name,state,total_population,median_household_income,gross_rent,median_home_value,total_in_labor_workforce,total_not_in_labor_workforce,total_education,education_no_hs,education_hs,education_associates,education_bachelors,education_graduate,total_occupancy_status,occupancy_status_occupied,occupancy_status_vacant,total_home_tenure,home_tenure_owner_occupied,home_tenure_renter_occupied,reporting_date,region_type,city
Alabama,01,4850771,46472,747,132100,3876136,1642927,3276637,481059,1012551,979449,503930,299648,2231126,1856695,374431,1856695,1273217,583478,2017-01-01,state,
Alabama,01,4864680,48486,772,137200,3894696,1657532,3299958,470043,1020172,987148,515443,307152,2244462,1860269,384193,1860269,1275223,585046,2018-01-01,state,
Alabama,01,4876250,50536,792,142700,3907144,1664359,3320877,458922,1022839,993344,529178,316594,2255026,1867893,387133,1867893,1284748,583145,2019-01-01,state,
Alabama,01,4893186,52035,811,149600,3926842,1666862,3344006,438947,1014342,1013673,546674,330370,2270398,1888504,381894,1888504,1306505,581999,2020-01-01,state,
Alabama,01,4997675,54943,852,157100,4005499,1691883,3413803,430047,1041209,1032122,563628,346797,2278526,1902983,375543,1902983,1320571,582412,2021-01-01,state,
Alabama,01,5028092,59609,925,179400,4046614,1701528,3428520,421180,1041725,1032770,572252,360593,2296920,1933150,363770,1933150,1347792,585358,2022-01-01,state,
Florida,12,20278447,50883,1077,178700,16645386,6872624,14396066,1787348,4170468,4342392,2616384,1479474,9259684,7510882,1748802,7510882,4868827,2642055,2017-01-01,state,
Florida,12,20598139,53267,1128,196800,16932309,7000510,14686727,1769489,4231678,4402103,2721635,1561822,9348689,7621760,1726929,7621760,4954601,2667159,2018-01-01,state,
Florida,12,20901636,55660,1175,215300,17201999,7085973,14965745,1767583,4276237,4450224,2827938,1643763,9448159,7736311,1711848,7736311,5058841,2677470,2019-01-01,state,
Florida,12,21216924,57703,1218,232000,17486583,7178515,15255326,1751798,4308542,4535040,2938593,1721353,9562324,7931313,1631011,7931313,5250878,2680435,2020-01-01,state,
Florida,12,21339762,61777,1301,248700,17577024,7128734,15349290,1682505,4282929,4543900,3038293,1801663,9764897,8157420,1607477,8157420,5420631,2736789,2021-01-01,state,
Florida,12,21634529,67917,1444,292200,17893588,7263895,15579847,1670872,4316799,4554710,3154240,1883226,9915957,8353441,1562516,8353441,5585924,2767517,2022-01-01,state,
New Jersey,34,8960161,76475,1249,321100,7197215,2472973,6163699,666782,1722597,1426484,1439971,907865,3595055,3199111,395944,3199111,2052073,1147038,2017-01-01,state,
New Jersey,34,8881845,79363,1295,327900,7142175,2458063,6129542,641113,1683568,1420805,1457910,926146,3605401,3213362,392039,3213362,2054413,1158949,2018-01-01,state,
New Jersey,34,8878503,82545,1334,335600,7148309,2458460,6146379,625931,1670942,1408555,1489653,951298,3616614,3231874,384740,3231874,2064240,1167634,2019-01-01,state,
New Jersey,34,8885418,85245,1368,343500,7161184,2452078,6169501,600761,1649853,1405825,1530150,982912,3628732,3272054,356678,3272054,2094427,1177627,2020-01-01,state,
New Jersey,34,9234024,89703,1436,355700,7436293,2531257,6411606,608877,1693560,1448316,1611515,1049338,3738342,3397156,341186,3397156,2168148,1229008,2021-01-01,state,
New Jersey,34,9249063,97126,1577,401400,7473298,2534217,6427003,601741,1674625,1435069,1636308,1079260,3756340,3438162,318178,3438162,2195831,1242331,2022-01-01,state,
Texas,48,27419612,57051,952,151500,20998008,7432970,17454431,3005904,4372430,5065702,3288777,1721618,10611386,9430419,1180967,9430419,5851046,3579373,2017-01-01,state,
Texas,48,27885195,59570,998,161700,21394120,7575789,17815359,2993432,4448881,5153577,3409836,1809633,10769900,9553046,1216854,9553046,5917771,3635275,2018-01-01,state,
Texas,48,28260856,61874,1045,172500,21736238,7680386,18131554,2957959,4525099,5227820,3534714,1885962,10937026,9691647,1245379,9691647,6004802,3686845,2019-01-01,state,
Texas,48,28635442,63826,1082,187200,22078090,7769024,18449851,2884734,4559034,5343905,3671085,1991093,11112975,9906070,1206905,9906070,6168808,3737262,2020-01-01,state,
Texas,48,28862581,67321,1146,202600,22261181,7768365,18619469,2826181,4563619,5358474,3791665,2079530,11433880,10239341,1194539,10239341,6391061,3848280,2021-01-01,state,
Texas,48,29243342,73035,1251,238000,22698396,7914084,18910948,2792334,4626129,5390698,3919003,2182784,11654971,10490553,1164418,10490553,6545727,3944826,2022-01-01,state,
ZCTA5 07001,34,18244,68426,1323,269700,15241,7729,14079,802,7302,2504,2196,1275,5236,5020,216,5020,2422,2598,2017-01-01,zipcode,Avenel
ZCTA5 07002,34,66719,56701,1187,314800,53739,20325,46513,5712,15414,9780,10768,4839,27568,25213,2355,25213,9605,15608,2017-01-01,zipcode,Bayonne
ZCTA5 07003,34,48892,74961,1300,316800,39675,11924,33952,2734,8744,8937,8758,4779,18476,17657,819,17657,9387,8270,2017-01-01,zipcode,Bloomfield
ZCTA5 07004,34,7584,107417,1907,472000,6149,2366,5519,340,1853,1292,1477,557,2823,2517,306,2517,2311,206,2017-01-01,zipcode,Fairfield
ZCTA5 07005,34,15350,109888,1338,442900,12460,3191,10695,571,2065,2349,3812,1898,5945,5550,395,5550,4311,1239,2017-01-01,zipcode,Boonton
ZCTA5 07006,34,25712,114096,1430,528000,21085,6841,18505,1122,3669,3548,6305,3861,10051,9579,472,9579,7255,2324,2017-01-01,zipcode,Caldwell
ZCTA5 07008,34,24040,73892,1443,267500,19279,6208,16501,2248,5712,4215,3152,1174,8472,7958,514,7958,4616,3342,2017-01-01,zipcode,Carteret
ZCTA5 07009,34,12638,115926,1402,451500,10694,4185,9535,653,2440,1784,3213,1445,4603,4480,123,4480,3539,941,2017-01-01,zipcode,Cedar grove
ZCTA5 07010,34,24861,67799,1332,432200,21421,7418,19383,2133,5587,3347,5176,3140,11260,10577,683,10577,5070,5507,2017-01-01,zipcode,Cliffside park
ZCTA5 07011,34,41692,56285,1362,295900,33419,11409,27030,3916,11315,6210,4296,1293,13887,12635,1252,12635,6075,6560,2017-01-01,zipcode,Clifton
ZCTA5 07012,34,11475,86472,1374,339500,9327,2923,8332,630,1837,1868,2498,1499,4975,4542,433,4542,2623,1919,2017-01-01,zipcode,Clifton
ZCTA5 07013,34,26934,93005,1284,350600,22984,7790,20394,2230,5136,5217,5057,2754,10934,9912,1022,9912,7181,2731,2017-01-01,zipcode,Clifton
ZCTA5 07014,34,5195,96339,1412,335700,4019,1152,3594,137,902,855,1127,573,2018,1843,175,1843,1376,467,2017-01-01,zipcode,Clifton
ZCTA5 07016,34,23972,122848,1566,463800,19181,5839,17041,704,3422,3925,5403,3587,8942,8501,441,8501,6658,1843,2017-01-01,zipcode,Cranford
ZCTA5 07017,34,36304,41322,999,208700,29032,9506,24519,3068,9099,7805,3120,1427,16045,13543,2502,13543,3945,9598,2017-01-01,zipcode,East orange
ZCTA5 07018,34,28922,42335,1094,198300,23073,7697,19243,2821,7151,5615,2579,1077,12816,10682,2134,10682,2439,8243,2017-01-01,zipcode,East orange
ZCTA5 07020,34,12165,103505,2268,560000,9748,3066,9121,383,1495,1073,4004,2166,5995,5411,584,5411,1839,3572,2017-01-01,zipcode,Edgewater
ZCTA5 07021,34,2071,198750,3018,832900,1604,603,1395,14,134,123,608,516,819,728,91,728,688,40,2017-01-01,zipcode,Essex fells
ZCTA5 07022,34,14422,56057,1263,351400,12156,3832,10913,3067,3517,1957,1769,603,5806,5515,291,5515,1779,3736,2017-01-01,zipcode,Fairview
ZCTA5 07023,34,7648,132292,2708,433100,5727,1918,5044,75,1047,697,1969,1256,2647,2531,116,2531,2224,307,2017-01-01,zipcode,Fanwood
ZCTA5 07024,34,37077,76623,1665,332600,31608,12665,28650,1730,5091,4757,10448,6624,18218,16658,1560,16658,9739,6919,2017-01-01,zipcode,Fort lee
ZCTA5 07026,34,31890,54037,1281,329100,25348,9423,21669,3373,8836,5270,3117,1073,12151,11265,886,11265,4067,7198,2017-01-01,zipcode,Garfield
ZCTA5 07027,34,4365,79063,1433,365600,3575,1183,3091,142,945,774,750,480,1880,1789,91,1789,1105,684,2017-01-01,zipcode,Garwood
ZCTA5 07028,34,7791,195714,1485,622500,5533,1567,4854,134,641,669,1710,1700,2575,2490,85,2490,2294,196,2017-01-01,zipcode,Glen ridge
ZCTA5 07029,34,18667,61084,1332,307500,15059,4425,13090,2379,3832,2375,2354,2150,6745,6391,354,6391,1749,4642,2017-01-01,zipcode,Harrison
ZCTA5 07030,34,54117,127523,2100,652200,47063,9607,41566,2338,3591,3120,20856,11661,26983,24812,2171,24812,8092,16720,2017-01-01,zipcode,Hoboken
ZCTA5 07031,34,15877,74481,1288,347800,13303,4703,11445,1269,3596,2696,2578,1306,6218,6088,130,6088,3147,2941,2017-01-01,zipcode,North arlington
ZCTA5 07032,34,42443,63222,1213,318700,34345,12188,29297,5316,10450,6383,5145,2003,14453,13461,992,13461,6369,7092,2017-01-01,zipcode,Kearny
ZCTA5 07033,34,8235,108281,1421,347500,6710,2312,5712,722,1841,1628,1151,370,2910,2800,110,2800,2186,614,2017-01-01,zipcode,Kenilworth
ZCTA5 07034,34,9308,82626,1209,327000,7738,2062,6702,489,1674,1309,1985,1245,3664,3436,228,3436,2247,1189,2017-01-01,zipcode,Lake hiawatha
ZCTA5 07035,34,10707,92075,1597,337700,8787,2970,7840,518,2487,1962,1815,1058,3951,3696,255,3696,2864,832,2017-01-01,zipcode,Lincoln park
ZCTA5 07036,34,43727,66166,1194,263900,36065,11521,31029,4115,10627,9546,4532,2209,16365,15022,1343,15022,8542,6480,2017-01-01,zipcode,Linden
ZCTA5 07039,34,29955,153381,2626,599100,23407,8356,20760,741,2827,2877,7578,6737,10426,9931,495,9931,8876,1055,2017-01-01,zipcode,Livingston
ZCTA5 07040,34,24543,125036,1485,487000,18216,4809,16280,791,2497,2743,5306,4943,8880,8149,731,8149,6315,1834,2017-01-01,zipcode,Maplewood
ZCTA5 07041,34,7283,104786,1656,721600,5286,1623,4700,149,414,537,1719,1881,2777,2561,216,2561,1649,912,2017-01-01,zipcode,Millburn
ZCTA5 07042,34,26323,97920,1491,501500,20755,6224,18100,873,2368,3288,6525,5046,10912,10125,787,10125,4924,5201,2017-01-01,zipcode,Montclair
ZCTA5 07043,34,12689,191449,1738,715900,9427,3010,7830,187,300,732,3040,3571,4192,4133,59,4133,3323,810,2017-01-01,zipcode,Montclair
ZCTA5 07044,34,13893,110745,1432,428600,11070,3459,10038,307,1860,1736,3530,2605,5588,5222,366,5222,4215,1007,2017-01-01,zipcode,Verona
ZCTA5 07045,34,10732,162798,2277,568200,8482,2899,7545,241,1249,1324,2369,2362,3993,3816,177,3816,3567,249,2017-01-01,zipcode,Montville
ZCTA5 07046,34,4309,175556,1469,810300,3226,1180,2697,41,110,224,921,1401,1437,1404,33,1404,1282,122,2017-01-01,zipcode,Mountain lakes
ZCTA5 07047,34,63438,57269,1300,308000,51152,15023,44726,8101,14960,10106,7920,3639,23376,21932,1444,21932,8458,13474,2017-01-01,zipcode,North bergen
ZCTA5 07050,34,30644,38506,1064,222300,23785,8116,20491,4115,6610,5333,3126,1307,13056,11733,1323,11733,2654,9079,2017-01-01,zipcode,Orange
ZCTA5 07052,34,47609,93954,1450,370200,38353,12742,33387,2599,7175,6463,9814,7336,17318,16184,1134,16184,10837,5347,2017-01-01,zipcode,West orange
ZCTA5 07054,34,29889,90355,1260,445800,25142,7985,22026,1719,4416,3926,7286,4679,11635,11082,553,11082,5802,5280,2017-01-01,zipcode,Parsippany
ZCTA5 07055,34,71097,34958,1145,309100,50029,20673,40537,13861,14077,6518,4107,1974,21358,19544,1814,19544,4593,14951,2017-01-01,zipcode,Passaic
ZCTA5 07057,34,11701,62648,1189,351900,9922,3568,8728,703,3555,2036,1636,798,4988,4545,443,4545,2002,2543,2017-01-01,zipcode,Wallington
ZCTA5 07058,34,5004,114229,1590,596700,3823,779,3392,136,443,577,1274,962,1984,1864,120,1864,887,977,2017-01-01,zipcode,Pine brook
ZCTA5 07059,34,15982,154429,1538,749300,12860,4710,10905,414,1850,1629,3474,3538,5273,5097,176,5097,4702,395,2017-01-01,zipcode,Warren
ZCTA5 07060,34,46270,57959,1184,269300,35988,9788,30082,7848,9657,6675,3928,1974,15286,14235,1051,14235,5742,8493,2017-01-01,zipcode,Plainfield
ZCTA5 07062,34,12793,67664,1252,229800,9972,2944,8543,1139,3173,2475,1115,641,4489,3921,568,3921,2388,1533,2017-01-01,zipcode,Plainfield
ZCTA5 07063,34,14031,72440,1342,239000,10762,3335,8873,2059,3285,2014,957,558,4011,3701,310,3701,2477,1224,2017-01-01,zipcode,Plainfield
ZCTA5 07064,34,4150,81912,1377,283700,3257,1191,2720,305,946,633,602,234,1402,1334,68,1334,1070,264,2017-01-01,zipcode,Port reading
ZCTA5 07065,34,29471,69932,1402,263000,23717,7365,20443,2155,7090,5448,3852,1898,11796,10844,952,10844,6349,4495,2017-01-01,zipcode,Rahway
ZCTA5 07066,34,15595,100000,1377,418100,12927,4015,11357,811,3080,2576,3211,1679,5830,5718,112,5718,4584,1134,2017-01-01,zipcode,Clark
ZCTA5 07067,34,17751,103205,1380,351300,14796,4175,12708,860,4140,2979,2914,1815,6194,5989,205,5989,5255,734,2017-01-01,zipcode,Colonia
ZCTA5 07068,34,5907,110208,2243,492700,4890,1716,4432,176,731,750,1474,1301,2581,2415,166,2415,2001,414,2017-01-01,zipcode,Roseland
ZCTA5 07069,34,6133,122434,1728,722800,4995,2198,4185,139,904,776,965,1401,2256,1968,288,1968,1577,391,2017-01-01,zipcode,Watchung
ZCTA5 07070,34,18622,93787,1383,446500,15245,4867,13181,554,2998,2475,4485,2669,7387,7095,292,7095,4348,2747,2017-01-01,zipcode,Rutherford
ZCTA5 07071,34,21937,73218,1275,368100,18592,6754,16361,1798,5670,3403,3306,2184,9048,8542,506,8542,4890,3652,2017-01-01,zipcode,Lyndhurst
ZCTA5 07072,34,6268,89419,1249,380700,5439,1735,4602,559,1393,936,1063,651,2515,2328,187,2328,1564,764,2017-01-01,zipcode,Carlstadt
ZCTA5 07073,34,9433,77400,1421,380600,7867,2688,7066,536,1802,1460,2358,910,4102,3850,252,3850,1523,2327,2017-01-01,zipcode,East rutherford
ZCTA5 07074,34,2783,59700,1293,336600,2225,760,1938,305,828,411,267,127,1051,936,115,936,753,183,2017-01-01,zipcode,Moonachie
ZCTA5 07075,34,8350,102283,1686,384700,6802,2321,5946,297,1740,1660,1309,940,3102,3048,54,3048,2180,868,2017-01-01,zipcode,Wood ridge
ZCTA5 07076,34,24339,117765,1481,481500,19359,5991,17135,789,3244,3462,5140,4500,8996,8576,420,8576,6864,1712,2017-01-01,zipcode,Scotch plains
ZCTA5 07077,34,2437,76389,1247,281800,2125,635,1855,100,607,518,449,181,1038,926,112,926,675,251,2017-01-01,zipcode,Sewaren
ZCTA5 07078,34,13097,250001,1852,1315700,9201,3314,8186,151,335,430,2820,4450,4221,4067,154,4067,3720,347,2017-01-01,zipcode,Short hills
ZCTA5 07079,34,16503,121637,1578,553100,13542,5016,9615,449,1043,1467,3576,3080,5610,5151,459,5151,3504,1647,2017-01-01,zipcode,South orange
ZCTA5 07080,34,24106,91250,1691,325800,19681,6069,17272,1845,5395,3952,3835,2245,8033,7865,168,7865,6294,1571,2017-01-01,zipcode,South plainfield
ZCTA5 07081,34,17528,110547,1574,426800,14139,4361,12854,660,2373,2128,4254,3439,7290,7012,278,7012,4550,2462,2017-01-01,zipcode,Springfield
ZCTA5 07082,34,5214,116615,2260,547100,4207,1332,3457,71,589,657,1118,1022,1791,1673,118,1673,1609,64,2017-01-01,zipcode,Towaco
ZCTA5 07083,34,55393,81359,1449,319700,46371,15718,39304,4556,11835,9272,9209,4432,20219,19235,984,19235,14164,5071,2017-01-01,zipcode,Union
ZCTA5 07086,34,14268,84841,1386,557200,12188,3258,11048,933,2140,1823,3525,2627,6985,6267,718,6267,1992,4275,2017-01-01,zipcode,Weehawken
ZCTA5 07087,34,69954,43407,1178,296800,56372,17654,48067,14569,15543,8357,6592,3006,26294,23559,2735,23559,4719,18840,2017-01-01,zipcode,Union city
ZCTA5 07088,34,3305,50299,1429,216000,2866,1099,2460,271,952,682,436,119,1345,1232,113,1232,788,444,2017-01-01,zipcode,Vauxhall
ZCTA5 07090,34,30591,159923,1594,725100,22766,7562,20127,515,2433,2892,7442,6845,11182,10591,591,10591,8727,1864,2017-01-01,zipcode,Westfield
ZCTA5 07092,34,6907,129405,1853,619500,5643,2325,5027,209,1008,1116,1568,1126,2485,2428,57,2428,2214,214,2017-01-01,zipcode,Mountainside
ZCTA5 07093,34,65078,51509,1235,304800,53240,16186,46465,12029,12948,8974,8113,4401,25505,23607,1898,23607,5479,18128,2017-01-01,zipcode,West new york
ZCTA5 07094,34,19279,99883,1593,426000,16079,5515,14450,1673,3518,2688,3998,2573,7708,7105,603,7105,4105,3000,2017-01-01,zipcode,Secaucus
ZCTA5 07095,34,19511,80196,1570,273800,15666,4737,13951,1341,3818,3470,3158,2164,7781,7221,560,7221,3999,3222,2017-01-01,zipcode,Woodbridge
ZCTA5 07102,34,12986,24353,783,225000,11183,5798,7855,2400,2138,1726,839,752,5269,4762,507,4762,424,4338,2017-01-01,zipcode,Newark
ZCTA5 07103,34,32610,27859,945,173400,25101,10986,19504,4391,7296,5074,2012,731,13076,10871,2205,10871,2572,8299,2017-01-01,zipcode,Newark
ZCTA5 07104,34,51398,36547,1016,239900,39460,13861,33096,9062,10592,7702,4042,1698,20447,18365,2082,18365,4125,14240,2017-01-01,zipcode,Newark
ZCTA5 07105,34,53323,45227,1118,294000,42615,14132,37165,13486,13079,5562,3721,1317,17765,16692,1073,16692,3623,13069,2017-01-01,zipcode,Newark
ZCTA5 07106,34,33140,37421,1007,193200,25797,8890,21278,3203,8375,6307,2252,1141,13697,11192,2505,11192,3598,7594,2017-01-01,zipcode,Newark
ZCTA5 07107,34,37797,30779,996,231000,28059,10333,22980,6922,7864,5384,2311,499,14975,12576,2399,12576,2771,9805,2017-01-01,zipcode,Newark
ZCTA5 07108,34,21993,25192,885,183600,16264,6872,12965,2784,4985,3820,1013,363,10350,7993,2357,7993,1418,6575,2017-01-01,zipcode,Newark
ZCTA5 07109,34,36344,67782,1236,277700,30111,8836,25375,3021,8136,7499,4876,1843,13898,12824,1074,12824,6547,6277,2017-01-01,zipcode,Belleville
ZCTA5 07110,34,28722,94128,1323,372100,23564,7507,20682,1117,5054,4601,6380,3530,11255,10672,583,10672,7018,3654,2017-01-01,zipcode,Nutley
ZCTA5 07111,34,54715,39734,974,181900,42283,12173,35362,5780,13906,10322,3807,1547,24393,20108,4285,20108,5763,14345,2017-01-01,zipcode,Irvington
ZCTA5 07112,34,26016,35765,1044,229200,20297,6208,17111,2146,5930,6279,1961,795,11965,9359,2606,9359,2711,6648,2017-01-01,zipcode,Newark
ZCTA5 07114,34,13698,26326,864,200000,11458,6776,10006,3029,4590,1685,538,164,4443,3664,779,3664,470,3194,2017-01-01,zipcode,Newark
ZCTA5 07201,34,27005,44655,1101,251600,20967,6347,17513,4910,6625,3999,1448,531,9427,8332,1095,8332,2125,6207,2017-01-01,zipcode,Elizabeth
ZCTA5 07202,34,41820,44867,1126,269300,32775,10354,27438,6996,10984,6274,2228,956,14206,13131,1075,13131,3033,10098,2017-01-01,zipcode,Elizabeth
ZCTA5 07203,34,21746,52480,1083,206700,17570,5679,14605,2195,4852,4884,1810,864,8687,7806,881,7806,4218,3588,2017-01-01,zipcode,Roselle
ZCTA5 07204,34,13709,67300,1183,277900,10835,3163,9195,884,2567,2296,2443,1005,5260,4947,313,4947,2929,2018,2017-01-01,zipcode,Roselle park
ZCTA5 07205,34,22069,65717,1263,239700,17893,5193,14924,1819,5062,4577,2212,1254,7634,7257,377,7257,4748,2509,2017-01-01,zipcode,Hillside
ZCTA5 07206,34,28010,43429,1156,249500,19624,6603,15901,5967,6160,2731,779,264,8907,7728,1179,7728,1823,5905,2017-01-01,zipcode,Elizabethport
ZCTA5 07208,34,32499,46572,1067,290800,25521,7238,21507,4109,8433,4949,2718,1298,11761,11014,747,11014,2956,8058,2017-01-01,zipcode,Elizabeth
ZCTA5 07302,34,42861,113898,2077,605700,37145,8178,34630,2258,3335,3674,13318,12045,23165,20267,2898,20267,5903,14364,2017-01-01,zipcode,Jersey city
ZCTA5 07304,34,43290,45870,1078,283800,34313,11415,29583,4860,9393,6894,6081,2355,17280,15454,1826,15454,4108,11346,2017-01-01,zipcode,Jersey city
ZCTA5 07305,34,66229,49453,1148,291500,51057,18672,42535,6720,14191,9780,8138,3706,25286,22265,3021,22265,8706,13559,2017-01-01,zipcode,Jersey city
ZCTA5 07306,34,55298,51197,1134,322900,45085,16040,39004,5892,8583,6813,11673,6043,22242,20212,2030,20212,4377,15835,2017-01-01,zipcode,Jersey city
ZCTA5 07307,34,44317,59744,1240,335800,35562,11924,30429,5181,7587,6490,7221,3950,17230,15789,1441,15789,4590,11199,2017-01-01,zipcode,Jersey city
ZCTA5 07310,34,13378,147357,2734,696300,11875,2763,10054,344,752,543,3057,5358,6617,5796,821,5796,864,4932,2017-01-01,zipcode,Jersey city
ZCTA5 07311,34,420,189750,2978,-666666666,403,64,388,0,0,36,94,258,305,222,83,222,0,222,2017-01-01,zipcode,Jersey city
ZCTA5 07401,34,6820,151875,1905,682100,5169,1787,4477,81,401,772,1884,1339,2426,2279,147,2279,1924,355,2017-01-01,zipcode,Allendale
ZCTA5 07403,34,8053,80872,1458,299000,6550,2190,5683,451,1886,1353,1385,608,2924,2834,90,2834,1921,913,2017-01-01,zipcode,Bloomingdale
ZCTA5 07405,34,17779,113281,1362,440100,14416,3955,12267,481,2961,2607,3722,2496,6470,6211,259,6211,4938,1273,2017-01-01,zipcode,Butler
ZCTA5 07407,34,20293,76907,1570,348200,16365,5304,13992,1362,5305,3250,3008,1067,7004,6685,319,6685,3715,2970,2017-01-01,zipcode,Elmwood park
ZCTA5 07410,34,33447,109747,1602,406400,27094,8593,23476,1557,4734,4860,7281,5044,11980,11611,369,11611,9424,2187,2017-01-01,zipcode,Fair lawn
ZCTA5 07416,34,5521,59477,1137,198000,4483,1441,3788,291,1555,1095,640,207,2540,2151,389,2151,1533,618,2017-01-01,zipcode,Franklin
ZCTA5 07417,34,10953,155458,2385,975000,8852,3515,7658,161,1047,1296,2996,2158,4024,3853,171,3853,3367,486,2017-01-01,zipcode,Franklin lakes
ZCTA5 07418,34,2267,128438,1820,278300,1852,441,1489,33,520,454,370,112,871,747,124,747,683,64,2017-01-01,zipcode,Glenwood
ZCTA5 07419,34,8654,85225,1400,222700,7008,2280,6477,302,2033,1955,1478,709,4129,3712,417,3712,2868,844,2017-01-01,zipcode,Hamburg
ZCTA5 07420,34,5248,80614,1376,256400,4265,1437,3840,515,1398,997,674,256,1704,1579,125,1579,1375,204,2017-01-01,zipcode,Haskell
ZCTA5 07421,34,7351,90412,1739,252800,5988,1603,5173,439,2058,1171,1021,484,3285,2651,634,2651,2260,391,2017-01-01,zipcode,Hewitt
ZCTA5 07422,34,6466,86250,1872,214800,5291,1387,4705,192,1630,1373,1003,507,3068,2463,605,2463,2280,183,2017-01-01,zipcode,Highland lakes
ZCTA5 07423,34,4162,176518,2338,727900,3072,1015,2741,50,207,330,1268,886,1489,1449,40,1449,1335,114,2017-01-01,zipcode,Ho ho kus
ZCTA5 07424,34,27066,79302,1374,369400,22606,7575,18935,1496,6755,3776,4404,2504,10112,9611,501,9611,6224,3387,2017-01-01,zipcode,Little falls
ZCTA5 07430,34,26581,107215,1833,489900,22152,7527,17268,726,3543,3172,5938,3889,9586,9345,241,9345,7407,1938,2017-01-01,zipcode,Mahwah
ZCTA5 07432,34,7336,105313,1635,488500,5745,1708,5151,246,1418,942,1602,943,2818,2690,128,2690,1838,852,2017-01-01,zipcode,Midland park
ZCTA5 07435,34,2790,124500,1048,393300,2228,614,1847,56,458,350,531,452,1203,994,209,994,859,135,2017-01-01,zipcode,Newfoundland
ZCTA5 07436,34,13145,112944,1702,446800,10433,2958,8797,361,1991,2087,2716,1642,4530,4319,211,4319,3917,402,2017-01-01,zipcode,Oakland
ZCTA5 07438,34,11537,106035,1228,336100,9453,2936,7984,363,2304,1906,2215,1196,4593,4295,298,4295,3993,302,2017-01-01,zipcode,Oak ridge
ZCTA5 07439,34,2500,84167,1313,223000,1969,481,1716,75,660,514,273,194,932,858,74,858,715,143,2017-01-01,zipcode,Ogdensburg
ZCTA5 07440,34,4270,104236,736,386100,3466,1034,2973,153,817,608,1018,377,1608,1511,97,1511,1280,231,2017-01-01,zipcode,Pequannock
ZCTA5 07442,34,11205,92952,1450,303300,9307,2287,8075,473,3307,1523,1750,1022,4187,4005,182,4005,3059,946,2017-01-01,zipcode,Pompton lakes
ZCTA5 07444,34,11229,91060,2037,393100,9467,3790,8402,440,2171,2022,2412,1357,4962,4788,174,4788,3792,996,2017-01-01,zipcode,Pompton plains
ZCTA5 07446,34,15076,137331,1382,554400,12091,3699,10410,189,1513,1760,4199,2749,5867,5539,328,5539,4890,649,2017-01-01,zipcode,Ramsey
ZCTA5 07450,34,25568,162201,1969,738900,18749,6640,16414,480,1517,1919,6534,5964,8580,8359,221,8359,6420,1939,2017-01-01,zipcode,Ridgewood
ZCTA5 07452,34,11962,162443,1840,621800,8878,2837,7702,175,692,1222,3226,2387,3991,3901,90,3901,3630,271,2017-01-01,zipcode,Glen rock
ZCTA5 07456,34,12328,115399,2024,342000,9747,2941,8196,720,1960,1936,2374,1206,4190,3867,323,3867,3710,157,2017-01-01,zipcode,Ringwood
ZCTA5 07457,34,4238,100602,1942,331200,3565,829,3173,262,686,661,994,570,1994,1887,107,1887,1365,522,2017-01-01,zipcode,Riverdale
ZCTA5 07458,34,11632,176455,2243,1043400,8972,3377,7683,233,1079,1260,2653,2458,3968,3714,254,3714,3274,440,2017-01-01,zipcode,Saddle river
ZCTA5 07460,34,3400,96176,2121,252000,2841,578,2345,142,785,641,524,253,1406,1212,194,1212,1155,57,2017-01-01,zipcode,Stockholm
ZCTA5 07461,34,18643,84676,1124,281800,15268,4993,13091,822,4771,3764,2700,1034,8232,6806,1426,6806,5723,1083,2017-01-01,zipcode,Sussex
ZCTA5 07462,34,6559,88223,1289,223800,5325,1297,4570,296,1597,1427,807,443,3396,2573,823,2573,1830,743,2017-01-01,zipcode,Vernon
ZCTA5 07463,34,9985,115591,1905,434000,7907,2135,6910,278,1390,1683,2419,1140,3652,3596,56,3596,3125,471,2017-01-01,zipcode,Waldwick
ZCTA5 07465,34,6743,85545,1536,335800,5733,2248,5092,224,1540,1213,1393,722,2837,2653,184,2653,2244,409,2017-01-01,zipcode,Wanaque
ZCTA5 07470,34,55154,108092,1551,454500,45137,16120,37992,2452,9086,7076,12084,7294,18941,18278,663,18278,14538,3740,2017-01-01,zipcode,Wayne
ZCTA5 07480,34,16632,100963,1463,288400,13434,4678,11839,673,3823,2994,2810,1539,6551,5913,638,5913,5273,640,2017-01-01,zipcode,West milford
ZCTA5 07481,34,17231,147463,1663,724100,13440,5425,11372,276,1854,1847,4398,2997,5941,5827,114,5827,5343,484,2017-01-01,zipcode,Wyckoff
ZCTA5 07495,34,0,-666666666,-666666666,-666666666,0,0,0,0,0,0,0,0,0,0,0,0,0,0,2017-01-01,zipcode,Mahwah
ZCTA5 07501,34,32749,26691,1073,242400,24995,11978,20389,7187,7777,3860,1156,409,11858,10250,1608,10250,1696,8554,2017-01-01,zipcode,Paterson
ZCTA5 07502,34,16719,52292,1307,225200,12892,5043,10578,2189,4354,2919,704,412,4906,4413,493,4413,2112,2301,2017-01-01,zipcode,Paterson
ZCTA5 07503,34,18559,40368,1170,246300,14273,6182,11718,3043,4663,2691,898,423,5732,5193,539,5193,1643,3550,2017-01-01,zipcode,Paterson
ZCTA5 07504,34,11122,58125,1228,270300,9211,3427,7729,1438,3174,1871,852,394,3495,3144,351,3144,1259,1885,2017-01-01,zipcode,Paterson
ZCTA5 07505,34,2673,26198,999,-666666666,2218,921,1984,508,877,401,192,6,1179,1052,127,1052,56,996,2017-01-01,zipcode,Paterson
ZCTA5 07506,34,19065,93675,1448,377700,15165,4170,13199,1158,4279,3183,2982,1597,7162,6933,229,6933,4156,2777,2017-01-01,zipcode,Hawthorne
ZCTA5 07508,34,22959,77128,1372,344200,18333,6052,15810,1645,5575,3918,3238,1434,7748,7407,341,7407,4810,2597,2017-01-01,zipcode,Haledon
ZCTA5 07512,34,10829,97729,1540,370200,9115,3212,7828,881,2548,1941,1790,668,3541,3371,170,3371,2761,610,2017-01-01,zipcode,Totowa
ZCTA5 07513,34,12794,39665,1262,256800,9661,3259,7870,2016,3664,1412,686,92,3747,3440,307,3440,967,2473,2017-01-01,zipcode,Paterson
ZCTA5 07514,34,20358,39951,1150,217300,15509,6042,12706,2953,5311,3157,1058,227,7156,6470,686,6470,1789,4681,2017-01-01,zipcode,Paterson
ZCTA5 07522,34,19890,30902,1138,214500,14836,6977,11587,3495,4787,1993,992,320,6938,5813,1125,5813,1316,4497,2017-01-01,zipcode,Paterson
ZCTA5 07524,34,13026,35397,1123,223400,9665,4257,7858,2449,3472,1217,608,112,4340,4011,329,4011,919,3092,2017-01-01,zipcode,Paterson
ZCTA5 07601,34,44673,59277,1335,292600,37148,12149,32872,4223,9776,7527,7694,3652,20269,18817,1452,18817,6505,12312,2017-01-01,zipcode,Hackensack
ZCTA5 07603,34,8437,79356,1302,316100,6854,2250,5745,655,1926,1507,1095,562,2965,2891,74,2891,1977,914,2017-01-01,zipcode,Bogota
ZCTA5 07604,34,12205,87800,1415,406800,10045,3353,8609,526,2186,2163,2436,1298,4491,4406,85,4406,2773,1633,2017-01-01,zipcode,Hasbrouck heights
ZCTA5 07605,34,9191,89744,1388,481200,7479,2678,6318,535,1002,1099,2311,1371,3449,3281,168,3281,1936,1345,2017-01-01,zipcode,Leonia
ZCTA5 07606,34,2661,66094,1440,365100,2249,782,1870,345,932,311,179,103,880,848,32,848,400,448,2017-01-01,zipcode,South hackensack
ZCTA5 07607,34,9789,86100,1463,373200,8152,2537,7045,467,2035,1917,1601,1025,3716,3578,138,3578,2189,1389,2017-01-01,zipcode,Maywood
ZCTA5 07608,34,108,-666666666,1453,-666666666,96,50,75,24,30,16,5,0,47,47,0,47,2,45,2017-01-01,zipcode,Teterboro
ZCTA5 07620,34,1489,118068,1211,2000001,1216,531,1143,83,140,118,490,312,635,563,72,563,451,112,2017-01-01,zipcode,Alpine
ZCTA5 07621,34,27694,90962,1316,344500,22423,6889,18831,1792,4975,4123,5552,2389,9007,8688,319,8688,5840,2848,2017-01-01,zipcode,Bergenfield
ZCTA5 07624,34,8702,130815,1983,625700,6926,2572,5876,221,1294,733,2181,1447,2751,2673,78,2673,2236,437,2017-01-01,zipcode,Closter
ZCTA5 07626,34,8811,136250,2151,595200,6695,2536,6102,303,713,1062,2346,1678,3173,2987,186,2987,2507,480,2017-01-01,zipcode,Cresskill
ZCTA5 07627,34,5031,149271,3147,673200,3931,1535,3262,78,404,532,1335,913,1763,1661,102,1661,1506,155,2017-01-01,zipcode,Demarest
ZCTA5 07628,34,17882,94617,1201,364500,14396,4458,12838,879,3756,2592,3566,2045,6561,6282,279,6282,4625,1657,2017-01-01,zipcode,Dumont
ZCTA5 07630,34,7668,111536,1854,465600,6187,2156,5256,486,1191,1363,1296,920,2569,2462,107,2462,2069,393,2017-01-01,zipcode,Emerson
ZCTA5 07631,34,28412,80489,1431,372700,22801,7228,20336,1825,5273,3922,5301,4015,11605,10606,999,10606,5389,5217,2017-01-01,zipcode,Englewood
ZCTA5 07632,34,5532,134904,3179,987400,4361,2039,4058,224,697,628,1401,1108,2008,1871,137,1871,1655,216,2017-01-01,zipcode,Englewood cliffs
ZCTA5 07640,34,4819,127188,1738,595900,3609,1210,3218,114,425,663,1137,879,1629,1629,0,1629,1449,180,2017-01-01,zipcode,Harrington park
ZCTA5 07641,34,3473,170417,3450,645500,2746,902,2347,40,324,384,829,770,1145,1127,18,1127,1084,43,2017-01-01,zipcode,Haworth
ZCTA5 07642,34,10520,124844,1503,522700,8332,2804,7186,383,1384,1688,2254,1477,3618,3570,48,3570,3120,450,2017-01-01,zipcode,Hillsdale
ZCTA5 07643,34,10942,61341,1273,323300,9404,2898,8266,1064,2202,2551,1726,723,4930,4414,516,4414,1874,2540,2017-01-01,zipcode,Little ferry
ZCTA5 07644,34,24805,57188,1227,369800,20497,6957,17294,2872,5743,4826,2859,994,9513,9005,508,9005,3669,5336,2017-01-01,zipcode,Lodi
ZCTA5 07645,34,8440,120060,1791,609700,6744,2505,5754,224,1060,1093,1809,1568,2868,2823,45,2823,2417,406,2017-01-01,zipcode,Montvale
ZCTA5 07646,34,16760,84025,1360,397000,13907,4199,11871,701,3374,2758,3476,1562,6129,5929,200,5929,3589,2340,2017-01-01,zipcode,New milford
ZCTA5 07647,34,5471,93925,1473,463400,4435,1602,3877,321,945,772,1425,414,1902,1835,67,1835,1524,311,2017-01-01,zipcode,Northvale
ZCTA5 07648,34,5864,125417,1719,639100,4811,1765,4258,229,848,894,1452,835,2177,2111,66,2111,1709,402,2017-01-01,zipcode,Norwood
ZCTA5 07649,34,8222,137583,1384,580200,6375,2188,5634,188,904,1061,2196,1285,2768,2696,72,2696,2364,332,2017-01-01,zipcode,Oradell
ZCTA5 07650,34,20697,64538,1420,522400,18044,6077,15891,2226,4046,2744,5516,1359,7870,7559,311,7559,2636,4923,2017-01-01,zipcode,Palisades park
ZCTA5 07652,34,26919,105114,1865,574600,22524,9534,19528,1733,4409,4221,6042,3123,8820,8349,471,8349,7294,1055,2017-01-01,zipcode,Paramus
ZCTA5 07656,34,8905,106875,1418,546000,7195,2547,6311,307,1252,1175,2312,1265,3431,3336,95,3336,2603,733,2017-01-01,zipcode,Park ridge
ZCTA5 07657,34,11369,66690,1593,447300,9445,3327,7797,746,2648,1610,1920,873,3890,3724,166,3724,1780,1944,2017-01-01,zipcode,Ridgefield
ZCTA5 07660,34,13070,72191,1308,326700,10507,3055,9060,700,2247,2242,2609,1262,5037,4703,334,4703,2521,2182,2017-01-01,zipcode,Ridgefield park
ZCTA5 07661,34,11648,123590,1478,486900,9352,2888,7971,477,1476,1439,2580,1999,4178,4004,174,4004,2976,1028,2017-01-01,zipcode,River edge
ZCTA5 07662,34,5677,78333,1618,371300,4835,1730,4109,349,1480,880,968,432,1987,1906,81,1906,1298,608,2017-01-01,zipcode,Rochelle park
ZCTA5 07663,34,14076,94177,1442,366500,12007,4165,10650,1350,2994,2797,2536,973,5535,5281,254,5281,3608,1673,2017-01-01,zipcode,Saddle brook
ZCTA5 07666,34,40977,106411,1403,389000,32217,11396,26704,1684,4802,5305,8451,6462,13957,13316,641,13316,9774,3542,2017-01-01,zipcode,Teaneck
ZCTA5 07670,34,14882,153906,1717,785200,10798,4003,9149,300,757,848,3116,4128,4944,4683,261,4683,3668,1015,2017-01-01,zipcode,Tenafly
ZCTA5 07675,34,27300,119748,1688,566600,21640,7103,18967,817,3560,3861,6714,4015,10233,9849,384,9849,7667,2182,2017-01-01,zipcode,Westwood
ZCTA5 07676,34,9354,128203,2283,491600,7583,2594,6576,285,1194,1517,2359,1221,3381,3231,150,3231,2990,241,2017-01-01,zipcode,Township of washington
ZCTA5 07677,34,5868,161250,1878,769500,4725,1742,3962,42,440,584,1636,1260,2104,2053,51,2053,1882,171,2017-01-01,zipcode,Woodcliff lake
ZCTA5 07701,34,23874,84520,1400,386200,19401,5619,17024,2211,3542,3692,4468,3111,10367,9648,719,9648,6354,3294,2017-01-01,zipcode,Red bank
ZCTA5 07702,34,4051,122321,2378,530100,3194,1272,2785,85,496,522,1139,543,1516,1450,66,1450,1331,119,2017-01-01,zipcode,Shrewsbury
ZCTA5 07703,34,54,-666666666,-666666666,-666666666,54,15,39,0,27,12,0,0,166,0,166,0,0,0,2017-01-01,zipcode,Fort monmouth
ZCTA5 07704,34,6015,158264,2132,686100,4196,1343,3628,35,390,551,1563,1089,1963,1889,74,1889,1689,200,2017-01-01,zipcode,Fair haven
ZCTA5 07711,34,1617,137625,1243,740100,1332,473,1165,17,149,265,436,298,886,593,293,593,488,105,2017-01-01,zipcode,Allenhurst
ZCTA5 07712,34,38580,60869,1145,385500,31018,9778,27017,2785,7877,6119,5934,4302,18103,16078,2025,16078,7188,8890,2017-01-01,zipcode,Asbury park
ZCTA5 07716,34,8733,91012,1168,425400,7304,2312,6360,283,1256,1686,1923,1212,3908,3575,333,3575,2660,915,2017-01-01,zipcode,Atlantic highlands
ZCTA5 07717,34,1814,78323,1505,864800,1600,665,1472,30,197,382,547,316,1342,911,431,911,571,340,2017-01-01,zipcode,Avon by the sea
ZCTA5 07718,34,7552,102542,1708,340100,6067,1941,5071,368,1866,1206,1154,477,2448,2397,51,2397,2003,394,2017-01-01,zipcode,Belford
ZCTA5 07719,34,21155,92414,1386,431700,17917,5954,15340,976,3583,3484,4682,2615,10202,8385,1817,8385,6008,2377,2017-01-01,zipcode,Belmar
ZCTA5 07720,34,4262,61209,1306,479100,3714,1315,3354,405,579,907,848,615,3123,2169,954,2169,954,1215,2017-01-01,zipcode,Bradley beach
ZCTA5 07721,34,3039,68350,1206,271100,2475,707,2051,163,640,522,468,258,1273,1119,154,1119,767,352,2017-01-01,zipcode,Cliffwood
ZCTA5 07722,34,10147,166706,1855,758400,7836,3036,6469,239,931,1415,2083,1801,3437,3306,131,3306,2976,330,2017-01-01,zipcode,Colts neck
ZCTA5 07723,34,749,77778,1337,1041700,658,396,555,66,134,183,110,62,1168,306,862,306,210,96,2017-01-01,zipcode,Deal
ZCTA5 07724,34,21245,79868,1204,353000,17479,5639,15481,776,4243,4042,3931,2489,9495,8722,773,8722,5657,3065,2017-01-01,zipcode,Eatontown
ZCTA5 07726,34,44337,106678,1636,449800,35176,12795,30071,1768,6592,7281,8322,6108,16350,15363,987,15363,13277,2086,2017-01-01,zipcode,Englishtown
ZCTA5 07727,34,7758,77128,1053,424700,6138,2364,5116,275,1702,1159,1090,890,2937,2713,224,2713,1926,787,2017-01-01,zipcode,Farmingdale
ZCTA5 07728,34,55497,86037,1628,354700,44726,16063,38253,3984,10315,8875,9315,5764,20764,19641,1123,19641,14710,4931,2017-01-01,zipcode,Freehold
ZCTA5 07730,34,17389,98194,922,320400,14081,4491,12152,866,3878,3257,2844,1307,6073,5844,229,5844,5151,693,2017-01-01,zipcode,Hazlet
ZCTA5 07731,34,38492,102961,1415,321000,30689,8224,25347,1431,6996,7475,6648,2797,13064,12574,490,12574,11233,1341,2017-01-01,zipcode,Howell
ZCTA5 07732,34,4900,60817,1142,276200,4442,1439,4190,411,1549,921,614,695,3756,2712,1044,2712,1713,999,2017-01-01,zipcode,Highlands
ZCTA5 07733,34,16729,152294,2083,637400,13458,5415,11966,621,1751,1833,3673,4088,6070,5772,298,5772,4999,773,2017-01-01,zipcode,Holmdel
ZCTA5 07734,34,12738,54092,1075,211800,10416,3435,9027,1238,3476,2505,1351,457,6416,5178,1238,5178,3142,2036,2017-01-01,zipcode,Keansburg
ZCTA5 07735,34,18939,66782,1194,253200,15503,5175,13292,1338,4965,3624,2329,1036,7742,6936,806,6936,4932,2004,2017-01-01,zipcode,Keyport
ZCTA5 07737,34,3909,91042,1285,335600,3184,1137,2617,157,728,785,596,351,1491,1413,78,1413,1222,191,2017-01-01,zipcode,Leonardo
ZCTA5 07738,34,6193,132222,392,492800,4973,1690,4257,158,850,905,1147,1197,2153,2106,47,2106,1812,294,2017-01-01,zipcode,Lincroft
ZCTA5 07739,34,5917,144250,2254,605100,4474,1715,3960,15,489,903,1440,1113,2196,2103,93,2103,1955,148,2017-01-01,zipcode,Little silver
ZCTA5 07740,34,31038,55038,1239,339000,24878,7988,21477,3657,6428,5012,3908,2472,14864,12045,2819,12045,5274,6771,2017-01-01,zipcode,Long branch
ZCTA5 07746,34,18576,144588,2493,536300,14525,4857,12404,468,1889,2504,4275,3268,6237,5935,302,5935,5755,180,2017-01-01,zipcode,Marlboro
ZCTA5 07747,34,31092,99825,1485,349000,25169,7658,22345,1281,5089,5526,6485,3964,11983,11479,504,11479,8790,2689,2017-01-01,zipcode,Matawan
ZCTA5 07748,34,27139,113676,1330,426000,21778,7397,18778,741,4417,4661,5513,3446,9810,9418,392,9418,7798,1620,2017-01-01,zipcode,Middletown
ZCTA5 07750,34,3237,110380,2372,710300,2680,1174,2407,16,309,488,1000,594,2042,1411,631,1411,1207,204,2017-01-01,zipcode,Monmouth beach
ZCTA5 07751,34,19837,145118,2213,500400,15572,5062,12612,479,2120,2235,4137,3641,6303,6075,228,6075,5580,495,2017-01-01,zipcode,Morganville
ZCTA5 07753,34,38073,64774,1410,279400,31862,12071,27846,2381,8450,8665,5691,2659,16948,15710,1238,15710,9966,5744,2017-01-01,zipcode,Neptune
ZCTA5 07755,34,5977,90192,1233,374200,4794,1785,4156,295,1096,1139,1070,556,2445,2180,265,2180,1924,256,2017-01-01,zipcode,Oakhurst
ZCTA5 07756,34,2943,60000,1100,482400,2844,1069,2661,62,437,618,757,787,3051,1786,1265,1786,896,890,2017-01-01,zipcode,Ocean grove
ZCTA5 07757,34,5738,107571,1375,441600,4636,1645,4215,143,947,898,1435,792,2294,2132,162,2132,1776,356,2017-01-01,zipcode,Oceanport
ZCTA5 07758,34,4275,92879,1940,306400,3316,942,2805,219,859,941,551,235,1622,1447,175,1447,1270,177,2017-01-01,zipcode,Port monmouth
ZCTA5 07760,34,8803,138917,1977,872400,6582,2549,5600,63,600,1075,2381,1481,3878,3166,712,3166,2694,472,2017-01-01,zipcode,Rumson
ZCTA5 07762,34,8250,77500,1433,608600,7125,2902,6226,155,1257,1477,2101,1236,5254,3868,1386,3868,2501,1367,2017-01-01,zipcode,Spring lake
ZCTA5 07764,34,7944,100000,1493,412300,6650,2612,4555,344,1195,1170,972,874,2589,2454,135,2454,1826,628,2017-01-01,zipcode,West long branch
ZCTA5 07801,34,25484,69028,1362,281700,20495,4820,17512,3577,5888,4571,2369,1107,8551,7887,664,7887,4033,3854,2017-01-01,zipcode,Dover
ZCTA5 07803,34,3609,84904,1045,284400,2857,975,2415,290,672,706,563,184,1273,1213,60,1213,1039,174,2017-01-01,zipcode,Mine hill
ZCTA5 07820,34,46,-666666666,-666666666,-666666666,46,38,46,5,0,0,41,0,38,38,0,38,38,0,2017-01-01,zipcode,Allamuchy
ZCTA5 07821,34,9465,106515,1310,296300,7665,2137,6574,182,1838,1901,1868,785,3994,3529,465,3529,3198,331,2017-01-01,zipcode,Andover
ZCTA5 07822,34,633,70156,-666666666,317000,485,216,467,58,91,88,173,57,263,263,0,263,239,24,2017-01-01,zipcode,Augusta
ZCTA5 07823,34,7747,60938,905,237900,6680,2824,5645,524,1976,1654,1065,426,3616,3212,404,3212,2285,927,2017-01-01,zipcode,Belvidere
ZCTA5 07825,34,9165,91903,1336,318000,7609,2759,6754,594,1876,1797,1626,861,3682,3336,346,3336,2970,366,2017-01-01,zipcode,Blairstown
ZCTA5 07826,34,5915,81569,1493,293200,4934,1897,4439,313,1666,1267,836,357,2690,2228,462,2228,1792,436,2017-01-01,zipcode,Branchville
ZCTA5 07827,34,4118,69688,963,201300,3459,1209,2922,192,1269,907,310,244,2010,1665,345,1665,1243,422,2017-01-01,zipcode,Montague
ZCTA5 07828,34,15197,77375,1105,312700,11709,2819,10249,482,3288,2467,2855,1157,6187,5838,349,5838,2897,2941,2017-01-01,zipcode,Budd lake
ZCTA5 07830,34,6745,124659,997,429300,5310,1845,4791,40,911,1082,1617,1141,2732,2412,320,2412,2263,149,2017-01-01,zipcode,Califon
ZCTA5 07832,34,4037,86944,1269,285900,3260,1124,2801,208,990,820,506,277,1663,1486,177,1486,1235,251,2017-01-01,zipcode,Columbia
ZCTA5 07833,34,103,-666666666,-666666666,-666666666,86,12,86,5,46,30,5,0,41,41,0,41,11,30,2017-01-01,zipcode,Delaware
ZCTA5 07834,34,18180,116273,1771,390100,14647,4460,12739,517,2296,2764,4086,3076,7287,6918,369,6918,5960,958,2017-01-01,zipcode,Denville
ZCTA5 07836,34,11972,107128,1413,391900,9343,2494,7956,164,1737,2015,2407,1633,4627,4230,397,4230,2843,1387,2017-01-01,zipcode,Flanders
ZCTA5 07838,34,3403,107757,1384,323800,2865,752,2390,81,600,682,699,328,1336,1247,89,1247,973,274,2017-01-01,zipcode,Great meadows
ZCTA5 07840,34,30028,77931,1125,288900,24546,7794,20321,1523,5576,5271,5114,2837,12459,11522,937,11522,7529,3993,2017-01-01,zipcode,Hackettstown
ZCTA5 07842,34,97,-666666666,-666666666,-666666666,89,0,81,0,17,9,46,9,45,45,0,45,45,0,2017-01-01,zipcode,Hibernia
ZCTA5 07843,34,11797,78694,1394,227400,9835,2472,8661,508,3002,2777,1787,587,5289,4628,661,4628,3866,762,2017-01-01,zipcode,Hopatcong
ZCTA5 07846,34,46,207969,-666666666,240600,22,3,22,0,0,2,6,14,23,13,10,13,13,0,2017-01-01,zipcode,Johnsonburg
ZCTA5 07847,34,1593,108836,1257,281500,1209,277,1133,144,411,249,230,99,571,571,0,571,491,80,2017-01-01,zipcode,Kenvil
ZCTA5 07848,34,4910,78472,1199,324400,4186,1844,3673,380,1116,1070,727,380,1849,1635,214,1635,1345,290,2017-01-01,zipcode,Lafayette
ZCTA5 07849,34,9142,87212,1431,311300,7569,2423,6476,426,1824,1804,1687,735,3905,3476,429,3476,3025,451,2017-01-01,zipcode,Lake hopatcong
ZCTA5 07850,34,6032,91164,1157,269200,4953,1508,4068,165,1458,1283,755,407,2433,2174,259,2174,1799,375,2017-01-01,zipcode,Landing
ZCTA5 07851,34,36,101250,-666666666,322700,36,11,32,0,6,11,15,0,55,17,38,17,17,0,2017-01-01,zipcode,Layton
ZCTA5 07852,34,3881,92792,1552,336000,3109,1039,2765,57,714,774,908,312,1587,1511,76,1511,1191,320,2017-01-01,zipcode,Ledgewood
ZCTA5 07853,34,13232,154135,1929,474300,10176,3364,8540,272,1276,1882,3087,2023,4493,4245,248,4245,4043,202,2017-01-01,zipcode,Long valley
ZCTA5 07856,34,4524,91563,1722,300100,4059,1518,3633,88,1141,860,911,633,2501,2082,419,2082,1521,561,2017-01-01,zipcode,Mount arlington
ZCTA5 07857,34,3270,56016,1165,264200,2915,862,2395,241,972,585,422,175,1471,1410,61,1410,695,715,2017-01-01,zipcode,Netcong
ZCTA5 07860,34,25654,82716,1141,264900,21551,7564,18162,1408,5333,5235,3918,2268,10984,9646,1338,9646,7281,2365,2017-01-01,zipcode,Newton
ZCTA5 07863,34,4213,85720,845,262100,3544,1346,3140,339,1293,781,485,242,1796,1665,131,1665,1385,280,2017-01-01,zipcode,Oxford
ZCTA5 07865,34,1959,118654,-666666666,288500,1602,391,1423,34,269,420,343,357,760,690,70,690,636,54,2017-01-01,zipcode,Port murray
ZCTA5 07866,34,22525,102712,1327,343800,18450,5970,16066,685,3728,4003,5133,2517,8769,8335,434,8335,6926,1409,2017-01-01,zipcode,Rockaway
ZCTA5 07869,34,25769,126290,1373,507900,20202,6347,17335,735,2369,3341,5919,4971,9331,8923,408,8923,6781,2142,2017-01-01,zipcode,Randolph
ZCTA5 07870,34,30,-666666666,-666666666,-666666666,30,21,21,0,0,0,9,12,15,15,0,15,6,9,2017-01-01,zipcode,Schooleys mountain
ZCTA5 07871,34,20459,131813,1191,374500,15940,4860,13451,320,2447,3284,4880,2520,7857,7041,816,7041,6349,692,2017-01-01,zipcode,Sparta
ZCTA5 07874,34,8205,90613,1486,257500,6651,2199,5806,227,1895,1533,1440,711,3301,3038,263,3038,2807,231,2017-01-01,zipcode,Stanhope
ZCTA5 07876,34,10518,124854,1414,379300,8771,3049,7305,385,1496,1855,2217,1352,3542,3478,64,3478,3307,171,2017-01-01,zipcode,Succasunna
ZCTA5 07878,34,786,106481,-666666666,347500,649,196,489,0,71,114,186,118,379,272,107,272,215,57,2017-01-01,zipcode,Mount tabor
ZCTA5 07880,34,240,132054,-666666666,-666666666,240,30,180,29,64,73,14,0,77,77,0,77,77,0,2017-01-01,zipcode,Vienna
ZCTA5 07881,34,6,-666666666,-666666666,-666666666,6,6,6,2,2,2,0,0,15,6,9,6,6,0,2017-01-01,zipcode,
ZCTA5 07882,34,14910,90304,1117,245700,12241,3502,10607,825,3192,3135,2174,1281,6072,5655,417,5655,4171,1484,2017-01-01,zipcode,Washington
ZCTA5 07885,34,10544,79222,1359,289400,8352,2646,7243,967,2221,1868,1455,732,4136,3821,315,3821,2430,1391,2017-01-01,zipcode,Wharton
ZCTA5 07901,34,23557,128097,1678,828000,17697,5961,15706,743,1936,1980,5531,5516,8708,8301,407,8301,5772,2529,2017-01-01,zipcode,Summit
ZCTA5 07920,34,26953,135365,2047,658200,20937,7744,17978,502,1718,2583,6334,6841,10048,9640,408,9640,7934,1706,2017-01-01,zipcode,Basking ridge
ZCTA5 07921,34,7754,104328,1974,375400,6789,1640,6388,102,717,1346,2145,2078,4251,3951,300,3951,3043,908,2017-01-01,zipcode,Bedminster
ZCTA5 07922,34,12574,146674,2031,600000,9802,3348,8560,399,1300,1172,2887,2802,4300,4072,228,4072,3844,228,2017-01-01,zipcode,Berkeley heights
ZCTA5 07924,34,7753,150246,1721,699800,6013,1746,5375,131,637,904,1990,1713,2901,2724,177,2724,2308,416,2017-01-01,zipcode,Bernardsville
ZCTA5 07926,34,7,-666666666,-666666666,-666666666,7,0,7,0,0,0,7,0,7,7,0,7,0,7,2017-01-01,zipcode,Brookside
ZCTA5 07927,34,4024,106458,2127,477700,3191,1025,2706,194,586,551,814,561,1677,1531,146,1531,1116,415,2017-01-01,zipcode,Cedar knolls
ZCTA5 07928,34,19360,173929,1788,800700,14046,4580,12401,338,1292,1388,4980,4403,6854,6410,444,6410,5355,1055,2017-01-01,zipcode,Chatham
ZCTA5 07930,34,8435,138328,1278,645400,6763,2542,5776,120,866,803,2205,1782,3212,2965,247,2965,2794,171,2017-01-01,zipcode,Chester
ZCTA5 07931,34,3193,186571,2142,1015000,2564,974,2132,58,247,350,856,621,1166,1084,82,1084,886,198,2017-01-01,zipcode,Far hills
ZCTA5 07932,34,10197,122843,2300,620700,8556,2833,7569,272,1104,1155,2738,2300,4277,4093,184,4093,2795,1298,2017-01-01,zipcode,Florham park
ZCTA5 07933,34,3326,142542,1567,494400,2844,926,2321,102,316,440,661,802,1244,1244,0,1244,1103,141,2017-01-01,zipcode,Gillette
ZCTA5 07934,34,1717,150250,1926,688300,1259,396,1132,0,198,197,414,323,608,574,34,574,477,97,2017-01-01,zipcode,Gladstone
ZCTA5 07935,34,230,-666666666,2119,350000,203,52,183,0,39,39,32,73,150,126,24,126,94,32,2017-01-01,zipcode,Green village
ZCTA5 07936,34,11241,121769,1986,557500,9335,3182,8226,661,2387,1738,2164,1276,3935,3811,124,3811,3516,295,2017-01-01,zipcode,East hanover
ZCTA5 07939,34,219,-666666666,-666666666,-666666666,219,185,208,29,92,48,39,0,0,0,0,0,0,0,2017-01-01,zipcode,Lyons
ZCTA5 07940,34,17242,128116,1643,697800,13848,5087,10206,475,1345,1483,3553,3350,5587,5369,218,5369,3845,1524,2017-01-01,zipcode,Madison
ZCTA5 07945,34,9059,171571,1882,742900,7084,2771,6090,151,588,902,2347,2102,3190,3090,100,3090,2824,266,2017-01-01,zipcode,Mendham
ZCTA5 07946,34,3251,152750,3113,587000,2605,821,2151,24,420,261,875,571,1143,1143,0,1143,1054,89,2017-01-01,zipcode,Millington
ZCTA5 07950,34,19117,120095,2007,467600,15513,5325,13652,526,2447,2483,4477,3719,7323,6952,371,6952,5678,1274,2017-01-01,zipcode,Morris plains
ZCTA5 07960,34,45023,114844,1659,568000,37621,11424,32908,2477,5244,4465,10848,9874,19188,17641,1547,17641,11185,6456,2017-01-01,zipcode,Morristown
ZCTA5 07961,34,0,-666666666,-666666666,-666666666,0,0,0,0,0,0,0,0,0,0,0,0,0,0,2017-01-01,zipcode,Convent station
ZCTA5 07970,34,168,233750,-666666666,360700,168,9,135,0,0,26,67,42,51,51,0,51,51,0,2017-01-01,zipcode,Mount freedom
ZCTA5 07974,34,12316,146776,1666,581600,9191,3202,8083,176,1190,1290,2960,2467,4322,4151,171,4151,3499,652,2017-01-01,zipcode,New providence
ZCTA5 07976,34,608,116019,-666666666,1750000,541,254,490,0,107,27,195,161,280,228,52,228,228,0,2017-01-01,zipcode,New vernon
ZCTA5 07977,34,567,74063,1208,495100,453,168,332,37,72,49,98,76,208,193,15,193,118,75,2017-01-01,zipcode,Peapack
ZCTA5 07979,34,541,130913,-666666666,552600,482,99,392,13,145,95,69,70,241,224,17,224,215,9,2017-01-01,zipcode,Pottersville
ZCTA5 07980,34,2186,122716,1335,529100,1800,571,1610,81,226,489,384,430,912,863,49,863,652,211,2017-01-01,zipcode,Stirling
ZCTA5 07981,34,9060,112534,1838,478200,7583,2521,6478,472,1554,1406,1776,1270,3580,3443,137,3443,2991,452,2017-01-01,zipcode,Whippany
ZCTA5 08001,34,869,68750,-666666666,172900,689,309,549,22,215,179,117,16,385,330,55,330,282,48,2017-01-01,zipcode,Alloway
ZCTA5 08002,34,22946,78812,1305,232300,18833,6138,16006,1552,3554,4140,4131,2629,9339,8559,780,8559,5618,2941,2017-01-01,zipcode,Cherry hill
ZCTA5 08003,34,29892,122591,1658,311200,24190,7953,21203,714,2822,3784,7168,6715,11331,10907,424,10907,9498,1409,2017-01-01,zipcode,Cherry hill
ZCTA5 08004,34,12495,87885,1406,191100,10025,3264,8948,869,3232,2685,1592,570,4394,4018,376,4018,3503,515,2017-01-01,zipcode,Atco
ZCTA5 08005,34,23606,70564,1513,252500,19305,8456,17048,1165,6216,5512,2861,1294,10321,9033,1288,9033,7774,1259,2017-01-01,zipcode,Barnegat
ZCTA5 08006,34,365,67750,1298,684400,351,220,339,6,85,98,85,65,1121,201,920,201,172,29,2017-01-01,zipcode,Barnegat light
ZCTA5 08007,34,5144,70152,830,191300,4297,1321,3922,245,1354,1190,741,392,2146,2041,105,2041,1335,706,2017-01-01,zipcode,Barrington
ZCTA5 08008,34,6923,82047,1161,776500,6514,3846,6117,92,1337,1341,1857,1490,17257,3455,13802,3455,3092,363,2017-01-01,zipcode,Beach haven
ZCTA5 08009,34,12824,81354,1170,218900,10417,3515,9112,828,2668,2815,2111,690,4909,4782,127,4782,4007,775,2017-01-01,zipcode,Berlin
ZCTA5 08010,34,11354,64085,1170,168300,9384,3327,8278,907,3321,2301,1172,577,4771,4427,344,4427,2632,1795,2017-01-01,zipcode,Beverly
ZCTA5 08011,34,23,-666666666,-666666666,-666666666,23,0,23,11,12,0,0,0,12,12,0,12,12,0,2017-01-01,zipcode,Birmingham
ZCTA5 08012,34,40040,71865,1122,201500,32379,10035,27593,2368,9131,8750,5249,2095,15862,14792,1070,14792,9891,4901,2017-01-01,zipcode,Blackwood
ZCTA5 08014,34,659,107838,-666666666,174200,456,60,423,11,165,183,11,53,240,206,34,206,156,50,2017-01-01,zipcode,Bridgeport
ZCTA5 08015,34,19837,65531,1141,166400,15779,5578,13121,1390,5678,4600,1086,367,7928,6912,1016,6912,5343,1569,2017-01-01,zipcode,Browns mills
ZCTA5 08016,34,33531,74626,1010,234700,26795,7707,22475,2214,7437,6176,4145,2503,13413,12090,1323,12090,8756,3334,2017-01-01,zipcode,Burlington
ZCTA5 08019,34,1007,95809,2333,260300,840,238,680,86,240,187,141,26,376,351,25,351,313,38,2017-01-01,zipcode,Chatsworth
ZCTA5 08020,34,2663,85519,1071,268000,2173,946,1940,158,827,418,398,139,948,892,56,892,810,82,2017-01-01,zipcode,Clarksboro
ZCTA5 08021,34,44394,50262,996,144400,35513,11592,30046,3527,10541,9488,4622,1868,19637,17658,1979,17658,9392,8266,2017-01-01,zipcode,Clementon
ZCTA5 08022,34,9210,89770,1792,304400,7857,3262,7004,404,1793,1807,2037,963,3899,3699,200,3699,3614,85,2017-01-01,zipcode,Columbus
ZCTA5 08023,34,371,28785,1325,101100,323,146,280,54,113,113,0,0,209,171,38,171,58,113,2017-01-01,zipcode,Deepwater
ZCTA5 08026,34,2177,84625,1841,199000,1818,601,1530,108,544,415,306,157,813,771,42,771,719,52,2017-01-01,zipcode,Gibbsboro
ZCTA5 08027,34,4861,70255,1154,180900,3893,1455,3533,253,1524,957,578,221,2097,1906,191,1906,1550,356,2017-01-01,zipcode,Gibbstown
ZCTA5 08028,34,20656,67875,1070,190800,17399,6698,12141,1220,3910,3127,2442,1442,7680,6751,929,6751,4497,2254,2017-01-01,zipcode,Glassboro
ZCTA5 08029,34,4212,55435,738,172000,3636,1275,3234,301,1400,1121,215,197,1954,1850,104,1850,1312,538,2017-01-01,zipcode,Glendora
ZCTA5 08030,34,13339,52136,1098,122000,10245,3579,8987,1110,3917,2217,1271,472,5310,4789,521,4789,3297,1492,2017-01-01,zipcode,Gloucester city
ZCTA5 08031,34,11482,49713,830,165400,9311,3229,8236,1146,3374,2311,994,411,4615,4357,258,4357,2633,1724,2017-01-01,zipcode,Bellmawr
ZCTA5 08033,34,16036,111939,1092,436600,12354,4023,11122,166,1432,2169,3904,3451,6437,6192,245,6192,4658,1534,2017-01-01,zipcode,Haddonfield
ZCTA5 08034,34,18508,91362,1346,240900,14970,4805,13013,662,2672,2688,4041,2950,7233,6922,311,6922,5570,1352,2017-01-01,zipcode,Cherry hill
ZCTA5 08035,34,7678,88667,879,278400,6350,2134,5644,320,1053,1153,1994,1124,3191,2994,197,2994,2383,611,2017-01-01,zipcode,Haddon heights
ZCTA5 08036,34,5971,97051,-666666666,280700,4841,1331,4064,271,1103,1167,1108,415,2270,2242,28,2242,2114,128,2017-01-01,zipcode,Hainesport
ZCTA5 08037,34,24033,71798,1190,233300,19757,7052,17275,2072,6527,4581,2801,1294,9419,8590,829,8590,6532,2058,2017-01-01,zipcode,Hammonton
ZCTA5 08038,34,67,49583,-666666666,167500,56,23,48,3,23,18,4,0,57,29,28,29,27,2,2017-01-01,zipcode,Hancocks bridge
ZCTA5 08039,34,115,68676,-666666666,226500,65,12,65,0,24,11,24,6,63,28,35,28,28,0,2017-01-01,zipcode,Harrisonville
ZCTA5 08041,34,1001,110500,-666666666,373200,743,261,640,51,165,248,92,84,322,300,22,300,262,38,2017-01-01,zipcode,Jobstown
ZCTA5 08042,34,219,-666666666,-666666666,236800,157,32,124,20,22,54,28,0,74,61,13,61,47,14,2017-01-01,zipcode,Juliustown
ZCTA5 08043,34,29392,85164,1227,308800,24120,9618,21423,1595,4335,4568,6253,4672,12022,10932,1090,10932,7443,3489,2017-01-01,zipcode,Voorhees
ZCTA5 08045,34,2846,63494,812,162300,2384,959,2106,213,726,567,347,253,1261,1129,132,1129,792,337,2017-01-01,zipcode,Lawnside
ZCTA5 08046,34,31549,70929,1599,161300,25944,8935,21496,1871,7424,6876,3552,1773,11416,10245,1171,10245,8419,1826,2017-01-01,zipcode,Willingboro
ZCTA5 08048,34,12309,84347,1199,303800,9720,3008,8340,413,2174,2287,2296,1170,4883,4629,254,4629,3262,1367,2017-01-01,zipcode,Lumberton
ZCTA5 08049,34,5678,55250,944,163400,4602,1172,3957,234,1470,1396,592,265,2245,2125,120,2125,1488,637,2017-01-01,zipcode,Magnolia
ZCTA5 08050,34,24841,75981,1562,268500,20663,7567,17825,1210,5937,4792,4121,1765,13237,9535,3702,9535,8103,1432,2017-01-01,zipcode,Manahawkin
ZCTA5 08051,34,10357,79032,1291,178000,8526,2422,7592,372,2288,2434,1627,871,4448,4249,199,4249,3381,868,2017-01-01,zipcode,Mantua
ZCTA5 08052,34,18940,57460,1153,179300,15862,4628,13739,978,5111,4025,2587,1038,8917,8220,697,8220,3926,4294,2017-01-01,zipcode,Maple shade
ZCTA5 08053,34,45489,94395,1421,282900,37145,10776,32686,1388,7259,8758,10029,5252,18859,17357,1502,17357,13229,4128,2017-01-01,zipcode,Marlton
ZCTA5 08054,34,41795,92826,1482,257000,34213,10834,29921,1434,5833,7350,8956,6348,18386,17257,1129,17257,13700,3557,2017-01-01,zipcode,Mount laurel
ZCTA5 08055,34,27454,112267,1370,343000,21934,7010,19234,448,3488,4466,6615,4217,10453,9994,459,9994,8707,1287,2017-01-01,zipcode,Medford
ZCTA5 08056,34,4831,158359,950,368800,3430,1122,3012,48,824,518,884,738,1531,1517,14,1517,1465,52,2017-01-01,zipcode,Mickleton
ZCTA5 08057,34,20893,132713,1179,489700,16565,5789,14217,488,2378,2685,4870,3796,7850,7295,555,7295,6183,1112,2017-01-01,zipcode,Moorestown
ZCTA5 08059,34,5676,73211,980,164000,4689,1276,3949,314,1694,1101,589,251,2339,2123,216,2123,1674,449,2017-01-01,zipcode,Mount ephraim
ZCTA5 08060,34,24349,79475,1167,229700,19519,6202,17065,1254,4817,5135,3873,1986,9491,8693,798,8693,6511,2182,2017-01-01,zipcode,Mount holly
ZCTA5 08061,34,2957,144258,2299,279200,2064,367,1885,17,388,487,719,274,1023,891,132,891,785,106,2017-01-01,zipcode,Mount royal
ZCTA5 08062,34,16272,125926,1219,342900,12506,3524,10515,354,2090,2992,2968,2111,5622,5392,230,5392,4798,594,2017-01-01,zipcode,Mullica hill
ZCTA5 08063,34,3068,62545,1025,151900,2408,790,2128,240,1023,590,192,83,1177,1093,84,1093,904,189,2017-01-01,zipcode,National park
ZCTA5 08064,34,156,-666666666,-666666666,-666666666,156,156,156,34,80,28,1,13,0,0,0,0,0,0,2017-01-01,zipcode,New lisbon
ZCTA5 08065,34,7296,68307,1288,173300,6127,1775,5331,333,1744,1753,1042,459,3372,2987,385,2987,2092,895,2017-01-01,zipcode,Palmyra
ZCTA5 08066,34,8700,49303,898,118700,7033,2572,5928,632,2420,1668,982,226,4011,3595,416,3595,2087,1508,2017-01-01,zipcode,Paulsboro
ZCTA5 08067,34,1610,78239,1213,219900,1287,399,1131,159,396,296,210,70,678,603,75,603,522,81,2017-01-01,zipcode,Pedricktown
ZCTA5 08068,34,7166,58574,975,192200,5949,2079,4928,606,1904,1451,645,322,2885,2732,153,2732,1700,1032,2017-01-01,zipcode,Pemberton
ZCTA5 08069,34,12608,49176,1006,151800,10127,3763,8453,1740,3071,2607,679,356,5367,4649,718,4649,2535,2114,2017-01-01,zipcode,Penns grove
ZCTA5 08070,34,12458,62417,898,154000,10153,3922,9024,955,3696,2748,1092,533,5817,5005,812,5005,3721,1284,2017-01-01,zipcode,Pennsville
ZCTA5 08071,34,9415,74492,1145,186200,7744,2686,6499,395,1793,2235,1366,710,3809,3528,281,3528,2706,822,2017-01-01,zipcode,Pitman
ZCTA5 08072,34,327,66346,-666666666,209700,283,136,255,0,122,80,49,4,126,126,0,126,126,0,2017-01-01,zipcode,Quinton
ZCTA5 08073,34,248,193583,-666666666,269600,192,66,172,0,60,69,15,28,73,73,0,73,73,0,2017-01-01,zipcode,Rancocas
ZCTA5 08074,34,17,-666666666,-666666666,-666666666,17,0,12,6,0,0,0,6,0,0,0,0,0,0,2017-01-01,zipcode,Richwood
ZCTA5 08075,34,28894,79486,1196,224400,23489,6578,20164,1510,6886,5214,4787,1767,11602,10536,1066,10536,7765,2771,2017-01-01,zipcode,Riverside
ZCTA5 08077,34,19258,97602,1468,269000,15893,5107,13580,593,3607,3673,3820,1887,7181,6661,520,6661,5863,798,2017-01-01,zipcode,Riverton
ZCTA5 08078,34,8360,61210,895,168000,6743,2158,5821,730,2028,1601,1048,414,3326,3173,153,3173,2148,1025,2017-01-01,zipcode,Runnemede
ZCTA5 08079,34,10353,42357,918,178700,7967,3461,6857,1017,3202,1713,661,264,4969,4049,920,4049,2356,1693,2017-01-01,zipcode,Salem
ZCTA5 08080,34,37112,97452,1375,257700,30236,9367,25667,1165,7700,7294,6502,3006,13476,12930,546,12930,11499,1431,2017-01-01,zipcode,Sewell
ZCTA5 08081,34,49421,83694,1182,200100,38468,10396,32422,2328,10229,10336,6347,3182,18316,16813,1503,16813,13602,3211,2017-01-01,zipcode,Sicklerville
ZCTA5 08083,34,9684,69783,959,184500,8265,2318,7092,486,2594,2098,1327,587,3953,3675,278,3675,2731,944,2017-01-01,zipcode,Somerdale
ZCTA5 08084,34,7003,72652,945,181600,5771,1774,4813,295,1779,1320,999,420,2847,2568,279,2568,1977,591,2017-01-01,zipcode,Stratford
ZCTA5 08085,34,20424,111318,1560,282200,15268,4229,13195,822,3135,3213,3710,2315,7197,6711,486,6711,5697,1014,2017-01-01,zipcode,Swedesboro
ZCTA5 08086,34,7947,78609,1289,226400,6690,2229,5788,354,1990,1659,1300,485,3513,3189,324,3189,2396,793,2017-01-01,zipcode,Thorofare
ZCTA5 08087,34,24764,63832,1305,223500,20422,8529,18137,1553,6309,5739,3184,1352,13209,10268,2941,10268,8514,1754,2017-01-01,zipcode,Tuckerton
ZCTA5 08088,34,24153,77303,1244,254500,19775,7666,17546,1181,6515,4660,3304,1886,9782,9327,455,9327,8694,633,2017-01-01,zipcode,Vincentown
ZCTA5 08089,34,4448,63027,1077,192500,3808,1547,3225,383,1327,993,341,181,1715,1601,114,1601,1264,337,2017-01-01,zipcode,Waterford works
ZCTA5 08090,34,8200,87019,1162,186600,6602,2107,5765,336,2352,1532,1103,442,3004,2867,137,2867,2556,311,2017-01-01,zipcode,Wenonah
ZCTA5 08091,34,5453,59122,898,177900,4556,1589,3996,595,1522,1034,682,163,2209,2058,151,2058,1367,691,2017-01-01,zipcode,West berlin
ZCTA5 08092,34,3557,81406,1641,302400,2932,1036,2504,235,920,638,428,283,1557,1324,233,1324,1116,208,2017-01-01,zipcode,West creek
ZCTA5 08093,34,9322,54460,941,159100,7660,2405,6301,587,3032,1672,693,317,3987,3703,284,3703,2207,1496,2017-01-01,zipcode,Westville
ZCTA5 08094,34,40233,73848,1049,191200,31958,10575,27667,2776,10617,7941,4208,2125,15963,14815,1148,14815,12462,2353,2017-01-01,zipcode,Williamstown
ZCTA5 08095,34,116,-666666666,-666666666,-666666666,116,41,96,26,55,15,0,0,76,41,35,41,41,0,2017-01-01,zipcode,Winslow
ZCTA5 08096,34,35641,68785,1162,189800,28875,10024,25129,2064,9102,6931,4847,2185,14770,13696,1074,13696,9688,4008,2017-01-01,zipcode,Woodbury
ZCTA5 08097,34,3204,79281,1131,202800,2554,842,2321,182,857,775,356,151,1171,1141,30,1141,992,149,2017-01-01,zipcode,Woodbury heights
ZCTA5 08098,34,9341,85218,1014,252700,7618,2795,6507,403,2251,1599,1561,693,3643,3301,342,3301,2443,858,2017-01-01,zipcode,Woodstown
ZCTA5 08102,34,7623,20529,708,86000,5660,2750,4322,1915,1273,875,252,7,2978,2497,481,2497,506,1991,2017-01-01,zipcode,Camden
ZCTA5 08103,34,14432,22500,938,80300,10754,5916,8806,2448,3564,1854,616,324,6195,4772,1423,4772,2037,2735,2017-01-01,zipcode,Camden
ZCTA5 08104,34,23269,22289,858,70600,15993,6726,13029,3920,4755,3604,500,250,10804,8933,1871,8933,3078,5855,2017-01-01,zipcode,Camden
ZCTA5 08105,34,28469,34750,949,91200,20354,7404,16339,5315,6130,3347,1148,399,10137,8526,1611,8526,3944,4582,2017-01-01,zipcode,Camden
ZCTA5 08106,34,9710,74866,894,206400,8086,2290,6971,374,2299,2120,1656,522,4171,3987,184,3987,2612,1375,2017-01-01,zipcode,Audubon
ZCTA5 08107,34,13055,54736,1007,184400,10572,3074,9172,795,2928,2768,1797,884,6065,5300,765,5300,2875,2425,2017-01-01,zipcode,Oaklyn
ZCTA5 08108,34,18378,88937,1258,265900,15151,4234,13630,588,3085,3368,4006,2583,8137,7411,726,7411,4921,2490,2017-01-01,zipcode,Collingswood
ZCTA5 08109,34,22916,68567,1013,174900,18302,5925,15993,2178,5222,4582,2753,1258,9132,8344,788,8344,6112,2232,2017-01-01,zipcode,Merchantville
ZCTA5 08110,34,18397,65648,1032,136400,14732,5237,12211,2256,4770,3323,1360,502,6323,5689,634,5689,4453,1236,2017-01-01,zipcode,Pennsauken
ZCTA5 08201,34,10091,58125,1318,195400,8454,2871,7236,831,2540,1750,1309,806,4513,3971,542,3971,2676,1295,2017-01-01,zipcode,Absecon
ZCTA5 08202,34,1525,87273,1219,1002200,1433,801,1386,24,294,283,424,361,5624,800,4824,800,730,70,2017-01-01,zipcode,Avalon
ZCTA5 08203,34,9164,65724,1264,348900,8194,3560,7616,615,2266,2124,1719,892,9671,4355,5316,4355,3191,1164,2017-01-01,zipcode,Brigantine
ZCTA5 08204,34,18824,67186,1033,293500,16161,6343,13674,999,4390,4237,2606,1442,13596,7642,5954,7642,6072,1570,2017-01-01,zipcode,Cape may
ZCTA5 08205,34,28275,63194,1180,203400,23259,7470,19495,1988,5785,6022,3872,1828,11433,10199,1234,10199,7869,2330,2017-01-01,zipcode,Absecon
ZCTA5 08210,34,16648,70009,1343,264800,13713,5371,12105,1354,3976,3131,2570,1074,8063,6191,1872,6191,5176,1015,2017-01-01,zipcode,Cape may court house
ZCTA5 08212,34,204,46964,1438,709200,202,162,182,2,38,28,58,56,623,113,510,113,105,8,2017-01-01,zipcode,Cape may point
ZCTA5 08215,34,13674,63724,1118,201200,11031,3667,9548,1380,3666,2478,1350,674,5789,5020,769,5020,3609,1411,2017-01-01,zipcode,Egg harbor city
ZCTA5 08217,34,24,-666666666,-666666666,-666666666,24,19,24,9,10,5,0,0,0,0,0,0,0,0,2017-01-01,zipcode,Elwood
ZCTA5 08221,34,6959,91861,1544,285300,5621,1962,5008,223,1227,1228,1336,994,2751,2569,182,2569,2165,404,2017-01-01,zipcode,Linwood
ZCTA5 08223,34,4057,73696,1362,275100,3436,1185,2977,86,886,810,815,380,2529,1682,847,1682,1517,165,2017-01-01,zipcode,Marmora
ZCTA5 08224,34,546,61974,917,246100,451,152,400,69,208,60,41,22,225,192,33,192,155,37,2017-01-01,zipcode,New gretna
ZCTA5 08225,34,8480,73586,1645,224300,6807,2338,5816,568,1786,1467,1282,713,3141,2903,238,2903,2594,309,2017-01-01,zipcode,Northfield
ZCTA5 08226,34,11328,72715,1135,567700,9436,4216,8584,500,1934,1974,2679,1497,19807,5234,14573,5234,3582,1652,2017-01-01,zipcode,Ocean city
ZCTA5 08230,34,5458,81698,1111,307800,4376,1586,3723,84,1155,862,1173,449,2511,2040,471,2040,1767,273,2017-01-01,zipcode,Ocean view
ZCTA5 08232,34,19507,40196,1114,149600,15242,5366,12817,3251,4686,3242,1316,322,7159,6299,860,6299,3664,2635,2017-01-01,zipcode,Pleasantville
ZCTA5 08234,34,42628,78324,980,219000,33141,9621,28676,3313,8545,7840,6401,2577,15441,13985,1456,13985,12250,1735,2017-01-01,zipcode,Egg harbor township
ZCTA5 08240,34,2282,-666666666,-666666666,-666666666,2282,1094,32,0,15,2,15,0,0,0,0,0,0,0,2017-01-01,zipcode,Pomona
ZCTA5 08241,34,1043,102375,1417,288600,899,304,798,69,177,243,186,123,403,379,24,379,360,19,2017-01-01,zipcode,Port republic
ZCTA5 08242,34,3004,53496,1053,246800,2488,974,2043,301,783,665,171,123,1716,1281,435,1281,984,297,2017-01-01,zipcode,Rio grande
ZCTA5 08243,34,1971,72153,1211,661700,1835,1033,1706,75,474,463,425,269,6917,1009,5908,1009,895,114,2017-01-01,zipcode,Sea isle city
ZCTA5 08244,34,10811,52767,1016,218200,8763,2790,7441,817,2634,2147,1332,511,5434,4470,964,4470,2444,2026,2017-01-01,zipcode,Somers point
ZCTA5 08246,34,83,-666666666,-666666666,-666666666,83,83,83,0,83,0,0,0,171,51,120,51,51,0,2017-01-01,zipcode,South seaville
ZCTA5 08247,34,1037,101484,1329,1184100,949,518,852,24,135,162,287,244,3287,485,2802,485,439,46,2017-01-01,zipcode,Stone harbor
ZCTA5 08248,34,257,222031,-666666666,-666666666,233,93,197,0,89,0,27,81,427,103,324,103,103,0,2017-01-01,zipcode,Strathmere
ZCTA5 08251,34,9423,49184,1267,177300,8079,2956,7124,1033,3265,1670,844,312,6668,4273,2395,4273,3278,995,2017-01-01,zipcode,Villas
ZCTA5 08260,34,12888,45471,905,332400,11204,5330,10037,1031,3708,2890,1566,842,23857,6250,17607,6250,4152,2098,2017-01-01,zipcode,Wildwood
ZCTA5 08270,34,8541,63471,1067,257100,6856,2512,5765,962,2119,1462,872,350,3498,2952,546,2952,2250,702,2017-01-01,zipcode,Woodbine
ZCTA5 08302,34,45661,46862,1056,161300,34774,15841,29468,7506,11710,6628,2501,1123,15134,13756,1378,13756,8103,5653,2017-01-01,zipcode,Bridgeton
ZCTA5 08310,34,1351,61458,-666666666,165600,1175,633,1053,102,645,146,150,10,662,573,89,573,475,98,2017-01-01,zipcode,Buena
ZCTA5 08311,34,2226,69444,1295,163400,1749,575,1426,358,577,360,90,41,772,648,124,648,473,175,2017-01-01,zipcode,Cedarville
ZCTA5 08312,34,8095,63698,1118,189600,6475,2300,5372,741,2094,1078,968,491,3140,2901,239,2901,2168,733,2017-01-01,zipcode,Clayton
ZCTA5 08314,34,2817,72083,-666666666,146300,2765,2531,2642,813,1277,429,101,22,131,108,23,108,95,13,2017-01-01,zipcode,Delmont
ZCTA5 08316,34,257,44519,-666666666,142900,181,71,147,42,51,42,12,0,101,79,22,79,66,13,2017-01-01,zipcode,Dorchester
ZCTA5 08317,34,1509,79363,-666666666,219900,1166,418,965,111,354,328,105,67,474,456,18,456,407,49,2017-01-01,zipcode,Dorothy
ZCTA5 08318,34,12330,79692,998,218900,10204,3554,8834,1044,3030,2400,1670,690,5017,4534,483,4534,4031,503,2017-01-01,zipcode,Elmer
ZCTA5 08319,34,1179,95662,-666666666,222700,986,241,836,52,279,260,159,86,518,415,103,415,408,7,2017-01-01,zipcode,Estell manor
ZCTA5 08320,34,1164,-666666666,-666666666,-666666666,1164,1164,1048,105,626,293,24,0,0,0,0,0,0,0,2017-01-01,zipcode,Fairton
ZCTA5 08321,34,200,24773,955,163100,195,145,186,57,77,44,8,0,315,130,185,130,80,50,2017-01-01,zipcode,Fortescue
ZCTA5 08322,34,10938,83596,1160,208200,8557,2660,7706,815,3169,2010,1196,516,3860,3633,227,3633,3320,313,2017-01-01,zipcode,Franklinville
ZCTA5 08323,34,893,71250,1385,194600,701,270,597,36,164,199,134,64,364,316,48,316,268,48,2017-01-01,zipcode,Greenwich
ZCTA5 08324,34,188,88571,-666666666,228800,183,74,151,27,91,15,18,0,123,76,47,76,57,19,2017-01-01,zipcode,Heislerville
ZCTA5 08326,34,1531,67958,1214,176100,1196,428,1073,83,394,304,234,58,612,541,71,541,432,109,2017-01-01,zipcode,Landisville
ZCTA5 08327,34,2954,89167,-666666666,159800,2943,2840,2840,814,1278,656,68,24,130,84,46,84,84,0,2017-01-01,zipcode,Leesburg
ZCTA5 08328,34,1201,65288,1317,168300,1006,392,875,123,402,219,109,22,443,443,0,443,412,31,2017-01-01,zipcode,Malaga
ZCTA5 08329,34,108,93098,-666666666,193500,94,21,94,0,20,29,33,12,123,55,68,55,31,24,2017-01-01,zipcode,Mauricetown
ZCTA5 08330,34,28066,64266,1404,195300,22778,7031,19487,1795,6614,5757,3608,1713,11501,10407,1094,10407,7761,2646,2017-01-01,zipcode,Mays landing
ZCTA5 08332,34,36305,50220,986,152700,27936,10499,23989,3858,9922,6559,2432,1218,15317,13529,1788,13529,8697,4832,2017-01-01,zipcode,Millville
ZCTA5 08340,34,1268,97583,-666666666,274400,938,222,724,43,384,149,114,34,377,341,36,341,294,47,2017-01-01,zipcode,Milmay
ZCTA5 08341,34,2220,33470,789,173200,1839,630,1595,546,406,486,92,65,1017,988,29,988,394,594,2017-01-01,zipcode,Minotola
ZCTA5 08343,34,5077,105329,1442,270200,4184,1305,3500,254,1225,1035,585,401,1778,1659,119,1659,1522,137,2017-01-01,zipcode,Monroeville
ZCTA5 08344,34,5074,68405,1176,173300,4274,1482,3746,449,1369,1050,578,300,2162,1894,268,1894,1576,318,2017-01-01,zipcode,Newfield
ZCTA5 08345,34,742,56339,909,145100,621,284,583,104,250,147,55,27,439,315,124,315,255,60,2017-01-01,zipcode,Newport
ZCTA5 08346,34,640,37074,-666666666,121900,497,75,368,46,124,175,23,0,247,193,54,193,167,26,2017-01-01,zipcode,Newtonville
ZCTA5 08348,34,131,56838,-666666666,145800,116,61,116,41,31,37,0,7,79,67,12,67,46,21,2017-01-01,zipcode,Port elizabeth
ZCTA5 08349,34,2202,34821,1044,153500,1803,829,1488,293,717,358,105,15,918,851,67,851,704,147,2017-01-01,zipcode,Port norris
ZCTA5 08350,34,1327,58077,-666666666,228300,902,228,608,129,123,141,128,87,460,378,82,378,319,59,2017-01-01,zipcode,Richland
ZCTA5 08352,34,712,68500,-666666666,124000,593,210,461,96,194,115,34,22,255,224,31,224,188,36,2017-01-01,zipcode,Rosenhayn
ZCTA5 08353,34,450,54375,817,158500,388,136,338,55,154,90,22,17,198,175,23,175,127,48,2017-01-01,zipcode,Shiloh
ZCTA5 08360,34,42689,47098,983,156300,33303,12468,28070,7248,10511,6644,2502,1165,16174,14856,1318,14856,8544,6312,2017-01-01,zipcode,Vineland
ZCTA5 08361,34,18590,76237,939,198100,15439,6144,13310,1842,4099,3510,2781,1078,7019,6508,511,6508,5421,1087,2017-01-01,zipcode,Vineland
ZCTA5 08401,34,39075,26006,858,168800,30108,12277,25303,6651,8586,5939,2977,1150,20070,15404,4666,15404,4057,11347,2017-01-01,zipcode,Atlantic city
ZCTA5 08402,34,6200,69896,1166,482100,5699,2548,5308,242,1170,1298,1477,1121,7337,3277,4060,3277,2626,651,2017-01-01,zipcode,Margate city
ZCTA5 08403,34,1088,118393,1861,770800,1002,524,946,37,215,246,287,161,1743,528,1215,528,454,74,2017-01-01,zipcode,Longport
ZCTA5 08406,34,10429,52799,1129,290100,8909,3538,7572,717,2769,1873,1314,899,7607,4403,3204,4403,2714,1689,2017-01-01,zipcode,Ventnor city
ZCTA5 08501,34,6165,116895,1145,391100,5125,1714,4298,129,906,966,1229,1068,2425,2292,133,2292,2108,184,2017-01-01,zipcode,Allentown
ZCTA5 08502,34,11688,182837,2065,647800,8880,2399,7333,127,618,996,2278,3314,3887,3635,252,3635,2830,805,2017-01-01,zipcode,Belle mead
ZCTA5 08505,34,17911,88865,1190,266700,14606,4508,12514,571,3214,3524,3405,1800,7524,6900,624,6900,5133,1767,2017-01-01,zipcode,Bordentown
ZCTA5 08510,34,5981,150050,-666666666,554300,5025,1780,3803,234,1080,797,1206,486,1954,1775,179,1775,1720,55,2017-01-01,zipcode,Millstone township
ZCTA5 08511,34,810,79583,874,233000,694,185,581,30,219,161,117,54,329,319,10,319,259,60,2017-01-01,zipcode,Cookstown
ZCTA5 08512,34,10813,83958,1220,470400,8673,3334,7547,769,1304,1272,2151,2051,4209,3934,275,3934,2315,1619,2017-01-01,zipcode,Cranbury
ZCTA5 08514,34,5392,90104,1173,366300,4167,1428,3754,257,1193,1056,749,499,1967,1883,84,1883,1598,285,2017-01-01,zipcode,Cream ridge
ZCTA5 08515,34,6468,142197,1519,431800,4981,1845,4071,256,990,989,1227,609,1887,1796,91,1796,1646,150,2017-01-01,zipcode,Chesterfield
ZCTA5 08518,34,5509,61500,1018,204200,4531,1495,3902,395,1292,1221,601,393,2475,2274,201,2274,1650,624,2017-01-01,zipcode,Florence
ZCTA5 08520,34,27662,87401,1323,291600,21752,6485,18989,2058,3646,3737,5731,3817,10407,9534,873,9534,6611,2923,2017-01-01,zipcode,Hightstown
ZCTA5 08525,34,4905,126141,1590,440000,4063,1108,3648,84,651,710,1114,1089,2041,1884,157,1884,1534,350,2017-01-01,zipcode,Hopewell
ZCTA5 08527,34,56139,87995,1350,340400,45222,15394,39125,2405,12205,12519,8329,3667,21093,20114,979,20114,17052,3062,2017-01-01,zipcode,Jackson
ZCTA5 08528,34,128,-666666666,-666666666,266100,114,46,100,0,0,15,10,75,66,66,0,66,56,10,2017-01-01,zipcode,Kingston
ZCTA5 08530,34,7662,94740,1244,396600,6544,2470,5780,518,1229,1192,1701,1140,3397,3140,257,3140,2192,948,2017-01-01,zipcode,Lambertville
ZCTA5 08533,34,6371,108185,1253,331700,5121,1211,4343,345,1797,1159,718,324,2186,2186,0,2186,1853,333,2017-01-01,zipcode,New egypt
ZCTA5 08534,34,12949,126108,1390,469400,10317,3382,8894,289,861,1265,3056,3423,5150,4885,265,4885,4414,471,2017-01-01,zipcode,Pennington
ZCTA5 08535,34,4590,174205,1307,602600,3717,1125,3184,50,430,848,1081,775,1610,1560,50,1560,1507,53,2017-01-01,zipcode,Millstone township
ZCTA5 08536,34,20239,98883,1458,462500,15690,4655,14052,485,1489,1446,5321,5311,8976,7955,1021,7955,3450,4505,2017-01-01,zipcode,Plainsboro
ZCTA5 08540,34,49153,135975,1649,623800,39416,14267,32062,935,2273,3388,9389,16077,18864,17643,1221,17643,11901,5742,2017-01-01,zipcode,Princeton
ZCTA5 08542,34,5507,72977,1567,575000,5029,1759,3096,129,640,349,770,1208,1891,1697,194,1697,469,1228,2017-01-01,zipcode,Princeton
ZCTA5 08550,34,19486,200049,1978,624000,15475,5179,13507,299,923,1146,4648,6491,6900,6557,343,6557,5598,959,2017-01-01,zipcode,Princeton junction
ZCTA5 08551,34,5318,136765,1509,459600,4378,1382,3599,189,868,675,1128,739,1912,1800,112,1800,1680,120,2017-01-01,zipcode,Ringoes
ZCTA5 08553,34,622,112917,1938,484400,485,168,436,22,42,68,154,150,271,230,41,230,186,44,2017-01-01,zipcode,Rocky hill
ZCTA5 08554,34,3756,81273,1286,170300,2991,778,2713,173,992,857,550,141,1560,1426,134,1426,1204,222,2017-01-01,zipcode,Roebling
ZCTA5 08555,34,805,100556,-666666666,281700,649,212,581,22,138,149,161,111,292,278,14,278,244,34,2017-01-01,zipcode,Roosevelt
ZCTA5 08558,34,7584,201964,1587,686100,5751,2300,4981,35,545,520,1832,2049,2693,2579,114,2579,2225,354,2017-01-01,zipcode,Skillman
ZCTA5 08559,34,5304,124088,1350,453800,4662,1568,3981,210,882,989,1159,741,2257,2053,204,2053,1770,283,2017-01-01,zipcode,Stockton
ZCTA5 08560,34,3840,109973,1787,377400,3292,1148,2878,251,432,522,859,814,1499,1407,92,1407,1286,121,2017-01-01,zipcode,Titusville
ZCTA5 08561,34,220,122697,-666666666,-666666666,148,41,148,37,11,8,27,65,65,65,0,65,65,0,2017-01-01,zipcode,Windsor
ZCTA5 08562,34,4424,64464,910,252000,3471,911,2960,214,977,926,587,256,1910,1714,196,1714,1029,685,2017-01-01,zipcode,Wrightstown
ZCTA5 08608,34,946,14740,814,-666666666,803,354,760,110,320,295,22,13,618,493,125,493,11,482,2017-01-01,zipcode,Trenton
ZCTA5 08609,34,13370,31881,1048,84600,10752,4099,8444,2683,3208,1847,555,151,5584,4260,1324,4260,960,3300,2017-01-01,zipcode,Trenton
ZCTA5 08610,34,30469,60620,1099,190600,24692,7818,20970,2918,7833,6197,2686,1336,12204,11149,1055,11149,7445,3704,2017-01-01,zipcode,Trenton
ZCTA5 08611,34,26625,37248,1043,90200,20525,7576,16861,6359,5172,3380,1322,628,9835,7971,1864,7971,2625,5346,2017-01-01,zipcode,Trenton
ZCTA5 08618,34,40655,41920,941,169600,32249,14160,23532,3811,8364,6609,2888,1860,16155,12907,3248,12907,5864,7043,2017-01-01,zipcode,Trenton
ZCTA5 08619,34,21593,74056,1219,249900,18114,5870,15719,1824,4203,4763,3196,1733,9237,8492,745,8492,5918,2574,2017-01-01,zipcode,Trenton
ZCTA5 08620,34,12481,92629,1012,266200,10590,4166,8972,710,3084,2610,1816,752,4523,4174,349,4174,3361,813,2017-01-01,zipcode,Trenton
ZCTA5 08628,34,9205,86315,1265,261800,7888,3025,7082,460,1706,1742,2111,1063,4234,3929,305,3929,2558,1371,2017-01-01,zipcode,Trenton
ZCTA5 08629,34,14051,61058,1209,118000,11063,3168,9245,1424,3981,2509,1064,267,4495,3969,526,3969,2743,1226,2017-01-01,zipcode,Trenton
ZCTA5 08638,34,22484,50754,1088,184400,18401,7208,15575,2916,5247,3824,2313,1275,9338,7998,1340,7998,4774,3224,2017-01-01,zipcode,Trenton
ZCTA5 08640,34,8032,58750,2034,-666666666,6911,5101,5942,657,2078,2226,690,291,999,891,108,891,5,886,2017-01-01,zipcode,Joint base mdl
ZCTA5 08641,34,4851,57500,1936,-666666666,3120,594,2039,57,293,1083,440,166,1364,1238,126,1238,3,1235,2017-01-01,zipcode,Joint base mdl
ZCTA5 08648,34,32231,95537,1542,287500,26845,9006,21873,1550,4231,4618,5191,6283,12493,11801,692,11801,7939,3862,2017-01-01,zipcode,Lawrence township
ZCTA5 08690,34,18967,99837,1382,287800,16035,4914,13699,792,3548,3378,3826,2155,7041,6856,185,6856,5990,866,2017-01-01,zipcode,Trenton
ZCTA5 08691,34,16002,119659,1698,390800,13132,4384,11285,420,2306,2333,3797,2429,6059,5867,192,5867,4996,871,2017-01-01,zipcode,Trenton
ZCTA5 08701,34,99467,45321,1397,313300,55427,24383,44103,7087,12983,11616,7355,5062,26112,23776,2336,23776,11514,12262,2017-01-01,zipcode,Lakewood
ZCTA5 08720,34,988,122826,-666666666,495500,780,386,604,32,181,107,189,95,248,248,0,248,233,15,2017-01-01,zipcode,Allenwood
ZCTA5 08721,34,21127,78496,1433,273400,16705,5939,14552,1091,5835,4216,2426,984,8464,7601,863,7601,6301,1300,2017-01-01,zipcode,Bayville
ZCTA5 08722,34,11193,72815,1581,233300,8781,2539,7209,527,2751,2370,1161,400,3925,3715,210,3715,3113,602,2017-01-01,zipcode,Beachwood
ZCTA5 08723,34,32520,70174,1282,275400,26905,9410,23048,2031,8196,7352,3916,1553,14655,12885,1770,12885,10126,2759,2017-01-01,zipcode,Brick
ZCTA5 08724,34,41401,75988,1380,279200,34612,12484,30268,2067,9988,8835,6670,2708,18285,16539,1746,16539,14279,2260,2017-01-01,zipcode,Brick
ZCTA5 08730,34,4738,133493,2150,633700,3826,1333,3261,93,429,631,1395,713,2118,1786,332,1786,1601,185,2017-01-01,zipcode,Brielle
ZCTA5 08731,34,20180,75333,1468,263700,16430,5772,14055,1057,4826,4339,2404,1429,9179,7722,1457,7722,6880,842,2017-01-01,zipcode,Forked river
ZCTA5 08732,34,1438,83929,1571,401500,1228,528,1089,22,258,273,279,257,749,622,127,622,489,133,2017-01-01,zipcode,Island heights
ZCTA5 08733,34,2725,62262,1776,186800,2051,699,1744,202,697,597,153,95,943,876,67,876,591,285,2017-01-01,zipcode,Lakehurst
ZCTA5 08734,34,8264,83086,-666666666,319700,6916,2666,5993,268,2170,1811,1125,619,3414,3117,297,3117,2807,310,2017-01-01,zipcode,Lanoka harbor
ZCTA5 08735,34,3582,68224,1091,620100,3343,1951,3164,154,853,740,796,621,6913,1812,5101,1812,1644,168,2017-01-01,zipcode,Lavallette
ZCTA5 08736,34,12848,112836,1364,585600,10741,3999,9249,221,1899,1860,2999,2270,6098,4731,1367,4731,3909,822,2017-01-01,zipcode,Manasquan
ZCTA5 08738,34,1028,84167,1406,1066200,998,613,972,29,144,188,379,232,1701,536,1165,536,510,26,2017-01-01,zipcode,Mantoloking
ZCTA5 08740,34,1911,62813,1661,250800,1607,627,1331,96,520,379,234,102,1192,764,428,764,544,220,2017-01-01,zipcode,Ocean gate
ZCTA5 08741,34,2651,93750,989,306200,2187,767,1906,63,589,531,421,302,1134,957,177,957,880,77,2017-01-01,zipcode,Pine beach
ZCTA5 08742,34,24410,92579,1484,401400,20023,6224,17349,728,4404,4525,4813,2879,12878,9882,2996,9882,7771,2111,2017-01-01,zipcode,Point pleasant beach
ZCTA5 08750,34,3272,117950,1194,869800,2857,1288,2531,28,390,514,950,649,1975,1407,568,1407,1277,130,2017-01-01,zipcode,Sea girt
ZCTA5 08751,34,4230,56667,1246,447000,3620,1315,2988,267,912,873,659,277,5306,1770,3536,1770,864,906,2017-01-01,zipcode,Seaside heights
ZCTA5 08752,34,2200,62464,1252,602300,1978,1008,1828,10,553,421,542,302,4161,1191,2970,1191,957,234,2017-01-01,zipcode,Seaside park
ZCTA5 08753,34,62844,77119,1422,283100,50785,16992,44144,2878,14878,12356,9483,4549,26281,23297,2984,23297,18342,4955,2017-01-01,zipcode,Toms river
ZCTA5 08755,34,26082,72674,1251,277100,21482,9349,19332,2071,6122,5346,3395,2398,10798,10176,622,10176,8564,1612,2017-01-01,zipcode,Toms river
ZCTA5 08757,34,33534,40767,1360,156400,30177,17851,28198,4001,13234,6761,3215,987,18898,16678,2220,16678,14719,1959,2017-01-01,zipcode,Toms river
ZCTA5 08758,34,7651,66692,1593,313800,6749,3566,6330,404,2127,1998,1225,576,3877,3444,433,3444,2986,458,2017-01-01,zipcode,Waretown
ZCTA5 08759,34,32970,38212,1059,114800,31318,21293,29953,3665,12069,7873,4482,1864,21668,19028,2640,19028,16520,2508,2017-01-01,zipcode,Manchester township
ZCTA5 08801,34,8999,120435,1686,393100,7791,4071,5101,281,879,1110,1686,1145,2662,2528,134,2528,2105,423,2017-01-01,zipcode,Annandale
ZCTA5 08802,34,4263,125494,1213,374000,3340,834,2872,80,688,728,833,543,1545,1503,42,1503,1374,129,2017-01-01,zipcode,Asbury
ZCTA5 08804,34,2423,84375,994,293100,1941,610,1710,88,337,582,432,271,1036,983,53,983,920,63,2017-01-01,zipcode,Bloomsbury
ZCTA5 08805,34,12026,68125,1273,283200,9583,2658,8106,1388,2854,1902,1227,735,5117,4179,938,4179,2357,1822,2017-01-01,zipcode,Bound brook
ZCTA5 08807,34,39382,120065,1659,468900,31190,10233,26746,1311,4778,5271,8081,7305,13750,13241,509,13241,10903,2338,2017-01-01,zipcode,Bridgewater
ZCTA5 08808,34,47,-666666666,-666666666,-666666666,47,10,47,4,10,33,0,0,43,43,0,43,22,21,2017-01-01,zipcode,Broadway
ZCTA5 08809,34,5955,91157,1481,336500,4856,1776,3820,271,714,760,1320,755,2084,2007,77,2007,1515,492,2017-01-01,zipcode,Clinton
ZCTA5 08810,34,9182,130203,1806,397500,7113,2141,5971,238,1042,906,2156,1629,3005,2865,140,2865,2356,509,2017-01-01,zipcode,Dayton
ZCTA5 08812,34,14573,96463,1334,343700,11505,3302,9819,802,2360,2334,2767,1556,4826,4611,215,4611,3716,895,2017-01-01,zipcode,Dunellen
ZCTA5 08816,34,47259,106039,1426,383100,38445,12259,33740,1901,6897,7019,10567,7356,16902,16176,726,16176,12948,3228,2017-01-01,zipcode,East brunswick
ZCTA5 08817,34,45039,87688,1513,306600,35834,10780,32312,2404,7223,6967,9291,6427,16337,15726,611,15726,8616,7110,2017-01-01,zipcode,Edison
ZCTA5 08820,34,40080,120911,1465,476900,31962,11874,28971,2516,4241,3394,8854,9966,13590,13041,549,13041,9574,3467,2017-01-01,zipcode,Edison
ZCTA5 08821,34,342,53859,-666666666,350000,295,121,207,0,114,63,20,10,105,105,0,105,94,11,2017-01-01,zipcode,Flagtown
ZCTA5 08822,34,31067,107215,1433,408500,25070,7866,21813,1332,4612,4992,5945,4932,12070,11561,509,11561,9123,2438,2017-01-01,zipcode,Flemington
ZCTA5 08823,34,9258,102851,1850,283600,7483,1906,7046,346,878,1387,2389,2046,3966,3574,392,3574,2412,1162,2017-01-01,zipcode,Franklin park
ZCTA5 08824,34,12562,128623,1211,415100,9870,2991,8730,439,1623,1669,3021,1978,4262,4198,64,4198,3785,413,2017-01-01,zipcode,Kendall park
ZCTA5 08825,34,4415,106858,1182,372300,3705,971,3280,317,748,823,901,491,1788,1655,133,1655,1277,378,2017-01-01,zipcode,Frenchtown
ZCTA5 08826,34,5091,100931,1254,335300,4305,1183,3751,117,1003,856,1095,680,2331,2132,199,2132,1722,410,2017-01-01,zipcode,Glen gardner
ZCTA5 08827,34,4296,102928,1038,367300,3577,1216,3178,122,689,903,995,469,1810,1675,135,1675,1433,242,2017-01-01,zipcode,Hampton
ZCTA5 08828,34,2321,79702,1722,262000,1933,564,1729,117,550,531,332,199,968,869,99,869,678,191,2017-01-01,zipcode,Helmetta
ZCTA5 08829,34,3597,93026,1436,251200,2824,883,2576,120,582,617,734,523,1573,1476,97,1476,1211,265,2017-01-01,zipcode,High bridge
ZCTA5 08830,34,19169,86875,1641,294300,15717,5767,14516,1344,3778,2887,4171,2336,6614,6476,138,6476,4711,1765,2017-01-01,zipcode,Iselin
ZCTA5 08831,34,50344,78920,1290,337900,41810,19972,38700,2801,10457,8423,9688,7331,21558,20704,854,20704,18268,2436,2017-01-01,zipcode,Monroe township
ZCTA5 08832,34,2657,59009,1288,279800,2276,774,1935,442,657,400,254,182,1025,1025,0,1025,211,814,2017-01-01,zipcode,Keasbey
ZCTA5 08833,34,8322,137063,1920,493800,7066,2409,6104,242,1130,1295,2137,1300,3262,3135,127,3135,2791,344,2017-01-01,zipcode,Lebanon
ZCTA5 08835,34,10436,67080,1336,251900,8418,2588,7260,739,3636,1743,897,245,4377,3721,656,3721,2424,1297,2017-01-01,zipcode,Manville
ZCTA5 08836,34,3898,150994,1384,594800,3238,1033,2729,90,427,397,866,949,1367,1327,40,1327,1278,49,2017-01-01,zipcode,Martinsville
ZCTA5 08837,34,17199,80423,1247,318400,13992,4480,12601,1043,2942,2671,3633,2312,6708,6367,341,6367,3386,2981,2017-01-01,zipcode,Edison
ZCTA5 08840,34,16571,115785,1510,382300,12985,3780,11839,655,2080,2456,3556,3092,6204,5991,213,5991,4794,1197,2017-01-01,zipcode,Metuchen
ZCTA5 08844,34,39920,120173,1574,411600,31631,8644,27124,706,5418,5563,9430,6007,14402,13532,870,13532,11601,1931,2017-01-01,zipcode,Hillsborough
ZCTA5 08846,34,13875,73196,1385,293700,10848,3551,9408,821,3043,3166,1582,796,4730,4565,165,4565,3295,1270,2017-01-01,zipcode,Middlesex
ZCTA5 08848,34,8416,97319,1178,337300,6985,2146,6108,261,1913,1445,1589,900,3418,3056,362,3056,2749,307,2017-01-01,zipcode,Milford
ZCTA5 08850,34,8747,102664,1602,344600,7075,2212,6267,463,1637,1768,1639,760,3272,3033,239,3033,2574,459,2017-01-01,zipcode,Milltown
ZCTA5 08852,34,18095,101928,1591,381200,13996,4151,12040,440,1512,2400,4516,3172,6809,6393,416,6393,4153,2240,2017-01-01,zipcode,Monmouth junction
ZCTA5 08853,34,5378,130352,1203,557800,4291,1347,3615,99,812,804,1004,896,1860,1806,54,1806,1424,382,2017-01-01,zipcode,Neshanic station
ZCTA5 08854,34,57695,89617,1474,310300,49122,21840,34350,2698,7002,7288,10223,7139,17157,16126,1031,16126,10762,5364,2017-01-01,zipcode,Piscataway
ZCTA5 08857,34,41227,93650,1181,346300,33659,9437,29993,2090,7807,8586,8131,3379,15665,14910,755,14910,10131,4779,2017-01-01,zipcode,Old bridge
ZCTA5 08858,34,173,-666666666,-666666666,-666666666,173,12,114,0,12,0,0,102,63,63,0,63,63,0,2017-01-01,zipcode,Oldwick
ZCTA5 08859,34,22183,83389,1205,296600,18151,5996,15849,1465,4985,3949,3465,1985,8650,8133,517,8133,5308,2825,2017-01-01,zipcode,Parlin
ZCTA5 08861,34,54453,51389,1243,247400,41472,15490,34072,10098,12031,6838,3838,1267,17563,16566,997,16566,5251,11315,2017-01-01,zipcode,Perth amboy
ZCTA5 08863,34,13197,87357,1310,291500,10476,3283,9398,793,3029,2493,2031,1052,4670,4482,188,4482,3225,1257,2017-01-01,zipcode,Fords
ZCTA5 08865,34,28883,60887,948,188500,23557,8075,20243,2886,7354,5347,3146,1510,13055,11479,1576,11479,7157,4322,2017-01-01,zipcode,Phillipsburg
ZCTA5 08867,34,5158,125694,1467,494800,4012,1231,3461,68,643,751,1245,754,1899,1789,110,1789,1629,160,2017-01-01,zipcode,Pittstown
ZCTA5 08869,34,7758,78974,1645,331200,6388,1844,5433,414,1779,1242,1345,653,3323,2899,424,2899,1743,1156,2017-01-01,zipcode,Raritan
ZCTA5 08872,34,20482,74985,1213,286900,16437,5129,14832,1277,4529,4207,3426,1393,7673,7369,304,7369,4398,2971,2017-01-01,zipcode,Sayreville
ZCTA5 08873,34,54342,90555,1525,328300,44635,15401,39141,2615,9304,8928,10238,8056,21357,19422,1935,19422,13666,5756,2017-01-01,zipcode,Somerset
ZCTA5 08876,34,22195,91324,1353,361500,18099,5219,15476,988,3699,3459,4612,2718,9204,8026,1178,8026,5701,2325,2017-01-01,zipcode,Somerville
ZCTA5 08879,34,23214,68693,1216,277500,19523,6044,17177,1966,5804,4843,3056,1508,9724,9083,641,9083,5214,3869,2017-01-01,zipcode,South amboy
ZCTA5 08880,34,4606,81545,1366,246500,3593,829,3290,302,1357,923,520,188,1752,1421,331,1421,919,502,2017-01-01,zipcode,South bound brook
ZCTA5 08882,34,16270,62179,1245,288700,13099,3973,11016,2273,3823,2308,1689,923,6320,5726,594,5726,3671,2055,2017-01-01,zipcode,South river
ZCTA5 08884,34,8443,75226,934,294300,6851,2647,6364,400,2423,1914,1153,474,3593,3437,156,3437,2743,694,2017-01-01,zipcode,Spotswood
ZCTA5 08886,34,7476,106012,1472,323600,5740,1853,4802,163,859,1363,1521,896,2585,2453,132,2453,1960,493,2017-01-01,zipcode,Stewartsville
ZCTA5 08887,34,1116,83750,1482,187600,965,331,861,39,141,258,272,151,542,542,0,542,430,112,2017-01-01,zipcode,Three bridges
ZCTA5 08889,34,9359,134387,1458,449700,7850,2623,6895,388,1414,1241,2421,1431,3880,3743,137,3743,3432,311,2017-01-01,zipcode,Whitehouse station
ZCTA5 08890,34,0,-666666666,-666666666,-666666666,0,0,0,0,0,0,0,0,0,0,0,0,0,0,2017-01-01,zipcode,
ZCTA5 08901,34,58347,38413,1395,257100,46283,22023,26524,10140,6338,4543,2846,2657,16267,14823,1444,14823,2777,12046,2017-01-01,zipcode,New brunswick
ZCTA5 08902,34,41600,88512,1542,319600,33212,9789,28976,2990,6556,5571,8115,5744,15013,14337,676,14337,8359,5978,2017-01-01,zipcode,North brunswick
ZCTA5 08904,34,14250,75913,1376,360000,11328,3198,9698,311,1298,1454,2850,3785,6044,5634,410,5634,2388,3246,2017-01-01,zipcode,Highland park
ZCTA5 32003,12,29163,90964,1416,242700,23575,8143,19586,587,4092,6474,5974,2459,10870,10362,508,10362,8292,2070,2017-01-01,zipcode,Fleming island
ZCTA5 32008,12,4808,42235,801,74900,4219,1853,3787,743,1638,1201,159,46,2926,2070,856,2070,1678,392,2017-01-01,zipcode,Branford
ZCTA5 32009,12,3647,65469,1084,154900,2968,911,2409,277,1003,819,254,56,1356,1190,166,1190,1030,160,2017-01-01,zipcode,Bryceville
ZCTA5 32011,12,14446,61176,847,157900,11709,4478,9858,1289,4279,3110,845,335,5590,5164,426,5164,4159,1005,2017-01-01,zipcode,Callahan
ZCTA5 32024,12,19479,49825,839,120200,15246,6676,13363,1547,4974,4416,1755,671,7849,6887,962,6887,5683,1204,2017-01-01,zipcode,Lake city
ZCTA5 32025,12,22427,43891,812,109700,18811,10176,14975,2335,5245,5143,1355,897,8922,7540,1382,7540,4719,2821,2017-01-01,zipcode,Lake city
ZCTA5 32026,12,1695,-666666666,-666666666,-666666666,1695,1695,1571,770,549,206,32,14,0,0,0,0,0,0,2017-01-01,zipcode,Raiford
ZCTA5 32033,12,4683,49107,1250,136300,3951,1788,3353,321,1012,1141,530,349,1936,1736,200,1736,1447,289,2017-01-01,zipcode,Elkton
ZCTA5 32034,12,33695,68533,1189,294400,28746,13550,26341,1528,6118,7759,6682,4254,19751,14562,5189,14562,10978,3584,2017-01-01,zipcode,Fernandina beach
ZCTA5 32038,12,9891,41325,841,99700,7901,3781,7116,754,2695,2706,486,475,4661,3900,761,3900,3292,608,2017-01-01,zipcode,Fort white
ZCTA5 32040,12,7553,56886,698,131600,5789,2287,4765,515,2329,1292,505,124,2811,2334,477,2334,1936,398,2017-01-01,zipcode,Glen saint mary
ZCTA5 32043,12,24381,59960,889,168000,19414,7939,17168,2195,5621,5956,2152,1244,9738,8775,963,8775,6722,2053,2017-01-01,zipcode,Green cove springs
ZCTA5 32044,12,2117,48654,869,78200,1639,747,1518,308,459,586,145,20,1154,798,356,798,661,137,2017-01-01,zipcode,Hampton
ZCTA5 32046,12,9070,56940,904,124600,7406,3327,6364,812,2970,2108,305,169,3631,3251,380,3251,2539,712,2017-01-01,zipcode,Hilliard
ZCTA5 32052,12,9452,37222,572,68800,8197,5564,6636,1702,2877,1587,323,147,3380,2646,734,2646,1812,834,2017-01-01,zipcode,Jasper
ZCTA5 32053,12,3256,40133,838,74600,2384,1185,2134,523,740,486,309,76,1574,1185,389,1185,1006,179,2017-01-01,zipcode,Jennings
ZCTA5 32054,12,11723,37348,555,88900,9689,5982,8510,1914,3311,2539,583,163,3974,3500,474,3500,2431,1069,2017-01-01,zipcode,Lake butler
ZCTA5 32055,12,16851,38684,770,105800,13314,6037,11727,1608,4186,3949,1390,594,6907,6106,801,6106,4062,2044,2017-01-01,zipcode,Lake city
ZCTA5 32058,12,4728,36471,661,104800,3841,2509,3317,849,1415,864,129,60,1478,1218,260,1218,988,230,2017-01-01,zipcode,Lawtey
ZCTA5 32059,12,2649,43239,728,81000,2021,858,1752,209,606,816,93,28,1273,975,298,975,824,151,2017-01-01,zipcode,Lee
ZCTA5 32060,12,23702,40276,748,100600,18923,9409,16434,3186,6600,4308,1667,673,9970,8366,1604,8366,6152,2214,2017-01-01,zipcode,Live oak
ZCTA5 32061,12,443,80515,-666666666,189700,364,154,235,88,95,30,22,0,118,101,17,101,81,20,2017-01-01,zipcode,Lulu
ZCTA5 32062,12,2511,48338,429,79300,2251,1153,1836,213,838,452,191,142,1135,863,272,863,731,132,2017-01-01,zipcode,Mc alpin
ZCTA5 32063,12,14081,62878,777,133600,11046,5201,9662,1412,3422,3340,931,557,5238,4478,760,4478,3323,1155,2017-01-01,zipcode,Macclenny
ZCTA5 32064,12,6782,38199,654,82300,5593,2419,4576,1260,1403,1148,578,187,2913,2195,718,2195,1002,1193,2017-01-01,zipcode,Live oak
ZCTA5 32065,12,37734,65891,1223,174600,28220,9076,24179,1643,6926,9031,4343,2236,13255,12429,826,12429,9007,3422,2017-01-01,zipcode,Orange park
ZCTA5 32066,12,7488,41089,603,110100,6117,3791,5250,1499,2008,937,368,438,2405,1748,657,1748,1389,359,2017-01-01,zipcode,Mayo
ZCTA5 32068,12,54614,58479,1126,142500,42672,15245,36414,3956,13295,13351,4111,1701,20350,18501,1849,18501,14604,3897,2017-01-01,zipcode,Middleburg
ZCTA5 32071,12,3172,45823,725,89200,2421,1061,1997,317,856,572,206,46,1562,1121,441,1121,847,274,2017-01-01,zipcode,O brien
ZCTA5 32072,12,296,68500,-666666666,71300,296,49,226,0,127,48,51,0,174,120,54,120,120,0,2017-01-01,zipcode,
ZCTA5 32073,12,40139,56546,990,157600,32524,11761,27549,2101,8415,10688,4516,1829,16406,15042,1364,15042,9556,5486,2017-01-01,zipcode,Orange park
ZCTA5 32079,12,416,32813,1209,95000,416,411,416,50,70,59,131,106,291,220,71,220,25,195,2017-01-01,zipcode,Penney farms
ZCTA5 32080,12,22349,67399,1105,327100,19940,9649,17544,563,3230,5186,4761,3804,15860,9863,5997,9863,6825,3038,2017-01-01,zipcode,Saint augustine
ZCTA5 32081,12,11634,114048,1692,358600,8497,3376,7578,77,943,2188,2622,1748,4218,3798,420,3798,3040,758,2017-01-01,zipcode,Ponte vedra
ZCTA5 32082,12,29726,97814,1298,473300,25127,10567,22516,339,2778,5857,8068,5474,15415,12638,2777,12638,10158,2480,2017-01-01,zipcode,Ponte vedra beach
ZCTA5 32083,12,3561,39226,673,88800,3240,2707,2947,803,1105,857,140,42,586,517,69,517,295,222,2017-01-01,zipcode,Raiford
ZCTA5 32084,12,34187,46263,995,172400,29124,11700,23775,2369,8056,7222,4211,1917,15360,12685,2675,12685,7890,4795,2017-01-01,zipcode,Saint augustine
ZCTA5 32086,12,28244,55530,1088,195600,24468,10807,21422,1627,5271,8383,4124,2017,12756,11329,1427,11329,8492,2837,2017-01-01,zipcode,Saint augustine
ZCTA5 32087,12,5551,45257,742,70700,4329,2737,3581,963,1676,715,202,25,1576,1328,248,1328,1021,307,2017-01-01,zipcode,Sanderson
ZCTA5 32091,12,14829,45058,757,86400,11816,5690,10406,1956,3866,3457,840,287,6746,5586,1160,5586,3675,1911,2017-01-01,zipcode,Starke
ZCTA5 32092,12,33562,88545,1677,263900,24838,9250,23037,1625,4825,6863,6500,3224,12996,11471,1525,11471,9833,1638,2017-01-01,zipcode,Saint augustine
ZCTA5 32094,12,2460,36389,-666666666,82500,1984,1231,1840,350,858,505,125,2,1213,956,257,956,760,196,2017-01-01,zipcode,Wellborn
ZCTA5 32095,12,8543,66316,1222,216800,6804,2802,6049,498,1397,1729,1581,844,3530,3169,361,3169,2368,801,2017-01-01,zipcode,Saint augustine
ZCTA5 32096,12,2303,34153,577,97200,1962,1079,1759,290,715,468,152,134,1407,1120,287,1120,850,270,2017-01-01,zipcode,White springs
ZCTA5 32097,12,17515,65350,1244,173300,13700,5002,11880,1006,4385,3930,1845,714,6808,6263,545,6263,4958,1305,2017-01-01,zipcode,Yulee
ZCTA5 32102,12,2178,31267,693,115900,2007,1166,1792,347,599,544,214,88,1795,1084,711,1084,909,175,2017-01-01,zipcode,Astor
ZCTA5 32110,12,7803,34663,739,113400,6582,3282,5630,988,2670,1393,457,122,3446,2776,670,2776,1913,863,2017-01-01,zipcode,Bunnell
ZCTA5 32112,12,8043,35453,538,80200,6072,3296,5163,1673,1909,1138,309,134,4010,2758,1252,2758,1959,799,2017-01-01,zipcode,Crescent city
ZCTA5 32113,12,5365,34071,782,73700,4711,2312,4022,791,2019,949,166,97,2849,2066,783,2066,1786,280,2017-01-01,zipcode,Citra
ZCTA5 32114,12,32087,24544,822,91900,27070,13273,20751,3247,6720,7190,2496,1098,16131,13381,2750,13381,4252,9129,2017-01-01,zipcode,Daytona beach
ZCTA5 32117,12,24566,32518,859,80700,20452,9294,17871,2609,7298,5612,1594,758,12601,9760,2841,9760,4941,4819,2017-01-01,zipcode,Daytona beach
ZCTA5 32118,12,16853,38851,896,202500,15393,8065,14317,1195,4020,4441,3021,1640,15933,8931,7002,8931,5357,3574,2017-01-01,zipcode,Daytona beach
ZCTA5 32119,12,22470,36822,937,123100,19288,9105,16289,1623,5618,5542,2455,1051,11923,9961,1962,9961,6009,3952,2017-01-01,zipcode,Daytona beach
ZCTA5 32124,12,5832,53537,1725,211100,5011,3210,4250,802,1416,1009,596,427,1632,1451,181,1451,1225,226,2017-01-01,zipcode,Daytona beach
ZCTA5 32127,12,30128,46359,1080,161900,25978,12791,23232,2237,8099,7259,3388,2249,16350,12920,3430,12920,9591,3329,2017-01-01,zipcode,Port orange
ZCTA5 32128,12,19285,71973,1283,230200,16038,7325,14290,1137,3050,4427,3515,2161,8946,7782,1164,7782,6588,1194,2017-01-01,zipcode,Port orange
ZCTA5 32129,12,21574,42638,1104,113800,18701,8455,16266,1534,5815,5833,2248,836,10700,9487,1213,9487,6280,3207,2017-01-01,zipcode,Port orange
ZCTA5 32130,12,5837,49085,957,148200,4626,2179,3984,895,1275,1213,372,229,2511,2017,494,2017,1567,450,2017-01-01,zipcode,De leon springs
ZCTA5 32131,12,4816,38446,785,133100,4027,2202,3720,578,1468,994,378,302,2121,1796,325,1796,1291,505,2017-01-01,zipcode,East palatka
ZCTA5 32132,12,7341,42185,852,115100,6372,3009,5767,515,2282,2234,372,364,3760,3174,586,3174,2420,754,2017-01-01,zipcode,Edgewater
ZCTA5 32133,12,54,-666666666,-666666666,-666666666,54,20,54,0,13,41,0,0,77,33,44,33,33,0,2017-01-01,zipcode,Eastlake weir
ZCTA5 32134,12,7242,34288,689,73200,6064,3682,5423,1123,2276,1493,288,243,5941,2999,2942,2999,2343,656,2017-01-01,zipcode,Fort mc coy
ZCTA5 32136,12,7842,51208,1045,226700,7081,4081,6642,434,1724,2195,1414,875,5456,3583,1873,3583,2975,608,2017-01-01,zipcode,Flagler beach
ZCTA5 32137,12,41496,55761,1158,217000,35723,20089,32096,2241,10018,11062,5460,3315,21637,15979,5658,15979,12662,3317,2017-01-01,zipcode,Palm coast
ZCTA5 32139,12,978,23257,-666666666,60900,875,687,855,294,303,232,26,0,869,505,364,505,472,33,2017-01-01,zipcode,Georgetown
ZCTA5 32140,12,1236,44201,-666666666,67600,1104,553,974,179,352,376,58,9,718,439,279,439,404,35,2017-01-01,zipcode,Florahome
ZCTA5 32141,12,18351,45496,1039,136300,15761,8309,14318,1568,5728,4861,1237,924,8557,7351,1206,7351,5968,1383,2017-01-01,zipcode,Edgewater
ZCTA5 32145,12,5662,38044,771,81300,4407,1989,3821,803,1334,1267,225,192,2203,1855,348,1855,1464,391,2017-01-01,zipcode,Hastings
ZCTA5 32147,12,668,22438,-666666666,21600,439,201,360,63,166,84,47,0,289,197,92,197,137,60,2017-01-01,zipcode,Hollister
ZCTA5 32148,12,10745,29853,705,59600,8063,4615,6998,1750,2833,1863,316,236,5413,4010,1403,4010,2772,1238,2017-01-01,zipcode,Interlachen
ZCTA5 32157,12,191,60667,-666666666,158500,175,131,175,0,113,35,12,15,276,108,168,108,85,23,2017-01-01,zipcode,
ZCTA5 32159,12,30742,44904,967,170700,27902,19035,26330,2117,9427,8068,3837,2881,18678,15174,3504,15174,12433,2741,2017-01-01,zipcode,Lady lake
ZCTA5 32162,12,55439,61313,1422,260300,55000,47534,54796,1622,13986,16932,13169,9087,36933,30398,6535,30398,29237,1161,2017-01-01,zipcode,The villages
ZCTA5 32164,12,45739,49251,1150,173700,37333,17778,32976,2649,11602,12329,4057,2339,18596,16032,2564,16032,11836,4196,2017-01-01,zipcode,Palm coast
ZCTA5 32168,12,25288,49565,957,193300,21628,11322,19635,1986,6259,6614,3093,1683,13051,10958,2093,10958,8338,2620,2017-01-01,zipcode,New smyrna beach
ZCTA5 32169,12,10232,65855,1226,325600,9596,5533,9257,320,1750,3375,2185,1627,11526,5343,6183,5343,4063,1280,2017-01-01,zipcode,New smyrna beach
ZCTA5 32174,12,50041,50261,1006,182000,43451,21923,39404,2595,11613,13849,6733,4614,24489,21393,3096,21393,16495,4898,2017-01-01,zipcode,Ormond beach
ZCTA5 32176,12,14772,49200,1107,201600,13400,7261,12345,824,3442,4216,2169,1694,10577,7005,3572,7005,5340,1665,2017-01-01,zipcode,Ormond beach
ZCTA5 32177,12,26331,32500,676,87100,20823,9742,17780,3303,7704,4370,1592,811,11659,9836,1823,9836,6457,3379,2017-01-01,zipcode,Palatka
ZCTA5 32179,12,8023,29861,677,67300,6683,3625,6028,960,2918,1617,284,249,4803,3149,1654,3149,2311,838,2017-01-01,zipcode,Ocklawaha
ZCTA5 32180,12,3825,44810,706,109900,2799,1279,2351,572,678,753,224,124,1417,1201,216,1201,915,286,2017-01-01,zipcode,Pierson
ZCTA5 32181,12,2145,39135,904,76200,1724,966,1509,314,473,429,197,96,1255,744,511,744,606,138,2017-01-01,zipcode,Pomona park
ZCTA5 32187,12,1654,33629,577,139800,1392,681,1302,286,524,395,57,40,700,628,72,628,461,167,2017-01-01,zipcode,San mateo
ZCTA5 32189,12,5866,32141,891,73700,5068,2884,4585,826,1843,1340,467,109,4016,2798,1218,2798,2488,310,2017-01-01,zipcode,Satsuma
ZCTA5 32190,12,1265,34750,607,174200,1034,425,858,296,347,123,75,17,567,418,149,418,299,119,2017-01-01,zipcode,Seville
ZCTA5 32193,12,811,32581,570,110300,714,466,632,138,296,148,21,29,715,370,345,370,283,87,2017-01-01,zipcode,Welaka
ZCTA5 32195,12,3620,51935,1006,113900,2990,1240,2707,324,1157,953,247,26,1542,1422,120,1422,1160,262,2017-01-01,zipcode,Weirsdale
ZCTA5 32202,12,6240,28025,562,117300,5833,4425,4859,1178,1369,1326,603,383,2138,1747,391,1747,203,1544,2017-01-01,zipcode,Jacksonville
ZCTA5 32204,12,7573,40417,898,158600,6582,2392,5736,605,1369,1469,1391,902,4493,3861,632,3861,1083,2778,2017-01-01,zipcode,Jacksonville
ZCTA5 32205,12,28865,43054,866,123700,23076,7568,20579,2404,5523,6548,3850,2254,14786,12744,2042,12744,6152,6592,2017-01-01,zipcode,Jacksonville
ZCTA5 32206,12,16750,25757,756,73600,13471,6016,11509,2635,4041,3197,1094,542,8964,6756,2208,6756,2794,3962,2017-01-01,zipcode,Jacksonville
ZCTA5 32207,12,35381,45214,840,149100,27920,9248,24647,3416,5925,7441,5041,2824,16677,14726,1951,14726,7378,7348,2017-01-01,zipcode,Jacksonville
ZCTA5 32208,12,32470,33425,872,75000,25889,11147,22496,3969,8868,6798,2090,771,14670,12204,2466,12204,6971,5233,2017-01-01,zipcode,Jacksonville
ZCTA5 32209,12,35541,23890,741,60800,26063,12686,21804,4728,9530,5459,1484,603,17034,12849,4185,12849,6210,6639,2017-01-01,zipcode,Jacksonville
ZCTA5 32210,12,60819,43177,914,108700,47054,15895,40454,5585,12799,14168,5553,2349,26856,23294,3562,23294,12698,10596,2017-01-01,zipcode,Jacksonville
ZCTA5 32211,12,34112,38025,816,108900,26534,9139,21766,2927,7266,7888,2621,1064,14781,12856,1925,12856,5958,6898,2017-01-01,zipcode,Jacksonville
ZCTA5 32212,12,2663,55037,1471,-666666666,2180,66,654,34,131,354,129,6,303,295,8,295,0,295,2017-01-01,zipcode,Jacksonville
ZCTA5 32216,12,38120,50648,1020,133100,31149,10986,27012,3050,7224,8201,6241,2296,17601,15518,2083,15518,7597,7921,2017-01-01,zipcode,Jacksonville
ZCTA5 32217,12,18878,46065,856,174300,15730,5160,13760,1596,3296,4094,3081,1693,9431,8092,1339,8092,4354,3738,2017-01-01,zipcode,Jacksonville
ZCTA5 32218,12,59891,51447,972,145800,46520,17501,38283,4370,12621,13661,5580,2051,23110,20589,2521,20589,13318,7271,2017-01-01,zipcode,Jacksonville
ZCTA5 32219,12,11810,46580,927,120600,10022,3619,8459,1277,2879,3076,870,357,4696,4157,539,4157,3398,759,2017-01-01,zipcode,Jacksonville
ZCTA5 32220,12,13928,53112,966,135600,10968,4112,9393,1232,4106,2565,971,519,5456,4805,651,4805,3834,971,2017-01-01,zipcode,Jacksonville
ZCTA5 32221,12,30040,59801,1200,147800,22817,8037,19493,2731,6639,6671,2717,735,10800,9806,994,9806,7233,2573,2017-01-01,zipcode,Jacksonville
ZCTA5 32222,12,9710,64036,1195,164800,7483,2326,6349,577,1430,2946,954,442,4056,3299,757,3299,2484,815,2017-01-01,zipcode,Jacksonville
ZCTA5 32223,12,24371,79722,1157,243100,20488,7096,18120,924,3396,6273,4720,2807,10101,9524,577,9524,7694,1830,2017-01-01,zipcode,Jacksonville
ZCTA5 32224,12,40354,72590,1233,262300,32534,11070,25847,1242,4529,7697,8194,4185,17066,14810,2256,14810,8783,6027,2017-01-01,zipcode,Jacksonville
ZCTA5 32225,12,54270,69233,1217,194500,43475,13613,37709,2365,9735,13085,8572,3952,21974,20037,1937,20037,13994,6043,2017-01-01,zipcode,Jacksonville
ZCTA5 32226,12,16289,78729,1576,194900,12695,4312,10652,1008,3120,3678,1992,854,6273,5453,820,5453,4484,969,2017-01-01,zipcode,Jacksonville
ZCTA5 32227,12,2848,42933,1481,-666666666,1977,268,893,21,242,448,120,62,605,429,176,429,4,425,2017-01-01,zipcode,Jacksonville
ZCTA5 32228,12,390,-666666666,-666666666,-666666666,390,0,81,0,10,51,20,0,0,0,0,0,0,0,2017-01-01,zipcode,Jacksonville
ZCTA5 32233,12,24423,57345,1066,245700,20915,6282,17288,1216,4606,5436,3809,2221,10986,9399,1587,9399,5326,4073,2017-01-01,zipcode,Atlantic beach
ZCTA5 32234,12,6177,52330,829,109800,4812,1520,4215,799,1836,1191,312,77,2652,2249,403,2249,1660,589,2017-01-01,zipcode,Jacksonville
ZCTA5 32244,12,60141,49871,997,112000,45409,14591,37779,3944,11364,14745,5746,1980,24087,21138,2949,21138,12585,8553,2017-01-01,zipcode,Jacksonville
ZCTA5 32246,12,51513,53720,1146,151600,41368,12450,35322,3755,9245,11397,7855,3070,21893,19709,2184,19709,10580,9129,2017-01-01,zipcode,Jacksonville
ZCTA5 32250,12,26574,70383,1161,312100,22568,7161,20695,842,3518,6350,6190,3795,14926,12470,2456,12470,8451,4019,2017-01-01,zipcode,Jacksonville beach
ZCTA5 32254,12,12972,29226,871,57900,9922,4653,8438,1895,3480,2600,347,116,5870,4513,1357,4513,2194,2319,2017-01-01,zipcode,Jacksonville
ZCTA5 32256,12,44557,59624,1120,264200,36899,10640,31277,1477,5498,8796,9690,5816,21988,19610,2378,19610,7436,12174,2017-01-01,zipcode,Jacksonville
ZCTA5 32257,12,38069,54347,1003,179800,31049,10241,27252,1700,7117,8748,6738,2949,16935,15419,1516,15419,9591,5828,2017-01-01,zipcode,Jacksonville
ZCTA5 32258,12,30529,79866,1285,211300,24001,5931,21779,954,3457,7739,6548,3081,12625,11669,956,11669,8589,3080,2017-01-01,zipcode,Jacksonville
ZCTA5 32259,12,47988,105955,1715,322300,35749,11758,30610,673,5141,8366,10930,5500,16048,15200,848,15200,12988,2212,2017-01-01,zipcode,Saint johns
ZCTA5 32266,12,7030,79333,1263,349800,5963,1878,4829,89,878,1440,1306,1116,3422,2864,558,2864,1943,921,2017-01-01,zipcode,Neptune beach
ZCTA5 32277,12,30415,47141,931,150400,23890,7780,19759,1639,5894,7361,3682,1183,13331,11625,1706,11625,6355,5270,2017-01-01,zipcode,Jacksonville
ZCTA5 32301,12,29668,41975,946,142700,25769,7672,17138,1158,3061,5455,4218,3246,15096,12648,2448,12648,3881,8767,2017-01-01,zipcode,Tallahassee
ZCTA5 32303,12,49849,47320,995,144400,41921,11358,30317,1912,5746,10165,7874,4620,23284,20853,2431,20853,10482,10371,2017-01-01,zipcode,Tallahassee
ZCTA5 32304,12,47800,21647,877,84900,44376,17753,13817,2268,3048,4528,2394,1579,20587,16834,3753,16834,2325,14509,2017-01-01,zipcode,Tallahassee
ZCTA5 32305,12,20719,38860,826,97200,15901,6228,12417,1834,4089,3955,1726,813,9232,7681,1551,7681,4611,3070,2017-01-01,zipcode,Tallahassee
ZCTA5 32308,12,22561,55625,991,199900,18754,6751,15958,725,2361,3949,4325,4598,11130,10371,759,10371,5498,4873,2017-01-01,zipcode,Tallahassee
ZCTA5 32309,12,31001,80376,1113,244600,24460,8322,21930,572,3132,5965,6778,5483,12836,12179,657,12179,9663,2516,2017-01-01,zipcode,Tallahassee
ZCTA5 32310,12,16172,35015,780,100400,12754,4778,9121,1264,3108,2715,1336,698,7914,6004,1910,6004,2777,3227,2017-01-01,zipcode,Tallahassee
ZCTA5 32311,12,20866,68076,1170,188900,16784,5458,14628,806,2661,3760,3810,3591,8976,8041,935,8041,4972,3069,2017-01-01,zipcode,Tallahassee
ZCTA5 32312,12,32365,93236,1215,282500,25942,8818,22112,590,2390,5412,7241,6479,13072,12396,676,12396,10121,2275,2017-01-01,zipcode,Tallahassee
ZCTA5 32317,12,14854,90035,1340,239300,11630,3546,10023,278,1593,2740,3139,2273,5674,5354,320,5354,4811,543,2017-01-01,zipcode,Tallahassee
ZCTA5 32320,12,3721,41442,670,141400,3062,1187,2706,484,932,824,256,210,2059,1517,542,1517,1049,468,2017-01-01,zipcode,Apalachicola
ZCTA5 32321,12,6253,34067,563,60800,5414,3564,4193,960,2050,825,177,181,2441,1509,932,1509,1132,377,2017-01-01,zipcode,Bristol
ZCTA5 32322,12,4089,36265,720,115200,3637,2591,3302,719,1341,783,324,135,2069,1143,926,1143,824,319,2017-01-01,zipcode,Carrabelle
ZCTA5 32323,12,400,35066,-666666666,44800,309,107,309,86,155,34,7,27,383,137,246,137,80,57,2017-01-01,zipcode,
ZCTA5 32324,12,4520,32418,637,84000,3932,2656,3495,930,1173,931,302,159,1908,1646,262,1646,1078,568,2017-01-01,zipcode,Chattahoochee
ZCTA5 32327,12,27829,60865,848,135700,22802,9766,20161,2516,7323,6723,2361,1238,11040,9514,1526,9514,7707,1807,2017-01-01,zipcode,Crawfordville
ZCTA5 32328,12,3184,46681,977,147000,2653,1213,2293,347,748,626,354,218,3114,1337,1777,1337,1080,257,2017-01-01,zipcode,Eastpoint
ZCTA5 32330,12,581,38542,758,71700,390,219,365,83,144,98,30,10,260,209,51,209,122,87,2017-01-01,zipcode,Greensboro
ZCTA5 32331,12,4252,35609,639,72100,3442,1923,3025,566,1163,848,252,196,1977,1601,376,1601,1344,257,2017-01-01,zipcode,Greenville
ZCTA5 32332,12,1512,33026,645,50800,1176,549,922,180,437,211,71,23,718,590,128,590,381,209,2017-01-01,zipcode,Gretna
ZCTA5 32333,12,10403,45311,731,122400,8773,4267,7898,1206,2732,2335,971,654,5162,4573,589,4573,3550,1023,2017-01-01,zipcode,Havana
ZCTA5 32334,12,2094,37929,589,68400,1645,768,1462,184,712,294,220,52,1081,816,265,816,619,197,2017-01-01,zipcode,Hosford
ZCTA5 32336,12,1301,43633,666,91000,1143,486,1022,117,284,347,198,76,891,621,270,621,568,53,2017-01-01,zipcode,Lamont
ZCTA5 32340,12,11179,32033,627,96300,9388,5747,8186,1520,3202,2355,637,472,4876,3901,975,3901,2730,1171,2017-01-01,zipcode,Madison
ZCTA5 32343,12,3322,56458,892,130500,2440,628,1999,275,623,581,347,173,1375,1253,122,1253,951,302,2017-01-01,zipcode,Midway
ZCTA5 32344,12,12572,45186,809,146400,10816,6235,9772,1928,3355,2472,1225,792,5895,4985,910,4985,3739,1246,2017-01-01,zipcode,Monticello
ZCTA5 32346,12,1803,34939,831,115500,1483,645,1275,172,446,441,153,63,1658,762,896,762,507,255,2017-01-01,zipcode,Panacea
ZCTA5 32347,12,8135,40893,609,87700,6577,3172,5614,815,2207,2024,445,123,3758,3006,752,3006,2592,414,2017-01-01,zipcode,Perry
ZCTA5 32348,12,12612,34662,617,73200,10601,7105,9168,2285,3960,2170,439,314,4791,3589,1202,3589,2722,867,2017-01-01,zipcode,Perry
ZCTA5 32350,12,1012,24832,578,117900,900,587,821,146,289,309,40,37,630,513,117,513,454,59,2017-01-01,zipcode,Pinetta
ZCTA5 32351,12,19275,35310,642,87200,15005,8416,12892,3185,4739,3289,1148,531,7499,6684,815,6684,4352,2332,2017-01-01,zipcode,Quincy
ZCTA5 32352,12,6500,46177,647,101100,5095,2181,4384,639,1730,1237,522,256,2758,2355,403,2355,1725,630,2017-01-01,zipcode,Quincy
ZCTA5 32355,12,203,57813,1096,127500,171,75,162,15,54,47,36,10,153,97,56,97,73,24,2017-01-01,zipcode,Saint marks
ZCTA5 32356,12,122,-666666666,-666666666,-666666666,122,96,122,11,96,15,0,0,80,60,20,60,60,0,2017-01-01,zipcode,Salem
ZCTA5 32358,12,2067,51469,688,144600,1726,902,1510,161,516,526,248,59,1366,907,459,907,765,142,2017-01-01,zipcode,Sopchoppy
ZCTA5 32359,12,1240,41061,965,129200,1186,779,1186,218,585,359,17,7,2421,742,1679,742,449,293,2017-01-01,zipcode,Steinhatchee
ZCTA5 32361,12,210,55511,-666666666,82700,153,46,146,28,50,61,7,0,119,77,42,77,71,6,2017-01-01,zipcode,Wacissa
ZCTA5 32399,12,0,-666666666,-666666666,-666666666,0,0,0,0,0,0,0,0,0,0,0,0,0,0,2017-01-01,zipcode,Tallahassee
ZCTA5 32401,12,23476,37629,837,124200,18835,8311,16549,2807,5614,5161,2050,917,11755,9443,2312,9443,4742,4701,2017-01-01,zipcode,Panama city
ZCTA5 32403,12,3557,62356,1471,-666666666,2243,565,1475,32,193,559,425,266,1015,865,150,865,0,865,2017-01-01,zipcode,Panama city
ZCTA5 32404,12,39552,50652,893,150300,31890,12591,26959,3207,9289,10800,2322,1341,16692,13897,2795,13897,9199,4698,2017-01-01,zipcode,Panama city
ZCTA5 32405,12,32513,45147,931,169000,25816,9784,22185,1943,6810,7830,3448,2154,14307,12519,1788,12519,6897,5622,2017-01-01,zipcode,Panama city
ZCTA5 32407,12,9735,57296,1193,218600,8263,2837,7044,469,1876,2638,1490,571,7797,4098,3699,4098,2122,1976,2017-01-01,zipcode,Panama city beach
ZCTA5 32408,12,16861,54000,1039,221700,14189,4487,11762,667,3352,4329,2220,1194,17020,7074,9946,7074,4355,2719,2017-01-01,zipcode,Panama city
ZCTA5 32409,12,10036,52378,706,145000,8131,3361,6952,1227,2124,2584,783,234,4135,3634,501,3634,3058,576,2017-01-01,zipcode,Panama city
ZCTA5 32410,12,1089,59375,1181,209700,1059,626,1012,50,248,340,156,218,1626,537,1089,537,383,154,2017-01-01,zipcode,Mexico beach
ZCTA5 32413,12,13591,59180,1072,217800,11627,4606,10832,929,2892,3564,2500,947,17068,5969,11099,5969,4096,1873,2017-01-01,zipcode,Panama city beach
ZCTA5 32420,12,1763,31337,666,68200,1465,847,1277,324,497,382,42,32,1183,760,423,760,606,154,2017-01-01,zipcode,Alford
ZCTA5 32421,12,5344,38078,717,70200,4084,1741,3568,617,1403,1105,351,92,2201,1923,278,1923,1589,334,2017-01-01,zipcode,Altha
ZCTA5 32423,12,1034,62539,-666666666,83500,890,473,803,85,234,387,63,34,576,449,127,449,380,69,2017-01-01,zipcode,Bascom
ZCTA5 32424,12,7334,35048,494,86900,6019,4023,5419,1494,2204,1276,317,128,2662,1969,693,1969,1604,365,2017-01-01,zipcode,Blountstown
ZCTA5 32425,12,13718,36752,639,93400,11250,6803,9718,2209,3926,2465,704,414,5901,4699,1202,4699,3539,1160,2017-01-01,zipcode,Bonifay
ZCTA5 32426,12,951,27472,693,72700,799,404,666,187,280,145,27,27,487,393,94,393,314,79,2017-01-01,zipcode,Campbellton
ZCTA5 32427,12,1040,25104,525,86900,907,508,745,211,267,208,30,29,507,421,86,421,377,44,2017-01-01,zipcode,Caryville
ZCTA5 32428,12,17083,37992,770,112000,14149,7701,12478,2580,4988,3410,980,520,7125,5643,1482,5643,4391,1252,2017-01-01,zipcode,Chipley
ZCTA5 32430,12,899,41419,-666666666,75500,777,347,642,64,259,249,63,7,625,368,257,368,323,45,2017-01-01,zipcode,Clarksville
ZCTA5 32431,12,3782,39783,650,78300,3118,1216,2762,564,1263,736,128,71,2185,1621,564,1621,1226,395,2017-01-01,zipcode,Cottondale
ZCTA5 32432,12,43,-666666666,-666666666,-666666666,43,43,43,21,0,22,0,0,21,21,0,21,21,0,2017-01-01,zipcode,Cypress
ZCTA5 32433,12,17679,31741,780,100100,13939,7344,12267,3008,4611,3613,584,451,7447,6194,1253,6194,4221,1973,2017-01-01,zipcode,Defuniak springs
ZCTA5 32435,12,7610,41555,718,131700,5979,2702,5172,905,1867,1312,562,526,3659,2885,774,2885,2090,795,2017-01-01,zipcode,Defuniak springs
ZCTA5 32437,12,888,19537,-666666666,55000,567,273,530,77,302,129,20,2,373,304,69,304,198,106,2017-01-01,zipcode,Ebro
ZCTA5 32438,12,3783,29914,-666666666,70200,3113,1793,2916,577,1306,887,146,0,2002,1430,572,1430,1262,168,2017-01-01,zipcode,Fountain
ZCTA5 32439,12,8931,55360,963,202400,7487,2506,6515,773,1720,2507,1073,442,4721,3679,1042,3679,2512,1167,2017-01-01,zipcode,Freeport
ZCTA5 32440,12,7654,41810,680,102800,6600,3975,5543,1376,1944,1502,387,334,2482,2030,452,2030,1446,584,2017-01-01,zipcode,Graceville
ZCTA5 32442,12,3336,36789,587,85600,2566,1046,2266,534,809,673,166,84,1738,1447,291,1447,991,456,2017-01-01,zipcode,Grand ridge
ZCTA5 32443,12,2842,34185,643,81900,2290,1093,2106,322,780,681,168,155,1632,1179,453,1179,928,251,2017-01-01,zipcode,Greenwood
ZCTA5 32444,12,21364,67246,973,188500,17242,6416,15186,1110,3859,5195,2818,2204,8695,7901,794,7901,5672,2229,2017-01-01,zipcode,Lynn haven
ZCTA5 32445,12,2664,33000,646,87000,2380,1779,1998,632,749,468,110,39,627,524,103,524,402,122,2017-01-01,zipcode,Malone
ZCTA5 32446,12,11501,43939,697,143500,9666,4990,8240,1162,2494,2585,1110,889,4693,3970,723,3970,2683,1287,2017-01-01,zipcode,Marianna
ZCTA5 32447,12,156,-666666666,-666666666,-666666666,102,102,0,0,0,0,0,0,0,0,0,0,0,0,2017-01-01,zipcode,Marianna
ZCTA5 32448,12,8811,26975,603,87400,7101,3355,6420,1061,2402,2177,398,382,4720,4014,706,4014,2515,1499,2017-01-01,zipcode,Marianna
ZCTA5 32449,12,595,28798,-666666666,70400,516,264,409,121,122,166,0,0,338,217,121,217,204,13,2017-01-01,zipcode,Wewahitchka
ZCTA5 32455,12,4530,32122,733,78700,3707,1631,3114,929,1083,794,191,117,2448,1789,659,1789,1290,499,2017-01-01,zipcode,Ponce de leon
ZCTA5 32456,12,7943,47440,1112,178100,6587,2953,5929,468,1789,2016,994,662,6117,3134,2983,3134,2276,858,2017-01-01,zipcode,Port saint joe
ZCTA5 32459,12,14028,71370,1327,362900,11374,3430,10610,587,1703,3883,3092,1345,13387,5893,7494,5893,4196,1697,2017-01-01,zipcode,Santa rosa beach
ZCTA5 32460,12,6016,37364,563,87500,5232,3604,4587,1158,1753,1263,282,131,1685,1477,208,1477,1112,365,2017-01-01,zipcode,Sneads
ZCTA5 32461,12,22,-666666666,-666666666,-666666666,22,11,22,0,0,0,22,0,64,11,53,11,11,0,2017-01-01,zipcode,Inlet beach
ZCTA5 32462,12,3460,42926,601,83100,2963,1142,2405,267,1030,827,184,97,1930,1346,584,1346,1063,283,2017-01-01,zipcode,Vernon
ZCTA5 32463,12,169,45833,488,81400,133,58,114,24,53,37,0,0,63,58,5,58,38,20,2017-01-01,zipcode,Wausau
ZCTA5 32464,12,4221,40516,394,78300,3441,1719,3064,859,1127,755,279,44,2099,1771,328,1771,1611,160,2017-01-01,zipcode,Westville
ZCTA5 32465,12,8463,40176,779,96900,7574,4787,6506,1467,2704,1645,595,95,3667,2334,1333,2334,1773,561,2017-01-01,zipcode,Wewahitchka
ZCTA5 32466,12,6038,48942,956,106800,4624,2057,3934,772,1621,1303,176,62,2406,1893,513,1893,1665,228,2017-01-01,zipcode,Youngstown
ZCTA5 32501,12,11868,29142,770,116600,9715,5040,8287,1368,2539,2533,1088,759,5380,4482,898,4482,2241,2241,2017-01-01,zipcode,Pensacola
ZCTA5 32502,12,2699,41667,854,117300,2257,738,2100,174,565,761,343,257,1668,1310,358,1310,736,574,2017-01-01,zipcode,Pensacola
ZCTA5 32503,12,34761,46707,864,147500,28501,10718,19693,1676,4631,6552,4319,2515,13384,11904,1480,11904,7167,4737,2017-01-01,zipcode,Pensacola
ZCTA5 32504,12,22989,49001,938,152800,17794,6478,14517,874,3003,5324,3192,2124,10387,9221,1166,9221,5199,4022,2017-01-01,zipcode,Pensacola
ZCTA5 32505,12,24993,36181,849,64200,21088,8199,18360,2825,6933,5969,1732,901,13049,10682,2367,10682,5412,5270,2017-01-01,zipcode,Pensacola
ZCTA5 32506,12,36310,45230,973,110700,28433,11350,24549,2582,6646,10341,3409,1571,16271,14096,2175,14096,7803,6293,2017-01-01,zipcode,Pensacola
ZCTA5 32507,12,30201,48584,925,147200,23843,8575,20832,1454,4976,8486,3492,2424,17624,12583,5041,12583,7134,5449,2017-01-01,zipcode,Pensacola
ZCTA5 32508,12,6288,43352,1235,-666666666,5774,512,1121,4,132,562,326,97,607,531,76,531,0,531,2017-01-01,zipcode,Pensacola
ZCTA5 32509,12,722,-666666666,-666666666,-666666666,722,722,722,25,268,276,86,67,0,0,0,0,0,0,2017-01-01,zipcode,Pensacola
ZCTA5 32511,12,1065,-666666666,-666666666,-666666666,1065,31,99,0,9,59,31,0,0,0,0,0,0,0,2017-01-01,zipcode,Pensacola
ZCTA5 32514,12,44166,45977,948,134200,35401,13491,27529,2487,6634,10222,5652,2534,18819,16923,1896,16923,8533,8390,2017-01-01,zipcode,Pensacola
ZCTA5 32526,12,36593,55050,1056,121000,29822,11826,26324,2005,7214,10593,4593,1919,15982,14382,1600,14382,10643,3739,2017-01-01,zipcode,Pensacola
ZCTA5 32530,12,0,-666666666,-666666666,-666666666,0,0,0,0,0,0,0,0,0,0,0,0,0,0,2017-01-01,zipcode,Bagdad
ZCTA5 32531,12,5546,55712,1035,143600,4358,2051,3886,409,1430,1417,332,298,2594,2085,509,2085,1782,303,2017-01-01,zipcode,Baker
ZCTA5 32533,12,27135,67265,974,161200,22200,9248,19441,1574,5525,6867,3880,1595,11047,9936,1111,9936,8246,1690,2017-01-01,zipcode,Cantonment
ZCTA5 32534,12,14636,48519,955,106900,12066,4564,10572,673,3120,4594,1731,454,6687,5992,695,5992,4273,1719,2017-01-01,zipcode,Pensacola
ZCTA5 32535,12,5523,36576,655,82300,5048,3218,4570,1085,2039,1106,242,98,2021,1774,247,1774,1120,654,2017-01-01,zipcode,Century
ZCTA5 32536,12,22746,64217,1039,187200,17614,6423,14657,1098,3896,6129,2400,1134,9629,8615,1014,8615,5833,2782,2017-01-01,zipcode,Crestview
ZCTA5 32539,12,29195,52990,949,149800,22240,10750,19060,2359,6133,7338,2402,828,10535,9314,1221,9314,6612,2702,2017-01-01,zipcode,Crestview
ZCTA5 32541,12,17524,73665,1396,335700,14865,4669,13165,534,2611,4261,3695,2064,15990,7726,8264,7726,4775,2951,2017-01-01,zipcode,Destin
ZCTA5 32542,12,3178,48333,1392,-666666666,2382,249,1108,20,137,659,244,48,955,668,287,668,0,668,2017-01-01,zipcode,Eglin afb
ZCTA5 32544,12,1848,45238,1369,-666666666,1292,110,521,5,48,288,113,67,300,274,26,274,0,274,2017-01-01,zipcode,Hurlburt field
ZCTA5 32547,12,34058,51099,975,169500,27400,9544,23118,2774,5795,8144,4083,2322,15992,14357,1635,14357,6710,7647,2017-01-01,zipcode,Fort walton beach
ZCTA5 32548,12,21076,53133,976,163700,17697,5966,15648,1448,4304,6189,2199,1508,12893,9298,3595,9298,5069,4229,2017-01-01,zipcode,Fort walton beach
ZCTA5 32550,12,8290,63913,1145,354300,7259,3242,6747,205,888,2433,2098,1123,13523,3850,9673,3850,2755,1095,2017-01-01,zipcode,Miramar beach
ZCTA5 32561,12,9154,100486,1338,394400,7537,2660,6570,208,873,1807,2093,1589,6391,3889,2502,3889,2941,948,2017-01-01,zipcode,Gulf breeze
ZCTA5 32563,12,25344,63732,1101,216400,19901,7180,17565,777,3958,6962,3619,2249,10850,9711,1139,9711,7276,2435,2017-01-01,zipcode,Gulf breeze
ZCTA5 32564,12,2569,65588,898,180400,1909,725,1788,176,579,723,236,74,1207,966,241,966,775,191,2017-01-01,zipcode,Holt
ZCTA5 32565,12,4904,46074,873,106900,4305,1946,3877,351,1713,1117,500,196,2517,2133,384,2133,1744,389,2017-01-01,zipcode,Jay
ZCTA5 32566,12,36714,69199,1262,212700,28967,10213,24544,1415,5765,10447,4599,2318,16882,13842,3040,13842,10297,3545,2017-01-01,zipcode,Navarre
ZCTA5 32567,12,3114,38993,721,120800,2554,1243,2333,441,837,754,190,111,1725,1307,418,1307,1064,243,2017-01-01,zipcode,Laurel hill
ZCTA5 32568,12,2751,51379,702,138100,2164,768,1943,230,796,699,135,83,1200,1008,192,1008,861,147,2017-01-01,zipcode,Mc david
ZCTA5 32569,12,12358,56933,1062,172900,9962,3321,8254,763,2212,3102,1317,860,5395,4798,597,4798,3206,1592,2017-01-01,zipcode,Mary esther
ZCTA5 32570,12,30099,54891,886,132500,24029,10721,20715,2100,6430,7901,3094,1190,12855,11391,1464,11391,7869,3522,2017-01-01,zipcode,Milton
ZCTA5 32571,12,33442,67344,986,165800,26268,9423,21952,1680,5682,7549,4804,2237,13005,11870,1135,11870,9139,2731,2017-01-01,zipcode,Milton
ZCTA5 32577,12,4321,55076,669,136000,3698,1791,3239,386,923,1287,499,144,1957,1722,235,1722,1479,243,2017-01-01,zipcode,Molino
ZCTA5 32578,12,32246,81445,1112,268500,25593,8846,22792,924,4286,7529,5799,4254,13419,12323,1096,12323,9509,2814,2017-01-01,zipcode,Niceville
ZCTA5 32579,12,10230,69464,1132,255800,8619,3609,7447,445,1602,2307,1826,1267,4750,4405,345,4405,2971,1434,2017-01-01,zipcode,Shalimar
ZCTA5 32580,12,4200,57269,1063,203500,3293,1052,2807,165,766,1136,409,331,1857,1563,294,1563,1085,478,2017-01-01,zipcode,Valparaiso
ZCTA5 32583,12,29678,55969,979,131800,25054,13651,21845,4235,7021,6680,2620,1289,10132,8913,1219,8913,6615,2298,2017-01-01,zipcode,Milton
ZCTA5 32601,12,18182,24524,820,135200,17039,7062,9395,664,1817,2428,2040,2446,9734,7765,1969,7765,2259,5506,2017-01-01,zipcode,Gainesville
ZCTA5 32603,12,7414,21956,825,267300,7155,4094,1482,45,133,221,368,715,2369,1813,556,1813,354,1459,2017-01-01,zipcode,Gainesville
ZCTA5 32605,12,23739,66881,1102,175100,20040,7002,17324,524,3170,4159,4328,5143,11142,10013,1129,10013,7120,2893,2017-01-01,zipcode,Gainesville
ZCTA5 32606,12,23991,62200,1129,197500,18980,6917,16206,700,2373,4097,4426,4610,10511,9193,1318,9193,4707,4486,2017-01-01,zipcode,Gainesville
ZCTA5 32607,12,30728,35872,860,191700,26442,9402,15854,1028,3394,4586,3465,3381,15216,12310,2906,12310,3992,8318,2017-01-01,zipcode,Gainesville
ZCTA5 32608,12,48948,41659,936,220800,41672,16134,28543,1743,4651,7113,7270,7766,23178,19366,3812,19366,7404,11962,2017-01-01,zipcode,Gainesville
ZCTA5 32609,12,18426,31357,850,96000,15239,6418,12318,2307,3837,3875,1277,1022,8160,6752,1408,6752,3794,2958,2017-01-01,zipcode,Gainesville
ZCTA5 32612,12,7756,-666666666,-666666666,-666666666,7756,6277,14,0,0,8,0,6,6,6,0,6,0,6,2017-01-01,zipcode,Gainesville
ZCTA5 32615,12,14531,54802,1053,163700,11540,4227,9904,566,2517,3528,2089,1204,6576,5665,911,5665,4242,1423,2017-01-01,zipcode,Alachua
ZCTA5 32616,12,956,27163,737,88900,802,415,745,149,373,154,47,22,500,431,69,431,198,233,2017-01-01,zipcode,
ZCTA5 32617,12,4598,49194,545,133600,3733,1480,2995,471,1207,935,163,219,1850,1598,252,1598,1306,292,2017-01-01,zipcode,Anthony
ZCTA5 32618,12,7922,48765,716,157700,6543,2824,5460,761,1567,1644,902,586,3411,2876,535,2876,2316,560,2017-01-01,zipcode,Archer
ZCTA5 32619,12,4475,40707,766,105100,3526,1596,3064,442,1187,1111,215,109,2220,1816,404,1816,1520,296,2017-01-01,zipcode,Bell
ZCTA5 32621,12,5471,34786,634,58900,4479,2555,3829,849,1625,1000,284,71,2508,2028,480,2028,1479,549,2017-01-01,zipcode,Bronson
ZCTA5 32622,12,997,42031,774,78900,811,420,747,147,324,175,93,8,521,391,130,391,331,60,2017-01-01,zipcode,Brooker
ZCTA5 32625,12,1564,34625,650,124100,1249,625,1206,66,445,364,164,167,1199,691,508,691,553,138,2017-01-01,zipcode,Cedar key
ZCTA5 32626,12,8452,34250,641,90600,6577,3401,5882,1113,2513,1663,387,206,4390,3448,942,3448,2502,946,2017-01-01,zipcode,Chiefland
ZCTA5 32628,12,5048,38565,651,79100,4215,2889,3772,896,1852,786,158,80,1705,1365,340,1365,975,390,2017-01-01,zipcode,Cross city
ZCTA5 32631,12,287,62303,-666666666,296900,281,201,281,0,10,133,20,118,154,154,0,154,154,0,2017-01-01,zipcode,Earleton
ZCTA5 32639,12,83,-666666666,-666666666,-666666666,83,51,83,39,44,0,0,0,220,28,192,28,17,11,2017-01-01,zipcode,Gulf hammock
ZCTA5 32640,12,11132,41832,714,106600,9491,4695,8564,1266,3294,2634,748,622,5903,4536,1367,4536,3551,985,2017-01-01,zipcode,Hawthorne
ZCTA5 32641,12,14091,33254,824,94500,11143,5460,9032,1596,3047,2962,981,446,5508,4746,762,4746,2822,1924,2017-01-01,zipcode,Gainesville
ZCTA5 32643,12,11554,54968,897,149700,9300,3736,8226,717,2355,3199,1124,831,4839,4101,738,4101,3467,634,2017-01-01,zipcode,High springs
ZCTA5 32648,12,433,53869,-666666666,130400,295,153,295,54,122,91,22,6,563,163,400,163,152,11,2017-01-01,zipcode,Horseshoe beach
ZCTA5 32653,12,13583,61954,908,180200,10963,4286,9723,472,1950,3247,2077,1977,6076,5730,346,5730,4337,1393,2017-01-01,zipcode,Gainesville
ZCTA5 32656,12,14080,46370,889,106300,11455,5388,9908,1240,3572,3524,1237,335,6639,5523,1116,5523,4341,1182,2017-01-01,zipcode,Keystone heights
ZCTA5 32658,12,308,46000,1156,108300,271,133,236,43,93,87,13,0,111,94,17,94,74,20,2017-01-01,zipcode,La crosse
ZCTA5 32664,12,618,40417,964,76100,574,282,557,88,265,83,76,45,345,282,63,282,230,52,2017-01-01,zipcode,Mc intosh
ZCTA5 32666,12,6019,41813,804,121100,5371,2886,4561,523,1768,1431,420,419,3105,2433,672,2433,1944,489,2017-01-01,zipcode,Melrose
ZCTA5 32667,12,4019,51083,720,243100,3292,1602,2837,148,819,790,559,521,1887,1620,267,1620,1308,312,2017-01-01,zipcode,Micanopy
ZCTA5 32668,12,4619,41260,808,139800,3931,2164,3523,354,1564,1101,299,205,2528,1985,543,1985,1552,433,2017-01-01,zipcode,Morriston
ZCTA5 32669,12,12646,69568,962,180800,9573,2936,8642,485,2164,2857,2079,1057,5470,4660,810,4660,3889,771,2017-01-01,zipcode,Newberry
ZCTA5 32680,12,10104,32737,659,63700,8433,5167,7549,1513,3135,2065,585,251,5938,4476,1462,4476,3569,907,2017-01-01,zipcode,Old town
ZCTA5 32681,12,96,-666666666,-666666666,64900,96,80,96,0,46,0,50,0,81,81,0,81,81,0,2017-01-01,zipcode,Orange lake
ZCTA5 32683,12,202,17500,-666666666,-666666666,163,135,152,27,94,31,0,0,76,64,12,64,59,5,2017-01-01,zipcode,Otter creek
ZCTA5 32686,12,4944,41389,592,110900,3903,1938,3301,705,1249,824,379,144,2410,1766,644,1766,1265,501,2017-01-01,zipcode,Reddick
ZCTA5 32692,12,246,-666666666,-666666666,-666666666,222,116,222,30,65,127,0,0,643,126,517,126,126,0,2017-01-01,zipcode,Suwannee
ZCTA5 32693,12,12079,37065,645,83500,9894,5388,8099,1443,3284,2328,756,288,5078,4362,716,4362,3243,1119,2017-01-01,zipcode,Trenton
ZCTA5 32694,12,2474,39278,680,95000,1946,664,1594,221,651,504,169,49,1044,837,207,837,593,244,2017-01-01,zipcode,Waldo
ZCTA5 32696,12,12408,46429,744,115400,10176,4180,8938,1314,3484,2937,728,475,5452,4556,896,4556,3508,1048,2017-01-01,zipcode,Williston
ZCTA5 32697,12,450,30673,885,-666666666,304,115,211,74,89,45,0,3,182,117,65,117,9,108,2017-01-01,zipcode,Worthington springs
ZCTA5 32701,12,21987,52981,1054,153700,18820,6837,16755,1095,3838,5944,4206,1672,11752,9369,2383,9369,4877,4492,2017-01-01,zipcode,Altamonte springs
ZCTA5 32702,12,2785,35424,-666666666,67700,2344,1428,2108,442,696,645,190,135,1619,1197,422,1197,690,507,2017-01-01,zipcode,Altoona
ZCTA5 32703,12,48853,48417,1035,142900,38456,13535,32483,4624,10799,9688,5289,2083,18915,16836,2079,16836,10404,6432,2017-01-01,zipcode,Apopka
ZCTA5 32707,12,35399,50361,1109,136500,29721,10664,26087,1361,6242,11136,5546,1802,16163,14069,2094,14069,9011,5058,2017-01-01,zipcode,Casselberry
ZCTA5 32708,12,45097,65886,1188,227700,37050,13613,32634,1844,6512,10726,8954,4598,17569,16169,1400,16169,12076,4093,2017-01-01,zipcode,Winter springs
ZCTA5 32709,12,1742,26215,-666666666,118500,1644,769,1555,266,528,490,172,99,828,761,67,761,688,73,2017-01-01,zipcode,Christmas
ZCTA5 32712,12,45683,67079,1186,211700,36354,12453,31618,4505,8230,9756,5647,3480,17419,15646,1773,15646,12828,2818,2017-01-01,zipcode,Apopka
ZCTA5 32713,12,20223,51233,1021,167500,17083,7904,15566,1133,5215,4981,3056,1181,9222,8277,945,8277,7000,1277,2017-01-01,zipcode,Debary
ZCTA5 32714,12,36004,49595,1110,160500,30233,9305,26580,1579,5958,9962,6005,3076,17678,14264,3414,14264,6515,7749,2017-01-01,zipcode,Altamonte springs
ZCTA5 32720,12,30940,39624,904,156100,25316,12302,21121,2326,6943,7221,3154,1477,13883,12036,1847,12036,8178,3858,2017-01-01,zipcode,Deland
ZCTA5 32724,12,35314,45028,1009,150700,29620,14685,24435,2332,8055,7953,3828,2267,15358,13759,1599,13759,9281,4478,2017-01-01,zipcode,Deland
ZCTA5 32725,12,47405,46345,1076,122000,38324,17119,33394,4081,11335,12251,4224,1503,18587,16676,1911,16676,12836,3840,2017-01-01,zipcode,Deltona
ZCTA5 32726,12,22048,40431,815,133200,18016,8124,15544,2186,6007,4350,2069,932,10073,8701,1372,8701,5555,3146,2017-01-01,zipcode,Eustis
ZCTA5 32730,12,5640,41533,977,126400,5058,2018,4452,259,1044,1894,899,356,2725,2457,268,2457,1071,1386,2017-01-01,zipcode,Casselberry
ZCTA5 32732,12,4559,58487,940,295900,3952,1524,3573,93,1102,1415,761,202,2100,1596,504,1596,1498,98,2017-01-01,zipcode,Geneva
ZCTA5 32735,12,4261,48350,1260,132900,3367,1985,3274,370,952,1263,393,296,2049,1924,125,1924,1654,270,2017-01-01,zipcode,Grand island
ZCTA5 32736,12,10210,66129,845,225200,8321,3641,7420,749,2209,2537,1230,695,4171,3518,653,3518,3078,440,2017-01-01,zipcode,Eustis
ZCTA5 32738,12,45042,47135,1141,121100,34987,13862,29307,3205,10681,10518,3964,939,16534,15015,1519,15015,11258,3757,2017-01-01,zipcode,Deltona
ZCTA5 32744,12,3808,43819,936,124600,3279,1450,2969,308,1133,933,440,155,1817,1529,288,1529,1275,254,2017-01-01,zipcode,Lake helen
ZCTA5 32746,12,42044,79137,1330,275000,34535,11736,30081,1163,4812,9553,9521,5032,18401,15664,2737,15664,10377,5287,2017-01-01,zipcode,Lake mary
ZCTA5 32750,12,24107,67359,1149,198800,20404,7154,17645,1226,4848,6006,3849,1716,9332,8651,681,8651,6142,2509,2017-01-01,zipcode,Longwood
ZCTA5 32751,12,22610,69821,1241,261600,18136,6595,15582,532,2354,4260,5414,3022,9933,8671,1262,8671,6028,2643,2017-01-01,zipcode,Maitland
ZCTA5 32754,12,10469,52360,826,149800,8849,3942,7880,840,2814,2707,1031,488,5267,4113,1154,4113,3658,455,2017-01-01,zipcode,Mims
ZCTA5 32757,12,26129,56180,974,189400,22453,10222,19891,2276,5452,5849,3827,2487,13047,10972,2075,10972,7630,3342,2017-01-01,zipcode,Mount dora
ZCTA5 32759,12,2757,33125,744,146900,2362,1329,2262,341,967,689,225,40,1587,1245,342,1245,920,325,2017-01-01,zipcode,Oak hill
ZCTA5 32763,12,22957,40931,1036,98400,18914,8384,16730,1695,6115,5876,2040,1004,10309,9032,1277,9032,5553,3479,2017-01-01,zipcode,Orange city
ZCTA5 32764,12,3514,60023,1047,163000,3174,1429,2804,481,953,967,282,121,1563,1265,298,1265,1133,132,2017-01-01,zipcode,Osteen
ZCTA5 32765,12,63974,72530,1337,251700,51103,17757,39596,1588,6789,13149,11400,6670,22420,20405,2015,20405,14336,6069,2017-01-01,zipcode,Oviedo
ZCTA5 32766,12,17240,103084,1473,295100,12946,4838,10643,570,1768,3242,3176,1887,5281,4986,295,4986,4448,538,2017-01-01,zipcode,Oviedo
ZCTA5 32767,12,3057,40111,721,84900,2544,1136,2137,533,1042,499,30,33,1371,1076,295,1076,852,224,2017-01-01,zipcode,Paisley
ZCTA5 32771,12,52002,53359,1101,168800,39792,13281,34675,3262,8201,12296,7555,3361,22588,18457,4131,18457,11519,6938,2017-01-01,zipcode,Sanford
ZCTA5 32773,12,31659,42077,1008,108700,24603,9297,21412,2169,7403,7355,3517,968,13317,10482,2835,10482,6203,4279,2017-01-01,zipcode,Sanford
ZCTA5 32776,12,12644,71840,1218,182300,9570,3088,8443,1212,2291,2880,1271,789,4238,3943,295,3943,3053,890,2017-01-01,zipcode,Sorrento
ZCTA5 32778,12,20694,43585,892,131000,17829,10060,16121,1669,5756,5144,2170,1382,11128,8979,2149,8979,6767,2212,2017-01-01,zipcode,Tavares
ZCTA5 32779,12,29600,86880,1349,290900,23656,8997,20741,438,3311,6252,6924,3816,11247,10445,802,10445,8481,1964,2017-01-01,zipcode,Longwood
ZCTA5 32780,12,35199,47546,875,129300,29536,13930,26747,2164,7588,9656,4930,2409,20105,15394,4711,15394,10258,5136,2017-01-01,zipcode,Titusville
ZCTA5 32784,12,11824,45038,730,132500,9329,4269,8030,1337,2554,2935,677,527,5357,4296,1061,4296,3189,1107,2017-01-01,zipcode,Umatilla
ZCTA5 32789,12,25879,71618,1093,414100,21676,9162,18494,1032,2582,3935,5834,5111,12402,10628,1774,10628,7133,3495,2017-01-01,zipcode,Winter park
ZCTA5 32792,12,50867,47885,1076,190400,43283,14623,35835,2428,7561,12550,8856,4440,23602,20480,3122,20480,9688,10792,2017-01-01,zipcode,Winter park
ZCTA5 32796,12,20772,43872,888,109300,17254,8671,15393,1318,4961,5943,2027,1144,10029,8119,1910,8119,6182,1937,2017-01-01,zipcode,Titusville
ZCTA5 32798,12,2420,43601,1075,70500,2349,1563,2170,279,676,818,316,81,1630,1257,373,1257,1109,148,2017-01-01,zipcode,Zellwood
ZCTA5 32801,12,12383,52746,1212,303700,11330,3348,10484,619,1948,2215,3771,1931,8774,7291,1483,7291,1718,5573,2017-01-01,zipcode,Orlando
ZCTA5 32803,12,18302,61891,1162,236700,16592,3788,14836,556,2239,3994,5047,3000,10641,9009,1632,9009,5058,3951,2017-01-01,zipcode,Orlando
ZCTA5 32804,12,17848,70609,1150,278000,15160,4866,13853,571,3049,3479,4328,2426,8907,7832,1075,7832,4972,2860,2017-01-01,zipcode,Orlando
ZCTA5 32805,12,22312,25361,772,100300,17630,7736,15143,3361,5392,3862,1916,612,9211,7921,1290,7921,2660,5261,2017-01-01,zipcode,Orlando
ZCTA5 32806,12,27324,56606,1044,222300,22324,6697,20023,1359,5014,5833,5054,2763,12401,11200,1201,11200,6587,4613,2017-01-01,zipcode,Orlando
ZCTA5 32807,12,33310,40567,1007,119500,26504,9083,22642,4448,8038,6486,2699,971,12621,11383,1238,11383,5326,6057,2017-01-01,zipcode,Orlando
ZCTA5 32808,12,54058,33475,930,86600,40900,13279,33119,7386,10963,10479,2835,1456,19835,17662,2173,17662,6855,10807,2017-01-01,zipcode,Orlando
ZCTA5 32809,12,28575,40114,944,128000,22510,7726,18771,3704,6437,5441,2329,860,10831,9329,1502,9329,4644,4685,2017-01-01,zipcode,Orlando
ZCTA5 32810,12,36535,44526,1047,108900,28611,8607,24246,3059,7537,8783,3800,1067,14433,12815,1618,12815,6510,6305,2017-01-01,zipcode,Orlando
ZCTA5 32811,12,40236,35374,1043,83000,31263,8462,25545,3632,7508,9045,3887,1473,17492,15262,2230,15262,3743,11519,2017-01-01,zipcode,Orlando
ZCTA5 32812,12,35290,47885,1051,189600,29830,9910,25618,1905,6995,8819,5588,2311,15402,14278,1124,14278,7834,6444,2017-01-01,zipcode,Orlando
ZCTA5 32814,12,8079,96818,1660,425300,6664,1592,5973,127,558,1082,2306,1900,4217,3416,801,3416,1690,1726,2017-01-01,zipcode,Orlando
ZCTA5 32817,12,36033,53357,1151,176900,31054,11415,20919,1982,4822,6598,5016,2501,13285,11833,1452,11833,6307,5526,2017-01-01,zipcode,Orlando
ZCTA5 32818,12,53839,43079,1019,141100,40869,11762,33147,5799,11124,10491,4228,1505,17791,16740,1051,16740,9372,7368,2017-01-01,zipcode,Orlando
ZCTA5 32819,12,28301,62918,1255,286100,23736,7468,19943,1408,3335,6277,6101,2822,14306,10394,3912,10394,6496,3898,2017-01-01,zipcode,Orlando
ZCTA5 32820,12,9687,63232,1243,213000,7449,2190,6233,938,1396,1885,1339,675,3270,2998,272,2998,2603,395,2017-01-01,zipcode,Orlando
ZCTA5 32821,12,17294,50461,1248,170000,15103,3934,12730,1104,2666,4202,3671,1087,11267,7281,3986,7281,2837,4444,2017-01-01,zipcode,Orlando
ZCTA5 32822,12,60935,35804,1037,105600,48753,16735,41178,6943,13286,13187,5931,1831,25736,22742,2994,22742,8979,13763,2017-01-01,zipcode,Orlando
ZCTA5 32824,12,44568,56002,1374,173500,35771,12014,29280,4002,7519,10583,5196,1980,14971,12919,2052,12919,8713,4206,2017-01-01,zipcode,Orlando
ZCTA5 32825,12,57344,54137,1153,175500,46127,14310,38569,4159,9259,13716,7868,3567,22212,19888,2324,19888,12145,7743,2017-01-01,zipcode,Orlando
ZCTA5 32826,12,36125,47197,999,143300,32593,18979,14262,1897,3042,3717,3626,1980,9210,8043,1167,8043,4223,3820,2017-01-01,zipcode,Orlando
ZCTA5 32827,12,9872,74366,1532,276500,7652,2085,6597,394,1216,1567,1930,1490,4233,3603,630,3603,2142,1461,2017-01-01,zipcode,Orlando
ZCTA5 32828,12,64955,69356,1395,234700,50608,15512,40573,2888,7100,12708,12030,5847,23212,20904,2308,20904,13072,7832,2017-01-01,zipcode,Orlando
ZCTA5 32829,12,19885,66196,1388,201400,15064,4397,13093,961,3051,4281,2811,1989,7438,6346,1092,6346,4765,1581,2017-01-01,zipcode,Orlando
ZCTA5 32830,12,6,-666666666,-666666666,-666666666,6,0,6,0,0,6,0,0,6,6,0,6,0,6,2017-01-01,zipcode,Orlando
ZCTA5 32831,12,3311,34200,-666666666,-666666666,3301,3267,2887,1101,1225,464,54,43,98,34,64,34,9,25,2017-01-01,zipcode,Orlando
ZCTA5 32832,12,21419,83462,1482,290700,15846,4645,13522,489,1379,3885,5158,2611,8382,7140,1242,7140,4513,2627,2017-01-01,zipcode,Orlando
ZCTA5 32833,12,9451,53006,1108,206000,7212,2183,6551,585,2046,2285,821,814,3741,3173,568,3173,2546,627,2017-01-01,zipcode,Orlando
ZCTA5 32835,12,42861,51318,1210,211300,35028,8289,29229,2370,6625,8942,7111,4181,18758,16418,2340,16418,6624,9794,2017-01-01,zipcode,Orlando
ZCTA5 32836,12,18471,83382,1165,401200,14888,5300,13292,652,2124,3347,4808,2361,7803,6683,1120,6683,4417,2266,2017-01-01,zipcode,Orlando
ZCTA5 32837,12,55855,57970,1326,204200,43665,13021,37306,3909,9244,11946,8462,3745,20343,18066,2277,18066,10111,7955,2017-01-01,zipcode,Orlando
ZCTA5 32839,12,54617,34972,1000,109400,42653,14300,35216,7077,11045,10257,5579,1258,22544,18665,3879,18665,4291,14374,2017-01-01,zipcode,Orlando
ZCTA5 32901,12,24763,34437,853,122200,22422,11783,18046,2145,5490,5637,2899,1875,13277,10925,2352,10925,5209,5716,2017-01-01,zipcode,Melbourne
ZCTA5 32903,12,13506,72967,1193,302500,11441,4763,10543,259,1752,3139,3073,2320,6921,5972,949,5972,4727,1245,2017-01-01,zipcode,Indialantic
ZCTA5 32904,12,30068,57545,1214,178200,24670,11055,21498,1585,6296,7207,3865,2545,12609,11273,1336,11273,8600,2673,2017-01-01,zipcode,Melbourne
ZCTA5 32905,12,23848,36701,873,101100,20089,9105,17004,2111,5450,6009,2337,1097,11727,9813,1914,9813,4961,4852,2017-01-01,zipcode,Palm bay
ZCTA5 32907,12,42895,47305,1096,124900,35308,15636,29836,2984,10436,10885,3798,1733,16861,14826,2035,14826,11401,3425,2017-01-01,zipcode,Palm bay
ZCTA5 32908,12,12500,49099,1292,121600,9156,3885,7891,711,2829,2993,1000,358,4115,3899,216,3899,3092,807,2017-01-01,zipcode,Palm bay
ZCTA5 32909,12,30468,50071,991,123100,24208,9424,21027,2016,7295,7935,2317,1464,12266,10708,1558,10708,8416,2292,2017-01-01,zipcode,Palm bay
ZCTA5 32920,12,10077,41406,834,202400,9149,4968,8437,574,2310,3041,1403,1109,8852,5299,3553,5299,2985,2314,2017-01-01,zipcode,Cape canaveral
ZCTA5 32922,12,15392,27201,694,87800,11753,5236,9569,1982,2953,3212,941,481,7348,5765,1583,5765,2364,3401,2017-01-01,zipcode,Cocoa
ZCTA5 32925,12,1442,51458,1365,-666666666,1090,382,789,46,118,342,193,90,471,421,50,421,0,421,2017-01-01,zipcode,Patrick afb
ZCTA5 32926,12,23373,46081,889,136800,19391,8883,16694,2206,5199,6104,2233,952,10135,8507,1628,8507,6744,1763,2017-01-01,zipcode,Cocoa
ZCTA5 32927,12,26401,60480,1026,122700,21568,8016,18696,1927,6189,7056,2353,1171,11133,9241,1892,9241,7866,1375,2017-01-01,zipcode,Cocoa
ZCTA5 32931,12,14112,55352,1083,295100,12860,6719,11840,404,2569,3758,3266,1843,10859,7077,3782,7077,4681,2396,2017-01-01,zipcode,Cocoa beach
ZCTA5 32934,12,17802,64367,1125,214800,15390,6955,13801,1102,3225,4701,2299,2474,7806,7175,631,7175,6055,1120,2017-01-01,zipcode,Melbourne
ZCTA5 32935,12,41704,44247,924,123500,34659,14285,31134,2931,10142,11430,4316,2315,20206,17495,2711,17495,10388,7107,2017-01-01,zipcode,Melbourne
ZCTA5 32937,12,26604,63803,1234,243000,22247,9665,19896,721,4427,6344,4979,3425,13478,11131,2347,11131,8280,2851,2017-01-01,zipcode,Satellite beach
ZCTA5 32940,12,38683,69508,1335,243900,32170,15765,28358,1183,4967,9286,7093,5829,16593,14939,1654,14939,12412,2527,2017-01-01,zipcode,Melbourne
ZCTA5 32948,12,8035,38998,782,154800,5905,2490,4646,1871,1155,1060,462,98,2469,2055,414,2055,1445,610,2017-01-01,zipcode,Fellsmere
ZCTA5 32949,12,2508,53650,-666666666,288600,2043,913,1882,101,577,741,202,261,1122,915,207,915,864,51,2017-01-01,zipcode,Grant
ZCTA5 32950,12,4196,62383,870,254000,3709,1618,3230,136,1027,1083,707,277,1834,1685,149,1685,1580,105,2017-01-01,zipcode,Malabar
ZCTA5 32951,12,11134,70575,1335,301800,10023,5372,9508,328,2008,2927,2496,1749,7065,5051,2014,5051,4246,805,2017-01-01,zipcode,Melbourne beach
ZCTA5 32952,12,20599,68646,1108,240200,17486,6993,15729,694,3793,5232,3588,2422,9643,8400,1243,8400,6797,1603,2017-01-01,zipcode,Merritt island
ZCTA5 32953,12,23578,51989,912,219100,19980,8912,17538,1429,4716,6157,3341,1895,11233,9672,1561,9672,6784,2888,2017-01-01,zipcode,Merritt island
ZCTA5 32955,12,37979,65039,1168,179200,31649,12986,28407,1518,7182,10174,5866,3667,17317,15120,2197,15120,11277,3843,2017-01-01,zipcode,Rockledge
ZCTA5 32958,12,27439,48087,993,155800,23745,13171,21871,2463,8404,6651,2802,1551,13727,11026,2701,11026,8889,2137,2017-01-01,zipcode,Sebastian
ZCTA5 32960,12,21323,36318,847,137300,18155,8371,15957,1871,5628,4886,2331,1241,11210,8453,2757,8453,4717,3736,2017-01-01,zipcode,Vero beach
ZCTA5 32962,12,24429,46272,927,119800,20528,9236,18309,2468,5549,6579,2493,1220,12730,9186,3544,9186,7001,2185,2017-01-01,zipcode,Vero beach
ZCTA5 32963,12,15039,98265,1313,580600,14088,9279,13529,301,1377,3185,4717,3949,12298,7344,4954,7344,6697,647,2017-01-01,zipcode,Vero beach
ZCTA5 32966,12,16889,44357,998,110500,15145,9444,14055,1341,5140,4060,2010,1504,10795,7723,3072,7723,5605,2118,2017-01-01,zipcode,Vero beach
ZCTA5 32967,12,20782,45586,909,183200,16377,7127,14220,2026,4896,3931,1959,1408,9957,7455,2502,7455,5299,2156,2017-01-01,zipcode,Vero beach
ZCTA5 32968,12,13738,72847,1126,227400,11264,5030,9796,666,2459,3153,2472,1046,5182,4573,609,4573,4198,375,2017-01-01,zipcode,Vero beach
ZCTA5 32970,12,327,11786,-666666666,59900,222,189,222,0,155,0,17,50,152,116,36,116,83,33,2017-01-01,zipcode,Wabasso
ZCTA5 32976,12,8900,33914,767,79000,8361,6059,8080,1157,3413,2491,705,314,6544,4533,2011,4533,3940,593,2017-01-01,zipcode,Sebastian
ZCTA5 33001,12,212,41094,1688,283300,207,72,201,19,87,57,29,9,700,142,558,142,102,40,2017-01-01,zipcode,Long key
ZCTA5 33004,12,16945,42146,1193,183700,14147,4832,12368,1622,3757,4152,1892,945,8609,6722,1887,6722,3109,3613,2017-01-01,zipcode,Dania
ZCTA5 33009,12,41250,35731,1157,170900,34896,14208,31588,4831,8639,8615,5890,3613,30440,18751,11689,18751,9891,8860,2017-01-01,zipcode,Hallandale
ZCTA5 33010,12,47500,25539,929,180300,40326,18213,35804,11398,13711,6563,3293,839,15794,15146,648,15146,4666,10480,2017-01-01,zipcode,Hialeah
ZCTA5 33012,12,75992,31010,1058,174400,65507,29465,58104,16929,20057,12832,6108,2178,24884,23840,1044,23840,11079,12761,2017-01-01,zipcode,Hialeah
ZCTA5 33013,12,34180,31145,1067,200500,29667,13867,26693,9232,9929,4588,2257,687,9928,9578,350,9578,5557,4021,2017-01-01,zipcode,Hialeah
ZCTA5 33014,12,40690,36257,1173,213400,33641,14268,29579,6504,9290,7782,4073,1930,14699,13800,899,13800,5917,7883,2017-01-01,zipcode,Hialeah
ZCTA5 33015,12,66343,48450,1259,221100,53655,17891,45438,6414,14197,14521,7126,3180,22480,21053,1427,21053,11466,9587,2017-01-01,zipcode,Hialeah
ZCTA5 33016,12,52124,43579,1274,171900,42654,15719,36111,7999,12187,8445,5538,1942,15255,14680,575,14680,8011,6669,2017-01-01,zipcode,Hialeah
ZCTA5 33018,12,50119,54232,1442,224000,41360,14334,35483,7059,11457,9177,5473,2317,13789,13378,411,13378,9963,3415,2017-01-01,zipcode,Hialeah
ZCTA5 33019,12,14956,77043,1468,393800,13013,5723,12204,757,2239,3422,2968,2818,12456,6816,5640,6816,5072,1744,2017-01-01,zipcode,Hollywood
ZCTA5 33020,12,44667,38090,991,174500,36686,11381,32132,4460,10357,10103,4977,2235,21564,18217,3347,18217,6237,11980,2017-01-01,zipcode,Hollywood
ZCTA5 33021,12,47461,55532,1222,240400,38878,14617,34401,4379,8936,11071,6136,3879,21323,17847,3476,17847,11726,6121,2017-01-01,zipcode,Hollywood
ZCTA5 33023,12,71766,47284,1203,170200,56232,17976,46840,8488,15968,15227,4977,2180,21732,20191,1541,20191,13217,6974,2017-01-01,zipcode,Hollywood
ZCTA5 33024,12,74780,56172,1296,196100,59429,17614,50667,6208,16816,15851,7931,3861,25966,23433,2533,23433,15731,7702,2017-01-01,zipcode,Hollywood
ZCTA5 33025,12,68450,55708,1382,201600,55115,16544,47701,3114,13606,18241,8188,4552,27231,23332,3899,23332,10983,12349,2017-01-01,zipcode,Hollywood
ZCTA5 33026,12,30962,70224,1684,240500,25406,8319,22078,1351,4416,7304,5537,3470,12128,11120,1008,11120,9100,2020,2017-01-01,zipcode,Hollywood
ZCTA5 33027,12,60467,65510,1425,297200,49679,20064,43675,2875,10281,14613,9659,6247,24106,21093,3013,21093,16881,4212,2017-01-01,zipcode,Hollywood
ZCTA5 33028,12,28498,98245,2026,350900,22491,6665,18583,986,2916,5986,5404,3291,9144,8191,953,8191,6370,1821,2017-01-01,zipcode,Pembroke pines
ZCTA5 33029,12,48169,100919,2452,354000,37927,12497,30725,2067,5950,9899,7654,5155,14282,12931,1351,12931,11305,1626,2017-01-01,zipcode,Hollywood
ZCTA5 33030,12,34967,36069,955,171300,25357,9634,21232,8288,6044,4560,1538,802,9920,9167,753,9167,3711,5456,2017-01-01,zipcode,Homestead
ZCTA5 33031,12,6676,71404,1560,346400,4931,1544,4174,896,1210,1168,442,458,1884,1725,159,1725,1468,257,2017-01-01,zipcode,Homestead
ZCTA5 33032,12,45380,44415,1199,176300,33754,11285,27215,5981,7428,7949,4054,1803,12797,11814,983,11814,6619,5195,2017-01-01,zipcode,Homestead
ZCTA5 33033,12,57924,43369,1213,163300,42491,16447,34736,9393,9742,9577,4264,1760,16304,14954,1350,14954,7627,7327,2017-01-01,zipcode,Homestead
ZCTA5 33034,12,23041,36572,949,97500,17244,8920,14601,6260,4389,3005,677,270,5653,4812,841,4812,1720,3092,2017-01-01,zipcode,Homestead
ZCTA5 33035,12,16688,49655,1398,162700,11807,3234,9738,1195,2536,2923,1935,1149,5482,4574,908,4574,1940,2634,2017-01-01,zipcode,Homestead
ZCTA5 33036,12,3364,72148,1362,645100,3147,1420,2931,129,821,1009,658,314,3602,1483,2119,1483,1178,305,2017-01-01,zipcode,Islamorada
ZCTA5 33037,12,11105,63623,1383,389200,9731,4295,9078,780,2485,2873,1591,1349,10643,4526,6117,4526,3426,1100,2017-01-01,zipcode,Key largo
ZCTA5 33039,12,442,75727,-666666666,259400,391,31,315,84,142,55,16,18,124,110,14,110,110,0,2017-01-01,zipcode,Homestead
ZCTA5 33040,12,34713,62663,1640,463000,29364,8740,25930,2708,7234,8100,4737,3151,17933,12815,5118,12815,5556,7259,2017-01-01,zipcode,Key west
ZCTA5 33042,12,6609,80160,1694,457200,5940,2274,5577,285,1393,1683,1474,742,4938,2892,2046,2892,2131,761,2017-01-01,zipcode,Summerland key
ZCTA5 33043,12,5385,57399,1325,357300,4861,1620,4351,272,1247,1563,901,368,3071,2142,929,2142,1484,658,2017-01-01,zipcode,Big pine key
ZCTA5 33050,12,9475,55032,1278,367900,8130,3224,6894,625,2130,2154,1356,629,6669,3748,2921,3748,2196,1552,2017-01-01,zipcode,Marathon
ZCTA5 33051,12,670,79167,1332,487500,670,332,670,39,182,164,154,131,1463,368,1095,368,225,143,2017-01-01,zipcode,Key colony beach
ZCTA5 33054,12,32768,21977,856,117500,25409,12379,20735,5219,9044,4622,1397,453,10526,9205,1321,9205,4285,4920,2017-01-01,zipcode,Opa locka
ZCTA5 33055,12,45389,42950,1305,163600,36542,14690,31133,6696,12573,7168,3056,1640,12050,11372,678,11372,8561,2811,2017-01-01,zipcode,Opa locka
ZCTA5 33056,12,35055,38330,1126,147100,27652,10828,22755,4426,8066,7203,2126,934,10756,9744,1012,9744,6179,3565,2017-01-01,zipcode,Miami gardens
ZCTA5 33060,12,36288,41007,1084,206100,28429,11050,24313,4836,7811,7108,2994,1564,14606,12624,1982,12624,5471,7153,2017-01-01,zipcode,Pompano beach
ZCTA5 33062,12,22012,60029,1269,324500,20382,9879,19497,1384,4330,5529,4960,3294,21463,11877,9586,11877,8189,3688,2017-01-01,zipcode,Pompano beach
ZCTA5 33063,12,54383,44159,1338,152900,45818,15561,40940,5132,13982,13051,6361,2414,25782,21434,4348,21434,14588,6846,2017-01-01,zipcode,Pompano beach
ZCTA5 33064,12,61076,48506,1194,159100,48211,15533,41706,7608,14090,10718,6758,2532,24216,20360,3856,20360,13112,7248,2017-01-01,zipcode,Pompano beach
ZCTA5 33065,12,55913,51736,1219,232400,42819,12070,35317,4055,9309,11988,7204,2761,19308,17586,1722,17586,9102,8484,2017-01-01,zipcode,Coral springs
ZCTA5 33066,12,17137,47509,1178,109400,15230,7833,14092,1158,3987,4097,2829,2021,10931,8578,2353,8578,6874,1704,2017-01-01,zipcode,Pompano beach
ZCTA5 33067,12,29289,97880,1615,413300,22774,6056,19218,628,3324,5522,5541,4203,9929,9125,804,9125,6507,2618,2017-01-01,zipcode,Pompano beach
ZCTA5 33068,12,51978,44154,1311,150800,40290,11005,33495,5582,13420,9279,3554,1660,17455,15545,1910,15545,8636,6909,2017-01-01,zipcode,Pompano beach
ZCTA5 33069,12,27302,43921,1249,141200,23898,11350,20926,3153,6893,5578,3611,1691,14335,10385,3950,10385,5105,5280,2017-01-01,zipcode,Pompano beach
ZCTA5 33070,12,5177,54487,1509,453500,4474,1841,4063,389,1018,1292,919,445,4328,2051,2277,2051,1422,629,2017-01-01,zipcode,Tavernier
ZCTA5 33071,12,38686,79833,1470,329400,30889,9211,25915,1441,5176,8630,6811,3857,13304,12596,708,12596,8109,4487,2017-01-01,zipcode,Coral springs
ZCTA5 33073,12,33154,71361,1592,289100,25511,6433,21362,1171,6320,6608,5279,1984,11915,10840,1075,10840,6291,4549,2017-01-01,zipcode,Pompano beach
ZCTA5 33076,12,35123,121458,2320,462100,26194,8332,22153,857,3250,5634,7656,4756,11687,11006,681,11006,8803,2203,2017-01-01,zipcode,Pompano beach
ZCTA5 33101,12,0,-666666666,-666666666,-666666666,0,0,0,0,0,0,0,0,0,0,0,0,0,0,2017-01-01,zipcode,Miami
ZCTA5 33109,12,431,177000,-666666666,2000001,431,267,431,0,36,14,240,141,931,264,667,264,222,42,2017-01-01,zipcode,Miami beach
ZCTA5 33122,12,402,66658,2071,-666666666,292,118,253,0,0,170,42,41,164,115,49,115,0,115,2017-01-01,zipcode,Miami
ZCTA5 33125,12,61036,25815,974,190300,51610,22553,45463,15777,16309,7698,4215,1464,22167,20356,1811,20356,5434,14922,2017-01-01,zipcode,Miami
ZCTA5 33126,12,53962,34088,1171,167300,46169,17016,40259,9031,14043,8792,6203,2190,19660,17988,1672,17988,5973,12015,2017-01-01,zipcode,Miami
ZCTA5 33127,12,32051,27807,930,165500,24857,10378,21073,6561,7113,4316,2272,811,10898,9608,1290,9608,2616,6992,2017-01-01,zipcode,Miami
ZCTA5 33128,12,7313,19138,764,-666666666,6203,2697,5493,2151,1894,882,414,152,3363,3040,323,3040,226,2814,2017-01-01,zipcode,Miami
ZCTA5 33129,12,12559,74755,1778,438800,10727,3186,9827,666,1027,1753,3425,2956,8472,5911,2561,5911,2698,3213,2017-01-01,zipcode,Miami
ZCTA5 33130,12,25924,27033,984,272600,21913,7679,19632,5209,5493,3551,2963,2416,14848,11596,3252,11596,1696,9900,2017-01-01,zipcode,Miami
ZCTA5 33131,12,16593,80539,2161,452400,14516,3458,13247,234,903,1773,5385,4952,14829,9158,5671,9158,2965,6193,2017-01-01,zipcode,Miami
ZCTA5 33132,12,11816,69973,1886,459100,11059,4006,9718,929,1509,1911,3122,2247,9112,5737,3375,5737,1406,4331,2017-01-01,zipcode,Miami
ZCTA5 33133,12,34421,63428,1368,548500,28146,9845,25523,2462,5418,5065,6806,5772,16542,13377,3165,13377,6468,6909,2017-01-01,zipcode,Miami
ZCTA5 33134,12,42496,65197,1304,432800,36761,12595,33481,3667,6605,8145,8170,6894,18508,16251,2257,16251,8688,7563,2017-01-01,zipcode,Miami
ZCTA5 33135,12,39502,25707,942,246700,33771,14163,30080,8940,11416,4660,3517,1547,15484,14412,1072,14412,2991,11421,2017-01-01,zipcode,Miami
ZCTA5 33136,12,13931,22864,784,154100,11509,4509,9879,2610,3293,2339,1169,468,6723,5465,1258,5465,780,4685,2017-01-01,zipcode,Miami
ZCTA5 33137,12,23316,57690,1512,308200,20252,5148,17946,2314,3790,4469,4512,2861,11566,9559,2007,9559,2574,6985,2017-01-01,zipcode,Miami
ZCTA5 33138,12,30151,43607,897,387000,24565,8498,22244,4618,4331,5457,4863,2975,13651,11925,1726,11925,5435,6490,2017-01-01,zipcode,Miami
ZCTA5 33139,12,38154,50565,1367,386200,33678,9005,31440,3149,5902,6922,8491,6976,33247,20521,12726,20521,6963,13558,2017-01-01,zipcode,Miami beach
ZCTA5 33140,12,22044,75257,1607,592900,18062,7048,16560,1382,2390,3596,4589,4603,17920,9375,8545,9375,5373,4002,2017-01-01,zipcode,Miami beach
ZCTA5 33141,12,40391,43439,1192,292700,35110,9947,31388,4114,7855,7850,7031,4538,23729,18112,5617,18112,5489,12623,2017-01-01,zipcode,Miami beach
ZCTA5 33142,12,56468,23346,870,139000,44403,20227,37985,12634,14130,7216,2832,1173,20944,18575,2369,18575,4881,13694,2017-01-01,zipcode,Miami
ZCTA5 33143,12,32153,65581,1244,529300,26293,8112,23361,1483,3929,6303,6656,4990,13759,11962,1797,11962,6586,5376,2017-01-01,zipcode,Miami
ZCTA5 33144,12,29466,42306,1236,261200,26015,10234,23424,5413,7422,5772,3343,1474,9171,8872,299,8872,5389,3483,2017-01-01,zipcode,Miami
ZCTA5 33145,12,32286,46856,1366,313800,27810,9817,24894,5013,7321,5028,4523,3009,12806,11367,1439,11367,5731,5636,2017-01-01,zipcode,Miami
ZCTA5 33146,12,15713,116536,2229,827800,13501,6307,7863,328,662,1385,2330,3158,4991,4018,973,4018,3020,998,2017-01-01,zipcode,Miami
ZCTA5 33147,12,47168,30000,949,118800,36922,16358,31332,8708,12493,7386,1887,858,15668,13704,1964,13704,6491,7213,2017-01-01,zipcode,Miami
ZCTA5 33149,12,13074,128563,2721,1137100,9734,4082,8737,123,596,1518,3453,3047,7640,4602,3038,4602,3347,1255,2017-01-01,zipcode,Key biscayne
ZCTA5 33150,12,28836,27231,837,161500,21860,8762,18378,5167,6232,4499,1563,917,10313,9085,1228,9085,3012,6073,2017-01-01,zipcode,Miami
ZCTA5 33154,12,14775,70848,1747,565700,11314,4517,10320,541,1149,2781,3490,2359,10585,6242,4343,6242,3218,3024,2017-01-01,zipcode,Miami beach
ZCTA5 33155,12,46324,60853,1304,300900,39209,14614,34476,5719,8833,8851,6846,4227,15249,14260,989,14260,10370,3890,2017-01-01,zipcode,Miami
ZCTA5 33156,12,33923,107244,1543,812700,26974,10200,22616,1117,3047,4729,6752,6971,12773,10886,1887,10886,7860,3026,2017-01-01,zipcode,Miami
ZCTA5 33157,12,69127,60325,1118,252800,54352,20529,45788,7129,13688,11894,8747,4330,20982,19371,1611,19371,12992,6379,2017-01-01,zipcode,Miami
ZCTA5 33158,12,6501,154868,2382,608300,5079,1936,4252,127,339,696,1319,1771,2261,2046,215,2046,1938,108,2017-01-01,zipcode,Miami
ZCTA5 33160,12,41045,50070,1456,276900,35969,14995,33182,2030,5728,11106,7982,6336,36594,19409,17185,19409,10804,8605,2017-01-01,zipcode,North miami beach
ZCTA5 33161,12,56540,36051,1035,189900,44889,16393,37127,9672,10450,10007,4983,2015,18120,16132,1988,16132,6302,9830,2017-01-01,zipcode,Miami
ZCTA5 33162,12,47349,40932,1037,164800,37790,13729,31012,7161,9025,9300,4011,1515,14799,12912,1887,12912,6894,6018,2017-01-01,zipcode,Miami
ZCTA5 33165,12,57357,46844,1301,265300,49068,19637,42957,8575,14650,8895,7441,3396,17201,16410,791,16410,11159,5251,2017-01-01,zipcode,Miami
ZCTA5 33166,12,24406,51738,1165,296100,20776,8228,18148,2336,5211,5163,3429,2009,9017,7653,1364,7653,3795,3858,2017-01-01,zipcode,Miami
ZCTA5 33167,12,20503,39931,1092,161000,16773,6742,13866,3686,4924,3604,1117,535,6043,5763,280,5763,3150,2613,2017-01-01,zipcode,Miami
ZCTA5 33168,12,28886,43036,1275,161100,23536,8828,19238,5061,6568,4914,1853,842,7233,6734,499,6734,4803,1931,2017-01-01,zipcode,Miami
ZCTA5 33169,12,40106,41999,1052,166900,31090,10836,26150,5073,8225,8313,2883,1656,13243,11635,1608,11635,6237,5398,2017-01-01,zipcode,Miami
ZCTA5 33170,12,14399,41207,1158,226600,10705,5054,8983,1621,3212,2284,1435,431,4057,3832,225,3832,2184,1648,2017-01-01,zipcode,Miami
ZCTA5 33172,12,43085,44368,1378,142300,35959,12526,31412,6036,9422,7222,6043,2689,15396,13648,1748,13648,6118,7530,2017-01-01,zipcode,Miami
ZCTA5 33173,12,31824,65482,1388,278800,26699,9841,23657,2564,5208,6504,5757,3624,12073,10999,1074,10999,7737,3262,2017-01-01,zipcode,Miami
ZCTA5 33174,12,34162,46390,1235,221400,30042,12403,24157,6048,6420,5144,4552,1993,9891,9366,525,9366,5460,3906,2017-01-01,zipcode,Miami
ZCTA5 33175,12,54144,51582,1447,262400,46848,18897,40820,7180,13746,10195,6743,2956,16104,15300,804,15300,11574,3726,2017-01-01,zipcode,Miami
ZCTA5 33176,12,52828,67866,1338,362500,43873,15333,38248,3460,8804,11161,8326,6497,18755,17213,1542,17213,11624,5589,2017-01-01,zipcode,Miami
ZCTA5 33177,12,58683,55444,1371,210100,48156,18292,40236,7639,13513,10221,6610,2253,15063,14394,669,14394,10713,3681,2017-01-01,zipcode,Miami
ZCTA5 33178,12,49430,78690,1900,350400,36901,11961,31168,1527,5328,7660,10800,5853,18541,14287,4254,14287,7326,6961,2017-01-01,zipcode,Miami
ZCTA5 33179,12,45094,44241,1171,136600,36472,12861,31256,4209,7909,10147,5580,3411,18100,15678,2422,15678,9659,6019,2017-01-01,zipcode,Miami
ZCTA5 33180,12,31878,65374,1776,361300,27068,11725,24827,1214,3146,7393,7953,5121,24119,14872,9247,14872,9594,5278,2017-01-01,zipcode,Miami
ZCTA5 33181,12,19462,44305,1148,236200,16499,5756,13842,1620,3763,4099,2908,1452,9006,7321,1685,7321,2773,4548,2017-01-01,zipcode,Miami
ZCTA5 33182,12,18173,70500,1787,293600,15601,8137,13206,2955,3803,3048,2381,1019,4003,3854,149,3854,3361,493,2017-01-01,zipcode,Miami
ZCTA5 33183,12,39100,53546,1413,207100,32445,11727,27941,3591,7727,8948,5386,2289,12527,11938,589,11938,7894,4044,2017-01-01,zipcode,Miami
ZCTA5 33184,12,22896,50493,1333,213100,19957,8100,17459,4500,4566,3601,3639,1153,6731,6406,325,6406,4856,1550,2017-01-01,zipcode,Miami
ZCTA5 33185,12,31647,80429,2097,323700,25822,8777,21842,2471,5518,6005,5747,2101,8341,8052,289,8052,6895,1157,2017-01-01,zipcode,Miami
ZCTA5 33186,12,71260,64907,1573,252900,57877,19395,49693,3911,11749,17511,10843,5679,23350,21505,1845,21505,14847,6658,2017-01-01,zipcode,Miami
ZCTA5 33187,12,18613,74902,1805,294300,15045,5065,12729,2191,3152,3634,2650,1102,5197,4973,224,4973,4538,435,2017-01-01,zipcode,Miami
ZCTA5 33189,12,27231,53438,994,218300,21102,6770,18124,2549,5522,5405,3240,1408,8503,7763,740,7763,4721,3042,2017-01-01,zipcode,Miami
ZCTA5 33190,12,15802,59123,1210,228700,11711,3297,9704,976,1998,3528,2322,880,4796,4478,318,4478,1993,2485,2017-01-01,zipcode,Miami
ZCTA5 33193,12,51417,54132,1371,230500,42442,15432,35403,6708,9138,8599,8585,2373,14982,14383,599,14383,9354,5029,2017-01-01,zipcode,Miami
ZCTA5 33194,12,7867,94535,1737,296800,6333,3466,5272,1183,1339,1381,857,512,1453,1453,0,1453,1184,269,2017-01-01,zipcode,Miami
ZCTA5 33196,12,49857,73382,1737,275700,40366,13554,33458,3297,6505,11780,8430,3446,14416,13241,1175,13241,8751,4490,2017-01-01,zipcode,Miami
ZCTA5 33301,12,14144,85219,1842,544700,13107,4118,11954,589,1335,2886,4150,2994,10442,7571,2871,7571,3600,3971,2017-01-01,zipcode,Fort lauderdale
ZCTA5 33304,12,18558,50040,1152,354400,16315,4360,15128,1050,3134,4247,4283,2414,12891,9417,3474,9417,3234,6183,2017-01-01,zipcode,Fort lauderdale
ZCTA5 33305,12,12369,62995,1252,372600,11313,3753,10582,324,1905,2766,3623,1964,8265,6568,1697,6568,4247,2321,2017-01-01,zipcode,Fort lauderdale
ZCTA5 33306,12,3380,67180,989,468400,3014,946,2787,23,366,945,817,636,2129,1707,422,1707,1132,575,2017-01-01,zipcode,Fort lauderdale
ZCTA5 33308,12,27141,61917,1271,364700,24874,10820,23673,1217,4925,6062,6769,4700,23324,15195,8129,15195,10532,4663,2017-01-01,zipcode,Fort lauderdale
ZCTA5 33309,12,40183,49872,1170,160900,32262,9757,28421,5079,8830,7963,4300,2249,14145,12776,1369,12776,7814,4962,2017-01-01,zipcode,Fort lauderdale
ZCTA5 33311,12,71227,33453,1050,120700,54756,22245,46334,11684,17355,11758,3751,1786,25837,21987,3850,21987,9094,12893,2017-01-01,zipcode,Fort lauderdale
ZCTA5 33312,12,53365,50603,1227,211100,42727,13616,36778,5773,10809,10422,6565,3209,20769,17828,2941,17828,10084,7744,2017-01-01,zipcode,Fort lauderdale
ZCTA5 33313,12,62625,35760,1070,105100,48067,17283,39310,7783,14612,11409,3374,2132,23975,19558,4417,19558,8404,11154,2017-01-01,zipcode,Fort lauderdale
ZCTA5 33314,12,25243,41936,1213,154700,20904,7480,17051,2553,5492,4659,3500,847,9749,8648,1101,8648,3946,4702,2017-01-01,zipcode,Fort lauderdale
ZCTA5 33315,12,14110,58502,1259,263100,12176,3279,11324,1200,2763,3321,2689,1351,7179,6334,845,6334,3276,3058,2017-01-01,zipcode,Fort lauderdale
ZCTA5 33316,12,9689,53333,1098,573700,8843,3683,8114,771,1564,2003,2179,1597,7800,4962,2838,4962,2898,2064,2017-01-01,zipcode,Fort lauderdale
ZCTA5 33317,12,37678,66468,1235,270100,29844,9923,26382,3151,6746,7505,6046,2934,13310,12317,993,12317,9119,3198,2017-01-01,zipcode,Fort lauderdale
ZCTA5 33319,12,46533,42613,1194,106700,38117,13543,33067,5478,10478,9779,4809,2523,23110,17825,5285,17825,11508,6317,2017-01-01,zipcode,Fort lauderdale
ZCTA5 33321,12,48037,45010,1344,148100,40608,16335,36227,3322,11114,10840,7296,3655,22468,19949,2519,19949,14633,5316,2017-01-01,zipcode,Fort lauderdale
ZCTA5 33322,12,39060,48420,1543,134500,33625,14363,30599,3109,8307,9692,5841,3650,19663,16175,3488,16175,12876,3299,2017-01-01,zipcode,Fort lauderdale
ZCTA5 33323,12,21774,87163,1846,283800,17435,4777,14983,1159,3103,5013,3648,2060,7878,6823,1055,6823,4806,2017,2017-01-01,zipcode,Fort lauderdale
ZCTA5 33324,12,47588,63420,1572,199000,39200,12237,35000,1809,7298,10235,9295,6363,22511,18908,3603,18908,10571,8337,2017-01-01,zipcode,Fort lauderdale
ZCTA5 33325,12,29412,77357,1562,249000,23703,7372,20148,1902,5246,5520,4611,2869,10648,9264,1384,9264,7094,2170,2017-01-01,zipcode,Fort lauderdale
ZCTA5 33326,12,33465,83160,1790,343100,26190,8351,22421,1101,3784,6143,6922,4471,13948,10997,2951,10997,7436,3561,2017-01-01,zipcode,Fort lauderdale
ZCTA5 33327,12,23323,106526,2668,482400,16504,6175,13662,341,1447,3134,5542,3198,7186,6569,617,6569,5198,1371,2017-01-01,zipcode,Fort lauderdale
ZCTA5 33328,12,29310,84712,1442,322700,23471,7538,19703,975,4253,6101,5136,3238,10831,10291,540,10291,8128,2163,2017-01-01,zipcode,Fort lauderdale
ZCTA5 33330,12,15187,112917,2408,504100,12426,4203,10088,588,1933,2872,2542,2153,4942,4675,267,4675,4215,460,2017-01-01,zipcode,Fort lauderdale
ZCTA5 33331,12,24948,107192,2131,443300,19196,5882,16282,646,2353,4533,5244,3506,8131,7430,701,7430,6377,1053,2017-01-01,zipcode,Fort lauderdale
ZCTA5 33332,12,11147,128601,2449,573200,8720,2817,7026,321,849,1825,2193,1838,3609,3175,434,3175,2907,268,2017-01-01,zipcode,Fort lauderdale
ZCTA5 33334,12,29680,50658,1096,233900,25333,6947,22921,3762,6124,6490,4306,2239,14007,12294,1713,12294,6699,5595,2017-01-01,zipcode,Fort lauderdale
ZCTA5 33351,12,35019,54438,1351,182900,27556,7870,22921,2627,6288,7524,4720,1762,12542,11275,1267,11275,5900,5375,2017-01-01,zipcode,Fort lauderdale
ZCTA5 33401,12,27477,46571,1150,212600,23811,8966,19297,2203,5006,5067,4178,2843,16168,11221,4947,11221,4263,6958,2017-01-01,zipcode,West palm beach
ZCTA5 33403,12,12539,43720,1105,153200,10195,3089,8903,1854,2312,2718,1395,624,5099,4415,684,4415,2117,2298,2017-01-01,zipcode,West palm beach
ZCTA5 33404,12,28348,41172,1081,129700,22594,9126,19313,3189,6301,5333,2841,1649,15202,9947,5255,9947,5426,4521,2017-01-01,zipcode,West palm beach
ZCTA5 33405,12,20555,46382,1132,226400,16883,5596,15001,3947,3954,3124,2551,1425,8408,7180,1228,7180,4013,3167,2017-01-01,zipcode,West palm beach
ZCTA5 33406,12,25441,57219,1203,176800,20325,6797,17459,2656,5112,5433,3319,939,9277,8389,888,8389,5229,3160,2017-01-01,zipcode,West palm beach
ZCTA5 33407,12,30218,37102,1026,153600,23609,7667,20346,4448,5974,5246,2894,1784,13194,10659,2535,10659,4582,6077,2017-01-01,zipcode,West palm beach
ZCTA5 33408,12,17903,66796,1235,315000,16024,7415,14792,953,3014,4100,4245,2480,12309,8799,3510,8799,6588,2211,2017-01-01,zipcode,North palm beach
ZCTA5 33409,12,32693,45459,1137,137000,25585,8225,21277,3543,5948,6055,3984,1747,13291,11077,2214,11077,4909,6168,2017-01-01,zipcode,West palm beach
ZCTA5 33410,12,35904,66682,1450,286700,30921,11334,28079,2153,6570,8333,7300,3723,17312,15188,2124,15188,9910,5278,2017-01-01,zipcode,Palm beach gardens
ZCTA5 33411,12,70441,67548,1313,247300,56840,20412,49182,4671,13628,15292,9893,5698,28079,23765,4314,23765,17605,6160,2017-01-01,zipcode,West palm beach
ZCTA5 33412,12,14140,86023,1827,311500,12118,5051,10726,680,2633,3389,2457,1567,6315,5100,1215,5100,4380,720,2017-01-01,zipcode,West palm beach
ZCTA5 33413,12,16457,58814,1371,216400,12802,4460,10625,1554,2806,3539,1723,1003,5414,4951,463,4951,3149,1802,2017-01-01,zipcode,West palm beach
ZCTA5 33414,12,60452,81949,1681,330900,46812,15850,39996,2023,8269,12344,10856,6504,23641,19620,4021,19620,14357,5263,2017-01-01,zipcode,Wellington
ZCTA5 33415,12,50843,38750,1096,99900,39495,13293,32827,7248,11871,8575,3915,1218,19018,16342,2676,16342,9008,7334,2017-01-01,zipcode,West palm beach
ZCTA5 33417,12,32707,33880,1042,67100,26419,11082,23199,4222,7556,6674,3542,1205,18777,13933,4844,13933,8185,5748,2017-01-01,zipcode,West palm beach
ZCTA5 33418,12,39226,86445,1580,367800,33853,14240,31167,1302,5481,8702,9050,6632,20966,16467,4499,16467,12973,3494,2017-01-01,zipcode,Palm beach gardens
ZCTA5 33426,12,23009,54990,1496,165100,19673,6828,17104,1512,4898,6230,3075,1389,11472,9443,2029,9443,5778,3665,2017-01-01,zipcode,Boynton beach
ZCTA5 33428,12,41069,65041,1514,246400,33177,11048,28188,2255,7513,8816,6323,3281,15531,13630,1901,13630,9717,3913,2017-01-01,zipcode,Boca raton
ZCTA5 33430,12,22383,25830,617,110400,16847,7504,13316,5167,4174,2776,791,408,8432,7253,1179,7253,2423,4830,2017-01-01,zipcode,Belle glade
ZCTA5 33431,12,19720,64096,1546,356500,17228,7349,13075,610,2540,3241,3927,2757,9251,7222,2029,7222,4857,2365,2017-01-01,zipcode,Boca raton
ZCTA5 33432,12,19894,64599,1463,568200,18299,7384,15942,891,2584,4454,4340,3673,14825,9969,4856,9969,6070,3899,2017-01-01,zipcode,Boca raton
ZCTA5 33433,12,41433,59226,1665,274300,35232,15807,31362,1196,6403,9130,8925,5708,23290,18714,4576,18714,12283,6431,2017-01-01,zipcode,Boca raton
ZCTA5 33434,12,20497,56228,975,218000,18250,9936,17082,1149,3327,4501,4713,3392,13777,9690,4087,9690,8036,1654,2017-01-01,zipcode,Boca raton
ZCTA5 33435,12,35264,43857,1347,139800,29800,11777,25907,4335,7735,7303,4345,2189,18474,13694,4780,13694,8037,5657,2017-01-01,zipcode,Boynton beach
ZCTA5 33436,12,44143,53919,1385,190300,37165,15319,33840,3167,8666,10350,8229,3428,21891,17922,3969,17922,12803,5119,2017-01-01,zipcode,Boynton beach
ZCTA5 33437,12,38222,60028,1475,256400,34585,21427,32880,1463,7797,9593,7994,6033,21208,18229,2979,18229,15876,2353,2017-01-01,zipcode,Boynton beach
ZCTA5 33438,12,365,49583,-666666666,67700,252,110,218,18,161,25,14,0,181,100,81,100,62,38,2017-01-01,zipcode,Canal point
ZCTA5 33440,12,20004,35989,783,73300,15287,6134,12440,4199,4377,2732,795,337,7687,6347,1340,6347,4111,2236,2017-01-01,zipcode,Clewiston
ZCTA5 33441,12,27214,43670,1129,197000,23010,7933,20258,3293,6400,5505,3670,1390,13867,11285,2582,11285,5535,5750,2017-01-01,zipcode,Deerfield beach
ZCTA5 33442,12,28295,45446,1511,120000,24242,10814,22133,1536,6830,7218,4069,2480,19314,13425,5889,13425,9108,4317,2017-01-01,zipcode,Deerfield beach
ZCTA5 33444,12,23688,50677,1189,248300,19864,6462,17230,4276,4608,4232,2781,1333,9553,8252,1301,8252,4466,3786,2017-01-01,zipcode,Delray beach
ZCTA5 33445,12,31494,51113,1461,178400,27296,10716,23885,2309,5534,6889,5609,3544,16963,13318,3645,13318,8316,5002,2017-01-01,zipcode,Delray beach
ZCTA5 33446,12,24302,53546,981,237700,22267,14594,21602,1271,5382,5674,5337,3938,17238,12713,4525,12713,11023,1690,2017-01-01,zipcode,Delray beach
ZCTA5 33449,12,11584,108415,1926,386600,9293,3769,7683,279,1046,2217,2298,1843,4350,3822,528,3822,3535,287,2017-01-01,zipcode,Lake worth
ZCTA5 33455,12,22741,52988,990,235000,19639,9906,17974,1436,4810,5543,3866,2319,12113,9915,2198,9915,7922,1993,2017-01-01,zipcode,Hobe sound
ZCTA5 33458,12,54945,78826,1480,328000,44029,12984,39091,3171,7598,10929,10999,6394,23051,20565,2486,20565,14569,5996,2017-01-01,zipcode,Jupiter
ZCTA5 33460,12,32617,35915,996,176800,25860,8520,22366,7469,5594,5143,2738,1422,13430,11087,2343,11087,4706,6381,2017-01-01,zipcode,Lake worth
ZCTA5 33461,12,46890,38890,1095,108400,36365,12282,31022,8499,9475,8357,3149,1542,17720,14964,2756,14964,7294,7670,2017-01-01,zipcode,Lake worth
ZCTA5 33462,12,33228,49843,1102,171800,27458,9951,23993,4354,7499,6503,3576,2061,15156,12032,3124,12032,7133,4899,2017-01-01,zipcode,Lake worth
ZCTA5 33463,12,60934,52189,1231,158700,46267,13592,38294,8492,10466,10992,6234,2110,20515,17668,2847,17668,12444,5224,2017-01-01,zipcode,Lake worth
ZCTA5 33467,12,52293,67011,1337,260500,43887,18992,38550,3147,9686,11882,8215,5620,23174,19621,3553,19621,17084,2537,2017-01-01,zipcode,Lake worth
ZCTA5 33469,12,15643,72737,1283,336600,13829,6202,12833,441,2721,3494,4087,2090,8919,7100,1819,7100,6007,1093,2017-01-01,zipcode,Jupiter
ZCTA5 33470,12,25791,82265,1700,277600,21232,6493,17337,2539,5322,5735,2577,1164,8815,7754,1061,7754,7042,712,2017-01-01,zipcode,Loxahatchee
ZCTA5 33471,12,7438,37478,729,79200,6434,3943,5600,1525,2178,1359,376,162,3114,2087,1027,2087,1428,659,2017-01-01,zipcode,Moore haven
ZCTA5 33472,12,19979,72633,2074,257700,17272,8802,15944,417,4007,5075,3895,2550,9009,7946,1063,7946,7220,726,2017-01-01,zipcode,Boynton beach
ZCTA5 33473,12,10777,138661,2877,513300,7638,2679,7005,93,1208,1472,2458,1774,3876,3246,630,3246,2794,452,2017-01-01,zipcode,Boynton beach
ZCTA5 33476,12,8264,24484,552,97000,6156,2776,4948,1815,1436,1210,359,128,2962,2540,422,2540,1120,1420,2017-01-01,zipcode,Pahokee
ZCTA5 33477,12,14253,77578,1456,368800,13361,7867,12775,363,2493,3518,3796,2605,12035,7534,4501,7534,6174,1360,2017-01-01,zipcode,Jupiter
ZCTA5 33478,12,12696,100994,2085,357800,10229,3058,9323,489,2312,2919,2375,1228,4735,4457,278,4457,4252,205,2017-01-01,zipcode,Jupiter
ZCTA5 33480,12,10008,100139,1572,792100,9411,6054,9309,184,1010,2424,3153,2538,11620,5607,6013,5607,4728,879,2017-01-01,zipcode,Palm beach
ZCTA5 33483,12,11809,74258,1476,475100,10716,5129,10119,501,1393,2246,3643,2336,9126,6066,3060,6066,4290,1776,2017-01-01,zipcode,Delray beach
ZCTA5 33484,12,25134,37671,1323,113600,23859,15491,22851,1522,6262,6844,4986,3237,18612,14096,4516,14096,11099,2997,2017-01-01,zipcode,Delray beach
ZCTA5 33486,12,24672,79941,1464,372800,19956,6716,17621,504,3707,4632,5632,3146,10191,9022,1169,9022,6972,2050,2017-01-01,zipcode,Boca raton
ZCTA5 33487,12,19080,79987,1659,359800,16615,7141,15421,562,2327,4567,5015,2950,12077,8731,3346,8731,6847,1884,2017-01-01,zipcode,Boca raton
ZCTA5 33493,12,5491,29286,764,84600,4812,3909,4350,1871,1515,736,156,72,877,622,255,622,295,327,2017-01-01,zipcode,South bay
ZCTA5 33496,12,22124,87510,1729,366700,19325,10405,17575,745,2736,4386,5020,4688,11776,9722,2054,9722,8531,1191,2017-01-01,zipcode,Boca raton
ZCTA5 33498,12,13953,100195,2644,387000,11168,4151,10145,296,1885,2691,2910,2363,5583,5003,580,5003,4700,303,2017-01-01,zipcode,Boca raton
ZCTA5 33503,12,96,-666666666,-666666666,-666666666,96,64,81,62,9,10,0,0,26,26,0,26,26,0,2017-01-01,zipcode,Balm
ZCTA5 33510,12,27899,57397,1046,147600,21947,7749,18924,1478,6142,6326,3593,1385,11084,10166,918,10166,6250,3916,2017-01-01,zipcode,Brandon
ZCTA5 33511,12,58401,58090,1157,173800,46641,14694,40331,2885,9841,14548,8805,4252,23765,21893,1872,21893,10805,11088,2017-01-01,zipcode,Brandon
ZCTA5 33513,12,11995,38362,704,91900,10149,6200,8494,1566,3467,2539,602,320,5067,3766,1301,3766,3034,732,2017-01-01,zipcode,Bushnell
ZCTA5 33514,12,2109,36375,802,75900,1534,667,1259,393,348,454,47,17,753,615,138,615,432,183,2017-01-01,zipcode,Center hill
ZCTA5 33521,12,398,32174,680,92100,338,179,332,45,202,77,8,0,280,178,102,178,145,33,2017-01-01,zipcode,Coleman
ZCTA5 33523,12,17489,42605,782,106700,13936,6232,11821,2167,4352,3440,1180,682,7640,6441,1199,6441,4311,2130,2017-01-01,zipcode,Dade city
ZCTA5 33525,12,19867,50654,793,127900,16801,8259,13920,1867,4758,4381,1876,1038,8725,7324,1401,7324,5302,2022,2017-01-01,zipcode,Dade city
ZCTA5 33527,12,15129,57045,911,214600,11845,4593,10110,3083,3084,2441,1038,464,5204,4732,472,4732,3413,1319,2017-01-01,zipcode,Dover
ZCTA5 33534,12,16570,47948,983,151700,11634,4090,9616,2033,3224,2767,1180,412,5406,4855,551,4855,3016,1839,2017-01-01,zipcode,Gibsonton
ZCTA5 33538,12,4435,34500,590,81900,3813,2042,3452,637,1486,1014,219,96,2909,1880,1029,1880,1396,484,2017-01-01,zipcode,Lake panasoffkee
ZCTA5 33540,12,8515,35027,736,69900,7337,4033,6637,1079,2658,2059,650,191,5281,3784,1497,3784,2669,1115,2017-01-01,zipcode,Zephyrhills
ZCTA5 33541,12,19625,39133,902,68600,17311,10968,16166,2496,6558,4881,1492,739,12624,8896,3728,8896,7092,1804,2017-01-01,zipcode,Zephyrhills
ZCTA5 33542,12,20387,32003,788,67200,17634,10761,16109,2728,6342,5123,1352,564,13405,9656,3749,9656,6705,2951,2017-01-01,zipcode,Zephyrhills
ZCTA5 33543,12,25521,76560,1351,192700,19685,6987,17175,1079,3369,5785,4214,2728,9818,8672,1146,8672,7049,1623,2017-01-01,zipcode,Wesley chapel
ZCTA5 33544,12,25720,78629,1408,228300,19602,5701,16803,1511,3616,4846,4393,2437,9402,8831,571,8831,6141,2690,2017-01-01,zipcode,Wesley chapel
ZCTA5 33545,12,17601,75828,1442,180800,13059,3606,11011,805,2514,3950,2528,1214,5897,5399,498,5399,3944,1455,2017-01-01,zipcode,Wesley chapel
ZCTA5 33547,12,24707,96494,1603,298100,17261,5858,14805,954,2836,3710,4442,2863,8393,7748,645,7748,6369,1379,2017-01-01,zipcode,Lithia
ZCTA5 33548,12,6670,96981,1134,339000,5600,2086,4931,188,1076,1474,1452,741,2596,2414,182,2414,2067,347,2017-01-01,zipcode,Lutz
ZCTA5 33549,12,16931,69438,1067,207100,13980,5027,12110,805,2949,3817,2708,1831,6952,6420,532,6420,4976,1444,2017-01-01,zipcode,Lutz
ZCTA5 33556,12,22535,100110,1202,359300,17824,6431,15790,880,3538,4404,4314,2654,8932,7779,1153,7779,6963,816,2017-01-01,zipcode,Odessa
ZCTA5 33558,12,22113,74380,1014,315200,17093,5511,14694,554,2788,4413,4656,2283,9183,8227,956,8227,5493,2734,2017-01-01,zipcode,Lutz
ZCTA5 33559,12,17480,57783,1052,166200,14199,3961,11412,652,2329,3992,2665,1774,7399,6641,758,6641,3792,2849,2017-01-01,zipcode,Lutz
ZCTA5 33563,12,27552,41347,896,112500,20999,7609,17623,3890,6825,4706,1594,608,11002,9682,1320,9682,5061,4621,2017-01-01,zipcode,Plant city
ZCTA5 33565,12,17511,52367,949,133800,14009,6267,12388,2340,4921,3428,1115,584,6693,5989,704,5989,4658,1331,2017-01-01,zipcode,Plant city
ZCTA5 33566,12,20144,61039,939,169700,15938,5711,13503,2440,4238,3415,2236,1174,7511,6770,741,6770,4976,1794,2017-01-01,zipcode,Plant city
ZCTA5 33567,12,12504,48113,698,177300,9165,3085,7810,2262,2240,1965,973,370,3885,3660,225,3660,2704,956,2017-01-01,zipcode,Plant city
ZCTA5 33569,12,26170,64131,1270,187800,20567,7821,18084,1581,4644,6790,3301,1768,10074,9203,871,9203,7520,1683,2017-01-01,zipcode,Riverview
ZCTA5 33570,12,26436,46970,875,148600,19859,7998,17427,3340,5988,5430,1724,945,11366,8847,2519,8847,6381,2466,2017-01-01,zipcode,Ruskin
ZCTA5 33572,12,17716,78617,1561,238600,14510,5292,13298,817,2719,4793,3193,1776,7900,7048,852,7048,5731,1317,2017-01-01,zipcode,Apollo beach
ZCTA5 33573,12,21334,46434,1794,150900,20345,15973,19994,1045,5858,6913,3430,2748,14454,12263,2191,12263,9881,2382,2017-01-01,zipcode,Sun city center
ZCTA5 33576,12,4284,54980,796,173100,3945,2387,3646,227,1154,1434,437,394,2373,1977,396,1977,1783,194,2017-01-01,zipcode,San antonio
ZCTA5 33578,12,47735,61063,1153,166100,37076,10021,31588,2104,8048,12019,6609,2808,19082,17869,1213,17869,9571,8298,2017-01-01,zipcode,Riverview
ZCTA5 33579,12,32166,80563,1569,191200,23270,6435,19789,1616,4971,6831,4121,2250,10634,9535,1099,9535,7238,2297,2017-01-01,zipcode,Riverview
ZCTA5 33584,12,25905,56994,1058,149200,20397,7284,18070,2049,5987,6100,2812,1122,10005,9076,929,9076,7070,2006,2017-01-01,zipcode,Seffner
ZCTA5 33585,12,1384,41625,-666666666,108700,1056,538,975,117,498,228,96,36,539,453,86,453,411,42,2017-01-01,zipcode,Sumterville
ZCTA5 33592,12,10463,36758,770,96600,8574,3948,7263,1263,2759,1915,965,361,4522,4033,489,4033,2630,1403,2017-01-01,zipcode,Thonotosassa
ZCTA5 33594,12,35437,62958,1277,168100,27778,9959,24408,2166,7212,8290,4581,2159,13392,12429,963,12429,9898,2531,2017-01-01,zipcode,Valrico
ZCTA5 33596,12,29788,96297,1619,243500,23457,7870,20337,763,4201,6176,6001,3196,10390,9910,480,9910,8430,1480,2017-01-01,zipcode,Valrico
ZCTA5 33597,12,8558,45918,802,96000,6983,3162,6153,1362,2183,1851,557,200,3888,3022,866,3022,2531,491,2017-01-01,zipcode,Webster
ZCTA5 33598,12,16072,55752,771,187300,12124,4583,10418,3221,2856,2463,1184,694,5724,5046,678,5046,3725,1321,2017-01-01,zipcode,Wimauma
ZCTA5 33602,12,13929,67945,1570,272000,12312,3803,11023,950,1422,2787,3097,2767,8754,7470,1284,7470,2859,4611,2017-01-01,zipcode,Tampa
ZCTA5 33603,12,20386,40078,897,147600,17017,5368,14622,2403,4459,3861,2731,1168,9395,8377,1018,8377,4501,3876,2017-01-01,zipcode,Tampa
ZCTA5 33604,12,38088,37316,890,118400,30849,10718,26772,5222,9661,6935,3376,1578,16994,14869,2125,14869,7235,7634,2017-01-01,zipcode,Tampa
ZCTA5 33605,12,17801,26121,847,84500,13941,5650,11780,3075,4014,2851,1383,457,8128,6989,1139,6989,2774,4215,2017-01-01,zipcode,Tampa
ZCTA5 33606,12,18926,74855,1285,452900,16832,5659,11657,426,1474,2231,4436,3090,8940,7880,1060,7880,3739,4141,2017-01-01,zipcode,Tampa
ZCTA5 33607,12,24371,40811,1155,120500,19945,7282,17276,3659,5292,3560,3234,1531,12052,10576,1476,10576,4116,6460,2017-01-01,zipcode,Tampa
ZCTA5 33609,12,18573,56830,1106,304000,15648,4395,13440,984,2319,3279,3920,2938,9371,8616,755,8616,4540,4076,2017-01-01,zipcode,Tampa
ZCTA5 33610,12,43494,32913,932,88200,31799,13099,26715,5359,9915,7057,2944,1440,17302,15596,1706,15596,6614,8982,2017-01-01,zipcode,Tampa
ZCTA5 33611,12,32192,64018,1053,222200,26715,8268,24684,1685,5356,6698,6609,4336,16726,14972,1754,14972,8230,6742,2017-01-01,zipcode,Tampa
ZCTA5 33612,12,47083,31101,820,109200,37050,14594,30808,5943,11355,8727,3246,1537,20744,18352,2392,18352,6446,11906,2017-01-01,zipcode,Tampa
ZCTA5 33613,12,34500,29695,792,134200,28943,10236,19873,3580,5144,5513,3842,1794,16463,13988,2475,13988,4260,9728,2017-01-01,zipcode,Tampa
ZCTA5 33614,12,47751,37115,931,134500,38758,12684,32650,6702,11211,8976,4090,1671,20105,18079,2026,18079,6842,11237,2017-01-01,zipcode,Tampa
ZCTA5 33615,12,46195,49163,1024,141500,38184,12860,32789,4284,10880,9251,5781,2593,19820,17352,2468,17352,9663,7689,2017-01-01,zipcode,Tampa
ZCTA5 33616,12,15334,57023,1186,176600,12514,3594,10500,815,3290,3201,2081,1113,7233,6355,878,6355,2829,3526,2017-01-01,zipcode,Tampa
ZCTA5 33617,12,46295,36181,926,139400,36054,12365,28953,2847,8597,8639,5326,3544,20181,18033,2148,18033,6875,11158,2017-01-01,zipcode,Tampa
ZCTA5 33618,12,26654,67325,1031,264400,22393,7481,19669,696,3791,5920,5592,3670,12291,11136,1155,11136,7147,3989,2017-01-01,zipcode,Tampa
ZCTA5 33619,12,38193,39932,1065,91600,30260,12538,25074,5952,8772,6468,2796,1086,13700,12478,1222,12478,5897,6581,2017-01-01,zipcode,Tampa
ZCTA5 33620,12,5359,-666666666,-666666666,-666666666,5359,4245,40,9,0,21,10,0,21,9,12,9,0,9,2017-01-01,zipcode,Tampa
ZCTA5 33621,12,2369,65417,2049,-666666666,1383,351,1029,0,69,472,312,176,628,588,40,588,0,588,2017-01-01,zipcode,Tampa
ZCTA5 33624,12,38139,65189,1135,192000,31620,9438,27355,1698,6639,9097,6379,3542,15834,14697,1137,14697,9722,4975,2017-01-01,zipcode,Tampa
ZCTA5 33625,12,25981,63766,1211,182800,21166,6044,18439,1387,5015,5946,4105,1986,10574,10005,569,10005,6513,3492,2017-01-01,zipcode,Tampa
ZCTA5 33626,12,29471,98903,1380,331900,22061,6056,19698,585,2720,4727,7206,4460,12198,11004,1194,11004,7073,3931,2017-01-01,zipcode,Tampa
ZCTA5 33629,12,25591,105443,1195,446400,19707,6640,17881,479,2089,3470,6445,5398,11446,10382,1064,10382,8221,2161,2017-01-01,zipcode,Tampa
ZCTA5 33634,12,20955,57086,1206,150800,16780,5145,14775,2036,4605,3615,3216,1303,7854,7260,594,7260,4517,2743,2017-01-01,zipcode,Tampa
ZCTA5 33635,12,18068,60303,1301,162300,14429,4272,13025,921,3678,4266,2578,1582,7698,6966,732,6966,4136,2830,2017-01-01,zipcode,Tampa
ZCTA5 33637,12,16732,52987,1047,132500,13565,3519,10586,1055,2756,3213,2275,1287,7389,6284,1105,6284,2572,3712,2017-01-01,zipcode,Tampa
ZCTA5 33647,12,66380,81693,1234,275800,51432,14658,42945,1918,6004,10360,14361,10302,25924,23820,2104,23820,13674,10146,2017-01-01,zipcode,Tampa
ZCTA5 33701,12,15545,34165,816,304200,14193,6238,12792,1287,2726,3271,3119,2389,11521,8701,2820,8701,3010,5691,2017-01-01,zipcode,Saint petersburg
ZCTA5 33702,12,30605,49208,963,137700,25593,8835,22883,2136,6783,7222,4241,2501,15254,12968,2286,12968,8068,4900,2017-01-01,zipcode,Saint petersburg
ZCTA5 33703,12,24784,62206,1160,169900,20568,7311,18642,1410,4243,5825,4447,2717,12009,10479,1530,10479,7820,2659,2017-01-01,zipcode,Saint petersburg
ZCTA5 33704,12,16293,71801,978,327800,13845,4826,12686,610,2159,2909,3883,3125,8567,7310,1257,7310,5064,2246,2017-01-01,zipcode,Saint petersburg
ZCTA5 33705,12,27171,43505,990,155900,22768,9709,19242,2247,5554,5805,3256,2380,13910,10707,3203,10707,5645,5062,2017-01-01,zipcode,Saint petersburg
ZCTA5 33706,12,16195,69691,1104,369100,14756,7038,14017,619,2563,4521,3674,2640,13879,8439,5440,8439,6211,2228,2017-01-01,zipcode,Saint petersburg
ZCTA5 33707,12,24734,43861,988,172100,22258,11162,20699,1775,5661,6285,4555,2423,15785,12315,3470,12315,8158,4157,2017-01-01,zipcode,Saint petersburg
ZCTA5 33708,12,15948,55555,1111,270100,14868,7638,14112,701,3468,4823,3291,1829,13832,8523,5309,8523,6075,2448,2017-01-01,zipcode,Saint petersburg
ZCTA5 33709,12,26285,40387,893,96300,22446,10387,20269,3030,7912,6166,2222,939,14368,11152,3216,11152,7924,3228,2017-01-01,zipcode,Saint petersburg
ZCTA5 33710,12,34043,54984,949,164300,28527,9529,25088,1944,7151,8522,5029,2442,15715,13582,2133,13582,10191,3391,2017-01-01,zipcode,Saint petersburg
ZCTA5 33711,12,19457,38500,1089,135100,15939,7201,12763,1755,4138,3750,1894,1226,9418,7144,2274,7144,4053,3091,2017-01-01,zipcode,Saint petersburg
ZCTA5 33712,12,25072,37821,948,147700,20265,7689,16923,2034,4769,5789,2971,1360,11564,9406,2158,9406,4778,4628,2017-01-01,zipcode,Saint petersburg
ZCTA5 33713,12,32177,50704,1058,135400,27100,8878,23104,3059,6272,7979,4142,1652,14744,12700,2044,12700,8167,4533,2017-01-01,zipcode,Saint petersburg
ZCTA5 33714,12,20179,32970,931,81300,16800,6649,14560,3164,5017,4403,1483,493,10185,8194,1991,8194,4884,3310,2017-01-01,zipcode,Saint petersburg
ZCTA5 33715,12,7282,82010,1493,365000,6723,3941,6437,156,915,1709,2035,1622,6804,3756,3048,3756,3266,490,2017-01-01,zipcode,Saint petersburg
ZCTA5 33716,12,18028,52656,1169,109800,15293,3996,13444,531,2717,4493,3675,2028,10385,8845,1540,8845,1661,7184,2017-01-01,zipcode,Saint petersburg
ZCTA5 33744,12,167,-666666666,-666666666,-666666666,167,147,157,46,79,32,0,0,0,0,0,0,0,0,2017-01-01,zipcode,Bay pines
ZCTA5 33755,12,24948,39820,966,162700,20141,7695,17250,2234,5703,5727,2469,1117,11025,9134,1891,9134,4951,4183,2017-01-01,zipcode,Clearwater
ZCTA5 33756,12,32992,41294,875,162800,26948,11197,23814,3372,5697,8616,4239,1890,16187,13010,3177,13010,7696,5314,2017-01-01,zipcode,Clearwater
ZCTA5 33759,12,18060,48042,1112,151000,14910,6622,13009,1338,4012,3765,2711,1183,9098,7727,1371,7727,4280,3447,2017-01-01,zipcode,Clearwater
ZCTA5 33760,12,17160,45682,967,120000,14178,5106,12194,1774,3935,4200,1604,681,7707,6528,1179,6528,3114,3414,2017-01-01,zipcode,Clearwater
ZCTA5 33761,12,20057,52304,903,151200,17534,8219,16130,748,4243,5544,3878,1717,10478,8904,1574,8904,7054,1850,2017-01-01,zipcode,Clearwater
ZCTA5 33762,12,7666,63500,1210,207100,6889,3502,6211,849,1612,1631,1232,887,3167,2604,563,2604,2039,565,2017-01-01,zipcode,Clearwater
ZCTA5 33763,12,19153,42779,1053,107400,16890,7983,15234,1687,4622,5241,2363,1321,11195,8865,2330,8865,6125,2740,2017-01-01,zipcode,Clearwater
ZCTA5 33764,12,26039,50424,994,156900,22401,9233,20296,1402,6289,6962,3829,1814,14463,11225,3238,11225,7830,3395,2017-01-01,zipcode,Clearwater
ZCTA5 33765,12,14108,40905,957,132000,11908,4199,10708,1303,3330,3948,1483,644,6575,5876,699,5876,2574,3302,2017-01-01,zipcode,Clearwater
ZCTA5 33767,12,7895,69541,1615,410100,7466,4278,7086,343,1594,2046,1674,1429,8458,4205,4253,4205,3350,855,2017-01-01,zipcode,Clearwater beach
ZCTA5 33770,12,25742,42864,964,148600,22316,8914,19949,1979,6536,6922,2903,1609,14202,11822,2380,11822,6677,5145,2017-01-01,zipcode,Largo
ZCTA5 33771,12,29505,37772,922,73100,24989,11132,23183,2552,8331,7598,3413,1289,17395,13889,3506,13889,7430,6459,2017-01-01,zipcode,Largo
ZCTA5 33772,12,22317,49489,1089,170000,19287,8047,17436,1187,5304,6022,3434,1489,12479,10143,2336,10143,7474,2669,2017-01-01,zipcode,Seminole
ZCTA5 33773,12,18163,47183,1010,148000,15334,5988,13650,1388,4557,4476,2212,1017,8568,7315,1253,7315,5193,2122,2017-01-01,zipcode,Largo
ZCTA5 33774,12,18860,48383,976,180200,16009,7244,14358,1176,4353,5093,2486,1250,10039,8089,1950,8089,5714,2375,2017-01-01,zipcode,Largo
ZCTA5 33776,12,12657,69262,1354,252500,10772,4499,9769,280,2546,3117,2442,1384,5679,4990,689,4990,4526,464,2017-01-01,zipcode,Seminole
ZCTA5 33777,12,16997,54045,1197,160100,14265,6302,12907,1114,3967,3945,2299,1582,8281,6906,1375,6906,5341,1565,2017-01-01,zipcode,Seminole
ZCTA5 33778,12,14869,44263,1041,119300,12380,5525,11169,1204,3731,4056,1479,699,7393,5978,1415,5978,4657,1321,2017-01-01,zipcode,Largo
ZCTA5 33781,12,25346,39261,886,126700,20850,8423,18531,2487,7018,5565,2358,1103,11775,10323,1452,10323,6027,4296,2017-01-01,zipcode,Pinellas park
ZCTA5 33782,12,22811,44902,1082,126700,18863,8443,17353,1815,6268,5369,2452,1449,10611,9484,1127,9484,6959,2525,2017-01-01,zipcode,Pinellas park
ZCTA5 33785,12,5546,65647,1275,393500,5147,2362,4856,178,939,1568,1379,792,5929,2982,2947,2982,2047,935,2017-01-01,zipcode,Indian rocks beach
ZCTA5 33786,12,1648,86000,2378,558900,1454,840,1400,45,233,317,484,321,1164,772,392,772,674,98,2017-01-01,zipcode,Belleair beach
ZCTA5 33801,12,35570,33029,788,68800,28791,14308,21846,4526,8100,6256,2237,727,14755,12373,2382,12373,6348,6025,2017-01-01,zipcode,Lakeland
ZCTA5 33803,12,28753,48673,960,129200,23941,10083,21235,1924,6781,5879,4291,2360,14770,11917,2853,11917,7317,4600,2017-01-01,zipcode,Lakeland
ZCTA5 33805,12,25358,32706,913,76000,19688,9076,16419,3082,6214,4658,1656,809,10503,8830,1673,8830,4390,4440,2017-01-01,zipcode,Lakeland
ZCTA5 33809,12,29666,51356,1000,147100,24957,10574,21652,2300,7627,7037,2993,1695,13075,10929,2146,10929,7353,3576,2017-01-01,zipcode,Lakeland
ZCTA5 33810,12,48030,52435,1024,134900,38251,16346,33268,4516,12071,10352,3992,2337,19716,16890,2826,16890,13033,3857,2017-01-01,zipcode,Lakeland
ZCTA5 33811,12,21836,53859,1016,154200,17422,6590,15113,1575,5882,4614,2181,861,8969,7652,1317,7652,5175,2477,2017-01-01,zipcode,Lakeland
ZCTA5 33812,12,12770,76479,1002,164200,9984,3272,8687,631,2482,2708,1787,1079,4944,4266,678,4266,3495,771,2017-01-01,zipcode,Lakeland
ZCTA5 33813,12,36108,78367,1122,187300,29060,11206,25077,1152,6771,6938,6450,3766,13898,12474,1424,12474,10215,2259,2017-01-01,zipcode,Lakeland
ZCTA5 33815,12,14536,31584,738,24300,11448,5478,9894,2255,4687,2060,653,239,7868,5485,2383,5485,2996,2489,2017-01-01,zipcode,Lakeland
ZCTA5 33823,12,30725,45384,846,120500,24196,10989,20733,3567,7414,6100,2339,1313,12411,10402,2009,10402,7525,2877,2017-01-01,zipcode,Auburndale
ZCTA5 33825,12,25425,36123,723,79800,20771,11704,18118,3561,6799,5044,1602,1112,11395,8785,2610,8785,6176,2609,2017-01-01,zipcode,Avon park
ZCTA5 33827,12,2834,58438,881,132300,2299,1181,1758,224,601,558,208,167,1180,839,341,839,713,126,2017-01-01,zipcode,Babson park
ZCTA5 33830,12,27651,48642,820,99600,21955,9149,18568,2598,7829,4818,2431,892,11186,9198,1988,9198,6180,3018,2017-01-01,zipcode,Bartow
ZCTA5 33834,12,7837,38912,680,80600,6080,3648,4984,1702,2084,775,356,67,2218,1689,529,1689,1122,567,2017-01-01,zipcode,Bowling green
ZCTA5 33837,12,25218,52344,1116,150300,19944,8945,17389,2387,5204,6088,2642,1068,11606,8158,3448,8158,5930,2228,2017-01-01,zipcode,Davenport
ZCTA5 33838,12,4011,35674,870,102400,2816,1374,2450,696,832,729,139,54,1673,1258,415,1258,677,581,2017-01-01,zipcode,Dundee
ZCTA5 33839,12,2984,41733,823,99900,2251,894,1949,408,738,569,163,71,1185,1054,131,1054,689,365,2017-01-01,zipcode,Eagle lake
ZCTA5 33841,12,8658,41992,719,77600,6605,3015,5677,1053,2653,1244,503,224,3691,2724,967,2724,2071,653,2017-01-01,zipcode,Fort meade
ZCTA5 33843,12,12049,41207,726,72300,10121,6530,8219,2335,3004,1940,534,406,5284,3428,1856,3428,2706,722,2017-01-01,zipcode,Frostproof
ZCTA5 33844,12,35692,36416,819,107900,27396,12907,23898,5796,8888,6314,2010,890,16835,11755,5080,11755,7621,4134,2017-01-01,zipcode,Haines city
ZCTA5 33847,12,169,45469,-666666666,-666666666,115,44,55,23,17,5,5,5,42,33,9,33,30,3,2017-01-01,zipcode,Homeland
ZCTA5 33848,12,1401,-666666666,-666666666,53400,978,314,766,378,220,168,0,0,638,301,337,301,97,204,2017-01-01,zipcode,Intercession city
ZCTA5 33849,12,1121,52353,-666666666,-666666666,901,307,734,140,279,273,27,15,419,322,97,322,322,0,2017-01-01,zipcode,Kathleen
ZCTA5 33850,12,7818,41628,889,83100,6378,2941,5569,959,2182,1508,477,443,3945,3176,769,3176,2030,1146,2017-01-01,zipcode,Lake alfred
ZCTA5 33851,12,1116,53359,1048,95900,858,309,771,83,429,164,87,8,385,329,56,329,295,34,2017-01-01,zipcode,Lake hamilton
ZCTA5 33852,12,20634,35131,703,109300,17467,9982,15776,2510,6265,4443,1786,772,12320,8483,3837,8483,6806,1677,2017-01-01,zipcode,Lake placid
ZCTA5 33853,12,12017,36569,735,106000,8914,3336,7855,1864,2469,2209,890,423,4830,4169,661,4169,2071,2098,2017-01-01,zipcode,Lake wales
ZCTA5 33854,12,193,31435,620,38900,171,112,171,20,74,42,35,0,550,125,425,125,71,54,2017-01-01,zipcode,Lakeshore
ZCTA5 33855,12,0,-666666666,-666666666,-666666666,0,0,0,0,0,0,0,0,21,0,21,0,0,0,2017-01-01,zipcode,Indian lake estates
ZCTA5 33856,12,450,24617,520,-666666666,450,446,450,0,229,200,21,0,501,273,228,273,0,273,2017-01-01,zipcode,Nalcrest
ZCTA5 33857,12,1892,30652,567,92200,1412,776,1332,420,695,217,0,0,1320,822,498,822,562,260,2017-01-01,zipcode,Lorida
ZCTA5 33859,12,10493,39375,835,92900,8465,4702,7033,1101,2656,2289,627,360,4863,4073,790,4073,2666,1407,2017-01-01,zipcode,Lake wales
ZCTA5 33860,12,23631,47868,922,112000,18496,7918,16132,2820,6614,4279,1708,711,9309,7732,1577,7732,5847,1885,2017-01-01,zipcode,Mulberry
ZCTA5 33865,12,449,35870,-666666666,84400,439,276,426,63,244,86,33,0,207,168,39,168,94,74,2017-01-01,zipcode,Ona
ZCTA5 33867,12,416,42727,-666666666,69800,416,270,416,30,147,105,102,32,322,232,90,232,232,0,2017-01-01,zipcode,River ranch
ZCTA5 33868,12,11962,50775,889,88400,10000,5662,9085,1827,3902,2237,743,376,4597,3770,827,3770,3110,660,2017-01-01,zipcode,Polk city
ZCTA5 33870,12,21952,30268,677,69400,18587,10645,16415,3476,5984,4696,1372,887,11899,8827,3072,8827,5615,3212,2017-01-01,zipcode,Sebring
ZCTA5 33872,12,15982,41785,873,84400,13918,9208,13127,1239,4350,4575,1804,1159,9301,7202,2099,7202,5664,1538,2017-01-01,zipcode,Sebring
ZCTA5 33873,12,14451,39958,664,82200,11013,4586,9174,2363,4005,1616,752,438,5584,4531,1053,4531,3005,1526,2017-01-01,zipcode,Wauchula
ZCTA5 33875,12,10575,43882,838,111900,9238,4740,8412,890,2877,2704,1329,612,5706,4756,950,4756,3943,813,2017-01-01,zipcode,Sebring
ZCTA5 33876,12,4573,46867,926,89200,4065,2482,3604,610,1303,1214,268,209,2804,2037,767,2037,1693,344,2017-01-01,zipcode,Sebring
ZCTA5 33877,12,464,43200,683,-666666666,358,271,260,99,99,62,0,0,183,112,71,112,38,74,2017-01-01,zipcode,Waverly
ZCTA5 33880,12,38733,39854,843,92400,30052,12930,25931,5952,9610,7232,2133,1004,16042,13077,2965,13077,8448,4629,2017-01-01,zipcode,Winter haven
ZCTA5 33881,12,32920,38819,767,84500,26661,13607,23120,4481,8090,6841,2559,1149,15523,12659,2864,12659,8547,4112,2017-01-01,zipcode,Winter haven
ZCTA5 33884,12,31486,54932,1051,159200,25524,11609,22559,1827,6549,8343,3639,2201,14811,12033,2778,12033,8595,3438,2017-01-01,zipcode,Winter haven
ZCTA5 33890,12,4795,36726,780,78700,3439,1504,2836,728,1343,574,75,116,1785,1394,391,1394,1115,279,2017-01-01,zipcode,Zolfo springs
ZCTA5 33896,12,9808,62183,1319,169700,8413,3008,7089,999,1747,2410,1269,664,5400,3023,2377,3023,1733,1290,2017-01-01,zipcode,Davenport
ZCTA5 33897,12,18359,51214,1285,140200,14813,5507,13016,1417,4253,4774,1877,695,11907,6123,5784,6123,4245,1878,2017-01-01,zipcode,Davenport
ZCTA5 33898,12,16766,40066,841,101800,14131,7095,12443,2093,4911,3477,1270,692,9020,6276,2744,6276,4914,1362,2017-01-01,zipcode,Lake wales
ZCTA5 33901,12,20399,35373,791,153100,17096,7359,15311,2917,4166,3885,2679,1664,11019,8532,2487,8532,3819,4713,2017-01-01,zipcode,Fort myers
ZCTA5 33903,12,22160,37706,820,87400,19940,12073,18605,2481,6772,5676,2391,1285,14857,10632,4225,10632,8133,2499,2017-01-01,zipcode,North fort myers
ZCTA5 33904,12,32340,50263,1029,208100,28178,13225,25862,2701,9068,7995,4129,1969,19658,13610,6048,13610,9964,3646,2017-01-01,zipcode,Cape coral
ZCTA5 33905,12,37092,44441,938,136300,30473,14181,26284,6873,8861,6426,2643,1481,14658,11048,3610,11048,7059,3989,2017-01-01,zipcode,Fort myers
ZCTA5 33907,12,22975,41536,982,135200,18713,6675,16498,2552,4912,4650,2938,1446,12734,9199,3535,9199,3980,5219,2017-01-01,zipcode,Fort myers
ZCTA5 33908,12,35917,56688,1364,243400,32956,19820,31077,1725,8453,8202,7719,4978,31046,17181,13865,17181,12376,4805,2017-01-01,zipcode,Fort myers
ZCTA5 33909,12,28760,50786,1119,155400,22230,8183,19147,2232,7141,6344,2583,847,10861,9124,1737,9124,5515,3609,2017-01-01,zipcode,Cape coral
ZCTA5 33912,12,17648,69431,1175,250500,15909,8377,14235,713,3329,4339,3413,2441,10976,7509,3467,7509,6329,1180,2017-01-01,zipcode,Fort myers
ZCTA5 33913,12,21647,78151,1307,288800,18830,9122,15978,927,3320,4354,4609,2768,11535,7853,3682,7853,6420,1433,2017-01-01,zipcode,Fort myers
ZCTA5 33914,12,36359,61283,1161,246700,31354,13701,27872,1894,9573,9065,4758,2582,19594,14224,5370,14224,10433,3791,2017-01-01,zipcode,Cape coral
ZCTA5 33916,12,22740,34967,892,89700,16637,5850,14252,3646,4100,3723,1785,998,10488,7834,2654,7834,2699,5135,2017-01-01,zipcode,Fort myers
ZCTA5 33917,12,29006,43441,801,84400,25813,15494,24239,2905,10075,6843,2621,1795,17266,12424,4842,12424,10112,2312,2017-01-01,zipcode,North fort myers
ZCTA5 33919,12,29848,54028,1103,185400,26323,12397,24644,1759,5930,7684,5469,3802,18758,13996,4762,13996,10071,3925,2017-01-01,zipcode,Fort myers
ZCTA5 33920,12,5665,66653,755,246500,4894,2171,4398,542,1547,1498,518,293,2461,1881,580,1881,1564,317,2017-01-01,zipcode,Alva
ZCTA5 33921,12,1001,58750,-666666666,944400,985,639,887,40,45,438,261,103,2000,379,1621,379,332,47,2017-01-01,zipcode,Boca grande
ZCTA5 33922,12,3634,40888,947,169700,3248,1933,3077,293,998,968,448,370,2726,1631,1095,1631,1333,298,2017-01-01,zipcode,Bokeelia
ZCTA5 33924,12,225,-666666666,-666666666,-666666666,225,96,225,62,60,61,26,16,1882,64,1818,64,49,15,2017-01-01,zipcode,Captiva
ZCTA5 33928,12,23518,69102,1407,282600,20435,11803,19405,1129,4638,5295,4981,3362,17106,10739,6367,10739,9149,1590,2017-01-01,zipcode,Estero
ZCTA5 33930,12,999,-666666666,675,100400,549,137,457,132,212,77,0,36,367,333,34,333,233,100,2017-01-01,zipcode,Felda
ZCTA5 33931,12,10594,54456,1093,299900,10386,7349,10207,714,2853,3235,1946,1459,14754,5683,9071,5683,4752,931,2017-01-01,zipcode,Fort myers beach
ZCTA5 33935,12,20315,39129,714,81700,15545,6380,12981,4589,3972,3296,653,471,8230,6420,1810,6420,4415,2005,2017-01-01,zipcode,Labelle
ZCTA5 33936,12,22768,37490,853,96000,19245,9372,17059,3707,6700,4277,1546,829,9778,7936,1842,7936,4921,3015,2017-01-01,zipcode,Lehigh acres
ZCTA5 33944,12,264,51003,-666666666,-666666666,164,120,164,0,147,0,0,17,103,103,0,103,103,0,2017-01-01,zipcode,Palmdale
ZCTA5 33945,12,0,-666666666,-666666666,-666666666,0,0,0,0,0,0,0,0,184,0,184,0,0,0,2017-01-01,zipcode,Pineland
ZCTA5 33946,12,2114,72778,1477,370700,2046,1337,1999,120,624,561,519,175,2660,1050,1610,1050,906,144,2017-01-01,zipcode,Placida
ZCTA5 33947,12,8775,49639,1158,223700,8160,5605,7646,344,2706,2725,1250,621,5450,3919,1531,3919,3330,589,2017-01-01,zipcode,Rotonda west
ZCTA5 33948,12,16050,44158,918,153400,14027,7420,12911,1102,4371,4405,1666,1367,8983,6913,2070,6913,5659,1254,2017-01-01,zipcode,Port charlotte
ZCTA5 33950,12,21045,52347,920,267200,20128,13421,18895,1353,4919,5924,4137,2562,15289,10788,4501,10788,8671,2117,2017-01-01,zipcode,Punta gorda
ZCTA5 33952,12,33184,37193,925,117200,28421,13558,25492,3119,9558,8524,2784,1507,16491,13728,2763,13728,9255,4473,2017-01-01,zipcode,Port charlotte
ZCTA5 33953,12,6156,54124,955,211000,5655,3330,5300,392,1899,1865,687,457,3659,2649,1010,2649,2322,327,2017-01-01,zipcode,Port charlotte
ZCTA5 33954,12,8595,48843,1217,172400,7363,3775,6732,790,2473,2191,839,439,3938,3435,503,3435,2772,663,2017-01-01,zipcode,Port charlotte
ZCTA5 33955,12,11559,58914,1055,225200,10323,6876,9614,1404,2767,2838,1602,1003,6480,4389,2091,4389,3937,452,2017-01-01,zipcode,Punta gorda
ZCTA5 33956,12,3671,51250,1111,189700,3553,2515,3337,301,1016,999,603,418,3240,1714,1526,1714,1552,162,2017-01-01,zipcode,Saint james city
ZCTA5 33957,12,7128,104115,1502,705900,6545,4176,6327,219,729,1364,2110,1905,8830,3575,5255,3575,3046,529,2017-01-01,zipcode,Sanibel
ZCTA5 33960,12,738,44519,-666666666,121800,681,316,645,88,289,150,91,27,594,341,253,341,291,50,2017-01-01,zipcode,Venus
ZCTA5 33965,12,1562,-666666666,-666666666,-666666666,1562,848,9,0,0,9,0,0,0,0,0,0,0,0,2017-01-01,zipcode,Fort myers
ZCTA5 33966,12,9418,60397,990,244900,8066,4069,7079,453,1844,2008,1588,1186,5459,3874,1585,3874,2611,1263,2017-01-01,zipcode,Fort myers
ZCTA5 33967,12,24206,62008,1122,178500,19882,5875,15993,2041,4294,5104,3256,1298,9690,8123,1567,8123,5936,2187,2017-01-01,zipcode,Fort myers
ZCTA5 33971,12,25938,47922,1029,130100,18738,6372,15154,3118,5358,4525,1483,670,8082,6915,1167,6915,4455,2460,2017-01-01,zipcode,Lehigh acres
ZCTA5 33972,12,16328,58152,985,123000,12592,5074,10804,1950,3830,3177,1318,529,5329,4529,800,4529,3151,1378,2017-01-01,zipcode,Lehigh acres
ZCTA5 33973,12,14975,37036,885,185000,9982,3557,7945,2697,2483,1931,597,237,4309,3757,552,3757,697,3060,2017-01-01,zipcode,Lehigh acres
ZCTA5 33974,12,16785,48343,1045,125700,12271,4229,10268,1758,3765,3211,1129,405,5186,4464,722,4464,2546,1918,2017-01-01,zipcode,Lehigh acres
ZCTA5 33976,12,18120,45675,1069,113000,12566,4130,10450,2514,3742,3012,1000,182,4912,4519,393,4519,2734,1785,2017-01-01,zipcode,Lehigh acres
ZCTA5 33980,12,12736,42188,831,131100,11592,7588,10443,1175,3198,3690,1578,802,7891,5718,2173,5718,4119,1599,2017-01-01,zipcode,Punta gorda
ZCTA5 33981,12,10017,49583,1088,198000,9013,5138,8653,646,3197,3073,1193,544,6187,4380,1807,4380,3645,735,2017-01-01,zipcode,Port charlotte
ZCTA5 33982,12,11201,47282,738,111500,9609,5470,8565,1410,2896,3101,685,473,5120,4089,1031,4089,3385,704,2017-01-01,zipcode,Punta gorda
ZCTA5 33983,12,15239,51057,958,185200,12575,6688,11415,976,3826,4028,1652,933,7797,5942,1855,5942,4705,1237,2017-01-01,zipcode,Punta gorda
ZCTA5 33990,12,32633,50989,1075,177800,27431,11700,24513,2250,8898,8491,3265,1609,13589,11296,2293,11296,7768,3528,2017-01-01,zipcode,Cape coral
ZCTA5 33991,12,21736,60477,1227,221300,16954,6701,15011,979,5129,4656,2802,1445,8844,7339,1505,7339,5257,2082,2017-01-01,zipcode,Cape coral
ZCTA5 33993,12,23923,53230,1229,184600,19326,8330,16916,1481,6338,5857,2058,1182,9663,7883,1780,7883,5843,2040,2017-01-01,zipcode,Cape coral
ZCTA5 34101,12,0,-666666666,-666666666,-666666666,0,0,0,0,0,0,0,0,14,0,14,0,0,0,2017-01-01,zipcode,Naples
ZCTA5 34102,12,11135,76096,1138,858400,9984,5649,9428,803,1471,2341,2962,1851,9479,5413,4066,5413,3763,1650,2017-01-01,zipcode,Naples
ZCTA5 34103,12,13037,85094,1330,654000,11850,6942,11142,747,2114,2723,2991,2567,11053,6116,4937,6116,4838,1278,2017-01-01,zipcode,Naples
ZCTA5 34104,12,23807,50254,1098,229100,20616,10055,18357,2317,5646,5417,2754,2223,15017,10289,4728,10289,7075,3214,2017-01-01,zipcode,Naples
ZCTA5 34105,12,16909,80600,1445,391700,14684,7374,13494,648,2347,4000,3794,2705,10461,7590,2871,7590,5335,2255,2017-01-01,zipcode,Naples
ZCTA5 34108,12,16742,87268,1253,666300,15308,8929,14432,716,2974,3135,4025,3582,14480,7953,6527,7953,6346,1607,2017-01-01,zipcode,Naples
ZCTA5 34109,12,24720,65487,1231,377000,21128,9542,19405,1090,4670,4477,5827,3341,14511,11144,3367,11144,6579,4565,2017-01-01,zipcode,Naples
ZCTA5 34110,12,24092,74082,1452,352500,21703,12433,20580,1181,4338,5769,5052,4240,15941,10930,5011,10930,8464,2466,2017-01-01,zipcode,Naples
ZCTA5 34112,12,26834,52478,986,194400,24035,12970,22175,2485,7420,5950,3717,2603,19072,12013,7059,12013,8884,3129,2017-01-01,zipcode,Naples
ZCTA5 34113,12,19861,52281,1181,264500,16953,8199,14731,2597,4098,3534,2748,1754,12430,7649,4781,7649,5512,2137,2017-01-01,zipcode,Naples
ZCTA5 34114,12,16331,55723,1236,222300,14604,8487,13178,1578,4436,3335,2301,1528,12188,6923,5265,6923,5671,1252,2017-01-01,zipcode,Naples
ZCTA5 34116,12,36240,47471,1094,212500,27499,7392,23397,6463,8367,5085,2379,1103,10475,9614,861,9614,4845,4769,2017-01-01,zipcode,Naples
ZCTA5 34117,12,15461,65925,1213,260000,12852,4054,10953,1498,3859,3034,1662,900,4989,4581,408,4581,4128,453,2017-01-01,zipcode,Naples
ZCTA5 34119,12,30985,80473,1404,402600,25749,12272,22936,1047,5389,6706,5605,4189,15781,12478,3303,12478,9394,3084,2017-01-01,zipcode,Naples
ZCTA5 34120,12,31597,77064,1409,270100,23938,9016,21248,2978,6312,5466,3667,2825,12718,9667,3051,9667,8086,1581,2017-01-01,zipcode,Naples
ZCTA5 34134,12,13898,75829,1155,450700,13163,8628,12599,413,2774,3410,3561,2441,14273,7079,7194,7079,5880,1199,2017-01-01,zipcode,Bonita springs
ZCTA5 34135,12,44842,61891,1161,247000,38745,19927,35100,6004,8240,9661,6645,4550,27186,17421,9765,17421,13670,3751,2017-01-01,zipcode,Bonita springs
ZCTA5 34137,12,485,20849,-666666666,-666666666,262,195,262,0,183,79,0,0,144,144,0,144,64,80,2017-01-01,zipcode,
ZCTA5 34138,12,74,-666666666,-666666666,-666666666,74,61,74,0,47,14,0,13,316,61,255,61,61,0,2017-01-01,zipcode,Chokoloskee
ZCTA5 34139,12,580,24632,794,120500,348,161,299,34,119,78,45,23,574,206,368,206,183,23,2017-01-01,zipcode,Everglades city
ZCTA5 34140,12,197,-666666666,-666666666,-666666666,197,111,168,0,0,83,85,0,485,111,374,111,59,52,2017-01-01,zipcode,Goodland
ZCTA5 34141,12,129,-666666666,-666666666,-666666666,123,23,100,60,0,16,4,20,91,20,71,20,4,16,2017-01-01,zipcode,Ochopee
ZCTA5 34142,12,29461,31150,761,114200,21496,6867,15738,8901,3760,1807,890,380,7383,6165,1218,6165,2576,3589,2017-01-01,zipcode,Immokalee
ZCTA5 34145,12,17561,72905,1531,523200,16302,10048,15721,1230,3155,4313,4333,2690,18799,8560,10239,8560,7291,1269,2017-01-01,zipcode,Marco island
ZCTA5 34201,12,3758,92112,2197,388000,3624,2060,3513,112,565,879,942,1015,2566,1800,766,1800,1643,157,2017-01-01,zipcode,Bradenton
ZCTA5 34202,12,22462,95610,1820,393300,18518,8696,16781,552,2490,4434,5163,4142,10876,8948,1928,8948,6870,2078,2017-01-01,zipcode,Bradenton
ZCTA5 34203,12,36511,48854,1032,177200,29705,13903,27093,3685,8877,7900,4173,2458,18155,13660,4495,13660,10113,3547,2017-01-01,zipcode,Bradenton
ZCTA5 34205,12,32163,37926,899,115700,25942,11820,22926,3918,8220,6940,2555,1293,15625,12325,3300,12325,6960,5365,2017-01-01,zipcode,Bradenton
ZCTA5 34207,12,36055,36777,895,64500,29447,13841,25393,4643,10317,6279,2433,1721,19150,14524,4626,14524,8360,6164,2017-01-01,zipcode,Bradenton
ZCTA5 34208,12,38248,44846,970,155900,29473,12194,24829,5713,9153,5566,2972,1425,14032,11872,2160,11872,6481,5391,2017-01-01,zipcode,Bradenton
ZCTA5 34209,12,34547,55995,1121,200900,30536,14827,27496,1835,8775,8369,5217,3300,18206,14378,3828,14378,10570,3808,2017-01-01,zipcode,Bradenton
ZCTA5 34210,12,17381,47566,1035,174700,15173,7715,13255,798,3601,4309,2733,1814,11244,7632,3612,7632,4548,3084,2017-01-01,zipcode,Bradenton
ZCTA5 34211,12,6872,90902,1633,374500,5768,3089,5125,161,841,1752,1446,925,3423,2809,614,2809,2514,295,2017-01-01,zipcode,Bradenton
ZCTA5 34212,12,17863,92940,1374,321100,14127,5317,12645,621,2164,4317,3585,1958,8006,6563,1443,6563,5201,1362,2017-01-01,zipcode,Bradenton
ZCTA5 34215,12,504,48214,-666666666,604800,480,273,428,4,81,145,136,62,489,212,277,212,172,40,2017-01-01,zipcode,Cortez
ZCTA5 34216,12,1016,62727,1109,703500,926,612,880,31,246,243,162,198,1435,482,953,482,431,51,2017-01-01,zipcode,Anna maria
ZCTA5 34217,12,5067,53688,1182,476600,4766,2864,4603,90,1012,1562,1036,903,6427,2714,3713,2714,1922,792,2017-01-01,zipcode,Bradenton beach
ZCTA5 34219,12,22984,78187,1678,240500,18476,7390,16729,1116,4258,5906,3691,1758,9083,7840,1243,7840,7075,765,2017-01-01,zipcode,Parrish
ZCTA5 34221,12,44115,50941,1011,129900,36555,16846,31660,4111,11626,9348,4307,2268,20081,15356,4725,15356,12002,3354,2017-01-01,zipcode,Palmetto
ZCTA5 34222,12,10976,46348,986,77500,9870,5717,9138,614,3268,3192,1424,640,7053,5238,1815,5238,4185,1053,2017-01-01,zipcode,Ellenton
ZCTA5 34223,12,17151,51845,919,203000,16020,10564,15274,991,5436,4500,2548,1799,13294,8600,4694,8600,6844,1756,2017-01-01,zipcode,Englewood
ZCTA5 34224,12,15826,42314,918,137000,14216,8586,13050,1185,5430,4045,1401,989,10869,7439,3430,7439,5777,1662,2017-01-01,zipcode,Englewood
ZCTA5 34228,12,7179,102348,1471,709300,7078,5378,6948,247,758,1532,2226,2185,9347,3820,5527,3820,3522,298,2017-01-01,zipcode,Longboat key
ZCTA5 34229,12,7663,80172,1122,388800,6802,3710,6337,268,1346,1464,1751,1508,4240,3393,847,3393,2929,464,2017-01-01,zipcode,Osprey
ZCTA5 34231,12,28926,49878,1084,191300,25494,10968,23382,1631,6765,7684,4124,3178,18304,14139,4165,14139,8781,5358,2017-01-01,zipcode,Sarasota
ZCTA5 34232,12,34545,60973,1272,187900,29242,10633,25979,2149,8957,7683,4907,2283,15010,13436,1574,13436,9210,4226,2017-01-01,zipcode,Sarasota
ZCTA5 34233,12,17166,59909,1303,235700,14575,6497,13017,883,3270,3620,3263,1981,8859,7657,1202,7657,5927,1730,2017-01-01,zipcode,Sarasota
ZCTA5 34234,12,21985,33793,896,107200,18052,8310,15390,2576,5813,4033,1929,1039,10464,8837,1627,8837,4590,4247,2017-01-01,zipcode,Sarasota
ZCTA5 34235,12,14719,54511,1181,206400,12621,6449,11419,722,2570,3511,2598,2018,8435,6399,2036,6399,4887,1512,2017-01-01,zipcode,Sarasota
ZCTA5 34236,12,12452,51852,963,639800,11405,7011,11083,809,1795,2557,3140,2782,10102,6592,3510,6592,3838,2754,2017-01-01,zipcode,Sarasota
ZCTA5 34237,12,17398,40445,1021,113700,14509,5387,12819,2188,4082,3569,2070,910,8297,6914,1383,6914,3656,3258,2017-01-01,zipcode,Sarasota
ZCTA5 34238,12,19077,68070,1417,340300,17221,10803,16163,485,2952,4385,4287,4054,12319,9779,2540,9779,7489,2290,2017-01-01,zipcode,Sarasota
ZCTA5 34239,12,15453,55654,1122,248100,13107,4954,11789,947,2755,3149,3050,1888,8455,6805,1650,6805,4628,2177,2017-01-01,zipcode,Sarasota
ZCTA5 34240,12,11261,81332,1225,386600,9363,4556,8356,457,2273,2039,1834,1753,5373,4048,1325,4048,3721,327,2017-01-01,zipcode,Sarasota
ZCTA5 34241,12,15001,73824,1257,332500,12412,5548,11290,462,2879,3301,2862,1786,6634,5778,856,5778,4962,816,2017-01-01,zipcode,Sarasota
ZCTA5 34242,12,7715,91250,1384,656500,6980,4044,6569,143,904,1595,2191,1736,10876,3820,7056,3820,3264,556,2017-01-01,zipcode,Sarasota
ZCTA5 34243,12,30887,60688,1350,245800,26749,12745,23854,1370,5774,7035,5831,3844,14985,12847,2138,12847,9388,3459,2017-01-01,zipcode,Sarasota
ZCTA5 34251,12,5223,76750,1367,276200,4388,1583,3929,645,1682,897,429,276,2011,1749,262,1749,1617,132,2017-01-01,zipcode,Myakka city
ZCTA5 34266,12,31580,34439,666,80400,25609,13352,21611,7084,8794,3706,1402,625,12231,9779,2452,9779,6363,3416,2017-01-01,zipcode,Arcadia
ZCTA5 34268,12,74,-666666666,-666666666,-666666666,54,54,54,0,54,0,0,0,111,54,57,54,22,32,2017-01-01,zipcode,Nocatee
ZCTA5 34269,12,4062,40861,878,124600,3724,2458,3543,371,1325,979,600,268,2665,1919,746,1919,1705,214,2017-01-01,zipcode,Arcadia
ZCTA5 34275,12,18492,53582,908,251600,16789,9434,15378,734,4860,4608,3087,2089,10881,8820,2061,8820,7079,1741,2017-01-01,zipcode,Nokomis
ZCTA5 34285,12,18910,50813,1081,172800,18296,12821,17440,861,5727,4866,3268,2718,15670,10292,5378,10292,7963,2329,2017-01-01,zipcode,Venice
ZCTA5 34286,12,19725,63788,1234,151300,15717,6248,12890,1400,4670,4432,1915,473,7195,6388,807,6388,5126,1262,2017-01-01,zipcode,North port
ZCTA5 34287,12,26734,47280,962,126900,23769,13704,22255,2226,9442,6281,2797,1509,14874,11133,3741,11133,8122,3011,2017-01-01,zipcode,North port
ZCTA5 34288,12,12046,52853,1222,180700,9235,5075,8468,672,2521,3697,1065,513,4835,4274,561,4274,3367,907,2017-01-01,zipcode,North port
ZCTA5 34289,12,2755,49097,1051,190900,2329,897,1933,88,456,779,418,192,1648,1393,255,1393,594,799,2017-01-01,zipcode,North port
ZCTA5 34291,12,5763,47338,1187,158400,4317,2001,3723,343,1584,1030,489,277,2243,2011,232,2011,1646,365,2017-01-01,zipcode,North port
ZCTA5 34292,12,15928,59289,1331,277900,14377,10017,13663,674,3671,3769,3394,2155,9566,7626,1940,7626,5866,1760,2017-01-01,zipcode,Venice
ZCTA5 34293,12,35968,54627,1169,199700,32635,18277,30385,2013,9639,9332,5894,3507,21548,16619,4929,16619,13689,2930,2017-01-01,zipcode,Venice
ZCTA5 34420,12,14776,39929,755,90000,12113,4910,10642,1789,4242,3168,1187,256,7391,5749,1642,5749,4287,1462,2017-01-01,zipcode,Belleview
ZCTA5 34428,12,9455,38534,720,101700,7964,3918,7257,1070,2862,2284,695,346,5255,4204,1051,4204,3130,1074,2017-01-01,zipcode,Crystal river
ZCTA5 34429,12,7413,40494,885,107500,6708,3796,5864,639,1989,1819,822,595,4841,3517,1324,3517,2883,634,2017-01-01,zipcode,Crystal river
ZCTA5 34431,12,8014,36864,819,99500,6734,3950,6190,771,2755,1667,601,396,4150,3380,770,3380,2735,645,2017-01-01,zipcode,Dunnellon
ZCTA5 34432,12,13720,40824,894,129800,11558,7169,10939,1554,3676,3547,1555,607,6761,5702,1059,5702,4877,825,2017-01-01,zipcode,Dunnellon
ZCTA5 34433,12,5838,47679,818,117800,5134,2810,4646,538,1838,1539,507,224,3470,2753,717,2753,2416,337,2017-01-01,zipcode,Dunnellon
ZCTA5 34434,12,8204,48530,1149,127300,6826,3354,6260,747,2538,2201,597,177,3912,3151,761,3151,2540,611,2017-01-01,zipcode,Dunnellon
ZCTA5 34436,12,7854,36161,681,85000,6810,3947,6100,973,2549,1900,343,335,4526,3441,1085,3441,2817,624,2017-01-01,zipcode,Floral city
ZCTA5 34442,12,13591,47644,768,156500,12501,8145,11666,1028,4480,3001,1898,1259,8523,6483,2040,6483,5781,702,2017-01-01,zipcode,Hernando
ZCTA5 34445,12,0,-666666666,-666666666,-666666666,0,0,0,0,0,0,0,0,53,0,53,0,0,0,2017-01-01,zipcode,Holder
ZCTA5 34446,12,16130,43486,973,132800,14457,10149,13472,1625,4756,4201,2177,713,9224,7470,1754,7470,6652,818,2017-01-01,zipcode,Homosassa
ZCTA5 34448,12,10592,35016,645,75100,9197,5644,8372,1159,3679,2701,590,243,6544,4764,1780,4764,3593,1171,2017-01-01,zipcode,Homosassa
ZCTA5 34449,12,2736,26111,492,82800,2487,1440,2296,382,958,655,196,105,1836,1264,572,1264,875,389,2017-01-01,zipcode,Inglis
ZCTA5 34450,12,10952,37091,724,113800,9376,5403,8599,1112,3247,2585,898,757,6132,4974,1158,4974,3612,1362,2017-01-01,zipcode,Inverness
ZCTA5 34452,12,11174,36712,827,106100,9657,5519,8676,1236,3416,2909,719,396,5950,4993,957,4993,4097,896,2017-01-01,zipcode,Inverness
ZCTA5 34453,12,11378,38308,889,98900,9342,5352,8389,1440,2945,2917,611,476,5685,4470,1215,4470,3452,1018,2017-01-01,zipcode,Inverness
ZCTA5 34461,12,10873,44179,690,154700,9562,5733,8632,1202,3018,2711,1094,607,5565,4249,1316,4249,3313,936,2017-01-01,zipcode,Lecanto
ZCTA5 34465,12,17563,36201,810,143000,15089,8804,13785,1337,4983,4632,1910,923,9012,7886,1126,7886,6175,1711,2017-01-01,zipcode,Beverly hills
ZCTA5 34470,12,19636,34387,791,92100,15924,7188,13768,1913,5477,4390,1407,581,9380,7900,1480,7900,4670,3230,2017-01-01,zipcode,Ocala
ZCTA5 34471,12,25082,50216,855,162400,20091,8523,17118,1627,5294,4964,3184,2049,11536,9806,1730,9806,6371,3435,2017-01-01,zipcode,Ocala
ZCTA5 34472,12,31317,40003,928,90800,23877,10640,20002,2419,7801,6708,2152,922,11868,10419,1449,10419,7586,2833,2017-01-01,zipcode,Ocala
ZCTA5 34473,12,19274,49071,990,142300,15391,6841,13240,1718,4463,4105,2316,638,7873,6468,1405,6468,4660,1808,2017-01-01,zipcode,Ocala
ZCTA5 34474,12,15937,39963,943,113200,12530,5189,11040,1135,3085,4114,1613,1093,8100,6744,1356,6744,3134,3610,2017-01-01,zipcode,Ocala
ZCTA5 34475,12,12275,24821,685,73600,10272,6213,8609,2144,3257,2276,596,336,4937,3978,959,3978,1906,2072,2017-01-01,zipcode,Ocala
ZCTA5 34476,12,22347,50382,849,134000,19786,11550,18292,1988,6231,6151,2650,1272,11054,9475,1579,9475,8431,1044,2017-01-01,zipcode,Ocala
ZCTA5 34479,12,14320,40399,853,89500,11443,4732,10034,1259,4268,3105,1012,390,5988,5378,610,5378,3708,1670,2017-01-01,zipcode,Ocala
ZCTA5 34480,12,19368,52706,763,145900,15376,6158,13069,922,4671,3966,1925,1585,7838,6511,1327,6511,4962,1549,2017-01-01,zipcode,Ocala
ZCTA5 34481,12,18447,42540,879,102300,17218,13054,16795,1590,5000,5693,2972,1540,11173,9416,1757,9416,8272,1144,2017-01-01,zipcode,Ocala
ZCTA5 34482,12,24105,38596,805,131000,20766,13258,18487,3610,7094,5018,1930,835,9422,7358,2064,7358,5639,1719,2017-01-01,zipcode,Ocala
ZCTA5 34484,12,3687,45670,759,204900,2992,1334,2707,316,829,953,370,239,1956,1429,527,1429,960,469,2017-01-01,zipcode,Oxford
ZCTA5 34488,12,9766,28868,662,50600,8159,5034,7299,1273,3137,2251,526,112,5464,4017,1447,4017,3066,951,2017-01-01,zipcode,Silver springs
ZCTA5 34491,12,25173,44806,926,158200,22499,15117,21211,2313,8287,6275,2972,1364,14800,11617,3183,11617,10088,1529,2017-01-01,zipcode,Summerfield
ZCTA5 34498,12,568,37031,970,145800,464,266,449,60,143,134,73,39,508,279,229,279,221,58,2017-01-01,zipcode,Yankeetown
ZCTA5 34601,12,21946,38704,750,97500,18183,9614,16231,2405,6110,4788,1843,1085,11233,9035,2198,9035,6398,2637,2017-01-01,zipcode,Brooksville
ZCTA5 34602,12,6719,47848,720,136000,5753,3059,5148,756,2085,1286,713,308,2938,2572,366,2572,2219,353,2017-01-01,zipcode,Brooksville
ZCTA5 34604,12,10808,46932,743,137800,8927,4549,7937,1192,3026,2365,804,550,4335,3783,552,3783,3153,630,2017-01-01,zipcode,Brooksville
ZCTA5 34606,12,26028,40704,918,108000,22271,13256,20253,2343,7462,6896,2397,1155,13937,11343,2594,11343,8518,2825,2017-01-01,zipcode,Spring hill
ZCTA5 34607,12,8562,46403,956,189400,7792,4538,6984,693,2211,2581,1004,495,5223,3981,1242,3981,3189,792,2017-01-01,zipcode,Spring hill
ZCTA5 34608,12,33685,42770,942,115800,27229,13309,23569,2898,9436,8136,2082,1017,14496,12803,1693,12803,9087,3716,2017-01-01,zipcode,Spring hill
ZCTA5 34609,12,40234,50522,1070,141000,32592,15820,28635,3006,9044,11127,3719,1739,17284,15323,1961,15323,12113,3210,2017-01-01,zipcode,Spring hill
ZCTA5 34610,12,13782,46768,897,123900,11456,5476,9742,1491,3678,3156,855,562,5575,4842,733,4842,4034,808,2017-01-01,zipcode,Spring hill
ZCTA5 34613,12,17460,41728,964,87400,15503,9789,14375,1759,5529,4743,1557,787,10293,8205,2088,8205,7028,1177,2017-01-01,zipcode,Brooksville
ZCTA5 34614,12,7520,48051,1040,138000,6218,3012,5470,519,2165,1909,572,305,2922,2638,284,2638,2357,281,2017-01-01,zipcode,Brooksville
ZCTA5 34637,12,8205,82967,1535,203900,7015,4465,6169,838,1641,1679,1300,711,2525,2166,359,2166,1826,340,2017-01-01,zipcode,Land o lakes
ZCTA5 34638,12,25452,84684,1433,227900,18342,5596,15908,912,3648,5607,3809,1932,8656,8144,512,8144,6407,1737,2017-01-01,zipcode,Land o lakes
ZCTA5 34639,12,27583,76957,1206,220200,21872,7154,18941,1436,4243,6684,4368,2210,10093,9602,491,9602,7685,1917,2017-01-01,zipcode,Land o lakes
ZCTA5 34652,12,23339,36329,843,88400,20057,10353,18056,2217,6780,6074,1926,1059,14452,10526,3926,10526,6577,3949,2017-01-01,zipcode,New port richey
ZCTA5 34653,12,35079,37509,938,84100,28900,14601,25206,3279,9311,8995,2568,1053,17017,14423,2594,14423,8789,5634,2017-01-01,zipcode,New port richey
ZCTA5 34654,12,23180,47465,939,140000,19143,9235,16991,2091,5809,5832,2076,1183,10465,8919,1546,8919,6750,2169,2017-01-01,zipcode,New port richey
ZCTA5 34655,12,39222,58953,1109,199900,32657,15163,29396,1839,8585,10191,5788,2993,19136,16464,2672,16464,13052,3412,2017-01-01,zipcode,New port richey
ZCTA5 34661,12,180,-666666666,-666666666,-666666666,114,33,68,0,35,8,0,25,129,44,85,44,34,10,2017-01-01,zipcode,Nobleton
ZCTA5 34667,12,33930,40748,870,116100,29603,17528,27015,3525,10343,8458,3213,1476,19469,15138,4331,15138,10832,4306,2017-01-01,zipcode,Hudson
ZCTA5 34668,12,45482,35298,900,72100,37837,18804,33348,4583,13169,11581,2898,1117,22867,18998,3869,18998,11716,7282,2017-01-01,zipcode,Port richey
ZCTA5 34669,12,12252,44682,968,121500,10328,4975,9011,855,3593,3206,958,399,5813,4869,944,4869,3893,976,2017-01-01,zipcode,Hudson
ZCTA5 34677,12,21858,63750,1107,212700,18147,6717,15643,1024,4348,4603,3676,1992,10065,8591,1474,8591,6138,2453,2017-01-01,zipcode,Oldsmar
ZCTA5 34679,12,64,26719,-666666666,140300,52,35,52,0,38,6,4,4,49,35,14,35,22,13,2017-01-01,zipcode,Aripeka
ZCTA5 34681,12,834,59434,-666666666,422700,771,351,709,27,104,116,339,123,514,402,112,402,402,0,2017-01-01,zipcode,Crystal beach
ZCTA5 34683,12,32672,60999,1113,235200,27829,10782,24196,1489,5362,8648,6002,2695,15760,13144,2616,13144,9973,3171,2017-01-01,zipcode,Palm harbor
ZCTA5 34684,12,28910,50296,1196,165600,25613,11984,23130,1155,6649,7921,5033,2372,14866,13248,1618,13248,8632,4616,2017-01-01,zipcode,Palm harbor
ZCTA5 34685,12,19210,79857,1297,319600,15881,6652,13827,524,2946,4041,4063,2253,8059,7235,824,7235,5422,1813,2017-01-01,zipcode,Palm harbor
ZCTA5 34688,12,6429,84514,2011,315300,5530,2598,5163,208,1052,1592,1546,765,3600,2841,759,2841,2598,243,2017-01-01,zipcode,Tarpon springs
ZCTA5 34689,12,27398,44487,865,166500,23509,11319,21167,2465,6539,6571,3526,2066,13881,11039,2842,11039,7541,3498,2017-01-01,zipcode,Tarpon springs
ZCTA5 34690,12,12013,33095,945,67900,10350,5261,9265,1341,4150,2596,870,308,6719,5422,1297,5422,3495,1927,2017-01-01,zipcode,Holiday
ZCTA5 34691,12,20164,39141,963,75000,16391,8181,14853,1670,6324,4349,1870,640,11725,8442,3283,8442,5611,2831,2017-01-01,zipcode,Holiday
ZCTA5 34695,12,17797,64918,1142,231100,15032,5752,13709,723,3258,3991,3608,2129,8458,7357,1101,7357,6202,1155,2017-01-01,zipcode,Safety harbor
ZCTA5 34698,12,38230,46193,1006,158700,33534,15719,31078,2637,8870,9667,6633,3271,21457,18022,3435,18022,12013,6009,2017-01-01,zipcode,Dunedin
ZCTA5 34705,12,2854,45125,832,97000,2271,875,2035,303,781,767,172,12,1174,978,196,978,728,250,2017-01-01,zipcode,Astatula
ZCTA5 34711,12,57273,64412,1244,201300,45503,18394,39938,3030,10549,14827,7556,3976,22914,20124,2790,20124,15327,4797,2017-01-01,zipcode,Clermont
ZCTA5 34714,12,21168,52067,1113,157100,16264,4874,13430,1109,4175,5044,2604,498,8915,6998,1917,6998,3471,3527,2017-01-01,zipcode,Clermont
ZCTA5 34715,12,17068,61073,1169,187100,13621,5465,11900,1732,3272,4057,2027,812,6329,5547,782,5547,3862,1685,2017-01-01,zipcode,Clermont
ZCTA5 34731,12,12270,43390,928,103600,10154,4373,9141,1062,3572,2856,1066,585,6051,5093,958,5093,3829,1264,2017-01-01,zipcode,Fruitland park
ZCTA5 34734,12,4206,53974,1254,231000,3232,1094,2782,227,897,767,623,268,1382,1382,0,1382,1237,145,2017-01-01,zipcode,Gotha
ZCTA5 34736,12,16713,56221,1128,160600,13510,5418,12130,2045,4399,3206,1799,681,6380,5718,662,5718,4436,1282,2017-01-01,zipcode,Groveland
ZCTA5 34737,12,2441,62500,1027,210100,2072,959,1821,205,563,593,256,204,1298,936,362,936,777,159,2017-01-01,zipcode,Howey in the hills
ZCTA5 34739,12,381,-666666666,-666666666,91400,276,125,261,75,80,52,54,0,516,194,322,194,146,48,2017-01-01,zipcode,Kenansville
ZCTA5 34741,12,45936,36246,995,128800,35844,12160,30057,4968,9284,11264,3293,1248,19773,15402,4371,15402,4481,10921,2017-01-01,zipcode,Kissimmee
ZCTA5 34743,12,42793,42726,1169,150100,33290,13051,27722,5125,9890,8782,2725,1200,12890,11241,1649,11241,7169,4072,2017-01-01,zipcode,Kissimmee
ZCTA5 34744,12,51648,48983,1181,178100,40316,15075,33870,4676,9756,12003,5125,2310,17916,14697,3219,14697,9017,5680,2017-01-01,zipcode,Kissimmee
ZCTA5 34746,12,42077,49170,1283,165500,33022,12330,27582,3156,8516,10491,3927,1492,21357,12378,8979,12378,7903,4475,2017-01-01,zipcode,Kissimmee
ZCTA5 34747,12,17324,67383,1371,293600,14205,4381,11967,346,2519,3569,3273,2260,23077,6243,16834,6243,3072,3171,2017-01-01,zipcode,Kissimmee
ZCTA5 34748,12,39053,43334,864,138200,33607,21197,31174,3516,11742,9857,3762,2297,21205,17615,3590,17615,12790,4825,2017-01-01,zipcode,Leesburg
ZCTA5 34753,12,5816,43935,860,104700,4477,1847,3732,979,1500,959,161,133,1734,1675,59,1675,1377,298,2017-01-01,zipcode,Mascotte
ZCTA5 34756,12,3301,71000,1069,259700,2686,838,2103,218,550,781,353,201,1391,1140,251,1140,934,206,2017-01-01,zipcode,Montverde
ZCTA5 34758,12,39531,43309,1122,156000,30526,12563,24689,3750,9971,7564,2489,915,12568,10259,2309,10259,6871,3388,2017-01-01,zipcode,Kissimmee
ZCTA5 34759,12,39117,45947,1177,158100,30138,15188,26047,4339,7891,8199,3849,1769,14672,11379,3293,11379,8119,3260,2017-01-01,zipcode,Kissimmee
ZCTA5 34760,12,801,68047,1016,206600,664,145,590,67,190,220,89,24,298,269,29,269,236,33,2017-01-01,zipcode,Oakland
ZCTA5 34761,12,45278,60921,1158,204500,34029,10663,29315,3780,7216,9211,6057,3051,15746,14679,1067,14679,10068,4611,2017-01-01,zipcode,Ocoee
ZCTA5 34762,12,452,59926,-666666666,115700,440,247,415,133,165,87,12,18,201,187,14,187,187,0,2017-01-01,zipcode,Okahumpka
ZCTA5 34769,12,23144,42869,1000,126500,18424,8021,16067,2286,5981,5331,1835,634,9898,7951,1947,7951,5184,2767,2017-01-01,zipcode,Saint cloud
ZCTA5 34771,12,15783,66930,1156,245800,12439,5150,10388,741,3633,3759,1705,550,6022,5109,913,5109,4577,532,2017-01-01,zipcode,Saint cloud
ZCTA5 34772,12,30395,64611,1327,191500,23213,8682,19899,2394,5999,7621,2776,1109,10436,8682,1754,8682,7270,1412,2017-01-01,zipcode,Saint cloud
ZCTA5 34773,12,3937,61988,1311,166100,2819,1317,2418,404,587,929,355,143,1369,1075,294,1075,712,363,2017-01-01,zipcode,Saint cloud
ZCTA5 34785,12,30140,56068,858,261600,28588,22301,27243,3071,8998,7821,4094,3259,14801,11316,3485,11316,9642,1674,2017-01-01,zipcode,Wildwood
ZCTA5 34786,12,41244,99769,1678,422000,29660,8760,25951,868,2631,6415,11052,4985,14819,13383,1436,13383,9651,3732,2017-01-01,zipcode,Windermere
ZCTA5 34787,12,57570,65743,1049,262200,43822,13672,37912,4098,9157,10122,9333,5202,21833,19539,2294,19539,13842,5697,2017-01-01,zipcode,Winter garden
ZCTA5 34788,12,17153,40298,908,71500,15058,8666,14170,1365,5508,4942,1586,769,9891,7987,1904,7987,6575,1412,2017-01-01,zipcode,Leesburg
ZCTA5 34797,12,948,75453,-666666666,201800,850,471,782,0,306,276,71,129,550,367,183,367,354,13,2017-01-01,zipcode,Yalaha
ZCTA5 34945,12,5414,44813,1072,169600,4638,2595,4058,951,1335,1110,404,258,1937,1562,375,1562,1343,219,2017-01-01,zipcode,Fort pierce
ZCTA5 34946,12,6474,29125,842,68400,5334,2789,4430,798,1434,1505,435,258,3038,2289,749,2289,1476,813,2017-01-01,zipcode,Fort pierce
ZCTA5 34947,12,13120,28262,913,89300,9377,3969,7792,1595,3410,2082,492,213,4867,4167,700,4167,1667,2500,2017-01-01,zipcode,Fort pierce
ZCTA5 34949,12,6992,57238,1034,265500,6742,4755,6581,199,1406,2232,1573,1171,7854,3835,4019,3835,3135,700,2017-01-01,zipcode,Fort pierce
ZCTA5 34950,12,15805,23068,745,75900,12067,5395,10161,3087,3541,2558,762,213,7379,5855,1524,5855,2428,3427,2017-01-01,zipcode,Fort pierce
ZCTA5 34951,12,15349,46188,901,89300,13508,7188,12376,1279,5048,3748,1354,947,8474,6698,1776,6698,5631,1067,2017-01-01,zipcode,Fort pierce
ZCTA5 34952,12,38936,43301,1137,109900,34174,16581,30793,3327,10968,11007,3666,1825,21054,16652,4402,16652,11399,5253,2017-01-01,zipcode,Port saint lucie
ZCTA5 34953,12,69139,57738,1251,163800,53105,17721,44712,7113,14434,15756,5305,2104,23477,20968,2509,20968,16432,4536,2017-01-01,zipcode,Port saint lucie
ZCTA5 34956,12,9819,37776,776,81400,7654,3892,6401,2611,2007,1234,334,215,2587,2080,507,2080,1274,806,2017-01-01,zipcode,Indiantown
ZCTA5 34957,12,23144,50193,1048,210200,20792,10796,18926,1209,6156,5823,3479,2259,17611,10689,6922,10689,7898,2791,2017-01-01,zipcode,Jensen beach
ZCTA5 34972,12,20121,37028,674,87300,16198,8659,13523,4416,4923,2792,962,430,7164,5379,1785,5379,3624,1755,2017-01-01,zipcode,Okeechobee
ZCTA5 34974,12,23871,40056,746,95100,19711,10557,17497,3462,7067,4898,1539,531,14234,9469,4765,9469,7246,2223,2017-01-01,zipcode,Okeechobee
ZCTA5 34981,12,5957,50166,942,176500,4968,2430,4124,472,1742,1037,515,358,2097,1819,278,1819,1076,743,2017-01-01,zipcode,Fort pierce
ZCTA5 34982,12,25492,36422,969,100600,20782,9806,18077,3469,6655,5291,1782,880,11218,9698,1520,9698,6457,3241,2017-01-01,zipcode,Fort pierce
ZCTA5 34983,12,42223,50909,1286,149800,34271,14371,29424,3856,10736,10096,3102,1634,15305,13642,1663,13642,10481,3161,2017-01-01,zipcode,Port saint lucie
ZCTA5 34984,12,15328,56536,1298,154300,12697,4773,10991,1383,3639,3960,1287,722,6135,5344,791,5344,4243,1101,2017-01-01,zipcode,Port saint lucie
ZCTA5 34986,12,24208,54375,1250,198500,20534,12121,18795,1530,5166,5612,4063,2424,13481,10760,2721,10760,8634,2126,2017-01-01,zipcode,Port saint lucie
ZCTA5 34987,12,7897,72724,1613,262200,6232,3390,5886,345,1303,2128,1344,766,3675,3008,667,3008,2015,993,2017-01-01,zipcode,Port saint lucie
ZCTA5 34990,12,29088,78811,1406,325300,24841,11986,22180,1131,4394,7297,5744,3614,13569,11733,1836,11733,10068,1665,2017-01-01,zipcode,Palm city
ZCTA5 34994,12,16563,39958,988,148100,13913,7115,12377,1430,3381,4354,1919,1293,9313,6938,2375,6938,3914,3024,2017-01-01,zipcode,Stuart
ZCTA5 34996,12,11069,60918,1136,221200,9961,5841,9562,361,2240,2841,2300,1820,8807,5731,3076,5731,4784,947,2017-01-01,zipcode,Stuart
ZCTA5 34997,12,43109,52582,1063,208500,36717,15885,32722,3505,9306,11471,5768,2672,20737,17163,3574,17163,13103,4060,2017-01-01,zipcode,Stuart
ZCTA5 35004,01,11167,60877,897,151900,8759,2518,7544,455,2296,3291,1029,473,4596,4460,136,4460,3557,903,2017-01-01,zipcode,Moody
ZCTA5 35005,01,7549,50271,879,92700,5994,2610,5272,834,1938,1752,473,275,3293,2792,501,2792,2015,777,2017-01-01,zipcode,Adamsville
ZCTA5 35006,01,2896,41540,711,81000,2326,1351,1952,302,880,536,165,69,1562,1087,475,1087,853,234,2017-01-01,zipcode,Adger
ZCTA5 35007,01,26215,69691,954,161500,19545,6923,16694,2056,4331,5376,2999,1932,9412,8628,784,8628,7012,1616,2017-01-01,zipcode,Alabaster
ZCTA5 35010,01,20896,36795,605,97100,16636,8094,14418,3337,4707,4238,1431,705,10119,8142,1977,8142,5350,2792,2017-01-01,zipcode,Alexander city
ZCTA5 35013,01,48,-666666666,-666666666,-666666666,48,39,48,48,0,0,0,0,24,18,6,18,0,18,2017-01-01,zipcode,Allgood
ZCTA5 35014,01,4668,46828,971,93500,4035,2414,3549,649,1296,1200,193,211,1822,1541,281,1541,1303,238,2017-01-01,zipcode,Alpine
ZCTA5 35016,01,16473,45435,602,129500,13329,5901,11428,1404,3516,4164,1484,860,7157,6339,818,6339,4781,1558,2017-01-01,zipcode,Arab
ZCTA5 35019,01,2047,31500,821,116500,1661,912,1451,300,629,404,110,8,958,810,148,810,665,145,2017-01-01,zipcode,Baileyton
ZCTA5 35020,01,26768,27772,704,68700,21191,9945,18203,3558,6963,5920,1257,505,12954,9995,2959,9995,5349,4646,2017-01-01,zipcode,Bessemer
ZCTA5 35022,01,20238,60249,905,171100,16859,5973,14763,1400,4212,4652,3077,1422,8848,8255,593,8255,6652,1603,2017-01-01,zipcode,Bessemer
ZCTA5 35023,01,24429,49570,809,116100,19548,9124,16738,2402,6404,5719,1470,743,9697,8597,1100,8597,6427,2170,2017-01-01,zipcode,Bessemer
ZCTA5 35031,01,8399,36813,576,111700,6568,3636,5586,1453,1814,1772,371,176,3694,2958,736,2958,2021,937,2017-01-01,zipcode,Blountsville
ZCTA5 35032,01,62,27321,-666666666,71700,41,26,41,4,21,11,0,5,23,17,6,17,15,2,2017-01-01,zipcode,Bon air
ZCTA5 35033,01,3455,40568,578,123200,2806,1498,2391,406,816,794,222,153,1691,1372,319,1372,1219,153,2017-01-01,zipcode,Bremen
ZCTA5 35034,01,5277,35625,744,61200,4500,3241,3798,1117,1593,717,299,72,1471,973,498,973,688,285,2017-01-01,zipcode,Brent
ZCTA5 35035,01,1387,82885,-666666666,132600,1171,392,1021,22,457,197,158,187,741,476,265,476,476,0,2017-01-01,zipcode,Brierfield
ZCTA5 35036,01,352,16029,238,80000,209,67,159,61,61,24,13,0,131,126,5,126,30,96,2017-01-01,zipcode,Brookside
ZCTA5 35040,01,16714,63501,1018,141100,12535,3821,11005,977,3225,3322,2427,1054,6839,6197,642,6197,4924,1273,2017-01-01,zipcode,Calera
ZCTA5 35042,01,5708,42393,626,134600,4980,1911,4413,599,2092,1191,284,247,2602,2153,449,2153,1521,632,2017-01-01,zipcode,Centreville
ZCTA5 35043,01,11043,91875,1365,233600,8165,2595,7211,314,1446,2429,2129,893,3862,3567,295,3567,3350,217,2017-01-01,zipcode,Chelsea
ZCTA5 35044,01,7522,38490,558,100800,6041,2531,5108,879,2066,1709,327,127,3464,3186,278,3186,2020,1166,2017-01-01,zipcode,Childersburg
ZCTA5 35045,01,14893,45857,632,109400,11919,5332,10359,1834,4137,2693,1001,694,6602,5847,755,5847,4195,1652,2017-01-01,zipcode,Clanton
ZCTA5 35046,01,4882,44048,773,111500,3740,1713,3370,610,1340,814,393,213,2750,1946,804,1946,1547,399,2017-01-01,zipcode,Clanton
ZCTA5 35049,01,3545,41477,609,132900,2822,1329,2387,433,784,740,241,189,1614,1335,279,1335,1135,200,2017-01-01,zipcode,Cleveland
ZCTA5 35051,01,9161,46315,637,161000,7609,4037,6625,1261,2494,1458,965,447,3654,3054,600,3054,2202,852,2017-01-01,zipcode,Columbiana
ZCTA5 35052,01,233,-666666666,-666666666,-666666666,233,186,233,86,46,66,28,7,0,0,0,0,0,0,2017-01-01,zipcode,Cook springs
ZCTA5 35053,01,2218,40473,830,157500,1905,1199,1679,299,529,448,263,140,2519,848,1671,848,756,92,2017-01-01,zipcode,Crane hill
ZCTA5 35054,01,3936,49133,545,165700,3366,1748,2890,522,1127,777,281,183,2288,1786,502,1786,1558,228,2017-01-01,zipcode,Cropwell
ZCTA5 35055,01,20780,40389,626,121100,16418,7435,14040,2364,4552,4406,1624,1094,8854,7953,901,7953,4987,2966,2017-01-01,zipcode,Cullman
ZCTA5 35057,01,13439,49605,678,142200,10377,4428,9083,1858,3102,2749,917,457,6093,4838,1255,4838,3966,872,2017-01-01,zipcode,Cullman
ZCTA5 35058,01,9364,39078,532,121800,7514,3529,6705,988,2617,2041,736,323,4231,3788,443,3788,2794,994,2017-01-01,zipcode,Cullman
ZCTA5 35060,01,290,-666666666,-666666666,33900,270,175,259,79,110,70,0,0,232,141,91,141,123,18,2017-01-01,zipcode,Docena
ZCTA5 35061,01,1479,41711,1079,74200,1290,540,1077,282,200,419,165,11,668,524,144,524,327,197,2017-01-01,zipcode,Dolomite
ZCTA5 35062,01,7879,44179,755,118400,6247,2972,5361,883,1958,1756,427,337,3413,2968,445,2968,2440,528,2017-01-01,zipcode,Dora
ZCTA5 35063,01,4007,43633,683,74100,3203,1790,2783,761,893,916,146,67,1787,1406,381,1406,1249,157,2017-01-01,zipcode,Empire
ZCTA5 35064,01,11403,36211,714,95900,9247,3986,7495,765,2296,3067,955,412,5630,4657,973,4657,2773,1884,2017-01-01,zipcode,Fairfield
ZCTA5 35068,01,8160,54312,942,136500,6533,2151,5523,560,1628,1903,958,474,3770,3506,264,3506,2474,1032,2017-01-01,zipcode,Fultondale
ZCTA5 35070,01,278,31429,800,81900,200,107,180,41,80,46,11,2,126,110,16,110,75,35,2017-01-01,zipcode,Garden city
ZCTA5 35071,01,15688,62570,903,158300,12433,4843,10819,725,3346,3731,1756,1261,6604,6146,458,6146,4948,1198,2017-01-01,zipcode,Gardendale
ZCTA5 35072,01,4877,37991,482,81700,4013,1948,3492,779,1386,966,249,112,2617,1903,714,1903,1572,331,2017-01-01,zipcode,Goodwater
ZCTA5 35073,01,2282,46745,946,84000,1867,955,1627,284,772,466,79,26,1075,881,194,881,754,127,2017-01-01,zipcode,Graysville
ZCTA5 35074,01,0,-666666666,-666666666,-666666666,0,0,0,0,0,0,0,0,0,0,0,0,0,0,2017-01-01,zipcode,Green pond
ZCTA5 35077,01,12498,38133,630,99500,10427,5610,8942,1680,3186,2921,784,371,5853,4781,1072,4781,3563,1218,2017-01-01,zipcode,Hanceville
ZCTA5 35078,01,1901,43013,565,144600,1560,733,1402,279,513,431,116,63,885,710,175,710,580,130,2017-01-01,zipcode,Harpersville
ZCTA5 35079,01,9034,51406,641,125400,7341,3543,6204,919,2256,2328,455,246,3643,3230,413,3230,2822,408,2017-01-01,zipcode,Hayden
ZCTA5 35080,01,17286,83933,1185,178900,12631,3347,10947,366,1859,3260,3933,1529,6301,6115,186,6115,5678,437,2017-01-01,zipcode,Helena
ZCTA5 35082,01,0,-666666666,-666666666,-666666666,0,0,0,0,0,0,0,0,9,0,9,0,0,0,2017-01-01,zipcode,Hollins
ZCTA5 35083,01,3500,35092,689,104500,2581,1355,2230,440,814,766,176,34,1507,1373,134,1373,1071,302,2017-01-01,zipcode,Holly pond
ZCTA5 35085,01,8433,36040,708,88200,6786,2904,5640,950,2616,1428,453,193,3474,3134,340,3134,2405,729,2017-01-01,zipcode,Jemison
ZCTA5 35087,01,1584,29221,640,101800,1509,896,1353,362,532,397,0,62,951,818,133,818,462,356,2017-01-01,zipcode,Joppa
ZCTA5 35089,01,1855,28189,639,100300,1707,991,1565,426,591,416,89,43,1003,781,222,781,570,211,2017-01-01,zipcode,Kellyton
ZCTA5 35091,01,3001,77218,1012,182900,2179,701,1906,161,695,586,290,174,1098,965,133,965,864,101,2017-01-01,zipcode,Kimberly
ZCTA5 35094,01,13938,59097,763,154000,10734,4311,9404,1283,2749,2973,1621,778,5905,5301,604,5301,4234,1067,2017-01-01,zipcode,Leeds
ZCTA5 35096,01,7443,51010,840,100600,6313,2616,5460,882,1910,1718,617,333,3999,2975,1024,2975,2452,523,2017-01-01,zipcode,Lincoln
ZCTA5 35097,01,1925,43000,745,130600,1592,956,1430,268,510,517,129,6,669,650,19,650,536,114,2017-01-01,zipcode,Locust fork
ZCTA5 35098,01,1093,36971,-666666666,89500,838,407,739,163,225,247,40,64,563,405,158,405,389,16,2017-01-01,zipcode,Logan
ZCTA5 35111,01,16347,74950,729,186800,13401,5086,11545,1144,3654,3793,2055,899,6667,5923,744,5923,5283,640,2017-01-01,zipcode,Mc calla
ZCTA5 35112,01,341,97966,-666666666,104700,251,96,188,0,116,48,24,0,157,96,61,96,96,0,2017-01-01,zipcode,Margaret
ZCTA5 35114,01,8479,80948,896,202800,6604,1941,5593,546,978,1571,1612,886,3185,3022,163,3022,2566,456,2017-01-01,zipcode,Alabaster
ZCTA5 35115,01,15152,39712,768,121700,12252,5080,9303,1646,3420,2430,1124,683,6260,5445,815,5445,3630,1815,2017-01-01,zipcode,Montevallo
ZCTA5 35116,01,4281,64950,805,155400,3570,1403,3128,293,1224,939,477,195,1841,1697,144,1697,1463,234,2017-01-01,zipcode,Morris
ZCTA5 35117,01,4984,68438,911,152300,4087,1466,3541,274,1211,1226,543,287,2129,1963,166,1963,1679,284,2017-01-01,zipcode,Mount olive
ZCTA5 35118,01,2889,53088,722,126600,2384,1109,2147,409,759,738,133,108,1317,1146,171,1146,933,213,2017-01-01,zipcode,Mulga
ZCTA5 35119,01,235,-666666666,-666666666,-666666666,181,63,181,98,38,45,0,0,70,70,0,70,45,25,2017-01-01,zipcode,New castle
ZCTA5 35120,01,13305,60100,684,142900,10324,3496,8814,1303,3247,2731,1021,512,5329,4851,478,4851,4172,679,2017-01-01,zipcode,Odenville
ZCTA5 35121,01,15208,48814,669,123400,12217,5971,10254,2260,2811,3635,954,594,6487,5648,839,5648,3823,1825,2017-01-01,zipcode,Oneonta
ZCTA5 35124,01,24545,75730,1027,181000,19543,5705,16994,1336,3023,5778,4233,2624,9978,9329,649,9329,7755,1574,2017-01-01,zipcode,Pelham
ZCTA5 35125,01,10422,40700,653,115100,8420,3967,7514,1634,2742,2135,585,418,4789,4064,725,4064,2755,1309,2017-01-01,zipcode,Pell city
ZCTA5 35126,01,21727,64098,962,144100,17631,6733,15013,1461,5252,5601,1878,821,8481,7782,699,7782,6576,1206,2017-01-01,zipcode,Pinson
ZCTA5 35127,01,10224,64761,1067,151000,8101,3168,6921,539,2267,2564,1108,443,3982,3688,294,3688,3240,448,2017-01-01,zipcode,Pleasant grove
ZCTA5 35128,01,11176,50101,770,166700,9069,3150,7833,1146,2566,2631,917,573,5207,4592,615,4592,3386,1206,2017-01-01,zipcode,Pell city
ZCTA5 35130,01,2915,39677,679,77400,2400,1053,2115,483,915,558,111,48,1655,1228,427,1228,978,250,2017-01-01,zipcode,Quinton
ZCTA5 35131,01,4063,36101,556,116100,3298,1724,2800,700,1134,789,113,64,1766,1543,223,1543,1162,381,2017-01-01,zipcode,Ragland
ZCTA5 35133,01,3292,46573,527,116900,2575,1455,2361,280,914,896,173,98,1566,1312,254,1312,1242,70,2017-01-01,zipcode,Remlap
ZCTA5 35135,01,2007,52656,735,182900,1488,426,1360,116,412,593,146,93,896,739,157,739,544,195,2017-01-01,zipcode,Riverside
ZCTA5 35136,01,1922,39321,273,128100,1690,953,1481,288,464,522,146,61,1216,775,441,775,631,144,2017-01-01,zipcode,Rockford
ZCTA5 35139,01,148,-666666666,-666666666,-666666666,125,86,125,77,40,8,0,0,64,64,0,64,56,8,2017-01-01,zipcode,Sayre
ZCTA5 35143,01,3290,55769,583,162800,2641,1366,2412,353,840,712,359,148,2254,1280,974,1280,1169,111,2017-01-01,zipcode,Shelby
ZCTA5 35146,01,12159,65907,653,169400,9755,4465,8778,1455,3356,2065,1380,522,4182,3748,434,3748,3238,510,2017-01-01,zipcode,Springville
ZCTA5 35147,01,5912,78460,1188,170700,4544,1536,4014,494,908,1222,953,437,2373,2099,274,2099,1879,220,2017-01-01,zipcode,Sterrett
ZCTA5 35148,01,2614,34792,681,96000,2040,1066,1750,279,698,664,84,25,1222,1027,195,1027,691,336,2017-01-01,zipcode,Sumiton
ZCTA5 35149,01,493,35590,-666666666,-666666666,462,234,309,122,118,69,0,0,257,207,50,207,171,36,2017-01-01,zipcode,Sycamore
ZCTA5 35150,01,17895,33750,565,84900,13544,6179,11764,2241,4447,3590,1030,456,8495,7131,1364,7131,4591,2540,2017-01-01,zipcode,Sylacauga
ZCTA5 35151,01,7225,38438,723,91100,5843,3300,5002,1202,1692,1545,306,257,3591,2835,756,2835,2436,399,2017-01-01,zipcode,Sylacauga
ZCTA5 35160,01,26197,33757,544,85500,21769,11186,18539,4082,6630,5436,1355,1036,12336,10134,2202,10134,6892,3242,2017-01-01,zipcode,Talladega
ZCTA5 35171,01,3880,50057,720,102700,2927,1382,2403,590,928,459,295,131,1528,1319,209,1319,1087,232,2017-01-01,zipcode,Thorsby
ZCTA5 35172,01,2943,33638,628,70300,2486,1322,2291,718,896,539,95,43,1335,1159,176,1159,814,345,2017-01-01,zipcode,Trafford
ZCTA5 35173,01,27385,81776,1084,221400,20510,7102,18315,1261,4608,6013,4174,2259,10125,9454,671,9454,8488,966,2017-01-01,zipcode,Trussville
ZCTA5 35175,01,5857,51087,517,114500,4564,2020,4013,833,1312,1033,553,282,2403,2028,375,2028,1767,261,2017-01-01,zipcode,Union grove
ZCTA5 35176,01,910,42350,675,65700,773,302,594,177,256,132,19,10,418,393,25,393,298,95,2017-01-01,zipcode,Vandiver
ZCTA5 35178,01,4122,47782,599,84800,3052,1364,2589,533,839,945,235,37,1672,1423,249,1423,1296,127,2017-01-01,zipcode,Vincent
ZCTA5 35179,01,9328,43757,736,128100,7348,3135,6293,1196,2381,1989,441,286,3700,3316,384,3316,2749,567,2017-01-01,zipcode,Vinemont
ZCTA5 35180,01,14653,53647,595,132500,11544,5141,10241,1126,4063,3692,988,372,5766,5333,433,5333,4682,651,2017-01-01,zipcode,Warrior
ZCTA5 35183,01,922,53519,-666666666,76400,750,193,649,63,318,248,0,20,315,264,51,264,253,11,2017-01-01,zipcode,Weogufka
ZCTA5 35184,01,5257,41461,760,88300,4026,2320,3488,713,1250,890,424,211,2464,1829,635,1829,1435,394,2017-01-01,zipcode,West blocton
ZCTA5 35186,01,4862,61576,1197,155800,4048,1802,3532,384,1352,1050,437,309,2213,1860,353,1860,1593,267,2017-01-01,zipcode,Wilsonville
ZCTA5 35187,01,10,-666666666,-666666666,-666666666,10,10,10,4,0,6,0,0,14,7,7,7,7,0,2017-01-01,zipcode,Wilton
ZCTA5 35188,01,3484,57118,869,118900,2704,1162,2338,234,1236,677,134,57,1225,1033,192,1033,807,226,2017-01-01,zipcode,Woodstock
ZCTA5 35203,01,3151,16295,589,182800,3054,1915,2654,557,904,533,424,236,1854,1596,258,1596,250,1346,2017-01-01,zipcode,Birmingham
ZCTA5 35204,01,9900,21929,554,60300,8148,3882,7057,1481,2412,2320,537,307,6011,4574,1437,4574,1724,2850,2017-01-01,zipcode,Birmingham
ZCTA5 35205,01,20833,34399,733,171200,18577,6303,13648,1085,2758,3201,4025,2579,12529,9682,2847,9682,2625,7057,2017-01-01,zipcode,Birmingham
ZCTA5 35206,01,15952,32537,798,76200,12837,5239,11325,1911,3877,3844,1138,555,8517,6583,1934,6583,3305,3278,2017-01-01,zipcode,Birmingham
ZCTA5 35207,01,8939,23170,505,60400,6525,3333,5519,1193,1881,1703,464,278,4377,3357,1020,3357,1803,1554,2017-01-01,zipcode,Birmingham
ZCTA5 35208,01,14330,34755,882,73900,11274,4941,9315,1429,3011,3804,750,321,7145,5442,1703,5442,2987,2455,2017-01-01,zipcode,Birmingham
ZCTA5 35209,01,28765,52734,917,307600,23142,6254,17999,776,2714,4242,5492,4775,15298,12730,2568,12730,5554,7176,2017-01-01,zipcode,Birmingham
ZCTA5 35210,01,13569,44975,861,132300,11256,4335,10055,1155,2916,2676,2146,1162,6208,5867,341,5867,3929,1938,2017-01-01,zipcode,Birmingham
ZCTA5 35211,01,25095,30941,737,79100,20690,8940,17588,2683,5062,5841,2508,1494,14902,11335,3567,11335,5534,5801,2017-01-01,zipcode,Birmingham
ZCTA5 35212,01,12501,29220,566,125300,9588,3703,8320,1256,2764,2384,1324,592,6217,4998,1219,4998,2075,2923,2017-01-01,zipcode,Birmingham
ZCTA5 35213,01,13513,110696,1201,519000,10399,3659,9200,114,534,1190,4198,3164,6094,5487,607,5487,4179,1308,2017-01-01,zipcode,Birmingham
ZCTA5 35214,01,18652,45820,730,102100,15178,6424,13297,1114,3702,5328,2008,1145,8745,7311,1434,7311,5498,1813,2017-01-01,zipcode,Birmingham
ZCTA5 35215,01,48418,37846,827,98100,35396,12171,29036,3733,9251,10892,3654,1506,20964,18191,2773,18191,9823,8368,2017-01-01,zipcode,Birmingham
ZCTA5 35216,01,36699,58742,968,270100,28119,7237,24380,1495,3738,6262,7818,5067,16466,14861,1605,14861,7856,7005,2017-01-01,zipcode,Birmingham
ZCTA5 35217,01,13363,31134,685,78600,10883,5141,9435,1807,3613,2786,947,282,6339,5024,1315,5024,2817,2207,2017-01-01,zipcode,Birmingham
ZCTA5 35218,01,7097,24645,755,63800,5536,2336,4748,820,1652,1848,319,109,3794,2850,944,2850,1091,1759,2017-01-01,zipcode,Birmingham
ZCTA5 35221,01,4716,32627,828,60300,3907,1784,3383,441,1312,1150,312,168,2443,1906,537,1906,1262,644,2017-01-01,zipcode,Birmingham
ZCTA5 35222,01,8856,53034,679,224500,7242,2473,6501,640,946,1540,1917,1458,4693,4062,631,4062,2280,1782,2017-01-01,zipcode,Birmingham
ZCTA5 35223,01,10898,121738,1403,479900,8487,3449,7546,47,230,1188,2970,3111,4446,4081,365,4081,3516,565,2017-01-01,zipcode,Birmingham
ZCTA5 35224,01,5376,35240,774,68100,4147,1580,3576,429,1289,1415,388,55,2814,2121,693,2121,1303,818,2017-01-01,zipcode,Birmingham
ZCTA5 35226,01,35119,102616,1154,256400,26993,7795,24251,547,3116,5499,8260,6829,14268,13410,858,13410,10695,2715,2017-01-01,zipcode,Birmingham
ZCTA5 35228,01,10037,32399,869,68000,8138,3345,6933,1062,2592,2353,727,199,4597,3794,803,3794,2278,1516,2017-01-01,zipcode,Birmingham
ZCTA5 35229,01,1206,-666666666,-666666666,-666666666,1206,831,0,0,0,0,0,0,0,0,0,0,0,0,2017-01-01,zipcode,Birmingham
ZCTA5 35233,01,1759,39583,1117,216800,1633,720,1011,80,133,106,380,312,1155,858,297,858,161,697,2017-01-01,zipcode,Birmingham
ZCTA5 35234,01,5446,24228,616,62000,4871,2685,4329,1049,1445,1340,384,111,2805,2069,736,2069,935,1134,2017-01-01,zipcode,Birmingham
ZCTA5 35235,01,19630,52175,937,121300,15661,5090,13783,1394,3796,5042,2158,1393,8941,8102,839,8102,5762,2340,2017-01-01,zipcode,Birmingham
ZCTA5 35242,01,53153,88167,1046,344800,42478,13129,36823,943,4143,9157,14617,7963,23122,20995,2127,20995,14772,6223,2017-01-01,zipcode,Birmingham
ZCTA5 35243,01,17114,74890,1151,339200,13936,4523,12415,235,939,2690,5032,3519,8766,7736,1030,7736,4730,3006,2017-01-01,zipcode,Birmingham
ZCTA5 35244,01,33638,84158,1095,284400,26665,7235,23210,912,2485,6020,8240,5553,13928,12971,957,12971,8762,4209,2017-01-01,zipcode,Birmingham
ZCTA5 35254,01,1403,10688,570,83200,1379,1022,199,72,90,26,0,11,219,196,23,196,58,138,2017-01-01,zipcode,Birmingham
ZCTA5 35401,01,36898,24732,741,110600,32516,18420,15804,3075,5250,3959,1853,1667,17830,11195,6635,11195,3854,7341,2017-01-01,zipcode,Tuscaloosa
ZCTA5 35404,01,22175,39574,842,124400,18583,7350,13198,1476,4466,3648,2303,1305,10874,7948,2926,7948,3932,4016,2017-01-01,zipcode,Tuscaloosa
ZCTA5 35405,01,44106,52407,830,170700,34862,12436,27985,2480,7529,8663,6202,3111,19148,16259,2889,16259,8986,7273,2017-01-01,zipcode,Tuscaloosa
ZCTA5 35406,01,17040,89260,977,328000,12872,4786,11438,419,856,2196,4204,3763,7566,6575,991,6575,5169,1406,2017-01-01,zipcode,Tuscaloosa
ZCTA5 35441,01,1111,36731,525,91000,903,517,719,136,273,200,80,30,815,372,443,372,320,52,2017-01-01,zipcode,Akron
ZCTA5 35442,01,6130,30917,512,92100,5133,3039,4408,1187,1307,1313,468,133,2554,1925,629,1925,1408,517,2017-01-01,zipcode,Aliceville
ZCTA5 35443,01,2286,14474,610,45300,1705,1145,1249,299,702,168,63,17,1287,716,571,716,425,291,2017-01-01,zipcode,Boligee
ZCTA5 35444,01,4063,49854,752,100600,3240,1364,2657,460,1034,831,269,63,1496,1395,101,1395,1116,279,2017-01-01,zipcode,Brookwood
ZCTA5 35446,01,1970,55852,857,115800,1621,580,1261,222,539,403,71,26,808,718,90,718,559,159,2017-01-01,zipcode,Buhl
ZCTA5 35447,01,3032,35809,398,82500,2408,1105,2030,384,834,594,178,40,1648,1235,413,1235,945,290,2017-01-01,zipcode,Carrollton
ZCTA5 35452,01,3181,56406,784,154000,2558,1169,2282,392,889,696,154,151,1233,1116,117,1116,886,230,2017-01-01,zipcode,Coker
ZCTA5 35453,01,11144,50067,778,134600,8603,3578,7268,1462,2575,2195,784,252,4534,3879,655,3879,3271,608,2017-01-01,zipcode,Cottondale
ZCTA5 35456,01,3403,49495,712,120200,2895,1094,2329,370,963,731,197,68,1331,1132,199,1132,976,156,2017-01-01,zipcode,Duncanville
ZCTA5 35457,01,0,-666666666,-666666666,-666666666,0,0,0,0,0,0,0,0,0,0,0,0,0,0,2017-01-01,zipcode,Echola
ZCTA5 35458,01,794,39655,-666666666,141700,596,259,501,46,266,139,36,14,282,226,56,226,172,54,2017-01-01,zipcode,Elrod
ZCTA5 35459,01,1207,37197,515,74300,910,448,779,146,329,203,54,47,573,386,187,386,309,77,2017-01-01,zipcode,Emelle
ZCTA5 35460,01,596,20753,625,-666666666,518,292,430,64,122,93,105,46,405,286,119,286,184,102,2017-01-01,zipcode,Epes
ZCTA5 35461,01,1906,40673,387,89000,1632,818,1376,203,585,471,79,38,1076,799,277,799,688,111,2017-01-01,zipcode,Ethelsville
ZCTA5 35462,01,4251,21819,443,77500,3292,1798,3149,865,932,965,274,113,2529,1687,842,1687,1130,557,2017-01-01,zipcode,Eutaw
ZCTA5 35463,01,1729,56429,-666666666,117300,1393,553,1276,150,419,479,214,14,789,684,105,684,625,59,2017-01-01,zipcode,Fosters
ZCTA5 35464,01,680,16667,256,-666666666,484,308,419,83,149,111,68,8,318,238,80,238,149,89,2017-01-01,zipcode,Gainesville
ZCTA5 35466,01,5311,41305,520,96100,4181,1911,3734,547,1520,1122,400,145,2446,2051,395,2051,1491,560,2017-01-01,zipcode,Gordo
ZCTA5 35469,01,261,-666666666,-666666666,-666666666,244,130,244,31,57,118,33,5,201,87,114,87,56,31,2017-01-01,zipcode,Knoxville
ZCTA5 35470,01,4798,13506,552,114600,4060,2234,2437,390,873,635,330,209,2470,1838,632,1838,905,933,2017-01-01,zipcode,Livingston
ZCTA5 35473,01,16571,57851,846,169200,13464,4928,11125,1105,3067,3018,2296,1639,7101,6333,768,6333,4245,2088,2017-01-01,zipcode,Northport
ZCTA5 35474,01,6715,49334,752,119200,5282,2150,4590,851,1786,1167,506,280,2767,2297,470,2297,1920,377,2017-01-01,zipcode,Moundville
ZCTA5 35475,01,15642,79294,784,184400,12273,3922,10573,788,3102,3501,1886,1296,6267,5199,1068,5199,4508,691,2017-01-01,zipcode,Northport
ZCTA5 35476,01,7408,40074,738,134900,5861,2510,5085,716,1602,1653,690,424,3273,2830,443,2830,1455,1375,2017-01-01,zipcode,Northport
ZCTA5 35477,01,176,51364,-666666666,-666666666,136,48,112,5,55,47,0,5,173,56,117,56,56,0,2017-01-01,zipcode,Panola
ZCTA5 35480,01,1446,80500,1316,150000,1279,461,1193,92,369,486,111,135,506,436,70,436,368,68,2017-01-01,zipcode,Ralph
ZCTA5 35481,01,3734,27702,360,80000,3150,1738,2650,579,1080,829,119,43,1854,1519,335,1519,1049,470,2017-01-01,zipcode,Reform
ZCTA5 35490,01,3927,53242,985,118900,2897,1014,2504,528,925,657,284,110,1566,1277,289,1277,1000,277,2017-01-01,zipcode,Vance
ZCTA5 35501,01,9465,33573,619,84900,7398,3449,6433,1277,2405,2118,344,289,4744,3774,970,3774,2314,1460,2017-01-01,zipcode,Jasper
ZCTA5 35503,01,8782,43575,701,103100,7093,3139,5992,1181,2201,1923,478,209,4162,3369,793,3369,2618,751,2017-01-01,zipcode,Jasper
ZCTA5 35504,01,13481,46597,619,139600,11109,5261,9566,1478,3139,3061,1093,795,6193,5138,1055,5138,3935,1203,2017-01-01,zipcode,Jasper
ZCTA5 35540,01,2543,45074,467,87400,2191,1064,1944,382,779,532,127,124,1194,1075,119,1075,817,258,2017-01-01,zipcode,Addison
ZCTA5 35541,01,3470,44113,604,138100,3098,1530,2714,502,1002,744,211,255,2711,1448,1263,1448,1311,137,2017-01-01,zipcode,Arley
ZCTA5 35542,01,1086,35588,672,83200,989,520,836,295,309,175,57,0,578,498,80,498,430,68,2017-01-01,zipcode,Bankston
ZCTA5 35543,01,1375,29901,537,58100,1074,538,855,183,323,291,27,31,576,545,31,545,415,130,2017-01-01,zipcode,Bear creek
ZCTA5 35544,01,675,52383,521,41700,529,235,474,147,154,117,52,4,360,281,79,281,239,42,2017-01-01,zipcode,Beaverton
ZCTA5 35545,01,95,31042,-666666666,-666666666,71,42,56,23,22,8,0,3,43,39,4,39,30,9,2017-01-01,zipcode,Belk
ZCTA5 35546,01,4123,38566,403,82100,3213,1499,2794,541,1044,705,362,142,1719,1582,137,1582,1251,331,2017-01-01,zipcode,Berry
ZCTA5 35548,01,1760,32000,374,65600,1408,794,1223,267,585,286,34,51,907,748,159,748,563,185,2017-01-01,zipcode,Brilliant
ZCTA5 35549,01,3761,33281,531,65200,3093,1705,2731,709,1058,727,90,147,1857,1502,355,1502,1111,391,2017-01-01,zipcode,Carbon hill
ZCTA5 35550,01,5192,32168,603,73700,4237,2239,3744,751,1596,1220,103,74,2594,2157,437,2157,1488,669,2017-01-01,zipcode,Cordova
ZCTA5 35552,01,868,31477,220,-666666666,619,327,547,124,205,193,20,5,361,302,59,302,273,29,2017-01-01,zipcode,Detroit
ZCTA5 35553,01,4366,33617,425,66100,3652,1877,3223,887,1277,644,273,142,2404,1607,797,1607,1317,290,2017-01-01,zipcode,Double springs
ZCTA5 35554,01,1080,40000,-666666666,71200,886,375,783,156,370,208,30,19,553,448,105,448,364,84,2017-01-01,zipcode,Eldridge
ZCTA5 35555,01,9619,38070,546,88100,7720,3724,6591,1016,2437,1818,938,382,4986,3902,1084,3902,2785,1117,2017-01-01,zipcode,Fayette
ZCTA5 35559,01,6,-666666666,-666666666,-666666666,6,6,6,0,0,6,0,0,9,6,3,6,6,0,2017-01-01,zipcode,Glen allen
ZCTA5 35563,01,4781,36323,441,108100,4056,1767,3545,536,1431,1166,233,179,2318,1975,343,1975,1424,551,2017-01-01,zipcode,Guin
ZCTA5 35564,01,2012,27708,701,88700,1582,760,1338,295,477,451,59,56,995,835,160,835,634,201,2017-01-01,zipcode,Hackleburg
ZCTA5 35565,01,12977,31781,536,68400,10148,4808,9159,2176,3280,2757,612,334,6302,5221,1081,5221,3974,1247,2017-01-01,zipcode,Haleyville
ZCTA5 35570,01,11540,38673,556,94600,9387,4734,8208,1760,2531,2776,743,398,5447,4685,762,4685,3468,1217,2017-01-01,zipcode,Hamilton
ZCTA5 35571,01,867,36786,505,67900,749,359,652,172,203,218,46,13,536,374,162,374,302,72,2017-01-01,zipcode,Hodges
ZCTA5 35572,01,1237,29205,-666666666,139100,940,519,827,208,263,240,48,68,898,457,441,457,384,73,2017-01-01,zipcode,Houston
ZCTA5 35574,01,1612,36635,400,84600,1350,667,1224,166,470,361,105,122,891,694,197,694,633,61,2017-01-01,zipcode,Kennedy
ZCTA5 35575,01,1071,41563,513,67200,866,448,764,199,290,194,72,9,466,431,35,431,334,97,2017-01-01,zipcode,Lynn
ZCTA5 35576,01,2893,40662,455,79100,2489,1172,2226,392,940,607,170,117,1521,1340,181,1340,996,344,2017-01-01,zipcode,Millport
ZCTA5 35577,01,43,-666666666,-666666666,-666666666,36,16,17,0,14,2,1,0,46,7,39,7,7,0,2017-01-01,zipcode,Natural bridge
ZCTA5 35578,01,5850,34805,642,76700,4794,2536,4298,1067,1712,1030,335,154,2677,2252,425,2252,1934,318,2017-01-01,zipcode,Nauvoo
ZCTA5 35579,01,3298,39127,334,71400,2596,1177,2344,535,954,681,142,32,1688,1306,382,1306,1067,239,2017-01-01,zipcode,Oakman
ZCTA5 35580,01,3754,39777,574,78300,2920,1163,2506,505,935,916,74,76,1727,1402,325,1402,1135,267,2017-01-01,zipcode,Parrish
ZCTA5 35581,01,5035,31381,638,76700,3845,2029,3312,771,979,1031,331,200,2362,1926,436,1926,1364,562,2017-01-01,zipcode,Phil campbell
ZCTA5 35582,01,4204,36795,436,80400,3265,1446,2747,590,1132,676,202,147,1982,1642,340,1642,1157,485,2017-01-01,zipcode,Red bay
ZCTA5 35584,01,408,26875,779,48000,316,181,291,54,106,122,4,5,189,149,40,149,115,34,2017-01-01,zipcode,Sipsey
ZCTA5 35585,01,1479,41917,757,120600,1218,536,1064,61,396,402,128,77,694,599,95,599,437,162,2017-01-01,zipcode,Spruce pine
ZCTA5 35586,01,3915,28905,391,77500,3157,1701,2962,770,1041,915,165,71,2326,1864,462,1864,1352,512,2017-01-01,zipcode,Sulligent
ZCTA5 35587,01,865,35676,-666666666,63300,693,295,478,106,228,127,6,11,460,328,132,328,290,38,2017-01-01,zipcode,Townley
ZCTA5 35592,01,4974,43868,406,70400,3924,1776,3234,554,1231,870,382,197,2384,1969,415,1969,1438,531,2017-01-01,zipcode,Vernon
ZCTA5 35593,01,1599,39130,457,87900,1346,542,1223,361,387,296,111,68,855,700,155,700,583,117,2017-01-01,zipcode,Vina
ZCTA5 35594,01,7041,37239,554,101900,5703,2694,4914,733,1733,1551,649,248,3702,2882,820,2882,2076,806,2017-01-01,zipcode,Winfield
ZCTA5 35601,01,32822,38898,619,97000,25898,11900,22892,5301,6444,6327,3578,1242,14517,12559,1958,12559,7564,4995,2017-01-01,zipcode,Decatur
ZCTA5 35603,01,31496,52205,628,167300,25390,10366,21405,2120,5646,7634,4186,1819,13765,12833,932,12833,8698,4135,2017-01-01,zipcode,Decatur
ZCTA5 35610,01,1836,40586,452,149800,1561,600,1412,218,685,349,91,69,864,812,52,812,653,159,2017-01-01,zipcode,Anderson
ZCTA5 35611,01,25979,35651,592,122500,21332,9805,17870,4030,5974,4819,2190,857,11634,10066,1568,10066,6094,3972,2017-01-01,zipcode,Athens
ZCTA5 35613,01,24385,74100,793,173700,19367,9008,17192,2064,4927,5143,3325,1733,7893,7249,644,7249,6513,736,2017-01-01,zipcode,Athens
ZCTA5 35614,01,8656,37396,661,89100,6559,3002,5742,1516,2072,1600,369,185,3308,3049,259,3049,2271,778,2017-01-01,zipcode,Athens
ZCTA5 35615,01,142,-666666666,-666666666,-666666666,142,13,142,13,0,0,129,0,157,73,84,73,70,3,2017-01-01,zipcode,Belle mina
ZCTA5 35616,01,4051,39934,661,83800,3268,1766,2807,725,915,801,153,213,2337,1698,639,1698,1330,368,2017-01-01,zipcode,Cherokee
ZCTA5 35618,01,1743,28438,386,76400,1361,745,1154,289,539,241,69,16,1121,835,286,835,556,279,2017-01-01,zipcode,Courtland
ZCTA5 35619,01,4279,48827,638,94200,3506,1634,3036,866,1004,921,179,66,2022,1648,374,1648,1355,293,2017-01-01,zipcode,Danville
ZCTA5 35620,01,8226,49144,624,130100,6669,2778,5681,1006,2014,1919,456,286,3422,3159,263,3159,2556,603,2017-01-01,zipcode,Elkmont
ZCTA5 35621,01,3042,38333,495,103600,2471,1109,2072,448,836,455,219,114,1331,1286,45,1286,1096,190,2017-01-01,zipcode,Eva
ZCTA5 35622,01,8156,51000,734,87800,6315,2784,5729,1129,2324,1645,414,217,3403,2752,651,2752,2346,406,2017-01-01,zipcode,Falkville
ZCTA5 35630,01,32971,32702,608,101200,27725,12334,21052,3597,6473,6133,2992,1857,17395,14925,2470,14925,6921,8004,2017-01-01,zipcode,Florence
ZCTA5 35633,01,22032,53401,797,138300,17463,7528,14903,1950,5409,3911,2239,1394,9554,8553,1001,8553,6961,1592,2017-01-01,zipcode,Florence
ZCTA5 35634,01,9510,65731,765,169200,8169,3602,7268,729,2694,2068,1159,618,4204,3878,326,3878,3419,459,2017-01-01,zipcode,Florence
ZCTA5 35640,01,25256,52239,635,131400,19871,7951,17105,2082,5673,6015,2071,1264,10634,9459,1175,9459,7442,2017,2017-01-01,zipcode,Hartselle
ZCTA5 35643,01,3449,42000,606,100900,3005,1350,2503,755,1064,488,155,41,1566,1394,172,1394,1209,185,2017-01-01,zipcode,Hillsboro
ZCTA5 35645,01,13658,57748,638,155200,11031,4641,9614,1101,3501,2828,1223,961,5919,5202,717,5202,4317,885,2017-01-01,zipcode,Killen
ZCTA5 35646,01,4303,39492,454,87700,3687,1894,3300,638,1419,884,115,244,2397,1761,636,1761,1341,420,2017-01-01,zipcode,Leighton
ZCTA5 35647,01,1058,43594,518,101900,906,379,736,123,355,143,89,26,420,385,35,385,294,91,2017-01-01,zipcode,Lester
ZCTA5 35648,01,3235,48516,573,113600,2536,1006,2165,307,1015,512,155,176,1412,1235,177,1235,1041,194,2017-01-01,zipcode,Lexington
ZCTA5 35649,01,73,109750,-666666666,430000,61,23,59,4,0,10,28,17,31,31,0,31,31,0,2017-01-01,zipcode,Mooresville
ZCTA5 35650,01,14241,45010,523,111500,11271,5699,10053,2026,4259,2663,792,313,6028,5409,619,5409,4252,1157,2017-01-01,zipcode,Moulton
ZCTA5 35651,01,1521,35769,706,106000,1149,619,969,143,428,322,46,30,592,530,62,530,409,121,2017-01-01,zipcode,Mount hope
ZCTA5 35652,01,8469,46804,698,122100,6951,3246,6226,881,2235,1847,820,443,4422,3633,789,3633,2867,766,2017-01-01,zipcode,Rogersville
ZCTA5 35653,01,11560,41868,606,97100,8646,3927,7035,2030,2801,1396,510,298,4651,3810,841,3810,2403,1407,2017-01-01,zipcode,Russellville
ZCTA5 35654,01,8313,39323,616,92900,6644,2746,5711,1253,2217,1557,401,283,3969,3088,881,3088,2196,892,2017-01-01,zipcode,Russellville
ZCTA5 35660,01,9007,33463,644,87700,7407,3690,6527,1301,2096,1937,721,472,4920,4051,869,4051,2341,1710,2017-01-01,zipcode,Sheffield
ZCTA5 35661,01,17170,52331,730,142100,13969,5849,11960,1064,3738,4081,2013,1064,7632,6863,769,6863,5302,1561,2017-01-01,zipcode,Muscle shoals
ZCTA5 35670,01,6515,45592,658,116600,5514,2481,4853,764,1617,1637,528,307,3274,2752,522,2752,2275,477,2017-01-01,zipcode,Somerville
ZCTA5 35671,01,2408,31507,542,-666666666,2120,663,1729,183,853,239,322,132,1077,942,135,942,611,331,2017-01-01,zipcode,Tanner
ZCTA5 35672,01,6095,51522,587,93000,4795,2381,4044,548,1780,1278,243,195,2862,2380,482,2380,1935,445,2017-01-01,zipcode,Town creek
ZCTA5 35673,01,7465,53811,528,111300,5971,2717,5282,1340,1595,1565,567,215,3194,2697,497,2697,2344,353,2017-01-01,zipcode,Trinity
ZCTA5 35674,01,18184,49532,644,109800,14596,6469,12742,2208,4292,4088,1359,795,8345,7076,1269,7076,5259,1817,2017-01-01,zipcode,Tuscumbia
ZCTA5 35677,01,1591,41250,825,90000,1245,526,1060,187,439,278,119,37,1047,666,381,666,512,154,2017-01-01,zipcode,Waterloo
ZCTA5 35739,01,5292,50315,745,115600,4010,1369,3704,469,1351,1130,496,258,2317,2086,231,2086,1582,504,2017-01-01,zipcode,Ardmore
ZCTA5 35740,01,3173,33177,478,102800,2585,1310,2218,350,964,577,226,101,1662,1404,258,1404,988,416,2017-01-01,zipcode,Bridgeport
ZCTA5 35741,01,2779,82286,983,271300,2317,992,2115,147,376,590,557,445,1369,1204,165,1204,921,283,2017-01-01,zipcode,Brownsboro
ZCTA5 35744,01,2437,35714,572,105200,1967,1072,1610,419,738,325,70,58,1055,854,201,854,697,157,2017-01-01,zipcode,Dutton
ZCTA5 35745,01,227,32250,-666666666,145800,205,120,175,15,107,31,15,7,161,107,54,107,91,16,2017-01-01,zipcode,Estillfork
ZCTA5 35746,01,663,32422,-666666666,-666666666,565,302,519,193,230,84,12,0,395,268,127,268,235,33,2017-01-01,zipcode,Fackler
ZCTA5 35747,01,5141,42667,562,123800,4143,1894,3634,535,1423,1106,367,203,2650,2106,544,2106,1651,455,2017-01-01,zipcode,Grant
ZCTA5 35748,01,7034,62313,589,156700,5590,2304,4913,748,1778,1035,850,502,2802,2607,195,2607,2188,419,2017-01-01,zipcode,Gurley
ZCTA5 35749,01,21862,83457,1174,175600,16690,4841,14486,787,3014,4563,3973,2149,8614,7830,784,7830,6891,939,2017-01-01,zipcode,Harvest
ZCTA5 35750,01,11782,45158,763,120900,9705,3483,8506,1349,3103,2482,1087,485,5339,4831,508,4831,3883,948,2017-01-01,zipcode,Hazel green
ZCTA5 35751,01,176,18304,-666666666,159700,162,65,154,10,91,44,9,0,102,75,27,75,57,18,2017-01-01,zipcode,Hollytree
ZCTA5 35752,01,2834,44232,812,87200,2282,1248,2035,499,739,567,196,34,1306,987,319,987,736,251,2017-01-01,zipcode,Hollywood
ZCTA5 35754,01,5480,52032,517,152300,4633,2084,3810,1027,1010,1168,458,147,2312,1923,389,1923,1481,442,2017-01-01,zipcode,Laceys spring
ZCTA5 35755,01,753,40417,578,200000,643,249,524,56,160,180,53,75,500,276,224,276,170,106,2017-01-01,zipcode,Langston
ZCTA5 35756,01,13298,77143,995,201000,9842,3232,8676,694,1627,2272,2677,1406,5052,4764,288,4764,4346,418,2017-01-01,zipcode,Madison
ZCTA5 35757,01,15499,91819,967,197000,12129,3717,10074,447,1403,3034,3284,1906,5957,5547,410,5547,4694,853,2017-01-01,zipcode,Madison
ZCTA5 35758,01,45205,87609,906,228700,36138,11146,30562,977,3900,8370,10428,6887,18822,17483,1339,17483,11612,5871,2017-01-01,zipcode,Madison
ZCTA5 35759,01,7573,83533,1030,182300,5966,1979,5260,342,1137,1868,1337,576,2983,2896,87,2896,2647,249,2017-01-01,zipcode,Meridianville
ZCTA5 35760,01,4801,46861,745,122300,3902,1572,3375,621,1387,839,403,125,2260,1865,395,1865,1452,413,2017-01-01,zipcode,New hope
ZCTA5 35761,01,12406,61058,813,142100,9684,3443,8479,1180,2430,2325,1735,809,5233,4696,537,4696,4110,586,2017-01-01,zipcode,New market
ZCTA5 35763,01,16943,105655,1139,268300,12676,4867,11209,387,1569,2438,4021,2794,6374,6163,211,6163,5786,377,2017-01-01,zipcode,Owens cross roads
ZCTA5 35764,01,616,33333,-666666666,98800,485,232,408,122,177,83,19,7,265,226,39,226,165,61,2017-01-01,zipcode,Paint rock
ZCTA5 35765,01,3729,33074,489,91500,3123,1653,2663,671,857,785,226,124,1784,1409,375,1409,1143,266,2017-01-01,zipcode,Pisgah
ZCTA5 35766,01,136,-666666666,-666666666,-666666666,102,41,102,0,42,30,7,23,94,67,27,67,54,13,2017-01-01,zipcode,Princeton
ZCTA5 35768,01,11543,40789,615,101000,9482,4463,8354,1512,3303,2290,666,583,5466,4512,954,4512,3034,1478,2017-01-01,zipcode,Scottsboro
ZCTA5 35769,01,9635,42137,627,143800,7834,3673,6892,914,2305,2147,1064,462,5247,3937,1310,3937,2869,1068,2017-01-01,zipcode,Scottsboro
ZCTA5 35771,01,3983,40263,667,128800,3194,1358,2932,582,1052,991,208,99,1687,1488,199,1488,1040,448,2017-01-01,zipcode,Section
ZCTA5 35772,01,4429,33514,506,86900,3396,1697,2898,467,1395,778,186,72,2256,1684,572,1684,1123,561,2017-01-01,zipcode,Stevenson
ZCTA5 35773,01,12666,52488,881,118500,10169,3104,8488,963,2651,2932,1186,756,5291,4727,564,4727,3671,1056,2017-01-01,zipcode,Toney
ZCTA5 35774,01,231,45804,-666666666,-666666666,231,145,158,18,111,14,15,0,81,69,12,69,61,8,2017-01-01,zipcode,Trenton
ZCTA5 35775,01,347,26875,-666666666,72400,347,174,346,192,60,94,0,0,313,263,50,263,196,67,2017-01-01,zipcode,Valhermoso springs
ZCTA5 35776,01,3584,37336,639,87600,2869,1330,2376,437,1163,575,112,89,1541,1286,255,1286,1098,188,2017-01-01,zipcode,Woodville
ZCTA5 35801,01,23987,66329,778,248200,20027,9012,17643,1713,2989,4371,4878,3692,10985,9918,1067,9918,6587,3331,2017-01-01,zipcode,Huntsville
ZCTA5 35802,01,21789,66399,798,224000,18368,7284,16113,717,2328,4404,5105,3559,11435,10180,1255,10180,6098,4082,2017-01-01,zipcode,Huntsville
ZCTA5 35803,01,26096,73020,905,174400,21210,8019,18812,969,3245,5314,6051,3233,11856,11192,664,11192,9001,2191,2017-01-01,zipcode,Huntsville
ZCTA5 35805,01,21345,23886,602,75600,15807,6209,12650,3304,3792,3868,1295,391,10702,9097,1605,9097,2858,6239,2017-01-01,zipcode,Huntsville
ZCTA5 35806,01,21316,71900,905,238900,17600,5531,15031,715,2060,3911,5361,2984,10627,9756,871,9756,4538,5218,2017-01-01,zipcode,Huntsville
ZCTA5 35808,01,1488,76750,1266,-666666666,1185,203,706,13,73,300,190,130,358,310,48,310,0,310,2017-01-01,zipcode,Huntsville
ZCTA5 35810,01,29749,37482,818,86000,24152,9821,19208,3165,5472,6716,2467,1388,12719,11331,1388,11331,7418,3913,2017-01-01,zipcode,Huntsville
ZCTA5 35811,01,28198,61055,838,156300,22675,8120,19622,2246,5192,6400,3650,2134,11850,10894,956,10894,8665,2229,2017-01-01,zipcode,Huntsville
ZCTA5 35816,01,13267,24423,647,90500,11397,3951,7969,1158,2089,2822,1292,608,8034,6458,1576,6458,1413,5045,2017-01-01,zipcode,Huntsville
ZCTA5 35824,01,8276,87813,887,220400,6834,1436,5550,177,527,1795,1514,1537,3732,3616,116,3616,1984,1632,2017-01-01,zipcode,Huntsville
ZCTA5 35896,01,684,-666666666,-666666666,-666666666,684,409,6,0,0,6,0,0,0,0,0,0,0,0,2017-01-01,zipcode,Huntsville
ZCTA5 35901,01,19950,37260,577,104100,16091,7794,13910,2527,4270,4520,1532,1061,9483,7607,1876,7607,4901,2706,2017-01-01,zipcode,Gadsden
ZCTA5 35903,01,17281,34409,641,88400,14268,6723,11796,2358,3933,3744,1031,730,8561,6719,1842,6719,4237,2482,2017-01-01,zipcode,Gadsden
ZCTA5 35904,01,14210,35674,624,67400,11527,5697,9863,2102,3114,3084,1166,397,6643,5318,1325,5318,4246,1072,2017-01-01,zipcode,Gadsden
ZCTA5 35905,01,6246,51250,579,119200,5247,2684,4802,820,1476,1671,443,392,2714,2310,404,2310,1765,545,2017-01-01,zipcode,Gadsden
ZCTA5 35906,01,9989,49455,733,151900,7933,3490,6890,543,1963,2561,1035,788,4721,4094,627,4094,2559,1535,2017-01-01,zipcode,Rainbow city
ZCTA5 35907,01,8497,69359,847,160100,6995,2652,6173,450,1578,2504,1135,506,3649,3291,358,3291,2936,355,2017-01-01,zipcode,Gadsden
ZCTA5 35950,01,21074,38147,624,105500,15402,6714,12964,3211,4309,3786,1103,555,7990,7255,735,7255,4549,2706,2017-01-01,zipcode,Albertville
ZCTA5 35951,01,12967,34483,665,87200,9764,4323,8221,2315,2887,2270,560,189,5017,4375,642,4375,2975,1400,2017-01-01,zipcode,Albertville
ZCTA5 35952,01,7651,39342,542,77200,6050,3138,5154,1435,1769,1472,358,120,3179,2640,539,2640,2100,540,2017-01-01,zipcode,Altoona
ZCTA5 35953,01,8023,44315,679,103900,6207,2933,5413,1097,2071,1752,337,156,3370,2841,529,2841,2340,501,2017-01-01,zipcode,Ashville
ZCTA5 35954,01,11343,40022,644,84900,9006,3821,8026,1367,3203,2607,422,427,5640,4367,1273,4367,3147,1220,2017-01-01,zipcode,Attalla
ZCTA5 35956,01,9276,49030,665,105000,7211,3223,5989,1045,2196,2095,351,302,3612,3179,433,3179,2633,546,2017-01-01,zipcode,Boaz
ZCTA5 35957,01,16190,38782,619,107300,12259,5340,10250,2444,2997,3209,1091,509,6534,5636,898,5636,3579,2057,2017-01-01,zipcode,Boaz
ZCTA5 35958,01,3622,50909,616,109200,3043,1390,2581,432,1211,646,256,36,1562,1416,146,1416,1119,297,2017-01-01,zipcode,Bryant
ZCTA5 35959,01,4639,41053,584,104200,3806,2075,3319,754,1223,943,226,173,3488,1938,1550,1938,1465,473,2017-01-01,zipcode,Cedar bluff
ZCTA5 35960,01,9864,42433,560,123900,8254,4311,7482,1465,2781,2133,531,572,6485,4307,2178,4307,3319,988,2017-01-01,zipcode,Centre
ZCTA5 35961,01,7029,38080,508,93900,5580,2847,4718,1522,1523,1363,196,114,2799,2405,394,2405,1600,805,2017-01-01,zipcode,Collinsville
ZCTA5 35962,01,9483,34953,621,78100,6977,3140,5774,1706,2092,1075,516,385,3443,2959,484,2959,2067,892,2017-01-01,zipcode,Crossville
ZCTA5 35963,01,1112,26587,-666666666,64200,948,614,883,250,340,223,55,15,620,431,189,431,314,117,2017-01-01,zipcode,Dawson
ZCTA5 35966,01,3778,37600,632,95600,3208,1597,2689,767,961,657,89,215,1808,1515,293,1515,1158,357,2017-01-01,zipcode,Flat rock
ZCTA5 35967,01,16300,40063,598,119900,12262,5061,10645,2941,3254,2982,833,635,7466,6018,1448,6018,3880,2138,2017-01-01,zipcode,Fort payne
ZCTA5 35968,01,4412,37778,560,102800,3774,1902,3271,852,1184,862,234,139,1831,1558,273,1558,1234,324,2017-01-01,zipcode,Fort payne
ZCTA5 35971,01,5727,39103,630,96800,4555,2049,3807,964,1155,1196,270,222,2437,2100,337,2100,1596,504,2017-01-01,zipcode,Fyffe
ZCTA5 35972,01,1035,67537,-666666666,109400,858,369,698,81,288,207,60,62,400,379,21,379,359,20,2017-01-01,zipcode,Gallant
ZCTA5 35973,01,2947,31721,635,81100,2350,1135,2019,527,788,532,123,49,1642,1254,388,1254,1048,206,2017-01-01,zipcode,Gaylesville
ZCTA5 35974,01,1526,37614,525,86700,1099,513,973,251,361,233,89,39,706,554,152,554,363,191,2017-01-01,zipcode,Geraldine
ZCTA5 35975,01,260,-666666666,-666666666,-666666666,260,137,226,68,89,41,28,0,148,85,63,85,72,13,2017-01-01,zipcode,Groveoak
ZCTA5 35976,01,17035,47583,614,157700,14281,6818,12687,1907,3562,3930,2156,1132,8301,6787,1514,6787,5134,1653,2017-01-01,zipcode,Guntersville
ZCTA5 35978,01,4623,38000,563,82100,3838,1758,3422,919,1394,777,223,109,2218,1852,366,1852,1406,446,2017-01-01,zipcode,Henagar
ZCTA5 35979,01,1540,33902,-666666666,123500,1094,492,968,138,507,287,24,12,753,657,96,657,474,183,2017-01-01,zipcode,Higdon
ZCTA5 35980,01,5475,39282,594,74500,4188,1727,3352,1096,977,883,157,239,2135,1773,362,1773,1410,363,2017-01-01,zipcode,Horton
ZCTA5 35981,01,2074,42075,229,104100,1818,793,1583,239,736,366,143,99,823,723,100,723,576,147,2017-01-01,zipcode,Ider
ZCTA5 35983,01,3912,51458,580,155900,3330,1572,2922,382,1096,1029,233,182,2571,1590,981,1590,1241,349,2017-01-01,zipcode,Leesburg
ZCTA5 35984,01,1668,35096,843,173000,1391,763,1294,135,368,339,324,128,1411,661,750,661,556,105,2017-01-01,zipcode,Mentone
ZCTA5 35986,01,8168,39250,574,117800,6600,3016,5672,1124,1960,2045,272,271,3749,3132,617,3132,2232,900,2017-01-01,zipcode,Rainsville
ZCTA5 35987,01,2674,46090,570,86500,2151,972,1829,261,834,566,136,32,1096,1001,95,1001,800,201,2017-01-01,zipcode,Steele
ZCTA5 35988,01,1922,42298,638,92100,1438,557,1179,179,445,370,118,67,707,635,72,635,443,192,2017-01-01,zipcode,Sylvania
ZCTA5 35989,01,3630,35536,568,98300,2672,1330,2336,522,856,495,238,225,1716,1310,406,1310,1022,288,2017-01-01,zipcode,Valley head
ZCTA5 35990,01,169,48304,900,-666666666,112,46,63,13,35,15,0,0,43,35,8,35,14,21,2017-01-01,zipcode,Walnut grove
ZCTA5 36003,01,1822,29073,531,79500,1527,775,1337,350,523,339,83,42,1004,839,165,839,645,194,2017-01-01,zipcode,Autaugaville
ZCTA5 36005,01,1641,45982,344,80900,1291,576,1086,194,458,320,61,53,694,551,143,551,421,130,2017-01-01,zipcode,Banks
ZCTA5 36006,01,1350,50714,-666666666,88200,1139,496,921,214,332,226,41,108,640,486,154,486,445,41,2017-01-01,zipcode,Billingsley
ZCTA5 36009,01,2342,35735,451,87400,1972,855,1683,281,655,426,234,87,1227,958,269,958,698,260,2017-01-01,zipcode,Brantley
ZCTA5 36010,01,4667,33169,539,79500,3867,1932,3130,770,1224,731,272,133,2511,1879,632,1879,1247,632,2017-01-01,zipcode,Brundidge
ZCTA5 36013,01,533,101008,-666666666,366700,452,124,401,0,51,191,98,61,203,203,0,203,186,17,2017-01-01,zipcode,Cecil
ZCTA5 36016,01,5109,28839,486,78500,4591,3006,3975,1466,1348,825,251,85,1935,1530,405,1530,980,550,2017-01-01,zipcode,Clayton
ZCTA5 36017,01,2956,28125,435,66000,2562,1813,2255,667,929,500,120,39,1027,694,333,694,487,207,2017-01-01,zipcode,Clio
ZCTA5 36020,01,1036,42750,771,161100,835,413,713,112,233,214,106,48,426,380,46,380,306,74,2017-01-01,zipcode,Coosada
ZCTA5 36022,01,12301,62346,726,167200,10022,3961,8240,871,2832,2790,1315,432,4807,4478,329,4478,3866,612,2017-01-01,zipcode,Deatsville
ZCTA5 36024,01,5012,52038,725,125800,4236,1934,3750,433,1491,1028,535,263,3085,2079,1006,2079,1704,375,2017-01-01,zipcode,Eclectic
ZCTA5 36025,01,7377,44444,875,133300,6378,4370,5406,1404,2221,1246,309,226,1504,1462,42,1462,896,566,2017-01-01,zipcode,Elmore
ZCTA5 36026,01,852,47400,-666666666,158900,764,394,661,39,187,174,208,53,1043,358,685,358,297,61,2017-01-01,zipcode,Equality
ZCTA5 36027,01,15607,34888,591,106100,12039,5326,10446,2266,3631,3007,933,609,7691,6004,1687,6004,3518,2486,2017-01-01,zipcode,Eufaula
ZCTA5 36028,01,1580,34926,563,104700,1331,604,1114,198,402,343,121,50,947,681,266,681,568,113,2017-01-01,zipcode,Dozier
ZCTA5 36029,01,1387,44938,-666666666,157800,1175,343,1119,210,495,230,120,64,428,377,51,377,336,41,2017-01-01,zipcode,Fitzpatrick
ZCTA5 36030,01,463,36442,-666666666,52000,432,200,406,30,249,60,52,15,306,171,135,171,160,11,2017-01-01,zipcode,Forest home
ZCTA5 36031,01,191,-666666666,-666666666,67300,174,142,141,79,51,11,0,0,109,97,12,97,92,5,2017-01-01,zipcode,Fort davis
ZCTA5 36032,01,2519,37407,520,68300,1940,812,1654,396,538,392,209,119,1231,940,291,940,675,265,2017-01-01,zipcode,Fort deposit
ZCTA5 36033,01,4368,33725,575,69000,3629,2202,3120,606,1292,877,175,170,2238,1483,755,1483,1077,406,2017-01-01,zipcode,Georgiana
ZCTA5 36034,01,948,37917,488,50000,776,382,558,86,239,167,25,41,441,331,110,331,292,39,2017-01-01,zipcode,Glenwood
ZCTA5 36035,01,1603,43517,-666666666,109500,1236,471,1116,167,445,241,154,109,872,639,233,639,529,110,2017-01-01,zipcode,Goshen
ZCTA5 36036,01,1810,40250,671,81700,1576,668,1396,439,503,264,159,31,1067,814,253,814,660,154,2017-01-01,zipcode,Grady
ZCTA5 36037,01,13361,38362,593,97100,10382,4298,9007,1647,3535,2186,954,685,6485,4754,1731,4754,3190,1564,2017-01-01,zipcode,Greenville
ZCTA5 36038,01,37,34821,-666666666,-666666666,37,20,36,10,1,24,1,0,13,13,0,13,13,0,2017-01-01,zipcode,Gantt
ZCTA5 36039,01,102,44125,-666666666,84500,94,56,82,14,38,22,8,0,45,45,0,45,45,0,2017-01-01,zipcode,Hardaway
ZCTA5 36040,01,3560,22584,619,59700,2815,1532,2428,699,991,504,158,76,1601,1443,158,1443,881,562,2017-01-01,zipcode,Hayneville
ZCTA5 36041,01,1349,56797,-666666666,71500,1068,438,903,169,367,259,74,34,545,441,104,441,385,56,2017-01-01,zipcode,Highland home
ZCTA5 36042,01,2199,40104,684,89800,1662,859,1522,382,644,330,127,39,982,701,281,701,571,130,2017-01-01,zipcode,Honoraville
ZCTA5 36043,01,3223,46349,921,112500,2776,1385,2369,451,801,592,307,218,1467,1259,208,1259,1031,228,2017-01-01,zipcode,Hope hull
ZCTA5 36046,01,1356,43750,761,86400,1146,511,1027,259,421,213,113,21,762,594,168,594,562,32,2017-01-01,zipcode,Lapine
ZCTA5 36047,01,1195,38036,-666666666,-666666666,947,458,864,181,322,239,122,0,674,548,126,548,469,79,2017-01-01,zipcode,Letohatchee
ZCTA5 36048,01,1491,36406,575,63800,1210,615,1037,394,383,209,39,12,704,528,176,528,388,140,2017-01-01,zipcode,Louisville
ZCTA5 36049,01,5844,39397,531,75000,4664,2158,4017,765,1445,972,595,240,2813,2320,493,2320,1443,877,2017-01-01,zipcode,Luverne
ZCTA5 36051,01,1898,41143,859,62500,1604,633,1428,218,638,395,73,104,908,740,168,740,605,135,2017-01-01,zipcode,Marbury
ZCTA5 36052,01,268,52375,-666666666,430000,227,90,220,8,54,39,92,27,225,143,82,143,128,15,2017-01-01,zipcode,Mathews
ZCTA5 36053,01,1684,24250,465,68100,1357,608,1171,380,398,271,86,36,1012,675,337,675,459,216,2017-01-01,zipcode,Midway
ZCTA5 36054,01,15527,58241,837,135600,11694,3974,9419,891,3257,3073,1232,966,6279,5769,510,5769,3872,1897,2017-01-01,zipcode,Millbrook
ZCTA5 36064,01,9959,103284,1076,276000,7704,2274,6662,384,1038,1510,2137,1593,3953,3656,297,3656,3367,289,2017-01-01,zipcode,Pike road
ZCTA5 36066,01,19266,63792,1116,176100,15041,5184,13238,1099,3469,3851,2670,2149,8581,7888,693,7888,4718,3170,2017-01-01,zipcode,Prattville
ZCTA5 36067,01,28235,50840,776,119900,21746,8898,18397,2683,6455,5394,2299,1566,11229,10290,939,10290,7733,2557,2017-01-01,zipcode,Prattville
ZCTA5 36069,01,1967,43566,541,86700,1802,745,1566,375,503,323,211,154,996,849,147,849,685,164,2017-01-01,zipcode,Ramer
ZCTA5 36071,01,510,29583,613,72900,426,251,409,153,160,71,25,0,253,213,40,213,170,43,2017-01-01,zipcode,Rutledge
ZCTA5 36075,01,2091,37621,658,84700,1742,877,1604,273,566,449,195,121,1023,865,158,865,664,201,2017-01-01,zipcode,Shorter
ZCTA5 36078,01,12713,51393,606,112500,9999,4334,8442,1419,2967,2520,961,575,5801,4835,966,4835,3419,1416,2017-01-01,zipcode,Tallassee
ZCTA5 36079,01,9955,46792,694,123700,7981,2827,6461,938,2138,1671,1114,600,4552,3621,931,3621,2495,1126,2017-01-01,zipcode,Troy
ZCTA5 36080,01,2681,62184,-666666666,179500,2136,1072,1822,142,815,485,275,105,1199,923,276,923,844,79,2017-01-01,zipcode,Titus
ZCTA5 36081,01,16091,28745,616,118500,13380,5678,9299,2041,2730,1997,1381,1150,8248,6301,1947,6301,3120,3181,2017-01-01,zipcode,Troy
ZCTA5 36082,01,1325,-666666666,-666666666,-666666666,1325,963,32,0,0,6,26,0,0,0,0,0,0,0,2017-01-01,zipcode,Troy
ZCTA5 36083,01,7961,33223,568,75200,6593,3034,5618,1063,1651,1580,736,588,4754,3592,1162,3592,2225,1367,2017-01-01,zipcode,Tuskegee
ZCTA5 36088,01,4697,26924,641,80100,4185,2015,1744,279,378,614,179,294,2029,1283,746,1283,523,760,2017-01-01,zipcode,Tuskegee institute
ZCTA5 36089,01,7454,27160,626,62500,5874,2588,5068,1480,1774,1136,322,356,3212,2723,489,2723,1796,927,2017-01-01,zipcode,Union springs
ZCTA5 36091,01,3472,43351,535,77000,2848,1349,2546,292,1389,478,221,166,1718,1455,263,1455,1081,374,2017-01-01,zipcode,Verbena
ZCTA5 36092,01,19633,44266,776,130700,15926,7702,13801,2259,5142,3972,1634,794,8386,7323,1063,7323,5042,2281,2017-01-01,zipcode,Wetumpka
ZCTA5 36093,01,10984,86104,1231,225400,8504,3292,7202,445,1619,2143,1872,1123,4138,3915,223,3915,3449,466,2017-01-01,zipcode,Wetumpka
ZCTA5 36104,01,8040,22221,663,74200,6613,3668,4842,1469,1182,1118,514,559,3897,2869,1028,2869,865,2004,2017-01-01,zipcode,Montgomery
ZCTA5 36105,01,10259,31454,798,66900,8640,3958,7577,1947,2802,1808,621,399,5278,3989,1289,3989,2559,1430,2017-01-01,zipcode,Montgomery
ZCTA5 36106,01,15024,53143,943,156300,12323,4625,10088,600,1883,2934,2386,2285,7038,6316,722,6316,3597,2719,2017-01-01,zipcode,Montgomery
ZCTA5 36107,01,7798,31129,765,65600,5936,2293,4995,1239,1803,982,577,394,4286,3177,1109,3177,1247,1930,2017-01-01,zipcode,Montgomery
ZCTA5 36108,01,19464,25035,588,66100,15368,7290,13280,3848,4397,3345,1124,566,9521,7921,1600,7921,4396,3525,2017-01-01,zipcode,Montgomery
ZCTA5 36109,01,24046,51449,950,116700,19954,7824,16881,1519,4719,5322,3481,1840,10943,9858,1085,9858,7375,2483,2017-01-01,zipcode,Montgomery
ZCTA5 36110,01,12232,30690,812,59300,9198,4631,7653,2313,2629,1684,690,337,5572,4284,1288,4284,2244,2040,2017-01-01,zipcode,Montgomery
ZCTA5 36111,01,12609,46502,838,138700,9535,3408,7956,923,2070,2010,1777,1176,5637,4963,674,4963,2791,2172,2017-01-01,zipcode,Montgomery
ZCTA5 36112,01,353,-666666666,-666666666,-666666666,353,9,114,0,20,59,0,35,0,0,0,0,0,0,2017-01-01,zipcode,Montgomery
ZCTA5 36113,01,1864,87250,1494,-666666666,1453,936,1250,101,432,349,158,210,290,275,15,275,0,275,2017-01-01,zipcode,Montgomery
ZCTA5 36115,01,917,56406,1332,-666666666,563,168,412,9,73,226,32,72,264,256,8,256,0,256,2017-01-01,zipcode,Montgomery
ZCTA5 36116,01,44305,42606,823,104600,33651,11572,27544,3809,7017,8943,4828,2947,19963,17178,2785,17178,8900,8278,2017-01-01,zipcode,Montgomery
ZCTA5 36117,01,53172,60884,949,177400,41860,13017,34598,2135,6397,10002,9666,6398,23567,21945,1622,21945,13132,8813,2017-01-01,zipcode,Montgomery
ZCTA5 36201,01,18849,27266,559,65100,14996,7650,13077,3630,4764,3750,638,295,9873,7510,2363,7510,4401,3109,2017-01-01,zipcode,Anniston
ZCTA5 36203,01,18007,52668,806,142500,14300,5271,12474,1900,3758,4082,1664,1070,7722,6927,795,6927,4876,2051,2017-01-01,zipcode,Oxford
ZCTA5 36205,01,494,66397,-666666666,255500,442,192,332,20,67,48,71,126,182,159,23,159,91,68,2017-01-01,zipcode,Anniston
ZCTA5 36206,01,11704,44882,630,94000,9248,3810,7822,1347,2586,2513,823,553,5264,4556,708,4556,3348,1208,2017-01-01,zipcode,Anniston
ZCTA5 36207,01,19631,45458,710,138300,16158,7058,14204,1456,4256,4822,1816,1854,9773,8395,1378,8395,5788,2607,2017-01-01,zipcode,Anniston
ZCTA5 36250,01,5050,68654,742,119900,3939,1265,3575,399,1142,1308,478,248,1943,1820,123,1820,1530,290,2017-01-01,zipcode,Alexandria
ZCTA5 36251,01,5222,32769,426,85700,4407,2050,3685,1005,1074,1201,258,147,2579,2098,481,2098,1463,635,2017-01-01,zipcode,Ashland
ZCTA5 36255,01,752,43005,-666666666,71800,575,217,498,159,205,108,0,26,397,345,52,345,320,25,2017-01-01,zipcode,Cragford
ZCTA5 36256,01,1730,50000,575,109200,1377,506,1239,221,513,332,123,50,823,668,155,668,581,87,2017-01-01,zipcode,Daviston
ZCTA5 36258,01,1310,45563,476,122400,1095,525,978,252,369,195,83,79,756,519,237,519,402,117,2017-01-01,zipcode,Delta
ZCTA5 36260,01,4008,40620,621,115700,3072,1377,2666,616,927,877,203,43,1772,1530,242,1530,1188,342,2017-01-01,zipcode,Eastaboga
ZCTA5 36262,01,1450,34375,479,74500,1130,517,986,246,436,244,57,3,648,561,87,561,440,121,2017-01-01,zipcode,Fruithurst
ZCTA5 36263,01,378,25455,683,89200,346,224,319,60,111,47,41,60,272,204,68,204,124,80,2017-01-01,zipcode,Graham
ZCTA5 36264,01,8657,35618,529,111800,6869,3428,5996,1555,2037,1595,482,327,4066,3361,705,3361,2487,874,2017-01-01,zipcode,Heflin
ZCTA5 36265,01,20869,47838,593,144400,17392,7319,12644,1337,3258,4615,1998,1436,8597,7548,1049,7548,4658,2890,2017-01-01,zipcode,Jacksonville
ZCTA5 36266,01,5438,33977,526,101000,4296,1974,3762,897,1345,1148,214,158,2771,2119,652,2119,1628,491,2017-01-01,zipcode,Lineville
ZCTA5 36267,01,79,-666666666,-666666666,-666666666,40,0,40,25,15,0,0,0,23,23,0,23,8,15,2017-01-01,zipcode,Millerville
ZCTA5 36268,01,5956,48278,759,100000,4630,1939,4133,839,1337,1507,248,202,2697,2394,303,2394,1980,414,2017-01-01,zipcode,Munford
ZCTA5 36269,01,1234,51429,541,82400,978,482,852,189,392,178,87,6,480,442,38,442,323,119,2017-01-01,zipcode,Muscadine
ZCTA5 36271,01,6174,52560,702,87500,4941,1815,4379,909,1418,1519,304,229,2776,2243,533,2243,1931,312,2017-01-01,zipcode,Ohatchee
ZCTA5 36272,01,12667,36762,532,84500,10298,5117,9110,2106,3330,2678,573,423,6527,5214,1313,5214,4079,1135,2017-01-01,zipcode,Piedmont
ZCTA5 36273,01,3225,47645,712,142200,2474,918,2196,404,922,591,153,126,1383,1227,156,1227,911,316,2017-01-01,zipcode,Ranburne
ZCTA5 36274,01,11213,40246,574,78600,9057,4257,7805,1487,2748,2380,852,338,5406,4412,994,4412,3174,1238,2017-01-01,zipcode,Roanoke
ZCTA5 36276,01,2531,31858,449,83000,2064,1002,1628,540,551,385,102,50,1082,853,229,853,653,200,2017-01-01,zipcode,Wadley
ZCTA5 36277,01,5145,49808,808,103800,3974,1704,3410,393,1109,1436,349,123,2410,1928,482,1928,1522,406,2017-01-01,zipcode,Weaver
ZCTA5 36278,01,4688,34753,663,126500,3718,2017,3253,668,1130,914,297,244,3152,1913,1239,1913,1334,579,2017-01-01,zipcode,Wedowee
ZCTA5 36279,01,2524,53780,670,155100,2137,940,1953,406,694,661,44,148,1272,1035,237,1035,950,85,2017-01-01,zipcode,Wellington
ZCTA5 36280,01,3606,45433,810,90400,2883,1563,2593,660,1131,500,121,181,1916,1435,481,1435,1107,328,2017-01-01,zipcode,Woodland
ZCTA5 36301,01,37292,39618,703,108400,29204,12049,25008,3926,8788,8106,2672,1516,16668,14101,2567,14101,8640,5461,2017-01-01,zipcode,Dothan
ZCTA5 36303,01,30957,40314,673,138800,24437,10405,20957,3104,5980,6848,3167,1858,14174,11812,2362,11812,6802,5010,2017-01-01,zipcode,Dothan
ZCTA5 36305,01,15869,60995,891,178300,12420,4795,10947,750,2551,4005,2274,1367,6829,6168,661,6168,4143,2025,2017-01-01,zipcode,Dothan
ZCTA5 36310,01,6247,40186,561,89800,5289,2859,4592,962,1678,1324,349,279,4045,2555,1490,2555,2063,492,2017-01-01,zipcode,Abbeville
ZCTA5 36311,01,2421,40598,604,76100,2027,997,1686,382,566,501,91,146,1326,963,363,963,831,132,2017-01-01,zipcode,Ariton
ZCTA5 36312,01,6289,40191,663,95800,5065,2380,4302,714,1680,1314,378,216,2851,2309,542,2309,1757,552,2017-01-01,zipcode,Ashford
ZCTA5 36313,01,417,66977,-666666666,162500,316,115,292,37,31,217,7,0,202,160,42,160,117,43,2017-01-01,zipcode,Bellwood
ZCTA5 36314,01,474,44583,613,116300,408,175,390,81,194,32,47,36,226,214,12,214,197,17,2017-01-01,zipcode,Black
ZCTA5 36316,01,1901,61912,636,136800,1494,523,1317,171,339,572,175,60,848,714,134,714,621,93,2017-01-01,zipcode,Chancellor
ZCTA5 36317,01,497,45347,495,69000,464,282,422,142,122,106,40,12,335,221,114,221,171,50,2017-01-01,zipcode,Clopton
ZCTA5 36318,01,1400,34375,675,71800,1134,566,975,209,346,380,25,15,690,577,113,577,488,89,2017-01-01,zipcode,Coffee springs
ZCTA5 36319,01,1887,34185,617,77700,1497,799,1431,226,494,548,104,59,1015,844,171,844,671,173,2017-01-01,zipcode,Columbia
ZCTA5 36320,01,3900,41915,611,87500,3119,1412,2780,533,1163,808,215,61,1783,1387,396,1387,1131,256,2017-01-01,zipcode,Cottonwood
ZCTA5 36321,01,1639,40139,767,91600,1285,470,1078,181,430,328,95,44,701,601,100,601,449,152,2017-01-01,zipcode,Cowarts
ZCTA5 36322,01,8979,40716,668,106400,7166,3072,5954,846,1970,2287,670,181,4528,3455,1073,3455,1953,1502,2017-01-01,zipcode,Daleville
ZCTA5 36323,01,8010,39361,587,98500,6605,3083,5511,1324,1743,1772,454,218,3614,2965,649,2965,2033,932,2017-01-01,zipcode,Elba
ZCTA5 36330,01,36220,54001,794,167900,28398,10706,24396,2688,6612,8410,4315,2371,16303,13967,2336,13967,8569,5398,2017-01-01,zipcode,Enterprise
ZCTA5 36340,01,5851,36782,546,100300,4569,2206,4020,972,1437,1158,300,153,2602,2351,251,2351,1545,806,2017-01-01,zipcode,Geneva
ZCTA5 36343,01,1444,34688,570,70700,1237,685,1102,276,467,298,36,25,764,570,194,570,486,84,2017-01-01,zipcode,Gordon
ZCTA5 36344,01,5824,41821,582,97300,4714,2235,4142,869,1420,1368,372,113,2825,2204,621,2204,1602,602,2017-01-01,zipcode,Hartford
ZCTA5 36345,01,8594,52611,622,140600,6749,2753,6007,967,2004,1738,663,635,3712,3277,435,3277,2666,611,2017-01-01,zipcode,Headland
ZCTA5 36346,01,1357,39423,582,94300,1066,522,949,195,397,234,64,59,591,510,81,510,394,116,2017-01-01,zipcode,Jack
ZCTA5 36350,01,6560,41516,626,120300,5004,1890,4472,595,1419,1683,488,287,3097,2650,447,2650,1569,1081,2017-01-01,zipcode,Midland city
ZCTA5 36351,01,3584,48770,697,109000,2911,1247,2564,432,933,869,200,130,1588,1416,172,1416,1077,339,2017-01-01,zipcode,New brockton
ZCTA5 36352,01,5225,52882,762,143400,4458,1654,3833,598,1275,1267,374,319,2036,1895,141,1895,1474,421,2017-01-01,zipcode,Newton
ZCTA5 36353,01,1848,46750,531,89400,1552,645,1232,249,407,396,115,65,944,715,229,715,608,107,2017-01-01,zipcode,Newville
ZCTA5 36360,01,19242,42549,590,109600,15574,7130,13729,2153,4468,4796,1478,834,9175,7698,1477,7698,5077,2621,2017-01-01,zipcode,Ozark
ZCTA5 36362,01,5149,65307,1269,-666666666,3504,879,2308,31,313,1188,561,215,1529,1299,230,1299,0,1299,2017-01-01,zipcode,Fort rucker
ZCTA5 36370,01,871,41696,638,83200,732,371,669,179,277,193,7,13,425,359,66,359,256,103,2017-01-01,zipcode,Pansey
ZCTA5 36371,01,612,34671,765,124500,508,302,471,64,145,189,61,12,312,275,37,275,187,88,2017-01-01,zipcode,Pinckard
ZCTA5 36373,01,559,41061,-666666666,65400,541,257,364,89,149,109,5,12,356,232,124,232,211,21,2017-01-01,zipcode,Shorterville
ZCTA5 36374,01,847,49938,-666666666,118200,711,362,630,106,273,151,46,54,484,373,111,373,345,28,2017-01-01,zipcode,Skipperville
ZCTA5 36375,01,6658,43467,704,79000,5546,2468,4709,1033,1734,1365,386,191,3211,2752,459,2752,2174,578,2017-01-01,zipcode,Slocomb
ZCTA5 36376,01,2153,37981,715,84700,1777,861,1534,329,641,423,83,58,1085,797,288,797,617,180,2017-01-01,zipcode,Webb
ZCTA5 36401,01,8143,28968,572,81600,6416,3454,5511,1053,2853,1134,311,160,4560,2986,1574,2986,2167,819,2017-01-01,zipcode,Evergreen
ZCTA5 36420,01,10621,42726,631,106900,8512,3595,7451,1228,2704,2126,780,613,5227,4278,949,4278,2994,1284,2017-01-01,zipcode,Andalusia
ZCTA5 36421,01,9789,42988,564,119000,7869,3502,6813,991,2036,2401,1021,364,4943,3995,948,3995,3153,842,2017-01-01,zipcode,Andalusia
ZCTA5 36425,01,1163,20125,536,36800,1005,563,724,74,386,182,49,33,716,443,273,443,302,141,2017-01-01,zipcode,Beatrice
ZCTA5 36426,01,15238,35331,562,89300,12386,6417,10855,2098,4201,2922,1021,613,7552,6018,1534,6018,4322,1696,2017-01-01,zipcode,Brewton
ZCTA5 36432,01,2067,30196,363,66100,1778,988,1564,458,765,285,30,26,1139,734,405,734,587,147,2017-01-01,zipcode,Castleberry
ZCTA5 36435,01,378,21875,-666666666,63500,235,130,221,66,74,67,0,14,213,98,115,98,89,9,2017-01-01,zipcode,Coy
ZCTA5 36436,01,410,38531,-666666666,60200,400,172,339,46,162,96,35,0,307,215,92,215,147,68,2017-01-01,zipcode,Dickinson
ZCTA5 36439,01,760,45278,807,133100,523,230,454,64,189,94,49,58,283,238,45,238,149,89,2017-01-01,zipcode,Excel
ZCTA5 36441,01,3994,36328,530,79000,2950,1361,2740,364,1337,722,251,66,1706,1417,289,1417,1116,301,2017-01-01,zipcode,Flomaton
ZCTA5 36442,01,3134,31534,478,78800,2588,1310,2382,372,1028,779,146,57,1797,1358,439,1358,1014,344,2017-01-01,zipcode,Florala
ZCTA5 36444,01,811,15341,-666666666,62100,698,526,585,182,268,113,4,18,603,345,258,345,191,154,2017-01-01,zipcode,Franklin
ZCTA5 36445,01,4494,34722,504,83300,3380,1943,3019,579,1351,784,223,82,2182,1716,466,1716,1154,562,2017-01-01,zipcode,Frisco city
ZCTA5 36446,01,511,26250,847,57900,414,229,338,100,151,73,0,14,263,180,83,180,118,62,2017-01-01,zipcode,Fulton
ZCTA5 36451,01,4701,45793,551,130100,3870,1905,3466,552,1421,1063,328,102,2564,1956,608,1956,1347,609,2017-01-01,zipcode,Grove hill
ZCTA5 36453,01,2245,39375,592,83600,1920,934,1680,315,643,529,135,58,1076,906,170,906,667,239,2017-01-01,zipcode,Kinston
ZCTA5 36454,01,22,-666666666,-666666666,-666666666,22,18,12,0,0,0,8,4,25,8,17,8,8,0,2017-01-01,zipcode,Lenox
ZCTA5 36455,01,286,31250,621,46100,227,86,221,44,99,67,9,2,176,127,49,127,93,34,2017-01-01,zipcode,Lockhart
ZCTA5 36456,01,1381,22412,371,58300,1131,715,940,207,389,252,68,24,744,535,209,535,387,148,2017-01-01,zipcode,Mc kenzie
ZCTA5 36460,01,10415,26172,485,100400,8084,3943,6896,1087,3091,1831,554,333,4749,3763,986,3763,2201,1562,2017-01-01,zipcode,Monroeville
ZCTA5 36467,01,9647,34183,556,92000,7798,3866,6755,1608,2395,1887,623,242,4650,3904,746,3904,2842,1062,2017-01-01,zipcode,Opp
ZCTA5 36470,01,214,11741,-666666666,-666666666,214,144,214,58,156,0,0,0,129,109,20,109,23,86,2017-01-01,zipcode,Perdue hill
ZCTA5 36471,01,990,18594,508,56400,860,519,760,105,476,123,24,32,765,449,316,449,265,184,2017-01-01,zipcode,Peterman
ZCTA5 36473,01,24,-666666666,-666666666,158300,17,4,10,3,1,0,0,6,30,9,21,9,8,1,2017-01-01,zipcode,Range
ZCTA5 36474,01,3295,41550,548,74300,2627,1192,2245,413,918,760,110,44,1687,1283,404,1283,1120,163,2017-01-01,zipcode,Red level
ZCTA5 36475,01,2122,33617,623,62800,1653,937,1468,249,721,339,54,105,1126,815,311,815,651,164,2017-01-01,zipcode,Repton
ZCTA5 36476,01,57,17708,-666666666,-666666666,45,31,37,21,4,6,6,0,23,17,6,17,15,2,2017-01-01,zipcode,River falls
ZCTA5 36477,01,3946,29442,529,64800,3157,1591,2718,508,1060,868,148,134,2231,1699,532,1699,1178,521,2017-01-01,zipcode,Samson
ZCTA5 36480,01,1380,30313,664,87300,1248,759,1104,157,466,280,97,104,1105,582,523,582,388,194,2017-01-01,zipcode,Uriah
ZCTA5 36481,01,340,17917,-666666666,-666666666,278,168,196,62,86,48,0,0,278,90,188,90,31,59,2017-01-01,zipcode,Vredenburgh
ZCTA5 36482,01,639,-666666666,-666666666,72000,555,295,495,68,198,173,46,10,396,288,108,288,199,89,2017-01-01,zipcode,Whatley
ZCTA5 36483,01,293,27308,-666666666,64300,258,147,238,38,113,63,20,4,160,142,18,142,137,5,2017-01-01,zipcode,Wing
ZCTA5 36502,01,18853,34985,588,104000,15245,8492,12553,2478,5856,2859,767,593,7374,5964,1410,5964,4184,1780,2017-01-01,zipcode,Atmore
ZCTA5 36505,01,1939,49767,1089,113400,1467,516,1268,268,272,481,170,77,762,669,93,669,506,163,2017-01-01,zipcode,Axis
ZCTA5 36507,01,21660,40099,635,126600,16182,7673,13855,2125,5131,4591,1467,541,8105,6955,1150,6955,4789,2166,2017-01-01,zipcode,Bay minette
ZCTA5 36509,01,2166,31964,726,77200,1608,676,1258,516,359,322,48,13,763,622,141,622,327,295,2017-01-01,zipcode,Bayou la batre
ZCTA5 36511,01,581,-666666666,-666666666,-666666666,476,309,417,90,258,69,0,0,381,285,96,285,228,57,2017-01-01,zipcode,Bon secour
ZCTA5 36512,01,0,-666666666,-666666666,-666666666,0,0,0,0,0,0,0,0,26,0,26,0,0,0,2017-01-01,zipcode,Bucks
ZCTA5 36513,01,1268,32917,-666666666,-666666666,854,603,733,397,216,81,0,39,326,293,33,293,180,113,2017-01-01,zipcode,Calvert
ZCTA5 36518,01,2224,38590,547,86700,1925,997,1658,209,728,464,147,110,1351,931,420,931,754,177,2017-01-01,zipcode,Chatom
ZCTA5 36521,01,5403,50855,779,115600,4411,2031,3839,752,1754,1122,157,54,2269,2034,235,2034,1778,256,2017-01-01,zipcode,Chunchula
ZCTA5 36522,01,7141,44627,780,107600,5422,2719,4518,822,1984,1219,379,114,2893,2443,450,2443,1810,633,2017-01-01,zipcode,Citronelle
ZCTA5 36523,01,2373,46196,826,98800,1997,974,1825,598,635,388,108,96,1185,944,241,944,687,257,2017-01-01,zipcode,Coden
ZCTA5 36524,01,1223,34598,775,109900,970,568,771,117,376,196,54,28,1002,477,525,477,405,72,2017-01-01,zipcode,Coffeeville
ZCTA5 36525,01,1773,51364,818,108500,1410,653,1226,157,508,363,151,47,740,658,82,658,478,180,2017-01-01,zipcode,Creola
ZCTA5 36526,01,33327,69808,1057,193700,26274,8459,22440,1123,4556,7698,6102,2961,13174,11828,1346,11828,8339,3489,2017-01-01,zipcode,Daphne
ZCTA5 36527,01,13876,83399,1140,281200,10550,3527,8930,417,1400,2602,2800,1711,5587,5189,398,5189,3639,1550,2017-01-01,zipcode,Daphne
ZCTA5 36528,01,1262,79323,993,227500,1125,560,1034,52,281,335,199,167,1917,531,1386,531,470,61,2017-01-01,zipcode,Dauphin island
ZCTA5 36529,01,151,-666666666,-666666666,136600,135,101,117,8,50,4,47,8,159,105,54,105,105,0,2017-01-01,zipcode,Deer park
ZCTA5 36530,01,8041,46426,874,167000,6545,2610,5264,609,1834,1608,883,330,3647,2835,812,2835,2170,665,2017-01-01,zipcode,Elberta
ZCTA5 36532,01,33251,63519,1025,235100,25660,10918,22841,1487,4430,6332,6352,4240,14317,11841,2476,11841,9314,2527,2017-01-01,zipcode,Fairhope
ZCTA5 36535,01,28793,42170,781,155200,24333,10270,21856,2239,6679,7567,3882,1489,15074,12153,2921,12153,8423,3730,2017-01-01,zipcode,Foley
ZCTA5 36538,01,460,29151,-666666666,16300,384,195,350,115,190,45,0,0,295,156,139,156,156,0,2017-01-01,zipcode,Frankville
ZCTA5 36539,01,796,34129,705,-666666666,630,299,460,52,248,115,19,26,401,293,108,293,202,91,2017-01-01,zipcode,Fruitdale
ZCTA5 36540,01,685,27159,-666666666,64100,608,328,463,134,245,72,5,7,329,235,94,235,161,74,2017-01-01,zipcode,Gainestown
ZCTA5 36541,01,16369,51517,1052,103700,12169,5192,10364,2111,3548,3398,893,414,6078,5311,767,5311,4737,574,2017-01-01,zipcode,Grand bay
ZCTA5 36542,01,13643,50737,980,246700,12363,5577,11113,530,2665,4140,2556,1222,16529,6432,10097,6432,4036,2396,2017-01-01,zipcode,Gulf shores
ZCTA5 36543,01,197,90524,-666666666,93400,158,59,158,0,31,111,0,16,65,65,0,65,65,0,2017-01-01,zipcode,Huxford
ZCTA5 36544,01,10569,39756,810,98900,8536,3781,7103,1914,3158,1512,444,75,4479,3847,632,3847,2990,857,2017-01-01,zipcode,Irvington
ZCTA5 36545,01,9884,30000,549,94800,7750,4263,6493,1118,3224,1354,454,343,4801,3666,1135,3666,2435,1231,2017-01-01,zipcode,Jackson
ZCTA5 36548,01,898,-666666666,-666666666,108500,827,407,675,30,239,291,71,44,533,430,103,430,358,72,2017-01-01,zipcode,Leroy
ZCTA5 36549,01,4754,46387,948,135500,4212,2492,3918,299,1579,1324,452,264,2710,1983,727,1983,1823,160,2017-01-01,zipcode,Lillian
ZCTA5 36550,01,407,-666666666,-666666666,-666666666,407,271,287,19,33,99,104,32,210,156,54,156,123,33,2017-01-01,zipcode,Little river
ZCTA5 36551,01,9063,48698,958,139700,7513,3616,6627,1345,2270,1951,750,311,3478,3039,439,3039,2303,736,2017-01-01,zipcode,Loxley
ZCTA5 36553,01,2897,48143,732,103800,2271,1234,1944,301,1000,546,80,17,1434,958,476,958,842,116,2017-01-01,zipcode,Mc intosh
ZCTA5 36555,01,678,50625,865,279600,612,370,590,39,117,186,186,62,518,329,189,329,288,41,2017-01-01,zipcode,Magnolia springs
ZCTA5 36556,01,603,-666666666,-666666666,-666666666,516,366,408,59,221,111,17,0,417,222,195,222,158,64,2017-01-01,zipcode,Malcolm
ZCTA5 36558,01,3775,40268,443,58600,3099,1545,2551,452,1100,728,135,136,1918,1364,554,1364,1213,151,2017-01-01,zipcode,Millry
ZCTA5 36559,01,94,-666666666,-666666666,-666666666,73,46,63,0,17,0,31,15,85,42,43,42,32,10,2017-01-01,zipcode,Montrose
ZCTA5 36560,01,3238,38438,612,77000,2668,1453,2342,701,946,544,115,36,1501,1250,251,1250,883,367,2017-01-01,zipcode,Mount vernon
ZCTA5 36561,01,6560,69088,1110,296900,5689,2584,5326,374,1064,1495,1689,704,13051,2922,10129,2922,2207,715,2017-01-01,zipcode,Orange beach
ZCTA5 36562,01,1678,38661,-666666666,112000,1299,586,1156,280,559,238,79,0,615,509,106,509,476,33,2017-01-01,zipcode,Perdido
ZCTA5 36564,01,44,-666666666,-666666666,-666666666,44,44,44,0,0,8,9,27,144,36,108,36,36,0,2017-01-01,zipcode,Point clear
ZCTA5 36567,01,14262,45248,776,134900,11041,4973,9527,1741,3745,2945,766,330,5735,4878,857,4878,3403,1475,2017-01-01,zipcode,Robertsdale
ZCTA5 36568,01,189,-666666666,-666666666,163200,189,131,189,48,105,0,36,0,86,86,0,86,86,0,2017-01-01,zipcode,Saint elmo
ZCTA5 36569,01,932,50179,-666666666,78000,774,380,713,46,365,253,49,0,398,335,63,335,296,39,2017-01-01,zipcode,Saint stephens
ZCTA5 36571,01,15348,54812,898,135100,12132,4887,10192,1455,3466,3448,1276,547,6150,5440,710,5440,3875,1565,2017-01-01,zipcode,Saraland
ZCTA5 36572,01,6161,60609,969,152900,4847,2213,4307,468,1769,1397,430,243,2346,2267,79,2267,1971,296,2017-01-01,zipcode,Satsuma
ZCTA5 36574,01,699,68958,-666666666,115600,665,336,562,83,340,75,36,28,507,298,209,298,298,0,2017-01-01,zipcode,Seminole
ZCTA5 36575,01,20224,57686,878,142100,15475,6550,13619,2021,5031,4443,1658,466,7864,7055,809,7055,5749,1306,2017-01-01,zipcode,Semmes
ZCTA5 36576,01,3754,49265,915,156400,3167,1095,2752,441,1083,618,512,98,1702,1558,144,1558,1191,367,2017-01-01,zipcode,Silverhill
ZCTA5 36578,01,1486,47279,694,168500,1170,545,1027,108,407,363,91,58,697,500,197,500,464,36,2017-01-01,zipcode,Stapleton
ZCTA5 36579,01,938,41346,529,158500,781,406,728,170,150,191,101,116,1182,412,770,412,333,79,2017-01-01,zipcode,Stockton
ZCTA5 36580,01,5416,40893,698,136200,4428,1995,3502,466,1334,1131,379,192,2499,1834,665,1834,1436,398,2017-01-01,zipcode,Summerdale
ZCTA5 36581,01,109,-666666666,-666666666,-666666666,84,84,84,0,79,5,0,0,61,12,49,12,12,0,2017-01-01,zipcode,Sunflower
ZCTA5 36582,01,24419,50720,733,117500,18905,7178,16150,2654,6007,4688,2144,657,10057,8940,1117,8940,6653,2287,2017-01-01,zipcode,Theodore
ZCTA5 36583,01,905,30982,-666666666,179700,729,354,651,173,217,187,67,7,363,327,36,327,278,49,2017-01-01,zipcode,Tibbie
ZCTA5 36584,01,789,69271,-666666666,-666666666,617,237,571,132,216,138,85,0,437,297,140,297,257,40,2017-01-01,zipcode,Vinegar bend
ZCTA5 36585,01,979,29549,600,159700,702,322,655,78,260,181,62,74,407,341,66,341,252,89,2017-01-01,zipcode,Wagarville
ZCTA5 36587,01,10022,53012,967,106300,8187,3784,6918,1227,2989,1954,610,138,4236,3438,798,3438,3145,293,2017-01-01,zipcode,Wilmer
ZCTA5 36590,01,0,-666666666,-666666666,-666666666,0,0,0,0,0,0,0,0,0,0,0,0,0,0,2017-01-01,zipcode,Theodore
ZCTA5 36602,01,909,19977,491,198400,892,485,810,111,193,289,115,102,736,617,119,617,83,534,2017-01-01,zipcode,Mobile
ZCTA5 36603,01,11516,20714,544,78000,10146,7608,8383,2465,2956,2235,483,244,3826,2716,1110,2716,1065,1651,2017-01-01,zipcode,Mobile
ZCTA5 36604,01,9767,47653,787,157400,8109,2724,6923,740,1405,2088,1548,1142,5208,4135,1073,4135,2290,1845,2017-01-01,zipcode,Mobile
ZCTA5 36605,01,26931,29782,780,76000,20274,9241,16878,3001,6246,5274,1566,791,12824,10061,2763,10061,5791,4270,2017-01-01,zipcode,Mobile
ZCTA5 36606,01,18640,36073,795,97100,14638,4966,12404,1090,4191,3766,2289,1068,9516,7835,1681,7835,4119,3716,2017-01-01,zipcode,Mobile
ZCTA5 36607,01,6005,34953,768,107000,5046,2162,4565,684,1384,1121,861,515,3410,2621,789,2621,1368,1253,2017-01-01,zipcode,Mobile
ZCTA5 36608,01,35810,48745,837,152500,29068,11648,22834,1953,5246,6352,5551,3732,16620,14489,2131,14489,8505,5984,2017-01-01,zipcode,Mobile
ZCTA5 36609,01,23738,40126,780,142200,18873,6553,15934,1273,4186,5824,3067,1584,13093,10762,2331,10762,4890,5872,2017-01-01,zipcode,Mobile
ZCTA5 36610,01,10621,21380,679,50000,8130,4708,6862,1540,2963,1757,472,130,5570,3937,1633,3937,1976,1961,2017-01-01,zipcode,Mobile
ZCTA5 36611,01,5889,30929,901,79200,4078,1763,3407,617,1267,1087,244,192,2572,2112,460,2112,1151,961,2017-01-01,zipcode,Mobile
ZCTA5 36612,01,4796,21597,712,63500,3492,1948,2850,483,1242,852,114,159,2040,1626,414,1626,800,826,2017-01-01,zipcode,Mobile
ZCTA5 36613,01,13510,41913,802,98500,10360,5275,8496,1319,3526,2500,805,346,5009,4167,842,4167,3292,875,2017-01-01,zipcode,Eight mile
ZCTA5 36615,01,0,-666666666,-666666666,-666666666,0,0,0,0,0,0,0,0,0,0,0,0,0,0,2017-01-01,zipcode,Mobile
ZCTA5 36616,01,0,-666666666,-666666666,-666666666,0,0,0,0,0,0,0,0,0,0,0,0,0,0,2017-01-01,zipcode,Mobile
ZCTA5 36617,01,14208,27039,807,74100,11290,6044,9773,1667,3735,3106,765,500,6263,5036,1227,5036,2888,2148,2017-01-01,zipcode,Mobile
ZCTA5 36618,01,17659,46759,838,112000,14011,5659,11801,1269,3808,4087,1713,924,7181,6373,808,6373,5242,1131,2017-01-01,zipcode,Mobile
ZCTA5 36619,01,15976,60492,896,131500,12645,5234,11042,1486,3994,3334,1721,507,6346,5716,630,5716,4483,1233,2017-01-01,zipcode,Mobile
ZCTA5 36688,01,195,-666666666,-666666666,-666666666,195,111,0,0,0,0,0,0,0,0,0,0,0,0,2017-01-01,zipcode,Mobile
ZCTA5 36693,01,19138,60685,941,145100,15804,5835,14023,808,3350,4764,3322,1779,8654,7647,1007,7647,5301,2346,2017-01-01,zipcode,Mobile
ZCTA5 36695,01,50900,67926,998,181000,39785,14067,33076,1654,7633,10537,8618,4634,20464,18544,1920,18544,12743,5801,2017-01-01,zipcode,Mobile
ZCTA5 36701,01,22493,31916,633,88000,17138,7998,14725,2474,5149,4481,1384,1237,11213,9111,2102,9111,5623,3488,2017-01-01,zipcode,Selma
ZCTA5 36703,01,12992,25445,583,78100,10285,4646,8297,1565,3435,2632,439,226,5898,5043,855,5043,2479,2564,2017-01-01,zipcode,Selma
ZCTA5 36720,01,999,12863,795,23800,692,585,508,236,107,93,61,11,440,339,101,339,243,96,2017-01-01,zipcode,Alberta
ZCTA5 36722,01,396,29773,-666666666,90700,334,149,304,47,133,109,15,0,231,152,79,152,79,73,2017-01-01,zipcode,Arlington
ZCTA5 36723,01,247,-666666666,-666666666,-666666666,142,108,142,30,25,78,9,0,203,93,110,93,55,38,2017-01-01,zipcode,Boykin
ZCTA5 36726,01,4864,33313,474,94400,3911,2041,3362,496,1653,823,254,136,2544,1799,745,1799,972,827,2017-01-01,zipcode,Camden
ZCTA5 36727,01,14,-666666666,-666666666,-666666666,14,14,14,0,14,0,0,0,30,14,16,14,14,0,2017-01-01,zipcode,Campbell
ZCTA5 36728,01,283,40735,-666666666,-666666666,273,138,239,68,76,66,23,6,182,126,56,126,106,20,2017-01-01,zipcode,Catherine
ZCTA5 36732,01,8101,27377,504,116800,6317,3001,5309,671,1757,1716,720,445,4151,3407,744,3407,2119,1288,2017-01-01,zipcode,Demopolis
ZCTA5 36736,01,1397,35664,-666666666,75900,1045,617,880,203,435,92,89,61,580,459,121,459,378,81,2017-01-01,zipcode,Dixons mills
ZCTA5 36738,01,1048,28859,-666666666,77900,859,554,687,109,345,169,42,22,394,327,67,327,272,55,2017-01-01,zipcode,Faunsdale
ZCTA5 36740,01,1326,30900,532,56000,1137,672,964,174,317,330,120,23,869,456,413,456,349,107,2017-01-01,zipcode,Forkland
ZCTA5 36742,01,1831,37000,760,63700,1705,825,1311,283,558,346,63,61,1061,690,371,690,576,114,2017-01-01,zipcode,Gallion
ZCTA5 36744,01,6620,29625,436,82600,5320,2825,4331,712,2030,972,451,166,3560,2667,893,2667,1696,971,2017-01-01,zipcode,Greensboro
ZCTA5 36748,01,2698,36375,614,88500,2329,1151,2136,308,841,641,208,138,1550,1261,289,1261,892,369,2017-01-01,zipcode,Linden
ZCTA5 36749,01,748,41615,-666666666,94200,684,436,583,107,261,136,47,32,426,291,135,291,225,66,2017-01-01,zipcode,Jones
ZCTA5 36750,01,2945,43438,619,114400,2247,1052,1878,427,761,418,116,156,1243,1042,201,1042,777,265,2017-01-01,zipcode,Maplesville
ZCTA5 36751,01,498,10781,603,34300,344,255,290,193,81,1,7,8,310,218,92,218,169,49,2017-01-01,zipcode,Lower peach tree
ZCTA5 36752,01,1384,42045,673,88800,1173,584,985,138,252,369,176,50,807,596,211,596,495,101,2017-01-01,zipcode,Lowndesboro
ZCTA5 36753,01,17,-666666666,-666666666,-666666666,17,17,17,17,0,0,0,0,35,17,18,17,0,17,2017-01-01,zipcode,Mc williams
ZCTA5 36754,01,353,45341,-666666666,179200,328,141,300,127,100,68,0,5,226,144,82,144,72,72,2017-01-01,zipcode,Magnolia
ZCTA5 36756,01,5780,25498,551,81000,4918,3133,3394,560,1430,739,301,364,2470,1593,877,1593,1280,313,2017-01-01,zipcode,Marion
ZCTA5 36758,01,1121,35466,669,74500,938,421,808,63,492,162,49,42,618,522,96,522,358,164,2017-01-01,zipcode,Plantersville
ZCTA5 36759,01,1656,29798,546,61800,1361,687,1185,266,311,391,134,83,892,685,207,685,488,197,2017-01-01,zipcode,Marion junction
ZCTA5 36761,01,924,28333,-666666666,78800,770,430,590,189,207,120,54,20,617,402,215,402,320,82,2017-01-01,zipcode,Minter
ZCTA5 36763,01,212,36042,-666666666,78600,149,96,138,59,40,33,5,1,89,67,22,67,56,11,2017-01-01,zipcode,Myrtlewood
ZCTA5 36765,01,1179,18750,890,63100,950,609,868,284,451,107,22,4,580,488,92,488,436,52,2017-01-01,zipcode,Newbern
ZCTA5 36766,01,22,-666666666,-666666666,-666666666,22,5,22,4,4,2,11,1,22,11,11,11,11,0,2017-01-01,zipcode,Oak hill
ZCTA5 36767,01,1561,24395,459,50700,1256,700,1089,373,322,250,117,27,1016,679,337,679,501,178,2017-01-01,zipcode,Orrville
ZCTA5 36768,01,819,17308,525,53800,661,423,530,129,184,109,51,57,652,322,330,322,256,66,2017-01-01,zipcode,Pine apple
ZCTA5 36769,01,3000,28194,507,68800,2405,1465,2023,390,926,492,153,62,1324,968,356,968,646,322,2017-01-01,zipcode,Pine hill
ZCTA5 36773,01,512,23750,445,100700,425,249,284,100,50,87,40,7,263,205,58,205,99,106,2017-01-01,zipcode,Safford
ZCTA5 36775,01,796,30400,754,45300,647,305,619,126,203,236,54,0,512,368,144,368,287,81,2017-01-01,zipcode,Sardis
ZCTA5 36776,01,1518,42500,-666666666,93800,1269,746,1063,200,386,284,159,34,733,546,187,546,484,62,2017-01-01,zipcode,Sawyerville
ZCTA5 36782,01,2905,33224,468,59700,2115,1174,1964,383,867,541,152,21,1304,1020,284,1020,855,165,2017-01-01,zipcode,Sweet water
ZCTA5 36783,01,551,24107,428,71800,503,276,482,51,229,130,26,46,525,300,225,300,251,49,2017-01-01,zipcode,Thomaston
ZCTA5 36784,01,7177,37500,534,112700,5808,3056,4974,1090,1944,1137,522,281,3382,2820,562,2820,1719,1101,2017-01-01,zipcode,Thomasville
ZCTA5 36785,01,1205,19938,661,63800,894,546,817,143,330,250,82,12,712,589,123,589,451,138,2017-01-01,zipcode,Tyler
ZCTA5 36786,01,2986,18067,508,52600,2009,1205,1739,438,709,322,182,88,1700,1084,616,1084,692,392,2017-01-01,zipcode,Uniontown
ZCTA5 36790,01,171,52993,-666666666,48600,171,96,129,10,95,24,0,0,81,81,0,81,81,0,2017-01-01,zipcode,Stanton
ZCTA5 36792,01,1401,65035,-666666666,97200,1074,520,976,60,494,402,20,0,602,477,125,477,388,89,2017-01-01,zipcode,Randolph
ZCTA5 36793,01,253,30332,-666666666,58200,237,131,185,42,119,5,0,19,249,131,118,131,127,4,2017-01-01,zipcode,Lawley
ZCTA5 36801,01,24833,40437,676,154700,19786,7838,17177,2397,4729,5131,2934,1986,11227,10131,1096,10131,5891,4240,2017-01-01,zipcode,Opelika
ZCTA5 36804,01,17485,46397,767,106200,13503,5526,11857,1623,3976,3845,1518,895,6991,6455,536,6455,4730,1725,2017-01-01,zipcode,Opelika
ZCTA5 36830,01,38799,52422,851,243500,32124,12041,22249,1572,2786,4674,6661,6556,17443,15409,2034,15409,7526,7883,2017-01-01,zipcode,Auburn
ZCTA5 36832,01,23787,27367,845,98400,20062,7879,10054,872,1904,3181,2526,1571,12184,9718,2466,9718,4066,5652,2017-01-01,zipcode,Auburn
ZCTA5 36849,01,4043,-666666666,-666666666,-666666666,4043,3237,7,0,7,0,0,0,0,0,0,0,0,0,2017-01-01,zipcode,Auburn university
ZCTA5 36850,01,2744,31477,394,55000,2394,1255,1935,430,670,566,175,94,1466,1160,306,1160,929,231,2017-01-01,zipcode,Camp hill
ZCTA5 36852,01,2490,34850,728,94100,2008,882,1675,195,690,566,161,63,1134,906,228,906,737,169,2017-01-01,zipcode,Cusseta
ZCTA5 36853,01,8162,51670,686,157200,6869,3787,6172,847,2003,1571,1082,669,6092,3345,2747,3345,2709,636,2017-01-01,zipcode,Dadeville
ZCTA5 36854,01,15399,43404,771,99900,12021,4802,10061,1325,3645,3414,1179,498,7437,5905,1532,5905,3770,2135,2017-01-01,zipcode,Valley
ZCTA5 36855,01,1764,42007,491,113700,1362,640,1203,312,478,221,104,88,876,661,215,661,580,81,2017-01-01,zipcode,Five points
ZCTA5 36856,01,7011,71689,1406,208700,5138,2045,4640,673,1078,1564,819,506,2469,2288,181,2288,1781,507,2017-01-01,zipcode,Fort mitchell
ZCTA5 36858,01,263,32500,612,90300,233,111,218,34,85,49,27,23,239,146,93,146,123,23,2017-01-01,zipcode,Hatchechubbee
ZCTA5 36859,01,48,-666666666,-666666666,-666666666,48,34,48,18,0,0,14,16,22,22,0,22,22,0,2017-01-01,zipcode,
ZCTA5 36860,01,1626,32083,504,60400,1347,815,1244,452,389,259,116,28,940,667,273,667,543,124,2017-01-01,zipcode,Hurtsboro
ZCTA5 36861,01,2986,50000,639,149400,2514,1169,2322,430,758,624,350,160,1947,1308,639,1308,1088,220,2017-01-01,zipcode,Jacksons gap
ZCTA5 36862,01,5984,31939,562,73000,4900,2496,4369,1199,1579,1117,274,200,3053,2536,517,2536,1692,844,2017-01-01,zipcode,Lafayette
ZCTA5 36863,01,11671,36746,662,93700,9573,3967,8322,1557,3316,2213,865,371,5886,4844,1042,4844,3145,1699,2017-01-01,zipcode,Lanett
ZCTA5 36865,01,29,41250,-666666666,63600,24,20,24,0,17,6,1,0,26,15,11,15,15,0,2017-01-01,zipcode,Loachapoka
ZCTA5 36866,01,3649,39773,543,70400,3036,1025,2724,308,1289,744,290,93,2047,1712,335,1712,1322,390,2017-01-01,zipcode,Notasulga
ZCTA5 36867,01,23280,41925,802,130800,17983,6140,15212,1965,4298,5374,2206,1369,11041,9543,1498,9543,4727,4816,2017-01-01,zipcode,Phenix city
ZCTA5 36869,01,21196,34656,737,108300,16581,7299,13501,2383,4740,4576,1024,778,9755,8085,1670,8085,4672,3413,2017-01-01,zipcode,Phenix city
ZCTA5 36870,01,21503,56680,883,126600,16284,6035,13233,1738,4056,4864,1566,1009,8167,7276,891,7276,5061,2215,2017-01-01,zipcode,Phenix city
ZCTA5 36871,01,1278,27589,-666666666,89200,1100,616,1006,112,411,331,130,22,607,511,96,511,420,91,2017-01-01,zipcode,Pittsview
ZCTA5 36874,01,8117,58488,902,152000,6574,2608,5641,503,1893,1973,715,557,3452,3029,423,3029,2624,405,2017-01-01,zipcode,Salem
ZCTA5 36875,01,3712,50137,800,108800,3112,1408,2832,354,1130,958,294,96,1886,1539,347,1539,1143,396,2017-01-01,zipcode,Seale
ZCTA5 36877,01,12097,50770,852,138900,9637,3364,8419,953,2433,3382,1119,532,5235,4803,432,4803,3219,1584,2017-01-01,zipcode,Smiths station
ZCTA5 36879,01,2002,70625,564,191000,1527,544,1316,156,386,331,183,260,893,752,141,752,670,82,2017-01-01,zipcode,Waverly
ZCTA5 36901,01,397,23911,509,34900,397,240,370,36,255,71,8,0,244,193,51,193,118,75,2017-01-01,zipcode,Bellamy
ZCTA5 36904,01,4039,31480,545,83400,3410,1946,3012,532,1176,844,358,102,2114,1695,419,1695,1144,551,2017-01-01,zipcode,Butler
ZCTA5 36907,01,1712,27418,676,73200,1422,692,1196,131,552,257,152,104,945,757,188,757,612,145,2017-01-01,zipcode,Cuba
ZCTA5 36908,01,2107,45565,318,81600,1715,977,1563,225,679,530,85,44,1060,806,254,806,736,70,2017-01-01,zipcode,Gilbertown
ZCTA5 36910,01,29,-666666666,-666666666,-666666666,19,19,0,0,0,0,0,0,76,19,57,19,0,19,2017-01-01,zipcode,Jachin
ZCTA5 36912,01,2007,30417,563,62400,1667,954,1483,307,659,384,68,65,1249,890,359,890,703,187,2017-01-01,zipcode,Lisman
ZCTA5 36913,01,79,-666666666,-666666666,40600,79,21,55,45,10,0,0,0,45,45,0,45,45,0,2017-01-01,zipcode,Melvin
ZCTA5 36915,01,768,30521,-666666666,49200,583,303,454,76,176,117,36,49,382,283,99,283,212,71,2017-01-01,zipcode,Needham
ZCTA5 36916,01,741,35144,439,64300,581,339,522,109,172,177,19,45,493,297,196,297,237,60,2017-01-01,zipcode,Pennington
ZCTA5 36919,01,1777,29598,503,55800,1460,890,1225,318,504,317,68,18,996,725,271,725,644,81,2017-01-01,zipcode,Silas
ZCTA5 36921,01,881,-666666666,592,60600,717,353,649,129,242,157,111,10,550,402,148,402,377,25,2017-01-01,zipcode,Toxey
ZCTA5 36922,01,377,35536,-666666666,52100,329,143,321,88,97,122,7,7,284,177,107,177,141,36,2017-01-01,zipcode,Ward
ZCTA5 36925,01,3543,24335,502,49200,2800,1468,2442,551,952,582,148,209,1579,1291,288,1291,929,362,2017-01-01,zipcode,York
ZCTA5 75001,48,14617,73578,1218,303500,13026,1876,11423,493,1302,2971,4316,2341,9315,8287,1028,8287,1495,6792,2017-01-01,zipcode,Addison
ZCTA5 75002,48,69688,98652,1366,229800,51605,13819,43166,2797,6669,13606,13718,6376,22532,22029,503,22029,17350,4679,2017-01-01,zipcode,Allen
ZCTA5 75006,48,50788,57415,1051,167000,39258,10801,33048,7509,8244,7901,6392,3002,18451,17780,671,17780,9279,8501,2017-01-01,zipcode,Carrollton
ZCTA5 75007,48,53744,82079,1159,200600,43331,12245,37346,3983,7449,10621,10909,4384,19665,19109,556,19109,14059,5050,2017-01-01,zipcode,Carrollton
ZCTA5 75009,48,10557,90717,1335,270200,8156,2407,6999,418,1745,2502,1746,588,3800,3532,268,3532,2830,702,2017-01-01,zipcode,Celina
ZCTA5 75010,48,27822,81856,1184,247800,22155,5077,19070,1170,2959,5547,6483,2911,11491,11083,408,11083,4889,6194,2017-01-01,zipcode,Carrollton
ZCTA5 75013,48,38975,124915,1388,375700,28392,7995,24436,519,2289,5235,9703,6690,13329,12894,435,12894,9747,3147,2017-01-01,zipcode,Allen
ZCTA5 75019,48,41947,118471,1285,344200,32421,8540,28412,929,2638,5903,11116,7826,16054,15346,708,15346,10815,4531,2017-01-01,zipcode,Coppell
ZCTA5 75020,48,21891,46582,777,97000,17800,7583,15626,1803,4806,5811,1918,1288,10142,8811,1331,8811,5654,3157,2017-01-01,zipcode,Denison
ZCTA5 75021,48,8704,49910,736,99100,6729,2727,5989,827,2214,2129,516,303,3511,3242,269,3242,2501,741,2017-01-01,zipcode,Denison
ZCTA5 75022,48,24625,156902,2208,378400,18018,5191,15537,387,1544,3131,7021,3454,7758,7587,171,7587,7210,377,2017-01-01,zipcode,Flower mound
ZCTA5 75023,48,49563,83764,1361,212000,40173,12534,34895,1834,5224,10609,11302,5926,18972,18298,674,18298,11614,6684,2017-01-01,zipcode,Plano
ZCTA5 75024,48,42405,91795,1255,356600,33884,9227,29656,579,2282,5817,12605,8373,18457,17692,765,17692,7694,9998,2017-01-01,zipcode,Plano
ZCTA5 75025,48,53559,112999,1328,308400,41816,12057,35786,862,2794,7806,14213,10111,19543,19007,536,19007,13441,5566,2017-01-01,zipcode,Plano
ZCTA5 75028,48,47056,115490,1671,271500,35899,9463,30750,992,3734,8474,11385,6165,16480,15966,514,15966,13302,2664,2017-01-01,zipcode,Flower mound
ZCTA5 75032,48,31399,101851,1243,272600,24179,7672,20555,1908,3052,6248,5883,3464,11241,10703,538,10703,8846,1857,2017-01-01,zipcode,Rockwall
ZCTA5 75034,48,95996,116962,1232,358600,69302,19988,60954,2663,7112,15390,22609,13180,35316,33152,2164,33152,23494,9658,2017-01-01,zipcode,Frisco
ZCTA5 75035,48,65264,122843,1698,290800,46419,11198,40550,1795,3585,10818,15129,9223,21683,21127,556,21127,16843,4284,2017-01-01,zipcode,Frisco
ZCTA5 75038,48,29762,51444,971,206900,22514,5151,19298,1673,3945,5147,5173,3360,13520,12389,1131,12389,1913,10476,2017-01-01,zipcode,Irving
ZCTA5 75039,48,18010,89845,1359,439800,14816,2551,13716,303,1069,2518,5449,4377,9783,8849,934,8849,1647,7202,2017-01-01,zipcode,Irving
ZCTA5 75040,48,62277,59305,1099,123700,46895,14537,38769,10615,9813,10993,5302,2046,19496,18499,997,18499,13300,5199,2017-01-01,zipcode,Garland
ZCTA5 75041,48,33304,42556,921,106100,23655,7930,19140,6614,5493,4698,1625,710,10261,9708,553,9708,5673,4035,2017-01-01,zipcode,Garland
ZCTA5 75042,48,39559,42153,860,116300,28993,9743,23592,8943,5571,6070,2318,690,12211,11623,588,11623,5843,5780,2017-01-01,zipcode,Garland
ZCTA5 75043,48,59951,58571,1022,142100,45204,12751,38804,5089,9745,14086,6695,3189,22335,20860,1475,20860,11969,8891,2017-01-01,zipcode,Garland
ZCTA5 75044,48,40942,64085,1183,166500,33740,10745,28712,3470,5357,8779,7637,3469,15919,15167,752,15167,10174,4993,2017-01-01,zipcode,Garland
ZCTA5 75048,48,24203,97666,1227,197900,18744,5435,15677,1836,3620,5137,3466,1618,7754,7522,232,7522,6557,965,2017-01-01,zipcode,Sachse
ZCTA5 75050,48,42670,50889,958,107100,31964,9210,25403,6097,7465,6571,3460,1810,16433,14640,1793,14640,6312,8328,2017-01-01,zipcode,Grand prairie
ZCTA5 75051,48,40962,40841,876,94300,30033,10334,24120,8087,8618,5038,1719,658,13872,12709,1163,12709,6011,6698,2017-01-01,zipcode,Grand prairie
ZCTA5 75052,48,94133,74859,1197,149900,71709,19268,59698,8815,14645,19769,11975,4494,30789,29494,1295,29494,22150,7344,2017-01-01,zipcode,Grand prairie
ZCTA5 75054,48,10764,116784,2091,278700,7765,2070,6692,187,835,2075,2431,1164,3268,3114,154,3114,2757,357,2017-01-01,zipcode,Grand prairie
ZCTA5 75056,48,57115,83141,1296,217100,44200,9701,37503,2347,7040,12177,11326,4613,21743,20777,966,20777,13387,7390,2017-01-01,zipcode,The colony
ZCTA5 75057,48,14562,51861,1128,117100,11109,2702,9305,2522,1978,2689,1611,505,5519,5035,484,5035,1755,3280,2017-01-01,zipcode,Lewisville
ZCTA5 75058,48,2697,75192,977,216300,2093,745,1788,191,453,516,464,164,934,864,70,864,677,187,2017-01-01,zipcode,Gunter
ZCTA5 75060,48,47922,52749,886,115900,35087,10091,28913,10086,7749,6946,2986,1146,14831,14295,536,14295,8921,5374,2017-01-01,zipcode,Irving
ZCTA5 75061,48,54907,44079,864,127500,40049,11627,32268,11371,8683,7340,3393,1481,18917,17456,1461,17456,6683,10773,2017-01-01,zipcode,Irving
ZCTA5 75062,48,48553,50133,935,134400,36779,10100,29676,6499,7267,8293,5011,2606,17091,16248,843,16248,6918,9330,2017-01-01,zipcode,Irving
ZCTA5 75063,48,38383,85165,1141,322000,29124,7041,26490,680,1875,5194,10140,8601,16503,15743,760,15743,6352,9391,2017-01-01,zipcode,Irving
ZCTA5 75065,48,12457,77273,1182,172700,10006,2963,8887,648,2526,3043,1989,681,4909,4586,323,4586,3519,1067,2017-01-01,zipcode,Lake dallas
ZCTA5 75067,48,66896,60029,1082,170900,51419,11089,43706,5630,9606,13538,10688,4244,26930,24913,2017,24913,9557,15356,2017-01-01,zipcode,Lewisville
ZCTA5 75068,48,55848,94356,1498,209900,39926,9205,35023,2667,6358,11404,9941,4653,18159,17670,489,17670,13751,3919,2017-01-01,zipcode,Little elm
ZCTA5 75069,48,36879,52504,971,238700,28524,10412,24182,4421,6121,6390,5095,2155,14567,13681,886,13681,7089,6592,2017-01-01,zipcode,Mckinney
ZCTA5 75070,48,93299,98754,1433,269600,68607,19169,59178,2077,7110,18374,21571,10046,34084,32577,1507,32577,23917,8660,2017-01-01,zipcode,Mckinney
ZCTA5 75071,48,49846,94473,1455,252400,36544,11374,31080,2088,5024,10276,8848,4844,16475,15980,495,15980,11373,4607,2017-01-01,zipcode,Mckinney
ZCTA5 75074,48,48977,65558,1168,173000,37862,10505,31448,5553,6649,8312,7666,3268,17483,16430,1053,16430,9593,6837,2017-01-01,zipcode,Plano
ZCTA5 75075,48,35933,75123,1152,223400,29857,10110,25390,1665,3656,7892,8102,4075,14851,14081,770,14081,9197,4884,2017-01-01,zipcode,Plano
ZCTA5 75076,48,7244,55267,863,135600,5882,2441,5362,369,1519,2109,873,492,4360,3043,1317,3043,2285,758,2017-01-01,zipcode,Pottsboro
ZCTA5 75077,48,36181,103326,1404,253500,28447,8136,24860,1166,4070,7720,8143,3761,13409,12966,443,12966,10395,2571,2017-01-01,zipcode,Lewisville
ZCTA5 75078,48,20611,136642,1256,409500,14022,4168,12149,388,1531,3403,4856,1971,6541,6111,430,6111,5374,737,2017-01-01,zipcode,Prosper
ZCTA5 75080,48,50247,69440,1215,225800,40041,13651,32631,3264,4214,7688,11227,6238,19585,18553,1032,18553,10148,8405,2017-01-01,zipcode,Richardson
ZCTA5 75081,48,37960,66513,1227,185400,30215,9579,26387,1769,4692,8238,7969,3719,15327,14482,845,14482,8192,6290,2017-01-01,zipcode,Richardson
ZCTA5 75082,48,23733,120237,1367,289500,18994,5409,16656,644,1679,3256,6402,4675,9295,8956,339,8956,6565,2391,2017-01-01,zipcode,Richardson
ZCTA5 75087,48,33110,96471,1278,241400,25118,8647,21587,1318,3989,6581,6514,3185,11924,11417,507,11417,8894,2523,2017-01-01,zipcode,Rockwall
ZCTA5 75088,48,25842,86140,1430,179700,20701,5738,17922,1442,3993,6695,3798,1994,9335,8842,493,8842,7578,1264,2017-01-01,zipcode,Rowlett
ZCTA5 75089,48,33117,97534,1562,182500,25012,6532,20864,1445,4615,7649,5023,2132,10786,10638,148,10638,9490,1148,2017-01-01,zipcode,Rowlett
ZCTA5 75090,48,23936,38086,835,82900,17971,7191,14398,2826,5190,4659,1169,554,8936,8052,884,8052,4955,3097,2017-01-01,zipcode,Sherman
ZCTA5 75092,48,24312,56958,826,143400,19386,6752,16835,1359,4421,6493,2969,1593,11066,9901,1165,9901,5426,4475,2017-01-01,zipcode,Sherman
ZCTA5 75093,48,48021,102889,1261,408600,39148,12160,34274,999,3218,7133,13484,9440,20623,19443,1180,19443,12348,7095,2017-01-01,zipcode,Plano
ZCTA5 75094,48,23097,127095,2165,318700,16554,4785,14173,846,2198,3143,5244,2742,6195,6123,72,6123,5171,952,2017-01-01,zipcode,Plano
ZCTA5 75098,48,54534,88453,1335,178600,39743,10926,33489,3045,8209,10749,8478,3008,17464,16866,598,16866,13494,3372,2017-01-01,zipcode,Wylie
ZCTA5 75101,48,710,45568,878,69400,499,205,410,175,127,78,26,4,241,215,26,215,154,61,2017-01-01,zipcode,Bardwell
ZCTA5 75102,48,1251,43611,976,85000,1073,454,906,209,355,235,98,9,623,480,143,480,398,82,2017-01-01,zipcode,Barry
ZCTA5 75103,48,13967,50722,907,120700,11330,4931,9821,1304,3081,3455,1437,544,6047,5163,884,5163,4091,1072,2017-01-01,zipcode,Canton
ZCTA5 75104,48,48568,69699,1277,147000,36126,10306,29930,2511,6784,11336,5480,3819,16867,15937,930,15937,11146,4791,2017-01-01,zipcode,Cedar hill
ZCTA5 75105,48,245,42132,-666666666,106300,208,112,151,21,51,69,10,0,112,89,23,89,84,5,2017-01-01,zipcode,Chatfield
ZCTA5 75109,48,4096,67038,1101,125800,3274,1297,2836,305,840,963,437,291,1906,1563,343,1563,1322,241,2017-01-01,zipcode,Corsicana
ZCTA5 75110,48,28847,42843,758,90300,21970,8170,18320,4612,4886,6051,1735,1036,11524,10128,1396,10128,6268,3860,2017-01-01,zipcode,Corsicana
ZCTA5 75114,48,5930,64519,1171,118100,4603,1373,3949,659,1474,1320,381,115,2144,1915,229,1915,1534,381,2017-01-01,zipcode,Crandall
ZCTA5 75115,48,52377,65194,1068,155300,40092,12124,35250,4100,7554,13549,6353,3694,20136,19109,1027,19109,12019,7090,2017-01-01,zipcode,Desoto
ZCTA5 75116,48,19996,44222,956,119800,14733,5309,12497,2868,3462,3865,1448,854,6985,6507,478,6507,3794,2713,2017-01-01,zipcode,Duncanville
ZCTA5 75117,48,4007,46069,724,119900,3214,1501,2708,412,884,912,347,153,1769,1583,186,1583,1176,407,2017-01-01,zipcode,Edgewood
ZCTA5 75119,48,27514,50947,846,115500,20927,7568,17350,4111,5502,5350,1586,801,10068,9150,918,9150,5840,3310,2017-01-01,zipcode,Ennis
ZCTA5 75124,48,4229,49954,646,112500,3660,1647,3158,462,1136,1036,295,229,2064,1617,447,1617,1198,419,2017-01-01,zipcode,Eustace
ZCTA5 75125,48,6236,52171,944,80400,4623,2002,3825,1143,1302,952,241,187,2195,2083,112,2083,1606,477,2017-01-01,zipcode,Ferris
ZCTA5 75126,48,42409,89782,1272,186200,29730,7606,25280,1822,6673,8791,5369,2625,12983,12527,456,12527,11072,1455,2017-01-01,zipcode,Forney
ZCTA5 75127,48,1719,39417,699,98800,1338,674,1142,232,481,325,58,46,698,609,89,609,452,157,2017-01-01,zipcode,Fruitvale
ZCTA5 75132,48,1864,70364,-666666666,148600,1255,311,1134,44,290,461,243,96,662,570,92,570,533,37,2017-01-01,zipcode,Fate
ZCTA5 75134,48,22106,49440,951,112000,15600,4545,12729,1694,3962,4964,1626,483,7447,6999,448,6999,4064,2935,2017-01-01,zipcode,Lancaster
ZCTA5 75135,48,7113,79400,929,143100,5033,1826,4332,384,1590,1718,489,151,2344,2166,178,2166,1792,374,2017-01-01,zipcode,Caddo mills
ZCTA5 75137,48,19640,59144,1185,137900,15657,5325,12700,1653,3121,4471,1922,1533,7135,6826,309,6826,4827,1999,2017-01-01,zipcode,Duncanville
ZCTA5 75140,48,6752,43772,691,102900,5205,2445,4680,1168,1609,1267,424,212,2609,2224,385,2224,1562,662,2017-01-01,zipcode,Grand saline
ZCTA5 75141,48,5815,37007,919,80700,4741,3009,3880,1115,1440,1063,190,72,1287,1203,84,1203,805,398,2017-01-01,zipcode,Hutchins
ZCTA5 75142,48,18702,51363,865,107500,14573,5670,12620,2375,4649,3979,1112,505,6603,5959,644,5959,4398,1561,2017-01-01,zipcode,Kaufman
ZCTA5 75143,48,14138,44200,823,93600,11527,5488,10109,2047,3748,2708,1174,432,7421,5479,1942,5479,4172,1307,2017-01-01,zipcode,Kemp
ZCTA5 75144,48,3377,42724,730,84600,2620,1077,2295,303,843,772,198,179,1729,1307,422,1307,889,418,2017-01-01,zipcode,Kerens
ZCTA5 75146,48,19071,56458,996,111500,14125,3863,11586,1545,3163,4462,1669,747,7038,6617,421,6617,4220,2397,2017-01-01,zipcode,Lancaster
ZCTA5 75147,48,6736,46797,693,101000,5174,2191,4268,549,1871,1085,512,251,2739,2294,445,2294,1599,695,2017-01-01,zipcode,Mabank
ZCTA5 75148,48,5774,32366,740,74300,4373,2281,3845,681,1222,1347,415,180,3240,2140,1100,2140,1478,662,2017-01-01,zipcode,Malakoff
ZCTA5 75149,48,55797,47016,992,103500,40961,13112,33497,7696,10386,10729,3253,1433,19114,17834,1280,17834,10901,6933,2017-01-01,zipcode,Mesquite
ZCTA5 75150,48,62297,48921,997,112800,46394,14090,37907,7842,11152,12171,4808,1934,23467,21391,2076,21391,9789,11602,2017-01-01,zipcode,Mesquite
ZCTA5 75152,48,4694,55666,982,108400,3350,925,2733,669,802,925,277,60,1640,1497,143,1497,1205,292,2017-01-01,zipcode,Palmer
ZCTA5 75153,48,440,36650,-666666666,66600,344,184,304,113,80,82,29,0,171,141,30,141,130,11,2017-01-01,zipcode,Powell
ZCTA5 75154,48,40225,73996,1106,158600,30077,9761,25034,4151,6532,8429,4058,1864,13170,12436,734,12436,9558,2878,2017-01-01,zipcode,Red oak
ZCTA5 75155,48,2946,49356,784,81800,2079,863,1804,606,542,493,139,24,978,883,95,883,718,165,2017-01-01,zipcode,Rice
ZCTA5 75156,48,15720,49140,792,98400,12999,6687,11422,1979,4302,3191,1440,510,9322,6255,3067,6255,4913,1342,2017-01-01,zipcode,Mabank
ZCTA5 75157,48,267,35000,838,68300,208,97,175,54,78,29,8,6,133,94,39,94,73,21,2017-01-01,zipcode,Rosser
ZCTA5 75158,48,3793,56000,1021,153600,3085,1375,2721,285,1060,857,287,232,1570,1388,182,1388,1229,159,2017-01-01,zipcode,Scurry
ZCTA5 75159,48,19440,48861,878,95000,14961,6914,13119,3710,4630,3465,853,461,5736,5470,266,5470,4008,1462,2017-01-01,zipcode,Seagoville
ZCTA5 75160,48,25315,48500,893,120400,19414,6911,16246,3035,5483,5018,1875,835,9158,8282,876,8282,5065,3217,2017-01-01,zipcode,Terrell
ZCTA5 75161,48,6577,50498,980,114500,5088,2226,4438,795,1941,1212,309,181,2309,2127,182,2127,1688,439,2017-01-01,zipcode,Terrell
ZCTA5 75163,48,2440,40424,1002,79900,2107,1109,1903,343,805,620,114,21,1706,1072,634,1072,787,285,2017-01-01,zipcode,Trinidad
ZCTA5 75164,48,629,46781,1096,106900,479,178,432,80,210,103,26,13,287,263,24,263,194,69,2017-01-01,zipcode,Josephine
ZCTA5 75165,48,42048,61877,989,148300,32114,11119,26843,3609,7707,9548,4260,1719,15973,14793,1180,14793,9081,5712,2017-01-01,zipcode,Waxahachie
ZCTA5 75166,48,4057,91136,1642,217000,2879,809,2479,152,593,890,531,313,1268,1258,10,1258,1093,165,2017-01-01,zipcode,Lavon
ZCTA5 75167,48,10616,82135,1403,202100,8115,2869,6885,954,2003,2300,1255,373,3581,3325,256,3325,3039,286,2017-01-01,zipcode,Waxahachie
ZCTA5 75169,48,12779,47399,720,94400,10499,4675,9113,1750,3716,2644,779,224,6254,4738,1516,4738,3739,999,2017-01-01,zipcode,Wills point
ZCTA5 75172,48,4109,40839,816,59000,3057,1249,2494,922,688,718,160,6,1192,1117,75,1117,619,498,2017-01-01,zipcode,Wilmer
ZCTA5 75173,48,4166,68687,1091,167900,3281,1128,2910,426,889,971,411,213,1600,1501,99,1501,1307,194,2017-01-01,zipcode,Nevada
ZCTA5 75180,48,24112,44228,919,83800,16228,5588,12708,5403,3445,3102,626,132,7011,6251,760,6251,3750,2501,2017-01-01,zipcode,Balch springs
ZCTA5 75181,48,27588,77238,1646,155200,20572,5622,17134,2167,4574,6042,2831,1520,8165,7989,176,7989,6713,1276,2017-01-01,zipcode,Mesquite
ZCTA5 75182,48,6077,137721,2220,348000,4552,1288,3940,250,738,1101,1157,694,1848,1793,55,1793,1725,68,2017-01-01,zipcode,Sunnyvale
ZCTA5 75189,48,25560,81275,1214,172600,18662,5658,15960,1918,5228,4751,3032,1031,8586,8113,473,8113,6787,1326,2017-01-01,zipcode,Royse city
ZCTA5 75201,48,15185,90781,1611,448700,14420,2071,12386,314,790,2019,5595,3668,10444,9080,1364,9080,933,8147,2017-01-01,zipcode,Dallas
ZCTA5 75202,48,2029,87375,1484,233500,1935,167,1644,0,111,359,856,318,1631,1297,334,1297,258,1039,2017-01-01,zipcode,Dallas
ZCTA5 75203,48,16351,32699,762,78900,12374,3792,10156,3624,2684,2338,1191,319,7185,6248,937,6248,1831,4417,2017-01-01,zipcode,Dallas
ZCTA5 75204,48,30370,71766,1376,317800,26995,5105,22574,2297,2155,3456,8534,6132,19282,16749,2533,16749,3432,13317,2017-01-01,zipcode,Dallas
ZCTA5 75205,48,24211,129406,1379,1136900,19346,7572,14529,149,655,1706,6543,5476,10366,9061,1305,9061,5736,3325,2017-01-01,zipcode,Dallas
ZCTA5 75206,48,38762,63392,1187,362100,34071,6615,28680,2879,2654,4813,11648,6686,23088,20424,2664,20424,5286,15138,2017-01-01,zipcode,Dallas
ZCTA5 75207,48,8028,79926,1522,-666666666,7923,6072,6619,1619,1741,1736,1052,471,1644,1433,211,1433,0,1433,2017-01-01,zipcode,Dallas
ZCTA5 75208,48,29448,55855,898,193500,22741,6610,19259,5994,3678,3840,3385,2362,11388,10166,1222,10166,5540,4626,2017-01-01,zipcode,Dallas
ZCTA5 75209,48,13898,86963,1234,581300,11706,3463,10788,952,1244,2180,3927,2485,7425,6615,810,6615,3868,2747,2017-01-01,zipcode,Dallas
ZCTA5 75210,48,8243,25793,688,63300,5874,2577,4925,2170,1472,1068,147,68,3260,2823,437,2823,727,2096,2017-01-01,zipcode,Dallas
ZCTA5 75211,48,77600,38760,852,94500,55742,19800,43160,20991,11900,7289,2287,693,23207,21552,1655,21552,10698,10854,2017-01-01,zipcode,Dallas
ZCTA5 75212,48,26120,30673,621,83600,18276,7915,14448,7065,4325,2264,584,210,8237,7441,796,7441,3993,3448,2017-01-01,zipcode,Dallas
ZCTA5 75214,48,34145,84709,1070,430900,27652,7881,25244,1633,2043,5403,9465,6700,17718,15841,1877,15841,8795,7046,2017-01-01,zipcode,Dallas
ZCTA5 75215,48,15664,27358,762,66600,12589,5660,10965,3119,3381,3175,957,333,7584,6192,1392,6192,2195,3997,2017-01-01,zipcode,Dallas
ZCTA5 75216,48,52895,25763,785,61400,38808,18965,32810,11687,11782,7090,1664,587,20439,17828,2611,17828,9093,8735,2017-01-01,zipcode,Dallas
ZCTA5 75217,48,85249,35282,870,77100,58788,25126,46604,20712,14704,9327,1379,482,25614,23352,2262,23352,14262,9090,2017-01-01,zipcode,Dallas
ZCTA5 75218,48,22264,70272,1062,276500,18880,5959,17244,1766,2858,4361,4980,3279,11149,10421,728,10421,6855,3566,2017-01-01,zipcode,Dallas
ZCTA5 75219,48,23277,67311,1226,276100,21608,4092,19666,2140,2035,3727,7236,4528,15885,13990,1895,13990,4893,9097,2017-01-01,zipcode,Dallas
ZCTA5 75220,48,42642,43001,788,218900,31805,8551,25833,12446,5299,3127,3013,1948,15971,14324,1647,14324,4478,9846,2017-01-01,zipcode,Dallas
ZCTA5 75223,48,14351,41667,849,104600,10562,3551,8765,3850,1674,1475,1190,576,5099,4616,483,4616,2524,2092,2017-01-01,zipcode,Dallas
ZCTA5 75224,48,36468,37225,809,93700,25921,9040,19335,6979,5320,4526,1772,738,11811,10972,839,10972,5294,5678,2017-01-01,zipcode,Dallas
ZCTA5 75225,48,21568,173828,1880,996400,16519,6923,15138,134,410,1980,7301,5313,9658,8846,812,8846,6653,2193,2017-01-01,zipcode,Dallas
ZCTA5 75226,48,4790,52587,1135,333300,4226,1416,3780,950,630,1085,837,278,2110,1919,191,1919,56,1863,2017-01-01,zipcode,Dallas
ZCTA5 75227,48,57806,41240,873,90500,39704,15510,31858,11179,9691,7832,2182,974,18969,17067,1902,17067,9838,7229,2017-01-01,zipcode,Dallas
ZCTA5 75228,48,74605,40306,788,119300,54756,17632,44858,13506,11776,11833,5153,2590,27804,25581,2223,25581,11685,13896,2017-01-01,zipcode,Dallas
ZCTA5 75229,48,32390,88062,946,345400,25230,7058,22326,5093,3317,3961,5950,4005,12005,11150,855,11150,7974,3176,2017-01-01,zipcode,Dallas
ZCTA5 75230,48,27521,78837,953,553900,23244,7301,20653,1382,1930,4105,7682,5554,14136,13003,1133,13003,7890,5113,2017-01-01,zipcode,Dallas
ZCTA5 75231,48,40464,37189,815,299200,30641,8516,25453,6344,5405,5952,5232,2520,19264,16390,2874,16390,3198,13192,2017-01-01,zipcode,Dallas
ZCTA5 75232,48,30714,33296,912,91000,23439,10900,19960,4702,7025,5402,1772,1059,11534,10635,899,10635,6217,4418,2017-01-01,zipcode,Dallas
ZCTA5 75233,48,16318,45468,870,122200,11732,3898,9503,3079,2802,2104,832,686,5524,5051,473,5051,2578,2473,2017-01-01,zipcode,Dallas
ZCTA5 75234,48,32589,61680,1167,154600,26171,8585,21979,4233,5131,6387,4435,1793,12381,11512,869,11512,7090,4422,2017-01-01,zipcode,Dallas
ZCTA5 75235,48,18794,48449,1073,124600,15558,5254,12864,3554,3076,2625,2050,1559,8340,7392,948,7392,1940,5452,2017-01-01,zipcode,Dallas
ZCTA5 75236,48,18542,40685,883,110900,12867,3871,10367,2631,2955,2866,1440,475,7012,6319,693,6319,2177,4142,2017-01-01,zipcode,Dallas
ZCTA5 75237,48,20295,26768,776,113900,14072,4746,10934,2416,3471,3517,1082,448,9202,8310,892,8310,1250,7060,2017-01-01,zipcode,Dallas
ZCTA5 75238,48,33009,58908,858,313800,24014,7224,20977,3479,3158,4689,6126,3525,13618,12638,980,12638,6244,6394,2017-01-01,zipcode,Dallas
ZCTA5 75240,48,27875,42567,921,210300,20511,4679,16148,4545,3267,3479,3208,1649,11177,10118,1059,10118,2312,7806,2017-01-01,zipcode,Dallas
ZCTA5 75241,48,29398,32652,852,75900,22357,10649,18429,3825,6884,5679,1373,668,11558,10524,1034,10524,6223,4301,2017-01-01,zipcode,Dallas
ZCTA5 75243,48,67445,38640,837,186600,51521,13689,42916,7423,9573,13753,7867,4300,30709,27344,3365,27344,6674,20670,2017-01-01,zipcode,Dallas
ZCTA5 75244,48,13613,82500,1315,356700,11138,2693,9972,390,937,2234,4104,2307,6550,6068,482,6068,3030,3038,2017-01-01,zipcode,Dallas
ZCTA5 75246,48,2276,26716,690,163800,1914,651,1738,463,328,498,308,141,1429,1211,218,1211,187,1024,2017-01-01,zipcode,Dallas
ZCTA5 75247,48,712,16886,817,-666666666,712,534,712,174,208,235,29,66,224,224,0,224,0,224,2017-01-01,zipcode,Dallas
ZCTA5 75248,48,35464,80421,1099,340600,29454,8864,26845,1889,3166,6451,9353,5986,17129,16070,1059,16070,8542,7528,2017-01-01,zipcode,Dallas
ZCTA5 75249,48,16100,60250,1356,131100,11700,3401,9477,1634,2589,3379,1272,603,5070,5015,55,5015,3913,1102,2017-01-01,zipcode,Dallas
ZCTA5 75251,48,2368,58024,1297,-666666666,2204,778,1902,22,281,555,620,424,1868,1610,258,1610,0,1610,2017-01-01,zipcode,Dallas
ZCTA5 75252,48,26493,61399,924,328300,22489,5895,18867,913,2078,4362,6661,4853,13671,12549,1122,12549,4993,7556,2017-01-01,zipcode,Dallas
ZCTA5 75253,48,22721,41905,930,44400,15298,4835,12371,5409,3102,3102,475,283,7001,6272,729,6272,4112,2160,2017-01-01,zipcode,Dallas
ZCTA5 75254,48,26602,47437,1019,388400,19869,3601,17254,2862,2914,4453,4524,2501,13070,11628,1442,11628,2151,9477,2017-01-01,zipcode,Dallas
ZCTA5 75270,48,0,-666666666,-666666666,-666666666,0,0,0,0,0,0,0,0,0,0,0,0,0,0,2017-01-01,zipcode,Dallas
ZCTA5 75287,48,53903,49887,964,277900,44009,6547,37541,2017,6642,11998,11526,5358,29973,27395,2578,27395,5587,21808,2017-01-01,zipcode,Dallas
ZCTA5 75390,48,0,-666666666,-666666666,-666666666,0,0,0,0,0,0,0,0,0,0,0,0,0,0,2017-01-01,zipcode,Dallas
ZCTA5 75401,48,18830,34732,791,60500,13941,5753,11967,2375,4408,3569,981,634,7317,6464,853,6464,3449,3015,2017-01-01,zipcode,Greenville
ZCTA5 75402,48,16931,65026,858,132700,13329,5065,11840,1315,3221,3695,2072,1537,6924,6218,706,6218,4424,1794,2017-01-01,zipcode,Greenville
ZCTA5 75407,48,16367,57027,1033,152500,12067,4012,10227,1441,3482,3369,1573,362,5904,5607,297,5607,3831,1776,2017-01-01,zipcode,Princeton
ZCTA5 75409,48,14010,83622,1603,174700,9956,3228,8713,855,2856,3010,1185,807,4748,4352,396,4352,3210,1142,2017-01-01,zipcode,Anna
ZCTA5 75410,48,5327,53462,761,113200,4302,1929,3920,739,1341,1378,292,170,2469,1956,513,1956,1566,390,2017-01-01,zipcode,Alba
ZCTA5 75411,48,1157,72538,688,80400,998,401,938,115,403,292,69,59,575,469,106,469,368,101,2017-01-01,zipcode,Arthur city
ZCTA5 75412,48,528,42366,-666666666,72400,446,180,421,53,130,217,21,0,371,271,100,271,257,14,2017-01-01,zipcode,Bagwell
ZCTA5 75413,48,223,50208,950,63500,170,59,148,36,53,44,11,4,97,87,10,87,61,26,2017-01-01,zipcode,Bailey
ZCTA5 75414,48,3184,61343,756,127300,2527,1115,2222,254,615,771,367,215,1288,1149,139,1149,974,175,2017-01-01,zipcode,Bells
ZCTA5 75415,48,128,-666666666,-666666666,78100,113,80,113,0,52,45,16,0,101,69,32,69,60,9,2017-01-01,zipcode,Ben franklin
ZCTA5 75416,48,2887,47167,770,88700,2274,887,1762,283,627,547,266,39,1255,1040,215,1040,810,230,2017-01-01,zipcode,Blossom
ZCTA5 75417,48,2691,34118,503,69200,2122,892,1873,489,508,675,177,24,1311,1060,251,1060,859,201,2017-01-01,zipcode,Bogata
ZCTA5 75418,48,14318,41508,742,91000,12064,6705,10375,1681,3669,3469,1026,530,5708,4719,989,4719,3250,1469,2017-01-01,zipcode,Bonham
ZCTA5 75420,48,870,83684,708,140800,764,258,655,77,220,214,77,67,401,334,67,334,283,51,2017-01-01,zipcode,Brashear
ZCTA5 75421,48,898,58723,831,110200,674,340,542,48,137,257,100,0,323,272,51,272,203,69,2017-01-01,zipcode,Brookston
ZCTA5 75422,48,2946,57679,826,98100,2362,965,2071,278,640,764,282,107,1182,1021,161,1021,880,141,2017-01-01,zipcode,Campbell
ZCTA5 75423,48,2749,61750,859,121100,2318,994,2097,242,897,631,253,74,1275,1049,226,1049,888,161,2017-01-01,zipcode,Celeste
ZCTA5 75424,48,3765,64405,1004,139100,2801,1092,2420,333,936,795,270,86,1402,1264,138,1264,1062,202,2017-01-01,zipcode,Blue ridge
ZCTA5 75426,48,4953,32472,632,52400,4329,2335,3657,523,1660,936,398,140,2807,2109,698,2109,1420,689,2017-01-01,zipcode,Clarksville
ZCTA5 75428,48,10802,32547,836,82300,9380,4173,5832,761,1714,1557,915,885,4686,3771,915,3771,1821,1950,2017-01-01,zipcode,Commerce
ZCTA5 75431,48,2356,46667,783,77800,1855,841,1637,307,751,477,76,26,1022,824,198,824,570,254,2017-01-01,zipcode,Como
ZCTA5 75432,48,3519,39350,560,74100,2780,1361,2328,446,768,661,319,134,1526,1305,221,1305,879,426,2017-01-01,zipcode,Cooper
ZCTA5 75433,48,2752,51791,753,99100,2274,978,2002,311,660,619,263,149,1317,1065,252,1065,864,201,2017-01-01,zipcode,Cumby
ZCTA5 75435,48,1374,40224,359,55100,1075,442,945,169,421,257,90,8,600,519,81,519,346,173,2017-01-01,zipcode,Deport
ZCTA5 75436,48,1923,37181,484,81800,1500,699,1309,181,543,483,80,22,996,770,226,770,555,215,2017-01-01,zipcode,Detroit
ZCTA5 75437,48,1335,64135,-666666666,110100,1086,466,965,130,345,351,105,34,521,475,46,475,445,30,2017-01-01,zipcode,Dike
ZCTA5 75438,48,918,76944,705,106600,703,276,633,44,284,169,94,42,422,352,70,352,307,45,2017-01-01,zipcode,Dodd city
ZCTA5 75439,48,932,58750,812,116000,733,252,628,99,203,236,55,35,388,357,31,357,229,128,2017-01-01,zipcode,Ector
ZCTA5 75440,48,6201,48475,634,130300,4990,2447,4553,735,1835,1464,364,155,3193,2498,695,2498,2003,495,2017-01-01,zipcode,Emory
ZCTA5 75441,48,128,48914,-666666666,-666666666,103,37,91,0,34,0,45,12,79,65,14,65,65,0,2017-01-01,zipcode,Enloe
ZCTA5 75442,48,9848,64398,1026,148500,7845,3175,6936,800,2661,2367,748,360,3941,3409,532,3409,2341,1068,2017-01-01,zipcode,Farmersville
ZCTA5 75446,48,3553,37778,725,93600,2792,1434,2230,388,765,573,323,181,1496,1186,310,1186,919,267,2017-01-01,zipcode,Honey grove
ZCTA5 75447,48,1057,76293,625,128300,873,374,715,91,247,342,20,15,398,352,46,352,271,81,2017-01-01,zipcode,Ivanhoe
ZCTA5 75448,48,604,58403,-666666666,49200,455,214,434,37,127,246,24,0,276,227,49,227,220,7,2017-01-01,zipcode,Klondike
ZCTA5 75449,48,1484,40481,755,58900,1091,437,917,116,302,319,114,66,680,582,98,582,418,164,2017-01-01,zipcode,Ladonia
ZCTA5 75450,48,173,50417,-666666666,106600,105,60,93,0,51,34,8,0,87,53,34,53,53,0,2017-01-01,zipcode,Lake creek
ZCTA5 75451,48,998,34392,611,101900,871,429,769,150,206,246,141,26,635,496,139,496,401,95,2017-01-01,zipcode,Leesburg
ZCTA5 75452,48,4306,57052,669,105000,3211,1299,2789,332,1103,783,388,183,1734,1479,255,1479,1088,391,2017-01-01,zipcode,Leonard
ZCTA5 75453,48,3102,49924,803,87900,2601,1232,2365,397,946,749,233,40,1564,1265,299,1265,1011,254,2017-01-01,zipcode,Lone oak
ZCTA5 75454,48,8807,89274,1196,259300,6404,1972,5150,456,1200,1886,1105,503,2602,2602,0,2602,2186,416,2017-01-01,zipcode,Melissa
ZCTA5 75455,48,28560,46490,683,101400,21106,7719,17342,4506,5172,4787,1985,892,10638,9410,1228,9410,6104,3306,2017-01-01,zipcode,Mount pleasant
ZCTA5 75457,48,6131,44349,818,127900,4833,1996,4207,474,1502,1335,624,272,3327,2360,967,2360,1665,695,2017-01-01,zipcode,Mount vernon
ZCTA5 75459,48,5207,69309,735,124500,4194,1292,3472,440,1313,1200,407,112,2108,1899,209,1899,1443,456,2017-01-01,zipcode,Howe
ZCTA5 75460,48,22226,32205,652,69400,17611,7619,15127,2811,5198,5237,1357,524,11097,9060,2037,9060,4568,4492,2017-01-01,zipcode,Paris
ZCTA5 75462,48,11691,58350,728,146100,9077,3396,7990,722,2407,2604,1515,742,4908,4457,451,4457,3278,1179,2017-01-01,zipcode,Paris
ZCTA5 75468,48,918,50992,-666666666,108000,788,523,734,94,380,197,8,55,493,392,101,392,357,35,2017-01-01,zipcode,Pattonville
ZCTA5 75469,48,350,34063,463,76100,314,204,283,34,135,84,12,18,191,141,50,141,119,22,2017-01-01,zipcode,Pecan gap
ZCTA5 75470,48,502,60385,-666666666,49700,407,170,374,65,185,80,22,22,235,188,47,188,177,11,2017-01-01,zipcode,Petty
ZCTA5 75471,48,1503,44861,-666666666,82500,1143,520,890,156,365,303,66,0,523,496,27,496,383,113,2017-01-01,zipcode,Pickton
ZCTA5 75472,48,3931,42318,737,85200,3123,1433,2742,505,1068,868,215,86,1735,1467,268,1467,1037,430,2017-01-01,zipcode,Point
ZCTA5 75473,48,3879,60604,823,93500,3092,1251,2757,293,965,1025,333,141,1548,1408,140,1408,1190,218,2017-01-01,zipcode,Powderly
ZCTA5 75474,48,15047,42670,830,81900,12317,5684,10576,2435,3983,3105,764,289,6881,5463,1418,5463,4136,1327,2017-01-01,zipcode,Quinlan
ZCTA5 75475,48,220,29318,-666666666,62600,199,107,156,45,54,34,23,0,97,90,7,90,86,4,2017-01-01,zipcode,Randolph
ZCTA5 75476,48,988,53063,753,102900,907,399,840,149,205,377,50,59,481,395,86,395,336,59,2017-01-01,zipcode,Ravenna
ZCTA5 75477,48,895,29375,473,52700,699,351,562,57,196,247,39,23,480,352,128,352,220,132,2017-01-01,zipcode,Roxton
ZCTA5 75478,48,831,40179,910,96300,629,291,584,92,172,232,68,20,398,347,51,347,266,81,2017-01-01,zipcode,Saltillo
ZCTA5 75479,48,1859,47578,650,87100,1542,721,1322,187,446,496,133,60,801,693,108,693,549,144,2017-01-01,zipcode,Savoy
ZCTA5 75480,48,1814,46979,588,256100,1540,690,1252,210,352,458,191,41,1292,593,699,593,517,76,2017-01-01,zipcode,Scroggins
ZCTA5 75481,48,346,50536,-666666666,75000,283,129,253,36,106,73,25,13,180,144,36,144,126,18,2017-01-01,zipcode,Sulphur bluff
ZCTA5 75482,48,24802,45180,754,97000,18995,7655,16356,2803,6051,4492,1994,1016,10563,9197,1366,9197,5939,3258,2017-01-01,zipcode,Sulphur springs
ZCTA5 75486,48,2552,52847,774,86500,1891,947,1595,470,427,396,234,68,1026,859,167,859,696,163,2017-01-01,zipcode,Sumner
ZCTA5 75487,48,1688,52318,568,67100,1338,552,1059,193,289,470,38,69,686,583,103,583,447,136,2017-01-01,zipcode,Talco
ZCTA5 75488,48,603,42375,807,97300,532,304,511,69,237,157,40,8,425,281,144,281,239,42,2017-01-01,zipcode,Telephone
ZCTA5 75489,48,1061,50469,810,100600,787,346,670,19,206,344,64,37,428,413,15,413,267,146,2017-01-01,zipcode,Tom bean
ZCTA5 75490,48,2399,63000,1006,113700,1811,595,1688,273,546,639,172,58,1009,886,123,886,760,126,2017-01-01,zipcode,Trenton
ZCTA5 75491,48,5646,57500,734,120300,4385,1531,3777,409,1065,1454,590,259,2299,1992,307,1992,1497,495,2017-01-01,zipcode,Whitewright
ZCTA5 75492,48,404,51324,600,114300,348,149,316,7,109,110,65,25,206,186,20,186,167,19,2017-01-01,zipcode,Windom
ZCTA5 75493,48,532,37500,592,55000,316,105,231,118,65,43,5,0,148,124,24,124,89,35,2017-01-01,zipcode,Winfield
ZCTA5 75494,48,9931,36105,706,90900,7877,4039,6663,1178,2100,2454,687,244,4771,3620,1151,3620,2837,783,2017-01-01,zipcode,Winnsboro
ZCTA5 75495,48,7797,75291,1015,164300,6102,1999,4963,343,1657,1860,890,213,3055,2778,277,2778,2198,580,2017-01-01,zipcode,Van alstyne
ZCTA5 75496,48,3436,56941,525,88800,2684,1195,2310,238,820,933,227,92,1568,1245,323,1245,968,277,2017-01-01,zipcode,Wolfe city
ZCTA5 75497,48,3585,59803,592,163000,3113,1849,2842,527,979,857,388,91,1900,1418,482,1418,1202,216,2017-01-01,zipcode,Yantis
ZCTA5 75501,48,35692,35935,670,96100,27721,12925,23882,3467,8748,8307,2347,1013,14979,12599,2380,12599,7570,5029,2017-01-01,zipcode,Texarkana
ZCTA5 75503,48,25916,59811,850,163500,20270,8417,16942,1441,4001,5381,4083,2036,11315,9572,1743,9572,6101,3471,2017-01-01,zipcode,Texarkana
ZCTA5 75550,48,838,37500,617,62500,698,422,593,97,198,169,76,53,536,358,178,358,286,72,2017-01-01,zipcode,Annona
ZCTA5 75551,48,10867,41661,661,99400,8456,3866,7613,1051,3169,1842,1111,440,5133,4252,881,4252,3356,896,2017-01-01,zipcode,Atlanta
ZCTA5 75554,48,1805,50909,531,70900,1495,686,1244,149,632,263,155,45,990,770,220,770,691,79,2017-01-01,zipcode,Avery
ZCTA5 75555,48,1765,50920,883,79500,1452,724,1214,125,605,351,94,39,902,661,241,661,602,59,2017-01-01,zipcode,Bivins
ZCTA5 75556,48,1044,41250,508,63300,800,323,692,133,342,137,58,22,442,378,64,378,304,74,2017-01-01,zipcode,Bloomburg
ZCTA5 75558,48,1902,60583,441,56300,1392,470,1085,284,392,409,0,0,608,499,109,499,434,65,2017-01-01,zipcode,Cookville
ZCTA5 75559,48,5316,45451,582,81400,4285,2222,3832,407,1601,1192,460,172,2680,2056,624,2056,1646,410,2017-01-01,zipcode,De kalb
ZCTA5 75560,48,715,30550,679,91700,641,235,557,88,271,100,69,29,443,347,96,347,300,47,2017-01-01,zipcode,Douglassville
ZCTA5 75561,48,5108,44063,699,81300,4003,1641,3528,524,1314,1296,252,142,2240,1941,299,1941,1347,594,2017-01-01,zipcode,Hooks
ZCTA5 75562,48,58,-666666666,-666666666,-666666666,58,0,58,0,0,58,0,0,89,58,31,58,58,0,2017-01-01,zipcode,Kildare
ZCTA5 75563,48,4410,38059,524,84300,3687,1838,3378,491,1599,828,327,133,2179,1827,352,1827,1301,526,2017-01-01,zipcode,Linden
ZCTA5 75565,48,193,30078,829,77500,178,120,146,30,91,25,0,0,126,91,35,91,59,32,2017-01-01,zipcode,Mc leod
ZCTA5 75566,48,604,33984,950,118900,537,328,520,59,342,78,35,6,431,307,124,307,272,35,2017-01-01,zipcode,Marietta
ZCTA5 75567,48,5191,53846,865,90400,4069,1705,3357,211,1818,940,298,90,1859,1712,147,1712,1303,409,2017-01-01,zipcode,Maud
ZCTA5 75568,48,2271,37201,542,78100,1724,695,1556,188,672,542,138,16,1369,1036,333,1036,710,326,2017-01-01,zipcode,Naples
ZCTA5 75569,48,3229,40295,922,104800,2278,1013,1793,124,779,607,200,83,1397,1211,186,1211,635,576,2017-01-01,zipcode,Nash
ZCTA5 75570,48,10969,47835,550,88800,9605,5622,8337,1543,3565,2424,571,234,3951,3197,754,3197,2238,959,2017-01-01,zipcode,New boston
ZCTA5 75571,48,3189,50588,584,105400,2419,976,2138,126,804,860,271,77,1480,1120,360,1120,939,181,2017-01-01,zipcode,Omaha
ZCTA5 75572,48,4285,47452,539,66600,3533,1544,2818,420,1316,707,213,162,1798,1600,198,1600,1214,386,2017-01-01,zipcode,Queen city
ZCTA5 75573,48,59,83125,-666666666,83300,53,34,53,0,7,6,22,18,38,24,14,24,24,0,2017-01-01,zipcode,Redwater
ZCTA5 75574,48,1716,50565,588,70300,1404,720,1203,209,480,376,107,31,877,706,171,706,580,126,2017-01-01,zipcode,Simms
ZCTA5 75601,48,16310,41882,737,128800,13004,5529,11295,1868,3247,4212,1173,795,7101,6325,776,6325,3585,2740,2017-01-01,zipcode,Longview
ZCTA5 75602,48,22112,35373,732,79200,16467,6623,12755,3518,3887,3795,1138,417,8277,7017,1260,7017,4141,2876,2017-01-01,zipcode,Longview
ZCTA5 75603,48,5913,49444,648,97400,4606,2045,4165,558,1450,1492,480,185,2831,2260,571,2260,1828,432,2017-01-01,zipcode,Longview
ZCTA5 75604,48,30565,47774,832,135500,22772,8150,19121,2831,5650,6449,2863,1328,12543,11219,1324,11219,6095,5124,2017-01-01,zipcode,Longview
ZCTA5 75605,48,30721,58526,867,177800,24506,8976,21018,1491,5201,7861,4573,1892,13249,12223,1026,12223,7508,4715,2017-01-01,zipcode,Longview
ZCTA5 75630,48,2238,42774,-666666666,94400,2065,1255,1972,207,734,705,248,78,1569,1158,411,1158,1029,129,2017-01-01,zipcode,Avinger
ZCTA5 75631,48,3137,60278,765,91600,2322,1021,2048,234,738,871,130,75,1359,1130,229,1130,894,236,2017-01-01,zipcode,Beckville
ZCTA5 75633,48,13779,48559,713,111500,10742,4773,9091,1243,2820,3471,1045,512,6243,5364,879,5364,4034,1330,2017-01-01,zipcode,Carthage
ZCTA5 75638,48,5908,39360,772,69100,4796,2251,4270,583,1639,1318,405,325,2696,2380,316,2380,1811,569,2017-01-01,zipcode,Daingerfield
ZCTA5 75639,48,2790,36680,784,76700,2322,1035,2054,413,800,643,180,18,1548,1164,384,1164,912,252,2017-01-01,zipcode,De berry
ZCTA5 75640,48,5020,46653,1132,116200,3692,1579,3200,450,1045,945,521,239,2162,1838,324,1838,1464,374,2017-01-01,zipcode,Diana
ZCTA5 75641,48,126,-666666666,-666666666,80600,109,63,103,18,33,43,9,0,68,50,18,50,41,9,2017-01-01,zipcode,Easton
ZCTA5 75642,48,27,-666666666,-666666666,-666666666,27,14,22,0,15,7,0,0,64,7,57,7,7,0,2017-01-01,zipcode,Elysian fields
ZCTA5 75643,48,2462,51875,545,83000,1898,811,1643,350,543,511,163,76,1183,861,322,861,702,159,2017-01-01,zipcode,Gary
ZCTA5 75644,48,12579,42472,705,106400,9705,4460,8417,1332,3007,2744,801,533,5119,4361,758,4361,3104,1257,2017-01-01,zipcode,Gilmer
ZCTA5 75645,48,10253,63921,938,124000,8360,3271,7078,991,2459,2199,990,439,4266,3359,907,3359,2985,374,2017-01-01,zipcode,Gilmer
ZCTA5 75647,48,12459,44509,892,115600,10186,4261,8565,1268,2628,3302,1165,202,5265,4478,787,4478,3154,1324,2017-01-01,zipcode,Gladewater
ZCTA5 75650,48,8858,59765,879,148400,6784,2596,5970,520,1734,2316,930,470,3608,3214,394,3214,2440,774,2017-01-01,zipcode,Hallsville
ZCTA5 75651,48,2192,48281,-666666666,103600,1553,496,1425,175,697,394,133,26,910,710,200,710,680,30,2017-01-01,zipcode,Harleton
ZCTA5 75652,48,17061,46197,728,132500,14095,8309,11730,2638,3787,3458,1245,602,5588,4684,904,4684,3253,1431,2017-01-01,zipcode,Henderson
ZCTA5 75654,48,12299,49375,691,115200,9140,3664,7908,1529,2114,2817,914,534,5142,4619,523,4619,3622,997,2017-01-01,zipcode,Henderson
ZCTA5 75656,48,4601,45238,523,95100,3402,1377,3001,448,1405,762,266,120,2003,1616,387,1616,1210,406,2017-01-01,zipcode,Hughes springs
ZCTA5 75657,48,8139,36349,696,88900,6566,3276,5765,887,2341,1699,577,261,4701,3371,1330,3371,2536,835,2017-01-01,zipcode,Jefferson
ZCTA5 75661,48,3043,50750,615,88400,2583,1285,2028,390,751,487,323,77,2063,1036,1027,1036,788,248,2017-01-01,zipcode,Karnack
ZCTA5 75662,48,26009,58207,774,108400,20149,7943,16765,3133,4666,6396,1840,730,10344,9001,1343,9001,6190,2811,2017-01-01,zipcode,Kilgore
ZCTA5 75667,48,1072,29028,533,97200,870,462,786,217,257,229,68,15,535,450,85,450,320,130,2017-01-01,zipcode,Laneville
ZCTA5 75668,48,2005,33068,566,92100,1652,763,1468,277,550,407,154,80,1100,833,267,833,523,310,2017-01-01,zipcode,Lone star
ZCTA5 75669,48,613,69120,-666666666,122100,540,253,463,45,113,271,34,0,343,250,93,250,229,21,2017-01-01,zipcode,Long branch
ZCTA5 75670,48,17537,33406,662,69300,13277,6042,10577,2588,4087,2552,974,376,7335,6013,1322,6013,3769,2244,2017-01-01,zipcode,Marshall
ZCTA5 75672,48,16252,49694,818,125100,12712,5738,11243,1555,3654,3591,1738,705,7097,6160,937,6160,4806,1354,2017-01-01,zipcode,Marshall
ZCTA5 75681,48,2299,38969,588,84600,1905,974,1731,279,736,402,223,91,1313,963,350,963,820,143,2017-01-01,zipcode,Mount enterprise
ZCTA5 75682,48,519,52625,-666666666,101100,428,202,372,78,129,123,20,22,206,179,27,179,172,7,2017-01-01,zipcode,New london
ZCTA5 75683,48,3811,42331,704,74900,3137,1378,2613,646,923,764,247,33,1883,1529,354,1529,1208,321,2017-01-01,zipcode,Ore city
ZCTA5 75684,48,7750,48889,766,93000,5852,2641,5145,1096,1717,1859,375,98,2865,2498,367,2498,1808,690,2017-01-01,zipcode,Overton
ZCTA5 75686,48,13047,44394,699,85800,10042,4360,8535,1443,3244,2433,1023,392,5888,4870,1018,4870,3498,1372,2017-01-01,zipcode,Pittsburg
ZCTA5 75691,48,3006,47809,727,81900,2209,1037,1958,568,647,519,191,33,1773,1162,611,1162,850,312,2017-01-01,zipcode,Tatum
ZCTA5 75692,48,5078,50625,779,100800,4088,1938,3549,600,1428,1027,269,225,2064,1643,421,1643,1322,321,2017-01-01,zipcode,Waskom
ZCTA5 75693,48,6973,59250,955,151700,5100,1519,4261,264,1520,1618,657,202,2509,2351,158,2351,1614,737,2017-01-01,zipcode,White oak
ZCTA5 75701,48,34876,49030,860,125900,27965,11047,22076,3048,4976,8187,4002,1863,14338,12304,2034,12304,6982,5322,2017-01-01,zipcode,Tyler
ZCTA5 75702,48,28270,31347,706,72500,20542,8368,16642,6141,4256,5047,955,243,9281,7891,1390,7891,4103,3788,2017-01-01,zipcode,Tyler
ZCTA5 75703,48,40868,55140,888,200000,32279,11506,27262,1715,4757,10438,6821,3531,18520,16735,1785,16735,9409,7326,2017-01-01,zipcode,Tyler
ZCTA5 75704,48,9974,38262,789,91500,7731,3520,6477,1593,2315,1990,378,201,3527,3019,508,3019,2308,711,2017-01-01,zipcode,Tyler
ZCTA5 75705,48,2591,41781,861,87400,2056,701,1826,256,694,633,164,79,1044,822,222,822,663,159,2017-01-01,zipcode,Tyler
ZCTA5 75706,48,9793,46381,819,86300,7190,2514,6234,1756,1377,2531,508,62,3557,2879,678,2879,1874,1005,2017-01-01,zipcode,Tyler
ZCTA5 75707,48,14565,59201,1006,166900,11642,4483,9145,727,2212,3321,1907,978,6003,5260,743,5260,3801,1459,2017-01-01,zipcode,Tyler
ZCTA5 75708,48,7709,37247,818,73900,5671,2368,4305,1349,1494,1094,294,74,2590,2316,274,2316,1568,748,2017-01-01,zipcode,Tyler
ZCTA5 75709,48,5046,49865,1021,113100,4323,1517,3795,352,1300,1020,571,552,2395,1984,411,1984,1176,808,2017-01-01,zipcode,Tyler
ZCTA5 75750,48,3695,48389,648,133600,3038,1164,2644,242,1032,823,387,160,1573,1424,149,1424,1163,261,2017-01-01,zipcode,Arp
ZCTA5 75751,48,16715,43804,789,95800,13145,6081,11044,2022,3479,3250,1379,914,6958,5802,1156,5802,3639,2163,2017-01-01,zipcode,Athens
ZCTA5 75752,48,7445,45649,794,119300,6052,2750,5165,771,1085,1915,910,484,3696,2810,886,2810,2402,408,2017-01-01,zipcode,Athens
ZCTA5 75754,48,6506,53004,839,146500,5359,2123,4414,710,1257,1939,359,149,2913,2437,476,2437,1929,508,2017-01-01,zipcode,Ben wheeler
ZCTA5 75755,48,5150,48675,667,122300,4130,1683,3587,617,1181,1250,425,114,2393,1973,420,1973,1339,634,2017-01-01,zipcode,Big sandy
ZCTA5 75756,48,4873,63007,845,98100,3705,1518,2950,541,846,1010,382,171,1764,1632,132,1632,1467,165,2017-01-01,zipcode,Brownsboro
ZCTA5 75757,48,12166,64289,748,198600,9500,3834,8123,807,2021,2476,2079,740,5039,4298,741,4298,3704,594,2017-01-01,zipcode,Bullard
ZCTA5 75758,48,8100,47143,751,121900,6792,3355,6187,621,2181,2003,868,514,4167,3440,727,3440,2663,777,2017-01-01,zipcode,Chandler
ZCTA5 75759,48,39,-666666666,-666666666,72500,24,15,24,4,5,13,2,0,42,16,26,16,13,3,2017-01-01,zipcode,Cuney
ZCTA5 75760,48,2429,45714,486,83100,2010,916,1820,287,789,469,235,40,1268,992,276,992,835,157,2017-01-01,zipcode,Cushing
ZCTA5 75762,48,12986,78475,1138,168700,9663,3444,8770,557,1682,3031,2461,1039,5430,4747,683,4747,3805,942,2017-01-01,zipcode,Flint
ZCTA5 75763,48,6286,50997,669,117900,5028,2381,4515,605,1531,1611,460,308,2989,2305,684,2305,1827,478,2017-01-01,zipcode,Frankston
ZCTA5 75764,48,234,59375,613,53500,183,43,163,38,46,65,12,2,86,86,0,86,71,15,2017-01-01,zipcode,Gallatin
ZCTA5 75765,48,7751,50770,824,132400,6528,3689,5583,589,1805,1900,999,290,4171,2869,1302,2869,2417,452,2017-01-01,zipcode,Hawkins
ZCTA5 75766,48,26671,42523,678,93400,20440,8481,17134,4144,5036,5170,1857,927,11335,9647,1688,9647,6773,2874,2017-01-01,zipcode,Jacksonville
ZCTA5 75770,48,3364,63235,655,99200,2810,1288,2418,272,813,992,197,144,1505,1240,265,1240,1040,200,2017-01-01,zipcode,Larue
ZCTA5 75771,48,21078,64206,923,153600,17078,7893,14701,1714,3861,5333,2821,972,8483,7392,1091,7392,5754,1638,2017-01-01,zipcode,Lindale
ZCTA5 75773,48,12927,47791,767,127000,10354,4670,9048,1159,3194,3250,943,502,5990,4746,1244,4746,3615,1131,2017-01-01,zipcode,Mineola
ZCTA5 75778,48,3167,41938,630,93800,2638,1703,2409,319,938,691,329,132,1770,1251,519,1251,1001,250,2017-01-01,zipcode,Murchison
ZCTA5 75779,48,160,41583,-666666666,82900,102,45,102,15,54,13,20,0,77,51,26,51,46,5,2017-01-01,zipcode,Neches
ZCTA5 75780,48,226,60000,471,57500,178,58,115,68,41,6,0,0,74,54,20,54,32,22,2017-01-01,zipcode,New summerfield
ZCTA5 75783,48,7559,46367,705,90000,6452,3424,5849,882,2221,1928,666,152,3524,2915,609,2915,2371,544,2017-01-01,zipcode,Quitman
ZCTA5 75784,48,829,40982,797,84400,628,392,543,144,165,158,59,17,350,282,68,282,261,21,2017-01-01,zipcode,Reklaw
ZCTA5 75785,48,10909,45057,770,86600,8751,4990,7585,1677,2609,2133,780,386,3830,3211,619,3211,2472,739,2017-01-01,zipcode,Rusk
ZCTA5 75788,48,102,-666666666,-666666666,-666666666,102,68,102,0,34,68,0,0,68,68,0,68,47,21,2017-01-01,zipcode,Sacul
ZCTA5 75789,48,7501,50127,807,152200,5817,2539,5180,691,1728,1658,839,264,3114,2754,360,2754,2262,492,2017-01-01,zipcode,Troup
ZCTA5 75790,48,4600,53690,598,111800,3322,1269,2894,339,960,1006,423,166,1746,1562,184,1562,1154,408,2017-01-01,zipcode,Van
ZCTA5 75791,48,13268,63989,956,159500,10147,3188,8448,1008,1694,3177,1679,890,5065,4606,459,4606,3533,1073,2017-01-01,zipcode,Whitehouse
ZCTA5 75792,48,2562,37515,828,85300,2168,960,1854,239,705,700,157,53,1370,1103,267,1103,711,392,2017-01-01,zipcode,Winona
ZCTA5 75801,48,15615,37842,759,103300,11901,4806,9989,1580,3246,3121,1293,749,7144,5737,1407,5737,3471,2266,2017-01-01,zipcode,Palestine
ZCTA5 75803,48,22903,42494,766,88600,19123,11465,16648,3317,6328,5172,1063,768,7172,6203,969,6203,4593,1610,2017-01-01,zipcode,Palestine
ZCTA5 75831,48,5746,50150,558,85500,4466,2051,3793,752,1360,1140,446,95,2625,1969,656,1969,1510,459,2017-01-01,zipcode,Buffalo
ZCTA5 75832,48,124,-666666666,-666666666,-666666666,124,13,101,0,30,71,0,0,25,10,15,10,0,10,2017-01-01,zipcode,Cayuga
ZCTA5 75833,48,3462,52679,653,110700,2666,1250,2376,304,946,666,339,121,2118,1264,854,1264,987,277,2017-01-01,zipcode,Centerville
ZCTA5 75835,48,10924,28810,651,85700,8706,4308,7340,1522,2307,2424,773,314,5894,4520,1374,4520,2748,1772,2017-01-01,zipcode,Crockett
ZCTA5 75838,48,638,39444,706,-666666666,520,251,466,105,199,147,5,10,375,290,85,290,235,55,2017-01-01,zipcode,Donie
ZCTA5 75839,48,5192,41512,640,71900,4097,1910,3468,564,1314,1193,256,141,2385,2018,367,2018,1678,340,2017-01-01,zipcode,Elkhart
ZCTA5 75840,48,6950,49130,713,92800,5421,2388,4653,636,1769,1538,495,215,3290,2654,636,2654,1988,666,2017-01-01,zipcode,Fairfield
ZCTA5 75844,48,6340,38712,658,73400,5090,2428,4522,644,1735,1318,694,131,3727,2615,1112,2615,2029,586,2017-01-01,zipcode,Grapeland
ZCTA5 75845,48,3208,42656,694,74000,2668,1390,2205,288,792,869,145,111,1692,1189,503,1189,904,285,2017-01-01,zipcode,Groveton
ZCTA5 75846,48,2875,33929,616,70800,2199,991,1859,463,813,476,71,36,1909,1080,829,1080,769,311,2017-01-01,zipcode,Jewett
ZCTA5 75847,48,1783,35133,529,68300,1386,806,1327,191,466,399,211,60,1169,799,370,799,604,195,2017-01-01,zipcode,Kennard
ZCTA5 75848,48,108,53000,-666666666,55000,86,45,49,14,6,25,4,0,58,52,6,52,38,14,2017-01-01,zipcode,Kirvin
ZCTA5 75849,48,85,20982,-666666666,-666666666,85,64,73,10,21,41,1,0,48,39,9,39,33,6,2017-01-01,zipcode,Latexo
ZCTA5 75850,48,959,73875,1106,167500,734,233,614,95,261,49,179,30,437,311,126,311,228,83,2017-01-01,zipcode,Leona
ZCTA5 75851,48,4834,51711,841,116000,4593,3796,4270,789,1910,1147,279,145,1372,838,534,838,705,133,2017-01-01,zipcode,Lovelady
ZCTA5 75852,48,4889,47557,855,121900,4655,4251,3646,1086,1425,934,149,52,661,395,266,395,285,110,2017-01-01,zipcode,Midway
ZCTA5 75853,48,809,29087,485,65200,666,394,612,146,170,256,24,16,457,373,84,373,310,63,2017-01-01,zipcode,Montalba
ZCTA5 75855,48,2463,37740,584,71200,2094,1256,1915,262,728,729,154,42,1555,1015,540,1015,840,175,2017-01-01,zipcode,Oakwood
ZCTA5 75856,48,121,-666666666,-666666666,-666666666,96,42,96,0,48,24,24,0,70,34,36,34,34,0,2017-01-01,zipcode,Pennington
ZCTA5 75858,48,14,-666666666,-666666666,-666666666,14,14,14,0,14,0,0,0,27,14,13,14,14,0,2017-01-01,zipcode,Ratcliff
ZCTA5 75859,48,1657,37500,913,77200,1392,828,1277,246,363,421,210,37,1259,746,513,746,632,114,2017-01-01,zipcode,Streetman
ZCTA5 75860,48,6415,48214,664,81900,5312,3173,4732,1029,1581,1760,263,99,2574,2050,524,2050,1533,517,2017-01-01,zipcode,Teague
ZCTA5 75861,48,8780,61667,935,85100,8467,7699,8030,2245,2978,2568,164,75,961,656,305,656,384,272,2017-01-01,zipcode,Tennessee colony
ZCTA5 75862,48,9863,34909,726,70300,8145,4628,7398,1451,2844,2263,603,237,6603,4240,2363,4240,3338,902,2017-01-01,zipcode,Trinity
ZCTA5 75901,48,31647,47081,787,101300,23744,9006,19669,4233,5808,6295,2269,1064,12163,10843,1320,10843,7051,3792,2017-01-01,zipcode,Lufkin
ZCTA5 75904,48,33820,47316,795,108300,26043,10491,21770,3366,6275,7591,3043,1495,14262,12437,1825,12437,7325,5112,2017-01-01,zipcode,Lufkin
ZCTA5 75925,48,4099,36915,651,99200,3083,1530,2552,325,888,978,270,91,1908,1514,394,1514,1055,459,2017-01-01,zipcode,Alto
ZCTA5 75926,48,1121,41667,745,72800,895,301,812,44,332,333,89,14,631,436,195,436,341,95,2017-01-01,zipcode,Apple springs
ZCTA5 75928,48,726,-666666666,-666666666,66600,578,302,456,18,287,136,15,0,663,263,400,263,216,47,2017-01-01,zipcode,Bon wier
ZCTA5 75929,48,1860,38177,-666666666,80800,1550,987,1381,194,527,511,102,47,1576,735,841,735,618,117,2017-01-01,zipcode,Broaddus
ZCTA5 75930,48,1909,28913,438,82000,1544,932,1311,165,696,315,87,48,1105,632,473,632,540,92,2017-01-01,zipcode,Bronson
ZCTA5 75931,48,2189,57277,765,101800,1817,861,1610,220,670,432,157,131,2134,889,1245,889,794,95,2017-01-01,zipcode,Brookeland
ZCTA5 75932,48,1833,44167,642,57700,1536,963,1391,288,595,436,44,28,1310,560,750,560,507,53,2017-01-01,zipcode,Burkeville
ZCTA5 75933,48,1139,41667,-666666666,45900,1078,616,984,202,603,160,19,0,628,492,136,492,468,24,2017-01-01,zipcode,Call
ZCTA5 75934,48,138,85491,-666666666,-666666666,104,26,104,6,51,43,0,4,132,59,73,59,31,28,2017-01-01,zipcode,Camden
ZCTA5 75935,48,13955,36062,576,74200,10230,4863,8458,2146,2714,2314,956,328,5884,4868,1016,4868,3256,1612,2017-01-01,zipcode,Center
ZCTA5 75936,48,842,43750,1639,76400,655,344,560,90,193,201,71,5,497,307,190,307,248,59,2017-01-01,zipcode,Chester
ZCTA5 75937,48,987,43750,600,92400,739,405,626,71,231,223,88,13,451,349,102,349,298,51,2017-01-01,zipcode,Chireno
ZCTA5 75938,48,2686,41886,724,92000,2243,1387,2121,297,926,650,180,68,1659,1072,587,1072,902,170,2017-01-01,zipcode,Colmesneil
ZCTA5 75939,48,4939,41394,446,68000,3671,1418,3065,707,1084,981,161,132,2289,1819,470,1819,1220,599,2017-01-01,zipcode,Corrigan
ZCTA5 75941,48,8974,45692,594,75300,7042,3393,6162,1444,1974,1997,536,211,3124,2664,460,2664,1999,665,2017-01-01,zipcode,Diboll
ZCTA5 75942,48,198,-666666666,-666666666,9999,122,37,95,0,59,36,0,0,145,46,99,46,46,0,2017-01-01,zipcode,Doucette
ZCTA5 75943,48,1349,46923,603,70500,1080,396,906,135,415,228,99,29,693,528,165,528,413,115,2017-01-01,zipcode,Douglass
ZCTA5 75944,48,1409,39306,750,83500,1175,617,1051,205,406,299,102,39,887,569,318,569,514,55,2017-01-01,zipcode,Etoile
ZCTA5 75946,48,3209,43269,804,87800,2563,1152,2246,481,792,715,192,66,1606,1272,334,1272,802,470,2017-01-01,zipcode,Garrison
ZCTA5 75948,48,6037,32682,517,106200,5155,3099,4840,708,1875,1544,509,204,5462,2279,3183,2279,2025,254,2017-01-01,zipcode,Hemphill
ZCTA5 75949,48,7376,40820,640,82100,5752,2839,5155,956,1883,1872,299,145,3574,2810,764,2810,2299,511,2017-01-01,zipcode,Huntington
ZCTA5 75951,48,16072,37002,731,92100,12318,5468,10435,1702,4303,2908,956,566,7445,5124,2321,5124,3462,1662,2017-01-01,zipcode,Jasper
ZCTA5 75954,48,3079,43750,708,66900,2559,1234,2077,420,816,504,226,111,1587,1127,460,1127,879,248,2017-01-01,zipcode,Joaquin
ZCTA5 75956,48,8533,40341,570,113300,6564,3343,5891,833,2578,1980,176,324,3629,2901,728,2901,2179,722,2017-01-01,zipcode,Kirbyville
ZCTA5 75959,48,742,47396,-666666666,110800,674,370,599,73,236,106,58,126,745,291,454,291,271,20,2017-01-01,zipcode,Milam
ZCTA5 75960,48,857,28406,-666666666,49800,659,223,591,91,99,327,60,14,461,327,134,327,303,24,2017-01-01,zipcode,Moscow
ZCTA5 75961,48,15484,36073,795,98400,12079,4024,8758,1462,2644,2718,1075,859,7258,6087,1171,6087,2946,3141,2017-01-01,zipcode,Nacogdoches
ZCTA5 75962,48,3204,-666666666,-666666666,-666666666,3204,2357,32,0,0,16,16,0,0,0,0,0,0,0,2017-01-01,zipcode,
ZCTA5 75964,48,19086,38645,681,81100,13528,4848,11537,3268,3138,3067,1264,800,7770,6617,1153,6617,3978,2639,2017-01-01,zipcode,Nacogdoches
ZCTA5 75965,48,18811,45588,768,174500,15641,6222,10824,685,2501,3103,2728,1807,8700,7697,1003,7697,3767,3930,2017-01-01,zipcode,Nacogdoches
ZCTA5 75966,48,5287,37734,530,68200,4210,2163,3448,312,1546,1004,435,151,2412,1741,671,1741,1411,330,2017-01-01,zipcode,Newton
ZCTA5 75968,48,1883,30952,713,57000,1586,904,1421,181,701,396,111,32,955,662,293,662,528,134,2017-01-01,zipcode,Pineland
ZCTA5 75969,48,3726,49393,721,103300,3153,1458,2754,456,1161,726,222,189,1564,1292,272,1292,1099,193,2017-01-01,zipcode,Pollok
ZCTA5 75972,48,6040,34208,605,82200,4881,2752,4392,1029,1711,1099,387,166,3371,2259,1112,2259,1763,496,2017-01-01,zipcode,San augustine
ZCTA5 75973,48,2470,45000,453,77400,2021,978,1795,305,776,410,221,83,1779,950,829,950,839,111,2017-01-01,zipcode,Shelbyville
ZCTA5 75974,48,3245,33672,506,67200,2543,1358,2048,631,675,448,189,105,1329,1119,210,1119,809,310,2017-01-01,zipcode,Tenaha
ZCTA5 75975,48,3727,35399,465,83300,2982,1422,2637,624,697,894,257,165,1952,1443,509,1443,1033,410,2017-01-01,zipcode,Timpson
ZCTA5 75976,48,806,31607,344,55700,609,346,542,146,192,127,75,2,355,287,68,287,160,127,2017-01-01,zipcode,Wells
ZCTA5 75977,48,471,28750,-666666666,60900,461,185,336,47,186,103,0,0,338,266,72,266,188,78,2017-01-01,zipcode,Wiergate
ZCTA5 75978,48,145,74107,-666666666,128000,111,25,97,0,44,30,6,17,62,55,7,55,49,6,2017-01-01,zipcode,Woden
ZCTA5 75979,48,12384,40079,715,75800,10259,6342,8304,1498,3435,2281,887,203,5428,3751,1677,3751,3037,714,2017-01-01,zipcode,Woodville
ZCTA5 75980,48,2500,37426,507,72000,2026,1254,1668,329,800,457,66,16,2038,994,1044,994,730,264,2017-01-01,zipcode,Zavalla
ZCTA5 76001,48,31829,83192,1368,165500,24183,7534,19834,2176,3987,6756,4632,2283,10420,9851,569,9851,8155,1696,2017-01-01,zipcode,Arlington
ZCTA5 76002,48,36569,84821,1771,163800,26128,6586,21380,2371,4696,7086,4952,2275,10050,9779,271,9779,8351,1428,2017-01-01,zipcode,Arlington
ZCTA5 76006,48,23259,43112,896,208100,18856,3904,16193,1061,3395,5192,4285,2260,13679,11488,2191,11488,2954,8534,2017-01-01,zipcode,Arlington
ZCTA5 76008,48,16334,118268,1245,287300,12095,3971,10482,285,1667,3030,3758,1742,5874,5545,329,5545,4892,653,2017-01-01,zipcode,Aledo
ZCTA5 76009,48,21049,54222,896,92900,16085,6103,13554,3325,4683,4299,930,317,7436,6850,586,6850,5400,1450,2017-01-01,zipcode,Alvarado
ZCTA5 76010,48,57813,35183,819,86100,41268,13085,31524,12905,9103,6513,2319,684,19884,17633,2251,17633,5770,11863,2017-01-01,zipcode,Arlington
ZCTA5 76011,48,22953,35681,816,122900,17663,4903,14187,3045,3456,4464,2406,816,11178,9585,1593,9585,2008,7577,2017-01-01,zipcode,Arlington
ZCTA5 76012,48,26571,58256,948,174600,21292,8110,18254,1954,3791,5590,4223,2696,11068,10146,922,10146,6350,3796,2017-01-01,zipcode,Arlington
ZCTA5 76013,48,33169,49294,855,160200,27484,9848,21760,1467,4415,7409,5510,2959,14072,13336,736,13336,6849,6487,2017-01-01,zipcode,Arlington
ZCTA5 76014,48,35235,50916,1088,99300,26516,8805,21739,4718,6835,7000,2389,797,12244,10982,1262,10982,5712,5270,2017-01-01,zipcode,Arlington
ZCTA5 76015,48,16464,53125,1088,123900,13262,4676,10997,1725,2615,3833,1660,1164,7087,6351,736,6351,3225,3126,2017-01-01,zipcode,Arlington
ZCTA5 76016,48,30808,84493,1350,170900,25273,8603,21775,1296,3921,7197,6247,3114,11939,11315,624,11315,9151,2164,2017-01-01,zipcode,Arlington
ZCTA5 76017,48,47010,69155,1052,159400,37327,11810,31194,1968,6985,11489,7203,3549,18342,17070,1272,17070,11421,5649,2017-01-01,zipcode,Arlington
ZCTA5 76018,48,31416,64406,1276,123900,23726,6341,18908,2766,4353,6968,3449,1372,9523,9386,137,9386,6556,2830,2017-01-01,zipcode,Arlington
ZCTA5 76020,48,27714,60770,845,135700,22330,8563,19667,2104,6955,6762,2737,1109,11209,10027,1182,10027,7462,2565,2017-01-01,zipcode,Azle
ZCTA5 76021,48,35903,68912,970,195700,29592,8675,26008,1358,4910,9238,7433,3069,15821,15343,478,15343,8563,6780,2017-01-01,zipcode,Bedford
ZCTA5 76022,48,13059,53650,1086,139500,10750,3305,9542,579,2197,3980,1662,1124,5960,5518,442,5518,2880,2638,2017-01-01,zipcode,Bedford
ZCTA5 76023,48,5930,54181,971,109200,4759,2014,4099,523,1236,1591,616,133,2290,2147,143,2147,1537,610,2017-01-01,zipcode,Boyd
ZCTA5 76028,48,67388,75420,1162,161600,51339,17164,44280,3816,13265,16126,7632,3441,25071,23666,1405,23666,18464,5202,2017-01-01,zipcode,Burleson
ZCTA5 76031,48,18050,53664,833,95600,13982,5903,12013,2457,4164,3614,1353,425,6758,6051,707,6051,4432,1619,2017-01-01,zipcode,Cleburne
ZCTA5 76033,48,25190,53671,885,117200,19443,7818,16054,2767,5250,4579,2471,987,10006,9356,650,9356,5665,3691,2017-01-01,zipcode,Cleburne
ZCTA5 76034,48,25557,164682,1618,456100,20078,6935,17999,278,1744,4130,6788,5059,9151,8854,297,8854,8489,365,2017-01-01,zipcode,Colleyville
ZCTA5 76035,48,1466,92386,1313,258000,1343,424,1133,125,254,328,233,193,632,579,53,579,550,29,2017-01-01,zipcode,Cresson
ZCTA5 76036,48,25736,67199,1124,158400,20018,6718,16667,1741,4885,6124,2833,1084,9324,8757,567,8757,6623,2134,2017-01-01,zipcode,Crowley
ZCTA5 76039,48,33750,64385,1124,169400,26875,6133,23776,1954,4695,8248,6139,2740,15478,14322,1156,14322,6086,8236,2017-01-01,zipcode,Euless
ZCTA5 76040,48,32301,55037,874,164100,24700,6827,21167,2820,5000,7655,3905,1787,12726,11398,1328,11398,5366,6032,2017-01-01,zipcode,Euless
ZCTA5 76041,48,331,52097,-666666666,101900,272,14,183,37,97,9,40,0,115,90,25,90,66,24,2017-01-01,zipcode,Forreston
ZCTA5 76043,48,7509,52288,849,175400,5936,2680,5104,856,1612,1788,531,317,3286,2795,491,2795,1961,834,2017-01-01,zipcode,Glen rose
ZCTA5 76044,48,3799,66341,911,169600,3101,1292,2722,331,1043,913,345,90,1673,1512,161,1512,1195,317,2017-01-01,zipcode,Godley
ZCTA5 76048,48,23702,48607,849,139200,18779,9215,16436,2324,5587,4978,2611,936,11436,9053,2383,9053,6081,2972,2017-01-01,zipcode,Granbury
ZCTA5 76049,48,27889,66851,948,189300,23110,10934,20585,1874,5456,7203,4067,1985,12739,10881,1858,10881,8951,1930,2017-01-01,zipcode,Granbury
ZCTA5 76050,48,5747,64391,820,162500,4460,1730,4028,386,1109,1770,526,237,2341,1971,370,1971,1717,254,2017-01-01,zipcode,Grandview
ZCTA5 76051,48,51685,83634,1208,273400,40881,9687,34386,2848,5807,10118,10822,4791,20878,19777,1101,19777,10953,8824,2017-01-01,zipcode,Grapevine
ZCTA5 76052,48,20779,105586,1452,265300,14503,3570,12625,693,3148,4362,3435,987,6997,6644,353,6644,5917,727,2017-01-01,zipcode,Haslet
ZCTA5 76053,48,30567,53907,968,134200,23456,6877,20163,3371,5768,6426,3167,1431,11772,10903,869,10903,6171,4732,2017-01-01,zipcode,Hurst
ZCTA5 76054,48,11948,91953,1203,204700,9684,3353,8663,385,1630,3074,2534,1040,4504,4363,141,4363,3830,533,2017-01-01,zipcode,Hurst
ZCTA5 76055,48,2643,48173,687,79700,2134,926,1934,436,581,620,194,103,1114,1005,109,1005,762,243,2017-01-01,zipcode,Itasca
ZCTA5 76058,48,18068,58792,885,111400,13468,5127,11345,2162,4244,3591,937,411,6967,6132,835,6132,4914,1218,2017-01-01,zipcode,Joshua
ZCTA5 76059,48,5211,40971,844,97800,4023,1802,2905,557,867,825,504,152,1811,1624,187,1624,651,973,2017-01-01,zipcode,Keene
ZCTA5 76060,48,7638,74384,925,173400,6122,2184,4919,794,1292,1357,1008,468,2822,2593,229,2593,2008,585,2017-01-01,zipcode,Kennedale
ZCTA5 76061,48,84,-666666666,-666666666,-666666666,84,84,84,0,84,0,0,0,39,39,0,39,39,0,2017-01-01,zipcode,Lillian
ZCTA5 76063,48,69146,93201,1244,219400,51460,15091,43456,2459,8559,14504,12571,5363,24116,22828,1288,22828,17375,5453,2017-01-01,zipcode,Mansfield
ZCTA5 76064,48,1790,64712,889,162300,1246,413,1115,111,432,397,116,59,640,559,81,559,457,102,2017-01-01,zipcode,Maypearl
ZCTA5 76065,48,34291,87365,1111,203000,25989,7917,22331,1395,5840,8442,4897,1757,11866,11505,361,11505,9473,2032,2017-01-01,zipcode,Midlothian
ZCTA5 76066,48,3193,61689,553,156700,2788,1195,2425,329,724,934,298,140,1422,1292,130,1292,1076,216,2017-01-01,zipcode,Millsap
ZCTA5 76067,48,20561,42982,753,83100,16093,6842,13294,2391,4874,4238,1331,460,8529,7062,1467,7062,4514,2548,2017-01-01,zipcode,Mineral wells
ZCTA5 76070,48,731,80709,-666666666,176500,594,249,555,0,163,135,233,24,268,261,7,261,261,0,2017-01-01,zipcode,Nemo
ZCTA5 76071,48,4069,59635,872,151400,3099,1266,2523,624,792,729,295,83,1461,1237,224,1237,942,295,2017-01-01,zipcode,Newark
ZCTA5 76073,48,6155,58225,963,134600,4578,1717,3931,583,1614,1180,382,172,2230,2021,209,2021,1771,250,2017-01-01,zipcode,Paradise
ZCTA5 76077,48,419,31042,-666666666,-666666666,394,205,313,36,42,157,40,38,164,164,0,164,155,9,2017-01-01,zipcode,Rainbow
ZCTA5 76078,48,10366,64994,1148,146200,7506,2527,6406,769,2150,2248,945,294,3445,3223,222,3223,2713,510,2017-01-01,zipcode,Rhome
ZCTA5 76082,48,18030,60768,906,135100,14125,5712,12155,1717,4303,4295,1400,440,7010,6214,796,6214,5054,1160,2017-01-01,zipcode,Springtown
ZCTA5 76084,48,8456,57455,815,102700,6686,3099,5624,1286,2128,1522,424,264,2610,2404,206,2404,2008,396,2017-01-01,zipcode,Venus
ZCTA5 76085,48,10747,69385,793,166200,8355,3002,7274,803,2265,2763,1033,410,3831,3577,254,3577,2897,680,2017-01-01,zipcode,Weatherford
ZCTA5 76086,48,22311,55777,1003,121200,17368,6614,14233,1884,4337,5458,1711,843,8976,7987,989,7987,3947,4040,2017-01-01,zipcode,Weatherford
ZCTA5 76087,48,26889,85501,1068,212800,21060,7539,18539,1555,3606,6347,4802,2229,11188,9829,1359,9829,8710,1119,2017-01-01,zipcode,Weatherford
ZCTA5 76088,48,11854,71004,964,196400,9440,3466,8042,881,2578,2939,1341,303,4564,4059,505,4059,3392,667,2017-01-01,zipcode,Weatherford
ZCTA5 76092,48,30138,207127,1434,628100,21847,7922,18925,128,1634,4141,7850,5172,9404,9154,250,9154,8510,644,2017-01-01,zipcode,Southlake
ZCTA5 76093,48,1680,52321,753,95900,1245,583,1101,200,493,296,79,33,780,637,143,637,426,211,2017-01-01,zipcode,Rio vista
ZCTA5 76102,48,9803,62664,1316,217800,8568,4303,7391,1186,1463,1691,1717,1334,3965,3537,428,3537,965,2572,2017-01-01,zipcode,Fort worth
ZCTA5 76103,48,13689,37313,772,86200,10816,4769,9134,2636,2573,2418,1027,480,5789,4860,929,4860,2960,1900,2017-01-01,zipcode,Fort worth
ZCTA5 76104,48,18199,26140,826,59200,13246,6578,11053,3742,3553,2473,835,450,7407,6234,1173,6234,2624,3610,2017-01-01,zipcode,Fort worth
ZCTA5 76105,48,21661,28843,800,57300,15330,6981,12203,5557,3594,2517,402,133,7366,6588,778,6588,3390,3198,2017-01-01,zipcode,Fort worth
ZCTA5 76106,48,39218,37550,865,75200,27612,10707,21576,10857,7160,2944,458,157,10569,9902,667,9902,5125,4777,2017-01-01,zipcode,Fort worth
ZCTA5 76107,48,30110,62137,1047,261300,25363,8753,21561,2506,3764,4659,6753,3879,15642,13796,1846,13796,6748,7048,2017-01-01,zipcode,Fort worth
ZCTA5 76108,48,41418,63333,963,126200,31670,9638,27605,3886,8404,8830,4427,2058,15843,14696,1147,14696,9711,4985,2017-01-01,zipcode,Fort worth
ZCTA5 76109,48,22448,70618,1098,389900,18798,7468,13777,465,1475,2353,4974,4510,10963,9622,1341,9622,5376,4246,2017-01-01,zipcode,Fort worth
ZCTA5 76110,48,31118,46185,840,102000,23328,8289,18722,6569,3912,3157,2865,2219,11000,9934,1066,9934,5788,4146,2017-01-01,zipcode,Fort worth
ZCTA5 76111,48,22456,42938,909,84100,16209,5467,12770,5519,3859,2121,956,315,7247,6502,745,6502,3943,2559,2017-01-01,zipcode,Fort worth
ZCTA5 76112,48,41448,40756,801,100300,31974,11761,27291,5476,7751,8810,3394,1860,18989,16242,2747,16242,7700,8542,2017-01-01,zipcode,Fort worth
ZCTA5 76114,48,25647,46096,889,86100,19532,6656,16616,4312,5561,4511,1704,528,9664,8876,788,8876,5008,3868,2017-01-01,zipcode,Fort worth
ZCTA5 76115,48,20485,37069,813,74400,14611,5143,11429,5730,2832,1757,696,414,6409,5817,592,5817,3051,2766,2017-01-01,zipcode,Fort worth
ZCTA5 76116,48,49789,49276,860,151700,39686,13488,33580,4756,7922,10269,6813,3820,24431,21331,3100,21331,8495,12836,2017-01-01,zipcode,Fort worth
ZCTA5 76117,48,31298,44040,839,93100,23641,8302,19501,5391,6708,5520,1193,689,11067,10087,980,10087,5681,4406,2017-01-01,zipcode,Haltom city
ZCTA5 76118,48,16318,64732,912,150300,12166,3508,10397,1203,2479,3776,2308,631,5841,5556,285,5556,4143,1413,2017-01-01,zipcode,Fort worth
ZCTA5 76119,48,48380,34333,830,66800,34633,15381,28340,10429,9128,6734,1394,655,15885,14180,1705,14180,7153,7027,2017-01-01,zipcode,Fort worth
ZCTA5 76120,48,19041,46404,899,144300,13860,3721,11415,1158,3388,4414,1836,619,7912,7171,741,7171,2855,4316,2017-01-01,zipcode,Fort worth
ZCTA5 76123,48,32131,84754,1443,149800,23660,6431,19471,1227,5226,6218,4440,2360,10871,10333,538,10333,7954,2379,2017-01-01,zipcode,Fort worth
ZCTA5 76126,48,21355,82063,1079,174500,16315,5310,15102,792,3390,4974,3729,2217,8918,8198,720,8198,6652,1546,2017-01-01,zipcode,Fort worth
ZCTA5 76127,48,2048,66250,1570,-666666666,1969,1584,1535,320,474,575,99,67,50,50,0,50,7,43,2017-01-01,zipcode,Naval air station jrb
ZCTA5 76129,48,2983,-666666666,-666666666,-666666666,2983,2153,47,0,0,41,6,0,0,0,0,0,0,0,2017-01-01,zipcode,Fort worth
ZCTA5 76131,48,37868,79033,1336,155400,26986,7386,22910,2541,5499,8451,4854,1565,12337,11554,783,11554,8405,3149,2017-01-01,zipcode,Fort worth
ZCTA5 76132,48,26405,52854,951,252100,21189,6799,18109,795,3567,5137,4905,3705,13424,12492,932,12492,4144,8348,2017-01-01,zipcode,Fort worth
ZCTA5 76133,48,51022,52583,1005,117600,39008,13840,33261,4633,10701,9338,5744,2845,19979,18281,1698,18281,11418,6863,2017-01-01,zipcode,Fort worth
ZCTA5 76134,48,26581,46250,989,97700,19025,6940,15746,3266,5608,4813,1349,710,8993,8407,586,8407,4957,3450,2017-01-01,zipcode,Fort worth
ZCTA5 76135,48,23845,60804,897,128400,18467,6450,15770,2726,4693,4882,2318,1151,9053,8261,792,8261,5636,2625,2017-01-01,zipcode,Fort worth
ZCTA5 76137,48,60065,70846,1200,152400,45166,11170,37019,3434,8115,13277,8833,3360,21141,20178,963,20178,12536,7642,2017-01-01,zipcode,Fort worth
ZCTA5 76140,48,30643,52752,1119,97900,22123,7635,18386,3733,6316,5656,1781,900,10548,9535,1013,9535,6679,2856,2017-01-01,zipcode,Fort worth
ZCTA5 76148,48,23819,67561,1327,111900,18301,5241,15531,1977,4863,5944,1954,793,8156,7950,206,7950,6330,1620,2017-01-01,zipcode,Fort worth
ZCTA5 76155,48,5289,51934,1039,-666666666,4372,559,3561,159,734,990,1092,586,3016,2754,262,2754,0,2754,2017-01-01,zipcode,Fort worth
ZCTA5 76164,48,16091,35401,817,64800,11819,4451,9333,5406,2273,1203,322,129,4868,4373,495,4373,2450,1923,2017-01-01,zipcode,Fort worth
ZCTA5 76177,48,7907,92990,1270,202300,5916,1030,5239,56,884,1889,1875,535,3385,3104,281,3104,1847,1257,2017-01-01,zipcode,Fort worth
ZCTA5 76179,48,57204,84548,1344,160000,42085,11390,35830,3048,8941,12321,8269,3251,19503,18335,1168,18335,13841,4494,2017-01-01,zipcode,Fort worth
ZCTA5 76180,48,36385,54851,1024,150600,28582,8869,24140,2363,5750,8745,5313,1969,15714,14503,1211,14503,6881,7622,2017-01-01,zipcode,North richland hills
ZCTA5 76182,48,31227,86386,1172,194100,24620,7106,21871,1368,4801,7822,5706,2174,11540,11234,306,11234,9118,2116,2017-01-01,zipcode,North richland hills
ZCTA5 76201,48,28038,27232,835,141100,26285,9921,11945,1328,1814,3610,3150,2043,11127,9958,1169,9958,2008,7950,2017-01-01,zipcode,Denton
ZCTA5 76205,48,20992,46347,978,199200,18222,6736,12600,1457,2947,3369,2750,2077,7880,7298,582,7298,2732,4566,2017-01-01,zipcode,Denton
ZCTA5 76207,48,14221,59276,1089,196200,11724,4647,9834,986,2008,3168,2688,984,5585,5365,220,5365,3494,1871,2017-01-01,zipcode,Denton
ZCTA5 76208,48,23463,74813,1098,219000,17775,4722,14821,1795,2826,4614,3623,1963,8687,8018,669,8018,5067,2951,2017-01-01,zipcode,Denton
ZCTA5 76209,48,24667,50810,941,144000,19432,5055,15272,2232,3357,4412,3088,2183,10139,9175,964,9175,4419,4756,2017-01-01,zipcode,Denton
ZCTA5 76210,48,44044,85890,1287,195400,34025,11181,28455,2170,5079,10728,6650,3828,15001,14436,565,14436,11047,3389,2017-01-01,zipcode,Denton
ZCTA5 76225,48,3313,67797,827,151600,2579,1069,2010,148,872,684,178,128,1291,1100,191,1100,907,193,2017-01-01,zipcode,Alvord
ZCTA5 76226,48,25037,130720,1636,370500,18678,5692,16625,565,2256,4259,6485,3060,8370,8020,350,8020,7228,792,2017-01-01,zipcode,Argyle
ZCTA5 76227,48,29616,88108,1598,190100,21658,5212,19090,1114,4183,7091,5035,1667,10048,9740,308,9740,7880,1860,2017-01-01,zipcode,Aubrey
ZCTA5 76228,48,1027,51625,675,88100,864,428,774,95,301,218,122,38,520,394,126,394,325,69,2017-01-01,zipcode,Bellevue
ZCTA5 76230,48,9538,49019,815,124800,7567,3280,6533,1026,2443,2036,617,411,4913,4030,883,4030,2856,1174,2017-01-01,zipcode,Bowie
ZCTA5 76233,48,3490,73606,966,152000,2694,878,2343,231,648,820,474,170,1487,1291,196,1291,968,323,2017-01-01,zipcode,Collinsville
ZCTA5 76234,48,15341,61645,967,161700,11795,4194,10266,1264,3088,3801,1603,510,6299,5657,642,5657,4154,1503,2017-01-01,zipcode,Decatur
ZCTA5 76238,48,400,70000,675,88800,357,169,315,12,125,135,33,10,197,166,31,166,133,33,2017-01-01,zipcode,Era
ZCTA5 76239,48,1263,66750,847,138200,1002,530,922,84,341,244,171,82,675,526,149,526,399,127,2017-01-01,zipcode,Forestburg
ZCTA5 76240,48,27123,56886,798,139400,21338,7979,18198,2758,5335,6229,2554,1322,11801,10693,1108,10693,6936,3757,2017-01-01,zipcode,Gainesville
ZCTA5 76244,48,74414,100861,1559,212100,51487,10699,44005,1418,6903,14616,15552,5516,23973,23025,948,23025,18241,4784,2017-01-01,zipcode,Keller
ZCTA5 76245,48,1869,44901,695,77900,1591,701,1432,130,467,521,255,59,1470,783,687,783,703,80,2017-01-01,zipcode,Gordonville
ZCTA5 76247,48,14009,88323,1221,165700,10431,3054,9033,906,2146,3207,2073,701,4328,4097,231,4097,3258,839,2017-01-01,zipcode,Justin
ZCTA5 76248,48,39131,123446,1295,324400,29902,9486,25516,1165,3605,6675,9259,4812,13168,12896,272,12896,10392,2504,2017-01-01,zipcode,Keller
ZCTA5 76249,48,8516,79360,1067,165900,6585,2024,5599,764,1420,1753,1237,425,3019,2766,253,2766,2154,612,2017-01-01,zipcode,Krum
ZCTA5 76250,48,1011,82143,1063,183000,798,262,720,14,149,272,188,97,408,404,4,404,364,40,2017-01-01,zipcode,Lindsay
ZCTA5 76251,48,658,43421,907,124300,540,288,508,100,222,120,57,9,358,276,82,276,210,66,2017-01-01,zipcode,Montague
ZCTA5 76252,48,2622,71500,834,172800,2042,580,1705,98,495,540,407,165,1166,988,178,988,784,204,2017-01-01,zipcode,Muenster
ZCTA5 76253,48,313,53750,475,-666666666,231,59,217,38,99,74,5,1,124,115,9,115,84,31,2017-01-01,zipcode,Myra
ZCTA5 76255,48,5369,36214,637,85800,4258,1952,3891,807,1330,1161,407,186,2988,2276,712,2276,1601,675,2017-01-01,zipcode,Nocona
ZCTA5 76258,48,6820,60075,927,151800,5386,1918,4593,718,1144,1630,776,325,2800,2417,383,2417,1973,444,2017-01-01,zipcode,Pilot point
ZCTA5 76259,48,4890,75500,1019,164200,3967,1291,3425,491,1014,1195,545,180,1717,1630,87,1630,1236,394,2017-01-01,zipcode,Ponder
ZCTA5 76261,48,310,54750,-666666666,73500,271,159,244,27,103,42,58,14,139,119,20,119,106,13,2017-01-01,zipcode,Ringgold
ZCTA5 76262,48,34422,107191,1158,319700,25671,7217,22572,916,3756,5828,8368,3704,12592,11958,634,11958,9187,2771,2017-01-01,zipcode,Roanoke
ZCTA5 76263,48,58,71071,-666666666,-666666666,55,36,55,0,35,13,7,0,45,20,25,20,13,7,2017-01-01,zipcode,Rosston
ZCTA5 76264,48,1541,60500,822,81400,1265,408,1054,29,448,502,72,3,724,600,124,600,473,127,2017-01-01,zipcode,Sadler
ZCTA5 76265,48,1806,51667,725,96600,1437,585,1211,180,442,376,143,70,964,698,266,698,575,123,2017-01-01,zipcode,Saint jo
ZCTA5 76266,48,15439,71595,1157,157800,11918,3272,10221,1001,3492,3314,1695,719,5729,5352,377,5352,3975,1377,2017-01-01,zipcode,Sanger
ZCTA5 76268,48,277,41250,-666666666,46100,220,93,187,35,85,52,9,6,110,100,10,100,83,17,2017-01-01,zipcode,Southmayd
ZCTA5 76270,48,1797,64706,437,132300,1501,738,1323,293,509,340,149,32,1003,682,321,682,493,189,2017-01-01,zipcode,Sunset
ZCTA5 76271,48,1626,70096,1007,141100,1249,433,1039,142,332,334,195,36,675,573,102,573,436,137,2017-01-01,zipcode,Tioga
ZCTA5 76272,48,4256,64074,619,128300,3258,1114,2791,425,844,1013,417,92,1696,1538,158,1538,1184,354,2017-01-01,zipcode,Valley view
ZCTA5 76273,48,9245,60739,712,139900,7503,2577,6335,906,1973,2313,756,387,3823,3477,346,3477,2435,1042,2017-01-01,zipcode,Whitesboro
ZCTA5 76301,48,15632,26659,639,49700,11751,4778,9999,2332,3515,2907,913,332,8161,6603,1558,6603,3410,3193,2017-01-01,zipcode,Wichita falls
ZCTA5 76302,48,13725,45709,738,108900,10494,4112,8627,1050,2484,3189,1383,521,5789,5179,610,5179,3015,2164,2017-01-01,zipcode,Wichita falls
ZCTA5 76305,48,4264,53611,543,111400,3466,1509,3104,347,1180,862,543,172,2147,1812,335,1812,1532,280,2017-01-01,zipcode,Wichita falls
ZCTA5 76306,48,15099,42896,772,75200,11609,4720,9828,1499,3345,3242,1196,546,7088,5881,1207,5881,3457,2424,2017-01-01,zipcode,Wichita falls
ZCTA5 76308,48,19361,48893,793,133100,15966,5341,11807,531,2945,3822,2997,1512,9085,8195,890,8195,4506,3689,2017-01-01,zipcode,Wichita falls
ZCTA5 76309,48,12939,42885,749,96100,9982,3647,8509,1253,2436,2779,1285,756,6196,5145,1051,5145,3149,1996,2017-01-01,zipcode,Wichita falls
ZCTA5 76310,48,17720,66829,773,132300,13591,4444,12374,961,3252,4007,2831,1323,7848,7182,666,7182,5156,2026,2017-01-01,zipcode,Wichita falls
ZCTA5 76311,48,8501,60208,1214,-666666666,7718,649,1799,52,244,883,470,150,667,653,14,653,5,648,2017-01-01,zipcode,Sheppard afb
ZCTA5 76351,48,1853,40417,618,77200,1372,529,1212,95,534,329,217,37,943,773,170,773,527,246,2017-01-01,zipcode,Archer city
ZCTA5 76354,48,12085,52090,858,96100,9345,3176,7987,925,2916,2638,1042,466,5380,4818,562,4818,3187,1631,2017-01-01,zipcode,Burkburnett
ZCTA5 76357,48,662,45536,725,61000,485,188,426,23,194,127,53,29,277,230,47,230,200,30,2017-01-01,zipcode,Byers
ZCTA5 76360,48,3561,36856,656,44300,3200,1504,2920,441,1275,839,293,72,2185,1639,546,1639,1246,393,2017-01-01,zipcode,Electra
ZCTA5 76363,48,433,75833,433,30000,321,151,251,32,90,83,44,2,187,132,55,132,116,16,2017-01-01,zipcode,Goree
ZCTA5 76364,48,143,58750,-666666666,65900,117,31,106,6,39,32,17,12,113,62,51,62,47,15,2017-01-01,zipcode,Harrold
ZCTA5 76365,48,4395,42386,663,81300,3615,1664,3153,346,1267,1005,374,161,2464,1785,679,1785,1437,348,2017-01-01,zipcode,Henrietta
ZCTA5 76366,48,2102,48750,623,94600,1784,769,1463,169,464,602,188,40,1106,814,292,814,626,188,2017-01-01,zipcode,Holliday
ZCTA5 76367,48,14963,52202,864,86100,12881,8394,11585,2559,4635,3176,851,364,4131,3763,368,3763,3252,511,2017-01-01,zipcode,Iowa park
ZCTA5 76370,48,252,46563,334,-666666666,232,100,204,45,88,55,6,10,175,123,52,123,101,22,2017-01-01,zipcode,Megargel
ZCTA5 76371,48,1557,45521,440,47200,1128,461,984,201,390,223,134,36,800,563,237,563,433,130,2017-01-01,zipcode,Munday
ZCTA5 76372,48,1409,40335,604,78300,1005,444,795,92,334,249,87,33,613,455,158,455,305,150,2017-01-01,zipcode,Newcastle
ZCTA5 76373,48,198,43125,-666666666,-666666666,146,55,134,22,45,34,33,0,91,64,27,64,52,12,2017-01-01,zipcode,Oklaunion
ZCTA5 76374,48,3917,46089,580,59500,3090,1308,2670,470,781,832,360,227,2026,1602,424,1602,1092,510,2017-01-01,zipcode,Olney
ZCTA5 76377,48,820,36831,563,56900,649,261,560,82,223,239,16,0,428,311,117,311,298,13,2017-01-01,zipcode,Petrolia
ZCTA5 76379,48,616,65333,640,121300,504,146,374,46,122,114,66,26,199,184,15,184,138,46,2017-01-01,zipcode,Scotland
ZCTA5 76380,48,3633,36437,472,66800,2922,1434,2590,312,830,797,531,120,2735,1659,1076,1659,1288,371,2017-01-01,zipcode,Seymour
ZCTA5 76384,48,12385,43592,634,70400,9900,3464,8379,1766,2516,2842,948,307,5957,4950,1007,4950,3210,1740,2017-01-01,zipcode,Vernon
ZCTA5 76388,48,318,48125,633,-666666666,287,111,215,30,124,33,17,11,203,137,66,137,124,13,2017-01-01,zipcode,Weinert
ZCTA5 76389,48,1387,72548,730,127500,1121,352,868,133,357,185,166,27,570,459,111,459,372,87,2017-01-01,zipcode,Windthorst
ZCTA5 76401,48,29478,46327,792,134600,24259,9394,16043,1929,3692,5480,3216,1726,12712,10121,2591,10121,5882,4239,2017-01-01,zipcode,Stephenville
ZCTA5 76402,48,831,-666666666,-666666666,-666666666,831,564,0,0,0,0,0,0,0,0,0,0,0,0,2017-01-01,zipcode,Stephenville
ZCTA5 76424,48,8794,44254,576,69700,6988,3435,5922,1405,1947,1601,632,337,4328,3077,1251,3077,2406,671,2017-01-01,zipcode,Breckenridge
ZCTA5 76426,48,12453,49408,893,132600,10030,4506,8753,1698,2935,2673,984,463,4730,4203,527,4203,2807,1396,2017-01-01,zipcode,Bridgeport
ZCTA5 76427,48,1021,34736,559,57500,803,536,597,181,273,102,39,2,471,361,110,361,240,121,2017-01-01,zipcode,Bryson
ZCTA5 76429,48,158,-666666666,-666666666,168100,158,31,158,0,29,96,17,16,227,101,126,101,72,29,2017-01-01,zipcode,Caddo
ZCTA5 76430,48,2428,43958,540,79600,1830,704,1519,245,380,445,315,134,1256,930,326,930,774,156,2017-01-01,zipcode,Albany
ZCTA5 76431,48,2931,58459,927,110800,2325,1130,2105,482,732,640,160,91,1425,1062,363,1062,912,150,2017-01-01,zipcode,Chico
ZCTA5 76432,48,1152,37692,681,107800,969,474,887,104,340,295,107,41,726,544,182,544,505,39,2017-01-01,zipcode,Blanket
ZCTA5 76433,48,1514,67656,865,249100,1292,596,1012,37,301,350,211,113,761,549,212,549,451,98,2017-01-01,zipcode,Bluff dale
ZCTA5 76435,48,453,33393,675,33300,386,190,362,65,174,85,23,15,348,187,161,187,156,31,2017-01-01,zipcode,Carbon
ZCTA5 76436,48,234,43478,-666666666,262500,156,81,139,26,15,29,40,29,116,78,38,78,78,0,2017-01-01,zipcode,Carlton
ZCTA5 76437,48,5401,36335,608,71300,4698,2344,3734,739,831,1592,340,232,3011,2093,918,2093,1590,503,2017-01-01,zipcode,Cisco
ZCTA5 76442,48,7496,43544,523,95200,5933,2835,5244,1097,1964,1266,584,333,3869,2742,1127,2742,2167,575,2017-01-01,zipcode,Comanche
ZCTA5 76443,48,2316,31676,661,69300,1744,1046,1546,187,675,452,205,27,1240,912,328,912,681,231,2017-01-01,zipcode,Cross plains
ZCTA5 76444,48,3472,38356,515,80600,2799,1304,2530,385,967,662,389,127,1913,1506,407,1506,1202,304,2017-01-01,zipcode,De leon
ZCTA5 76445,48,322,28143,-666666666,71600,275,153,253,41,94,77,7,34,268,176,92,176,166,10,2017-01-01,zipcode,Desdemona
ZCTA5 76446,48,8105,45337,599,91300,5953,2276,5108,1292,1444,1473,656,243,3833,2710,1123,2710,2027,683,2017-01-01,zipcode,Dublin
ZCTA5 76448,48,5224,31330,540,77200,4159,1984,3803,575,1494,1216,380,138,2974,1770,1204,1770,1368,402,2017-01-01,zipcode,Eastland
ZCTA5 76449,48,2427,50741,678,112200,2085,857,1912,249,639,661,285,78,2970,968,2002,968,756,212,2017-01-01,zipcode,Graford
ZCTA5 76450,48,12885,49946,679,91900,10288,4006,8944,1601,3156,2481,1215,491,6579,5120,1459,5120,4249,871,2017-01-01,zipcode,Graham
ZCTA5 76452,48,95,69297,-666666666,-666666666,61,5,49,33,5,11,0,0,27,23,4,23,11,12,2017-01-01,zipcode,Energy
ZCTA5 76453,48,1357,61875,746,177600,1224,641,1137,72,386,356,216,107,860,627,233,627,576,51,2017-01-01,zipcode,Gordon
ZCTA5 76454,48,1560,30761,348,43400,1244,729,1082,230,442,304,102,4,1027,614,413,614,481,133,2017-01-01,zipcode,Gorman
ZCTA5 76455,48,1249,50417,523,59800,897,378,738,153,310,191,79,5,587,370,217,370,259,111,2017-01-01,zipcode,Gustine
ZCTA5 76457,48,4102,42402,684,127700,3280,1285,2707,485,910,859,315,138,2126,1456,670,1456,1029,427,2017-01-01,zipcode,Hico
ZCTA5 76458,48,5913,53897,730,84700,4928,2796,4176,885,1801,985,283,222,2576,1956,620,1956,1636,320,2017-01-01,zipcode,Jacksboro
ZCTA5 76459,48,175,106458,-666666666,74400,119,28,107,24,37,42,0,4,113,84,29,84,80,4,2017-01-01,zipcode,Jermyn
ZCTA5 76460,48,419,72118,-666666666,181100,344,146,242,9,22,101,24,86,219,137,82,137,124,13,2017-01-01,zipcode,Loving
ZCTA5 76462,48,3102,78068,915,209000,2544,1089,2325,256,711,722,482,154,1388,1128,260,1128,1033,95,2017-01-01,zipcode,Lipan
ZCTA5 76463,48,380,31250,990,65000,351,182,308,62,134,84,13,15,283,169,114,169,145,24,2017-01-01,zipcode,Mingus
ZCTA5 76464,48,587,55972,630,61000,514,237,471,60,162,162,56,31,373,239,134,239,171,68,2017-01-01,zipcode,Moran
ZCTA5 76466,48,107,-666666666,-666666666,-666666666,107,57,107,0,43,50,0,14,137,57,80,57,14,43,2017-01-01,zipcode,Olden
ZCTA5 76469,48,68,31094,-666666666,60600,64,57,56,6,9,28,11,2,37,29,8,29,29,0,2017-01-01,zipcode,Putnam
ZCTA5 76470,48,3820,33241,382,56000,2974,1439,2410,305,890,940,154,121,1856,1186,670,1186,808,378,2017-01-01,zipcode,Ranger
ZCTA5 76471,48,2275,35750,622,49300,1816,946,1480,234,547,448,162,89,1235,731,504,731,575,156,2017-01-01,zipcode,Rising star
ZCTA5 76472,48,1507,49038,1019,117100,1173,507,1105,180,277,313,232,103,792,638,154,638,530,108,2017-01-01,zipcode,Santo
ZCTA5 76474,48,223,42404,-666666666,117000,212,128,203,13,69,57,35,29,139,103,36,103,95,8,2017-01-01,zipcode,Sidney
ZCTA5 76475,48,909,36696,625,87800,748,320,696,114,233,156,103,90,734,355,379,355,277,78,2017-01-01,zipcode,Strawn
ZCTA5 76476,48,2718,58393,850,166500,2137,788,1883,197,633,604,371,78,1199,1053,146,1053,841,212,2017-01-01,zipcode,Tolar
ZCTA5 76481,48,222,-666666666,-666666666,-666666666,98,50,98,0,65,33,0,0,103,48,55,48,33,15,2017-01-01,zipcode,South bend
ZCTA5 76483,48,972,36700,367,65000,847,401,747,171,249,183,129,15,682,476,206,476,334,142,2017-01-01,zipcode,Throckmorton
ZCTA5 76484,48,926,38828,710,100000,743,538,642,122,217,209,71,23,577,353,224,353,260,93,2017-01-01,zipcode,Palo pinto
ZCTA5 76486,48,1040,64167,678,74100,878,456,820,99,362,279,58,22,665,458,207,458,391,67,2017-01-01,zipcode,Perrin
ZCTA5 76487,48,2704,45991,990,144000,2118,867,1774,355,636,517,216,50,1205,907,298,907,759,148,2017-01-01,zipcode,Poolville
ZCTA5 76490,48,67,-666666666,-666666666,-666666666,67,19,62,0,33,16,7,6,71,44,27,44,40,4,2017-01-01,zipcode,Whitt
ZCTA5 76491,48,341,31458,567,54000,264,117,232,27,72,111,18,4,268,156,112,156,124,32,2017-01-01,zipcode,Woodson
ZCTA5 76501,48,17571,42361,692,110400,13599,5587,11424,2098,3656,3963,1166,541,6973,6192,781,6192,3777,2415,2017-01-01,zipcode,Temple
ZCTA5 76502,48,38571,64725,1023,154400,28800,9898,25093,1231,6356,8538,5515,3453,15646,14197,1449,14197,9449,4748,2017-01-01,zipcode,Temple
ZCTA5 76504,48,23368,38944,805,91900,18125,6996,15285,2174,5398,4831,1905,977,10333,8703,1630,8703,3408,5295,2017-01-01,zipcode,Temple
ZCTA5 76508,48,10,-666666666,-666666666,-666666666,0,0,0,0,0,0,0,0,0,0,0,0,0,0,2017-01-01,zipcode,Temple
ZCTA5 76511,48,2869,36964,611,90600,2401,1521,2030,594,826,446,132,32,836,707,129,707,533,174,2017-01-01,zipcode,Bartlett
ZCTA5 76513,48,38124,63679,816,163400,29242,10878,22799,2665,5920,7107,3983,3124,14410,12977,1433,12977,8823,4154,2017-01-01,zipcode,Belton
ZCTA5 76518,48,1408,41466,634,73000,1034,453,912,169,389,228,88,38,599,476,123,476,382,94,2017-01-01,zipcode,Buckholts
ZCTA5 76519,48,457,35125,-666666666,-666666666,270,119,212,25,97,29,43,18,243,171,72,171,146,25,2017-01-01,zipcode,Burlington
ZCTA5 76520,48,8124,40586,619,77900,6436,3404,5728,1162,2050,1668,613,235,3911,3093,818,3093,2106,987,2017-01-01,zipcode,Cameron
ZCTA5 76522,48,36581,53163,876,112500,27813,9938,23107,1429,5683,11649,2990,1356,15462,13675,1787,13675,7986,5689,2017-01-01,zipcode,Copperas cove
ZCTA5 76523,48,0,-666666666,-666666666,-666666666,0,0,0,0,0,0,0,0,0,0,0,0,0,0,2017-01-01,zipcode,Davilla
ZCTA5 76524,48,3359,58676,916,103300,2396,814,1976,287,697,758,146,88,1170,1066,104,1066,954,112,2017-01-01,zipcode,Eddy
ZCTA5 76525,48,1051,46429,652,103600,863,410,785,142,245,235,107,56,697,424,273,424,324,100,2017-01-01,zipcode,Evant
ZCTA5 76527,48,3886,55333,749,145200,2985,1163,2625,478,816,968,273,90,1483,1280,203,1280,883,397,2017-01-01,zipcode,Florence
ZCTA5 76528,48,16708,49164,722,108200,13140,5980,11706,1940,3915,4122,1211,518,6964,6003,961,6003,4240,1763,2017-01-01,zipcode,Gatesville
ZCTA5 76530,48,2190,45223,729,141900,1773,838,1584,240,694,435,170,45,892,769,123,769,577,192,2017-01-01,zipcode,Granger
ZCTA5 76531,48,4632,50500,563,111700,3900,2012,3561,555,1138,914,734,220,2604,1912,692,1912,1564,348,2017-01-01,zipcode,Hamilton
ZCTA5 76534,48,2927,53207,669,123000,2083,810,1826,263,582,662,196,123,1139,973,166,973,716,257,2017-01-01,zipcode,Holland
ZCTA5 76537,48,4921,64730,947,157800,3862,1067,3187,372,1035,1205,385,190,1768,1652,116,1652,1263,389,2017-01-01,zipcode,Jarrell
ZCTA5 76538,48,734,65625,679,110700,555,220,493,25,177,183,79,29,385,281,104,281,215,66,2017-01-01,zipcode,Jonesboro
ZCTA5 76539,48,8530,67295,932,160500,6860,3059,5868,472,1338,2850,767,441,3307,3031,276,3031,2651,380,2017-01-01,zipcode,Kempner
ZCTA5 76541,48,18447,30899,690,69100,14102,5002,11173,1951,3883,4195,875,269,10220,7495,2725,7495,2123,5372,2017-01-01,zipcode,Killeen
ZCTA5 76542,48,50324,60892,1036,147100,36693,11080,29882,2282,6774,13424,5268,2134,19214,17110,2104,17110,9605,7505,2017-01-01,zipcode,Killeen
ZCTA5 76543,48,29256,41019,807,88500,21470,6635,17272,1726,5069,8165,1649,663,13698,11307,2391,11307,4314,6993,2017-01-01,zipcode,Killeen
ZCTA5 76544,48,26637,44046,1181,-666666666,20223,3134,9484,368,2449,4960,1330,377,6418,4221,2197,4221,32,4189,2017-01-01,zipcode,Fort hood
ZCTA5 76548,48,29595,72284,898,174500,22518,8453,18780,1446,3871,6676,4555,2232,11558,9904,1654,9904,6391,3513,2017-01-01,zipcode,Harker heights
ZCTA5 76549,48,48970,51972,1035,129800,34933,10859,26944,1413,6154,13993,3915,1469,19159,16265,2894,16265,8300,7965,2017-01-01,zipcode,Killeen
ZCTA5 76550,48,12517,46678,775,128500,9884,3957,8715,1203,2698,3063,1185,566,5715,4912,803,4912,3441,1471,2017-01-01,zipcode,Lampasas
ZCTA5 76554,48,2285,48125,920,107300,1716,603,1410,204,507,528,123,48,879,747,132,747,541,206,2017-01-01,zipcode,Little river academy
ZCTA5 76556,48,1281,41961,433,85300,1031,535,898,119,413,261,72,33,662,542,120,542,432,110,2017-01-01,zipcode,Milano
ZCTA5 76557,48,4783,54821,675,112100,4095,1901,3398,399,1369,1121,329,180,2156,1759,397,1759,1470,289,2017-01-01,zipcode,Moody
ZCTA5 76559,48,5534,54359,893,126900,3641,978,3130,259,797,1500,383,191,2118,1873,245,1873,1071,802,2017-01-01,zipcode,Nolanville
ZCTA5 76561,48,1007,52250,757,83200,777,291,691,130,243,210,78,30,447,394,53,394,294,100,2017-01-01,zipcode,Oglesby
ZCTA5 76565,48,72,-666666666,-666666666,151400,72,53,60,9,41,0,0,10,44,37,7,37,37,0,2017-01-01,zipcode,Pottsville
ZCTA5 76566,48,330,-666666666,-666666666,185700,263,158,259,0,148,57,54,0,193,149,44,149,96,53,2017-01-01,zipcode,Purmela
ZCTA5 76567,48,9098,38104,669,96100,6999,3107,6075,1088,2266,1933,577,211,4172,3613,559,3613,2155,1458,2017-01-01,zipcode,Rockdale
ZCTA5 76569,48,2250,52126,929,87800,1755,732,1549,149,623,596,138,43,861,792,69,792,624,168,2017-01-01,zipcode,Rogers
ZCTA5 76570,48,2909,38819,642,65400,2237,1197,2093,298,843,513,368,71,1377,919,458,919,693,226,2017-01-01,zipcode,Rosebud
ZCTA5 76571,48,7200,87852,749,273300,5595,2071,4978,123,1010,1588,1344,913,2892,2573,319,2573,2210,363,2017-01-01,zipcode,Salado
ZCTA5 76573,48,22,-666666666,-666666666,-666666666,22,17,14,10,4,0,0,0,9,9,0,9,4,5,2017-01-01,zipcode,Schwertner
ZCTA5 76574,48,18939,50030,857,133500,15050,5304,12688,2333,4960,3482,1261,652,6742,6320,422,6320,4081,2239,2017-01-01,zipcode,Taylor
ZCTA5 76577,48,3311,51090,741,142100,2692,1011,2218,354,777,667,342,78,1466,1274,192,1274,962,312,2017-01-01,zipcode,Thorndale
ZCTA5 76578,48,1422,63611,1045,140900,1171,370,967,125,398,305,117,22,585,502,83,502,428,74,2017-01-01,zipcode,Thrall
ZCTA5 76579,48,4672,60848,924,117500,3484,1280,2998,311,1000,1250,363,74,1659,1505,154,1505,1134,371,2017-01-01,zipcode,Troy
ZCTA5 76596,48,1319,-666666666,-666666666,-666666666,1319,1319,1222,304,340,534,34,10,0,0,0,0,0,0,2017-01-01,zipcode,Gatesville
ZCTA5 76597,48,2816,-666666666,-666666666,-666666666,2816,2816,2750,852,1083,724,76,15,0,0,0,0,0,0,2017-01-01,zipcode,Gatesville
ZCTA5 76598,48,505,-666666666,-666666666,-666666666,505,505,425,90,145,179,6,5,0,0,0,0,0,0,2017-01-01,zipcode,Gatesville
ZCTA5 76599,48,2057,-666666666,-666666666,-666666666,2057,2057,1862,465,534,826,27,10,0,0,0,0,0,0,2017-01-01,zipcode,Gatesville
ZCTA5 76621,48,907,59063,717,123500,706,265,643,46,168,239,124,66,449,361,88,361,317,44,2017-01-01,zipcode,Abbott
ZCTA5 76622,48,1110,51750,767,86300,914,392,792,137,334,211,75,35,570,420,150,420,313,107,2017-01-01,zipcode,Aquilla
ZCTA5 76623,48,144,39219,-666666666,70800,91,40,83,34,20,23,2,4,49,49,0,49,43,6,2017-01-01,zipcode,Avalon
ZCTA5 76624,48,2065,61667,766,103300,1588,647,1362,192,428,477,201,64,910,726,184,726,551,175,2017-01-01,zipcode,Axtell
ZCTA5 76626,48,1312,49167,844,89100,937,407,748,65,247,319,76,41,565,472,93,472,337,135,2017-01-01,zipcode,Blooming grove
ZCTA5 76627,48,1612,58409,735,85700,1174,451,1041,169,428,317,58,69,611,554,57,554,494,60,2017-01-01,zipcode,Blum
ZCTA5 76628,48,26,14375,-666666666,-666666666,24,8,21,6,0,15,0,0,30,16,14,16,14,2,2017-01-01,zipcode,Brandon
ZCTA5 76629,48,1686,45000,525,81600,1459,680,1217,204,498,391,90,34,1190,720,470,720,475,245,2017-01-01,zipcode,Bremond
ZCTA5 76630,48,1124,66657,812,124000,898,474,741,39,281,274,107,40,503,337,166,337,288,49,2017-01-01,zipcode,Bruceville
ZCTA5 76631,48,555,64327,1034,58200,444,159,343,46,108,145,30,14,226,171,55,171,139,32,2017-01-01,zipcode,Bynum
ZCTA5 76632,48,1537,40302,1053,54900,1166,599,875,265,278,246,86,0,740,507,233,507,400,107,2017-01-01,zipcode,Chilton
ZCTA5 76633,48,5346,84342,942,184800,4123,1307,3559,192,883,1324,836,324,1983,1870,113,1870,1592,278,2017-01-01,zipcode,China spring
ZCTA5 76634,48,7068,50962,707,125900,5963,2881,5379,800,1731,1731,803,314,3913,2824,1089,2824,2153,671,2017-01-01,zipcode,Clifton
ZCTA5 76635,48,1219,31250,626,55300,951,346,792,293,214,250,15,20,577,419,158,419,311,108,2017-01-01,zipcode,Coolidge
ZCTA5 76636,48,1330,50781,654,116000,1101,435,991,146,359,332,117,37,628,555,73,555,456,99,2017-01-01,zipcode,Covington
ZCTA5 76637,48,629,44792,615,80000,495,248,425,103,115,112,53,42,397,252,145,252,204,48,2017-01-01,zipcode,Cranfills gap
ZCTA5 76638,48,3081,73952,1051,214500,2453,969,2184,109,554,807,422,292,1257,1142,115,1142,933,209,2017-01-01,zipcode,Crawford
ZCTA5 76639,48,1341,40385,524,65000,1149,503,1013,243,323,251,144,52,812,580,232,580,383,197,2017-01-01,zipcode,Dawson
ZCTA5 76640,48,2816,32957,793,77800,2325,851,2132,412,763,708,157,92,1272,1152,120,1152,788,364,2017-01-01,zipcode,Elm mott
ZCTA5 76641,48,1768,45823,599,74300,1419,627,1200,300,442,314,96,48,760,639,121,639,521,118,2017-01-01,zipcode,Frost
ZCTA5 76642,48,7025,44456,645,91000,5640,2920,4720,698,1422,1743,625,232,3182,2541,641,2541,1939,602,2017-01-01,zipcode,Groesbeck
ZCTA5 76643,48,14253,72842,1090,151500,11350,3509,9920,798,2285,3606,2165,1066,5364,5073,291,5073,3721,1352,2017-01-01,zipcode,Hewitt
ZCTA5 76645,48,10477,41845,718,83700,8188,3367,6582,1491,1984,2031,662,414,4623,3713,910,3713,2294,1419,2017-01-01,zipcode,Hillsboro
ZCTA5 76648,48,2762,45417,685,90600,2211,1028,1917,305,623,681,214,94,1166,1023,143,1023,760,263,2017-01-01,zipcode,Hubbard
ZCTA5 76649,48,701,43125,775,92500,584,302,514,68,225,114,82,25,404,290,114,290,262,28,2017-01-01,zipcode,Iredell
ZCTA5 76650,48,172,51607,-666666666,65000,130,50,115,25,41,30,12,7,127,71,56,71,56,15,2017-01-01,zipcode,Irene
ZCTA5 76651,48,3232,45234,790,98200,2599,942,2262,352,831,830,189,60,1468,1252,216,1252,864,388,2017-01-01,zipcode,Italy
ZCTA5 76652,48,1210,42841,830,83800,960,536,875,134,427,206,71,37,605,457,148,457,396,61,2017-01-01,zipcode,Kopperl
ZCTA5 76653,48,902,40875,738,90000,725,423,692,116,288,241,14,33,527,349,178,349,282,67,2017-01-01,zipcode,Kosse
ZCTA5 76654,48,178,43000,-666666666,62100,131,53,122,25,46,40,8,3,75,66,9,66,61,5,2017-01-01,zipcode,Leroy
ZCTA5 76655,48,8530,83098,942,168500,6741,2318,5854,269,1690,2273,1178,444,3214,3005,209,3005,2429,576,2017-01-01,zipcode,Lorena
ZCTA5 76656,48,2440,50417,475,97900,1848,753,1507,276,552,463,196,20,955,741,214,741,563,178,2017-01-01,zipcode,Lott
ZCTA5 76657,48,9663,62366,835,198100,7450,2284,6308,572,1621,2197,1092,826,3802,3448,354,3448,2414,1034,2017-01-01,zipcode,Mc gregor
ZCTA5 76660,48,530,46750,638,82300,417,122,343,54,160,102,19,8,239,181,58,181,147,34,2017-01-01,zipcode,Malone
ZCTA5 76661,48,8108,28934,461,52600,6862,4485,5831,1767,2290,1376,272,126,3489,2409,1080,2409,1513,896,2017-01-01,zipcode,Marlin
ZCTA5 76664,48,3494,44819,801,84100,2657,1192,2150,269,830,609,307,135,1485,1190,295,1190,879,311,2017-01-01,zipcode,Mart
ZCTA5 76665,48,2399,45690,595,100000,1890,890,1646,305,484,581,135,141,1250,940,310,940,638,302,2017-01-01,zipcode,Meridian
ZCTA5 76666,48,259,41667,742,83000,203,110,192,20,72,67,28,5,138,112,26,112,96,16,2017-01-01,zipcode,Mertens
ZCTA5 76667,48,11261,40760,701,85200,8853,3701,7520,1682,2533,2295,713,297,4550,3657,893,3657,2680,977,2017-01-01,zipcode,Mexia
ZCTA5 76670,48,1524,45833,958,101800,1155,472,951,196,340,289,92,34,591,480,111,480,363,117,2017-01-01,zipcode,Milford
ZCTA5 76671,48,1792,41047,735,91300,1439,662,1233,252,529,302,96,54,1199,753,446,753,561,192,2017-01-01,zipcode,Morgan
ZCTA5 76673,48,1620,45439,598,80000,1003,410,878,209,332,249,73,15,586,438,148,438,330,108,2017-01-01,zipcode,Mount calm
ZCTA5 76676,48,268,58214,-666666666,84200,202,60,176,41,47,60,25,3,153,98,55,98,83,15,2017-01-01,zipcode,Penelope
ZCTA5 76678,48,362,30313,803,-666666666,242,114,229,59,56,80,16,18,121,99,22,99,53,46,2017-01-01,zipcode,Prairie hill
ZCTA5 76679,48,1380,43684,615,86600,1064,433,949,164,336,288,131,30,662,528,134,528,433,95,2017-01-01,zipcode,Purdon
ZCTA5 76680,48,302,-666666666,-666666666,66400,264,161,249,47,66,98,38,0,158,122,36,122,122,0,2017-01-01,zipcode,Reagan
ZCTA5 76681,48,676,40288,932,-666666666,502,247,456,100,172,149,21,14,400,273,127,273,191,82,2017-01-01,zipcode,Richland
ZCTA5 76682,48,2702,51861,831,89900,2143,937,1850,225,728,564,260,73,1178,963,215,963,721,242,2017-01-01,zipcode,Riesel
ZCTA5 76685,48,17,-666666666,-666666666,-666666666,17,0,17,0,0,0,17,0,44,17,27,17,0,17,2017-01-01,zipcode,Satin
ZCTA5 76686,48,209,56250,780,76100,155,44,150,19,50,55,23,3,116,89,27,89,63,26,2017-01-01,zipcode,Tehuacana
ZCTA5 76687,48,1934,39214,668,109100,1634,958,1497,202,657,500,99,39,1143,714,429,714,518,196,2017-01-01,zipcode,Thornton
ZCTA5 76689,48,3715,61646,796,122800,2783,1054,2444,268,808,706,428,234,1706,1298,408,1298,1064,234,2017-01-01,zipcode,Valley mills
ZCTA5 76690,48,984,37279,759,75000,749,272,624,146,230,172,53,23,436,343,93,343,241,102,2017-01-01,zipcode,Walnut springs
ZCTA5 76691,48,6524,57056,752,106400,5161,1824,4380,478,1491,1596,580,235,2831,2395,436,2395,1740,655,2017-01-01,zipcode,West
ZCTA5 76692,48,10577,45380,661,101900,8817,4116,7752,1305,2831,2242,946,428,5536,3890,1646,3890,3023,867,2017-01-01,zipcode,Whitney
ZCTA5 76693,48,1604,36696,683,83800,1207,457,907,153,337,304,93,20,796,547,249,547,309,238,2017-01-01,zipcode,Wortham
ZCTA5 76701,48,1906,31278,943,306300,1744,702,1144,164,346,329,190,115,831,656,175,656,114,542,2017-01-01,zipcode,Waco
ZCTA5 76704,48,7825,22508,667,80000,5928,3164,4315,750,1718,1509,221,117,3713,3075,638,3075,1118,1957,2017-01-01,zipcode,Waco
ZCTA5 76705,48,30546,41213,729,88400,23473,9981,18168,4555,5297,6390,1322,604,11699,10101,1598,10101,5635,4466,2017-01-01,zipcode,Waco
ZCTA5 76706,48,36680,30461,815,106400,29898,13113,15919,3169,4815,4936,1803,1196,15040,13084,1956,13084,5173,7911,2017-01-01,zipcode,Waco
ZCTA5 76707,48,16256,30148,766,64900,11511,4519,9065,2988,2684,2287,677,429,6008,5195,813,5195,2344,2851,2017-01-01,zipcode,Waco
ZCTA5 76708,48,27160,45719,829,121900,20475,6522,16733,3290,4674,5524,2168,1077,10463,9726,737,9726,5831,3895,2017-01-01,zipcode,Waco
ZCTA5 76710,48,24415,44554,742,122800,19135,6561,16446,1669,4778,5456,2929,1614,11465,10422,1043,10422,5121,5301,2017-01-01,zipcode,Waco
ZCTA5 76711,48,9671,37555,942,62500,7440,2554,5883,2072,1568,1541,508,194,3644,3206,438,3206,1707,1499,2017-01-01,zipcode,Waco
ZCTA5 76712,48,25350,70056,928,185900,20016,6801,17157,1080,3014,5641,4594,2828,10470,9873,597,9873,6754,3119,2017-01-01,zipcode,Woodway
ZCTA5 76798,48,1599,-666666666,-666666666,-666666666,1599,1352,5,0,0,5,0,0,0,0,0,0,0,0,2017-01-01,zipcode,Waco
ZCTA5 76801,48,24918,40555,705,92000,19719,9341,16568,2578,6430,4659,2001,900,11998,9029,2969,9029,6181,2848,2017-01-01,zipcode,Brownwood
ZCTA5 76802,48,5010,52355,729,112500,4047,1839,3369,406,1213,1110,477,163,1959,1709,250,1709,1287,422,2017-01-01,zipcode,Early
ZCTA5 76820,48,107,86429,-666666666,196300,107,56,107,0,35,28,35,9,185,54,131,54,46,8,2017-01-01,zipcode,Art
ZCTA5 76821,48,4595,36365,585,78900,3768,1914,3348,632,1315,804,522,75,2441,1751,690,1751,1310,441,2017-01-01,zipcode,Ballinger
ZCTA5 76823,48,3348,47632,562,81500,2641,1157,2406,308,923,823,229,123,1551,1220,331,1220,960,260,2017-01-01,zipcode,Bangs
ZCTA5 76824,48,15,-666666666,-666666666,-666666666,15,15,15,0,0,15,0,0,15,15,0,15,0,15,2017-01-01,zipcode,Bend
ZCTA5 76825,48,6891,43750,729,80300,5427,2162,4840,1120,1597,1458,492,173,3324,2582,742,2582,1907,675,2017-01-01,zipcode,Brady
ZCTA5 76827,48,402,48125,-666666666,108600,333,176,310,67,117,67,44,15,239,167,72,167,139,28,2017-01-01,zipcode,Brookesmith
ZCTA5 76828,48,211,51406,-666666666,66900,182,88,176,15,71,77,5,8,230,85,145,85,78,7,2017-01-01,zipcode,Burkett
ZCTA5 76831,48,39,-666666666,-666666666,-666666666,39,18,39,0,21,18,0,0,75,18,57,18,18,0,2017-01-01,zipcode,Castell
ZCTA5 76832,48,691,60781,1081,159100,534,216,501,103,199,135,56,8,347,225,122,225,167,58,2017-01-01,zipcode,Cherokee
ZCTA5 76834,48,5349,41250,696,63200,4277,1940,3805,779,1373,1094,396,163,3176,2176,1000,2176,1540,636,2017-01-01,zipcode,Coleman
ZCTA5 76836,48,9,-666666666,-666666666,-666666666,9,0,9,9,0,0,0,0,24,9,15,9,9,0,2017-01-01,zipcode,Doole
ZCTA5 76837,48,2901,39792,693,86700,2543,1957,2115,1039,536,334,131,75,841,488,353,488,314,174,2017-01-01,zipcode,Eden
ZCTA5 76841,48,25,-666666666,-666666666,-666666666,25,0,25,9,8,8,0,0,69,17,52,17,17,0,2017-01-01,zipcode,Fort mc kavett
ZCTA5 76842,48,213,41578,-666666666,-666666666,202,142,191,2,26,113,35,15,218,111,107,111,96,15,2017-01-01,zipcode,Fredonia
ZCTA5 76844,48,3719,48000,569,104300,2965,1205,2522,450,632,877,351,212,2074,1374,700,1374,1147,227,2017-01-01,zipcode,Goldthwaite
ZCTA5 76845,48,154,-666666666,-666666666,-666666666,143,89,123,21,56,40,0,6,200,63,137,63,48,15,2017-01-01,zipcode,Gouldbusk
ZCTA5 76848,48,70,27500,-666666666,-666666666,70,51,70,0,39,31,0,0,82,40,42,40,40,0,2017-01-01,zipcode,Hext
ZCTA5 76849,48,3884,40190,601,104000,3176,1252,2838,482,993,869,307,187,2611,1628,983,1628,1175,453,2017-01-01,zipcode,Junction
ZCTA5 76852,48,191,55000,670,120300,177,78,165,27,50,59,20,9,204,90,114,90,71,19,2017-01-01,zipcode,Lohn
ZCTA5 76853,48,1575,47188,668,88500,1160,519,1070,86,342,366,209,67,869,570,299,570,441,129,2017-01-01,zipcode,Lometa
ZCTA5 76854,48,238,40136,-666666666,-666666666,238,155,220,64,56,87,13,0,416,157,259,157,137,20,2017-01-01,zipcode,London
ZCTA5 76856,48,3684,39230,797,153900,3077,1042,2669,321,935,900,341,172,2154,1443,711,1443,1037,406,2017-01-01,zipcode,Mason
ZCTA5 76857,48,1733,49196,656,78700,1497,797,1364,121,427,485,223,108,1616,765,851,765,645,120,2017-01-01,zipcode,May
ZCTA5 76858,48,335,28594,-666666666,27700,250,143,233,56,49,81,27,20,230,122,108,122,107,15,2017-01-01,zipcode,Melvin
ZCTA5 76859,48,1967,38750,604,56800,1606,612,1482,334,503,400,157,88,1533,873,660,873,560,313,2017-01-01,zipcode,Menard
ZCTA5 76861,48,1992,68438,698,101600,1522,558,1265,215,452,336,191,71,860,641,219,641,490,151,2017-01-01,zipcode,Miles
ZCTA5 76862,48,186,65000,-666666666,193800,169,80,152,10,76,42,18,6,295,78,217,78,47,31,2017-01-01,zipcode,Millersview
ZCTA5 76864,48,700,38125,538,142500,539,329,487,74,195,99,84,35,500,271,229,271,234,37,2017-01-01,zipcode,Mullin
ZCTA5 76865,48,107,-666666666,-666666666,142500,105,76,95,30,37,21,0,7,112,44,68,44,44,0,2017-01-01,zipcode,Norton
ZCTA5 76866,48,696,50104,525,163800,589,271,526,69,174,193,85,5,435,194,241,194,172,22,2017-01-01,zipcode,Paint rock
ZCTA5 76869,48,122,68250,-666666666,166700,108,35,108,10,67,16,5,10,131,34,97,34,24,10,2017-01-01,zipcode,Pontotoc
ZCTA5 76870,48,297,42500,506,96300,197,109,166,16,62,58,24,6,153,94,59,94,74,20,2017-01-01,zipcode,Priddy
ZCTA5 76871,48,723,46611,613,65600,612,233,581,76,181,216,71,37,595,312,283,312,216,96,2017-01-01,zipcode,Richland springs
ZCTA5 76872,48,851,59083,700,150000,742,332,661,34,176,269,123,59,585,363,222,363,306,57,2017-01-01,zipcode,Rochelle
ZCTA5 76873,48,41,27708,-666666666,-666666666,41,33,41,5,26,4,0,6,67,25,42,25,19,6,2017-01-01,zipcode,Rockwood
ZCTA5 76874,48,40,-666666666,-666666666,-666666666,40,0,22,0,0,0,22,0,175,18,157,18,0,18,2017-01-01,zipcode,Roosevelt
ZCTA5 76875,48,551,45417,919,115600,445,158,414,24,186,128,57,19,269,224,45,224,187,37,2017-01-01,zipcode,Rowena
ZCTA5 76877,48,4187,30313,673,100200,3439,1694,2883,915,775,760,311,122,2049,1471,578,1471,966,505,2017-01-01,zipcode,San saba
ZCTA5 76878,48,1920,37500,615,66300,1571,778,1383,237,531,439,156,20,1062,762,300,762,465,297,2017-01-01,zipcode,Santa anna
ZCTA5 76882,48,259,36667,-666666666,114800,234,172,232,3,104,72,41,12,201,120,81,120,95,25,2017-01-01,zipcode,Talpa
ZCTA5 76884,48,148,49583,-666666666,31900,118,79,93,0,44,23,15,11,73,50,23,50,45,5,2017-01-01,zipcode,Valera
ZCTA5 76885,48,184,-666666666,-666666666,-666666666,161,46,108,0,45,41,8,14,176,65,111,65,52,13,2017-01-01,zipcode,Valley spring
ZCTA5 76887,48,95,33452,-666666666,-666666666,95,79,95,0,62,13,20,0,104,58,46,58,58,0,2017-01-01,zipcode,Voca
ZCTA5 76888,48,137,39250,-666666666,151600,111,77,105,18,41,43,0,3,202,71,131,71,58,13,2017-01-01,zipcode,Voss
ZCTA5 76890,48,1015,57321,-666666666,111200,793,384,673,101,271,209,75,17,477,321,156,321,257,64,2017-01-01,zipcode,Zephyr
ZCTA5 76901,48,29879,51700,907,103200,23487,7954,20279,3047,6432,6474,2751,1575,12662,11405,1257,11405,7586,3819,2017-01-01,zipcode,San angelo
ZCTA5 76903,48,32103,36215,747,78500,25411,10539,21495,6103,7178,5669,1852,693,13803,11940,1863,11940,7048,4892,2017-01-01,zipcode,San angelo
ZCTA5 76904,48,34828,59993,846,184700,27866,10255,21678,968,4741,7554,5968,2447,14997,13816,1181,13816,8207,5609,2017-01-01,zipcode,San angelo
ZCTA5 76905,48,13129,60086,969,120500,9274,3045,7842,1323,2291,2613,1075,540,4787,4410,377,4410,3008,1402,2017-01-01,zipcode,San angelo
ZCTA5 76908,48,2652,-666666666,-666666666,-666666666,2652,225,316,0,117,92,89,18,0,0,0,0,0,0,2017-01-01,zipcode,Goodfellow afb
ZCTA5 76930,48,110,74792,-666666666,81500,105,29,105,15,62,24,4,0,59,49,10,49,30,19,2017-01-01,zipcode,Barnhart
ZCTA5 76932,48,3744,59904,763,89300,2794,953,2324,696,757,640,179,52,1323,1168,155,1168,808,360,2017-01-01,zipcode,Big lake
ZCTA5 76933,48,1344,38077,608,85800,1045,429,941,191,333,240,135,42,795,614,181,614,442,172,2017-01-01,zipcode,Bronte
ZCTA5 76934,48,1308,49671,725,123800,1030,480,827,125,293,232,97,80,484,419,65,419,346,73,2017-01-01,zipcode,Carlsbad
ZCTA5 76935,48,1736,73810,-666666666,170800,1430,719,1298,84,330,542,241,101,667,616,51,616,585,31,2017-01-01,zipcode,Christoval
ZCTA5 76936,48,3122,63432,483,72900,2340,766,1963,505,415,645,305,93,1476,1102,374,1102,847,255,2017-01-01,zipcode,Eldorado
ZCTA5 76937,48,54,2499,-666666666,-666666666,54,32,47,0,0,18,29,0,29,29,0,29,29,0,2017-01-01,zipcode,Eola
ZCTA5 76939,48,8,-666666666,-666666666,-666666666,8,0,8,0,0,4,0,4,12,4,8,4,4,0,2017-01-01,zipcode,Knickerbocker
ZCTA5 76940,48,164,42350,-666666666,-666666666,162,46,158,14,4,102,29,9,99,75,24,75,61,14,2017-01-01,zipcode,Mereta
ZCTA5 76941,48,1430,58125,833,151700,1087,435,918,47,365,359,91,56,765,568,197,568,467,101,2017-01-01,zipcode,Mertzon
ZCTA5 76943,48,3693,51712,526,83100,2893,1202,2404,605,851,736,159,53,1809,1379,430,1379,1007,372,2017-01-01,zipcode,Ozona
ZCTA5 76945,48,1647,44034,538,74200,1387,591,1244,151,453,340,182,118,1379,799,580,799,557,242,2017-01-01,zipcode,Robert lee
ZCTA5 76949,48,16,-666666666,-666666666,-666666666,15,9,15,2,8,5,0,0,10,5,5,5,5,0,2017-01-01,zipcode,Silver
ZCTA5 76950,48,3915,60742,633,95200,3074,1124,2694,619,793,754,460,68,2162,1586,576,1586,1077,509,2017-01-01,zipcode,Sonora
ZCTA5 76951,48,1139,50000,919,66100,858,329,779,110,351,151,103,64,609,462,147,462,393,69,2017-01-01,zipcode,Sterling city
ZCTA5 76953,48,38,103984,-666666666,-666666666,38,7,18,2,7,3,6,0,58,25,33,25,3,22,2017-01-01,zipcode,Tennyson
ZCTA5 76955,48,148,187250,-666666666,549100,131,41,118,0,0,62,46,10,58,58,0,58,45,13,2017-01-01,zipcode,Vancourt
ZCTA5 76957,48,0,-666666666,-666666666,-666666666,0,0,0,0,0,0,0,0,0,0,0,0,0,0,2017-01-01,zipcode,Wall
ZCTA5 76958,48,158,50972,-666666666,177100,144,96,118,0,51,35,13,19,90,62,28,62,52,10,2017-01-01,zipcode,Water valley
ZCTA5 77002,48,12370,72306,1418,233000,12317,8595,9848,1824,2983,2122,1545,1374,4237,3295,942,3295,833,2462,2017-01-01,zipcode,Houston
ZCTA5 77003,48,9646,59575,975,272800,8171,1856,7200,1621,1133,1683,1629,1134,5292,4470,822,4470,2014,2456,2017-01-01,zipcode,Houston
ZCTA5 77004,48,37642,48592,957,247300,33378,13196,21770,2558,3914,5113,5224,4961,16549,13340,3209,13340,4595,8745,2017-01-01,zipcode,Houston
ZCTA5 77005,48,28233,180758,1648,940800,22293,8505,17816,297,504,2204,6171,8640,10920,10114,806,10114,7384,2730,2017-01-01,zipcode,Houston
ZCTA5 77006,48,21945,82878,1223,430600,20284,3483,17666,508,1206,3692,6252,6008,14197,12493,1704,12493,4419,8074,2017-01-01,zipcode,Houston
ZCTA5 77007,48,35822,121458,1587,398200,32256,4751,29225,1328,1887,4159,12489,9362,20887,19082,1805,19082,9655,9427,2017-01-01,zipcode,Houston
ZCTA5 77008,48,34491,97690,1203,396300,29107,5569,27186,1896,3234,5222,9900,6934,17313,16116,1197,16116,9501,6615,2017-01-01,zipcode,Houston
ZCTA5 77009,48,37751,49383,877,250800,29989,9427,25582,7629,5008,5375,4297,3273,16284,14176,2108,14176,7589,6587,2017-01-01,zipcode,Houston
ZCTA5 77010,48,915,250001,3190,-666666666,873,212,842,11,1,81,328,421,862,589,273,589,78,511,2017-01-01,zipcode,Houston
ZCTA5 77011,48,18598,30665,644,85700,13917,5360,11488,5719,2890,2127,593,159,6861,5619,1242,5619,2561,3058,2017-01-01,zipcode,Houston
ZCTA5 77012,48,20085,36537,715,77400,15016,5064,12839,6846,3330,1983,611,69,7109,6084,1025,6084,2512,3572,2017-01-01,zipcode,Houston
ZCTA5 77013,48,20790,39513,850,85500,15539,6244,12428,5192,3429,2924,662,221,6541,6107,434,6107,2183,3924,2017-01-01,zipcode,Houston
ZCTA5 77014,48,35729,45596,906,132700,26280,7765,21287,4996,4926,7691,2676,998,12694,11606,1088,11606,4908,6698,2017-01-01,zipcode,Houston
ZCTA5 77015,48,57258,45917,859,95800,40947,13731,32187,10829,8917,8599,2491,1351,19073,17509,1564,17509,8975,8534,2017-01-01,zipcode,Houston
ZCTA5 77016,48,29597,32302,803,60600,23221,10548,19074,5363,7269,4672,1036,734,11094,9771,1323,9771,6201,3570,2017-01-01,zipcode,Houston
ZCTA5 77017,48,32556,44286,800,90300,24919,9556,20179,8044,5988,4465,1093,589,11260,9999,1261,9999,5364,4635,2017-01-01,zipcode,Houston
ZCTA5 77018,48,28073,81565,848,342200,21780,7336,19797,2972,3680,3800,5614,3731,12146,10889,1257,10889,7345,3544,2017-01-01,zipcode,Houston
ZCTA5 77019,48,21572,112243,1586,510000,19198,4970,16897,614,1022,2629,6877,5755,11883,10835,1048,10835,5695,5140,2017-01-01,zipcode,Houston
ZCTA5 77020,48,25898,27587,674,77700,19294,7887,15799,6721,4527,3171,966,414,9789,8502,1287,8502,3787,4715,2017-01-01,zipcode,Houston
ZCTA5 77021,48,26654,35126,864,89900,21206,8321,17199,2767,4934,5085,2595,1818,12375,10770,1605,10770,4245,6525,2017-01-01,zipcode,Houston
ZCTA5 77022,48,27364,30164,709,85900,20569,8399,17601,7795,5189,3464,863,290,10707,9228,1479,9228,4140,5088,2017-01-01,zipcode,Houston
ZCTA5 77023,48,28528,37462,760,112800,21821,7296,17903,6262,4797,4124,1938,782,10898,9592,1306,9592,4345,5247,2017-01-01,zipcode,Houston
ZCTA5 77024,48,38110,118561,1467,898100,29714,12185,26651,826,2025,3594,10763,9443,16770,15252,1518,15252,10241,5011,2017-01-01,zipcode,Houston
ZCTA5 77025,48,28922,71990,1186,405900,23673,7395,20835,1421,2086,3150,6021,8157,14263,12959,1304,12959,5519,7440,2017-01-01,zipcode,Houston
ZCTA5 77026,48,22799,26644,664,62100,17736,8227,15203,5704,4909,3456,877,257,9707,8063,1644,8063,3368,4695,2017-01-01,zipcode,Houston
ZCTA5 77027,48,16012,91296,1448,679000,14318,3275,12763,303,539,2255,5348,4318,10763,8915,1848,8915,3136,5779,2017-01-01,zipcode,Houston
ZCTA5 77028,48,15725,30233,805,56200,12183,5232,10210,2602,4238,2580,516,274,6728,5526,1202,5526,2991,2535,2017-01-01,zipcode,Houston
ZCTA5 77029,48,17894,32200,743,68500,13097,5295,11042,4663,2923,2628,542,286,6555,5664,891,5664,3326,2338,2017-01-01,zipcode,Houston
ZCTA5 77030,48,10813,75290,1436,471100,8875,2859,7421,166,286,714,2418,3837,5859,4994,865,4994,2137,2857,2017-01-01,zipcode,Houston
ZCTA5 77031,48,18052,44459,822,135900,13735,3647,10730,2736,2597,2586,2077,734,6605,5992,613,5992,2733,3259,2017-01-01,zipcode,Houston
ZCTA5 77032,48,14443,30451,860,82500,9639,3909,7088,2681,2112,1695,370,230,4630,4292,338,4292,1568,2724,2017-01-01,zipcode,Houston
ZCTA5 77033,48,29692,33750,883,62400,22523,10262,18476,5799,6687,4639,1073,278,10416,9139,1277,9139,5562,3577,2017-01-01,zipcode,Houston
ZCTA5 77034,48,40183,47252,880,109400,28726,8475,22324,6219,6721,6410,2184,790,13835,12363,1472,12363,5434,6929,2017-01-01,zipcode,Houston
ZCTA5 77035,48,38324,44546,810,196400,29072,8131,25135,6820,5171,6363,3909,2872,16047,14144,1903,14144,5827,8317,2017-01-01,zipcode,Houston
ZCTA5 77036,48,76605,29744,749,129600,56116,17233,45725,17048,13161,8659,4751,2106,31098,26852,4246,26852,5191,21661,2017-01-01,zipcode,Houston
ZCTA5 77037,48,20038,41491,928,94400,14447,4778,11893,6660,3522,1383,268,60,5766,5441,325,5441,3806,1635,2017-01-01,zipcode,Houston
ZCTA5 77038,48,30653,41347,907,105300,21069,6903,17169,7609,4690,3486,913,471,8907,8474,433,8474,4430,4044,2017-01-01,zipcode,Houston
ZCTA5 77039,48,27972,34608,846,89200,19887,8100,15450,8011,4413,2491,417,118,8301,7483,818,7483,4598,2885,2017-01-01,zipcode,Houston
ZCTA5 77040,48,48273,55438,968,150200,37788,11268,31793,6801,7671,8539,6101,2681,18664,17652,1012,17652,9634,8018,2017-01-01,zipcode,Houston
ZCTA5 77041,48,35372,79503,1314,159700,27829,9000,23360,3894,5416,6077,5056,2917,12256,11649,607,11649,8770,2879,2017-01-01,zipcode,Houston
ZCTA5 77042,48,42098,47297,990,239500,33410,8485,28573,3252,4993,7865,8133,4330,21978,19165,2813,19165,4946,14219,2017-01-01,zipcode,Houston
ZCTA5 77043,48,25838,60043,974,194700,20685,6074,17276,3620,3724,3936,4186,1810,10105,8963,1142,8963,5210,3753,2017-01-01,zipcode,Houston
ZCTA5 77044,48,42665,76387,1180,173400,29349,8423,25461,4186,6671,7110,5085,2409,13627,12594,1033,12594,9315,3279,2017-01-01,zipcode,Houston
ZCTA5 77045,48,36270,51170,899,80900,27025,9658,21527,6442,6572,5255,2264,994,10901,10330,571,10330,7033,3297,2017-01-01,zipcode,Houston
ZCTA5 77046,48,1029,90036,1825,348200,1003,302,944,0,20,254,369,301,755,719,36,719,222,497,2017-01-01,zipcode,Houston
ZCTA5 77047,48,29410,56706,1139,122900,21951,6838,18015,2519,4433,6162,2912,1989,10291,9626,665,9626,6886,2740,2017-01-01,zipcode,Houston
ZCTA5 77048,48,17143,41220,704,71900,13017,5048,10583,2026,3314,3329,1176,738,6844,5622,1222,5622,3613,2009,2017-01-01,zipcode,Houston
ZCTA5 77049,48,33749,56760,1014,126400,24868,7481,19149,5525,5099,5549,2016,960,11152,10236,916,10236,7039,3197,2017-01-01,zipcode,Houston
ZCTA5 77050,48,5031,57163,831,81300,3989,1493,3312,1109,1070,729,323,81,1539,1404,135,1404,1099,305,2017-01-01,zipcode,Houston
ZCTA5 77051,48,16661,27244,756,73800,12489,5646,10228,2255,3509,3319,906,239,7274,6102,1172,6102,2527,3575,2017-01-01,zipcode,Houston
ZCTA5 77053,48,31868,45953,1126,85200,22991,7517,18163,5821,5712,4669,1441,520,9103,8740,363,8740,5741,2999,2017-01-01,zipcode,Houston
ZCTA5 77054,48,22517,48681,1085,138800,20074,5827,16220,231,1685,4534,4254,5516,15165,12485,2680,12485,2005,10480,2017-01-01,zipcode,Houston
ZCTA5 77055,48,45003,52269,894,383000,33382,10082,28489,7847,6225,4773,5812,3832,16663,15034,1629,15034,6382,8652,2017-01-01,zipcode,Houston
ZCTA5 77056,48,21732,107003,1557,631800,18990,5822,17358,345,1202,2832,7949,5030,13256,10782,2474,10782,4672,6110,2017-01-01,zipcode,Houston
ZCTA5 77057,48,40130,57093,1025,287000,32973,8473,28719,4241,2942,5297,9831,6408,22485,19843,2642,19843,6792,13051,2017-01-01,zipcode,Houston
ZCTA5 77058,48,16669,51635,985,171800,14068,3665,11688,867,1677,4337,3002,1805,9257,8080,1177,8080,2387,5693,2017-01-01,zipcode,Houston
ZCTA5 77059,48,17374,126385,1547,277700,13645,4855,12019,580,862,2077,4757,3743,6138,5889,249,5889,5321,568,2017-01-01,zipcode,Houston
ZCTA5 77060,48,44549,28948,755,95700,29600,9750,23593,10584,6562,5016,1097,334,16330,13877,2453,13877,3214,10663,2017-01-01,zipcode,Houston
ZCTA5 77061,48,26276,39180,734,116900,19552,6493,15771,5377,5246,3062,1467,619,9982,8690,1292,8690,2991,5699,2017-01-01,zipcode,Houston
ZCTA5 77062,48,26583,88433,1129,178900,20988,6983,18079,1010,2729,6123,5363,2854,10028,9758,270,9758,7644,2114,2017-01-01,zipcode,Houston
ZCTA5 77063,48,38931,44957,1009,207400,30898,9145,26589,2929,4610,6545,8377,4128,20235,18281,1954,18281,4738,13543,2017-01-01,zipcode,Houston
ZCTA5 77064,48,49578,67763,1184,143000,38659,12164,33004,5843,7626,9729,7187,2619,17181,16300,881,16300,9520,6780,2017-01-01,zipcode,Houston
ZCTA5 77065,48,38820,54688,1082,154000,29929,9012,25107,3387,6769,7589,5002,2360,16049,15033,1016,15033,7216,7817,2017-01-01,zipcode,Houston
ZCTA5 77066,48,33796,61430,1094,125900,26161,7831,21761,4397,6505,5918,3581,1360,10845,10315,530,10315,7212,3103,2017-01-01,zipcode,Houston
ZCTA5 77067,48,33489,40138,827,99900,24323,8083,19168,5521,5645,5913,1525,564,11280,10160,1120,10160,4093,6067,2017-01-01,zipcode,Houston
ZCTA5 77068,48,10897,80313,1023,194000,9168,2993,7742,998,1686,2309,1958,791,4305,3821,484,3821,2531,1290,2017-01-01,zipcode,Houston
ZCTA5 77069,48,18238,64313,1150,233900,15020,5012,13481,365,1768,4900,4318,2130,8800,8212,588,8212,4494,3718,2017-01-01,zipcode,Houston
ZCTA5 77070,48,51080,69038,1230,166900,39639,11403,33363,2297,6729,11542,8714,4081,21170,19713,1457,19713,10298,9415,2017-01-01,zipcode,Houston
ZCTA5 77071,48,27981,49137,835,130900,21468,6985,18107,2760,4239,4704,4168,2236,11039,9912,1127,9912,5448,4464,2017-01-01,zipcode,Houston
ZCTA5 77072,48,62162,41041,902,97500,46938,14893,37655,13590,10647,8416,3813,1189,19713,17853,1860,17853,8508,9345,2017-01-01,zipcode,Houston
ZCTA5 77073,48,42780,54079,1005,119100,30548,9220,24002,4150,7079,8832,2855,1086,13669,12824,845,12824,7061,5763,2017-01-01,zipcode,Houston
ZCTA5 77074,48,39915,36593,821,114100,29473,9442,24639,7448,7456,5008,3463,1264,14832,13130,1702,13130,4269,8861,2017-01-01,zipcode,Houston
ZCTA5 77075,48,43586,50653,908,125900,31753,10217,25170,7726,8310,5997,2426,711,13638,12827,811,12827,6859,5968,2017-01-01,zipcode,Houston
ZCTA5 77076,48,35144,34842,842,88800,24251,8962,19297,9252,6684,2610,637,114,10600,9756,844,9756,4593,5163,2017-01-01,zipcode,Houston
ZCTA5 77077,48,57757,66587,1171,265300,46986,12922,41569,1844,5566,11451,13470,9238,29475,26614,2861,26614,9446,17168,2017-01-01,zipcode,Houston
ZCTA5 77078,48,15820,35770,883,74500,11489,4928,9415,2863,3514,2124,622,292,5190,4757,433,4757,2817,1940,2017-01-01,zipcode,Houston
ZCTA5 77079,48,33577,98774,1293,444100,24979,9029,22161,1452,2346,4105,8592,5666,14074,12496,1578,12496,7957,4539,2017-01-01,zipcode,Houston
ZCTA5 77080,48,45665,44386,880,171000,34488,10396,28900,9361,8081,6461,3382,1615,16489,15241,1248,15241,6126,9115,2017-01-01,zipcode,Houston
ZCTA5 77081,48,49059,29079,782,256700,34478,8902,29375,10522,8353,4593,4140,1767,20314,18070,2244,18070,977,17093,2017-01-01,zipcode,Houston
ZCTA5 77082,48,56641,53999,1097,147200,44641,12591,38867,4421,8599,11613,9395,4839,24741,22547,2194,22547,8129,14418,2017-01-01,zipcode,Houston
ZCTA5 77083,48,79408,54786,976,130300,60405,19926,48959,9728,12465,14404,8697,3665,23141,22380,761,22380,14901,7479,2017-01-01,zipcode,Houston
ZCTA5 77084,48,104582,65617,1187,142400,78423,22498,64694,9805,15600,20640,13301,5348,36033,33790,2243,33790,21054,12736,2017-01-01,zipcode,Houston
ZCTA5 77085,48,17981,55950,1056,106300,14035,4695,11092,3788,2911,2527,1198,668,5312,5146,166,5146,3546,1600,2017-01-01,zipcode,Houston
ZCTA5 77086,48,29506,43116,924,97300,21076,7374,16702,5838,5790,3671,1098,305,8509,8078,431,8078,4868,3210,2017-01-01,zipcode,Houston
ZCTA5 77087,48,37200,35302,762,89000,27201,9927,22056,8648,6813,4630,1465,500,12044,11076,968,11076,5433,5643,2017-01-01,zipcode,Houston
ZCTA5 77088,48,56716,44472,854,100000,42078,15343,35031,10183,11325,8794,3512,1217,19141,17381,1760,17381,10648,6733,2017-01-01,zipcode,Houston
ZCTA5 77089,48,52699,66775,1073,137400,41195,12573,33534,6073,9136,11094,4738,2493,18185,16858,1327,16858,10925,5933,2017-01-01,zipcode,Houston
ZCTA5 77090,48,38361,39392,913,140900,27759,7877,21937,3292,5852,8146,3110,1537,17742,15487,2255,15487,3421,12066,2017-01-01,zipcode,Houston
ZCTA5 77091,48,25277,32500,752,110900,19142,7427,16687,4313,5679,4344,1526,825,11166,9658,1508,9658,3959,5699,2017-01-01,zipcode,Houston
ZCTA5 77092,48,38476,39921,805,147100,29201,8564,24417,6507,8457,5410,2966,1077,15469,14075,1394,14075,5142,8933,2017-01-01,zipcode,Houston
ZCTA5 77093,48,44428,30837,776,75900,31823,13777,25294,12975,7731,3775,602,211,14215,12275,1940,12275,6984,5291,2017-01-01,zipcode,Houston
ZCTA5 77094,48,9439,158160,1842,390000,7088,2694,6165,135,474,1103,2543,1910,3447,3167,280,3167,2600,567,2017-01-01,zipcode,Houston
ZCTA5 77095,48,72081,92175,1220,193100,55806,16228,46788,3314,8731,14784,13295,6664,25500,24232,1268,24232,18150,6082,2017-01-01,zipcode,Houston
ZCTA5 77096,48,35465,61583,921,320100,27425,8555,23745,2106,3770,5490,6577,5802,15926,14382,1544,14382,6904,7478,2017-01-01,zipcode,Houston
ZCTA5 77098,48,13444,87820,1524,462500,12202,2333,11035,226,319,1738,4425,4327,9046,8090,956,8090,2534,5556,2017-01-01,zipcode,Houston
ZCTA5 77099,48,51905,38878,879,105700,38897,12122,31555,9165,8552,8851,3736,1251,18293,16805,1488,16805,6367,10438,2017-01-01,zipcode,Houston
ZCTA5 77201,48,0,-666666666,-666666666,-666666666,0,0,0,0,0,0,0,0,0,0,0,0,0,0,2017-01-01,zipcode,Houston
ZCTA5 77301,48,31801,40795,823,111100,24424,9168,19685,7237,5620,4336,1779,713,11411,10173,1238,10173,4949,5224,2017-01-01,zipcode,Conroe
ZCTA5 77302,48,19311,63328,834,147100,14286,5326,12322,1963,4342,3648,1623,746,7023,6417,606,6417,5335,1082,2017-01-01,zipcode,Conroe
ZCTA5 77303,48,19695,52283,992,123700,14799,5344,12168,2921,4333,3423,1196,295,6917,6564,353,6564,4824,1740,2017-01-01,zipcode,Conroe
ZCTA5 77304,48,28692,60568,1019,198000,22611,7819,19177,1887,4606,5975,4163,2546,12686,11655,1031,11655,6541,5114,2017-01-01,zipcode,Conroe
ZCTA5 77306,48,11453,44354,945,84700,8417,3535,6631,2140,2353,1814,319,5,4231,3602,629,3602,2763,839,2017-01-01,zipcode,Conroe
ZCTA5 77316,48,21272,86719,970,266700,15948,5657,13505,1303,3802,4120,2886,1394,7767,7294,473,7294,6416,878,2017-01-01,zipcode,Montgomery
ZCTA5 77318,48,15437,61722,1150,209600,12405,5364,11144,855,3927,3455,2013,894,6877,5848,1029,5848,4588,1260,2017-01-01,zipcode,Willis
ZCTA5 77320,48,35670,48889,792,109200,31041,19978,26621,5034,10982,6560,3084,961,11474,8936,2538,8936,5718,3218,2017-01-01,zipcode,Huntsville
ZCTA5 77326,48,15,-666666666,-666666666,-666666666,15,0,15,0,0,0,15,0,53,15,38,15,15,0,2017-01-01,zipcode,Ace
ZCTA5 77327,48,22430,40636,715,87500,16634,8383,14443,3622,5788,3629,1052,352,9166,7704,1462,7704,5292,2412,2017-01-01,zipcode,Cleveland
ZCTA5 77328,48,15863,56991,823,110500,11977,5456,9956,2547,4257,2279,746,127,5725,4881,844,4881,3728,1153,2017-01-01,zipcode,Cleveland
ZCTA5 77331,48,7667,48398,726,114200,6577,3412,5660,901,2473,1426,646,214,4417,3002,1415,3002,2723,279,2017-01-01,zipcode,Coldspring
ZCTA5 77334,48,286,39138,-666666666,-666666666,233,131,233,77,54,102,0,0,134,112,22,112,76,36,2017-01-01,zipcode,Dodge
ZCTA5 77335,48,2519,37656,973,123200,2102,875,1844,247,874,543,180,0,1458,1069,389,1069,849,220,2017-01-01,zipcode,Goodrich
ZCTA5 77336,48,12397,67563,1035,162600,9408,3536,8055,1042,2656,3067,1102,188,4832,4430,402,4430,3247,1183,2017-01-01,zipcode,Huffman
ZCTA5 77338,48,40335,50263,948,128800,29339,8488,24445,3490,7463,9429,3084,979,14590,13714,876,13714,7564,6150,2017-01-01,zipcode,Humble
ZCTA5 77339,48,41403,73466,1226,171800,32982,11325,27702,1191,4836,10198,7858,3619,17004,15918,1086,15918,10387,5531,2017-01-01,zipcode,Kingwood
ZCTA5 77340,48,29900,35563,861,161400,26505,14357,16263,2033,4936,4461,3312,1521,11864,10695,1169,10695,4249,6446,2017-01-01,zipcode,Huntsville
ZCTA5 77342,48,0,-666666666,-666666666,-666666666,0,0,0,0,0,0,0,0,0,0,0,0,0,0,2017-01-01,zipcode,Huntsville
ZCTA5 77345,48,29090,128646,1307,272700,22218,8671,18572,474,1684,4727,7607,4080,10094,9725,369,9725,8321,1404,2017-01-01,zipcode,Kingwood
ZCTA5 77346,48,63233,98840,1300,182900,45836,13848,39587,2534,7532,13591,11348,4582,21182,20466,716,20466,16961,3505,2017-01-01,zipcode,Humble
ZCTA5 77350,48,173,-666666666,-666666666,41900,133,75,112,41,5,46,15,5,95,70,25,70,67,3,2017-01-01,zipcode,Leggett
ZCTA5 77351,48,33199,45207,686,90500,27496,14026,24023,5572,8787,6542,2289,833,16567,12051,4516,12051,9242,2809,2017-01-01,zipcode,Livingston
ZCTA5 77354,48,35904,79440,1174,237900,27523,9375,23770,2581,6639,7122,5302,2126,12489,11848,641,11848,9812,2036,2017-01-01,zipcode,Magnolia
ZCTA5 77355,48,27271,83713,1074,207700,21662,7137,18016,2096,5216,5561,3746,1397,9798,9269,529,9269,7875,1394,2017-01-01,zipcode,Magnolia
ZCTA5 77356,48,25888,77444,1165,243800,21652,9408,19268,648,4062,7013,5286,2259,13882,10996,2886,10996,8926,2070,2017-01-01,zipcode,Montgomery
ZCTA5 77357,48,24334,47805,808,105400,17989,7597,14058,3937,4496,4031,1183,411,8033,7341,692,7341,5533,1808,2017-01-01,zipcode,New caney
ZCTA5 77358,48,5597,51657,926,139500,4052,1962,3330,420,1200,1349,134,227,2472,1788,684,1788,1349,439,2017-01-01,zipcode,New waverly
ZCTA5 77359,48,418,-666666666,-666666666,132100,418,266,418,0,342,37,39,0,285,201,84,201,133,68,2017-01-01,zipcode,Oakhurst
ZCTA5 77360,48,5084,39956,808,75200,4175,2087,3734,680,1565,1092,360,37,3561,2193,1368,2193,1773,420,2017-01-01,zipcode,Onalaska
ZCTA5 77362,48,5546,67023,1633,163000,4005,1468,3209,417,1181,779,722,110,1743,1666,77,1666,1442,224,2017-01-01,zipcode,Pinehurst
ZCTA5 77363,48,2705,47826,1024,90800,2263,848,2103,276,722,700,235,170,1510,1232,278,1232,1002,230,2017-01-01,zipcode,Plantersville
ZCTA5 77364,48,1822,26574,823,102400,1578,1135,1340,345,476,347,129,43,1368,741,627,741,676,65,2017-01-01,zipcode,Pointblank
ZCTA5 77365,48,31406,72623,1019,177200,24063,8545,20405,3864,5035,7156,2797,1553,11205,10343,862,10343,7618,2725,2017-01-01,zipcode,Porter
ZCTA5 77367,48,111,50795,934,-666666666,99,46,89,31,27,24,7,0,104,62,42,62,24,38,2017-01-01,zipcode,Riverside
ZCTA5 77368,48,181,38162,-666666666,120500,181,163,181,59,75,20,20,7,135,90,45,90,90,0,2017-01-01,zipcode,Romayor
ZCTA5 77369,48,482,35417,-666666666,73200,438,303,415,166,107,89,53,0,335,212,123,212,198,14,2017-01-01,zipcode,Rye
ZCTA5 77371,48,8025,39028,610,64800,6068,2766,5353,1029,2957,1146,138,83,3125,2445,680,2445,1774,671,2017-01-01,zipcode,Shepherd
ZCTA5 77372,48,12351,51818,886,81000,9184,3694,7765,1841,3191,2240,439,54,4565,4070,495,4070,3140,930,2017-01-01,zipcode,Splendora
ZCTA5 77373,48,58255,67924,1282,132700,43787,13203,36844,3078,10546,14568,6107,2545,20939,19731,1208,19731,14430,5301,2017-01-01,zipcode,Spring
ZCTA5 77374,48,463,48777,-666666666,91300,353,118,318,33,49,181,55,0,168,168,0,168,168,0,2017-01-01,zipcode,Thicket
ZCTA5 77375,48,50525,69446,1112,168300,37076,10915,30938,3173,8480,9763,7121,2401,17383,16125,1258,16125,11521,4604,2017-01-01,zipcode,Tomball
ZCTA5 77376,48,430,35938,-666666666,-666666666,430,350,358,96,230,27,5,0,232,166,66,166,166,0,2017-01-01,zipcode,Votaw
ZCTA5 77377,48,36758,96064,1271,241800,26611,8823,22751,1988,3932,7265,6914,2652,11983,11624,359,11624,9622,2002,2017-01-01,zipcode,Tomball
ZCTA5 77378,48,16150,55114,913,107100,11577,4555,9884,2167,3867,2444,1111,295,5552,4983,569,4983,3661,1322,2017-01-01,zipcode,Willis
ZCTA5 77379,48,78226,99693,1226,229000,59523,19507,52234,2787,8676,15792,16551,8428,27675,26321,1354,26321,20898,5423,2017-01-01,zipcode,Spring
ZCTA5 77380,48,26691,68839,1282,222700,22332,6335,19061,1222,3168,5538,5473,3660,13061,11649,1412,11649,4802,6847,2017-01-01,zipcode,Spring
ZCTA5 77381,48,36919,103439,1370,339300,29545,11705,26405,539,2946,6575,10140,6205,15058,14205,853,14205,10457,3748,2017-01-01,zipcode,Spring
ZCTA5 77382,48,40546,139902,1764,408100,29198,10606,24395,717,2260,5590,9257,6571,14162,13259,903,13259,9868,3391,2017-01-01,zipcode,Spring
ZCTA5 77384,48,16472,85371,1391,298100,13214,4775,11894,643,2202,3451,3239,2359,7371,6560,811,6560,3938,2622,2017-01-01,zipcode,Conroe
ZCTA5 77385,48,23578,88220,1197,205300,17680,5197,15083,1559,3722,4684,3304,1814,8209,7956,253,7956,6367,1589,2017-01-01,zipcode,Conroe
ZCTA5 77386,48,53042,99076,1412,205900,37604,10143,32438,1695,5315,11700,10094,3634,16939,16675,264,16675,12735,3940,2017-01-01,zipcode,Spring
ZCTA5 77388,48,45841,87574,1486,172300,36251,11548,29927,2624,5575,11053,7124,3551,16238,15774,464,15774,12606,3168,2017-01-01,zipcode,Spring
ZCTA5 77389,48,31883,115725,1484,283100,22655,6716,20333,1000,3450,4861,7307,3715,11443,10482,961,10482,8780,1702,2017-01-01,zipcode,Spring
ZCTA5 77396,48,54352,64195,1151,130800,38996,11186,33829,5596,8578,11180,5709,2766,17683,16773,910,16773,9727,7046,2017-01-01,zipcode,Humble
ZCTA5 77401,48,19062,172205,1596,802300,14402,4745,13206,363,688,1689,4175,6291,7403,7011,392,7011,5760,1251,2017-01-01,zipcode,Bellaire
ZCTA5 77406,48,41008,114696,1244,265700,31655,11117,27999,1651,5282,8728,7624,4714,14468,13392,1076,13392,11795,1597,2017-01-01,zipcode,Richmond
ZCTA5 77407,48,48157,96947,1469,216900,34440,9638,29868,1893,3847,9578,9294,5256,14574,14198,376,14198,11815,2383,2017-01-01,zipcode,Richmond
ZCTA5 77412,48,105,63750,-666666666,95000,99,6,61,6,8,29,18,0,36,30,6,30,30,0,2017-01-01,zipcode,Altair
ZCTA5 77414,48,23369,46104,771,105500,17816,6923,15293,3608,4608,4767,1721,589,11905,8652,3253,8652,5008,3644,2017-01-01,zipcode,Bay city
ZCTA5 77415,48,86,-666666666,-666666666,-666666666,50,13,37,0,0,0,37,0,21,21,0,21,21,0,2017-01-01,zipcode,Cedar lane
ZCTA5 77417,48,2760,42219,930,107100,2253,1038,1973,543,544,512,336,38,1342,1123,219,1123,771,352,2017-01-01,zipcode,Beasley
ZCTA5 77418,48,9926,59984,796,221200,8195,3605,7012,1025,1691,2262,1330,704,4598,3985,613,3985,2926,1059,2017-01-01,zipcode,Bellville
ZCTA5 77419,48,1473,60663,860,111300,920,274,732,178,327,121,106,0,588,456,132,456,360,96,2017-01-01,zipcode,Blessing
ZCTA5 77420,48,2245,46756,758,97800,1856,701,1483,227,516,664,33,43,1028,913,115,913,697,216,2017-01-01,zipcode,Boling
ZCTA5 77422,48,13378,53929,796,92000,11165,5730,9490,1356,3684,3535,674,241,6108,4728,1380,4728,3816,912,2017-01-01,zipcode,Brazoria
ZCTA5 77423,48,11551,52019,886,166100,9091,3116,7397,1770,2387,1862,934,444,4155,3799,356,3799,2734,1065,2017-01-01,zipcode,Brookshire
ZCTA5 77426,48,2350,65352,1216,152100,1994,885,1581,227,292,719,252,91,1134,845,289,845,682,163,2017-01-01,zipcode,Chappell hill
ZCTA5 77428,48,0,-666666666,-666666666,-666666666,0,0,0,0,0,0,0,0,0,0,0,0,0,0,2017-01-01,zipcode,Collegeport
ZCTA5 77429,48,86399,103092,1265,215000,62149,18455,53659,2673,9227,15848,18065,7846,28930,27727,1203,27727,23330,4397,2017-01-01,zipcode,Cypress
ZCTA5 77430,48,2051,72935,950,126800,1590,651,1423,102,507,411,309,94,904,740,164,740,671,69,2017-01-01,zipcode,Damon
ZCTA5 77432,48,112,-666666666,-666666666,-666666666,85,19,85,37,0,19,16,13,64,35,29,35,16,19,2017-01-01,zipcode,Danevang
ZCTA5 77433,48,75008,103773,1499,227800,51732,14936,44979,3713,8429,11581,14250,7006,24353,23046,1307,23046,19784,3262,2017-01-01,zipcode,Cypress
ZCTA5 77434,48,4781,40250,689,58500,3682,1484,3171,865,1091,868,240,107,2079,1637,442,1637,1269,368,2017-01-01,zipcode,Eagle lake
ZCTA5 77435,48,4303,55284,924,139100,3444,1318,2961,592,946,663,587,173,1923,1607,316,1607,1209,398,2017-01-01,zipcode,East bernard
ZCTA5 77436,48,43,-666666666,-666666666,-666666666,28,15,28,0,0,0,15,13,33,13,20,13,13,0,2017-01-01,zipcode,Egypt
ZCTA5 77437,48,16875,50465,733,133900,12592,4367,10631,2471,3393,3216,967,584,6636,6033,603,6033,3950,2083,2017-01-01,zipcode,El campo
ZCTA5 77440,48,23,-666666666,-666666666,-666666666,23,0,23,23,0,0,0,0,23,23,0,23,0,23,2017-01-01,zipcode,Elmaton
ZCTA5 77441,48,9919,160162,-666666666,411900,7538,2946,6607,379,815,1501,2521,1391,3474,3315,159,3315,3147,168,2017-01-01,zipcode,Fulshear
ZCTA5 77442,48,922,62386,521,114400,719,211,595,97,146,172,139,41,609,367,242,367,276,91,2017-01-01,zipcode,Garwood
ZCTA5 77443,48,256,-666666666,-666666666,-666666666,103,0,103,0,103,0,0,0,50,50,0,50,50,0,2017-01-01,zipcode,Glen flora
ZCTA5 77444,48,708,59886,-666666666,-666666666,544,229,450,108,170,112,39,21,324,249,75,249,202,47,2017-01-01,zipcode,Guy
ZCTA5 77445,48,13301,43730,804,132100,9906,3281,7203,1852,2382,1848,740,381,5263,4484,779,4484,2562,1922,2017-01-01,zipcode,Hempstead
ZCTA5 77446,48,6095,20083,1107,140600,5921,3494,446,92,64,156,60,74,869,584,285,584,123,461,2017-01-01,zipcode,Prairie view
ZCTA5 77447,48,15246,72775,1199,134900,11208,4173,9397,1717,3104,2992,1129,455,4975,4710,265,4710,3828,882,2017-01-01,zipcode,Hockley
ZCTA5 77448,48,58,-666666666,-666666666,-666666666,58,23,58,0,46,12,0,0,13,13,0,13,0,13,2017-01-01,zipcode,Hungerford
ZCTA5 77449,48,119204,72397,1386,142600,85829,22574,70134,11027,17304,23713,13759,4331,35116,33719,1397,33719,23412,10307,2017-01-01,zipcode,Katy
ZCTA5 77450,48,74631,101240,1277,242000,57045,18580,48019,2737,7185,12896,16394,8807,26032,24987,1045,24987,17815,7172,2017-01-01,zipcode,Katy
ZCTA5 77451,48,79,22083,-666666666,65000,65,31,44,4,31,9,0,0,38,31,7,31,28,3,2017-01-01,zipcode,Kendleton
ZCTA5 77453,48,335,28056,746,-666666666,154,35,152,50,21,81,0,0,112,112,0,112,38,74,2017-01-01,zipcode,Lane city
ZCTA5 77454,48,15,-666666666,-666666666,-666666666,15,0,15,0,0,0,0,15,15,15,0,15,15,0,2017-01-01,zipcode,Lissie
ZCTA5 77455,48,2026,52798,710,128200,1666,548,1500,254,549,479,154,64,966,829,137,829,677,152,2017-01-01,zipcode,Louise
ZCTA5 77456,48,1323,36397,-666666666,75900,1046,492,841,265,302,123,128,23,602,484,118,484,430,54,2017-01-01,zipcode,Markham
ZCTA5 77457,48,521,35179,309,131300,431,216,389,51,88,167,83,0,1110,239,871,239,216,23,2017-01-01,zipcode,Matagorda
ZCTA5 77458,48,272,-666666666,-666666666,-666666666,272,46,177,73,76,19,9,0,181,120,61,120,104,16,2017-01-01,zipcode,Midfield
ZCTA5 77459,48,66175,112161,1706,246700,50713,15715,43326,2012,5521,10968,16131,8694,21785,21160,625,21160,18196,2964,2017-01-01,zipcode,Missouri city
ZCTA5 77460,48,151,-666666666,-666666666,-666666666,133,52,63,0,12,51,0,0,30,30,0,30,18,12,2017-01-01,zipcode,Nada
ZCTA5 77461,48,10752,69621,834,139300,8436,2664,7325,1546,2554,1948,1059,218,4206,3852,354,3852,2941,911,2017-01-01,zipcode,Needville
ZCTA5 77464,48,284,54500,1019,141900,208,116,161,38,66,39,9,9,106,98,8,98,55,43,2017-01-01,zipcode,Orchard
ZCTA5 77465,48,7269,49103,761,109100,6005,2490,4880,821,1918,1347,412,382,3819,2769,1050,2769,2406,363,2017-01-01,zipcode,Palacios
ZCTA5 77466,48,353,70000,946,114700,320,78,235,57,82,61,29,6,189,154,35,154,100,54,2017-01-01,zipcode,Pattison
ZCTA5 77467,48,37,69602,-666666666,-666666666,37,0,37,0,0,37,0,0,49,37,12,37,0,37,2017-01-01,zipcode,Pierce
ZCTA5 77468,48,44,-666666666,-666666666,-666666666,44,19,44,0,0,25,0,19,46,19,27,19,19,0,2017-01-01,zipcode,Pledger
ZCTA5 77469,48,46934,82214,1009,195800,36649,13573,31194,4927,6926,9436,6722,3183,15659,14853,806,14853,10888,3965,2017-01-01,zipcode,Richmond
ZCTA5 77470,48,399,-666666666,-666666666,-666666666,356,157,242,98,106,14,18,6,199,145,54,145,110,35,2017-01-01,zipcode,Rock island
ZCTA5 77471,48,38837,49923,964,134900,28147,9934,22946,5631,6960,6496,2421,1438,13736,12334,1402,12334,6996,5338,2017-01-01,zipcode,Rosenberg
ZCTA5 77473,48,111,20313,-666666666,-666666666,80,37,76,9,29,35,0,3,47,47,0,47,13,34,2017-01-01,zipcode,San felipe
ZCTA5 77474,48,12993,63152,867,162800,9816,3199,8413,1720,2694,2465,1189,345,5115,4568,547,4568,3305,1263,2017-01-01,zipcode,Sealy
ZCTA5 77475,48,882,67000,-666666666,77500,688,219,578,23,194,277,52,32,544,284,260,284,284,0,2017-01-01,zipcode,Sheridan
ZCTA5 77476,48,194,-666666666,-666666666,324100,157,73,148,47,27,49,14,11,94,75,19,75,62,13,2017-01-01,zipcode,Simonton
ZCTA5 77477,48,36932,58524,1184,153900,30097,8948,24708,4033,5100,6995,5939,2641,13963,13169,794,13169,5939,7230,2017-01-01,zipcode,Stafford
ZCTA5 77478,48,25846,91431,1454,270200,21570,8101,19200,1546,2509,4667,6780,3698,9842,9345,497,9345,7142,2203,2017-01-01,zipcode,Sugar land
ZCTA5 77479,48,88603,135952,1771,344400,66617,22897,57428,2823,5935,10726,21011,16933,28530,27308,1222,27308,22921,4387,2017-01-01,zipcode,Sugar land
ZCTA5 77480,48,7661,56111,791,106800,5904,2531,4992,545,1727,2047,576,97,3408,2876,532,2876,2293,583,2017-01-01,zipcode,Sweeny
ZCTA5 77481,48,13,-666666666,-666666666,-666666666,13,5,13,0,0,13,0,0,15,8,7,8,2,6,2017-01-01,zipcode,Thompsons
ZCTA5 77482,48,2274,-666666666,762,76100,1836,912,1652,365,469,660,106,52,1141,1009,132,1009,826,183,2017-01-01,zipcode,Van vleck
ZCTA5 77483,48,292,-666666666,-666666666,-666666666,147,0,124,13,66,45,0,0,232,85,147,85,34,51,2017-01-01,zipcode,Wadsworth
ZCTA5 77484,48,10710,66000,859,176200,8055,2657,6790,1528,2079,2027,804,352,3953,3638,315,3638,2815,823,2017-01-01,zipcode,Waller
ZCTA5 77485,48,4691,54239,758,136900,3667,1726,3160,809,1127,782,320,122,1781,1642,139,1642,1191,451,2017-01-01,zipcode,Wallis
ZCTA5 77486,48,7082,67701,914,121600,5681,2286,4816,428,1445,2292,445,206,2903,2540,363,2540,1928,612,2017-01-01,zipcode,West columbia
ZCTA5 77488,48,14738,45027,714,105200,11308,4741,9402,2045,2982,3073,744,558,6290,5434,856,5434,3482,1952,2017-01-01,zipcode,Wharton
ZCTA5 77489,48,36786,66124,1271,117000,28760,8204,24232,2620,6478,8119,4672,2343,12535,12059,476,12059,9083,2976,2017-01-01,zipcode,Missouri city
ZCTA5 77493,48,29984,85865,1336,171200,22684,6567,19090,2459,4718,6162,3832,1919,9524,9004,520,9004,7156,1848,2017-01-01,zipcode,Katy
ZCTA5 77494,48,105854,137600,1576,318600,74171,23856,63459,2276,6012,15987,23686,15498,33966,32612,1354,32612,26067,6545,2017-01-01,zipcode,Katy
ZCTA5 77498,48,51037,80307,1415,186500,39609,13094,32673,4213,6114,9372,8902,4072,16224,15344,880,15344,11339,4005,2017-01-01,zipcode,Sugar land
ZCTA5 77502,48,39040,46105,871,92500,27970,10863,22327,8585,6975,5156,1189,422,11802,10950,852,10950,6708,4242,2017-01-01,zipcode,Pasadena
ZCTA5 77503,48,26171,45778,859,92900,18900,6357,15242,4265,4822,4720,1057,378,8587,8046,541,8046,4081,3965,2017-01-01,zipcode,Pasadena
ZCTA5 77504,48,23327,40693,856,134700,16939,5570,13851,3148,4488,3912,1695,608,10051,8620,1431,8620,3477,5143,2017-01-01,zipcode,Pasadena
ZCTA5 77505,48,24230,77490,1047,172600,18892,5600,15822,1451,4314,6076,2748,1233,9116,8370,746,8370,5717,2653,2017-01-01,zipcode,Pasadena
ZCTA5 77506,48,37736,34838,783,73300,26207,9295,21034,9468,6757,3993,696,120,12025,11037,988,11037,4465,6572,2017-01-01,zipcode,Pasadena
ZCTA5 77507,48,0,-666666666,-666666666,-666666666,0,0,0,0,0,0,0,0,0,0,0,0,0,0,2017-01-01,zipcode,Pasadena
ZCTA5 77510,48,14608,69647,909,157700,11740,4560,10163,1058,3711,4283,831,280,5983,5479,504,5479,4282,1197,2017-01-01,zipcode,Santa fe
ZCTA5 77511,48,46121,57098,872,125200,35202,13277,29390,4754,9653,10575,3047,1361,17615,16050,1565,16050,11419,4631,2017-01-01,zipcode,Alvin
ZCTA5 77514,48,4443,38953,776,127200,3545,1889,3084,776,1042,844,185,237,2144,1660,484,1660,1340,320,2017-01-01,zipcode,Anahuac
ZCTA5 77515,48,31627,61603,793,115000,24863,10491,21672,4001,7462,6767,2705,737,12031,10732,1299,10732,7275,3457,2017-01-01,zipcode,Angleton
ZCTA5 77517,48,5688,74627,1014,162400,4473,1839,3799,471,1420,1484,361,63,2164,1738,426,1738,1638,100,2017-01-01,zipcode,Santa fe
ZCTA5 77518,48,10984,38843,788,88500,7942,2653,6837,1771,2135,1791,766,374,4008,3679,329,3679,2371,1308,2017-01-01,zipcode,Bacliff
ZCTA5 77519,48,1509,62379,-666666666,56700,1182,532,1024,217,502,217,69,19,615,527,88,527,491,36,2017-01-01,zipcode,Batson
ZCTA5 77520,48,36694,46311,852,80200,27107,9883,22544,6923,6116,7188,1631,686,13968,12354,1614,12354,7084,5270,2017-01-01,zipcode,Baytown
ZCTA5 77521,48,57125,62513,886,135500,42532,15185,34390,5506,9739,13079,4446,1620,20941,18970,1971,18970,11819,7151,2017-01-01,zipcode,Baytown
ZCTA5 77523,48,21366,100116,1131,199000,15449,5265,13151,1436,3237,5254,2177,1047,7270,6885,385,6885,5672,1213,2017-01-01,zipcode,Baytown
ZCTA5 77530,48,31119,55761,882,91500,22465,7559,18371,5864,6344,4981,884,298,9658,9239,419,9239,5901,3338,2017-01-01,zipcode,Channelview
ZCTA5 77531,48,16078,57954,828,109400,12340,3860,10052,2476,2899,3326,965,386,7153,6047,1106,6047,3183,2864,2017-01-01,zipcode,Clute
ZCTA5 77532,48,28320,62606,964,135300,21929,8338,18847,2831,6060,6888,2365,703,10513,9970,543,9970,7891,2079,2017-01-01,zipcode,Crosby
ZCTA5 77533,48,849,49423,671,60900,654,277,569,97,239,177,41,15,453,336,117,336,223,113,2017-01-01,zipcode,Daisetta
ZCTA5 77534,48,2426,83867,893,141900,1938,573,1574,226,342,719,195,92,968,879,89,879,726,153,2017-01-01,zipcode,Danbury
ZCTA5 77535,48,32904,54873,891,100900,26402,14184,22102,4870,9195,6270,1162,605,10566,9388,1178,9388,7464,1924,2017-01-01,zipcode,Dayton
ZCTA5 77536,48,32392,82420,1214,147000,25103,8256,20974,2194,5106,9399,3031,1244,11697,10853,844,10853,8340,2513,2017-01-01,zipcode,Deer park
ZCTA5 77538,48,906,62188,731,103200,768,410,606,164,183,171,62,26,354,301,53,301,282,19,2017-01-01,zipcode,Devers
ZCTA5 77539,48,42607,71216,931,152400,33514,11199,28328,4673,7939,9345,4076,2295,16834,14940,1894,14940,10472,4468,2017-01-01,zipcode,Dickinson
ZCTA5 77541,48,18525,48390,782,88800,13673,4776,10676,2919,3568,3248,764,177,8757,6273,2484,6273,3665,2608,2017-01-01,zipcode,Freeport
ZCTA5 77545,48,25036,70326,1332,152400,17707,4711,14019,2256,2829,4533,2695,1706,7224,6968,256,6968,5855,1113,2017-01-01,zipcode,Fresno
ZCTA5 77546,48,52261,98621,1209,220000,40148,13440,33897,1655,5864,10119,10893,5366,18331,17615,716,17615,13884,3731,2017-01-01,zipcode,Friendswood
ZCTA5 77547,48,10077,41037,827,67400,7137,2536,5698,2437,1605,1280,302,74,2889,2694,195,2694,1701,993,2017-01-01,zipcode,Galena park
ZCTA5 77550,48,22070,35305,843,135700,18670,7689,15979,2738,4091,4475,2705,1970,14324,9866,4458,9866,4078,5788,2017-01-01,zipcode,Galveston
ZCTA5 77551,48,21203,47727,911,159200,17543,7583,14567,2776,3742,4434,2257,1358,10003,8084,1919,8084,3144,4940,2017-01-01,zipcode,Galveston
ZCTA5 77554,48,8249,66833,984,277400,7576,3230,5826,301,957,2110,1466,992,10029,3696,6333,3696,2408,1288,2017-01-01,zipcode,Galveston
ZCTA5 77560,48,624,97321,-666666666,190800,514,152,457,69,212,126,34,16,407,270,137,270,260,10,2017-01-01,zipcode,Hankamer
ZCTA5 77561,48,67,-666666666,-666666666,126400,60,33,60,20,26,5,9,0,42,42,0,42,35,7,2017-01-01,zipcode,Hardin
ZCTA5 77562,48,10665,62077,936,106600,8411,3515,6925,1116,2435,2666,383,325,4046,3690,356,3690,2780,910,2017-01-01,zipcode,Highlands
ZCTA5 77563,48,10067,55652,868,128800,7764,3168,6996,963,2238,2643,846,306,4970,3960,1010,3960,2850,1110,2017-01-01,zipcode,Hitchcock
ZCTA5 77564,48,1986,59531,-666666666,98100,1574,755,1325,344,573,246,162,0,958,775,183,775,695,80,2017-01-01,zipcode,Hull
ZCTA5 77565,48,7233,68062,1223,234000,6087,2271,5347,150,1105,1934,1548,610,3754,3417,337,3417,1875,1542,2017-01-01,zipcode,Kemah
ZCTA5 77566,48,29441,78276,1041,159300,23019,7515,19815,1255,4666,7351,4568,1975,12293,11410,883,11410,7756,3654,2017-01-01,zipcode,Lake jackson
ZCTA5 77568,48,15640,44381,838,96400,12529,5249,10656,1598,3726,3946,1071,315,6757,5591,1166,5591,3770,1821,2017-01-01,zipcode,La marque
ZCTA5 77571,48,37374,75232,1032,133600,29612,9446,25335,2700,7735,10089,3307,1504,14135,13248,887,13248,9814,3434,2017-01-01,zipcode,La porte
ZCTA5 77573,48,85108,103922,1276,224500,63332,18177,54129,2187,9691,17634,15768,8849,30396,29201,1195,29201,21925,7276,2017-01-01,zipcode,League city
ZCTA5 77575,48,17005,55156,822,104000,12895,5599,10763,1853,4106,3544,806,454,6927,5983,944,5983,4383,1600,2017-01-01,zipcode,Liberty
ZCTA5 77577,48,1566,70815,686,134400,1224,571,1121,239,295,416,144,27,819,581,238,581,538,43,2017-01-01,zipcode,Liverpool
ZCTA5 77578,48,18636,99082,738,220400,14078,3974,12267,697,2533,3749,3065,2223,6353,5869,484,5869,5133,736,2017-01-01,zipcode,Manvel
ZCTA5 77580,48,534,-666666666,-666666666,317300,293,145,293,0,31,162,100,0,151,151,0,151,151,0,2017-01-01,zipcode,Mont belvieu
ZCTA5 77581,48,47625,89931,1117,199200,35896,12059,30472,2105,6667,10216,7715,3769,17381,16452,929,16452,12399,4053,2017-01-01,zipcode,Pearland
ZCTA5 77583,48,35308,67241,870,161500,26582,13372,21976,5430,6824,5431,2731,1560,8873,8165,708,8165,6591,1574,2017-01-01,zipcode,Rosharon
ZCTA5 77584,48,87121,106162,1391,223900,64431,16488,56246,2710,7366,16172,17624,12374,30955,29633,1322,29633,22034,7599,2017-01-01,zipcode,Pearland
ZCTA5 77585,48,880,40508,-666666666,24000,662,408,574,185,226,119,44,0,403,290,113,290,259,31,2017-01-01,zipcode,Saratoga
ZCTA5 77586,48,22182,90612,1045,212500,17864,5492,15227,514,2433,5340,4827,2113,9562,8714,848,8714,5695,3019,2017-01-01,zipcode,Seabrook
ZCTA5 77587,48,16901,44371,789,85200,11806,4398,9407,4105,3064,1512,554,172,4908,4511,397,4511,2702,1809,2017-01-01,zipcode,South houston
ZCTA5 77590,48,31084,41697,847,98400,24081,10078,20726,4634,7067,6903,1679,443,13072,11205,1867,11205,6779,4426,2017-01-01,zipcode,Texas city
ZCTA5 77591,48,14073,43487,907,119300,11031,4474,9363,1220,2590,3907,1256,390,6219,5399,820,5399,2935,2464,2017-01-01,zipcode,Texas city
ZCTA5 77597,48,1210,43009,-666666666,-666666666,850,390,737,91,245,310,87,4,407,325,82,325,281,44,2017-01-01,zipcode,Wallisville
ZCTA5 77598,48,24689,52167,1015,138600,19698,4464,15668,2364,2932,5600,3441,1331,11466,10349,1117,10349,2172,8177,2017-01-01,zipcode,Webster
ZCTA5 77611,48,8325,69897,792,142500,6482,2168,5595,397,1936,2323,774,165,3353,3078,275,3078,2385,693,2017-01-01,zipcode,Bridge city
ZCTA5 77612,48,9134,49479,802,99600,7527,4236,6351,595,3259,1982,403,112,4024,3116,908,3116,2629,487,2017-01-01,zipcode,Buna
ZCTA5 77613,48,1048,53875,728,112800,907,399,888,119,453,229,46,41,512,471,41,471,361,110,2017-01-01,zipcode,China
ZCTA5 77614,48,516,-666666666,-666666666,61800,466,306,435,70,265,100,0,0,335,214,121,214,151,63,2017-01-01,zipcode,Deweyville
ZCTA5 77615,48,1049,59474,498,80400,778,348,691,76,408,191,11,5,436,332,104,332,302,30,2017-01-01,zipcode,Evadale
ZCTA5 77616,48,535,39574,-666666666,81100,495,216,447,42,244,122,39,0,458,256,202,256,250,6,2017-01-01,zipcode,Fred
ZCTA5 77617,48,64,-666666666,-666666666,263600,64,49,64,8,7,18,31,0,151,48,103,48,48,0,2017-01-01,zipcode,
ZCTA5 77619,48,15775,52992,878,104900,12503,5190,10606,1226,4219,3629,1211,321,6510,5952,558,5952,4165,1787,2017-01-01,zipcode,Groves
ZCTA5 77622,48,1464,83875,765,121200,1119,493,953,69,440,274,139,31,530,475,55,475,433,42,2017-01-01,zipcode,Hamshire
ZCTA5 77623,48,515,49868,1045,79400,411,169,386,31,153,131,53,18,257,176,81,176,140,36,2017-01-01,zipcode,High island
ZCTA5 77624,48,630,64158,993,108500,544,272,495,81,222,119,73,0,387,309,78,309,240,69,2017-01-01,zipcode,Hillister
ZCTA5 77625,48,9691,60098,772,84600,7609,2979,6312,862,2690,1869,436,455,3964,3310,654,3310,2810,500,2017-01-01,zipcode,Kountze
ZCTA5 77627,48,21198,66493,886,133100,17494,5998,14642,673,4805,5550,2362,1252,9771,8792,979,8792,6256,2536,2017-01-01,zipcode,Nederland
ZCTA5 77629,48,634,49079,505,98000,498,208,422,84,113,132,67,26,289,250,39,250,201,49,2017-01-01,zipcode,Nome
ZCTA5 77630,48,28740,47638,783,98900,22545,8937,19520,2328,7221,6872,2205,894,13393,11704,1689,11704,7780,3924,2017-01-01,zipcode,Orange
ZCTA5 77632,48,23475,61387,787,119300,18436,7651,15605,1361,5938,5397,2286,623,9921,8656,1265,8656,7195,1461,2017-01-01,zipcode,Orange
ZCTA5 77640,48,15964,33114,812,63900,12270,5857,10657,2023,4043,3003,1150,438,8271,6428,1843,6428,3993,2435,2017-01-01,zipcode,Port arthur
ZCTA5 77642,48,38845,32266,713,64000,28437,13024,23655,7181,8144,5997,1652,681,16039,13790,2249,13790,7320,6470,2017-01-01,zipcode,Port arthur
ZCTA5 77650,48,1611,46250,831,196000,1338,573,1125,166,276,308,190,185,2675,674,2001,674,496,178,2017-01-01,zipcode,Port bolivar
ZCTA5 77651,48,12840,61976,800,155000,10429,3765,9057,737,2640,3498,1460,722,5496,5090,406,5090,3800,1290,2017-01-01,zipcode,Port neches
ZCTA5 77655,48,346,50000,-666666666,94300,306,148,248,52,111,66,19,0,166,140,26,140,127,13,2017-01-01,zipcode,Sabine pass
ZCTA5 77656,48,16362,46689,697,91100,12985,6028,11362,1650,4402,4011,996,303,7699,6343,1356,6343,4863,1480,2017-01-01,zipcode,Silsbee
ZCTA5 77657,48,21427,65956,815,153300,16564,6371,14042,1246,4949,4862,2077,908,8656,8001,655,8001,6346,1655,2017-01-01,zipcode,Lumberton
ZCTA5 77659,48,4722,66667,819,150500,3577,1367,3206,265,1118,902,663,258,2033,1740,293,1740,1460,280,2017-01-01,zipcode,Sour lake
ZCTA5 77660,48,1182,63750,-666666666,63700,918,449,829,150,306,309,47,17,622,395,227,395,347,48,2017-01-01,zipcode,Spurger
ZCTA5 77661,48,852,-666666666,-666666666,86300,649,364,396,151,146,72,14,13,332,244,88,244,184,60,2017-01-01,zipcode,Stowell
ZCTA5 77662,48,26394,47781,719,90600,20513,8866,17246,2268,7364,5624,1620,370,11231,9817,1414,9817,7722,2095,2017-01-01,zipcode,Vidor
ZCTA5 77663,48,1283,59702,-666666666,161200,1018,684,961,100,293,463,82,23,648,504,144,504,504,0,2017-01-01,zipcode,Village mills
ZCTA5 77664,48,2229,68977,-666666666,85600,1874,945,1632,137,769,595,99,32,1192,874,318,874,785,89,2017-01-01,zipcode,Warren
ZCTA5 77665,48,6252,45718,812,118900,4855,1822,4207,870,1687,1014,472,164,2713,2287,426,2287,1739,548,2017-01-01,zipcode,Winnie
ZCTA5 77701,48,13216,27309,683,56800,9953,4523,8379,2463,3151,2119,502,144,6297,4980,1317,4980,2699,2281,2017-01-01,zipcode,Beaumont
ZCTA5 77702,48,3091,44940,847,85400,2353,689,2033,224,583,755,337,134,1524,1181,343,1181,574,607,2017-01-01,zipcode,Beaumont
ZCTA5 77703,48,14288,29007,691,62200,10643,4629,8849,2034,3671,2565,496,83,6358,5315,1043,5315,2661,2654,2017-01-01,zipcode,Beaumont
ZCTA5 77705,48,40819,38356,715,77500,34547,21718,28278,6250,10351,8664,2026,987,12539,10896,1643,10896,6892,4004,2017-01-01,zipcode,Beaumont
ZCTA5 77706,48,29249,63261,844,167200,23692,8615,20557,1031,4193,7029,5323,2981,14011,12807,1204,12807,7286,5521,2017-01-01,zipcode,Beaumont
ZCTA5 77707,48,17954,52611,909,104400,14079,5293,11490,1451,3286,4034,1841,878,7051,6541,510,6541,4729,1812,2017-01-01,zipcode,Beaumont
ZCTA5 77708,48,12288,45552,858,101700,8961,3221,7331,660,2379,2849,867,576,5148,4545,603,4545,2602,1943,2017-01-01,zipcode,Beaumont
ZCTA5 77713,48,14402,60127,1059,139900,11590,3889,9899,937,2793,3227,2318,624,6699,5930,769,5930,3679,2251,2017-01-01,zipcode,Beaumont
ZCTA5 77801,48,16759,32060,799,106000,13290,4267,8278,2440,1634,1911,1182,1111,7525,6588,937,6588,1126,5462,2017-01-01,zipcode,Bryan
ZCTA5 77802,48,26185,54451,933,160900,21288,7042,17695,1390,3389,5320,4458,3138,11814,11074,740,11074,5651,5423,2017-01-01,zipcode,Bryan
ZCTA5 77803,48,30609,37895,799,84900,22646,8823,18216,6056,6238,4474,1099,349,10247,9237,1010,9237,5362,3875,2017-01-01,zipcode,Bryan
ZCTA5 77807,48,10288,59004,838,157100,7958,3104,6365,1231,1895,1765,947,527,3913,3315,598,3315,2087,1228,2017-01-01,zipcode,Bryan
ZCTA5 77808,48,10849,69038,1006,187800,8487,2953,7526,1143,1867,2262,1342,912,4475,4152,323,4152,3762,390,2017-01-01,zipcode,Bryan
ZCTA5 77830,48,2830,57422,445,180600,2184,942,1927,221,625,666,268,147,1360,1053,307,1053,905,148,2017-01-01,zipcode,Anderson
ZCTA5 77831,48,3115,47565,713,126100,2450,1212,2260,266,1053,580,223,138,1778,1276,502,1276,1133,143,2017-01-01,zipcode,Bedias
ZCTA5 77833,48,29060,54721,845,173200,23233,10019,18741,2985,5551,5666,3155,1384,11902,9725,2177,9725,7350,2375,2017-01-01,zipcode,Brenham
ZCTA5 77835,48,2603,66304,-666666666,122900,2231,936,2177,207,848,466,459,197,1935,1210,725,1210,1002,208,2017-01-01,zipcode,Burton
ZCTA5 77836,48,12022,57215,765,108900,9693,4060,8496,1779,3328,2078,857,454,5643,4395,1248,4395,3424,971,2017-01-01,zipcode,Caldwell
ZCTA5 77837,48,1889,35950,652,95400,1488,602,1211,175,541,332,100,63,929,643,286,643,426,217,2017-01-01,zipcode,Calvert
ZCTA5 77840,48,59673,23426,890,167800,54111,25606,18438,1678,2596,5408,4228,4528,24202,21053,3149,21053,2665,18388,2017-01-01,zipcode,College station
ZCTA5 77845,48,59512,76230,1146,224000,46788,13939,34377,1745,4461,8213,10470,9488,23360,21934,1426,21934,14532,7402,2017-01-01,zipcode,College station
ZCTA5 77853,48,1287,60690,711,103900,1098,464,946,235,273,240,134,64,728,510,218,510,429,81,2017-01-01,zipcode,Dime box
ZCTA5 77855,48,72,-666666666,-666666666,-666666666,72,32,72,19,13,24,16,0,172,37,135,37,37,0,2017-01-01,zipcode,Flynn
ZCTA5 77856,48,5037,46212,725,115900,4033,1695,3521,377,1100,1273,563,208,2884,2024,860,2024,1543,481,2017-01-01,zipcode,Franklin
ZCTA5 77857,48,664,52188,575,201700,521,265,471,72,180,134,61,24,398,281,117,281,230,51,2017-01-01,zipcode,Gause
ZCTA5 77859,48,7393,57226,668,84900,5489,2066,4732,1124,1741,1289,389,189,3186,2579,607,2579,1962,617,2017-01-01,zipcode,Hearne
ZCTA5 77861,48,2452,58135,733,131100,2005,815,1819,293,670,527,231,98,1194,959,235,959,859,100,2017-01-01,zipcode,Iola
ZCTA5 77864,48,6935,42609,786,96900,5232,2189,4562,874,1609,1301,600,178,3487,2888,599,2888,2042,846,2017-01-01,zipcode,Madisonville
ZCTA5 77865,48,1778,45293,623,112000,1533,959,1262,174,469,416,178,25,1037,723,314,723,685,38,2017-01-01,zipcode,Marquez
ZCTA5 77867,48,93,40833,-666666666,84100,77,29,73,30,22,13,3,5,55,44,11,44,39,5,2017-01-01,zipcode,Mumford
ZCTA5 77868,48,17027,48051,679,108700,13667,7451,11407,2888,3997,3096,932,494,5618,4800,818,4800,3425,1375,2017-01-01,zipcode,Navasota
ZCTA5 77871,48,2568,50500,767,132500,2254,1010,2066,261,874,446,258,227,1698,1126,572,1126,868,258,2017-01-01,zipcode,Normangee
ZCTA5 77872,48,1577,44444,533,102000,1200,551,1060,133,471,291,110,55,869,638,231,638,572,66,2017-01-01,zipcode,North zulch
ZCTA5 77873,48,1268,36875,537,84100,939,349,735,117,225,238,112,43,634,490,144,490,398,92,2017-01-01,zipcode,Richards
ZCTA5 77876,48,203,68750,-666666666,-666666666,169,110,169,43,86,31,9,0,147,76,71,76,63,13,2017-01-01,zipcode,Shiro
ZCTA5 77878,48,263,31432,866,-666666666,201,98,163,33,33,91,6,0,193,131,62,131,77,54,2017-01-01,zipcode,Snook
ZCTA5 77879,48,5251,48792,710,84600,4150,1683,3608,466,1644,994,270,234,3100,1991,1109,1991,1610,381,2017-01-01,zipcode,Somerville
ZCTA5 77880,48,1397,54255,825,112800,1156,473,1096,216,261,363,155,101,1053,599,454,599,514,85,2017-01-01,zipcode,Washington
ZCTA5 77901,48,43424,44663,843,89700,32936,11301,26353,6316,9149,7372,2368,1148,17019,14823,2196,14823,7661,7162,2017-01-01,zipcode,Victoria
ZCTA5 77904,48,27570,74694,954,174300,21616,7924,18714,1510,4489,6916,3915,1884,11184,10457,727,10457,7436,3021,2017-01-01,zipcode,Victoria
ZCTA5 77905,48,14326,71619,882,142700,11313,4052,10025,1378,3338,3649,1146,514,5796,5334,462,5334,4657,677,2017-01-01,zipcode,Victoria
ZCTA5 77950,48,173,49375,535,97500,160,74,157,28,41,57,18,13,159,89,70,89,73,16,2017-01-01,zipcode,Austwell
ZCTA5 77951,48,2059,33977,583,48800,1633,659,1453,460,590,345,58,0,813,649,164,649,448,201,2017-01-01,zipcode,Bloomington
ZCTA5 77954,48,12256,59512,835,112400,9694,4746,8617,1623,3463,2386,808,337,4533,3810,723,3810,2608,1202,2017-01-01,zipcode,Cuero
ZCTA5 77957,48,8494,53019,822,103200,6648,2511,5609,857,1795,1858,762,337,3696,3089,607,3089,2067,1022,2017-01-01,zipcode,Edna
ZCTA5 77960,48,42,-666666666,-666666666,-666666666,42,28,42,0,28,0,14,0,58,14,44,14,14,0,2017-01-01,zipcode,Fannin
ZCTA5 77961,48,252,96378,-666666666,111200,195,77,195,0,34,112,49,0,206,100,106,100,100,0,2017-01-01,zipcode,Francitas
ZCTA5 77962,48,3178,56270,912,97400,2383,881,2035,418,787,549,244,37,1249,1055,194,1055,816,239,2017-01-01,zipcode,Ganado
ZCTA5 77963,48,5991,54010,656,121300,4861,2368,4088,447,1284,1585,478,294,2925,2185,740,2185,1770,415,2017-01-01,zipcode,Goliad
ZCTA5 77964,48,8269,52313,638,159600,6604,2735,5911,858,2529,1483,712,329,4614,3270,1344,3270,2461,809,2017-01-01,zipcode,Hallettsville
ZCTA5 77968,48,3054,68468,597,174000,2389,919,2097,119,675,795,353,155,1325,1144,181,1144,1016,128,2017-01-01,zipcode,Inez
ZCTA5 77969,48,158,-666666666,-666666666,-666666666,122,47,110,0,49,47,14,0,98,41,57,41,23,18,2017-01-01,zipcode,La salle
ZCTA5 77970,48,378,51792,577,-666666666,351,126,290,86,97,72,33,2,242,196,46,196,94,102,2017-01-01,zipcode,La ward
ZCTA5 77971,48,1078,79702,695,82800,777,193,777,93,213,334,137,0,567,420,147,420,284,136,2017-01-01,zipcode,Lolita
ZCTA5 77973,48,0,-666666666,-666666666,-666666666,0,0,0,0,0,0,0,0,0,0,0,0,0,0,2017-01-01,zipcode,Mcfaddin
ZCTA5 77974,48,382,97143,1083,162500,275,63,268,24,92,94,45,13,202,142,60,142,121,21,2017-01-01,zipcode,Meyersville
ZCTA5 77975,48,1942,63333,746,123600,1553,699,1359,263,560,356,108,72,1088,736,352,736,522,214,2017-01-01,zipcode,Moulton
ZCTA5 77976,48,89,-666666666,-666666666,147900,81,32,76,0,43,21,0,12,50,38,12,38,33,5,2017-01-01,zipcode,Nursery
ZCTA5 77977,48,747,33659,606,59200,598,257,455,216,141,82,3,13,274,254,20,254,201,53,2017-01-01,zipcode,Placedo
ZCTA5 77978,48,774,62143,1029,76100,564,152,451,47,172,187,20,25,424,316,108,316,178,138,2017-01-01,zipcode,Point comfort
ZCTA5 77979,48,17526,59675,761,110800,13659,5157,11688,2333,3789,3613,1291,662,8045,6205,1840,6205,4320,1885,2017-01-01,zipcode,Port lavaca
ZCTA5 77982,48,1070,59938,-666666666,186600,834,320,707,83,178,316,103,27,1690,345,1345,345,281,64,2017-01-01,zipcode,Port o connor
ZCTA5 77983,48,2351,48971,685,150500,1823,944,1509,356,556,394,161,42,1328,800,528,800,612,188,2017-01-01,zipcode,Seadrift
ZCTA5 77984,48,3954,51652,670,163600,3117,1412,2778,384,1083,702,448,161,2122,1567,555,1567,1285,282,2017-01-01,zipcode,Shiner
ZCTA5 77987,48,352,75313,-666666666,88500,262,93,221,31,81,66,41,2,144,128,16,128,115,13,2017-01-01,zipcode,Sweet home
ZCTA5 77988,48,565,-666666666,-666666666,120100,350,159,287,67,51,102,29,38,179,164,15,164,142,22,2017-01-01,zipcode,Telferner
ZCTA5 77990,48,864,41791,769,80800,634,267,575,115,155,210,84,11,571,325,246,325,221,104,2017-01-01,zipcode,Tivoli
ZCTA5 77991,48,614,68636,1267,68200,322,112,234,19,117,88,0,10,144,108,36,108,67,41,2017-01-01,zipcode,Vanderbilt
ZCTA5 77993,48,183,-666666666,-666666666,1048900,183,82,160,0,105,44,6,5,113,56,57,56,37,19,2017-01-01,zipcode,Weesatche
ZCTA5 77994,48,508,35500,-666666666,-666666666,404,171,358,32,186,68,72,0,314,210,104,210,173,37,2017-01-01,zipcode,Westhoff
ZCTA5 77995,48,9847,46958,638,96700,7610,3199,6450,1158,2875,1570,717,130,4515,3743,772,3743,2829,914,2017-01-01,zipcode,Yoakum
ZCTA5 78001,48,0,-666666666,-666666666,-666666666,0,0,0,0,0,0,0,0,0,0,0,0,0,0,2017-01-01,zipcode,Artesia wells
ZCTA5 78002,48,7904,44907,785,103700,6347,2870,5420,1610,1973,1505,276,56,2216,2056,160,2056,1571,485,2017-01-01,zipcode,Atascosa
ZCTA5 78003,48,8958,59181,912,171800,7641,3809,6967,1074,2243,2151,1014,485,4749,3538,1211,3538,2986,552,2017-01-01,zipcode,Bandera
ZCTA5 78004,48,879,112946,-666666666,339300,796,315,719,21,252,203,85,158,345,332,13,332,332,0,2017-01-01,zipcode,Bergheim
ZCTA5 78005,48,870,-666666666,-666666666,139400,703,388,673,190,216,160,80,27,279,279,0,279,279,0,2017-01-01,zipcode,Bigfoot
ZCTA5 78006,48,31709,79196,1124,295700,24913,9911,21985,1073,4639,7144,6355,2774,12280,11169,1111,11169,8088,3081,2017-01-01,zipcode,Boerne
ZCTA5 78007,48,165,71250,-666666666,106300,121,53,102,19,63,11,9,0,78,39,39,39,22,17,2017-01-01,zipcode,Calliham
ZCTA5 78008,48,210,117833,-666666666,108900,210,122,210,142,0,0,42,26,277,136,141,136,115,21,2017-01-01,zipcode,Campbellton
ZCTA5 78009,48,8910,57744,949,152100,6844,2618,5802,1029,1595,2006,806,366,3001,2778,223,2778,2311,467,2017-01-01,zipcode,Castroville
ZCTA5 78010,48,3401,53333,812,163100,2740,1250,2357,404,577,881,353,142,1564,1260,304,1260,1012,248,2017-01-01,zipcode,Center point
ZCTA5 78011,48,2030,40705,725,47100,1598,685,1365,468,570,231,36,60,813,658,155,658,517,141,2017-01-01,zipcode,Charlotte
ZCTA5 78012,48,362,47083,-666666666,62300,286,136,254,77,94,52,7,24,198,135,63,135,122,13,2017-01-01,zipcode,Christine
ZCTA5 78013,48,6574,73264,811,161500,5310,1538,4189,838,1442,1228,464,217,2366,1900,466,1900,1459,441,2017-01-01,zipcode,Comfort
ZCTA5 78014,48,5616,42741,539,73900,4584,2152,3780,1123,1511,602,405,139,2496,1847,649,1847,1318,529,2017-01-01,zipcode,Cotulla
ZCTA5 78015,48,13897,121287,1567,415200,11037,4227,9651,183,1286,2643,3502,2037,4840,4605,235,4605,4075,530,2017-01-01,zipcode,Boerne
ZCTA5 78016,48,8895,49955,586,94000,6954,2906,5998,1418,1835,1816,683,246,3808,3185,623,3185,2515,670,2017-01-01,zipcode,Devine
ZCTA5 78017,48,5514,37292,747,51100,4333,2516,3108,963,1072,736,215,122,1562,1112,450,1112,619,493,2017-01-01,zipcode,Dilley
ZCTA5 78019,48,1505,41875,770,54300,1266,810,1055,439,378,140,90,8,630,383,247,383,257,126,2017-01-01,zipcode,Encinal
ZCTA5 78021,48,342,-666666666,-666666666,-666666666,263,242,263,70,172,5,16,0,225,91,134,91,86,5,2017-01-01,zipcode,Fowlerton
ZCTA5 78022,48,4286,51000,823,89400,3397,1693,3038,719,922,1003,313,81,2286,1398,888,1398,1091,307,2017-01-01,zipcode,George west
ZCTA5 78023,48,29872,122706,1402,283900,22703,7749,18835,902,2727,5842,5274,4090,9159,8836,323,8836,8085,751,2017-01-01,zipcode,Helotes
ZCTA5 78024,48,1332,49805,560,280400,1187,627,1149,41,283,281,296,248,1084,545,539,545,413,132,2017-01-01,zipcode,Hunt
ZCTA5 78025,48,4523,49099,843,111200,3662,1496,3011,438,1009,927,405,232,2186,1721,465,1721,1390,331,2017-01-01,zipcode,Ingram
ZCTA5 78026,48,6094,53342,946,76800,4520,1870,3751,1047,1676,736,204,88,2382,2023,359,2023,1456,567,2017-01-01,zipcode,Jourdanton
ZCTA5 78027,48,569,99130,-666666666,327700,443,244,417,40,92,60,169,56,244,162,82,162,116,46,2017-01-01,zipcode,Kendalia
ZCTA5 78028,48,39626,47868,805,166000,33074,15641,28918,3212,7980,10053,4966,2707,18512,16545,1967,16545,11473,5072,2017-01-01,zipcode,Kerrville
ZCTA5 78029,48,0,-666666666,-666666666,-666666666,0,0,0,0,0,0,0,0,0,0,0,0,0,0,2017-01-01,zipcode,Kerrville
ZCTA5 78039,48,1528,58047,598,88500,1279,390,1058,181,336,262,254,25,621,557,64,557,483,74,2017-01-01,zipcode,La coste
ZCTA5 78040,48,42324,24622,641,74900,29257,15021,23562,11297,6423,4267,1199,376,13596,11524,2072,11524,5041,6483,2017-01-01,zipcode,Laredo
ZCTA5 78041,48,46671,41912,791,146200,35124,15456,28152,8207,7306,6193,4083,2363,15303,13857,1446,13857,7572,6285,2017-01-01,zipcode,Laredo
ZCTA5 78043,48,44762,33252,767,94900,31356,13361,23956,8895,7030,5007,2026,998,13646,12199,1447,12199,6975,5224,2017-01-01,zipcode,Laredo
ZCTA5 78044,48,451,41250,-666666666,-666666666,329,219,319,184,77,35,23,0,306,104,202,104,62,42,2017-01-01,zipcode,Laredo
ZCTA5 78045,48,64705,67787,1145,164900,45665,13769,36627,5198,8008,11402,8549,3470,19268,18358,910,18358,14190,4168,2017-01-01,zipcode,Laredo
ZCTA5 78046,48,69471,33839,800,84900,45250,20711,33870,15136,10478,5790,2090,376,17037,15866,1171,15866,11431,4435,2017-01-01,zipcode,Laredo
ZCTA5 78050,48,448,29539,548,78400,360,205,332,152,140,4,36,0,205,189,16,189,86,103,2017-01-01,zipcode,Leming
ZCTA5 78052,48,6838,61827,688,109400,5170,2137,4299,871,1655,1152,362,259,2276,2035,241,2035,1653,382,2017-01-01,zipcode,Lytle
ZCTA5 78055,48,1945,43702,800,165600,1667,1103,1382,233,565,289,174,121,1071,635,436,635,477,158,2017-01-01,zipcode,Medina
ZCTA5 78056,48,2131,96324,-666666666,348200,1860,819,1713,14,477,461,462,299,984,756,228,756,717,39,2017-01-01,zipcode,Mico
ZCTA5 78057,48,627,33309,-666666666,-666666666,565,136,475,96,90,177,66,46,350,267,83,267,246,21,2017-01-01,zipcode,Moore
ZCTA5 78058,48,1032,86875,427,-666666666,940,408,886,128,104,337,173,144,764,430,334,430,389,41,2017-01-01,zipcode,Mountain home
ZCTA5 78059,48,6131,62885,666,133200,5191,2298,4397,842,1769,1057,491,238,2436,2004,432,2004,1851,153,2017-01-01,zipcode,Natalia
ZCTA5 78060,48,30,-666666666,-666666666,-666666666,30,0,30,0,12,0,0,18,12,12,0,12,12,0,2017-01-01,zipcode,Oakville
ZCTA5 78061,48,12595,40181,740,76900,9666,4618,7563,2873,2669,1569,376,76,3879,3003,876,3003,2093,910,2017-01-01,zipcode,Pearsall
ZCTA5 78063,48,9936,57514,854,160100,8275,3606,7557,839,2063,2733,1289,633,5241,3849,1392,3849,3310,539,2017-01-01,zipcode,Pipe creek
ZCTA5 78064,48,15966,66633,861,144500,11884,4732,10473,1742,3793,2742,1427,769,6073,5466,607,5466,3826,1640,2017-01-01,zipcode,Pleasanton
ZCTA5 78065,48,10181,49670,695,86600,7733,2867,6161,1659,2480,1414,473,135,3878,3117,761,3117,2356,761,2017-01-01,zipcode,Poteet
ZCTA5 78066,48,538,65352,-666666666,-666666666,318,62,183,0,65,33,64,21,156,133,23,133,103,30,2017-01-01,zipcode,Rio medina
ZCTA5 78067,48,695,55977,-666666666,105000,524,223,494,192,129,84,32,57,408,247,161,247,197,50,2017-01-01,zipcode,San ygnacio
ZCTA5 78069,48,5874,45135,750,88800,4203,1672,3495,890,1129,1167,231,78,1924,1656,268,1656,1323,333,2017-01-01,zipcode,Somerset
ZCTA5 78070,48,15559,87643,1183,294300,12747,5117,11255,664,2681,4115,2445,1350,6034,5585,449,5585,4974,611,2017-01-01,zipcode,Spring branch
ZCTA5 78071,48,4510,53750,634,83200,3780,2330,3355,698,1319,1079,187,72,1624,1048,576,1048,836,212,2017-01-01,zipcode,Three rivers
ZCTA5 78072,48,404,71875,540,65900,301,117,285,43,92,76,40,34,267,145,122,145,117,28,2017-01-01,zipcode,Tilden
ZCTA5 78073,48,9269,44385,706,69600,6661,2672,5523,1921,1932,1361,184,125,2638,2383,255,2383,1794,589,2017-01-01,zipcode,Von ormy
ZCTA5 78075,48,166,134375,-666666666,124000,132,0,61,0,36,17,8,0,51,38,13,38,25,13,2017-01-01,zipcode,Whitsett
ZCTA5 78076,48,13202,33914,508,60600,9180,3796,7257,3158,1844,1435,609,211,5636,4067,1569,4067,2944,1123,2017-01-01,zipcode,Zapata
ZCTA5 78101,48,6911,85400,1018,205500,5877,2300,4984,518,1972,1296,733,465,2540,2288,252,2288,2147,141,2017-01-01,zipcode,Adkins
ZCTA5 78102,48,28648,45246,866,81100,23168,14038,19416,5382,6851,5469,1040,674,8884,7216,1668,7216,4289,2927,2017-01-01,zipcode,Beeville
ZCTA5 78104,48,65,63194,-666666666,-666666666,65,28,55,0,40,11,4,0,60,35,25,35,26,9,2017-01-01,zipcode,Beeville
ZCTA5 78107,48,296,26442,-666666666,67500,196,70,169,42,83,44,0,0,132,117,15,117,52,65,2017-01-01,zipcode,Berclair
ZCTA5 78108,48,35986,89919,1643,205200,26380,8713,22051,1150,4660,7880,4934,3427,11668,11132,536,11132,8932,2200,2017-01-01,zipcode,Cibolo
ZCTA5 78109,48,40093,65220,1173,136200,29033,9494,23132,2574,5965,9443,3323,1827,12725,11853,872,11853,8425,3428,2017-01-01,zipcode,Converse
ZCTA5 78112,48,8129,51131,857,81200,5999,2302,4999,1266,1751,1574,345,63,2372,2190,182,2190,1850,340,2017-01-01,zipcode,Elmendorf
ZCTA5 78113,48,2877,64767,1014,152800,2231,796,1966,180,786,531,397,72,1287,1074,213,1074,816,258,2017-01-01,zipcode,Falls city
ZCTA5 78114,48,22409,64631,857,149700,17455,7407,14862,2792,5118,4634,1519,799,8268,7438,830,7438,5880,1558,2017-01-01,zipcode,Floresville
ZCTA5 78116,48,362,86000,-666666666,219600,283,135,265,53,112,58,28,14,257,142,115,142,125,17,2017-01-01,zipcode,Gillett
ZCTA5 78117,48,453,97500,738,212100,441,204,380,48,147,118,56,11,255,192,63,192,159,33,2017-01-01,zipcode,Hobson
ZCTA5 78118,48,3862,47750,760,87100,2975,1494,2511,665,892,521,348,85,1522,1092,430,1092,780,312,2017-01-01,zipcode,Karnes city
ZCTA5 78119,48,7521,48286,591,81700,6323,3931,5163,1490,1893,1335,284,161,2690,1861,829,1861,1403,458,2017-01-01,zipcode,Kenedy
ZCTA5 78121,48,12726,90566,1105,230500,9819,3312,8447,799,2615,2723,1648,662,4548,4249,299,4249,3843,406,2017-01-01,zipcode,La vernia
ZCTA5 78122,48,291,50353,-666666666,-666666666,260,92,244,64,114,20,17,29,231,137,94,137,114,23,2017-01-01,zipcode,Leesville
ZCTA5 78123,48,2527,56310,825,135100,2097,748,1932,296,716,619,218,83,1361,1114,247,1114,819,295,2017-01-01,zipcode,Mc queeney
ZCTA5 78124,48,5961,63196,866,156800,4932,2109,4352,431,1627,1432,605,257,2254,2155,99,2155,1788,367,2017-01-01,zipcode,Marion
ZCTA5 78125,48,75,51875,-666666666,-666666666,73,34,65,14,8,25,3,15,86,38,48,38,31,7,2017-01-01,zipcode,Mineral
ZCTA5 78130,48,70055,60370,1087,176800,53530,17637,46355,5283,13424,14357,10068,3223,27863,24974,2889,24974,16059,8915,2017-01-01,zipcode,New braunfels
ZCTA5 78132,48,26918,95979,1039,328400,21549,8758,18336,620,3875,5149,5668,3024,10013,9376,637,9376,8114,1262,2017-01-01,zipcode,New braunfels
ZCTA5 78133,48,18942,58540,1030,198900,16043,7309,14056,1048,4082,4791,2619,1516,10241,7702,2539,7702,6148,1554,2017-01-01,zipcode,Canyon lake
ZCTA5 78140,48,3736,43333,629,66100,2734,1091,2204,791,954,327,88,44,1401,1172,229,1172,783,389,2017-01-01,zipcode,Nixon
ZCTA5 78141,48,484,53929,688,79000,407,209,360,72,141,91,47,9,356,204,152,204,173,31,2017-01-01,zipcode,Nordheim
ZCTA5 78142,48,153,133214,-666666666,105800,124,53,96,19,33,15,6,23,71,48,23,48,34,14,2017-01-01,zipcode,Normanna
ZCTA5 78143,48,516,-666666666,-666666666,-666666666,299,235,152,74,35,43,0,0,90,90,0,90,90,0,2017-01-01,zipcode,Pandora
ZCTA5 78144,48,40,25769,-666666666,-666666666,40,27,40,0,11,16,0,13,40,40,0,40,16,24,2017-01-01,zipcode,Panna maria
ZCTA5 78145,48,91,64750,-666666666,113800,68,21,60,17,14,29,0,0,41,35,6,35,27,8,2017-01-01,zipcode,Pawnee
ZCTA5 78146,48,559,62031,-666666666,59500,464,200,374,57,119,147,51,0,220,165,55,165,123,42,2017-01-01,zipcode,Pettus
ZCTA5 78147,48,2156,67067,728,131700,1619,446,1307,248,423,391,164,81,744,659,85,659,452,207,2017-01-01,zipcode,Poth
ZCTA5 78148,48,21456,60547,937,156000,16652,5804,14394,1094,3632,5707,2377,1584,8462,7904,558,7904,4516,3388,2017-01-01,zipcode,Universal city
ZCTA5 78150,48,20,-666666666,-666666666,-666666666,20,0,0,0,0,0,0,0,0,0,0,0,0,0,2017-01-01,zipcode,Jbsa randolph
ZCTA5 78151,48,1529,53523,531,102600,1193,512,1069,237,369,313,101,49,674,495,179,495,340,155,2017-01-01,zipcode,Runge
ZCTA5 78152,48,2155,78319,938,186800,1754,621,1558,62,618,498,297,83,764,699,65,699,616,83,2017-01-01,zipcode,Saint hedwig
ZCTA5 78154,48,38293,76451,1190,180200,29373,9973,25038,1971,6101,8190,5593,3183,13910,13305,605,13305,9383,3922,2017-01-01,zipcode,Schertz
ZCTA5 78155,48,47469,51274,833,130800,37996,15177,31442,5284,11576,8741,4019,1822,19233,17324,1909,17324,12234,5090,2017-01-01,zipcode,Seguin
ZCTA5 78159,48,993,57500,556,54300,745,355,584,113,256,164,38,13,466,332,134,332,239,93,2017-01-01,zipcode,Smiley
ZCTA5 78160,48,4424,57045,863,130600,3654,1581,3245,468,1333,911,390,143,1902,1654,248,1654,1334,320,2017-01-01,zipcode,Stockdale
ZCTA5 78161,48,628,42326,-666666666,107900,521,168,443,14,170,162,52,45,308,279,29,279,254,25,2017-01-01,zipcode,Sutherland springs
ZCTA5 78162,48,410,32330,-666666666,72000,305,108,285,36,113,93,43,0,200,119,81,119,102,17,2017-01-01,zipcode,Tuleta
ZCTA5 78163,48,10703,117528,-666666666,335400,8354,3392,7408,517,1786,2251,1753,1101,3838,3637,201,3637,3422,215,2017-01-01,zipcode,Bulverde
ZCTA5 78164,48,3048,39854,623,93300,2589,1324,2368,514,875,617,223,139,2065,1365,700,1365,1204,161,2017-01-01,zipcode,Yorktown
ZCTA5 78201,48,47500,36844,764,87400,37274,14219,31122,9159,9409,7932,2649,1973,18203,16324,1879,16324,7907,8417,2017-01-01,zipcode,San antonio
ZCTA5 78202,48,12178,24744,772,70300,8860,4272,7229,2612,2069,1643,571,334,4583,3785,798,3785,1923,1862,2017-01-01,zipcode,San antonio
ZCTA5 78203,48,6456,31058,771,64600,4904,1862,4103,1403,1121,1012,375,192,2234,1927,307,1927,928,999,2017-01-01,zipcode,San antonio
ZCTA5 78204,48,12454,41556,872,83500,10310,3807,8833,2060,2794,2178,1221,580,4827,4325,502,4325,2432,1893,2017-01-01,zipcode,San antonio
ZCTA5 78205,48,1041,31706,543,350800,1026,428,969,103,159,384,129,194,1361,849,512,849,128,721,2017-01-01,zipcode,San antonio
ZCTA5 78207,48,54071,25517,629,57300,39786,19164,32827,15190,10221,5690,1236,490,17513,15490,2023,15490,7392,8098,2017-01-01,zipcode,San antonio
ZCTA5 78208,48,4704,25618,718,76300,3519,1763,3006,1133,907,760,148,58,1842,1462,380,1462,483,979,2017-01-01,zipcode,San antonio
ZCTA5 78209,48,41274,71538,1032,337500,33903,12600,28926,1816,3243,6916,9385,7566,19991,17804,2187,17804,10210,7594,2017-01-01,zipcode,San antonio
ZCTA5 78210,48,37801,36583,766,84200,29085,11522,24726,7448,7717,6450,2112,999,14220,12754,1466,12754,6902,5852,2017-01-01,zipcode,San antonio
ZCTA5 78211,48,31952,36202,781,66000,24740,9905,20088,8283,6665,4088,747,305,10087,9015,1072,9015,5623,3392,2017-01-01,zipcode,San antonio
ZCTA5 78212,48,28664,42789,775,137900,24328,9834,19581,4034,5026,4428,3471,2622,12780,10784,1996,10784,5041,5743,2017-01-01,zipcode,San antonio
ZCTA5 78213,48,43394,42708,869,114000,34601,11888,27816,4918,7636,9057,3951,2254,17554,16286,1268,16286,7703,8583,2017-01-01,zipcode,San antonio
ZCTA5 78214,48,26013,35072,719,70000,19425,8541,15556,4939,5658,3945,744,270,8165,7555,610,7555,4327,3228,2017-01-01,zipcode,San antonio
ZCTA5 78215,48,2686,59078,1329,-666666666,2532,375,2194,155,210,409,856,564,1795,1619,176,1619,68,1551,2017-01-01,zipcode,San antonio
ZCTA5 78216,48,41042,46186,903,172300,33484,9622,28033,3092,6768,8437,6445,3291,19696,17369,2327,17369,6220,11149,2017-01-01,zipcode,San antonio
ZCTA5 78217,48,33803,45098,895,128400,26822,8518,22314,2161,6593,8350,3366,1844,15410,13986,1424,13986,5862,8124,2017-01-01,zipcode,San antonio
ZCTA5 78218,48,35384,40406,856,100600,27086,10027,22576,3920,6129,7837,3049,1641,13982,12348,1634,12348,5752,6596,2017-01-01,zipcode,San antonio
ZCTA5 78219,48,16376,32795,877,80500,11642,4889,9550,1419,2998,3936,870,327,6078,5718,360,5718,2840,2878,2017-01-01,zipcode,San antonio
ZCTA5 78220,48,16833,28633,840,70100,12473,6081,10591,3283,3513,2683,753,359,6271,5483,788,5483,3075,2408,2017-01-01,zipcode,San antonio
ZCTA5 78221,48,40249,39531,793,79300,30539,12192,24808,7493,9401,6204,1334,376,12623,11591,1032,11591,7155,4436,2017-01-01,zipcode,San antonio
ZCTA5 78222,48,24189,48033,871,105800,18041,7008,14978,2886,5043,4828,1574,647,7870,7150,720,7150,5194,1956,2017-01-01,zipcode,San antonio
ZCTA5 78223,48,54517,40326,786,87400,40658,14956,33707,7879,11719,10272,2987,850,19302,17603,1699,17603,10355,7248,2017-01-01,zipcode,San antonio
ZCTA5 78224,48,21636,47919,892,85300,15966,5915,12734,3410,4606,3564,891,263,5879,5598,281,5598,3400,2198,2017-01-01,zipcode,San antonio
ZCTA5 78225,48,13933,33057,769,66900,10523,4738,9017,2997,3107,2192,651,70,4720,4289,431,4289,2892,1397,2017-01-01,zipcode,San antonio
ZCTA5 78226,48,6755,30199,668,67800,5250,2303,4497,1419,1552,1185,225,116,2972,2365,607,2365,922,1443,2017-01-01,zipcode,San antonio
ZCTA5 78227,48,49793,38804,839,83500,35402,14368,29219,8279,9724,9198,1407,611,15623,14414,1209,14414,7358,7056,2017-01-01,zipcode,San antonio
ZCTA5 78228,48,62371,39317,806,88100,48503,22039,39506,11402,13031,10336,3464,1273,20309,18808,1501,18808,11384,7424,2017-01-01,zipcode,San antonio
ZCTA5 78229,48,32338,38837,895,134700,26293,8194,22383,2472,5607,7123,4146,3035,16111,14014,2097,14014,2272,11742,2017-01-01,zipcode,San antonio
ZCTA5 78230,48,45104,59170,958,210600,36479,11963,30650,2066,4687,8552,9443,5902,20287,18555,1732,18555,9036,9519,2017-01-01,zipcode,San antonio
ZCTA5 78231,48,8453,77045,1136,255300,7029,2468,6101,187,612,1700,2107,1495,3530,3374,156,3374,2435,939,2017-01-01,zipcode,San antonio
ZCTA5 78232,48,38054,70997,1100,221100,31469,9889,27231,932,4251,8597,8190,5261,16493,15784,709,15784,9221,6563,2017-01-01,zipcode,San antonio
ZCTA5 78233,48,47700,56174,1018,122500,37328,12147,31072,3007,9931,11390,4922,1822,17669,16942,727,16942,10040,6902,2017-01-01,zipcode,San antonio
ZCTA5 78234,48,5552,62938,1679,-666666666,3723,851,2021,94,173,1051,481,222,965,912,53,912,59,853,2017-01-01,zipcode,Jbsa ft sam houston
ZCTA5 78235,48,1062,65069,1299,-666666666,887,185,695,119,206,296,42,32,432,419,13,419,0,419,2017-01-01,zipcode,San antonio
ZCTA5 78236,48,7048,73859,1699,-666666666,6216,514,1375,0,134,605,495,141,479,412,67,412,0,412,2017-01-01,zipcode,Jbsa lackland
ZCTA5 78237,48,37508,28273,777,58000,28263,13102,23837,10503,8090,4259,822,163,11734,10856,878,10856,6910,3946,2017-01-01,zipcode,San antonio
ZCTA5 78238,48,25300,45463,910,119600,19402,6414,16628,2261,4951,5983,2544,889,10003,9262,741,9262,4044,5218,2017-01-01,zipcode,San antonio
ZCTA5 78239,48,28373,59844,1124,127300,22401,8804,19118,2443,5482,6943,2707,1543,10209,9086,1123,9086,6512,2574,2017-01-01,zipcode,San antonio
ZCTA5 78240,48,58207,52779,972,156300,46471,14618,38606,2840,6974,13145,10040,5607,26021,23773,2248,23773,8310,15463,2017-01-01,zipcode,San antonio
ZCTA5 78242,48,33219,40789,855,72300,24057,9234,18472,6682,6408,4014,1059,309,9729,8855,874,8855,5035,3820,2017-01-01,zipcode,San antonio
ZCTA5 78243,48,413,-666666666,-666666666,-666666666,413,24,96,0,10,39,47,0,0,0,0,0,0,0,2017-01-01,zipcode,San antonio
ZCTA5 78244,48,30618,60940,1192,112200,23059,7370,18646,2389,4976,7790,2429,1062,9910,9160,750,9160,6377,2783,2017-01-01,zipcode,San antonio
ZCTA5 78245,48,72277,63269,1156,136700,51798,15736,41999,5390,12272,15395,6046,2896,21857,20715,1142,20715,14235,6480,2017-01-01,zipcode,San antonio
ZCTA5 78247,48,52885,72719,1173,162200,40938,11738,35141,2232,8883,13511,7074,3441,18448,17632,816,17632,13441,4191,2017-01-01,zipcode,San antonio
ZCTA5 78248,48,14372,104132,1191,298000,11555,3941,10038,134,1054,2660,3536,2654,5852,5543,309,5543,4298,1245,2017-01-01,zipcode,San antonio
ZCTA5 78249,48,56674,62747,1169,175600,47781,14631,31951,1410,4738,11693,9020,5090,20991,19314,1677,19314,10924,8390,2017-01-01,zipcode,San antonio
ZCTA5 78250,48,60906,64826,1105,134500,46843,14565,39226,3423,9835,15478,7277,3213,19338,18796,542,18796,13937,4859,2017-01-01,zipcode,San antonio
ZCTA5 78251,48,58522,65172,1074,157500,45064,12274,37471,2716,8844,14874,7209,3828,21028,19954,1074,19954,11184,8770,2017-01-01,zipcode,San antonio
ZCTA5 78252,48,10593,56349,1170,109600,7769,3852,6690,1944,1800,2130,690,126,2497,2415,82,2415,1865,550,2017-01-01,zipcode,San antonio
ZCTA5 78253,48,41188,96847,1392,224400,29197,7882,25461,1414,4372,9119,6236,4320,13246,12417,829,12417,10004,2413,2017-01-01,zipcode,San antonio
ZCTA5 78254,48,56329,82330,1234,172700,40732,11456,33503,2121,7034,11660,8531,4157,16899,16376,523,16376,13071,3305,2017-01-01,zipcode,San antonio
ZCTA5 78255,48,14507,120814,1458,300300,10494,3449,9048,256,1120,2549,2865,2258,4579,4358,221,4358,3811,547,2017-01-01,zipcode,San antonio
ZCTA5 78256,48,9423,101140,1274,389300,7604,1907,5481,126,294,1563,2104,1394,4287,3577,710,3577,1535,2042,2017-01-01,zipcode,San antonio
ZCTA5 78257,48,6107,120955,1166,578100,4694,1747,4063,130,513,929,1413,1078,2818,2186,632,2186,1505,681,2017-01-01,zipcode,San antonio
ZCTA5 78258,48,45966,104802,1369,305200,34277,12027,29046,898,2821,7550,10989,6788,16938,15977,961,15977,10475,5502,2017-01-01,zipcode,San antonio
ZCTA5 78259,48,25873,93002,1269,240700,19505,6365,16791,584,2372,4970,5368,3497,9398,8832,566,8832,6437,2395,2017-01-01,zipcode,San antonio
ZCTA5 78260,48,27907,116854,1723,301500,20024,6177,17477,899,2152,5034,5866,3526,8976,8539,437,8539,7522,1017,2017-01-01,zipcode,San antonio
ZCTA5 78261,48,17143,102860,1567,272800,12233,3454,10684,367,1511,3306,3122,2378,5875,5506,369,5506,4401,1105,2017-01-01,zipcode,San antonio
ZCTA5 78263,48,5072,66379,887,186700,4198,1393,3663,378,1353,1219,474,239,1754,1666,88,1666,1422,244,2017-01-01,zipcode,San antonio
ZCTA5 78264,48,10188,49855,898,80300,7721,3175,6014,1549,2083,1785,432,165,3410,2888,522,2888,2412,476,2017-01-01,zipcode,San antonio
ZCTA5 78266,48,6746,114003,1855,374900,5266,2403,4570,164,619,1121,1428,1238,2467,2367,100,2367,2211,156,2017-01-01,zipcode,San antonio
ZCTA5 78330,48,975,42438,790,69700,746,299,645,120,257,167,71,30,373,345,28,345,288,57,2017-01-01,zipcode,Agua dulce
ZCTA5 78332,48,28641,41112,736,72600,21788,9380,18003,4706,6756,4495,1569,477,11031,9597,1434,9597,6404,3193,2017-01-01,zipcode,Alice
ZCTA5 78335,48,0,-666666666,-666666666,-666666666,0,0,0,0,0,0,0,0,0,0,0,0,0,0,2017-01-01,zipcode,Aransas pass
ZCTA5 78336,48,11828,40759,852,120000,9470,4311,7908,2015,2835,2217,590,251,6196,4502,1694,4502,2632,1870,2017-01-01,zipcode,Aransas pass
ZCTA5 78338,48,46,53333,-666666666,-666666666,19,6,19,4,6,0,0,9,12,10,2,10,3,7,2017-01-01,zipcode,Armstrong
ZCTA5 78339,48,433,62917,827,-666666666,390,169,287,70,120,64,33,0,267,171,96,171,96,75,2017-01-01,zipcode,Banquete
ZCTA5 78340,48,461,52500,638,83400,383,199,326,39,101,127,47,12,356,188,168,188,159,29,2017-01-01,zipcode,Bayside
ZCTA5 78341,48,2100,32143,498,43200,1616,734,1368,296,435,393,120,124,1326,864,462,864,585,279,2017-01-01,zipcode,Benavides
ZCTA5 78342,48,361,40521,820,-666666666,299,137,234,73,56,79,11,15,137,124,13,124,73,51,2017-01-01,zipcode,Ben bolt
ZCTA5 78343,48,4374,50172,698,80900,3396,1416,2754,612,813,952,258,119,1888,1496,392,1496,1090,406,2017-01-01,zipcode,Bishop
ZCTA5 78344,48,270,-666666666,-666666666,98000,220,115,207,29,58,58,56,6,211,116,95,116,88,28,2017-01-01,zipcode,Bruni
ZCTA5 78349,48,685,-666666666,-666666666,40500,553,296,475,166,176,115,18,0,424,248,176,248,243,5,2017-01-01,zipcode,Concepcion
ZCTA5 78351,48,391,31875,1063,33100,265,159,213,84,66,49,14,0,197,120,77,120,99,21,2017-01-01,zipcode,Driscoll
ZCTA5 78352,48,271,-666666666,-666666666,24200,161,75,125,50,27,48,0,0,105,81,24,81,81,0,2017-01-01,zipcode,Edroy
ZCTA5 78353,48,206,22391,-666666666,61300,196,135,187,94,43,50,0,0,301,118,183,118,95,23,2017-01-01,zipcode,Encino
ZCTA5 78355,48,7309,25636,600,62500,5452,2512,4153,1269,1186,1036,451,211,2873,1992,881,1992,1230,762,2017-01-01,zipcode,Falfurrias
ZCTA5 78357,48,2912,53891,715,54900,2232,814,1806,405,696,590,114,1,1263,921,342,921,626,295,2017-01-01,zipcode,Freer
ZCTA5 78358,48,682,37933,939,36400,637,288,538,102,167,183,70,16,449,321,128,321,136,185,2017-01-01,zipcode,Fulton
ZCTA5 78359,48,2056,47868,809,61600,1571,515,1225,351,463,309,76,26,768,657,111,657,437,220,2017-01-01,zipcode,Gregory
ZCTA5 78361,48,5357,31990,500,63000,3920,1914,3285,906,1056,935,279,109,2463,1610,853,1610,1228,382,2017-01-01,zipcode,Hebbronville
ZCTA5 78362,48,9907,58565,979,122600,7565,2740,6120,978,2334,1928,624,256,3996,3555,441,3555,2505,1050,2017-01-01,zipcode,Ingleside
ZCTA5 78363,48,29963,41076,799,86900,23548,8856,16393,3571,3707,5145,2758,1212,12438,10454,1984,10454,5386,5068,2017-01-01,zipcode,Kingsville
ZCTA5 78368,48,9620,41830,592,61900,7450,3442,6279,2265,1988,1584,327,115,4229,3271,958,3271,2436,835,2017-01-01,zipcode,Mathis
ZCTA5 78369,48,480,26477,-666666666,52100,328,191,267,107,98,47,15,0,216,139,77,139,101,38,2017-01-01,zipcode,Mirando city
ZCTA5 78370,48,4718,52209,744,79000,3454,1568,3069,839,924,872,288,146,1892,1549,343,1549,1160,389,2017-01-01,zipcode,Odem
ZCTA5 78371,48,307,57500,-666666666,63200,277,136,229,52,78,93,6,0,238,118,120,118,87,31,2017-01-01,zipcode,Oilton
ZCTA5 78372,48,6233,36373,781,83800,4097,1929,3306,774,1359,933,233,7,2277,1773,504,1773,1325,448,2017-01-01,zipcode,Orange grove
ZCTA5 78373,48,4084,53113,1204,250600,3568,1361,3096,57,916,1105,643,375,4902,1993,2909,1993,1201,792,2017-01-01,zipcode,Port aransas
ZCTA5 78374,48,17661,64057,1202,158400,13162,4735,11253,1158,2921,4381,1841,952,6793,6141,652,6141,4009,2132,2017-01-01,zipcode,Portland
ZCTA5 78375,48,3055,36993,729,66700,2394,1187,2107,662,724,422,268,31,1292,1020,272,1020,799,221,2017-01-01,zipcode,Premont
ZCTA5 78376,48,760,36850,528,36600,607,362,558,239,212,91,14,2,398,271,127,271,190,81,2017-01-01,zipcode,Realitos
ZCTA5 78377,48,3770,50688,595,79700,2977,1405,2446,514,820,806,212,94,1787,1398,389,1398,945,453,2017-01-01,zipcode,Refugio
ZCTA5 78379,48,1576,56917,854,78300,1312,530,1011,281,274,230,139,87,748,503,245,503,421,82,2017-01-01,zipcode,Riviera
ZCTA5 78380,48,24126,46709,708,80400,18050,7520,14903,4047,4623,4393,1276,564,8826,7556,1270,7556,5235,2321,2017-01-01,zipcode,Robstown
ZCTA5 78382,48,21537,47039,785,166100,17920,8223,15970,2524,4468,5593,2132,1253,13750,8139,5611,8139,6224,1915,2017-01-01,zipcode,Rockport
ZCTA5 78383,48,4077,56225,618,123100,3266,1663,3113,653,840,1139,251,230,2696,1624,1072,1624,1476,148,2017-01-01,zipcode,Sandia
ZCTA5 78384,48,5635,23480,724,43500,4348,2263,3539,1444,1043,771,177,104,2482,1793,689,1793,1020,773,2017-01-01,zipcode,San diego
ZCTA5 78385,48,483,24375,473,20000,366,214,317,196,78,30,11,2,161,124,37,124,40,84,2017-01-01,zipcode,Sarita
ZCTA5 78387,48,10062,51953,715,70400,7445,2962,6115,1535,2013,1976,385,206,3888,3276,612,3276,2291,985,2017-01-01,zipcode,Sinton
ZCTA5 78389,48,1623,36705,-666666666,65100,1428,768,1085,318,443,251,60,13,625,526,99,526,424,102,2017-01-01,zipcode,Skidmore
ZCTA5 78390,48,5197,39149,739,70400,4124,1737,3297,889,1079,1056,201,72,2291,1806,485,1806,1179,627,2017-01-01,zipcode,Taft
ZCTA5 78391,48,251,50833,-666666666,57500,187,86,155,53,39,41,22,0,100,76,24,76,69,7,2017-01-01,zipcode,Tynan
ZCTA5 78393,48,2130,56250,952,80500,1700,655,1526,300,599,510,89,28,1004,751,253,751,606,145,2017-01-01,zipcode,Woodsboro
ZCTA5 78401,48,5445,24676,668,60900,4804,3104,4180,1198,1460,1103,270,149,2330,1811,519,1811,344,1467,2017-01-01,zipcode,Corpus christi
ZCTA5 78402,48,272,68264,1264,141700,264,112,255,25,49,80,72,29,338,155,183,155,64,91,2017-01-01,zipcode,Corpus christi
ZCTA5 78404,48,18467,41513,899,94700,14689,5723,12624,3117,3451,3110,1680,1266,8212,7170,1042,7170,3492,3678,2017-01-01,zipcode,Corpus christi
ZCTA5 78405,48,15469,27744,686,51300,12195,5401,10158,4729,3179,1788,321,141,6121,5326,795,5326,2940,2386,2017-01-01,zipcode,Corpus christi
ZCTA5 78406,48,1784,53804,1250,54300,1477,1045,1222,449,463,259,51,0,422,364,58,364,322,42,2017-01-01,zipcode,Corpus christi
ZCTA5 78407,48,3456,40776,845,59600,2675,1025,2091,575,815,583,65,53,1438,1202,236,1202,593,609,2017-01-01,zipcode,Corpus christi
ZCTA5 78408,48,12606,36484,711,69400,9183,3317,7772,2501,2767,1976,343,185,4715,4129,586,4129,1953,2176,2017-01-01,zipcode,Corpus christi
ZCTA5 78409,48,2733,55333,683,81500,2068,680,1691,437,533,620,92,9,1142,972,170,972,534,438,2017-01-01,zipcode,Corpus christi
ZCTA5 78410,48,27087,66336,1015,139300,20230,7379,17187,2169,5154,6270,2571,1023,10307,9464,843,9464,6286,3178,2017-01-01,zipcode,Corpus christi
ZCTA5 78411,48,26570,53341,934,113600,21195,7393,18244,2473,4826,6972,2507,1466,11225,10166,1059,10166,6327,3839,2017-01-01,zipcode,Corpus christi
ZCTA5 78412,48,39286,47591,974,120400,31404,11083,22754,2445,6261,8337,3762,1949,15856,14707,1149,14707,6673,8034,2017-01-01,zipcode,Corpus christi
ZCTA5 78413,48,40070,72522,1104,167700,31751,9449,26563,2128,6811,9311,5258,3055,16356,15007,1349,15007,8390,6617,2017-01-01,zipcode,Corpus christi
ZCTA5 78414,48,38343,83847,1174,191700,28505,8588,24671,1213,5231,9120,5629,3478,14678,13884,794,13884,9116,4768,2017-01-01,zipcode,Corpus christi
ZCTA5 78415,48,40496,42995,875,88600,30913,11476,25415,6005,9253,7475,1736,946,14776,13513,1263,13513,7855,5658,2017-01-01,zipcode,Corpus christi
ZCTA5 78416,48,15493,36653,836,69500,11448,4868,10020,3950,3511,2100,413,46,5682,5093,589,5093,3061,2032,2017-01-01,zipcode,Corpus christi
ZCTA5 78417,48,4176,45873,692,82100,3232,1188,2737,853,967,701,190,26,1459,1347,112,1347,1033,314,2017-01-01,zipcode,Corpus christi
ZCTA5 78418,48,31120,64167,1042,171500,25507,8761,21669,2086,6040,7591,3731,2221,15062,12510,2552,12510,7307,5203,2017-01-01,zipcode,Corpus christi
ZCTA5 78419,48,919,51518,1625,-666666666,653,132,396,4,72,179,118,23,215,204,11,204,4,200,2017-01-01,zipcode,Corpus christi
ZCTA5 78501,48,64340,34853,684,98300,49189,20311,40173,13136,8198,9279,7190,2370,23732,20766,2966,20766,10486,10280,2017-01-01,zipcode,Mcallen
ZCTA5 78503,48,22877,32968,807,93200,16622,7504,13616,5042,2917,2345,2399,913,7974,6585,1389,6585,4244,2341,2017-01-01,zipcode,Mcallen
ZCTA5 78504,48,53665,63158,876,148400,39736,13785,32491,4091,5930,10051,8315,4104,18818,17107,1711,17107,11806,5301,2017-01-01,zipcode,Mcallen
ZCTA5 78516,48,35223,32854,547,52600,23950,11073,18596,7723,4949,4148,1378,398,11483,9371,2112,9371,7112,2259,2017-01-01,zipcode,Alamo
ZCTA5 78520,48,62804,32612,613,83800,45557,20036,35328,12891,8460,7552,4600,1825,20075,18022,2053,18022,10953,7069,2017-01-01,zipcode,Brownsville
ZCTA5 78521,48,92975,28935,683,69000,65597,30798,51243,22282,12184,10625,4687,1465,28079,25228,2851,25228,14993,10235,2017-01-01,zipcode,Brownsville
ZCTA5 78526,48,47125,53757,831,108100,33905,13392,26372,7373,5335,6372,5651,1641,13808,12687,1121,12687,9472,3215,2017-01-01,zipcode,Brownsville
ZCTA5 78535,48,678,-666666666,808,63500,508,232,412,141,207,50,0,14,241,213,28,213,160,53,2017-01-01,zipcode,Combes
ZCTA5 78536,48,400,-666666666,-666666666,32800,317,154,231,95,86,33,17,0,135,99,36,99,83,16,2017-01-01,zipcode,Delmita
ZCTA5 78537,48,45606,27961,568,56000,30460,14012,23598,10831,5885,4897,1511,474,14173,11856,2317,11856,8843,3013,2017-01-01,zipcode,Donna
ZCTA5 78538,48,10912,27996,557,52300,7719,3680,6244,2993,1352,1361,459,79,3728,3093,635,3093,2306,787,2017-01-01,zipcode,Edcouch
ZCTA5 78539,48,34991,55507,759,125700,25326,8193,20329,3286,3874,5774,4727,2668,12186,10974,1212,10974,6392,4582,2017-01-01,zipcode,Edinburg
ZCTA5 78541,48,44387,33829,741,82700,31631,12225,23323,7887,5089,5803,3329,1215,14162,12922,1240,12922,6925,5997,2017-01-01,zipcode,Edinburg
ZCTA5 78542,48,75822,36538,606,77700,51442,23127,39536,16941,9385,7900,4082,1228,18601,16874,1727,16874,12716,4158,2017-01-01,zipcode,Edinburg
ZCTA5 78543,48,8886,31994,552,57400,6236,2516,5057,1820,1801,902,428,106,2760,2333,427,2333,1567,766,2017-01-01,zipcode,Elsa
ZCTA5 78545,48,521,-666666666,-666666666,50700,332,152,308,208,56,34,10,0,282,150,132,150,110,40,2017-01-01,zipcode,Falcon heights
ZCTA5 78548,48,649,-666666666,-666666666,47500,509,243,379,220,68,84,7,0,235,163,72,163,159,4,2017-01-01,zipcode,Grulla
ZCTA5 78549,48,925,16000,-666666666,71700,581,385,474,325,89,17,34,9,336,262,74,262,219,43,2017-01-01,zipcode,Hargill
ZCTA5 78550,48,52746,36069,690,80000,37258,15725,30914,9086,8443,8243,3307,1835,19310,16665,2645,16665,8911,7754,2017-01-01,zipcode,Harlingen
ZCTA5 78552,48,38352,48900,816,100000,28185,12606,23570,5719,6075,6704,3456,1616,14336,11775,2561,11775,9281,2494,2017-01-01,zipcode,Harlingen
ZCTA5 78557,48,13859,33627,618,88700,9796,3993,7429,3057,1632,1410,1097,233,3780,3486,294,3486,2526,960,2017-01-01,zipcode,Hidalgo
ZCTA5 78558,48,1121,34593,-666666666,72200,851,308,667,307,248,83,29,0,286,266,20,266,208,58,2017-01-01,zipcode,La blanca
ZCTA5 78559,48,12579,41422,606,69100,9389,4084,8032,2127,2221,2437,1005,242,4518,3826,692,3826,2906,920,2017-01-01,zipcode,La feria
ZCTA5 78560,48,4846,38871,686,83600,3278,1343,2580,1202,587,587,119,85,1543,1328,215,1328,867,461,2017-01-01,zipcode,La joya
ZCTA5 78561,48,772,29712,566,36500,553,256,439,178,133,106,22,0,198,175,23,175,141,34,2017-01-01,zipcode,Lasara
ZCTA5 78562,48,4099,29605,500,45900,3090,2047,2462,1316,681,343,122,0,864,798,66,798,605,193,2017-01-01,zipcode,La villa
ZCTA5 78563,48,167,40446,-666666666,137500,167,109,160,14,60,21,46,19,98,73,25,73,56,17,2017-01-01,zipcode,Linn
ZCTA5 78564,48,171,-666666666,-666666666,-666666666,75,12,75,75,0,0,0,0,66,38,28,38,0,38,2017-01-01,zipcode,Lopeno
ZCTA5 78565,48,133,26080,-666666666,-666666666,133,109,133,63,0,46,0,24,132,73,59,73,51,22,2017-01-01,zipcode,Los ebanos
ZCTA5 78566,48,18120,40008,694,89300,12818,5738,10113,3280,2700,2396,1220,517,5492,4749,743,4749,3540,1209,2017-01-01,zipcode,Los fresnos
ZCTA5 78567,48,521,20938,-666666666,52300,411,172,371,131,133,82,3,22,221,175,46,175,162,13,2017-01-01,zipcode,Los indios
ZCTA5 78569,48,4110,34572,582,57100,3171,1726,2545,644,929,626,243,103,1381,1185,196,1185,1017,168,2017-01-01,zipcode,Lyford
ZCTA5 78570,48,34560,32424,553,59600,22855,9768,18486,7480,4640,4370,1345,651,10664,9049,1615,9049,6433,2616,2017-01-01,zipcode,Mercedes
ZCTA5 78572,48,78770,40705,746,84500,56981,26475,46209,14944,11482,10064,7004,2715,30023,24234,5789,24234,16759,7475,2017-01-01,zipcode,Mission
ZCTA5 78573,48,38420,35740,675,88500,26094,9731,19604,8106,4507,4433,1758,800,10807,9660,1147,9660,6513,3147,2017-01-01,zipcode,Mission
ZCTA5 78574,48,61238,34511,675,79800,40692,16449,31237,14421,6587,5936,3130,1163,17172,15286,1886,15286,11617,3669,2017-01-01,zipcode,Mission
ZCTA5 78575,48,9762,52150,788,127200,7213,3132,5806,1092,1252,1742,1014,706,3443,2838,605,2838,2237,601,2017-01-01,zipcode,Olmito
ZCTA5 78576,48,11044,21825,654,62000,6575,3054,4714,2516,1449,537,195,17,2833,2590,243,2590,1902,688,2017-01-01,zipcode,Penitas
ZCTA5 78577,48,76821,39388,735,74900,52383,22086,42244,15542,10795,9908,4437,1562,24172,21433,2739,21433,13091,8342,2017-01-01,zipcode,Pharr
ZCTA5 78578,48,11727,36191,729,117600,9103,4346,8096,2288,2601,1633,1072,502,6831,4373,2458,4373,3043,1330,2017-01-01,zipcode,Port isabel
ZCTA5 78579,48,4775,44886,561,56700,3644,1414,2701,1280,658,472,195,96,1180,1112,68,1112,913,199,2017-01-01,zipcode,Progreso
ZCTA5 78580,48,14943,28271,578,49500,11688,6606,9280,3369,3506,1626,627,152,4498,3770,728,3770,2755,1015,2017-01-01,zipcode,Raymondville
ZCTA5 78582,48,42644,30634,528,66400,29737,12194,23067,11253,5868,3677,1649,620,12711,10623,2088,10623,8048,2575,2017-01-01,zipcode,Rio grande city
ZCTA5 78583,48,6820,34189,456,59800,5416,2752,4794,1367,1279,1421,443,284,3742,2567,1175,2567,2202,365,2017-01-01,zipcode,Rio hondo
ZCTA5 78584,48,18757,21127,521,71400,13437,6604,10650,6121,2100,1368,778,283,6135,5115,1020,5115,3580,1535,2017-01-01,zipcode,Roma
ZCTA5 78585,48,313,13348,-666666666,-666666666,243,131,214,108,53,41,0,12,191,125,66,125,125,0,2017-01-01,zipcode,Salineno
ZCTA5 78586,48,56086,29535,609,59300,39778,18753,31669,12686,8327,7268,2452,936,18367,15606,2761,15606,11776,3830,2017-01-01,zipcode,San benito
ZCTA5 78588,48,198,-666666666,-666666666,-666666666,161,58,136,23,42,65,3,3,102,66,36,66,51,15,2017-01-01,zipcode,San isidro
ZCTA5 78589,48,40709,35695,644,83300,28536,12102,22592,9587,5319,4741,2082,863,11428,10499,929,10499,8074,2425,2017-01-01,zipcode,San juan
ZCTA5 78590,48,288,26875,-666666666,33400,204,83,184,96,63,25,0,0,91,72,19,72,65,7,2017-01-01,zipcode,San perlita
ZCTA5 78591,48,285,45625,-666666666,-666666666,243,119,202,26,78,82,13,3,126,84,42,84,61,23,2017-01-01,zipcode,Santa elena
ZCTA5 78592,48,936,31339,590,34100,675,325,530,261,130,122,17,0,338,282,56,282,230,52,2017-01-01,zipcode,Santa maria
ZCTA5 78593,48,6114,26705,588,54000,4427,2148,3486,1277,1191,724,261,33,1812,1596,216,1596,1130,466,2017-01-01,zipcode,Santa rosa
ZCTA5 78594,48,1632,19116,-666666666,43900,1243,737,1021,394,315,260,35,17,635,491,144,491,430,61,2017-01-01,zipcode,Sebastian
ZCTA5 78595,48,6330,24012,565,60900,4352,1921,3240,1941,705,411,138,45,1976,1747,229,1747,1421,326,2017-01-01,zipcode,Sullivan city
ZCTA5 78596,48,65013,34339,670,74900,46019,19220,37200,13031,8928,9634,3973,1634,22880,18746,4134,18746,13297,5449,2017-01-01,zipcode,Weslaco
ZCTA5 78597,48,2856,45060,957,288000,2602,1189,2511,253,434,763,554,507,7598,1586,6012,1586,1072,514,2017-01-01,zipcode,South padre island
ZCTA5 78598,48,95,-666666666,-666666666,115600,95,31,95,0,33,31,3,28,429,46,383,46,46,0,2017-01-01,zipcode,Port mansfield
ZCTA5 78602,48,28027,58509,871,165000,22192,10849,19555,3165,5483,6507,2813,1587,10552,9098,1454,9098,6798,2300,2017-01-01,zipcode,Bastrop
ZCTA5 78605,48,5955,63154,869,151200,4887,2094,4042,540,1490,1393,402,217,2253,1938,315,1938,1618,320,2017-01-01,zipcode,Bertram
ZCTA5 78606,48,5552,47500,793,242300,4698,2066,4116,513,1132,1458,727,286,2781,2094,687,2094,1659,435,2017-01-01,zipcode,Blanco
ZCTA5 78607,48,77,21875,-666666666,-666666666,77,69,77,0,23,8,39,7,183,62,121,62,55,7,2017-01-01,zipcode,Bluffton
ZCTA5 78608,48,387,108110,-666666666,160200,344,125,311,41,95,88,87,0,213,162,51,162,104,58,2017-01-01,zipcode,Briggs
ZCTA5 78609,48,1948,40574,743,162900,1798,1064,1684,172,533,653,248,78,1635,949,686,949,740,209,2017-01-01,zipcode,Buchanan dam
ZCTA5 78610,48,32692,76623,1179,224600,24867,6655,21081,1764,4960,6685,5332,2340,11585,11243,342,11243,8774,2469,2017-01-01,zipcode,Buda
ZCTA5 78611,48,13016,54088,832,159000,10279,4376,9087,1230,2890,2886,1354,727,6303,4598,1705,4598,3314,1284,2017-01-01,zipcode,Burnet
ZCTA5 78612,48,12484,59894,1172,145500,9355,3919,8222,1436,2076,2756,1386,568,4148,3824,324,3824,3010,814,2017-01-01,zipcode,Cedar creek
ZCTA5 78613,48,77779,96857,1299,255200,57181,16005,49538,2115,7568,16393,15978,7484,26780,25202,1578,25202,17956,7246,2017-01-01,zipcode,Cedar park
ZCTA5 78614,48,556,65703,838,169300,451,193,433,64,155,126,78,10,251,235,16,235,175,60,2017-01-01,zipcode,Cost
ZCTA5 78615,48,931,43988,875,160900,801,392,698,87,244,195,79,93,423,359,64,359,296,63,2017-01-01,zipcode,Coupland
ZCTA5 78616,48,7518,53457,822,114600,5558,1955,4585,1314,1725,1145,287,114,2739,2372,367,2372,1690,682,2017-01-01,zipcode,Dale
ZCTA5 78617,48,27900,52819,1303,123900,20117,7500,15614,5335,4875,3657,1305,442,7244,6520,724,6520,5049,1471,2017-01-01,zipcode,Del valle
ZCTA5 78618,48,353,80139,860,287500,320,145,304,8,150,89,46,11,289,143,146,143,123,20,2017-01-01,zipcode,Doss
ZCTA5 78619,48,4124,117212,-666666666,445600,3057,1064,2827,185,591,641,821,589,1481,1439,42,1439,1350,89,2017-01-01,zipcode,Driftwood
ZCTA5 78620,48,15452,98125,1113,352300,12068,4159,10603,740,1701,3119,3354,1689,5871,5445,426,5445,4733,712,2017-01-01,zipcode,Dripping springs
ZCTA5 78621,48,22261,58730,914,137300,16466,5723,14535,3275,3935,4790,1851,684,7975,7276,699,7276,5559,1717,2017-01-01,zipcode,Elgin
ZCTA5 78622,48,200,51979,917,41500,182,25,146,40,60,37,9,0,121,79,42,79,59,20,2017-01-01,zipcode,Fentress
ZCTA5 78623,48,781,60208,541,222500,646,345,598,0,140,180,116,162,417,329,88,329,269,60,2017-01-01,zipcode,Fischer
ZCTA5 78624,48,21687,57104,879,278100,17806,7422,16014,1552,4836,4243,3805,1578,10907,9050,1857,9050,6709,2341,2017-01-01,zipcode,Fredericksburg
ZCTA5 78626,48,32529,62860,994,188400,25603,9466,20824,2854,5744,6180,4222,1824,10919,10167,752,10167,6667,3500,2017-01-01,zipcode,Georgetown
ZCTA5 78628,48,30322,84147,1108,267200,24190,9799,21414,1069,4768,6572,5709,3296,11428,10823,605,10823,7932,2891,2017-01-01,zipcode,Georgetown
ZCTA5 78629,48,12341,48507,644,112000,9372,3684,7942,1886,2613,2202,893,348,5290,4300,990,4300,2787,1513,2017-01-01,zipcode,Gonzales
ZCTA5 78631,48,2729,50750,-666666666,202900,2249,968,1874,238,527,592,369,148,1421,1097,324,1097,900,197,2017-01-01,zipcode,Harper
ZCTA5 78632,48,821,43750,975,131400,645,183,639,102,292,153,65,27,466,367,99,367,328,39,2017-01-01,zipcode,Harwood
ZCTA5 78633,48,24727,74375,1608,285300,22403,15150,21210,538,3583,6553,5966,4570,11598,11332,266,11332,10447,885,2017-01-01,zipcode,Georgetown
ZCTA5 78634,48,29770,77092,1232,171300,21326,4889,18380,1592,4893,6502,4000,1393,9398,8805,593,8805,7000,1805,2017-01-01,zipcode,Hutto
ZCTA5 78635,48,214,72012,-666666666,-666666666,214,0,89,0,34,55,0,0,66,66,0,66,25,41,2017-01-01,zipcode,Hye
ZCTA5 78636,48,3882,60226,774,221400,3220,1481,2935,269,857,807,555,447,2179,1541,638,1541,1123,418,2017-01-01,zipcode,Johnson city
ZCTA5 78638,48,2103,54514,682,127400,1684,669,1487,287,455,419,241,85,924,843,81,843,657,186,2017-01-01,zipcode,Kingsbury
ZCTA5 78639,48,8046,41230,834,118500,6855,3497,5939,1129,1785,2093,626,306,4939,3272,1667,3272,2283,989,2017-01-01,zipcode,Kingsland
ZCTA5 78640,48,52981,69014,1339,160500,37598,10610,31634,5800,7799,9826,5701,2508,17012,16074,938,16074,11614,4460,2017-01-01,zipcode,Kyle
ZCTA5 78641,48,60135,88562,1364,213100,44102,11537,38282,3076,7409,13662,9855,4280,19847,18662,1185,18662,15129,3533,2017-01-01,zipcode,Leander
ZCTA5 78642,48,11087,85896,852,258600,8374,2520,7235,614,2014,2619,1486,502,3720,3431,289,3431,2918,513,2017-01-01,zipcode,Liberty hill
ZCTA5 78643,48,5901,53825,753,179000,4984,2262,4579,678,1207,1486,818,390,3662,2257,1405,2257,1692,565,2017-01-01,zipcode,Llano
ZCTA5 78644,48,18287,58005,860,132900,14513,6113,12446,2264,4937,3446,1195,604,6480,5848,632,5848,3875,1973,2017-01-01,zipcode,Lockhart
ZCTA5 78645,48,10705,75761,1096,207300,9175,3498,8510,436,1996,3096,2153,829,6036,4600,1436,4600,3725,875,2017-01-01,zipcode,Leander
ZCTA5 78648,48,7791,43385,650,113900,6081,2780,5210,1272,1757,1392,612,177,3131,2919,212,2919,1982,937,2017-01-01,zipcode,Luling
ZCTA5 78650,48,1663,59769,918,137500,1290,409,1071,219,431,234,154,33,742,573,169,573,453,120,2017-01-01,zipcode,Mc dade
ZCTA5 78652,48,4965,87520,1231,239500,4162,1501,3824,326,981,888,1115,514,2194,1913,281,1913,1330,583,2017-01-01,zipcode,Manchaca
ZCTA5 78653,48,20822,66752,1273,160600,14795,3977,12670,1769,3678,4003,2507,713,6891,6332,559,6332,5210,1122,2017-01-01,zipcode,Manor
ZCTA5 78654,48,18488,56488,822,182400,15138,7002,12633,1759,3341,4226,2202,1105,9466,7111,2355,7111,5326,1785,2017-01-01,zipcode,Marble falls
ZCTA5 78655,48,3415,57009,841,163900,2573,886,2130,647,749,374,189,171,1280,1115,165,1115,834,281,2017-01-01,zipcode,Martindale
ZCTA5 78656,48,2513,45260,846,104600,2025,674,1565,131,697,536,169,32,852,806,46,806,477,329,2017-01-01,zipcode,Maxwell
ZCTA5 78657,48,5868,73472,1067,314300,5329,2846,4859,250,1080,1399,1444,686,4785,2614,2171,2614,2147,467,2017-01-01,zipcode,Horseshoe bay
ZCTA5 78659,48,3136,64808,676,144700,2559,888,1984,254,843,493,343,51,1209,1000,209,1000,822,178,2017-01-01,zipcode,Paige
ZCTA5 78660,48,85450,81693,1312,198500,64733,15955,56042,5007,11957,18437,14758,5883,29569,28469,1100,28469,21486,6983,2017-01-01,zipcode,Pflugerville
ZCTA5 78661,48,416,46250,747,95000,343,141,268,50,139,67,12,0,169,152,17,152,118,34,2017-01-01,zipcode,Prairie lea
ZCTA5 78662,48,2485,80315,913,163200,2014,679,1627,163,508,680,145,131,1030,869,161,869,784,85,2017-01-01,zipcode,Red rock
ZCTA5 78663,48,913,74397,-666666666,-666666666,715,206,644,32,165,223,98,126,544,348,196,348,283,65,2017-01-01,zipcode,Round mountain
ZCTA5 78664,48,61361,67462,1137,172900,45942,10965,38405,3789,8593,13868,8370,3785,21831,20346,1485,20346,11321,9025,2017-01-01,zipcode,Round rock
ZCTA5 78665,48,46109,92511,1288,230000,33532,8735,28161,1255,5153,9558,7997,4198,15143,14246,897,14246,10498,3748,2017-01-01,zipcode,Round rock
ZCTA5 78666,48,77355,38100,962,148300,66693,22731,38803,5479,10507,11010,7976,3831,30427,27735,2692,27735,10057,17678,2017-01-01,zipcode,San marcos
ZCTA5 78669,48,11375,100862,1077,418500,8884,3578,8395,217,1409,2536,2678,1555,5541,4254,1287,4254,3728,526,2017-01-01,zipcode,Spicewood
ZCTA5 78670,48,164,46500,928,112500,153,65,145,19,50,65,11,0,66,66,0,66,39,27,2017-01-01,zipcode,Staples
ZCTA5 78671,48,626,-666666666,-666666666,170000,504,167,442,66,90,105,160,21,338,271,67,271,242,29,2017-01-01,zipcode,Stonewall
ZCTA5 78672,48,1248,50817,-666666666,117700,1117,571,1094,177,373,372,153,19,1159,623,536,623,578,45,2017-01-01,zipcode,Tow
ZCTA5 78675,48,384,62813,-666666666,-666666666,355,122,304,72,89,63,55,25,209,154,55,154,144,10,2017-01-01,zipcode,Willow city
ZCTA5 78676,48,13231,71051,1232,245200,11221,4876,9806,510,1653,3439,2394,1810,6523,5539,984,5539,4569,970,2017-01-01,zipcode,Wimberley
ZCTA5 78677,48,45,55000,-666666666,-666666666,39,25,39,14,25,0,0,0,26,18,8,18,18,0,2017-01-01,zipcode,Wrightsboro
ZCTA5 78681,48,57234,100622,1223,256100,42023,11572,35543,1964,5032,10060,12591,5896,18348,17274,1074,17274,13562,3712,2017-01-01,zipcode,Round rock
ZCTA5 78701,48,7875,112201,1847,476700,7798,1716,7084,433,499,965,2994,2193,6576,4855,1721,4855,1702,3153,2017-01-01,zipcode,Austin
ZCTA5 78702,48,22876,54053,1020,297700,19110,5423,16706,3258,3463,3408,4272,2305,9839,8937,902,8937,4183,4754,2017-01-01,zipcode,Austin
ZCTA5 78703,48,20788,98553,1319,767400,16911,3857,15624,306,430,1787,6615,6486,11047,9723,1324,9723,5051,4672,2017-01-01,zipcode,Austin
ZCTA5 78704,48,47158,66262,1235,464400,40699,8248,35879,2299,3474,7261,15017,7828,25815,23213,2602,23213,7970,15243,2017-01-01,zipcode,Austin
ZCTA5 78705,48,33075,15309,1198,417800,32384,18209,6991,250,429,1648,2923,1741,10336,8370,1966,8370,890,7480,2017-01-01,zipcode,Austin
ZCTA5 78712,48,845,-666666666,-666666666,-666666666,845,540,9,0,0,0,9,0,0,0,0,0,0,0,2017-01-01,zipcode,Austin
ZCTA5 78717,48,27764,104167,1250,319800,20091,5337,17885,330,1974,4614,6750,4217,10474,9846,628,9846,6016,3830,2017-01-01,zipcode,Austin
ZCTA5 78719,48,2007,46833,859,129700,1559,599,1406,630,432,234,74,36,563,500,63,500,372,128,2017-01-01,zipcode,Austin
ZCTA5 78721,48,12447,41611,990,212400,10272,3418,8697,2470,2366,1791,1483,587,4632,4197,435,4197,2427,1770,2017-01-01,zipcode,Austin
ZCTA5 78722,48,7254,69267,1280,358900,6225,1125,5700,237,671,922,2473,1397,3415,3111,304,3111,1419,1692,2017-01-01,zipcode,Austin
ZCTA5 78723,48,33170,49606,964,268700,25904,7108,22837,3872,4819,5207,5522,3417,13777,12518,1259,12518,5352,7166,2017-01-01,zipcode,Austin
ZCTA5 78724,48,24833,45158,1091,122100,16610,5803,13466,4819,3732,3178,1109,628,6754,6360,394,6360,3847,2513,2017-01-01,zipcode,Austin
ZCTA5 78725,48,7517,62172,1338,137800,5688,1283,5113,1167,1718,1402,493,333,2598,2544,54,2544,2033,511,2017-01-01,zipcode,Austin
ZCTA5 78726,48,14610,88322,1136,392800,11465,2544,9346,144,754,2270,3859,2319,5998,5554,444,5554,2569,2985,2017-01-01,zipcode,Austin
ZCTA5 78727,48,28999,74458,1219,249700,24483,6207,22031,1204,2892,5605,8341,3989,14029,12937,1092,12937,6179,6758,2017-01-01,zipcode,Austin
ZCTA5 78728,48,21245,55603,1093,205500,17318,3771,15270,716,3366,4550,4942,1696,10626,10029,597,10029,2838,7191,2017-01-01,zipcode,Austin
ZCTA5 78729,48,29434,73047,1178,234200,24175,5270,20949,832,3099,6540,7046,3432,13636,12622,1014,12622,5426,7196,2017-01-01,zipcode,Austin
ZCTA5 78730,48,8933,108750,1281,659400,7160,2179,6430,79,341,1155,2810,2045,4019,3678,341,3678,2234,1444,2017-01-01,zipcode,Austin
ZCTA5 78731,48,27447,89099,1231,572700,22534,7112,20198,415,1064,3172,8051,7496,13476,12556,920,12556,7036,5520,2017-01-01,zipcode,Austin
ZCTA5 78732,48,17762,142612,1466,495800,12022,3653,10922,319,620,1882,5156,2945,6114,5689,425,5689,4469,1220,2017-01-01,zipcode,Austin
ZCTA5 78733,48,8754,136563,1511,533800,6366,1994,5670,98,369,1081,2224,1898,3033,2920,113,2920,2645,275,2017-01-01,zipcode,Austin
ZCTA5 78734,48,18722,107827,1715,377400,15092,5353,13911,766,1740,3581,5152,2672,8633,7392,1241,7392,5929,1463,2017-01-01,zipcode,Austin
ZCTA5 78735,48,17919,102551,1362,463200,14021,4135,12832,660,1311,2592,4832,3437,8176,7193,983,7193,3835,3358,2017-01-01,zipcode,Austin
ZCTA5 78736,48,8199,107467,1425,313700,6544,1902,6013,170,800,1833,2238,972,3306,3023,283,3023,2472,551,2017-01-01,zipcode,Austin
ZCTA5 78737,48,15879,127136,1979,394600,11928,3810,10759,192,1205,2858,4143,2361,5385,5305,80,5305,4894,411,2017-01-01,zipcode,Austin
ZCTA5 78738,48,15746,123836,1435,496300,11894,4161,10631,146,1020,2096,4894,2475,6737,5964,773,5964,4340,1624,2017-01-01,zipcode,Austin
ZCTA5 78739,48,20191,147736,2339,426700,14056,4345,12898,213,820,2242,5977,3646,6460,6367,93,6367,6044,323,2017-01-01,zipcode,Austin
ZCTA5 78741,48,52307,39049,1002,156800,43644,10018,31192,7430,6692,7750,6501,2819,23380,20758,2622,20758,3107,17651,2017-01-01,zipcode,Austin
ZCTA5 78742,48,517,33182,1048,86100,482,180,398,118,77,132,57,14,252,218,34,218,126,92,2017-01-01,zipcode,Austin
ZCTA5 78744,48,48432,47073,1104,121500,35192,9595,28707,8712,8153,6950,3758,1134,15236,14345,891,14345,6509,7836,2017-01-01,zipcode,Austin
ZCTA5 78745,48,62220,60567,1218,229200,52071,12795,46639,5804,8874,13581,12637,5743,27367,25857,1510,25857,11931,13926,2017-01-01,zipcode,Austin
ZCTA5 78746,48,28268,136138,1456,812900,22053,7601,19951,199,915,2726,8693,7418,11922,10848,1074,10848,7765,3083,2017-01-01,zipcode,Austin
ZCTA5 78747,48,20954,79500,1387,203800,16013,4860,13238,1871,3534,3746,2935,1152,6654,6364,290,6364,4630,1734,2017-01-01,zipcode,Austin
ZCTA5 78748,48,49142,74176,1326,238600,39847,9661,35082,2456,6294,10576,10642,5114,19577,18820,757,18820,11402,7418,2017-01-01,zipcode,Austin
ZCTA5 78749,48,37453,92313,1335,296900,29962,6705,27274,586,2710,6213,11449,6316,15727,15215,512,15215,9417,5798,2017-01-01,zipcode,Austin
ZCTA5 78750,48,30758,81061,1255,359500,24146,6932,21610,864,2785,5502,7280,5179,12472,11713,759,11713,7391,4322,2017-01-01,zipcode,Austin
ZCTA5 78751,48,14949,54129,1200,395200,13603,2754,10928,386,1055,1662,4728,3097,8632,7463,1169,7463,2229,5234,2017-01-01,zipcode,Austin
ZCTA5 78752,48,20302,41486,962,233900,15579,3482,13606,2871,3164,2970,3172,1429,8720,7932,788,7932,2165,5767,2017-01-01,zipcode,Austin
ZCTA5 78753,48,58693,45983,1003,161000,44496,11044,37992,10179,11194,9243,5319,2057,21287,19947,1340,19947,7118,12829,2017-01-01,zipcode,Austin
ZCTA5 78754,48,23858,64114,1183,183200,17890,4351,15683,1848,3346,4486,3780,2223,8451,8009,442,8009,3987,4022,2017-01-01,zipcode,Austin
ZCTA5 78756,48,8377,73578,1213,476700,7304,1493,6786,230,663,887,2796,2210,4642,4246,396,4246,2040,2206,2017-01-01,zipcode,Austin
ZCTA5 78757,48,24059,65709,1120,348600,19736,4939,18008,1318,2744,3864,6364,3718,11454,10746,708,10746,6009,4737,2017-01-01,zipcode,Austin
ZCTA5 78758,48,46618,50018,1072,178100,37299,8747,32767,5458,7659,8203,8308,3139,21064,19397,1667,19397,5543,13854,2017-01-01,zipcode,Austin
ZCTA5 78759,48,41847,76749,1203,389900,35069,9449,32389,720,2966,7416,11782,9505,21798,20240,1558,20240,9357,10883,2017-01-01,zipcode,Austin
ZCTA5 78801,48,22156,40837,632,76700,16828,6434,13504,4031,3178,4349,1449,497,8557,6970,1587,6970,4941,2029,2017-01-01,zipcode,Uvalde
ZCTA5 78802,48,549,90015,-666666666,-666666666,395,86,261,34,0,163,64,0,184,163,21,163,125,38,2017-01-01,zipcode,Uvalde
ZCTA5 78827,48,1110,24271,467,60700,897,476,685,220,195,169,42,59,527,420,107,420,285,135,2017-01-01,zipcode,Asherton
ZCTA5 78828,48,104,-666666666,-666666666,101600,104,79,104,8,3,88,5,0,272,31,241,31,31,0,2017-01-01,zipcode,Barksdale
ZCTA5 78829,48,1195,14309,655,41200,861,543,627,330,101,119,77,0,536,312,224,312,258,54,2017-01-01,zipcode,Batesville
ZCTA5 78830,48,867,19643,675,43800,759,443,665,304,231,78,47,5,338,258,80,258,212,46,2017-01-01,zipcode,Big wells
ZCTA5 78832,48,3631,34926,513,64200,2943,1457,2662,683,907,767,237,68,1927,1200,727,1200,928,272,2017-01-01,zipcode,Brackettville
ZCTA5 78833,48,1403,32000,767,76500,1192,559,1015,180,363,291,140,41,1001,496,505,496,340,156,2017-01-01,zipcode,Camp wood
ZCTA5 78834,48,8662,33295,758,71700,6174,2462,5048,1750,1527,1271,303,197,3362,2721,641,2721,1877,844,2017-01-01,zipcode,Carrizo springs
ZCTA5 78836,48,165,-666666666,-666666666,39100,165,143,145,55,59,23,8,0,140,64,76,64,64,0,2017-01-01,zipcode,Catarina
ZCTA5 78837,48,190,-666666666,-666666666,-666666666,169,76,159,57,47,18,21,16,215,76,139,76,70,6,2017-01-01,zipcode,Comstock
ZCTA5 78838,48,202,42841,-666666666,239700,202,164,202,49,82,48,7,16,274,104,170,104,104,0,2017-01-01,zipcode,Concan
ZCTA5 78839,48,9251,28333,538,38200,6879,2946,5361,1995,1764,1239,262,101,3065,2706,359,2706,1820,886,2017-01-01,zipcode,Crystal city
ZCTA5 78840,48,48317,44659,687,94900,35819,14938,29055,9501,7393,6919,3737,1505,18539,15070,3469,15070,9493,5577,2017-01-01,zipcode,Del rio
ZCTA5 78843,48,409,-666666666,-666666666,-666666666,409,13,12,0,0,0,12,0,14,14,0,14,0,14,2017-01-01,zipcode,Laughlin afb
ZCTA5 78850,48,1306,52708,-666666666,142300,1060,486,903,106,297,234,202,64,594,415,179,415,390,25,2017-01-01,zipcode,D hanis
ZCTA5 78851,48,33,-666666666,-666666666,-666666666,26,11,26,5,5,8,8,0,30,11,19,11,9,2,2017-01-01,zipcode,Dryden
ZCTA5 78852,48,55879,37667,627,94800,40169,16422,31216,12732,6645,8242,2683,914,17703,15947,1756,15947,10779,5168,2017-01-01,zipcode,Eagle pass
ZCTA5 78860,48,122,-666666666,-666666666,-666666666,93,47,93,52,16,25,0,0,45,45,0,45,45,0,2017-01-01,zipcode,El indio
ZCTA5 78861,48,13782,56131,780,127900,10982,5573,8854,1473,3220,2940,791,430,4851,3743,1108,3743,2750,993,2017-01-01,zipcode,Hondo
ZCTA5 78870,48,1031,34632,534,75000,831,362,671,211,173,163,82,42,441,335,106,335,236,99,2017-01-01,zipcode,Knippa
ZCTA5 78871,48,46,-666666666,-666666666,-666666666,46,43,46,0,46,0,0,0,82,18,64,18,18,0,2017-01-01,zipcode,Langtry
ZCTA5 78872,48,1724,24353,529,46200,1261,615,976,451,212,223,49,41,748,531,217,531,384,147,2017-01-01,zipcode,La pryor
ZCTA5 78873,48,1920,35694,913,112300,1589,840,1359,345,231,534,151,98,1438,645,793,645,527,118,2017-01-01,zipcode,Leakey
ZCTA5 78877,48,1183,-666666666,-666666666,155600,825,518,782,348,95,177,77,85,391,364,27,364,286,78,2017-01-01,zipcode,Quemado
ZCTA5 78879,48,215,-666666666,-666666666,149200,215,169,215,0,78,56,58,23,325,82,243,82,75,7,2017-01-01,zipcode,Rio frio
ZCTA5 78880,48,1833,43750,400,66600,1555,712,1327,377,407,238,282,23,1409,539,870,539,463,76,2017-01-01,zipcode,Rocksprings
ZCTA5 78881,48,2321,36875,760,65600,1663,849,1486,390,495,357,175,69,1055,749,306,749,617,132,2017-01-01,zipcode,Sabinal
ZCTA5 78883,48,200,39514,900,-666666666,182,157,178,0,85,16,51,26,333,123,210,123,101,22,2017-01-01,zipcode,Tarpley
ZCTA5 78884,48,977,52667,477,173200,821,387,714,68,241,221,103,81,816,382,434,382,338,44,2017-01-01,zipcode,Utopia
ZCTA5 78885,48,86,105313,-666666666,-666666666,86,36,81,32,9,12,7,21,177,42,135,42,38,4,2017-01-01,zipcode,Vanderpool
ZCTA5 78886,48,336,39844,-666666666,176000,327,123,279,32,73,103,45,26,228,154,74,154,129,25,2017-01-01,zipcode,Yancey
ZCTA5 78931,48,266,96944,-666666666,-666666666,212,87,212,21,60,81,33,17,208,112,96,112,90,22,2017-01-01,zipcode,Bleiblerville
ZCTA5 78932,48,583,55625,723,120900,509,298,453,70,120,158,63,42,411,226,185,226,162,64,2017-01-01,zipcode,Carmine
ZCTA5 78933,48,1138,76213,-666666666,164000,1034,547,1022,86,328,395,158,55,760,504,256,504,442,62,2017-01-01,zipcode,Cat spring
ZCTA5 78934,48,6238,44775,647,138000,4685,2116,4058,564,1580,966,852,96,3216,2267,949,2267,1769,498,2017-01-01,zipcode,Columbus
ZCTA5 78935,48,1509,76667,-666666666,286300,1320,487,1077,241,221,298,241,76,506,430,76,430,418,12,2017-01-01,zipcode,Alleyton
ZCTA5 78938,48,337,60625,-666666666,94500,271,86,210,0,97,50,57,6,173,105,68,105,82,23,2017-01-01,zipcode,Ellinger
ZCTA5 78940,48,2387,53214,750,175800,2042,914,1781,136,801,485,288,71,1477,924,553,924,844,80,2017-01-01,zipcode,Fayetteville
ZCTA5 78941,48,2791,46274,586,148200,2413,1171,2177,481,881,479,265,71,1652,1013,639,1013,809,204,2017-01-01,zipcode,Flatonia
ZCTA5 78942,48,8499,53689,877,118500,6729,2482,5466,1221,1972,1429,570,274,3686,2902,784,2902,2002,900,2017-01-01,zipcode,Giddings
ZCTA5 78943,48,231,-666666666,-666666666,-666666666,211,71,211,34,66,73,25,13,178,97,81,97,97,0,2017-01-01,zipcode,Glidden
ZCTA5 78944,48,521,58523,588,167900,481,177,405,40,125,132,44,64,299,239,60,239,210,29,2017-01-01,zipcode,Industry
ZCTA5 78945,48,10107,64063,870,176600,8046,3198,6925,1289,2585,1849,912,290,5231,3701,1530,3701,2904,797,2017-01-01,zipcode,La grange
ZCTA5 78946,48,860,40385,836,185100,844,411,797,125,321,276,53,22,694,414,280,414,335,79,2017-01-01,zipcode,Ledbetter
ZCTA5 78947,48,4605,59659,831,201700,3560,1421,3245,275,1227,1046,503,194,2096,1720,376,1720,1470,250,2017-01-01,zipcode,Lexington
ZCTA5 78948,48,743,58550,-666666666,212800,698,244,519,90,202,114,87,26,411,268,143,268,251,17,2017-01-01,zipcode,Lincoln
ZCTA5 78949,48,768,76429,527,150400,482,226,460,62,151,148,29,70,381,236,145,236,200,36,2017-01-01,zipcode,Muldoon
ZCTA5 78950,48,2000,51000,717,172800,1768,802,1546,233,587,489,177,60,1411,816,595,816,721,95,2017-01-01,zipcode,New ulm
ZCTA5 78951,48,0,-666666666,-666666666,-666666666,0,0,0,0,0,0,0,0,0,0,0,0,0,0,2017-01-01,zipcode,Oakland
ZCTA5 78953,48,874,71111,1302,129000,797,300,741,85,238,363,49,6,488,362,126,362,316,46,2017-01-01,zipcode,Rosanky
ZCTA5 78954,48,1170,56458,740,291100,1117,572,1045,88,331,261,253,112,1009,567,442,567,525,42,2017-01-01,zipcode,Round top
ZCTA5 78956,48,5518,47054,773,136600,4542,1982,4007,832,1568,980,469,158,2977,2041,936,2041,1564,477,2017-01-01,zipcode,Schulenburg
ZCTA5 78957,48,9310,53431,914,151200,7398,3228,6407,801,2189,1905,1095,417,4509,3623,886,3623,2745,878,2017-01-01,zipcode,Smithville
ZCTA5 78959,48,2047,42467,463,76000,1687,666,1450,606,379,347,103,15,969,693,276,693,560,133,2017-01-01,zipcode,Waelder
ZCTA5 78962,48,5200,59346,862,112300,4249,1642,3676,495,1582,950,483,166,2805,2076,729,2076,1740,336,2017-01-01,zipcode,Weimar
ZCTA5 78963,48,1174,54293,-666666666,118200,848,320,728,140,270,265,53,0,472,369,103,369,363,6,2017-01-01,zipcode,West point
ZCTA5 79001,48,201,70000,-666666666,97000,184,79,182,31,38,49,43,21,133,90,43,90,67,23,2017-01-01,zipcode,Adrian
ZCTA5 79003,48,210,67679,-666666666,103000,157,63,148,26,28,69,23,2,98,77,21,77,47,30,2017-01-01,zipcode,Allison
ZCTA5 79005,48,1653,69000,679,125200,1302,366,1102,209,426,317,97,53,696,606,90,606,439,167,2017-01-01,zipcode,Booker
ZCTA5 79007,48,14415,47737,722,77000,11127,4442,9204,1387,2933,3449,1042,393,6832,5131,1701,5131,3844,1287,2017-01-01,zipcode,Borger
ZCTA5 79009,48,1921,42125,644,75500,1450,549,1096,332,399,252,104,9,746,616,130,616,359,257,2017-01-01,zipcode,Bovina
ZCTA5 79010,48,1008,-666666666,-666666666,-666666666,579,442,339,6,174,53,85,21,261,190,71,190,112,78,2017-01-01,zipcode,Boys ranch
ZCTA5 79011,48,209,83194,-666666666,68500,180,63,173,31,50,53,25,14,136,111,25,111,75,36,2017-01-01,zipcode,Briscoe
ZCTA5 79012,48,1272,109628,-666666666,263100,871,88,756,0,90,381,285,0,486,461,25,461,406,55,2017-01-01,zipcode,Bushland
ZCTA5 79013,48,3707,47697,549,55400,2556,856,1858,1313,246,217,82,0,1279,944,335,944,550,394,2017-01-01,zipcode,Cactus
ZCTA5 79014,48,4119,68491,805,136700,2973,962,2457,583,634,671,488,81,1635,1334,301,1334,913,421,2017-01-01,zipcode,Canadian
ZCTA5 79015,48,21576,60867,790,182600,17071,4914,12250,807,1828,4569,3430,1616,8444,7616,828,7616,4838,2778,2017-01-01,zipcode,Canyon
ZCTA5 79016,48,133,-666666666,-666666666,-666666666,133,107,10,0,0,5,5,0,0,0,0,0,0,0,2017-01-01,zipcode,Canyon
ZCTA5 79018,48,272,44688,668,56700,230,73,206,11,73,91,25,6,224,147,77,147,66,81,2017-01-01,zipcode,Channing
ZCTA5 79019,48,1756,69464,732,131700,1389,527,1254,132,291,540,198,93,814,634,180,634,507,127,2017-01-01,zipcode,Claude
ZCTA5 79021,48,142,41875,-666666666,73300,96,23,82,46,17,15,1,3,69,49,20,49,14,35,2017-01-01,zipcode,Cotton center
ZCTA5 79022,48,11488,54047,726,100800,8762,3847,7670,1955,2738,1929,748,300,4014,3495,519,3495,2158,1337,2017-01-01,zipcode,Dalhart
ZCTA5 79024,48,470,61071,850,80400,363,140,311,45,113,80,57,16,202,176,26,176,127,49,2017-01-01,zipcode,Darrouzett
ZCTA5 79025,48,39,-666666666,-666666666,-666666666,39,19,20,10,10,0,0,0,20,20,0,20,10,10,2017-01-01,zipcode,Dawn
ZCTA5 79027,48,5090,40956,611,81800,3681,1526,2972,830,855,861,281,145,2011,1582,429,1582,915,667,2017-01-01,zipcode,Dimmitt
ZCTA5 79029,48,16010,54278,768,118400,11495,3285,9275,2698,2413,2785,1055,324,5693,4959,734,4959,3146,1813,2017-01-01,zipcode,Dumas
ZCTA5 79031,48,1397,51964,650,77900,985,355,886,229,227,202,185,43,617,486,131,486,352,134,2017-01-01,zipcode,Earth
ZCTA5 79032,48,180,74375,-666666666,93900,125,62,86,14,60,8,1,3,63,45,18,45,29,16,2017-01-01,zipcode,Edmonson
ZCTA5 79033,48,87,-666666666,-666666666,-666666666,73,43,73,33,15,0,25,0,53,38,15,38,32,6,2017-01-01,zipcode,Farnsworth
ZCTA5 79034,48,634,59000,694,92700,442,159,372,69,114,113,63,13,268,210,58,210,170,40,2017-01-01,zipcode,Follett
ZCTA5 79035,48,4892,52109,676,78600,3580,1347,3038,860,1097,528,429,124,1832,1573,259,1573,1104,469,2017-01-01,zipcode,Friona
ZCTA5 79036,48,5253,53058,714,72900,4126,1885,3655,467,1383,1480,258,67,2634,1940,694,1940,1780,160,2017-01-01,zipcode,Fritch
ZCTA5 79039,48,951,61094,580,113200,691,231,629,65,155,247,104,58,432,377,55,377,327,50,2017-01-01,zipcode,Groom
ZCTA5 79040,48,1771,44268,732,95000,1289,412,955,303,184,275,164,29,798,608,190,608,392,216,2017-01-01,zipcode,Gruver
ZCTA5 79041,48,3199,41598,653,70300,2387,1061,1895,517,643,501,169,65,1401,1171,230,1171,842,329,2017-01-01,zipcode,Hale center
ZCTA5 79042,48,1136,38929,717,72400,844,295,690,27,249,266,82,66,560,452,108,452,345,107,2017-01-01,zipcode,Happy
ZCTA5 79043,48,1443,43333,775,49800,1095,519,852,332,293,161,44,22,583,438,145,438,314,124,2017-01-01,zipcode,Hart
ZCTA5 79044,48,651,37434,625,109500,454,183,400,182,89,51,65,13,327,279,48,279,123,156,2017-01-01,zipcode,Hartley
ZCTA5 79045,48,19066,51564,764,87500,13751,4545,11199,3100,3535,2995,1175,394,7165,6143,1022,6143,3994,2149,2017-01-01,zipcode,Hereford
ZCTA5 79046,48,636,45804,880,79500,475,200,408,104,93,127,59,25,305,251,54,251,179,72,2017-01-01,zipcode,Higgins
ZCTA5 79051,48,32,-666666666,-666666666,-666666666,32,0,32,0,0,16,16,0,16,16,0,16,0,16,2017-01-01,zipcode,Kerrick
ZCTA5 79052,48,1166,46477,610,77500,967,374,715,127,269,198,94,27,533,415,118,415,316,99,2017-01-01,zipcode,Kress
ZCTA5 79053,48,185,63542,520,123800,147,51,119,3,39,55,22,0,82,55,27,55,31,24,2017-01-01,zipcode,Lazbuddie
ZCTA5 79054,48,527,40481,588,31800,403,163,374,41,169,140,17,7,307,223,84,223,175,48,2017-01-01,zipcode,Lefors
ZCTA5 79056,48,84,73750,-666666666,90000,64,47,59,3,15,18,16,7,52,24,28,24,20,4,2017-01-01,zipcode,Lipscomb
ZCTA5 79057,48,1595,55703,535,47100,1180,528,1054,158,267,455,149,25,684,538,146,538,410,128,2017-01-01,zipcode,Mclean
ZCTA5 79058,48,0,-666666666,-666666666,-666666666,0,0,0,0,0,0,0,0,0,0,0,0,0,0,2017-01-01,zipcode,Masterson
ZCTA5 79059,48,705,76667,893,123600,541,219,476,36,136,138,136,30,360,276,84,276,211,65,2017-01-01,zipcode,Miami
ZCTA5 79061,48,392,57000,528,70800,280,108,229,34,45,88,53,9,175,136,39,136,84,52,2017-01-01,zipcode,Mobeetie
ZCTA5 79062,48,226,66250,-666666666,45600,205,70,143,22,49,30,31,11,112,74,38,74,54,20,2017-01-01,zipcode,Morse
ZCTA5 79063,48,661,61500,522,152600,482,171,428,12,214,104,66,32,263,236,27,236,211,25,2017-01-01,zipcode,Nazareth
ZCTA5 79064,48,2364,40208,599,60900,1855,787,1602,523,595,321,96,67,1095,887,208,887,574,313,2017-01-01,zipcode,Olton
ZCTA5 79065,48,21082,49005,760,74700,16315,7082,14081,2828,4618,4802,1398,435,9148,7290,1858,7290,5463,1827,2017-01-01,zipcode,Pampa
ZCTA5 79068,48,3043,68977,711,123700,2363,775,1960,77,491,650,431,311,1318,1135,183,1135,935,200,2017-01-01,zipcode,Panhandle
ZCTA5 79070,48,10183,49548,733,103500,7319,2352,5971,1462,1777,1655,800,277,3931,3428,503,3428,2447,981,2017-01-01,zipcode,Perryton
ZCTA5 79072,48,26829,45884,641,83800,20164,8455,16292,4070,5457,4080,1828,857,10165,8489,1676,8489,4836,3653,2017-01-01,zipcode,Plainview
ZCTA5 79078,48,275,-666666666,625,-666666666,222,56,214,26,93,73,4,18,226,113,113,113,103,10,2017-01-01,zipcode,Sanford
ZCTA5 79079,48,2696,44696,598,84600,2138,833,1861,385,515,687,212,62,1463,1181,282,1181,725,456,2017-01-01,zipcode,Shamrock
ZCTA5 79080,48,562,57596,825,39100,431,213,407,23,147,186,30,21,391,237,154,237,200,37,2017-01-01,zipcode,Skellytown
ZCTA5 79081,48,4065,38097,647,99200,2916,1288,2579,762,751,706,274,86,1597,1359,238,1359,1044,315,2017-01-01,zipcode,Spearman
ZCTA5 79082,48,276,49583,-666666666,101600,178,75,156,30,42,39,36,9,111,83,28,83,71,12,2017-01-01,zipcode,Springlake
ZCTA5 79083,48,2155,42625,840,69300,1734,922,1515,264,441,659,100,51,1228,811,417,811,641,170,2017-01-01,zipcode,Stinnett
ZCTA5 79084,48,2384,55217,633,87500,1850,529,1561,414,366,459,244,78,1025,806,219,806,659,147,2017-01-01,zipcode,Stratford
ZCTA5 79085,48,25,43125,-666666666,-666666666,21,2,19,9,3,7,0,0,18,12,6,12,12,0,2017-01-01,zipcode,Summerfield
ZCTA5 79086,48,2283,53220,695,84600,1771,610,1522,372,439,437,222,52,951,821,130,821,604,217,2017-01-01,zipcode,Sunray
ZCTA5 79087,48,591,56250,720,83300,478,139,414,75,72,157,77,33,316,250,66,250,170,80,2017-01-01,zipcode,Texline
ZCTA5 79088,48,5756,37901,657,71300,4496,2493,3979,1004,1390,1154,359,72,2384,1944,440,1944,1322,622,2017-01-01,zipcode,Tulia
ZCTA5 79091,48,153,-666666666,-666666666,78500,107,10,107,30,32,0,22,23,52,52,0,52,52,0,2017-01-01,zipcode,Umbarger
ZCTA5 79092,48,985,56875,904,92400,775,275,716,71,250,234,125,36,422,357,65,357,313,44,2017-01-01,zipcode,Vega
ZCTA5 79093,48,77,-666666666,-666666666,-666666666,57,13,57,0,33,24,0,0,37,37,0,37,37,0,2017-01-01,zipcode,Waka
ZCTA5 79094,48,77,56771,-666666666,59600,77,15,77,0,41,18,18,0,32,23,9,23,23,0,2017-01-01,zipcode,Wayside
ZCTA5 79095,48,2699,46618,620,56800,2105,747,1824,398,613,563,161,89,1237,968,269,968,772,196,2017-01-01,zipcode,Wellington
ZCTA5 79096,48,2231,52656,713,87700,1628,553,1425,316,504,388,171,46,949,852,97,852,578,274,2017-01-01,zipcode,Wheeler
ZCTA5 79097,48,1037,77500,917,106200,770,281,690,37,149,274,175,55,431,372,59,372,331,41,2017-01-01,zipcode,White deer
ZCTA5 79098,48,521,78125,825,113200,353,135,304,40,86,145,28,5,181,156,25,156,130,26,2017-01-01,zipcode,Wildorado
ZCTA5 79101,48,2185,25978,708,77400,1901,1074,1726,250,571,578,214,113,1496,1062,434,1062,120,942,2017-01-01,zipcode,Amarillo
ZCTA5 79102,48,9586,44257,644,98600,7242,2271,5779,1344,1337,1987,769,342,4346,3881,465,3881,2016,1865,2017-01-01,zipcode,Amarillo
ZCTA5 79103,48,10880,46233,871,85300,8082,2430,6701,1407,2418,2285,468,123,4101,3836,265,3836,2845,991,2017-01-01,zipcode,Amarillo
ZCTA5 79104,48,6727,38800,722,58800,5016,1831,4258,1691,1375,1057,99,36,2687,2324,363,2324,1405,919,2017-01-01,zipcode,Amarillo
ZCTA5 79105,48,0,-666666666,-666666666,-666666666,0,0,0,0,0,0,0,0,0,0,0,0,0,0,2017-01-01,zipcode,Amarillo
ZCTA5 79106,48,27883,41480,754,111300,21370,7448,18284,2480,4899,6634,2817,1454,13183,11622,1561,11622,6059,5563,2017-01-01,zipcode,Amarillo
ZCTA5 79107,48,35188,35023,734,64000,24364,9174,19286,7325,6376,4513,847,225,12754,11342,1412,11342,6773,4569,2017-01-01,zipcode,Amarillo
ZCTA5 79108,48,16479,51374,807,109400,14088,8630,12778,2730,4887,3827,1090,244,5114,4351,763,4351,3385,966,2017-01-01,zipcode,Amarillo
ZCTA5 79109,48,44211,56396,772,157200,34931,10919,29562,2460,6261,12058,5869,2914,20806,18365,2441,18365,10934,7431,2017-01-01,zipcode,Amarillo
ZCTA5 79110,48,19242,58631,899,109700,14489,3534,12101,1490,3276,5150,1554,631,7725,7017,708,7017,4926,2091,2017-01-01,zipcode,Amarillo
ZCTA5 79111,48,2060,62114,963,-666666666,1561,752,1226,184,325,585,69,63,539,503,36,503,11,492,2017-01-01,zipcode,Amarillo
ZCTA5 79118,48,22279,72712,1081,150100,17018,5234,14976,1989,4626,5200,2259,902,8227,7576,651,7576,5908,1668,2017-01-01,zipcode,Amarillo
ZCTA5 79119,48,15884,87565,976,254200,12132,3546,10710,369,1614,3957,2951,1819,6373,6065,308,6065,4594,1471,2017-01-01,zipcode,Amarillo
ZCTA5 79121,48,6582,73885,836,186500,5886,2185,5121,313,959,1695,1446,708,3060,2859,201,2859,1960,899,2017-01-01,zipcode,Amarillo
ZCTA5 79124,48,8720,87546,1017,224400,6553,2242,5829,177,1148,2202,1410,892,3581,3335,246,3335,2736,599,2017-01-01,zipcode,Amarillo
ZCTA5 79201,48,7066,40714,749,81400,5753,3074,4773,812,1736,1342,581,302,2965,2296,669,2296,1268,1028,2017-01-01,zipcode,Childress
ZCTA5 79220,48,276,33750,569,104700,204,92,167,24,45,52,39,7,176,108,68,108,52,56,2017-01-01,zipcode,Afton
ZCTA5 79225,48,1075,49779,538,42300,888,333,757,283,197,177,76,24,602,373,229,373,279,94,2017-01-01,zipcode,Chillicothe
ZCTA5 79226,48,2967,44758,637,67400,2447,1095,1869,179,607,738,232,113,1868,1082,786,1082,792,290,2017-01-01,zipcode,Clarendon
ZCTA5 79227,48,1454,49583,517,46900,1223,529,1071,238,344,312,136,41,972,582,390,582,466,116,2017-01-01,zipcode,Crowell
ZCTA5 79229,48,399,57273,550,49300,329,189,308,36,112,123,24,13,245,156,89,156,129,27,2017-01-01,zipcode,Dickens
ZCTA5 79230,48,195,52647,-666666666,-666666666,145,62,141,60,40,15,12,14,92,60,32,60,56,4,2017-01-01,zipcode,Dodson
ZCTA5 79231,48,100,-666666666,-666666666,-666666666,48,21,48,0,21,27,0,0,27,27,0,27,0,27,2017-01-01,zipcode,Dougherty
ZCTA5 79233,48,89,46500,730,26300,84,35,71,7,18,32,14,0,79,40,39,40,27,13,2017-01-01,zipcode,Estelline
ZCTA5 79234,48,57,33750,-666666666,58800,49,26,34,0,21,6,5,2,82,27,55,27,19,8,2017-01-01,zipcode,Flomot
ZCTA5 79235,48,3621,47128,713,49600,2702,1148,2285,605,624,623,300,133,1815,1373,442,1373,1077,296,2017-01-01,zipcode,Floydada
ZCTA5 79236,48,269,63438,700,36900,208,37,194,36,67,53,27,11,125,92,33,92,17,75,2017-01-01,zipcode,Guthrie
ZCTA5 79237,48,429,31528,544,58800,364,186,337,74,104,123,32,4,291,167,124,167,126,41,2017-01-01,zipcode,Hedley
ZCTA5 79239,48,178,22188,-666666666,37100,143,83,140,14,70,37,10,9,176,75,101,75,43,32,2017-01-01,zipcode,Lakeview
ZCTA5 79240,48,0,-666666666,-666666666,-666666666,0,0,0,0,0,0,0,0,7,0,7,0,0,0,2017-01-01,zipcode,Lelia lake
ZCTA5 79241,48,2196,54185,686,75900,1767,760,1469,396,314,520,189,50,1115,901,214,901,591,310,2017-01-01,zipcode,Lockney
ZCTA5 79243,48,51,51250,-666666666,103100,51,32,46,0,12,28,6,0,32,24,8,24,14,10,2017-01-01,zipcode,Mcadoo
ZCTA5 79244,48,753,43750,527,58700,552,182,468,38,122,226,69,13,432,280,152,280,203,77,2017-01-01,zipcode,Matador
ZCTA5 79245,48,2467,30682,530,49900,1942,911,1634,442,474,525,116,77,1330,974,356,974,607,367,2017-01-01,zipcode,Memphis
ZCTA5 79247,48,78,-666666666,-666666666,27500,54,16,40,7,15,18,0,0,27,27,0,27,24,3,2017-01-01,zipcode,Odell
ZCTA5 79248,48,1442,32227,288,42300,1099,412,1007,260,341,235,117,54,1013,639,374,639,407,232,2017-01-01,zipcode,Paducah
ZCTA5 79250,48,1479,62688,652,62400,1179,465,1032,210,321,282,152,67,689,533,156,533,403,130,2017-01-01,zipcode,Petersburg
ZCTA5 79251,48,23,-666666666,-666666666,63600,23,13,23,7,3,13,0,0,30,15,15,15,15,0,2017-01-01,zipcode,Quail
ZCTA5 79252,48,2996,35865,496,38000,2341,1049,2101,353,768,663,235,82,1722,1186,536,1186,889,297,2017-01-01,zipcode,Quanah
ZCTA5 79255,48,670,39417,592,104700,532,207,444,112,107,123,91,11,421,263,158,263,173,90,2017-01-01,zipcode,Quitaque
ZCTA5 79256,48,285,36000,615,54800,256,101,221,38,100,62,18,3,216,152,64,152,104,48,2017-01-01,zipcode,Roaring springs
ZCTA5 79257,48,932,44706,625,54400,765,312,687,108,229,196,115,39,552,396,156,396,333,63,2017-01-01,zipcode,Silverton
ZCTA5 79258,48,47,-666666666,-666666666,70700,47,35,35,0,25,10,0,0,26,19,7,19,19,0,2017-01-01,zipcode,South plains
ZCTA5 79259,48,36,-666666666,-666666666,-666666666,24,8,19,0,0,19,0,0,78,11,67,11,11,0,2017-01-01,zipcode,Tell
ZCTA5 79261,48,394,38571,606,55000,326,170,260,54,71,94,27,14,311,158,153,158,116,42,2017-01-01,zipcode,Turkey
ZCTA5 79311,48,3615,50750,686,82100,2751,1033,2268,472,742,657,254,143,1534,1297,237,1297,960,337,2017-01-01,zipcode,Abernathy
ZCTA5 79312,48,1020,47829,471,58600,882,393,727,191,278,170,69,19,444,379,65,379,277,102,2017-01-01,zipcode,Amherst
ZCTA5 79313,48,1738,43625,600,58400,1241,481,1072,316,267,378,80,31,751,593,158,593,409,184,2017-01-01,zipcode,Anton
ZCTA5 79314,48,70,-666666666,-666666666,30300,58,37,58,19,21,16,0,2,54,39,15,39,29,10,2017-01-01,zipcode,Bledsoe
ZCTA5 79316,48,11510,41406,732,68000,8706,4233,7359,2319,2220,1886,602,332,4321,3704,617,3704,2567,1137,2017-01-01,zipcode,Brownfield
ZCTA5 79322,48,1927,35651,628,55000,1498,586,1259,264,482,316,158,39,977,743,234,743,534,209,2017-01-01,zipcode,Crosbyton
ZCTA5 79323,48,7367,65352,708,84800,4962,1518,4103,1301,1156,1026,446,174,2411,2208,203,2208,1739,469,2017-01-01,zipcode,Denver city
ZCTA5 79324,48,67,140982,-666666666,269600,52,15,32,0,2,30,0,0,17,17,0,17,17,0,2017-01-01,zipcode,Enochs
ZCTA5 79325,48,2492,49861,684,116200,1914,751,1618,473,460,424,169,92,990,859,131,859,653,206,2017-01-01,zipcode,Farwell
ZCTA5 79326,48,153,236000,-666666666,850000,110,44,102,0,5,11,28,58,99,66,33,66,66,0,2017-01-01,zipcode,Fieldton
ZCTA5 79329,48,3216,67371,698,140300,2506,805,2055,365,680,459,391,160,1295,1135,160,1135,852,283,2017-01-01,zipcode,Idalou
ZCTA5 79330,48,316,204250,-666666666,226500,263,122,187,0,151,15,10,11,345,75,270,75,61,14,2017-01-01,zipcode,Justiceburg
ZCTA5 79331,48,12742,42513,570,67300,9967,4830,8147,2262,2952,1925,730,278,4970,4207,763,4207,2991,1216,2017-01-01,zipcode,Lamesa
ZCTA5 79336,48,17229,49332,671,89200,13381,5039,10549,2434,3053,3734,881,447,6949,6046,903,6046,4034,2012,2017-01-01,zipcode,Levelland
ZCTA5 79339,48,6624,41402,688,61100,4824,1965,4082,1056,1331,1095,393,207,2963,2311,652,2311,1581,730,2017-01-01,zipcode,Littlefield
ZCTA5 79342,48,535,91429,425,74200,347,84,308,74,58,84,32,60,213,166,47,166,67,99,2017-01-01,zipcode,Loop
ZCTA5 79343,48,1653,40694,565,68200,1204,430,960,249,343,254,87,27,640,530,110,530,324,206,2017-01-01,zipcode,Lorenzo
ZCTA5 79344,48,95,34688,-666666666,-666666666,48,28,31,0,18,9,4,0,51,18,33,18,10,8,2017-01-01,zipcode,Maple
ZCTA5 79345,48,920,52500,575,71100,674,275,573,132,211,142,76,12,367,312,55,312,243,69,2017-01-01,zipcode,Meadow
ZCTA5 79346,48,2251,36169,516,33100,1671,672,1381,524,405,333,83,36,1094,795,299,795,610,185,2017-01-01,zipcode,Morton
ZCTA5 79347,48,7212,42904,808,69800,5304,2061,4373,1283,1210,1206,522,152,2739,2312,427,2312,1645,667,2017-01-01,zipcode,Muleshoe
ZCTA5 79350,48,339,45250,695,71800,246,103,207,57,82,61,4,3,130,109,21,109,79,30,2017-01-01,zipcode,New deal
ZCTA5 79351,48,1436,46920,594,65200,1041,431,928,251,279,278,98,22,622,491,131,491,340,151,2017-01-01,zipcode,Odonnell
ZCTA5 79353,48,54,48750,-666666666,-666666666,45,15,27,13,12,2,0,0,18,11,7,11,2,9,2017-01-01,zipcode,Pep
ZCTA5 79355,48,1889,57375,830,80900,1425,475,1209,364,283,376,141,45,807,651,156,651,468,183,2017-01-01,zipcode,Plains
ZCTA5 79356,48,6372,52857,750,73700,5451,3124,4838,2108,1251,1004,387,88,1838,1618,220,1618,1043,575,2017-01-01,zipcode,Post
ZCTA5 79357,48,2260,40030,653,54800,1711,630,1451,413,502,369,137,30,1031,779,252,779,538,241,2017-01-01,zipcode,Ralls
ZCTA5 79358,48,1080,54063,918,75400,837,339,751,143,202,240,122,44,462,389,73,389,329,60,2017-01-01,zipcode,Ropesville
ZCTA5 79359,48,2900,46620,682,50000,1976,764,1585,561,586,341,88,9,1046,879,167,879,598,281,2017-01-01,zipcode,Seagraves
ZCTA5 79360,48,15623,57654,731,121700,10641,3934,8548,3312,2570,1714,601,351,4959,4447,512,4447,3526,921,2017-01-01,zipcode,Seminole
ZCTA5 79363,48,5799,65845,817,128900,4286,1593,3520,353,1217,1029,578,343,2108,1931,177,1931,1436,495,2017-01-01,zipcode,Shallowater
ZCTA5 79364,48,7710,42976,688,75300,5831,2214,5134,887,1784,1574,688,201,3702,3144,558,3144,2070,1074,2017-01-01,zipcode,Slaton
ZCTA5 79366,48,1236,97368,833,210700,993,310,906,23,164,246,292,181,553,508,45,508,453,55,2017-01-01,zipcode,Ransom canyon
ZCTA5 79367,48,756,53750,1000,73500,551,157,419,48,127,195,36,13,269,240,29,240,177,63,2017-01-01,zipcode,Smyer
ZCTA5 79369,48,138,34167,-666666666,-666666666,110,52,110,7,61,24,0,18,52,52,0,52,52,0,2017-01-01,zipcode,Spade
ZCTA5 79370,48,1572,41364,476,53600,1296,654,1136,272,344,365,89,66,1139,564,575,564,420,144,2017-01-01,zipcode,Spur
ZCTA5 79371,48,1450,50536,594,61900,1119,393,938,263,229,282,128,36,679,533,146,533,430,103,2017-01-01,zipcode,Sudan
ZCTA5 79372,48,1191,51765,723,73400,904,311,748,177,162,241,100,68,503,422,81,422,303,119,2017-01-01,zipcode,Sundown
ZCTA5 79373,48,2903,39779,650,72200,2214,979,1882,381,698,474,265,64,1415,1159,256,1159,742,417,2017-01-01,zipcode,Tahoka
ZCTA5 79376,48,49,-666666666,-666666666,-666666666,39,27,39,11,6,15,7,0,37,22,15,22,22,0,2017-01-01,zipcode,Tokio
ZCTA5 79377,48,255,66875,760,68600,187,57,153,35,47,36,26,9,147,78,69,78,61,17,2017-01-01,zipcode,Welch
ZCTA5 79378,48,290,56750,353,-666666666,226,86,197,70,62,42,18,5,129,113,16,113,74,39,2017-01-01,zipcode,Wellman
ZCTA5 79379,48,619,63611,433,47100,481,205,389,68,117,133,42,29,214,170,44,170,126,44,2017-01-01,zipcode,Whiteface
ZCTA5 79380,48,173,38750,781,45000,130,34,106,34,25,21,18,8,72,60,12,60,36,24,2017-01-01,zipcode,Whitharral
ZCTA5 79381,48,1528,51250,783,112200,1189,401,1013,260,275,286,155,37,632,512,120,512,395,117,2017-01-01,zipcode,Wilson
ZCTA5 79382,48,7122,66117,873,179900,5253,1562,4389,512,1004,1357,883,633,2729,2465,264,2465,1847,618,2017-01-01,zipcode,Wolfforth
ZCTA5 79401,48,7909,18425,943,70400,7159,3492,2692,516,675,901,270,330,4268,3203,1065,3203,358,2845,2017-01-01,zipcode,Lubbock
ZCTA5 79403,48,17401,39639,762,54100,13142,5949,10816,3371,3934,2686,624,201,6451,5431,1020,5431,3419,2012,2017-01-01,zipcode,Lubbock
ZCTA5 79404,48,10347,32393,740,47400,7779,3430,6578,2093,2272,1688,362,163,3860,3243,617,3243,1987,1256,2017-01-01,zipcode,Lubbock
ZCTA5 79406,48,6824,-666666666,-666666666,-666666666,6824,4296,32,0,0,7,25,0,0,0,0,0,0,0,2017-01-01,zipcode,Lubbock
ZCTA5 79407,48,21028,43981,772,101400,16962,4727,12544,1305,3286,4387,2134,1432,9554,8690,864,8690,4103,4587,2017-01-01,zipcode,Lubbock
ZCTA5 79410,48,9583,43408,1084,128700,8396,3155,5021,526,961,1551,866,1117,4462,3803,659,3803,1595,2208,2017-01-01,zipcode,Lubbock
ZCTA5 79411,48,7894,35812,890,64400,6562,2143,4307,1191,1094,1048,629,345,3741,3225,516,3225,1252,1973,2017-01-01,zipcode,Lubbock
ZCTA5 79412,48,17141,36584,833,77500,12491,4263,9512,2721,3574,2144,722,351,6324,5541,783,5541,2793,2748,2017-01-01,zipcode,Lubbock
ZCTA5 79413,48,22149,48898,1012,132200,16988,5709,13407,1608,3165,4364,2792,1478,9476,8442,1034,8442,4822,3620,2017-01-01,zipcode,Lubbock
ZCTA5 79414,48,18150,39165,854,91500,14173,4262,11055,1825,2831,3783,1667,949,8376,7745,631,7745,3101,4644,2017-01-01,zipcode,Lubbock
ZCTA5 79415,48,17343,29223,796,57100,13771,5163,9595,2668,3040,2326,969,592,7119,6270,849,6270,2467,3803,2017-01-01,zipcode,Lubbock
ZCTA5 79416,48,33302,48594,1006,118600,26795,8785,19324,1965,4813,6504,3327,2715,14472,12882,1590,12882,6267,6615,2017-01-01,zipcode,Lubbock
ZCTA5 79423,48,37960,63837,976,138900,28518,8192,23971,1747,5465,8240,5805,2714,15080,14189,891,14189,10095,4094,2017-01-01,zipcode,Lubbock
ZCTA5 79424,48,45948,78892,923,187800,35257,10873,29957,1562,5338,9910,8140,5007,19494,18348,1146,18348,12692,5656,2017-01-01,zipcode,Lubbock
ZCTA5 79501,48,2959,51477,757,71000,2319,1047,1959,401,518,682,291,67,1560,1206,354,1206,930,276,2017-01-01,zipcode,Anson
ZCTA5 79502,48,984,45625,496,52100,757,356,712,119,306,208,55,24,719,423,296,423,317,106,2017-01-01,zipcode,Aspermont
ZCTA5 79503,48,195,61429,-666666666,-666666666,173,114,151,2,26,55,57,11,141,90,51,90,80,10,2017-01-01,zipcode,Avoca
ZCTA5 79504,48,3157,45089,688,64500,2618,1333,2306,297,767,831,281,130,1484,1217,267,1217,1024,193,2017-01-01,zipcode,Baird
ZCTA5 79505,48,314,35625,-666666666,41700,246,138,215,39,81,46,43,6,168,119,49,119,96,23,2017-01-01,zipcode,Benjamin
ZCTA5 79506,48,679,49241,471,81400,596,293,546,43,148,218,119,18,742,339,403,339,274,65,2017-01-01,zipcode,Blackwell
ZCTA5 79508,48,1403,76989,743,168800,1089,300,938,52,331,281,258,16,543,492,51,492,408,84,2017-01-01,zipcode,Buffalo gap
ZCTA5 79510,48,7056,41059,778,82200,5575,2688,4843,603,2133,1368,506,233,3561,2689,872,2689,2205,484,2017-01-01,zipcode,Clyde
ZCTA5 79511,48,1278,58958,728,103500,1001,401,955,134,355,342,96,28,650,552,98,552,498,54,2017-01-01,zipcode,Coahoma
ZCTA5 79512,48,7907,51968,636,69000,6617,4031,5360,1352,1945,1412,498,153,3508,2235,1273,2235,1671,564,2017-01-01,zipcode,Colorado city
ZCTA5 79517,48,239,92604,-666666666,210000,187,66,187,5,30,73,70,9,120,105,15,105,84,21,2017-01-01,zipcode,Fluvanna
ZCTA5 79518,48,51,79167,-666666666,75700,51,25,44,11,13,14,5,1,60,28,32,28,28,0,2017-01-01,zipcode,Girard
ZCTA5 79519,48,52,39375,-666666666,151800,46,19,46,0,10,14,14,8,60,31,29,31,31,0,2017-01-01,zipcode,Goldsboro
ZCTA5 79520,48,2219,49886,753,62500,1631,831,1319,188,596,362,132,41,1244,967,277,967,713,254,2017-01-01,zipcode,Hamlin
ZCTA5 79521,48,3795,46270,485,58600,3273,1693,2878,965,927,661,235,90,2118,1244,874,1244,968,276,2017-01-01,zipcode,Haskell
ZCTA5 79525,48,2261,46094,763,100300,1743,793,1668,263,576,539,282,8,1147,1039,108,1039,747,292,2017-01-01,zipcode,Hawley
ZCTA5 79526,48,835,55385,850,77600,682,307,609,83,261,151,82,32,446,348,98,348,267,81,2017-01-01,zipcode,Hermleigh
ZCTA5 79527,48,183,52938,-666666666,-666666666,163,82,129,24,40,48,17,0,214,77,137,77,66,11,2017-01-01,zipcode,Ira
ZCTA5 79528,48,619,47841,475,60700,479,210,442,102,116,124,76,24,323,241,82,241,173,68,2017-01-01,zipcode,Jayton
ZCTA5 79529,48,1378,46118,524,44300,1080,489,940,157,287,278,143,75,740,527,213,527,435,92,2017-01-01,zipcode,Knox city
ZCTA5 79530,48,428,62813,700,51600,370,104,335,49,127,77,75,7,220,185,35,185,172,13,2017-01-01,zipcode,Lawn
ZCTA5 79532,48,700,61071,543,47700,509,175,461,86,177,145,46,7,424,312,112,312,252,60,2017-01-01,zipcode,Loraine
ZCTA5 79533,48,347,38333,389,31200,299,111,274,57,91,79,47,0,249,146,103,146,98,48,2017-01-01,zipcode,Lueders
ZCTA5 79534,48,59,13333,-666666666,-666666666,59,42,59,17,12,25,5,0,68,30,38,30,24,6,2017-01-01,zipcode,Mc caulley
ZCTA5 79535,48,134,65000,-666666666,54500,125,98,120,6,38,68,6,2,115,76,39,76,71,5,2017-01-01,zipcode,Maryneal
ZCTA5 79536,48,4593,50636,841,72100,3716,1295,3203,457,1191,1133,297,125,2187,1830,357,1830,1369,461,2017-01-01,zipcode,Merkel
ZCTA5 79537,48,35,-666666666,-666666666,-666666666,35,31,35,0,31,0,4,0,29,21,8,21,21,0,2017-01-01,zipcode,Nolan
ZCTA5 79538,48,210,43750,-666666666,-666666666,189,90,176,25,66,71,12,2,177,106,71,106,99,7,2017-01-01,zipcode,Novice
ZCTA5 79539,48,142,61250,525,31500,137,74,121,27,21,39,29,5,104,80,24,80,61,19,2017-01-01,zipcode,O brien
ZCTA5 79540,48,51,87813,-666666666,81700,43,9,43,3,20,13,7,0,45,21,24,21,21,0,2017-01-01,zipcode,Old glory
ZCTA5 79541,48,1137,-666666666,-666666666,259600,785,249,646,26,120,170,120,210,368,339,29,339,306,33,2017-01-01,zipcode,Ovalo
ZCTA5 79543,48,1236,46172,596,64700,953,445,834,131,260,266,148,29,617,483,134,483,363,120,2017-01-01,zipcode,Roby
ZCTA5 79544,48,496,33958,570,35000,415,204,383,128,102,109,23,21,327,220,107,220,174,46,2017-01-01,zipcode,Rochester
ZCTA5 79545,48,1913,57826,634,76600,1468,544,1221,244,351,343,199,84,873,684,189,684,568,116,2017-01-01,zipcode,Roscoe
ZCTA5 79546,48,1768,40192,532,56900,1461,669,1271,264,413,372,156,66,1103,806,297,806,529,277,2017-01-01,zipcode,Rotan
ZCTA5 79547,48,771,31667,621,32100,607,320,539,143,192,147,41,16,461,320,141,320,224,96,2017-01-01,zipcode,Rule
ZCTA5 79548,48,123,31250,-666666666,72300,116,78,112,21,40,20,22,9,132,63,69,63,54,9,2017-01-01,zipcode,Rule
ZCTA5 79549,48,16236,54820,735,91100,12500,5894,10384,2351,3294,3038,1134,567,6601,5383,1218,5383,3973,1410,2017-01-01,zipcode,Snyder
ZCTA5 79553,48,3279,38958,546,47600,2430,1214,2211,393,883,588,257,90,1973,1424,549,1424,993,431,2017-01-01,zipcode,Stamford
ZCTA5 79556,48,12915,40998,634,64800,10041,4087,8420,1670,2883,2895,711,261,6025,4783,1242,4783,3205,1578,2017-01-01,zipcode,Sweetwater
ZCTA5 79560,48,145,49500,-666666666,76500,124,52,97,14,37,32,8,6,98,68,30,68,55,13,2017-01-01,zipcode,Sylvester
ZCTA5 79561,48,736,48382,618,63300,579,248,460,55,161,186,30,28,325,272,53,272,194,78,2017-01-01,zipcode,Trent
ZCTA5 79562,48,3805,75208,891,162000,2859,877,2526,50,730,902,617,227,1489,1329,160,1329,1238,91,2017-01-01,zipcode,Tuscola
ZCTA5 79563,48,1052,37167,731,58800,775,296,657,119,334,146,52,6,437,378,59,378,266,112,2017-01-01,zipcode,Tye
ZCTA5 79565,48,223,60417,-666666666,46400,184,91,159,27,60,58,14,0,135,101,34,101,87,14,2017-01-01,zipcode,Westbrook
ZCTA5 79566,48,231,-666666666,-666666666,241700,231,115,217,21,40,83,49,24,209,125,84,125,111,14,2017-01-01,zipcode,Wingate
ZCTA5 79567,48,3517,40680,539,43400,2641,1155,2177,646,663,448,303,117,1698,1283,415,1283,821,462,2017-01-01,zipcode,Winters
ZCTA5 79601,48,28041,38691,774,88900,24525,13963,17111,3371,6139,4554,1870,1177,9363,7804,1559,7804,3624,4180,2017-01-01,zipcode,Abilene
ZCTA5 79602,48,24027,60957,819,150600,18023,6290,15168,1885,4072,4995,2866,1350,9140,8090,1050,8090,5779,2311,2017-01-01,zipcode,Abilene
ZCTA5 79603,48,23577,38427,714,71800,17861,6332,14430,3278,5151,3995,1634,372,9864,8668,1196,8668,5462,3206,2017-01-01,zipcode,Abilene
ZCTA5 79605,48,29672,45043,837,99900,23417,7940,18633,2286,5866,6567,2625,1289,13147,11217,1930,11217,6165,5052,2017-01-01,zipcode,Abilene
ZCTA5 79606,48,23929,60686,930,169700,18739,5875,15371,957,3591,6001,3030,1792,10777,9623,1154,9623,5309,4314,2017-01-01,zipcode,Abilene
ZCTA5 79607,48,3309,46786,1194,-666666666,2312,305,979,33,167,516,217,46,717,628,89,628,0,628,2017-01-01,zipcode,Dyess afb
ZCTA5 79699,48,124,-666666666,-666666666,-666666666,124,66,0,0,0,0,0,0,156,0,156,0,0,0,2017-01-01,zipcode,Abilene
ZCTA5 79701,48,29315,57758,935,114000,21454,7197,17677,5619,4701,4564,2152,641,10512,9587,925,9587,6272,3315,2017-01-01,zipcode,Midland
ZCTA5 79703,48,23083,70245,1225,143000,17448,5184,13791,2818,4461,4778,1334,400,8027,7465,562,7465,5097,2368,2017-01-01,zipcode,Midland
ZCTA5 79705,48,39818,80562,1221,226700,30470,9354,25457,3189,5311,7998,6274,2685,15133,14061,1072,14061,9713,4348,2017-01-01,zipcode,Midland
ZCTA5 79706,48,25344,75042,1111,151000,17041,5220,14623,2560,4765,4952,1953,393,8090,7555,535,7555,5898,1657,2017-01-01,zipcode,Midland
ZCTA5 79707,48,38489,97349,1264,276400,29486,7660,25304,1811,5579,8089,7052,2773,15355,14560,795,14560,8864,5696,2017-01-01,zipcode,Midland
ZCTA5 79713,48,339,59583,525,107500,256,120,216,42,58,55,26,35,175,132,43,132,92,40,2017-01-01,zipcode,Ackerly
ZCTA5 79714,48,17577,70753,997,126000,12732,4295,10390,2642,3872,2858,663,355,6164,5413,751,5413,3981,1432,2017-01-01,zipcode,Andrews
ZCTA5 79718,48,894,44671,663,42900,690,247,531,110,181,127,104,9,439,295,144,295,212,83,2017-01-01,zipcode,Balmorhea
ZCTA5 79719,48,631,44750,663,37100,465,205,369,162,89,97,15,6,231,189,42,189,134,55,2017-01-01,zipcode,Barstow
ZCTA5 79720,48,35231,51048,841,85200,28442,13556,23773,4799,8215,7646,2240,873,12539,10505,2034,10505,7040,3465,2017-01-01,zipcode,Big spring
ZCTA5 79730,48,348,43940,-666666666,29200,295,107,285,217,59,7,1,1,155,115,40,115,100,15,2017-01-01,zipcode,Coyanosa
ZCTA5 79731,48,4767,64074,702,84800,3389,1336,2846,750,795,973,211,117,1649,1458,191,1458,1126,332,2017-01-01,zipcode,Crane
ZCTA5 79733,48,198,49000,429,71300,139,53,135,23,30,49,24,9,74,68,6,68,44,24,2017-01-01,zipcode,Forsan
ZCTA5 79734,48,2129,47102,688,113000,1782,875,1678,341,241,495,298,303,1590,953,637,953,780,173,2017-01-01,zipcode,Fort davis
ZCTA5 79735,48,13383,46445,872,70100,10572,5496,9054,2817,3421,2064,497,255,4596,3609,987,3609,2517,1092,2017-01-01,zipcode,Fort stockton
ZCTA5 79738,48,265,71667,-666666666,61300,205,89,180,6,51,48,43,32,157,106,51,106,73,33,2017-01-01,zipcode,Gail
ZCTA5 79739,48,1149,44917,860,214300,920,415,781,223,191,186,103,78,452,387,65,387,280,107,2017-01-01,zipcode,Garden city
ZCTA5 79741,48,212,35625,-666666666,67600,206,119,188,6,75,77,28,2,146,121,25,121,104,17,2017-01-01,zipcode,Goldsmith
ZCTA5 79742,48,494,39861,-666666666,30100,405,180,342,111,134,52,33,12,240,175,65,175,127,48,2017-01-01,zipcode,Grandfalls
ZCTA5 79743,48,384,75000,431,63100,295,83,250,36,81,71,34,28,179,120,59,120,79,41,2017-01-01,zipcode,Imperial
ZCTA5 79744,48,1466,62900,732,77000,1102,339,906,158,229,320,161,38,563,494,69,494,321,173,2017-01-01,zipcode,Iraan
ZCTA5 79745,48,6842,49257,843,57300,5158,2163,4055,1295,1150,1231,290,89,2659,2232,427,2232,1736,496,2017-01-01,zipcode,Kermit
ZCTA5 79748,48,178,47125,-666666666,-666666666,136,58,110,46,23,23,15,3,84,53,31,53,50,3,2017-01-01,zipcode,Knott
ZCTA5 79749,48,345,80750,431,187500,261,102,207,38,43,49,53,24,127,103,24,103,77,26,2017-01-01,zipcode,Lenorah
ZCTA5 79752,48,2473,50192,549,58200,1710,833,1440,307,537,418,97,81,1067,864,203,864,638,226,2017-01-01,zipcode,Mc camey
ZCTA5 79754,48,59,75000,930,-666666666,59,28,56,13,16,27,0,0,55,28,27,28,16,12,2017-01-01,zipcode,Mentone
ZCTA5 79755,48,188,40486,711,-666666666,154,54,143,50,30,53,10,0,84,73,11,73,30,43,2017-01-01,zipcode,Midkiff
ZCTA5 79756,48,9622,66974,815,89900,7247,2946,6001,1179,2164,1798,572,288,3899,3307,592,3307,2303,1004,2017-01-01,zipcode,Monahans
ZCTA5 79758,48,2137,82794,833,141400,1398,307,1305,56,490,625,105,29,961,784,177,784,567,217,2017-01-01,zipcode,Gardendale
ZCTA5 79759,48,16,-666666666,-666666666,-666666666,16,0,16,0,16,0,0,0,8,8,0,8,8,0,2017-01-01,zipcode,Notrees
ZCTA5 79761,48,33922,53722,897,123100,25087,7730,20302,5475,5880,6212,2054,681,12604,11226,1378,11226,7183,4043,2017-01-01,zipcode,Odessa
ZCTA5 79762,48,44014,64239,1067,148300,33014,8989,26372,4145,7227,9011,4130,1859,17477,15613,1864,15613,8849,6764,2017-01-01,zipcode,Odessa
ZCTA5 79763,48,37282,51849,862,99000,26670,9684,21571,7231,6274,6177,1558,331,12713,11485,1228,11485,7784,3701,2017-01-01,zipcode,Odessa
ZCTA5 79764,48,22105,50827,936,83300,16239,5580,13155,4247,4708,3465,545,190,7918,7390,528,7390,5509,1881,2017-01-01,zipcode,Odessa
ZCTA5 79765,48,13451,95551,1359,212500,9912,2577,8475,822,1910,2605,2064,1074,5254,4917,337,4917,3492,1425,2017-01-01,zipcode,Odessa
ZCTA5 79766,48,6519,57024,832,93300,4531,1869,3592,1310,1183,792,242,65,1940,1780,160,1780,1436,344,2017-01-01,zipcode,Odessa
ZCTA5 79770,48,56,-666666666,-666666666,-666666666,30,11,30,0,0,30,0,0,94,11,83,11,11,0,2017-01-01,zipcode,Orla
ZCTA5 79772,48,13569,51420,798,56200,10982,5947,9073,3532,2509,2238,556,238,3982,3348,634,3348,2397,951,2017-01-01,zipcode,Pecos
ZCTA5 79777,48,248,52200,-666666666,60000,169,64,146,16,47,46,37,0,153,90,63,90,42,48,2017-01-01,zipcode,Pyote
ZCTA5 79778,48,903,61875,557,80000,721,295,630,128,268,186,27,21,450,360,90,360,286,74,2017-01-01,zipcode,Rankin
ZCTA5 79780,48,179,-666666666,-666666666,-666666666,120,53,104,48,12,28,13,3,88,63,25,63,48,15,2017-01-01,zipcode,Saragosa
ZCTA5 79781,48,350,44432,680,32500,267,95,200,6,98,73,3,20,227,111,116,111,80,31,2017-01-01,zipcode,Sheffield
ZCTA5 79782,48,4521,66375,819,113800,3271,1131,2638,616,834,674,348,166,1491,1307,184,1307,991,316,2017-01-01,zipcode,Stanton
ZCTA5 79783,48,305,112639,-666666666,201600,232,95,212,22,101,50,28,11,118,99,19,99,87,12,2017-01-01,zipcode,Tarzan
ZCTA5 79785,48,114,-666666666,-666666666,-666666666,67,25,63,11,20,22,10,0,43,31,12,31,23,8,2017-01-01,zipcode,Toyah
ZCTA5 79788,48,469,51250,675,42200,365,135,321,60,159,90,12,0,212,173,39,173,141,32,2017-01-01,zipcode,Wickett
ZCTA5 79789,48,908,70909,678,63300,616,226,508,99,161,160,75,13,331,278,53,278,224,54,2017-01-01,zipcode,Wink
ZCTA5 79821,48,7269,38011,610,94100,5551,2886,4783,1164,1462,1574,417,166,1943,1775,168,1775,1232,543,2017-01-01,zipcode,Anthony
ZCTA5 79830,48,7802,38563,634,131700,6317,2554,5561,850,1257,1460,1224,770,4181,3215,966,3215,1707,1508,2017-01-01,zipcode,Alpine
ZCTA5 79831,48,14,-666666666,-666666666,-666666666,14,0,14,0,0,4,4,6,22,10,12,10,4,6,2017-01-01,zipcode,
ZCTA5 79834,48,173,47411,566,-666666666,157,26,153,12,26,51,48,16,126,81,45,81,1,80,2017-01-01,zipcode,Big bend national park
ZCTA5 79835,48,11835,28833,694,77100,8363,3766,6207,2494,1580,1333,557,243,3566,3206,360,3206,2097,1109,2017-01-01,zipcode,Canutillo
ZCTA5 79836,48,5889,37453,636,83000,4326,1682,3566,1151,1091,875,276,173,1899,1736,163,1736,1404,332,2017-01-01,zipcode,Clint
ZCTA5 79837,48,456,19625,-666666666,29400,339,226,288,99,62,110,12,5,312,179,133,179,93,86,2017-01-01,zipcode,Dell city
ZCTA5 79838,48,6719,27724,513,58300,5008,2436,4123,2080,1236,659,110,38,2319,2020,299,2020,1289,731,2017-01-01,zipcode,Fabens
ZCTA5 79839,48,1748,18393,594,45400,1315,672,1098,706,251,98,43,0,680,429,251,429,358,71,2017-01-01,zipcode,Fort hancock
ZCTA5 79842,48,533,48438,542,94200,468,158,422,62,84,115,109,52,466,258,208,258,179,79,2017-01-01,zipcode,Marathon
ZCTA5 79843,48,2298,41333,727,107600,1677,649,1420,353,281,298,283,205,1415,802,613,802,557,245,2017-01-01,zipcode,Marfa
ZCTA5 79845,48,4785,22997,438,44000,3632,1996,3059,1769,526,338,325,101,2440,1755,685,1755,986,769,2017-01-01,zipcode,Presidio
ZCTA5 79846,48,93,-666666666,-666666666,-666666666,36,25,23,23,0,0,0,0,58,17,41,17,0,17,2017-01-01,zipcode,Redford
ZCTA5 79847,48,100,50921,2013,18300,78,18,78,0,38,27,13,0,107,60,47,60,18,42,2017-01-01,zipcode,Salt flat
ZCTA5 79848,48,662,25625,744,66700,543,292,522,102,155,189,46,30,679,325,354,325,254,71,2017-01-01,zipcode,Sanderson
ZCTA5 79849,48,12452,27555,637,67000,8892,3898,6801,3426,1556,1240,559,20,3639,3274,365,3274,2339,935,2017-01-01,zipcode,San elizario
ZCTA5 79851,48,1227,36083,576,44500,1042,775,876,380,265,162,61,8,385,213,172,213,120,93,2017-01-01,zipcode,Sierra blanca
ZCTA5 79852,48,698,26042,367,76900,614,363,587,79,156,174,107,71,665,368,297,368,264,104,2017-01-01,zipcode,Terlingua
ZCTA5 79853,48,2912,31750,472,52400,1958,871,1436,741,401,223,57,14,830,720,110,720,576,144,2017-01-01,zipcode,Tornillo
ZCTA5 79854,48,109,-666666666,512,44400,99,44,99,19,34,11,22,13,157,59,98,59,26,33,2017-01-01,zipcode,Valentine
ZCTA5 79855,48,2208,27418,535,57000,1777,775,1533,573,511,316,96,37,1007,715,292,715,490,225,2017-01-01,zipcode,Van horn
ZCTA5 79901,48,10284,13087,380,53200,8279,4908,6909,4418,1266,1009,169,47,4614,3929,685,3929,416,3513,2017-01-01,zipcode,El paso
ZCTA5 79902,48,20123,32989,603,152900,16933,7073,13913,3436,2323,3789,2541,1824,9426,8097,1329,8097,3358,4739,2017-01-01,zipcode,El paso
ZCTA5 79903,48,16495,30534,563,88900,13787,6356,11882,4082,2818,3143,1259,580,6905,6042,863,6042,3489,2553,2017-01-01,zipcode,El paso
ZCTA5 79904,48,34098,35605,818,100400,23983,10490,19443,4439,5491,6653,2130,730,12410,10835,1575,10835,4724,6111,2017-01-01,zipcode,El paso
ZCTA5 79905,48,23108,21856,453,80000,17902,8646,14936,6411,3875,3578,802,270,8687,7682,1005,7682,4075,3607,2017-01-01,zipcode,El paso
ZCTA5 79906,48,5125,49119,1326,-666666666,3074,897,1888,87,328,825,442,206,1361,1166,195,1166,0,1166,2017-01-01,zipcode,El paso
ZCTA5 79907,48,53505,31031,661,87800,40912,17979,32731,11195,10079,8116,2516,825,17547,16252,1295,16252,9708,6544,2017-01-01,zipcode,El paso
ZCTA5 79908,48,5299,61836,1565,-666666666,3695,570,2057,10,370,1072,418,187,817,729,88,729,0,729,2017-01-01,zipcode,El paso
ZCTA5 79911,48,4474,91957,1453,222500,3236,524,2886,34,166,901,940,845,1641,1524,117,1524,1213,311,2017-01-01,zipcode,El paso
ZCTA5 79912,48,81159,57863,889,185500,61602,21496,50582,5319,7528,13322,14944,9469,31950,28546,3404,28546,15413,13133,2017-01-01,zipcode,El paso
ZCTA5 79915,48,35622,30101,595,86100,29114,13757,24593,8767,7115,6289,1792,630,13463,12338,1125,12338,7329,5009,2017-01-01,zipcode,El paso
ZCTA5 79916,48,3074,-666666666,-666666666,-666666666,3056,134,1020,6,118,522,228,146,5,5,0,5,0,5,2017-01-01,zipcode,Fort bliss
ZCTA5 79920,48,5,-666666666,-666666666,-666666666,5,0,0,0,0,0,0,0,0,0,0,0,0,0,2017-01-01,zipcode,
ZCTA5 79922,48,8528,75880,805,274900,6920,2798,5604,603,964,1304,1615,1118,2992,2723,269,2723,2318,405,2017-01-01,zipcode,El paso
ZCTA5 79924,48,59587,40682,840,99000,45140,19767,36168,7594,10587,12035,4538,1414,21718,19629,2089,19629,12121,7508,2017-01-01,zipcode,El paso
ZCTA5 79925,48,39455,46870,799,137900,31306,11817,25432,3469,6267,9590,4178,1928,16298,14706,1592,14706,7674,7032,2017-01-01,zipcode,El paso
ZCTA5 79927,48,41162,33255,705,86100,30555,13157,23840,9784,6732,5946,967,411,11657,11028,629,11028,8210,2818,2017-01-01,zipcode,El paso
ZCTA5 79928,48,56851,50513,960,116000,39098,13250,30647,6996,7893,10219,4167,1372,16146,15175,971,15175,12511,2664,2017-01-01,zipcode,El paso
ZCTA5 79930,48,28324,33229,727,91900,22354,9024,18402,5468,4322,5324,2236,1052,12108,10286,1822,10286,4844,5442,2017-01-01,zipcode,El paso
ZCTA5 79932,48,28345,56485,849,157100,20786,7022,17397,2682,3241,5551,3856,2067,9436,8927,509,8927,6443,2484,2017-01-01,zipcode,El paso
ZCTA5 79934,48,25846,68084,1151,134400,18555,5257,15054,1230,2879,5719,3427,1799,9694,8571,1123,8571,5910,2661,2017-01-01,zipcode,El paso
ZCTA5 79935,48,18166,47744,787,143000,14819,5913,12164,2163,3022,4166,2122,691,6826,6242,584,6242,3507,2735,2017-01-01,zipcode,El paso
ZCTA5 79936,48,111918,52785,949,124000,85215,28402,66558,9491,17675,23332,11471,4589,37001,34781,2220,34781,23930,10851,2017-01-01,zipcode,El paso
ZCTA5 79938,48,77487,55742,1010,139400,53033,17418,42794,7790,8965,16025,7605,2409,23123,21340,1783,21340,16054,5286,2017-01-01,zipcode,El paso
ZCTA5 79942,48,19,-666666666,-666666666,-666666666,19,0,19,0,10,0,9,0,9,9,0,9,9,0,2017-01-01,zipcode,El paso
ZCTA5 07001,34,18307,71943,1390,267700,15163,7727,13710,904,6810,2433,2198,1365,5210,4955,255,4955,2504,2451,2018-01-01,zipcode,Avenel
ZCTA5 07002,34,65300,59924,1221,320300,51570,18635,45316,5482,14839,8933,11015,5047,27272,24975,2297,24975,9486,15489,2018-01-01,zipcode,Bayonne
ZCTA5 07003,34,48810,76487,1333,322600,39595,11634,34224,2838,8862,8722,8821,4981,19032,18080,952,18080,9391,8689,2018-01-01,zipcode,Bloomfield
ZCTA5 07004,34,7331,117750,2096,474300,5968,2306,5406,326,1394,1180,1818,688,2926,2696,230,2696,2407,289,2018-01-01,zipcode,Fairfield
ZCTA5 07005,34,15095,111380,1414,457600,12263,3309,10462,575,2079,2264,3713,1831,5861,5495,366,5495,4117,1378,2018-01-01,zipcode,Boonton
ZCTA5 07006,34,25529,117828,1475,547800,20792,6642,18342,903,3409,3264,6577,4189,10035,9606,429,9606,7330,2276,2018-01-01,zipcode,Caldwell
ZCTA5 07008,34,23682,74676,1510,271900,18760,6422,16436,2224,5801,4383,3033,995,8500,7950,550,7950,4559,3391,2018-01-01,zipcode,Carteret
ZCTA5 07009,34,12531,119946,1483,465500,10546,4026,9256,543,2362,1756,3060,1535,4578,4451,127,4451,3542,909,2018-01-01,zipcode,Cedar grove
ZCTA5 07010,34,24883,66952,1392,443300,21594,7762,19345,2031,5568,3482,5439,2825,11300,10535,765,10535,4967,5568,2018-01-01,zipcode,Cliffside park
ZCTA5 07011,34,40173,57517,1373,298800,32556,10920,26348,3782,10801,6200,4251,1314,13746,12574,1172,12574,6068,6506,2018-01-01,zipcode,Clifton
ZCTA5 07012,34,12181,80881,1414,352700,9904,3560,8774,741,2239,1665,2526,1603,4898,4645,253,4645,2476,2169,2018-01-01,zipcode,Clifton
ZCTA5 07013,34,26950,91963,1335,357500,22693,7676,20171,2259,4948,4994,5094,2876,10922,9959,963,9959,7106,2853,2018-01-01,zipcode,Clifton
ZCTA5 07014,34,4971,93023,1406,327800,3836,939,3485,179,937,786,1068,515,1996,1807,189,1807,1371,436,2018-01-01,zipcode,Clifton
ZCTA5 07016,34,23882,126655,1677,474200,19049,5813,16766,775,3053,3512,5561,3865,9057,8654,403,8654,6892,1762,2018-01-01,zipcode,Cranford
ZCTA5 07017,34,35731,44805,1030,217300,28031,9189,24012,3141,8888,7605,3026,1352,15581,13066,2515,13066,3641,9425,2018-01-01,zipcode,East orange
ZCTA5 07018,34,28756,44869,1123,207300,22902,7828,18909,2604,7106,5692,2381,1126,12567,10585,1982,10585,2479,8106,2018-01-01,zipcode,East orange
ZCTA5 07020,34,12184,107143,2365,563800,10037,2959,9241,329,1492,1057,4105,2258,6328,5746,582,5746,1891,3855,2018-01-01,zipcode,Edgewater
ZCTA5 07021,34,2180,198750,2286,824600,1691,634,1482,22,127,134,609,590,839,782,57,782,741,41,2018-01-01,zipcode,Essex fells
ZCTA5 07022,34,14269,57706,1384,354300,11998,3855,10488,2987,3452,1954,1629,466,5690,5393,297,5393,1824,3569,2018-01-01,zipcode,Fairview
ZCTA5 07023,34,7602,133452,2811,450200,5731,1897,5055,53,1054,726,1765,1457,2607,2544,63,2544,2228,316,2018-01-01,zipcode,Fanwood
ZCTA5 07024,34,37008,78151,1800,324000,31590,12540,28831,1718,5027,5104,10402,6580,18538,17013,1525,17013,9941,7072,2018-01-01,zipcode,Fort lee
ZCTA5 07026,34,31697,57181,1285,333900,25298,9139,21613,3071,9003,5235,3224,1080,12153,11329,824,11329,4313,7016,2018-01-01,zipcode,Garfield
ZCTA5 07027,34,4334,84896,1499,369800,3579,992,3108,141,872,822,774,499,1835,1773,62,1773,1060,713,2018-01-01,zipcode,Garwood
ZCTA5 07028,34,7685,213138,1601,642700,5426,1571,4820,122,558,647,1965,1528,2528,2449,79,2449,2304,145,2018-01-01,zipcode,Glen ridge
ZCTA5 07029,34,18889,65377,1382,327400,15166,4392,13136,2313,3828,2411,2377,2207,7005,6635,370,6635,1833,4802,2018-01-01,zipcode,Harrison
ZCTA5 07030,34,53211,136402,2231,693400,46327,9473,41102,2293,3350,3103,20771,11585,27308,25132,2176,25132,8224,16908,2018-01-01,zipcode,Hoboken
ZCTA5 07031,34,15724,75291,1350,350600,13173,4679,11478,1230,3715,2749,2534,1250,6435,6248,187,6248,3257,2991,2018-01-01,zipcode,North arlington
ZCTA5 07032,34,41523,67284,1244,323400,33633,11600,28858,5246,9716,6330,5492,2074,14547,13568,979,13568,6407,7161,2018-01-01,zipcode,Kearny
ZCTA5 07033,34,8160,98624,1415,346000,6641,2470,5710,638,1799,1637,1241,395,2989,2828,161,2828,2255,573,2018-01-01,zipcode,Kenilworth
ZCTA5 07034,34,8964,85293,1211,332400,7470,2051,6511,436,1512,1270,2118,1175,3568,3331,237,3331,2119,1212,2018-01-01,zipcode,Lake hiawatha
ZCTA5 07035,34,10552,93377,1651,334100,8778,3004,7655,496,2376,1986,1849,948,3797,3641,156,3641,2789,852,2018-01-01,zipcode,Lincoln park
ZCTA5 07036,34,43607,68531,1223,275300,35613,11610,30506,4169,10000,9496,4576,2265,16413,15166,1247,15166,8407,6759,2018-01-01,zipcode,Linden
ZCTA5 07039,34,29698,163403,2615,618400,23097,8373,20544,720,2658,2763,7284,7119,10446,9994,452,9994,8867,1127,2018-01-01,zipcode,Livingston
ZCTA5 07040,34,24471,131607,1569,510300,18217,4926,15912,700,2496,2754,5018,4944,8562,7987,575,7987,6097,1890,2018-01-01,zipcode,Maplewood
ZCTA5 07041,34,7075,109167,1708,765300,5172,1586,4638,161,462,561,1579,1875,2761,2520,241,2520,1629,891,2018-01-01,zipcode,Millburn
ZCTA5 07042,34,26029,103345,1600,518000,20595,6117,18141,750,2495,3220,6482,5194,11149,10297,852,10297,5101,5196,2018-01-01,zipcode,Montclair
ZCTA5 07043,34,12772,191706,1850,736800,9492,3140,7992,202,364,853,3027,3546,4291,4171,120,4171,3335,836,2018-01-01,zipcode,Montclair
ZCTA5 07044,34,13622,120408,1515,445100,10831,3351,9815,251,1508,1744,3633,2679,5473,5139,334,5139,4130,1009,2018-01-01,zipcode,Verona
ZCTA5 07045,34,10655,166429,2375,588500,8578,3021,7679,298,1260,1246,2470,2405,4132,3942,190,3942,3721,221,2018-01-01,zipcode,Montville
ZCTA5 07046,34,4288,212426,1430,846800,3192,1213,2635,6,87,254,902,1386,1404,1363,41,1363,1264,99,2018-01-01,zipcode,Mountain lakes
ZCTA5 07047,34,61970,61734,1363,329400,50191,15142,43875,7858,13720,10096,8420,3781,23468,21900,1568,21900,8512,13388,2018-01-01,zipcode,North bergen
ZCTA5 07050,34,30324,38526,1108,228700,23981,8475,20622,3805,6453,5628,3395,1341,13339,12245,1094,12245,2614,9631,2018-01-01,zipcode,Orange
ZCTA5 07052,34,47210,99845,1491,372400,38606,12392,33753,2754,7277,6467,9698,7557,17451,16281,1170,16281,11113,5168,2018-01-01,zipcode,West orange
ZCTA5 07054,34,29516,94665,1308,452400,24702,7972,21676,1565,3995,3759,7043,5314,11546,11166,380,11166,5734,5432,2018-01-01,zipcode,Parsippany
ZCTA5 07055,34,70199,36288,1177,325600,49981,20551,40739,13802,13818,6630,4258,2231,21574,19672,1902,19672,4511,15161,2018-01-01,zipcode,Passaic
ZCTA5 07057,34,11580,65212,1232,356800,9907,3411,8814,800,3222,2103,1850,839,5119,4676,443,4676,1934,2742,2018-01-01,zipcode,Wallington
ZCTA5 07058,34,5068,136122,1648,613100,3865,856,3459,182,342,511,1462,962,1971,1886,85,1886,1020,866,2018-01-01,zipcode,Pine brook
ZCTA5 07059,34,15783,165030,1485,784900,12671,4726,10818,420,1710,1639,3438,3611,5362,5153,209,5153,4758,395,2018-01-01,zipcode,Warren
ZCTA5 07060,34,45986,58796,1198,268300,36354,10194,30393,7797,9205,7102,4161,2128,15663,14850,813,14850,5930,8920,2018-01-01,zipcode,Plainfield
ZCTA5 07062,34,12618,71004,1248,232500,9764,2848,8351,927,3116,2425,1147,736,4552,3992,560,3992,2529,1463,2018-01-01,zipcode,Plainfield
ZCTA5 07063,34,13666,71144,1315,246000,10410,3344,8861,1786,3205,2225,1007,638,4314,3995,319,3995,2589,1406,2018-01-01,zipcode,Plainfield
ZCTA5 07064,34,4139,82361,1477,286200,3222,1180,2758,305,1084,688,505,176,1462,1339,123,1339,1100,239,2018-01-01,zipcode,Port reading
ZCTA5 07065,34,29370,74164,1322,266300,24001,7227,20874,2426,7153,5363,4050,1882,12120,11188,932,11188,6541,4647,2018-01-01,zipcode,Rahway
ZCTA5 07066,34,15603,100464,1404,428200,13184,4297,11492,999,3248,2508,2802,1935,5897,5788,109,5788,4585,1203,2018-01-01,zipcode,Clark
ZCTA5 07067,34,18079,105330,1475,356100,15024,4440,13132,795,4079,3177,3062,2019,6305,6109,196,6109,5416,693,2018-01-01,zipcode,Colonia
ZCTA5 07068,34,5849,126250,2319,500800,4819,1801,4363,147,676,713,1598,1229,2491,2341,150,2341,1891,450,2018-01-01,zipcode,Roseland
ZCTA5 07069,34,5984,153707,1724,702300,4880,2009,4228,94,907,952,987,1288,2226,1912,314,1912,1551,361,2018-01-01,zipcode,Watchung
ZCTA5 07070,34,18427,96384,1373,460900,15096,4847,13122,515,2986,2549,4414,2658,7372,7101,271,7101,4473,2628,2018-01-01,zipcode,Rutherford
ZCTA5 07071,34,22030,78036,1386,367700,18471,6598,16174,1584,5435,3711,3513,1931,8936,8442,494,8442,4618,3824,2018-01-01,zipcode,Lyndhurst
ZCTA5 07072,34,6191,100792,1260,375000,5234,1590,4537,499,1289,1043,1112,594,2539,2321,218,2321,1500,821,2018-01-01,zipcode,Carlstadt
ZCTA5 07073,34,9466,78429,1444,389300,7952,2793,7134,497,1845,1744,2333,715,4129,3800,329,3800,1380,2420,2018-01-01,zipcode,East rutherford
ZCTA5 07074,34,2739,65688,1330,356700,2141,737,1982,298,741,461,309,173,1061,977,84,977,779,198,2018-01-01,zipcode,Moonachie
ZCTA5 07075,34,8511,92989,1670,386600,6970,2340,5956,268,1633,1578,1482,995,3309,3252,57,3252,2243,1009,2018-01-01,zipcode,Wood ridge
ZCTA5 07076,34,24121,128750,1509,484200,19323,6176,17192,688,3046,3369,5522,4567,9090,8714,376,8714,7126,1588,2018-01-01,zipcode,Scotch plains
ZCTA5 07077,34,2318,77396,1292,286600,1981,586,1800,107,553,466,448,226,1007,923,84,923,655,268,2018-01-01,zipcode,Sewaren
ZCTA5 07078,34,13097,250001,2468,1364400,9232,3269,8166,203,268,406,2791,4498,4146,4050,96,4050,3693,357,2018-01-01,zipcode,Short hills
ZCTA5 07079,34,16473,133281,1658,577000,13631,5027,9938,444,1113,1342,3630,3409,5600,5146,454,5146,3555,1591,2018-01-01,zipcode,South orange
ZCTA5 07080,34,23854,100573,1812,333200,19406,5911,17095,1568,5196,4333,3917,2081,8111,7829,282,7829,6495,1334,2018-01-01,zipcode,South plainfield
ZCTA5 07081,34,17398,114296,1673,433400,14027,4257,12691,493,2456,1918,4482,3342,7336,6972,364,6972,4459,2513,2018-01-01,zipcode,Springfield
ZCTA5 07082,34,5192,116791,2045,536700,4155,1223,3334,91,600,667,1136,840,1770,1617,153,1617,1526,91,2018-01-01,zipcode,Towaco
ZCTA5 07083,34,55183,87952,1500,323000,46483,15122,39718,4399,11629,9509,9632,4549,20231,19239,992,19239,14308,4931,2018-01-01,zipcode,Union
ZCTA5 07086,34,14327,94544,1451,590500,12194,3212,11211,968,2156,1659,3554,2874,7086,6461,625,6461,2207,4254,2018-01-01,zipcode,Weehawken
ZCTA5 07087,34,68484,45620,1203,317900,54659,17312,46733,13899,15254,8009,6565,3006,26759,24194,2565,24194,4769,19425,2018-01-01,zipcode,Union city
ZCTA5 07088,34,3133,52299,1513,222800,2789,1008,2416,303,964,706,343,100,1345,1223,122,1223,762,461,2018-01-01,zipcode,Vauxhall
ZCTA5 07090,34,30068,168983,1663,728000,22282,7292,19473,470,2222,2491,7512,6778,10897,10367,530,10367,8627,1740,2018-01-01,zipcode,Westfield
ZCTA5 07092,34,6900,130345,1858,636700,5626,2400,4985,201,1044,1032,1539,1169,2493,2438,55,2438,2195,243,2018-01-01,zipcode,Mountainside
ZCTA5 07093,34,63913,54824,1296,312100,52312,15908,46028,11231,12840,8222,9021,4714,26003,24319,1684,24319,5904,18415,2018-01-01,zipcode,West new york
ZCTA5 07094,34,19390,101184,1597,448100,16118,5683,14332,1538,3651,2521,4038,2584,7781,7285,496,7285,4066,3219,2018-01-01,zipcode,Secaucus
ZCTA5 07095,34,19540,82917,1648,278200,15690,4692,13963,1223,4002,3575,3108,2055,7729,7199,530,7199,4081,3118,2018-01-01,zipcode,Woodbridge
ZCTA5 07102,34,13382,25351,786,244200,11347,6003,8090,2338,2293,1879,777,803,5461,5079,382,5079,448,4631,2018-01-01,zipcode,Newark
ZCTA5 07103,34,32471,29304,1021,181600,25076,11325,19312,4311,7013,5218,1984,786,13310,11085,2225,11085,2697,8388,2018-01-01,zipcode,Newark
ZCTA5 07104,34,51250,36799,1059,265900,39244,13603,32741,8605,10588,7770,4034,1744,20444,18606,1838,18606,4441,14165,2018-01-01,zipcode,Newark
ZCTA5 07105,34,52033,44721,1161,309400,41693,14180,36691,12772,13314,5621,3381,1603,17871,16796,1075,16796,3664,13132,2018-01-01,zipcode,Newark
ZCTA5 07106,34,33583,39562,1053,196400,25959,8612,21427,3117,7874,6642,2575,1219,13828,11339,2489,11339,3536,7803,2018-01-01,zipcode,Newark
ZCTA5 07107,34,37524,31366,1039,230400,28086,10204,22998,7033,7824,5269,2267,605,14998,12749,2249,12749,2729,10020,2018-01-01,zipcode,Newark
ZCTA5 07108,34,22047,26317,920,191100,16188,6592,13102,2544,5209,3783,1210,356,10557,8323,2234,8323,1445,6878,2018-01-01,zipcode,Newark
ZCTA5 07109,34,36019,70054,1301,288700,29410,8676,24870,2891,7951,7140,4885,2003,13653,12493,1160,12493,6409,6084,2018-01-01,zipcode,Belleville
ZCTA5 07110,34,28428,95259,1317,379000,23260,7277,20573,1142,5302,4445,6089,3595,11366,10831,535,10831,7169,3662,2018-01-01,zipcode,Nutley
ZCTA5 07111,34,54035,41868,1022,172000,42148,11814,36078,5854,13799,10156,4469,1800,24600,20403,4197,20403,5588,14815,2018-01-01,zipcode,Irvington
ZCTA5 07112,34,25555,35680,1080,229500,20101,6464,16793,2115,5903,6196,1961,618,12055,9582,2473,9582,2507,7075,2018-01-01,zipcode,Newark
ZCTA5 07114,34,12749,26970,870,212900,10522,6689,9360,2495,4231,1903,575,156,4348,3460,888,3460,480,2980,2018-01-01,zipcode,Newark
ZCTA5 07201,34,27790,46160,1151,266100,21372,6521,17937,4664,6658,4508,1610,497,9611,8557,1054,8557,2072,6485,2018-01-01,zipcode,Elizabeth
ZCTA5 07202,34,41235,48527,1155,273000,32395,10063,27310,6736,10971,6343,2264,996,14054,12999,1055,12999,3036,9963,2018-01-01,zipcode,Elizabeth
ZCTA5 07203,34,21582,61804,1136,214300,17433,5654,14521,1871,4943,4747,2101,859,8345,7528,817,7528,4189,3339,2018-01-01,zipcode,Roselle
ZCTA5 07204,34,13568,71846,1227,281000,10792,3124,9276,956,2576,2277,2431,1036,5285,5087,198,5087,2972,2115,2018-01-01,zipcode,Roselle park
ZCTA5 07205,34,21895,71102,1294,235300,17868,5165,14803,1954,5100,4224,2232,1293,7714,7271,443,7271,4710,2561,2018-01-01,zipcode,Hillside
ZCTA5 07206,34,27660,44048,1178,248700,19376,6543,15800,5963,6090,2693,726,328,8959,7844,1115,7844,1870,5974,2018-01-01,zipcode,Elizabethport
ZCTA5 07208,34,31442,47728,1110,296200,24297,6961,20596,3956,7448,4862,2963,1367,11791,10981,810,10981,2874,8107,2018-01-01,zipcode,Elizabeth
ZCTA5 07302,34,43770,123617,2236,668300,37764,7966,35382,2332,3235,3625,13746,12444,23842,20926,2916,20926,5791,15135,2018-01-01,zipcode,Jersey city
ZCTA5 07304,34,44233,48238,1113,297500,34197,10813,29833,5102,9027,6603,6562,2539,17481,15750,1731,15750,4283,11467,2018-01-01,zipcode,Jersey city
ZCTA5 07305,34,64535,51755,1192,300700,50314,18325,42083,6396,14453,9468,7918,3848,25088,22280,2808,22280,8804,13476,2018-01-01,zipcode,Jersey city
ZCTA5 07306,34,52945,53327,1168,346100,43441,15957,37732,5459,7837,6487,11770,6179,22043,20216,1827,20216,4485,15731,2018-01-01,zipcode,Jersey city
ZCTA5 07307,34,43055,62562,1280,377300,34584,11641,29515,4916,7628,5807,7156,4008,17076,15774,1302,15774,4717,11057,2018-01-01,zipcode,Jersey city
ZCTA5 07310,34,12682,153657,2872,727200,11408,2834,9749,190,481,508,3237,5333,6576,5776,800,5776,894,4882,2018-01-01,zipcode,Jersey city
ZCTA5 07311,34,404,186780,2816,-666666666,385,64,385,0,0,38,114,233,327,238,89,238,0,238,2018-01-01,zipcode,Jersey city
ZCTA5 07401,34,6762,158977,1921,710600,5078,1764,4356,102,356,790,1892,1216,2403,2254,149,2254,1925,329,2018-01-01,zipcode,Allendale
ZCTA5 07403,34,7999,90372,1612,297000,6511,2055,5501,344,1724,1363,1453,617,3011,2883,128,2883,1892,991,2018-01-01,zipcode,Bloomingdale
ZCTA5 07405,34,17620,116692,1386,440900,14315,3983,12288,439,3028,2556,3714,2551,6495,6242,253,6242,4772,1470,2018-01-01,zipcode,Butler
ZCTA5 07407,34,20112,77887,1572,353100,16230,5214,13933,1352,5344,3255,2911,1071,7281,6890,391,6890,3858,3032,2018-01-01,zipcode,Elmwood park
ZCTA5 07410,34,33081,115512,1629,409700,26638,8201,23010,1216,4490,4825,7459,5020,11904,11463,441,11463,9178,2285,2018-01-01,zipcode,Fair lawn
ZCTA5 07416,34,5432,69085,1158,187800,4390,1382,3761,295,1511,1131,616,208,2542,2129,413,2129,1580,549,2018-01-01,zipcode,Franklin
ZCTA5 07417,34,10883,159883,2564,955000,8819,3410,7682,134,1045,1441,2933,2129,3936,3758,178,3758,3305,453,2018-01-01,zipcode,Franklin lakes
ZCTA5 07418,34,2304,130563,-666666666,282600,1924,453,1483,41,540,421,367,114,842,766,76,766,724,42,2018-01-01,zipcode,Glenwood
ZCTA5 07419,34,8820,88339,1477,225700,7058,2383,6341,250,1842,1992,1485,772,4059,3619,440,3619,2772,847,2018-01-01,zipcode,Hamburg
ZCTA5 07420,34,5100,81737,1474,261600,4109,1462,3774,466,1515,792,770,231,1729,1598,131,1598,1369,229,2018-01-01,zipcode,Haskell
ZCTA5 07421,34,7357,92274,1767,261900,6015,1661,5094,377,2069,1124,1001,523,3260,2637,623,2637,2315,322,2018-01-01,zipcode,Hewitt
ZCTA5 07422,34,6377,93217,1183,216300,5347,1429,4711,173,1555,1429,1069,485,3025,2320,705,2320,2179,141,2018-01-01,zipcode,Highland lakes
ZCTA5 07423,34,4101,191645,2378,740300,2966,985,2716,60,187,234,1340,895,1498,1415,83,1415,1340,75,2018-01-01,zipcode,Ho ho kus
ZCTA5 07424,34,26948,85254,1448,364300,22419,7530,18427,1442,5732,3540,4954,2759,10031,9556,475,9556,6352,3204,2018-01-01,zipcode,Little falls
ZCTA5 07430,34,26325,104800,1859,492400,21862,7574,17281,766,3493,3236,5855,3931,9632,9505,127,9505,7515,1990,2018-01-01,zipcode,Mahwah
ZCTA5 07432,34,7263,119231,1711,498500,5712,1596,4996,302,1485,1006,1382,821,2741,2604,137,2604,1809,795,2018-01-01,zipcode,Midland park
ZCTA5 07435,34,2629,121599,1071,373800,2115,641,1741,52,430,298,558,403,1262,925,337,925,810,115,2018-01-01,zipcode,Newfoundland
ZCTA5 07436,34,13009,117996,1688,456200,10306,2925,8745,320,2050,1949,2824,1602,4554,4311,243,4311,3893,418,2018-01-01,zipcode,Oakland
ZCTA5 07438,34,11527,109539,1404,343600,9402,3078,7882,353,2204,1958,2248,1119,4655,4288,367,4288,3956,332,2018-01-01,zipcode,Oak ridge
ZCTA5 07439,34,2396,90402,1483,219500,1945,470,1699,91,689,491,269,159,945,835,110,835,703,132,2018-01-01,zipcode,Ogdensburg
ZCTA5 07440,34,4169,117159,1170,405000,3329,846,2851,107,805,645,952,342,1520,1442,78,1442,1241,201,2018-01-01,zipcode,Pequannock
ZCTA5 07442,34,11049,97782,1512,305000,9145,2315,7908,478,3041,1500,1985,904,4124,3952,172,3952,2864,1088,2018-01-01,zipcode,Pompton lakes
ZCTA5 07444,34,11117,94121,2111,420600,9410,3918,8304,482,1843,1969,2536,1474,5036,4747,289,4747,3752,995,2018-01-01,zipcode,Pompton plains
ZCTA5 07446,34,14920,144491,1570,586600,11880,3567,10285,211,1267,1649,4537,2621,5874,5512,362,5512,4788,724,2018-01-01,zipcode,Ramsey
ZCTA5 07450,34,25283,168807,1996,738300,18592,6599,16175,563,1642,1764,6352,5854,8596,8344,252,8344,6475,1869,2018-01-01,zipcode,Ridgewood
ZCTA5 07452,34,11826,166450,1705,631900,8668,2806,7497,150,632,1186,3090,2439,3927,3781,146,3781,3586,195,2018-01-01,zipcode,Glen rock
ZCTA5 07456,34,12147,128272,1970,346200,9602,2851,8269,566,2033,1880,2465,1325,4244,3914,330,3914,3770,144,2018-01-01,zipcode,Ringwood
ZCTA5 07457,34,4226,109851,2112,338500,3492,923,3155,202,763,677,869,644,1878,1829,49,1829,1263,566,2018-01-01,zipcode,Riverdale
ZCTA5 07458,34,11497,168125,2069,997700,8993,3447,7650,261,1142,1388,2604,2255,3961,3724,237,3724,3265,459,2018-01-01,zipcode,Saddle river
ZCTA5 07460,34,3407,109688,2015,263600,2913,725,2393,162,738,616,529,348,1445,1240,205,1240,1160,80,2018-01-01,zipcode,Stockholm
ZCTA5 07461,34,18522,86178,1154,278000,15324,4971,12977,835,4765,3800,2631,946,8247,6822,1425,6822,5723,1099,2018-01-01,zipcode,Sussex
ZCTA5 07462,34,6250,84574,1315,218500,5212,1240,4469,254,1611,1369,823,412,3460,2634,826,2634,1852,782,2018-01-01,zipcode,Vernon
ZCTA5 07463,34,9948,119434,2006,440800,7786,2134,6839,352,1254,1642,2501,1090,3632,3574,58,3574,3209,365,2018-01-01,zipcode,Waldwick
ZCTA5 07465,34,6824,95915,1533,344900,5710,2179,5034,173,1535,1263,1391,672,2784,2596,188,2596,2186,410,2018-01-01,zipcode,Wanaque
ZCTA5 07470,34,54190,118044,1643,461600,44468,16139,37766,2273,8937,7255,11859,7442,18738,18129,609,18129,14391,3738,2018-01-01,zipcode,Wayne
ZCTA5 07480,34,16400,99178,1480,293700,13336,4521,11750,544,3528,3183,2841,1654,6534,5951,583,5951,5271,680,2018-01-01,zipcode,West milford
ZCTA5 07481,34,17047,150329,1795,752900,13398,5277,11295,304,1852,1875,4232,3032,5897,5710,187,5710,5249,461,2018-01-01,zipcode,Wyckoff
ZCTA5 07495,34,0,-666666666,-666666666,-666666666,0,0,0,0,0,0,0,0,0,0,0,0,0,0,2018-01-01,zipcode,Mahwah
ZCTA5 07501,34,32028,28159,1091,241200,24421,11482,19963,6815,7887,3828,1070,363,12059,10559,1500,10559,1642,8917,2018-01-01,zipcode,Paterson
ZCTA5 07502,34,16791,55726,1327,229800,12675,4899,10727,2021,4204,3095,1043,364,4846,4458,388,4458,2142,2316,2018-01-01,zipcode,Paterson
ZCTA5 07503,34,18226,43921,1201,247300,14000,6061,11548,3098,4603,2592,924,331,5772,5322,450,5322,1599,3723,2018-01-01,zipcode,Paterson
ZCTA5 07504,34,11498,58818,1286,280400,9545,3492,8068,1454,3308,1801,1113,392,3919,3554,365,3554,1241,2313,2018-01-01,zipcode,Paterson
ZCTA5 07505,34,2423,19625,1006,110900,2066,860,1869,460,790,438,180,1,1156,1037,119,1037,37,1000,2018-01-01,zipcode,Paterson
ZCTA5 07506,34,18802,96250,1478,371700,15275,4187,13234,1230,3840,3299,3405,1460,7159,6963,196,6963,4204,2759,2018-01-01,zipcode,Hawthorne
ZCTA5 07508,34,22645,77468,1384,351400,18053,6091,15570,1609,5394,3810,3307,1450,7884,7562,322,7562,4918,2644,2018-01-01,zipcode,Haledon
ZCTA5 07512,34,10828,101321,1596,377200,9103,3105,7945,678,2705,1928,1932,702,3527,3460,67,3460,2877,583,2018-01-01,zipcode,Totowa
ZCTA5 07513,34,12447,43305,1311,248200,9466,3150,7871,2163,3559,1397,630,122,3622,3415,207,3415,1038,2377,2018-01-01,zipcode,Paterson
ZCTA5 07514,34,19044,42483,1184,219500,14345,5403,11950,2644,5004,2857,1176,269,7012,6279,733,6279,1671,4608,2018-01-01,zipcode,Paterson
ZCTA5 07522,34,20104,33543,1150,211800,14489,6574,11515,3252,5212,1924,902,225,6991,6074,917,6074,1324,4750,2018-01-01,zipcode,Paterson
ZCTA5 07524,34,13239,37333,1139,235400,9813,4076,7784,2339,3568,1131,655,91,4336,4050,286,4050,1069,2981,2018-01-01,zipcode,Paterson
ZCTA5 07601,34,44381,67188,1390,298500,37104,11523,32811,4141,9420,7346,8079,3825,20236,18732,1504,18732,6270,12462,2018-01-01,zipcode,Hackensack
ZCTA5 07603,34,8362,83517,1359,326900,6942,2257,5818,660,1778,1681,1109,590,2980,2866,114,2866,2009,857,2018-01-01,zipcode,Bogota
ZCTA5 07604,34,12091,91911,1396,416800,9992,3332,8412,586,2123,2150,2274,1279,4403,4239,164,4239,2742,1497,2018-01-01,zipcode,Hasbrouck heights
ZCTA5 07605,34,9111,96131,1403,495900,7465,2743,6304,485,1104,1199,2290,1226,3499,3338,161,3338,1989,1349,2018-01-01,zipcode,Leonia
ZCTA5 07606,34,2580,70735,1406,391600,2167,694,1800,289,878,286,216,131,849,808,41,808,411,397,2018-01-01,zipcode,South hackensack
ZCTA5 07607,34,9654,88143,1460,380500,8076,2695,6922,453,2111,1810,1577,971,3656,3499,157,3499,2201,1298,2018-01-01,zipcode,Maywood
ZCTA5 07608,34,107,28750,1396,-666666666,79,41,69,17,29,18,3,2,41,41,0,41,0,41,2018-01-01,zipcode,Teterboro
ZCTA5 07620,34,1521,124844,-666666666,2000001,1198,536,1099,83,132,86,495,303,607,533,74,533,430,103,2018-01-01,zipcode,Alpine
ZCTA5 07621,34,27372,96713,1355,348400,22022,6721,18644,1783,4533,4380,5652,2296,9011,8760,251,8760,5892,2868,2018-01-01,zipcode,Bergenfield
ZCTA5 07624,34,8577,132719,2081,658000,6847,2512,5882,260,1184,737,2231,1470,2870,2756,114,2756,2295,461,2018-01-01,zipcode,Closter
ZCTA5 07626,34,8730,138256,2500,656300,6667,2544,5892,306,850,1002,2261,1473,3053,2890,163,2890,2408,482,2018-01-01,zipcode,Cresskill
ZCTA5 07627,34,4959,158906,3029,685700,3849,1469,3267,89,360,477,1396,945,1785,1686,99,1686,1507,179,2018-01-01,zipcode,Demarest
ZCTA5 07628,34,17694,96017,1203,365900,14497,4526,12693,966,3572,2600,3485,2070,6662,6373,289,6373,4577,1796,2018-01-01,zipcode,Dumont
ZCTA5 07630,34,7611,123808,1896,486100,6145,2277,5279,446,1142,1536,1133,1022,2634,2509,125,2509,2087,422,2018-01-01,zipcode,Emerson
ZCTA5 07631,34,28238,84054,1423,392200,22743,7006,20186,1992,5384,3943,4900,3967,11717,10613,1104,10613,5591,5022,2018-01-01,zipcode,Englewood
ZCTA5 07632,34,5450,146944,3259,1029400,4306,1922,4031,206,620,595,1412,1198,2012,1814,198,1814,1573,241,2018-01-01,zipcode,Englewood cliffs
ZCTA5 07640,34,4761,128380,2036,597200,3587,1289,3194,75,359,635,1238,887,1625,1625,0,1625,1489,136,2018-01-01,zipcode,Harrington park
ZCTA5 07641,34,3418,173750,3501,661300,2701,938,2327,64,266,388,819,790,1140,1112,28,1112,1052,60,2018-01-01,zipcode,Haworth
ZCTA5 07642,34,10395,140694,1395,552100,8295,2654,7081,298,1337,1695,2235,1516,3665,3602,63,3602,3092,510,2018-01-01,zipcode,Hillsdale
ZCTA5 07643,34,10827,61144,1326,316600,9297,2907,8090,1063,2159,2316,1842,710,4702,4308,394,4308,1731,2577,2018-01-01,zipcode,Little ferry
ZCTA5 07644,34,24498,60651,1316,376200,20445,6614,17204,2625,5745,4604,3185,1045,9383,8927,456,8927,3629,5298,2018-01-01,zipcode,Lodi
ZCTA5 07645,34,8438,128641,1747,615800,6682,2320,5710,225,1061,1242,1721,1461,2879,2858,21,2858,2401,457,2018-01-01,zipcode,Montvale
ZCTA5 07646,34,16578,91900,1424,413400,13521,4160,11773,708,3249,2731,3496,1589,6013,5806,207,5806,3637,2169,2018-01-01,zipcode,New milford
ZCTA5 07647,34,5412,109567,1516,466600,4430,1650,3971,269,910,785,1534,473,1862,1795,67,1795,1549,246,2018-01-01,zipcode,Northvale
ZCTA5 07648,34,5819,127386,1732,631000,4805,1779,4253,239,892,815,1406,901,2193,2133,60,2133,1732,401,2018-01-01,zipcode,Norwood
ZCTA5 07649,34,8134,146103,1588,599700,6320,2152,5583,190,872,1127,2118,1276,2763,2719,44,2719,2393,326,2018-01-01,zipcode,Oradell
ZCTA5 07650,34,20536,64626,1476,526600,17626,6151,15520,1839,4098,2707,5553,1323,7840,7516,324,7516,2616,4900,2018-01-01,zipcode,Palisades park
ZCTA5 07652,34,26613,117087,1987,588800,22280,9209,19380,1700,4302,4019,6054,3305,8767,8310,457,8310,7189,1121,2018-01-01,zipcode,Paramus
ZCTA5 07656,34,8804,118560,1420,585600,7186,2670,6204,308,1062,1218,2357,1259,3462,3299,163,3299,2619,680,2018-01-01,zipcode,Park ridge
ZCTA5 07657,34,11248,67500,1555,436200,9344,3206,7939,695,2570,1658,2099,917,4074,3900,174,3900,1892,2008,2018-01-01,zipcode,Ridgefield
ZCTA5 07660,34,12934,80450,1325,340700,10583,2962,9113,675,2298,2249,2504,1387,5104,4761,343,4761,2588,2173,2018-01-01,zipcode,Ridgefield park
ZCTA5 07661,34,11530,123409,1588,492100,9152,2832,7783,494,1153,1476,2787,1873,4111,3942,169,3942,2945,997,2018-01-01,zipcode,River edge
ZCTA5 07662,34,5613,81394,1597,374000,4841,1720,4134,426,1424,928,1055,301,2069,1993,76,1993,1367,626,2018-01-01,zipcode,Rochelle park
ZCTA5 07663,34,13918,99094,1551,372000,11760,3911,10547,1215,2872,2812,2592,1056,5646,5371,275,5371,3643,1728,2018-01-01,zipcode,Saddle brook
ZCTA5 07666,34,40543,109677,1421,396500,32108,11271,26491,1581,4681,5150,8252,6827,14006,13330,676,13330,9840,3490,2018-01-01,zipcode,Teaneck
ZCTA5 07670,34,14687,159722,1807,807000,10666,3964,8885,267,648,729,3097,4144,4783,4600,183,4600,3573,1027,2018-01-01,zipcode,Tenafly
ZCTA5 07675,34,27044,124346,1749,575900,21422,6897,18969,980,3271,3826,6576,4316,10376,9958,418,9958,7561,2397,2018-01-01,zipcode,Westwood
ZCTA5 07676,34,9229,131875,2221,495900,7384,2465,6449,274,1214,1450,2275,1236,3377,3240,137,3240,3056,184,2018-01-01,zipcode,Township of washington
ZCTA5 07677,34,5816,167344,1772,790400,4728,1734,3942,29,514,558,1696,1145,2054,2009,45,2009,1790,219,2018-01-01,zipcode,Woodcliff lake
ZCTA5 07701,34,23861,82474,1517,401200,19458,6077,17276,1921,3590,4103,4691,2971,10457,9804,653,9804,6536,3268,2018-01-01,zipcode,Red bank
ZCTA5 07702,34,4088,124500,2365,575600,3246,1203,2814,59,454,507,1151,643,1488,1454,34,1454,1338,116,2018-01-01,zipcode,Shrewsbury
ZCTA5 07703,34,57,-666666666,-666666666,-666666666,57,0,57,0,24,0,16,17,199,17,182,17,0,17,2018-01-01,zipcode,Fort monmouth
ZCTA5 07704,34,5943,170625,2625,708100,4176,1331,3643,66,332,617,1559,1069,1928,1864,64,1864,1682,182,2018-01-01,zipcode,Fair haven
ZCTA5 07711,34,1570,126667,1163,708900,1320,493,1133,19,142,286,383,303,876,602,274,602,508,94,2018-01-01,zipcode,Allenhurst
ZCTA5 07712,34,38443,64852,1196,396900,31419,10174,27175,2476,7513,6494,6455,4237,18337,16236,2101,16236,7388,8848,2018-01-01,zipcode,Asbury park
ZCTA5 07716,34,8332,96693,1164,442400,7143,2249,6288,272,1051,1715,2056,1194,3874,3537,337,3537,2612,925,2018-01-01,zipcode,Atlantic highlands
ZCTA5 07717,34,1761,88594,1496,867400,1548,713,1409,29,195,343,473,369,1322,895,427,895,592,303,2018-01-01,zipcode,Avon by the sea
ZCTA5 07718,34,7139,112944,1660,342500,5634,1755,4759,316,1715,1065,1135,528,2406,2348,58,2348,1906,442,2018-01-01,zipcode,Belford
ZCTA5 07719,34,21331,95206,1437,453900,18058,5917,15523,904,3617,3642,4857,2503,10394,8463,1931,8463,6016,2447,2018-01-01,zipcode,Belmar
ZCTA5 07720,34,4223,60362,1361,507600,3712,1230,3320,371,507,771,980,691,3049,2120,929,2120,962,1158,2018-01-01,zipcode,Bradley beach
ZCTA5 07721,34,3003,73211,1277,270700,2408,612,1933,158,581,507,420,267,1263,1121,142,1121,774,347,2018-01-01,zipcode,Cliffwood
ZCTA5 07722,34,10094,160048,1750,763200,7823,2877,6387,169,867,1395,2037,1919,3507,3305,202,3305,2969,336,2018-01-01,zipcode,Colts neck
ZCTA5 07723,34,695,65982,1208,1108900,601,358,489,51,106,174,105,53,1172,279,893,279,177,102,2018-01-01,zipcode,Deal
ZCTA5 07724,34,21105,79060,1222,363600,17564,5819,15548,937,4314,4126,3661,2510,9603,8920,683,8920,5856,3064,2018-01-01,zipcode,Eatontown
ZCTA5 07726,34,43870,111484,1559,456000,34950,12491,30136,1591,6297,6949,8883,6416,16094,15303,791,15303,13093,2210,2018-01-01,zipcode,Englishtown
ZCTA5 07727,34,7479,80438,1044,428700,5861,2262,5033,219,1755,1071,1101,887,2970,2679,291,2679,1906,773,2018-01-01,zipcode,Farmingdale
ZCTA5 07728,34,55039,89484,1667,365400,44611,15842,38163,3846,10366,9280,8995,5676,21154,19946,1208,19946,14717,5229,2018-01-01,zipcode,Freehold
ZCTA5 07730,34,16991,101118,1059,331200,13876,4626,12052,734,4172,2894,2772,1480,6159,5895,264,5895,5143,752,2018-01-01,zipcode,Hazlet
ZCTA5 07731,34,38483,106371,1458,329400,30878,8128,25587,1254,6989,7254,7204,2886,13159,12621,538,12621,11269,1352,2018-01-01,zipcode,Howell
ZCTA5 07732,34,4834,59234,1205,273100,4438,1299,4140,411,1378,1094,710,547,3658,2787,871,2787,1715,1072,2018-01-01,zipcode,Highlands
ZCTA5 07733,34,16566,154187,2045,647100,13336,5571,11869,523,1672,1835,3906,3933,6056,5758,298,5758,4954,804,2018-01-01,zipcode,Holmdel
ZCTA5 07734,34,12879,56398,1201,217400,10401,3586,8909,1502,3287,2422,1320,378,6288,5183,1105,5183,3145,2038,2018-01-01,zipcode,Keansburg
ZCTA5 07735,34,18586,72015,1158,257700,15317,5120,13293,1300,5201,3823,2076,893,7736,6980,756,6980,5068,1912,2018-01-01,zipcode,Keyport
ZCTA5 07737,34,3939,97232,1184,323200,3247,1184,2656,183,854,770,543,306,1490,1438,52,1438,1272,166,2018-01-01,zipcode,Leonardo
ZCTA5 07738,34,6310,142896,538,530100,4940,1669,4324,98,822,973,1140,1291,2192,2077,115,2077,1849,228,2018-01-01,zipcode,Lincroft
ZCTA5 07739,34,5864,162232,2308,595100,4421,1704,4001,30,394,811,1533,1233,2200,2099,101,2099,1942,157,2018-01-01,zipcode,Little silver
ZCTA5 07740,34,30889,58652,1290,356000,24628,7966,21056,3538,6443,4897,3699,2479,14722,12019,2703,12019,5341,6678,2018-01-01,zipcode,Long branch
ZCTA5 07746,34,18532,149401,2534,559300,14535,5302,12218,418,1905,2262,4209,3424,6214,5975,239,5975,5726,249,2018-01-01,zipcode,Marlboro
ZCTA5 07747,34,31146,103580,1578,358200,25577,7675,22602,1209,4953,5672,6690,4078,12230,11771,459,11771,8966,2805,2018-01-01,zipcode,Matawan
ZCTA5 07748,34,27396,116076,1407,437500,22221,7332,19049,780,4529,4492,5815,3433,9986,9617,369,9617,7823,1794,2018-01-01,zipcode,Middletown
ZCTA5 07750,34,3211,133295,2393,739600,2679,1137,2408,10,265,436,974,723,1947,1409,538,1409,1202,207,2018-01-01,zipcode,Monmouth beach
ZCTA5 07751,34,19715,148265,2199,539600,15219,5062,12528,431,1919,2400,3898,3880,6335,6025,310,6025,5467,558,2018-01-01,zipcode,Morganville
ZCTA5 07753,34,37597,70994,1465,292000,31469,11676,27333,2531,7389,8679,5822,2912,16807,15583,1224,15583,9858,5725,2018-01-01,zipcode,Neptune
ZCTA5 07755,34,5851,94886,1375,387400,4698,1804,4050,258,957,1230,1011,594,2472,2196,276,2196,1970,226,2018-01-01,zipcode,Oakhurst
ZCTA5 07756,34,3133,61199,1216,471700,3067,1119,2902,75,424,671,797,935,3032,1967,1065,1967,780,1187,2018-01-01,zipcode,Ocean grove
ZCTA5 07757,34,5667,110329,1250,453200,4617,1793,4121,153,941,868,1440,719,2235,2101,134,2101,1804,297,2018-01-01,zipcode,Oceanport
ZCTA5 07758,34,4113,95186,1739,315800,3249,870,2773,204,814,936,630,189,1582,1423,159,1423,1261,162,2018-01-01,zipcode,Port monmouth
ZCTA5 07760,34,8867,153942,1836,940200,6603,2587,5654,57,624,1031,2255,1687,3810,3179,631,3179,2728,451,2018-01-01,zipcode,Rumson
ZCTA5 07762,34,8232,84368,1488,618700,7159,2994,6290,145,1129,1343,2276,1397,5105,3897,1208,3897,2465,1432,2018-01-01,zipcode,Spring lake
ZCTA5 07764,34,7917,104566,1586,419700,6494,2479,4542,359,1155,1105,1036,887,2689,2459,230,2459,1885,574,2018-01-01,zipcode,West long branch
ZCTA5 07801,34,25026,71485,1374,280700,19890,4880,17048,3148,5486,4705,2477,1232,8769,8061,708,8061,4019,4042,2018-01-01,zipcode,Dover
ZCTA5 07803,34,3560,95268,1179,294300,2835,976,2428,254,649,610,717,198,1331,1252,79,1252,1082,170,2018-01-01,zipcode,Mine hill
ZCTA5 07820,34,36,-666666666,-666666666,-666666666,36,28,36,6,1,0,29,0,28,28,0,28,28,0,2018-01-01,zipcode,Allamuchy
ZCTA5 07821,34,9156,107982,1381,309600,7513,2177,6512,178,1655,1970,1926,783,4025,3469,556,3469,3057,412,2018-01-01,zipcode,Andover
ZCTA5 07822,34,723,67813,-666666666,316000,492,208,475,55,106,75,158,81,268,268,0,268,250,18,2018-01-01,zipcode,Augusta
ZCTA5 07823,34,7834,57917,908,237700,6776,3045,5801,443,1930,1772,1180,476,3719,3356,363,3356,2299,1057,2018-01-01,zipcode,Belvidere
ZCTA5 07825,34,9489,99896,1421,339800,7913,3129,6963,573,2019,1848,1720,803,3819,3402,417,3402,3009,393,2018-01-01,zipcode,Blairstown
ZCTA5 07826,34,5771,82469,1451,294600,4837,1966,4330,269,1532,1195,959,375,2682,2215,467,2215,1770,445,2018-01-01,zipcode,Branchville
ZCTA5 07827,34,4078,69792,1040,207600,3396,1209,2879,174,1259,824,381,241,2011,1616,395,1616,1263,353,2018-01-01,zipcode,Montague
ZCTA5 07828,34,15369,74616,1164,328900,12084,3114,10527,617,3148,2735,2843,1184,6263,5949,314,5949,3020,2929,2018-01-01,zipcode,Budd lake
ZCTA5 07830,34,6888,128504,1104,478700,5379,1815,4752,43,844,962,1594,1309,2646,2413,233,2413,2262,151,2018-01-01,zipcode,Califon
ZCTA5 07832,34,3633,97872,1177,312200,3086,1099,2650,241,837,728,560,284,1572,1323,249,1323,1183,140,2018-01-01,zipcode,Columbia
ZCTA5 07833,34,149,48819,-666666666,172100,132,13,132,5,68,48,11,0,67,67,0,67,35,32,2018-01-01,zipcode,Delaware
ZCTA5 07834,34,17852,119829,1634,406600,14649,4291,12775,465,2276,2699,4004,3331,7229,6794,435,6794,5756,1038,2018-01-01,zipcode,Denville
ZCTA5 07836,34,11725,113198,1421,395300,9365,2583,7857,245,1570,2238,2267,1537,4582,4197,385,4197,2759,1438,2018-01-01,zipcode,Flanders
ZCTA5 07838,34,3161,107237,1433,318400,2657,763,2231,78,539,617,671,326,1283,1206,77,1206,1007,199,2018-01-01,zipcode,Great meadows
ZCTA5 07840,34,29825,80740,1194,292400,24435,7501,20563,1425,5771,5250,5347,2770,12395,11477,918,11477,7496,3981,2018-01-01,zipcode,Hackettstown
ZCTA5 07842,34,93,-666666666,-666666666,-666666666,85,0,77,0,16,7,45,9,44,44,0,44,44,0,2018-01-01,zipcode,Hibernia
ZCTA5 07843,34,11451,81317,1365,236400,9430,2432,8420,484,2957,2658,1649,672,5114,4468,646,4468,3661,807,2018-01-01,zipcode,Hopatcong
ZCTA5 07846,34,35,-666666666,-666666666,-666666666,19,3,19,0,0,3,3,13,20,10,10,10,10,0,2018-01-01,zipcode,Johnsonburg
ZCTA5 07847,34,1731,111994,1427,296400,1380,374,1321,71,489,398,274,89,667,667,0,667,626,41,2018-01-01,zipcode,Kenvil
ZCTA5 07848,34,5059,83063,1188,334000,4315,1919,3861,341,1122,1140,842,416,1928,1739,189,1739,1462,277,2018-01-01,zipcode,Lafayette
ZCTA5 07849,34,8915,93180,1453,301600,7432,2035,6344,387,1784,1670,1637,866,3906,3523,383,3523,2940,583,2018-01-01,zipcode,Lake hopatcong
ZCTA5 07850,34,5704,89397,1183,278900,4764,1689,3882,229,1418,1153,672,410,2359,2096,263,2096,1698,398,2018-01-01,zipcode,Landing
ZCTA5 07851,34,65,127000,-666666666,344100,61,12,61,0,6,13,33,9,61,30,31,30,27,3,2018-01-01,zipcode,Layton
ZCTA5 07852,34,4084,82000,984,350300,3297,1167,2872,32,672,878,947,343,1615,1556,59,1556,1339,217,2018-01-01,zipcode,Ledgewood
ZCTA5 07853,34,12926,162693,1930,491000,10078,3448,8286,179,1208,1731,3103,2065,4536,4225,311,4225,4009,216,2018-01-01,zipcode,Long valley
ZCTA5 07856,34,5028,91917,1948,332200,4201,1410,3755,105,983,1020,964,683,2543,2160,383,2160,1528,632,2018-01-01,zipcode,Mount arlington
ZCTA5 07857,34,3237,61761,1191,265800,2836,734,2313,273,860,614,395,171,1496,1407,89,1407,683,724,2018-01-01,zipcode,Netcong
ZCTA5 07860,34,25425,84000,1168,263100,21497,7519,18194,1186,5518,5318,3919,2253,11069,9624,1445,9624,7295,2329,2018-01-01,zipcode,Newton
ZCTA5 07863,34,3830,82768,770,256700,3269,1124,2842,306,1180,684,462,210,1677,1511,166,1511,1281,230,2018-01-01,zipcode,Oxford
ZCTA5 07865,34,2024,125186,-666666666,297800,1642,480,1493,48,279,430,409,327,772,699,73,699,663,36,2018-01-01,zipcode,Port murray
ZCTA5 07866,34,22831,105733,1433,347900,18833,6393,15985,611,3414,4014,5122,2824,8789,8439,350,8439,7058,1381,2018-01-01,zipcode,Rockaway
ZCTA5 07869,34,25820,128596,1435,522100,20405,6542,17422,723,2482,3677,5516,5024,9409,9076,333,9076,6763,2313,2018-01-01,zipcode,Randolph
ZCTA5 07870,34,28,-666666666,-666666666,-666666666,28,20,20,0,0,0,9,11,14,14,0,14,5,9,2018-01-01,zipcode,Schooleys mountain
ZCTA5 07871,34,20255,130273,1236,371700,16090,4989,13546,388,2649,3057,4909,2543,7854,7039,815,7039,6289,750,2018-01-01,zipcode,Sparta
ZCTA5 07874,34,8281,93058,1659,259800,6703,2111,5879,190,1937,1540,1527,685,3341,3078,263,3078,2769,309,2018-01-01,zipcode,Stanhope
ZCTA5 07876,34,10400,125634,1400,384600,8696,3026,7508,427,1587,2126,2214,1154,3745,3660,85,3660,3426,234,2018-01-01,zipcode,Succasunna
ZCTA5 07878,34,803,98938,-666666666,335700,663,211,508,0,67,172,176,93,361,271,90,271,219,52,2018-01-01,zipcode,Mount tabor
ZCTA5 07880,34,263,192682,-666666666,407300,263,30,203,32,72,83,16,0,89,89,0,89,89,0,2018-01-01,zipcode,Vienna
ZCTA5 07881,34,6,-666666666,-666666666,150000,6,4,6,1,1,4,0,0,12,4,8,4,4,0,2018-01-01,zipcode,
ZCTA5 07882,34,14468,92942,1137,250400,11962,3249,10297,792,3155,3312,1966,1072,5991,5545,446,5545,4118,1427,2018-01-01,zipcode,Washington
ZCTA5 07885,34,10052,73763,1441,292800,8049,2631,6979,806,2213,1882,1252,826,4304,3787,517,3787,2340,1447,2018-01-01,zipcode,Wharton
ZCTA5 07901,34,23335,139919,1779,859300,17649,5646,15652,727,2032,1710,5426,5757,8655,8274,381,8274,5726,2548,2018-01-01,zipcode,Summit
ZCTA5 07920,34,27017,145942,1991,667900,21307,7878,18160,432,1676,2490,6137,7425,10183,9752,431,9752,8060,1692,2018-01-01,zipcode,Basking ridge
ZCTA5 07921,34,7651,118042,2086,376300,6546,1657,6081,140,611,1180,2020,2130,4043,3781,262,3781,2892,889,2018-01-01,zipcode,Bedminster
ZCTA5 07922,34,12404,167639,2375,606700,9685,3217,8451,407,1155,1114,2841,2934,4285,4107,178,4107,3879,228,2018-01-01,zipcode,Berkeley heights
ZCTA5 07924,34,7591,159970,1848,743800,5899,1839,5154,113,450,789,2213,1589,2730,2633,97,2633,2254,379,2018-01-01,zipcode,Bernardsville
ZCTA5 07926,34,11,-666666666,-666666666,-666666666,11,0,11,0,0,0,11,0,11,11,0,11,0,11,2018-01-01,zipcode,Brookside
ZCTA5 07927,34,3879,119569,2328,475700,3091,960,2726,199,467,504,733,823,1797,1624,173,1624,1084,540,2018-01-01,zipcode,Cedar knolls
ZCTA5 07928,34,18956,177564,1865,809300,13831,4450,12306,262,1189,1383,4794,4678,6938,6466,472,6466,5536,930,2018-01-01,zipcode,Chatham
ZCTA5 07930,34,8359,144649,1234,635800,6711,2347,5680,119,773,847,2061,1880,3164,2957,207,2957,2779,178,2018-01-01,zipcode,Chester
ZCTA5 07931,34,3174,190577,2771,925900,2565,1019,2145,56,283,394,794,618,1131,1068,63,1068,894,174,2018-01-01,zipcode,Far hills
ZCTA5 07932,34,9899,126492,2347,630500,8228,2752,7196,284,1006,954,2688,2264,4261,3966,295,3966,2746,1220,2018-01-01,zipcode,Florham park
ZCTA5 07933,34,3231,145361,1706,504500,2819,813,2313,62,256,522,763,710,1201,1201,0,1201,1097,104,2018-01-01,zipcode,Gillette
ZCTA5 07934,34,1603,150833,1895,698000,1158,375,1070,0,192,254,339,285,598,558,40,558,490,68,2018-01-01,zipcode,Gladstone
ZCTA5 07935,34,420,138611,-666666666,538500,296,85,274,0,63,30,67,114,192,164,28,164,138,26,2018-01-01,zipcode,Green village
ZCTA5 07936,34,11116,129659,2281,584400,9275,3258,7838,614,2138,1536,2231,1319,3822,3697,125,3697,3494,203,2018-01-01,zipcode,East hanover
ZCTA5 07939,34,212,-666666666,-666666666,-666666666,212,198,202,56,59,39,48,0,0,0,0,0,0,0,2018-01-01,zipcode,Lyons
ZCTA5 07940,34,17156,133333,1674,711800,13771,4834,10273,394,1359,1487,3691,3342,5651,5464,187,5464,3730,1734,2018-01-01,zipcode,Madison
ZCTA5 07945,34,8999,178984,1230,738900,7066,2667,6146,98,612,1025,2305,2106,3235,3159,76,3159,2864,295,2018-01-01,zipcode,Mendham
ZCTA5 07946,34,3175,166063,3080,615000,2521,834,2128,23,323,344,873,565,1123,1123,0,1123,1031,92,2018-01-01,zipcode,Millington
ZCTA5 07950,34,19148,125000,2067,478500,15659,5292,13777,592,2318,2411,4504,3952,7433,7002,431,7002,5695,1307,2018-01-01,zipcode,Morris plains
ZCTA5 07960,34,44907,118578,1782,588500,38129,11777,33215,2188,5004,4531,11510,9982,19192,17839,1353,17839,11255,6584,2018-01-01,zipcode,Morristown
ZCTA5 07961,34,0,-666666666,-666666666,-666666666,0,0,0,0,0,0,0,0,0,0,0,0,0,0,2018-01-01,zipcode,Convent station
ZCTA5 07970,34,178,238108,-666666666,340400,178,0,145,0,0,31,77,37,56,56,0,56,56,0,2018-01-01,zipcode,Mount freedom
ZCTA5 07974,34,12407,146615,1680,596000,9262,3048,8090,179,1160,1208,2926,2617,4299,4124,175,4124,3445,679,2018-01-01,zipcode,New providence
ZCTA5 07976,34,653,93750,1419,-666666666,569,302,521,32,101,42,205,141,292,264,28,264,203,61,2018-01-01,zipcode,New vernon
ZCTA5 07977,34,634,85833,1385,484800,482,175,350,34,104,44,110,58,226,210,16,210,114,96,2018-01-01,zipcode,Peapack
ZCTA5 07979,34,440,133197,-666666666,652000,422,68,328,0,183,0,84,61,208,191,17,191,179,12,2018-01-01,zipcode,Pottersville
ZCTA5 07980,34,2253,127587,1381,542500,1748,631,1547,67,203,461,359,457,870,815,55,815,642,173,2018-01-01,zipcode,Stirling
ZCTA5 07981,34,8989,110025,1874,493700,7467,2475,6513,506,1463,1224,1877,1443,3616,3517,99,3517,3001,516,2018-01-01,zipcode,Whippany
ZCTA5 08001,34,977,70404,1183,166900,747,264,592,18,237,218,89,30,423,367,56,367,282,85,2018-01-01,zipcode,Alloway
ZCTA5 08002,34,22651,80153,1298,237400,18635,5955,15998,1476,3332,4665,3904,2621,9404,8517,887,8517,5645,2872,2018-01-01,zipcode,Cherry hill
ZCTA5 08003,34,29849,125958,1642,323300,24156,8065,21130,732,2992,3804,6895,6707,11348,10820,528,10820,9440,1380,2018-01-01,zipcode,Cherry hill
ZCTA5 08004,34,12248,91035,1354,191100,9959,3215,8944,915,3184,2744,1577,524,4389,3945,444,3945,3489,456,2018-01-01,zipcode,Atco
ZCTA5 08005,34,24013,73053,1551,249200,19673,8824,17313,1163,6476,5500,2877,1297,10456,9156,1300,9156,8007,1149,2018-01-01,zipcode,Barnegat
ZCTA5 08006,34,344,64306,1295,672300,342,208,329,4,76,90,100,59,1156,201,955,201,169,32,2018-01-01,zipcode,Barnegat light
ZCTA5 08007,34,5020,72000,892,190800,4101,1246,3740,351,1057,1060,827,445,2149,2034,115,2034,1311,723,2018-01-01,zipcode,Barrington
ZCTA5 08008,34,6921,85343,1273,805200,6571,3749,6259,96,1253,1369,2058,1483,17473,3563,13910,3563,3183,380,2018-01-01,zipcode,Beach haven
ZCTA5 08009,34,13097,83024,1314,221400,10754,3601,9262,742,2572,2815,2296,837,5151,5020,131,5020,4303,717,2018-01-01,zipcode,Berlin
ZCTA5 08010,34,11115,65172,1218,167600,9183,3239,8082,1067,3187,2150,1154,524,4779,4324,455,4324,2594,1730,2018-01-01,zipcode,Beverly
ZCTA5 08011,34,20,-666666666,-666666666,-666666666,20,0,20,11,9,0,0,0,9,9,0,9,9,0,2018-01-01,zipcode,Birmingham
ZCTA5 08012,34,38407,72597,1131,204300,31399,9890,27010,2270,8774,8526,5324,2116,15741,14448,1293,14448,9625,4823,2018-01-01,zipcode,Blackwood
ZCTA5 08014,34,548,103295,-666666666,181800,421,91,387,13,188,164,11,11,254,189,65,189,136,53,2018-01-01,zipcode,Bridgeport
ZCTA5 08015,34,19585,65349,1223,165100,15507,5108,12925,1230,5370,4632,1243,450,7951,6968,983,6968,5466,1502,2018-01-01,zipcode,Browns mills
ZCTA5 08016,34,33406,78898,1046,233300,26559,7625,22483,1886,7356,6652,4091,2498,13278,12197,1081,12197,9017,3180,2018-01-01,zipcode,Burlington
ZCTA5 08019,34,1115,99063,2563,272800,863,277,724,69,279,220,133,23,390,366,24,366,317,49,2018-01-01,zipcode,Chatsworth
ZCTA5 08020,34,2742,88110,1134,275600,2296,1092,2068,150,923,484,396,115,1011,934,77,934,868,66,2018-01-01,zipcode,Clarksboro
ZCTA5 08021,34,44245,51183,997,146400,35226,11701,30173,3517,10813,9050,4771,2022,20003,18072,1931,18072,9459,8613,2018-01-01,zipcode,Clementon
ZCTA5 08022,34,8905,94864,959,309500,7720,3289,6867,385,1838,1755,1825,1064,3697,3593,104,3593,3435,158,2018-01-01,zipcode,Columbus
ZCTA5 08023,34,312,28708,1293,103000,289,166,260,27,100,133,0,0,195,157,38,157,43,114,2018-01-01,zipcode,Deepwater
ZCTA5 08026,34,2217,82069,2068,205200,1814,608,1513,83,550,426,304,150,802,766,36,766,719,47,2018-01-01,zipcode,Gibbsboro
ZCTA5 08027,34,4839,72601,1136,178000,3928,1547,3527,307,1483,976,534,227,2095,1922,173,1922,1557,365,2018-01-01,zipcode,Gibbstown
ZCTA5 08028,34,20919,70460,1183,195300,17561,6926,11896,1172,3488,3168,2534,1534,7458,6489,969,6489,4449,2040,2018-01-01,zipcode,Glassboro
ZCTA5 08029,34,4435,53486,776,165100,3783,1351,3382,327,1693,1016,181,165,2039,1883,156,1883,1385,498,2018-01-01,zipcode,Glendora
ZCTA5 08030,34,13269,57093,1190,125400,10211,3497,8723,1046,3740,2326,1108,503,5146,4679,467,4679,3202,1477,2018-01-01,zipcode,Gloucester city
ZCTA5 08031,34,11415,54447,889,166800,9332,3282,8197,1250,3198,2272,1015,462,4729,4379,350,4379,2670,1709,2018-01-01,zipcode,Bellmawr
ZCTA5 08033,34,16010,120188,1105,450200,12424,3988,11157,153,1447,2029,3983,3545,6500,6193,307,6193,4746,1447,2018-01-01,zipcode,Haddonfield
ZCTA5 08034,34,18444,92841,1315,240800,14845,5003,13255,799,2621,2713,4181,2941,7269,6972,297,6972,5550,1422,2018-01-01,zipcode,Cherry hill
ZCTA5 08035,34,7680,94479,895,285900,6255,2018,5639,258,1090,1221,2005,1065,3192,3037,155,3037,2458,579,2018-01-01,zipcode,Haddon heights
ZCTA5 08036,34,5915,109133,1058,290400,4765,1219,4104,245,1157,1059,1189,454,2257,2194,63,2194,1981,213,2018-01-01,zipcode,Hainesport
ZCTA5 08037,34,23800,73388,1194,235000,19519,7119,16812,2016,5908,4678,3003,1207,9260,8477,783,8477,6514,1963,2018-01-01,zipcode,Hammonton
ZCTA5 08038,34,83,51607,-666666666,170000,69,23,56,3,24,25,4,0,43,35,8,35,28,7,2018-01-01,zipcode,Hancocks bridge
ZCTA5 08039,34,131,71136,-666666666,227300,72,10,72,0,29,9,28,6,61,32,29,32,32,0,2018-01-01,zipcode,Harrisonville
ZCTA5 08041,34,978,126023,-666666666,367900,749,222,672,50,159,273,137,53,343,319,24,319,285,34,2018-01-01,zipcode,Jobstown
ZCTA5 08042,34,213,155417,-666666666,-666666666,153,33,120,20,19,57,24,0,72,58,14,58,44,14,2018-01-01,zipcode,Juliustown
ZCTA5 08043,34,29223,92361,1310,323400,23980,9525,21122,1766,4213,4246,6073,4824,11928,10879,1049,10879,7310,3569,2018-01-01,zipcode,Voorhees
ZCTA5 08045,34,2806,64517,872,165700,2387,1005,2046,167,823,472,297,287,1186,1063,123,1063,713,350,2018-01-01,zipcode,Lawnside
ZCTA5 08046,34,31525,74083,1602,162900,26031,9148,21727,1775,7611,7207,3426,1708,11667,10367,1300,10367,8256,2111,2018-01-01,zipcode,Willingboro
ZCTA5 08048,34,12227,86800,1282,311100,9719,3018,8392,513,2045,2358,2192,1284,4994,4662,332,4662,3333,1329,2018-01-01,zipcode,Lumberton
ZCTA5 08049,34,5491,61250,988,163300,4501,1147,3758,240,1405,1272,543,298,2182,2075,107,2075,1444,631,2018-01-01,zipcode,Magnolia
ZCTA5 08050,34,24930,76512,1652,276600,20434,7595,17810,1175,5844,4935,4081,1775,13137,9510,3627,9510,8018,1492,2018-01-01,zipcode,Manahawkin
ZCTA5 08051,34,10409,80525,1302,181200,8515,2504,7577,420,2406,2144,1637,970,4469,4201,268,4201,3302,899,2018-01-01,zipcode,Mantua
ZCTA5 08052,34,18729,56944,1156,183000,15641,4857,13692,971,5012,3994,2635,1080,9107,8482,625,8482,3977,4505,2018-01-01,zipcode,Maple shade
ZCTA5 08053,34,45193,97036,1457,289200,36780,10943,32253,1375,6832,8331,10421,5294,18642,17456,1186,17456,13311,4145,2018-01-01,zipcode,Marlton
ZCTA5 08054,34,41518,94719,1565,265900,34157,11175,30186,1318,5951,6997,9461,6459,18282,17281,1001,17281,13476,3805,2018-01-01,zipcode,Mount laurel
ZCTA5 08055,34,27355,118365,1369,350600,21924,7043,19278,435,3307,4535,6760,4241,10421,9979,442,9979,8639,1340,2018-01-01,zipcode,Medford
ZCTA5 08056,34,4755,163125,1380,367900,3299,947,2963,52,751,533,751,876,1481,1469,12,1469,1410,59,2018-01-01,zipcode,Mickleton
ZCTA5 08057,34,20705,140802,1231,506400,16414,5748,14047,390,2261,2634,4787,3975,7690,7186,504,7186,5943,1243,2018-01-01,zipcode,Moorestown
ZCTA5 08059,34,5612,69040,978,166100,4659,1446,4016,258,1698,1238,587,235,2371,2131,240,2131,1611,520,2018-01-01,zipcode,Mount ephraim
ZCTA5 08060,34,24364,86706,1202,230400,19594,5950,16977,1113,4562,5191,4150,1961,9702,8857,845,8857,6591,2266,2018-01-01,zipcode,Mount holly
ZCTA5 08061,34,2943,141429,2153,293300,2055,388,1851,0,382,575,580,314,992,890,102,890,807,83,2018-01-01,zipcode,Mount royal
ZCTA5 08062,34,16312,130417,1098,343900,12269,3335,10532,392,2147,2646,2949,2398,5704,5447,257,5447,4953,494,2018-01-01,zipcode,Mullica hill
ZCTA5 08063,34,3072,64609,1071,149900,2470,870,2107,243,1017,600,184,63,1153,1069,84,1069,891,178,2018-01-01,zipcode,National park
ZCTA5 08064,34,192,-666666666,-666666666,-666666666,192,174,192,39,79,28,19,27,18,18,0,18,18,0,2018-01-01,zipcode,New lisbon
ZCTA5 08065,34,7223,70714,1351,170800,6018,1781,5282,315,1810,1679,1080,398,3364,2950,414,2950,2068,882,2018-01-01,zipcode,Palmyra
ZCTA5 08066,34,8563,49762,967,117000,7354,2877,6201,625,2453,1799,1019,305,4336,3692,644,3692,2172,1520,2018-01-01,zipcode,Paulsboro
ZCTA5 08067,34,1591,90417,1202,234200,1250,420,1106,158,332,318,240,58,675,586,89,586,519,67,2018-01-01,zipcode,Pedricktown
ZCTA5 08068,34,7181,60351,1000,188600,5974,2097,4945,484,1913,1464,767,317,2909,2745,164,2745,1677,1068,2018-01-01,zipcode,Pemberton
ZCTA5 08069,34,12558,49347,1046,149200,10273,3976,8625,1797,3133,2623,758,314,5497,4746,751,4746,2435,2311,2018-01-01,zipcode,Penns grove
ZCTA5 08070,34,12392,64508,976,156000,10089,3667,9046,902,3900,2796,932,516,5729,4934,795,4934,3629,1305,2018-01-01,zipcode,Pennsville
ZCTA5 08071,34,9433,78077,1120,184000,7739,2679,6519,288,1870,2248,1422,691,3815,3554,261,3554,2640,914,2018-01-01,zipcode,Pitman
ZCTA5 08072,34,333,71094,-666666666,202600,281,116,260,5,109,83,49,14,130,130,0,130,130,0,2018-01-01,zipcode,Quinton
ZCTA5 08073,34,203,242629,-666666666,305200,147,56,130,0,39,62,0,29,55,55,0,55,55,0,2018-01-01,zipcode,Rancocas
ZCTA5 08074,34,15,-666666666,-666666666,-666666666,15,0,15,7,0,0,0,8,0,0,0,0,0,0,2018-01-01,zipcode,Richwood
ZCTA5 08075,34,28731,76777,1207,221200,23370,7000,20177,1562,6851,5366,4626,1772,11863,10884,979,10884,7880,3004,2018-01-01,zipcode,Riverside
ZCTA5 08077,34,19197,101807,1539,271500,15914,5034,13758,514,3495,3862,3841,2046,7391,6880,511,6880,6004,876,2018-01-01,zipcode,Riverton
ZCTA5 08078,34,8317,61506,919,165300,6593,2213,5788,572,2144,1521,1082,469,3357,3179,178,3179,2166,1013,2018-01-01,zipcode,Runnemede
ZCTA5 08079,34,10103,42736,932,176200,7732,3503,6704,961,3051,1815,625,252,4960,3886,1074,3886,2265,1621,2018-01-01,zipcode,Salem
ZCTA5 08080,34,36988,99432,1438,258800,30128,9393,25688,1021,7256,7408,6906,3097,13512,13028,484,13028,11452,1576,2018-01-01,zipcode,Sewell
ZCTA5 08081,34,49836,86806,1312,205300,38837,10584,32788,1915,9949,10896,6756,3272,18442,16999,1443,16999,13863,3136,2018-01-01,zipcode,Sicklerville
ZCTA5 08083,34,9728,76504,981,187000,8257,2391,7218,503,2530,2046,1492,647,3985,3729,256,3729,2776,953,2018-01-01,zipcode,Somerdale
ZCTA5 08084,34,6950,79950,962,182800,5706,1685,4833,205,1736,1223,1108,561,2845,2599,246,2599,1978,621,2018-01-01,zipcode,Stratford
ZCTA5 08085,34,20731,121032,1663,288600,15564,4205,13396,705,3233,3162,4013,2283,7310,6813,497,6813,5722,1091,2018-01-01,zipcode,Swedesboro
ZCTA5 08086,34,8006,79885,1351,229300,6651,2200,5825,365,1845,1808,1306,501,3530,3219,311,3219,2358,861,2018-01-01,zipcode,Thorofare
ZCTA5 08087,34,24953,65620,1364,223900,20698,8642,18627,1415,6781,5622,3222,1587,13495,10595,2900,10595,8874,1721,2018-01-01,zipcode,Tuckerton
ZCTA5 08088,34,23864,78910,1389,258900,19581,7674,17340,1205,6198,4708,3323,1906,9715,9261,454,9261,8586,675,2018-01-01,zipcode,Vincentown
ZCTA5 08089,34,4195,63789,954,192500,3619,1562,3066,308,1253,1006,340,159,1697,1563,134,1563,1287,276,2018-01-01,zipcode,Waterford works
ZCTA5 08090,34,8020,89450,1275,188500,6478,1964,5675,335,2249,1493,1093,505,2938,2848,90,2848,2608,240,2018-01-01,zipcode,Wenonah
ZCTA5 08091,34,5487,65050,1066,177000,4624,1733,4113,581,1463,1169,686,214,2263,2107,156,2107,1428,679,2018-01-01,zipcode,West berlin
ZCTA5 08092,34,3476,74469,1615,302300,2935,1094,2533,220,897,687,510,219,1581,1359,222,1359,1131,228,2018-01-01,zipcode,West creek
ZCTA5 08093,34,9045,54747,979,154100,7444,2381,6331,726,2920,1654,720,311,3942,3557,385,3557,2239,1318,2018-01-01,zipcode,Westville
ZCTA5 08094,34,40337,80712,1018,199800,32087,10683,28013,2496,10512,8345,4270,2390,15912,14743,1169,14743,12561,2182,2018-01-01,zipcode,Williamstown
ZCTA5 08095,34,36,-666666666,-666666666,-666666666,36,15,15,0,0,15,0,0,51,15,36,15,15,0,2018-01-01,zipcode,Winslow
ZCTA5 08096,34,35686,70151,1179,191500,29009,10069,25501,2108,9109,7160,4964,2160,15021,13749,1272,13749,9680,4069,2018-01-01,zipcode,Woodbury
ZCTA5 08097,34,3213,81619,984,201400,2571,826,2335,162,762,849,404,158,1175,1145,30,1145,1022,123,2018-01-01,zipcode,Woodbury heights
ZCTA5 08098,34,9145,88390,1017,262400,7628,2833,6605,372,2116,1785,1508,824,3758,3362,396,3362,2476,886,2018-01-01,zipcode,Woodstown
ZCTA5 08102,34,7790,21016,754,83700,5890,3094,4445,1841,1388,809,361,46,2964,2439,525,2439,524,1915,2018-01-01,zipcode,Camden
ZCTA5 08103,34,14224,28065,957,85000,10771,5738,8829,2529,3287,1952,632,429,5897,4720,1177,4720,1890,2830,2018-01-01,zipcode,Camden
ZCTA5 08104,34,22441,23744,854,69200,15738,6855,13046,4130,4678,3334,485,419,10686,8573,2113,8573,3021,5552,2018-01-01,zipcode,Camden
ZCTA5 08105,34,28534,31918,954,89700,20227,7071,16412,5604,5732,3575,1182,319,9947,8597,1350,8597,3965,4632,2018-01-01,zipcode,Camden
ZCTA5 08106,34,9593,77238,939,204400,8215,2289,7070,265,2401,2040,1683,681,4159,3965,194,3965,2598,1367,2018-01-01,zipcode,Audubon
ZCTA5 08107,34,12935,54957,1013,184700,10402,3082,9035,868,2900,2629,1780,858,5958,5280,678,5280,2731,2549,2018-01-01,zipcode,Oaklyn
ZCTA5 08108,34,18252,91957,1290,265200,15036,4261,13494,562,2937,3208,4139,2648,8131,7385,746,7385,4887,2498,2018-01-01,zipcode,Collingswood
ZCTA5 08109,34,22385,67673,1052,171700,17985,5937,15874,2079,5147,4586,2775,1287,9233,8514,719,8514,6100,2414,2018-01-01,zipcode,Merchantville
ZCTA5 08110,34,18598,66875,1126,137300,14665,5288,11893,2293,4376,3265,1437,522,6418,5703,715,5703,4390,1313,2018-01-01,zipcode,Pennsauken
ZCTA5 08201,34,9908,68274,1372,197400,8223,2710,6837,775,2316,1869,1171,706,4350,3807,543,3807,2552,1255,2018-01-01,zipcode,Absecon
ZCTA5 08202,34,1495,85625,1313,1105600,1420,837,1354,18,279,292,424,341,5553,779,4774,779,722,57,2018-01-01,zipcode,Avalon
ZCTA5 08203,34,8966,71483,1263,351300,7994,3358,7429,540,2105,2208,1676,900,9575,4127,5448,4127,2997,1130,2018-01-01,zipcode,Brigantine
ZCTA5 08204,34,18608,67305,1057,293700,15929,6314,13606,978,4391,4007,2769,1461,13568,7747,5821,7747,6087,1660,2018-01-01,zipcode,Cape may
ZCTA5 08205,34,27630,64894,1221,202200,23149,7795,19678,1711,5405,6579,4079,1904,11950,10412,1538,10412,8114,2298,2018-01-01,zipcode,Absecon
ZCTA5 08210,34,16413,69371,1330,264700,13413,5357,11960,1252,3946,3485,2352,925,7930,6187,1743,6187,5087,1100,2018-01-01,zipcode,Cape may court house
ZCTA5 08212,34,188,47917,1667,729700,187,121,181,2,26,24,63,66,596,99,497,99,94,5,2018-01-01,zipcode,Cape may point
ZCTA5 08215,34,13528,67049,1114,198800,11003,3733,9595,1290,3524,2683,1371,727,5794,5071,723,5071,3561,1510,2018-01-01,zipcode,Egg harbor city
ZCTA5 08217,34,25,-666666666,-666666666,-666666666,25,20,25,15,10,0,0,0,0,0,0,0,0,0,2018-01-01,zipcode,Elwood
ZCTA5 08221,34,6826,95034,1566,284100,5518,1932,4858,198,1039,1201,1402,1018,2686,2491,195,2491,2145,346,2018-01-01,zipcode,Linwood
ZCTA5 08223,34,4185,80224,1446,280900,3524,1198,3089,81,828,878,860,442,2506,1725,781,1725,1537,188,2018-01-01,zipcode,Marmora
ZCTA5 08224,34,538,75795,-666666666,253300,438,138,384,65,146,87,72,14,221,187,34,187,166,21,2018-01-01,zipcode,New gretna
ZCTA5 08225,34,8344,78191,1703,223800,6686,2318,5770,449,1721,1473,1441,686,3104,2832,272,2832,2573,259,2018-01-01,zipcode,Northfield
ZCTA5 08226,34,11202,70871,1176,582100,9499,4428,8607,385,2070,1934,2681,1537,20082,5262,14820,5262,3609,1653,2018-01-01,zipcode,Ocean city
ZCTA5 08230,34,5342,91950,1161,307800,4344,1604,3705,105,1034,929,1143,494,2510,2012,498,2012,1787,225,2018-01-01,zipcode,Ocean view
ZCTA5 08232,34,19403,40387,1043,150500,15092,5310,12599,2847,4704,3411,1288,349,7171,6256,915,6256,3444,2812,2018-01-01,zipcode,Pleasantville
ZCTA5 08234,34,42081,78534,999,213700,32837,9915,28309,3146,8735,7427,6313,2688,15600,14011,1589,14011,12228,1783,2018-01-01,zipcode,Egg harbor township
ZCTA5 08240,34,2293,-666666666,-666666666,-666666666,2293,1171,53,0,17,10,26,0,0,0,0,0,0,0,2018-01-01,zipcode,Pomona
ZCTA5 08241,34,1153,111607,1550,273700,1011,331,904,80,157,265,226,176,427,393,34,393,368,25,2018-01-01,zipcode,Port republic
ZCTA5 08242,34,3241,52732,1039,257100,2405,929,2093,372,885,625,146,65,1777,1243,534,1243,851,392,2018-01-01,zipcode,Rio grande
ZCTA5 08243,34,1955,77500,1449,663000,1824,1002,1681,58,443,434,419,327,6886,1020,5866,1020,913,107,2018-01-01,zipcode,Sea isle city
ZCTA5 08244,34,10521,59863,1085,218500,8648,2870,7286,787,2477,1944,1485,593,5601,4504,1097,4504,2606,1898,2018-01-01,zipcode,Somers point
ZCTA5 08246,34,87,-666666666,-666666666,-666666666,87,87,87,0,87,0,0,0,188,52,136,52,52,0,2018-01-01,zipcode,South seaville
ZCTA5 08247,34,984,108281,1325,1146600,929,531,826,23,110,146,305,242,3273,469,2804,469,427,42,2018-01-01,zipcode,Stone harbor
ZCTA5 08248,34,242,226719,-666666666,-666666666,221,95,184,0,85,0,25,74,482,97,385,97,97,0,2018-01-01,zipcode,Strathmere
ZCTA5 08251,34,9378,53468,1267,176100,8004,2834,7177,936,3062,1918,881,380,6676,4260,2416,4260,3383,877,2018-01-01,zipcode,Villas
ZCTA5 08260,34,12737,47408,936,330500,11359,5704,10033,994,3632,2919,1617,871,23816,6154,17662,6154,4182,1972,2018-01-01,zipcode,Wildwood
ZCTA5 08270,34,8296,61513,1057,262600,6717,2436,5788,986,2085,1526,796,395,3568,3019,549,3019,2314,705,2018-01-01,zipcode,Woodbine
ZCTA5 08302,34,45352,46639,1059,163300,34391,15696,29215,7245,11478,6703,2568,1221,15298,13856,1442,13856,8134,5722,2018-01-01,zipcode,Bridgeton
ZCTA5 08310,34,1270,59000,1218,110900,1123,575,1021,170,593,155,93,10,633,548,85,548,433,115,2018-01-01,zipcode,Buena
ZCTA5 08311,34,2252,61845,1285,167200,1760,670,1446,396,564,367,92,27,793,649,144,649,481,168,2018-01-01,zipcode,Cedarville
ZCTA5 08312,34,8261,65163,1186,199600,6784,2131,5727,692,2131,1175,1180,549,3419,3076,343,3076,2416,660,2018-01-01,zipcode,Clayton
ZCTA5 08314,34,3020,74357,-666666666,146300,2917,2610,2799,820,1306,516,117,40,204,180,24,180,167,13,2018-01-01,zipcode,Delmont
ZCTA5 08316,34,384,66016,-666666666,140400,262,108,228,29,64,101,16,18,188,139,49,139,115,24,2018-01-01,zipcode,Dorchester
ZCTA5 08317,34,1579,81759,-666666666,251600,1193,454,996,110,294,423,128,41,471,460,11,460,402,58,2018-01-01,zipcode,Dorothy
ZCTA5 08318,34,12219,81797,1133,213600,10077,3576,8549,895,2978,2241,1685,750,4946,4495,451,4495,3988,507,2018-01-01,zipcode,Elmer
ZCTA5 08319,34,1159,99125,-666666666,240700,982,255,825,44,312,232,135,102,548,421,127,421,418,3,2018-01-01,zipcode,Estell manor
ZCTA5 08320,34,1091,-666666666,-666666666,-666666666,1091,1091,987,96,603,255,33,0,0,0,0,0,0,0,2018-01-01,zipcode,Fairton
ZCTA5 08321,34,147,23250,956,161500,143,98,139,38,64,32,0,5,290,96,194,96,57,39,2018-01-01,zipcode,Fortescue
ZCTA5 08322,34,10859,84298,1275,209600,8769,2801,7740,850,3156,2202,1114,418,3797,3703,94,3703,3391,312,2018-01-01,zipcode,Franklinville
ZCTA5 08323,34,613,73750,1422,204300,499,192,431,21,124,138,93,55,299,233,66,233,188,45,2018-01-01,zipcode,Greenwich
ZCTA5 08324,34,282,86250,-666666666,218200,267,113,226,36,124,37,29,0,163,112,51,112,104,8,2018-01-01,zipcode,Heislerville
ZCTA5 08326,34,1498,66513,1351,149500,1173,424,1080,51,467,276,226,60,568,526,42,526,406,120,2018-01-01,zipcode,Landisville
ZCTA5 08327,34,3087,66154,-666666666,149100,3087,2945,2974,773,1383,663,120,35,209,160,49,160,139,21,2018-01-01,zipcode,Leesburg
ZCTA5 08328,34,1239,67250,-666666666,164000,1068,394,921,166,399,212,114,30,468,468,0,468,459,9,2018-01-01,zipcode,Malaga
ZCTA5 08329,34,248,66058,-666666666,283600,233,133,233,0,77,69,75,12,198,124,74,124,99,25,2018-01-01,zipcode,Mauricetown
ZCTA5 08330,34,27809,66397,1450,204500,22412,6920,19393,1632,6094,6025,3831,1811,11681,10714,967,10714,7965,2749,2018-01-01,zipcode,Mays landing
ZCTA5 08332,34,36119,53110,993,152400,28186,10671,24310,4058,9815,6787,2408,1242,15662,13876,1786,13876,8978,4898,2018-01-01,zipcode,Millville
ZCTA5 08340,34,1251,89196,1415,270900,949,209,738,51,367,173,117,30,349,349,0,349,281,68,2018-01-01,zipcode,Milmay
ZCTA5 08341,34,2305,35802,846,182000,1836,713,1590,392,484,446,181,87,1056,999,57,999,388,611,2018-01-01,zipcode,Minotola
ZCTA5 08343,34,5288,105345,1452,269300,4288,1326,3602,244,1191,1171,617,379,1760,1662,98,1662,1529,133,2018-01-01,zipcode,Monroeville
ZCTA5 08344,34,4818,69069,1309,175700,3949,1415,3549,428,1246,1002,556,317,2111,1833,278,1833,1515,318,2018-01-01,zipcode,Newfield
ZCTA5 08345,34,566,59125,956,144900,460,191,422,62,172,114,51,23,341,229,112,229,188,41,2018-01-01,zipcode,Newport
ZCTA5 08346,34,695,37038,-666666666,120400,534,108,404,52,139,182,31,0,304,222,82,222,191,31,2018-01-01,zipcode,Newtonville
ZCTA5 08348,34,188,80450,-666666666,138000,161,39,155,25,70,45,0,15,95,83,12,83,68,15,2018-01-01,zipcode,Port elizabeth
ZCTA5 08349,34,1658,36361,1317,157300,1439,714,1256,199,663,277,104,13,839,727,112,727,648,79,2018-01-01,zipcode,Port norris
ZCTA5 08350,34,629,92614,-666666666,289300,492,62,356,110,76,49,25,96,302,221,81,221,209,12,2018-01-01,zipcode,Richland
ZCTA5 08352,34,615,68594,-666666666,150400,491,190,383,73,147,100,38,25,203,190,13,190,171,19,2018-01-01,zipcode,Rosenhayn
ZCTA5 08353,34,374,56429,877,160500,306,107,276,41,122,79,19,15,163,148,15,148,95,53,2018-01-01,zipcode,Shiloh
ZCTA5 08360,34,42197,49697,1021,158200,32922,12299,27752,7419,9957,6770,2457,1149,15691,14453,1238,14453,8492,5961,2018-01-01,zipcode,Vineland
ZCTA5 08361,34,18730,78330,1009,203300,15426,6377,13116,1844,4177,3379,2622,1094,6942,6425,517,6425,5388,1037,2018-01-01,zipcode,Vineland
ZCTA5 08401,34,38372,27786,872,165200,29879,11994,25507,6759,8528,6039,2923,1258,20094,15272,4822,15272,4070,11202,2018-01-01,zipcode,Atlantic city
ZCTA5 08402,34,6076,79375,1279,485700,5553,2499,5176,245,1061,1314,1435,1121,7178,3053,4125,3053,2506,547,2018-01-01,zipcode,Margate city
ZCTA5 08403,34,967,121208,1729,830400,893,443,859,27,170,222,267,173,1685,477,1208,477,399,78,2018-01-01,zipcode,Longport
ZCTA5 08406,34,10232,55484,1166,268600,8716,3297,7432,842,2697,1653,1296,944,7586,4196,3390,4196,2611,1585,2018-01-01,zipcode,Ventnor city
ZCTA5 08501,34,6220,119427,1214,407700,5194,1675,4244,113,806,1046,1261,1018,2417,2310,107,2310,2120,190,2018-01-01,zipcode,Allentown
ZCTA5 08502,34,11203,199750,2133,653700,8644,2281,7236,89,690,949,2177,3331,3709,3561,148,3561,2814,747,2018-01-01,zipcode,Belle mead
ZCTA5 08505,34,18078,88604,1207,276200,14868,4784,12777,574,3123,3613,3556,1911,7673,6930,743,6930,5156,1774,2018-01-01,zipcode,Bordentown
ZCTA5 08510,34,5753,148045,2048,590300,4812,1656,3614,252,1061,767,1062,472,1913,1727,186,1727,1621,106,2018-01-01,zipcode,Millstone township
ZCTA5 08511,34,867,75962,874,226100,738,150,632,76,238,159,100,59,352,332,20,332,260,72,2018-01-01,zipcode,Cookstown
ZCTA5 08512,34,11080,89885,1294,496100,8862,3164,7786,822,1362,1238,2190,2174,4303,4116,187,4116,2407,1709,2018-01-01,zipcode,Cranbury
ZCTA5 08514,34,5046,102143,1140,377800,4098,1318,3628,225,1140,1050,750,463,2006,1880,126,1880,1631,249,2018-01-01,zipcode,Cream ridge
ZCTA5 08515,34,6396,151406,1582,440600,4926,1823,4056,240,1079,1013,1049,675,1812,1723,89,1723,1596,127,2018-01-01,zipcode,Chesterfield
ZCTA5 08518,34,5414,56223,1019,209500,4434,1548,3889,400,1218,1230,575,466,2568,2314,254,2314,1632,682,2018-01-01,zipcode,Florence
ZCTA5 08520,34,27093,88092,1378,289800,21321,6718,18360,2002,3689,3614,5334,3721,10156,9276,880,9276,6475,2801,2018-01-01,zipcode,Hightstown
ZCTA5 08525,34,4788,129688,1571,432300,3946,1001,3457,102,435,742,1102,1076,2004,1885,119,1885,1596,289,2018-01-01,zipcode,Hopewell
ZCTA5 08527,34,56261,90582,1402,350300,44813,15418,38743,2097,11706,12819,8731,3390,21401,20183,1218,20183,17209,2974,2018-01-01,zipcode,Jackson
ZCTA5 08528,34,86,25750,-666666666,-666666666,86,48,71,0,0,15,11,45,43,43,0,43,32,11,2018-01-01,zipcode,Kingston
ZCTA5 08530,34,7458,95888,1330,402200,6672,2527,5886,473,1337,1338,1628,1110,3408,3183,225,3183,2218,965,2018-01-01,zipcode,Lambertville
ZCTA5 08533,34,6604,105648,1239,332500,5301,1296,4501,297,1775,1111,940,378,2394,2394,0,2394,2031,363,2018-01-01,zipcode,New egypt
ZCTA5 08534,34,13167,129700,1427,466800,10529,3670,9053,294,1103,1070,3068,3518,5256,4946,310,4946,4365,581,2018-01-01,zipcode,Pennington
ZCTA5 08535,34,4711,181065,1261,616100,3840,1206,3296,85,456,861,1193,701,1626,1545,81,1545,1489,56,2018-01-01,zipcode,Millstone township
ZCTA5 08536,34,19793,105238,1515,469200,15236,4342,13915,343,1488,1564,4794,5726,8847,7801,1046,7801,3356,4445,2018-01-01,zipcode,Plainsboro
ZCTA5 08540,34,48968,142339,1740,640200,39491,14260,31994,881,1989,3218,9107,16799,19077,17700,1377,17700,11819,5881,2018-01-01,zipcode,Princeton
ZCTA5 08542,34,5927,84958,1662,494700,5295,2016,3282,220,662,367,737,1296,1948,1769,179,1769,530,1239,2018-01-01,zipcode,Princeton
ZCTA5 08550,34,19246,195146,2094,629800,15322,5107,13403,263,907,1138,4660,6435,6936,6507,429,6507,5553,954,2018-01-01,zipcode,Princeton junction
ZCTA5 08551,34,5157,138173,1453,463600,4318,1458,3583,174,820,706,1248,635,1875,1789,86,1789,1661,128,2018-01-01,zipcode,Ringoes
ZCTA5 08553,34,598,115156,1792,508300,481,187,432,22,34,58,157,161,281,229,52,229,184,45,2018-01-01,zipcode,Rocky hill
ZCTA5 08554,34,3947,84515,1327,168000,3145,829,2688,116,949,931,550,142,1514,1446,68,1446,1186,260,2018-01-01,zipcode,Roebling
ZCTA5 08555,34,802,100833,-666666666,288600,618,188,559,19,133,113,177,117,285,270,15,270,241,29,2018-01-01,zipcode,Roosevelt
ZCTA5 08558,34,7598,208148,1556,674400,5857,2515,5001,53,634,514,1666,2134,2661,2518,143,2518,2194,324,2018-01-01,zipcode,Skillman
ZCTA5 08559,34,5110,111080,1402,450200,4431,1533,3713,221,907,734,1053,798,2203,2036,167,2036,1716,320,2018-01-01,zipcode,Stockton
ZCTA5 08560,34,3623,111182,1841,389000,3097,1110,2645,125,424,463,822,811,1439,1342,97,1342,1191,151,2018-01-01,zipcode,Titusville
ZCTA5 08561,34,320,-666666666,-666666666,326300,211,41,211,35,9,23,62,82,115,115,0,115,98,17,2018-01-01,zipcode,Windsor
ZCTA5 08562,34,4460,66267,1035,241100,3439,1132,2952,305,902,833,610,302,1928,1739,189,1739,1061,678,2018-01-01,zipcode,Wrightstown
ZCTA5 08608,34,893,16442,728,-666666666,797,381,742,99,264,327,25,27,698,556,142,556,12,544,2018-01-01,zipcode,Trenton
ZCTA5 08609,34,12759,34857,1084,83600,10505,3975,8302,2749,3248,1796,402,107,5479,4170,1309,4170,1029,3141,2018-01-01,zipcode,Trenton
ZCTA5 08610,34,30493,62268,1138,193000,24821,8057,21058,3127,7786,6006,2828,1311,12226,11194,1032,11194,7328,3866,2018-01-01,zipcode,Trenton
ZCTA5 08611,34,26608,35720,1090,89500,19729,7312,16447,6215,4746,3709,1201,576,9862,8109,1753,8109,2559,5550,2018-01-01,zipcode,Trenton
ZCTA5 08618,34,39731,44181,968,171900,31735,13834,23335,4084,8158,6399,2977,1717,16198,13004,3194,13004,5790,7214,2018-01-01,zipcode,Trenton
ZCTA5 08619,34,21013,77413,1274,249600,17943,5882,15556,1765,4114,4512,3479,1686,9320,8597,723,8597,6053,2544,2018-01-01,zipcode,Trenton
ZCTA5 08620,34,12052,92225,1088,260900,10195,4137,8602,707,2834,2579,1646,836,4509,4138,371,4138,3346,792,2018-01-01,zipcode,Trenton
ZCTA5 08628,34,9315,89007,1309,266700,7933,2913,7008,390,1651,1561,2277,1129,4224,3918,306,3918,2597,1321,2018-01-01,zipcode,Trenton
ZCTA5 08629,34,14108,63171,1206,115400,11027,3355,9225,1541,3972,2621,851,240,4360,3957,403,3957,2678,1279,2018-01-01,zipcode,Trenton
ZCTA5 08638,34,22294,55510,1144,176700,18137,7032,15351,2405,5366,3859,2337,1384,9376,8021,1355,8021,4859,3162,2018-01-01,zipcode,Trenton
ZCTA5 08640,34,7753,59327,2082,-666666666,6710,4960,5694,898,2004,1865,671,256,988,878,110,878,5,873,2018-01-01,zipcode,Joint base mdl
ZCTA5 08641,34,4478,65737,1955,-666666666,2927,553,1993,50,238,1071,454,180,1281,1179,102,1179,0,1179,2018-01-01,zipcode,Joint base mdl
ZCTA5 08648,34,31725,102633,1581,302700,26668,8431,22140,1256,4245,4520,5468,6651,12609,11846,763,11846,7867,3979,2018-01-01,zipcode,Lawrence township
ZCTA5 08690,34,18676,99809,1388,282800,15738,5096,13616,714,3601,3579,3725,1997,7103,6994,109,6994,6220,774,2018-01-01,zipcode,Trenton
ZCTA5 08691,34,16033,127813,1668,383300,13163,4284,11481,375,2268,2350,3653,2835,6212,6000,212,6000,5220,780,2018-01-01,zipcode,Trenton
ZCTA5 08701,34,100763,48341,1463,322000,55758,24490,43905,6194,13045,11494,7842,5330,26251,23877,2374,23877,11624,12253,2018-01-01,zipcode,Lakewood
ZCTA5 08720,34,770,111000,-666666666,562500,599,281,528,46,124,91,177,90,226,226,0,226,208,18,2018-01-01,zipcode,Allenwood
ZCTA5 08721,34,20873,81599,1498,278200,16445,5674,14362,1241,5701,4105,2274,1041,8373,7453,920,7453,6113,1340,2018-01-01,zipcode,Bayville
ZCTA5 08722,34,11210,74967,1667,230600,8822,2646,7231,535,2681,2522,1133,360,3971,3766,205,3766,3162,604,2018-01-01,zipcode,Beachwood
ZCTA5 08723,34,32944,74269,1362,281600,27199,9330,23302,2080,8060,7439,4058,1665,14604,13062,1542,13062,10223,2839,2018-01-01,zipcode,Brick
ZCTA5 08724,34,40924,78019,1460,283900,34299,12063,30070,1949,9334,9028,6882,2877,17956,16462,1494,16462,14201,2261,2018-01-01,zipcode,Brick
ZCTA5 08730,34,4709,138750,2138,630100,3789,1270,3173,46,458,626,1311,732,2142,1780,362,1780,1617,163,2018-01-01,zipcode,Brielle
ZCTA5 08731,34,19956,80979,1538,262900,16026,5737,13778,1006,4536,4316,2370,1550,9114,7725,1389,7725,6872,853,2018-01-01,zipcode,Forked river
ZCTA5 08732,34,1357,98333,1615,412400,1153,466,1052,19,237,269,284,243,720,582,138,582,473,109,2018-01-01,zipcode,Island heights
ZCTA5 08733,34,2713,61182,1702,186200,2124,692,1803,237,708,532,224,102,1008,937,71,937,615,322,2018-01-01,zipcode,Lakehurst
ZCTA5 08734,34,8624,84580,809,333200,7401,2856,6398,259,2085,2175,1121,758,3524,3262,262,3262,2889,373,2018-01-01,zipcode,Lanoka harbor
ZCTA5 08735,34,3874,74135,1145,637000,3651,2114,3442,110,865,826,959,682,6880,2015,4865,2015,1800,215,2018-01-01,zipcode,Lavallette
ZCTA5 08736,34,12991,119176,1333,618300,10752,3740,9400,199,1617,1973,3153,2458,6261,4857,1404,4857,4247,610,2018-01-01,zipcode,Manasquan
ZCTA5 08738,34,1164,84659,1441,1126100,1097,651,1073,37,171,189,421,255,1732,600,1132,600,562,38,2018-01-01,zipcode,Mantoloking
ZCTA5 08740,34,1733,60345,1634,253300,1428,530,1226,80,544,318,199,85,1204,748,456,748,507,241,2018-01-01,zipcode,Ocean gate
ZCTA5 08741,34,2640,96250,1276,316700,2147,877,1885,58,540,511,444,332,1109,960,149,960,876,84,2018-01-01,zipcode,Pine beach
ZCTA5 08742,34,24292,91869,1463,410200,20155,6339,17849,604,4468,4791,4924,3062,12707,9980,2727,9980,7835,2145,2018-01-01,zipcode,Point pleasant beach
ZCTA5 08750,34,3117,123464,1113,933700,2734,1367,2452,24,308,503,948,669,1892,1369,523,1369,1264,105,2018-01-01,zipcode,Sea girt
ZCTA5 08751,34,4379,56985,1273,447100,3768,1460,3142,340,968,826,680,328,5372,1883,3489,1883,975,908,2018-01-01,zipcode,Seaside heights
ZCTA5 08752,34,2204,68750,1291,634000,1996,923,1853,15,457,455,522,404,4126,1220,2906,1220,929,291,2018-01-01,zipcode,Seaside park
ZCTA5 08753,34,63026,79997,1443,288800,50822,16904,44030,2864,14314,12619,9740,4493,26243,23403,2840,23403,18320,5083,2018-01-01,zipcode,Toms river
ZCTA5 08755,34,25835,69331,1318,272200,21392,9247,19044,1717,6316,5318,3317,2376,10837,10312,525,10312,8827,1485,2018-01-01,zipcode,Toms river
ZCTA5 08757,34,33999,43932,1439,162600,30549,17970,28427,3726,13448,6870,3265,1118,18919,16713,2206,16713,14663,2050,2018-01-01,zipcode,Toms river
ZCTA5 08758,34,7674,66543,1629,312700,6764,3637,6299,374,2195,1920,1247,563,3905,3443,462,3443,2932,511,2018-01-01,zipcode,Waretown
ZCTA5 08759,34,32803,37286,1151,122600,31120,21219,29819,3419,12123,8025,4394,1858,21786,19295,2491,19295,16681,2614,2018-01-01,zipcode,Manchester township
ZCTA5 08801,34,8990,123608,1771,409800,7724,3816,5269,250,954,1158,1660,1247,2764,2593,171,2593,2181,412,2018-01-01,zipcode,Annandale
ZCTA5 08802,34,4035,128914,1333,389500,3142,847,2756,90,620,697,792,557,1473,1443,30,1443,1321,122,2018-01-01,zipcode,Asbury
ZCTA5 08804,34,2540,83750,1083,293300,2051,546,1833,89,347,651,467,279,1123,1047,76,1047,940,107,2018-01-01,zipcode,Bloomsbury
ZCTA5 08805,34,11974,72884,1387,289300,9599,2661,8074,1236,2895,2119,1099,725,4909,4119,790,4119,2318,1801,2018-01-01,zipcode,Bound brook
ZCTA5 08807,34,38748,125700,1657,472900,30845,9760,26707,1196,4898,5302,8024,7287,13656,13254,402,13254,10927,2327,2018-01-01,zipcode,Bridgewater
ZCTA5 08808,34,142,73648,-666666666,-666666666,142,4,142,102,4,36,0,0,89,89,0,89,67,22,2018-01-01,zipcode,Broadway
ZCTA5 08809,34,6013,98281,1454,357600,4835,1655,3916,254,667,755,1342,898,2121,2097,24,2097,1516,581,2018-01-01,zipcode,Clinton
ZCTA5 08810,34,9049,138203,1821,410800,7076,2268,6065,259,860,889,2514,1543,3033,2888,145,2888,2370,518,2018-01-01,zipcode,Dayton
ZCTA5 08812,34,14422,96585,1368,345000,11394,3205,9730,672,2583,2346,2696,1433,4910,4684,226,4684,3770,914,2018-01-01,zipcode,Dunellen
ZCTA5 08816,34,46660,109041,1435,389300,38050,12195,33701,1957,6871,6576,10817,7480,17265,16487,778,16487,13344,3143,2018-01-01,zipcode,East brunswick
ZCTA5 08817,34,44823,89538,1563,316200,35513,10983,32000,2392,7493,6816,8922,6377,16317,15657,660,15657,8595,7062,2018-01-01,zipcode,Edison
ZCTA5 08820,34,38796,126650,1576,488200,30832,11801,27998,2289,4222,2976,8857,9654,13397,12902,495,12902,9280,3622,2018-01-01,zipcode,Edison
ZCTA5 08821,34,377,55573,-666666666,365000,332,129,241,0,125,63,41,12,160,131,29,131,119,12,2018-01-01,zipcode,Flagtown
ZCTA5 08822,34,31119,110671,1446,415500,25272,8027,21934,1222,4569,4790,6373,4980,12316,11727,589,11727,9164,2563,2018-01-01,zipcode,Flemington
ZCTA5 08823,34,9301,112045,1940,286800,7451,1836,7005,221,892,1180,2431,2281,4000,3594,406,3594,2545,1049,2018-01-01,zipcode,Franklin park
ZCTA5 08824,34,12301,134507,1317,429500,9534,2848,8348,256,1487,1576,3110,1919,4176,4080,96,4080,3629,451,2018-01-01,zipcode,Kendall park
ZCTA5 08825,34,4327,105368,1244,385000,3629,1017,3219,311,749,797,873,489,1714,1625,89,1625,1255,370,2018-01-01,zipcode,Frenchtown
ZCTA5 08826,34,5361,103987,1289,342600,4457,1224,3851,161,887,823,1246,734,2458,2162,296,2162,1757,405,2018-01-01,zipcode,Glen gardner
ZCTA5 08827,34,4085,108380,676,373900,3392,1057,3037,91,625,845,1022,454,1772,1611,161,1611,1425,186,2018-01-01,zipcode,Hampton
ZCTA5 08828,34,2283,83068,1741,250700,1904,516,1714,123,595,500,310,186,986,887,99,887,710,177,2018-01-01,zipcode,Helmetta
ZCTA5 08829,34,3558,97016,1212,259400,2883,969,2502,141,549,564,749,499,1571,1468,103,1468,1131,337,2018-01-01,zipcode,High bridge
ZCTA5 08830,34,17940,95595,1727,297600,14793,5074,13693,1157,3587,2851,3866,2232,6471,6240,231,6240,4445,1795,2018-01-01,zipcode,Iselin
ZCTA5 08831,34,50174,82451,1294,338600,41713,19722,38805,2541,10372,8646,9864,7382,21868,20977,891,20977,18379,2598,2018-01-01,zipcode,Monroe township
ZCTA5 08832,34,2706,63000,1383,261000,2295,755,1907,331,659,435,282,200,1038,1014,24,1014,215,799,2018-01-01,zipcode,Keasbey
ZCTA5 08833,34,8412,140027,1929,491200,7114,2411,6172,244,1059,1224,2237,1408,3316,3242,74,3242,2868,374,2018-01-01,zipcode,Lebanon
ZCTA5 08835,34,10283,69654,1351,253800,8192,2477,7032,625,3418,1893,808,288,4305,3785,520,3785,2505,1280,2018-01-01,zipcode,Manville
ZCTA5 08836,34,3766,155754,1414,612500,2952,855,2578,64,385,409,899,821,1311,1303,8,1303,1222,81,2018-01-01,zipcode,Martinsville
ZCTA5 08837,34,17208,83870,1344,326400,14075,4356,12608,1069,3106,2609,3532,2292,6705,6329,376,6329,3274,3055,2018-01-01,zipcode,Edison
ZCTA5 08840,34,16392,122161,1659,390500,12897,3709,11712,553,1897,2384,3627,3251,6238,5997,241,5997,4804,1193,2018-01-01,zipcode,Metuchen
ZCTA5 08844,34,39520,125774,1704,423400,31278,8137,27220,732,5056,5330,9982,6120,14604,13613,991,13613,11496,2117,2018-01-01,zipcode,Hillsborough
ZCTA5 08846,34,13659,71061,1364,300400,10836,3369,9642,856,3038,3160,1682,906,5156,4943,213,4943,3527,1416,2018-01-01,zipcode,Middlesex
ZCTA5 08848,34,8355,102821,1141,329400,6919,2178,6079,255,1903,1484,1502,935,3428,3087,341,3087,2804,283,2018-01-01,zipcode,Milford
ZCTA5 08850,34,8488,107837,1556,349000,6861,2051,5927,278,1710,1639,1549,751,3159,2913,246,2913,2514,399,2018-01-01,zipcode,Milltown
ZCTA5 08852,34,18052,105649,1610,388500,13913,4161,12230,288,1490,1871,5237,3344,6927,6612,315,6612,4444,2168,2018-01-01,zipcode,Monmouth junction
ZCTA5 08853,34,5243,140263,1183,568700,4148,1227,3468,65,634,681,1051,1037,1916,1858,58,1858,1483,375,2018-01-01,zipcode,Neshanic station
ZCTA5 08854,34,56931,93534,1562,321300,48773,21964,33860,2505,6606,7385,10330,7034,17035,16043,992,16043,10625,5418,2018-01-01,zipcode,Piscataway
ZCTA5 08857,34,40335,93730,1220,353200,32982,9279,29698,1969,7553,8107,8568,3501,15730,14986,744,14986,10016,4970,2018-01-01,zipcode,Old bridge
ZCTA5 08858,34,147,-666666666,-666666666,-666666666,147,0,95,0,0,0,0,95,48,48,0,48,48,0,2018-01-01,zipcode,Oldwick
ZCTA5 08859,34,22312,80693,1256,305300,18167,5847,15876,1672,4792,4046,3849,1517,8714,8299,415,8299,5266,3033,2018-01-01,zipcode,Parlin
ZCTA5 08861,34,53879,54072,1306,255500,41197,15449,33647,9643,12178,6761,3691,1374,17734,16665,1069,16665,5310,11355,2018-01-01,zipcode,Perth amboy
ZCTA5 08863,34,12570,90336,1369,299600,10043,3295,9003,850,2880,2287,1959,1027,4680,4388,292,4388,3205,1183,2018-01-01,zipcode,Fords
ZCTA5 08865,34,28846,63975,1026,194500,23596,8137,20268,2625,7428,5305,3199,1711,13134,11605,1529,11605,7404,4201,2018-01-01,zipcode,Phillipsburg
ZCTA5 08867,34,5097,138300,1436,487800,4113,1191,3446,97,620,768,1162,799,1886,1772,114,1772,1577,195,2018-01-01,zipcode,Pittstown
ZCTA5 08869,34,7797,78404,1667,335200,6444,1923,5399,453,1778,1210,1236,722,3314,2938,376,2938,1676,1262,2018-01-01,zipcode,Raritan
ZCTA5 08872,34,20324,75395,1216,292300,16245,5126,14634,1286,4684,3906,3397,1361,7674,7430,244,7430,4349,3081,2018-01-01,zipcode,Sayreville
ZCTA5 08873,34,53686,92357,1579,333700,44234,15772,38442,2430,8424,8727,11014,7847,21845,19854,1991,19854,13885,5969,2018-01-01,zipcode,Somerset
ZCTA5 08876,34,22059,95438,1404,371700,17830,5391,15312,1010,3107,3387,4989,2819,9167,8047,1120,8047,5543,2504,2018-01-01,zipcode,Somerville
ZCTA5 08879,34,22733,68512,1280,274500,18776,5815,16674,1571,5988,4707,2920,1488,9662,8913,749,8913,5018,3895,2018-01-01,zipcode,South amboy
ZCTA5 08880,34,4550,83155,1366,247900,3601,993,3179,268,1172,959,491,289,1877,1578,299,1578,908,670,2018-01-01,zipcode,South bound brook
ZCTA5 08882,34,16024,68729,1245,294000,12676,3692,10933,1903,3700,2652,1831,847,6012,5574,438,5574,3505,2069,2018-01-01,zipcode,South river
ZCTA5 08884,34,8293,76055,927,292400,6768,2522,6155,443,2161,1991,1083,477,3459,3339,120,3339,2611,728,2018-01-01,zipcode,Spotswood
ZCTA5 08886,34,7285,106837,1211,310000,5671,1771,4817,215,937,1449,1383,833,2600,2487,113,2487,2018,469,2018-01-01,zipcode,Stewartsville
ZCTA5 08887,34,1004,89674,1621,187100,902,294,836,35,149,206,291,155,510,510,0,510,409,101,2018-01-01,zipcode,Three bridges
ZCTA5 08889,34,9562,135601,1425,458300,7957,2972,6943,419,1397,1322,2242,1563,3847,3764,83,3764,3460,304,2018-01-01,zipcode,Whitehouse station
ZCTA5 08890,34,15,-666666666,-666666666,-666666666,15,0,15,0,7,0,8,0,7,7,0,7,0,7,2018-01-01,zipcode,
ZCTA5 08901,34,57659,42185,1445,257400,45849,22885,25920,9571,6321,4393,3174,2461,16354,14893,1461,14893,2557,12336,2018-01-01,zipcode,New brunswick
ZCTA5 08902,34,41135,94490,1561,336100,32681,9679,28623,2839,6400,5373,8077,5934,14958,14249,709,14249,8032,6217,2018-01-01,zipcode,North brunswick
ZCTA5 08904,34,13992,80846,1427,362600,11312,3161,9691,346,1174,1465,2931,3775,6066,5608,458,5608,2377,3231,2018-01-01,zipcode,Highland park
ZCTA5 32003,12,28531,91287,1500,255800,23012,8128,19401,564,4001,6239,5733,2864,10840,10292,548,10292,8116,2176,2018-01-01,zipcode,Fleming island
ZCTA5 32008,12,4538,40573,691,83100,3850,1558,3493,581,1512,1092,261,47,2782,1853,929,1853,1485,368,2018-01-01,zipcode,Branford
ZCTA5 32009,12,3821,69821,1194,158400,3101,926,2512,257,1077,890,258,30,1370,1217,153,1217,1068,149,2018-01-01,zipcode,Bryceville
ZCTA5 32011,12,13805,61038,775,170800,11169,4265,9640,1162,4171,2938,983,386,5644,4999,645,4999,4115,884,2018-01-01,zipcode,Callahan
ZCTA5 32024,12,19378,51607,907,118500,15462,6724,13464,1680,4946,4506,1674,658,8007,7045,962,7045,5930,1115,2018-01-01,zipcode,Lake city
ZCTA5 32025,12,22374,44904,836,115900,18416,10064,14998,2245,5306,5188,1400,859,8935,7533,1402,7533,4569,2964,2018-01-01,zipcode,Lake city
ZCTA5 32026,12,1907,-666666666,-666666666,-666666666,1907,1907,1784,883,618,213,57,13,0,0,0,0,0,0,2018-01-01,zipcode,Raiford
ZCTA5 32033,12,4660,52419,1306,179800,4130,1937,3499,422,1028,1359,398,292,2030,1792,238,1792,1428,364,2018-01-01,zipcode,Elkton
ZCTA5 32034,12,34928,71476,1141,310700,29919,13649,27453,1503,6510,7877,6647,4916,20037,15074,4963,15074,11444,3630,2018-01-01,zipcode,Fernandina beach
ZCTA5 32038,12,10103,40534,873,101400,8269,4133,7473,912,2754,2755,600,452,4623,3887,736,3887,3339,548,2018-01-01,zipcode,Fort white
ZCTA5 32040,12,7570,59604,829,117300,5833,2337,4915,571,2375,1217,631,121,2921,2465,456,2465,2104,361,2018-01-01,zipcode,Glen saint mary
ZCTA5 32043,12,24952,62317,984,180700,19994,8483,17462,1985,5837,6138,2346,1156,9917,9032,885,9032,6723,2309,2018-01-01,zipcode,Green cove springs
ZCTA5 32044,12,1824,46250,-666666666,71500,1505,732,1313,251,487,371,177,27,1115,764,351,764,615,149,2018-01-01,zipcode,Hampton
ZCTA5 32046,12,9426,57445,885,135500,7642,3525,6606,897,3004,2189,346,170,3779,3341,438,3341,2576,765,2018-01-01,zipcode,Hilliard
ZCTA5 32052,12,9704,36486,575,72500,8365,5565,7059,1755,3211,1641,322,130,3451,2720,731,2720,1824,896,2018-01-01,zipcode,Jasper
ZCTA5 32053,12,3139,36034,874,67600,2327,1372,1992,461,821,423,241,46,1514,1088,426,1088,835,253,2018-01-01,zipcode,Jennings
ZCTA5 32054,12,11724,41566,604,108100,9655,6029,8472,1836,3286,2577,562,211,3987,3476,511,3476,2471,1005,2018-01-01,zipcode,Lake butler
ZCTA5 32055,12,17114,40173,803,117700,13461,6190,11836,1741,4320,4035,1159,581,6943,6165,778,6165,4215,1950,2018-01-01,zipcode,Lake city
ZCTA5 32058,12,4585,38500,785,102100,3866,2526,3225,867,1465,730,106,57,1488,1210,278,1210,935,275,2018-01-01,zipcode,Lawtey
ZCTA5 32059,12,2465,44792,778,83700,1918,931,1760,299,674,691,81,15,1241,974,267,974,849,125,2018-01-01,zipcode,Lee
ZCTA5 32060,12,23768,40619,779,105300,18642,9414,16329,3068,6348,4530,1693,690,9898,8093,1805,8093,5884,2209,2018-01-01,zipcode,Live oak
ZCTA5 32061,12,457,83125,-666666666,188000,377,161,248,91,98,32,27,0,122,104,18,104,84,20,2018-01-01,zipcode,Lulu
ZCTA5 32062,12,2085,50990,434,87500,1893,1000,1583,189,691,344,213,146,1100,757,343,757,684,73,2018-01-01,zipcode,Mc alpin
ZCTA5 32063,12,13840,64643,734,152100,10855,5082,9548,1351,3600,3238,784,575,5145,4512,633,4512,3115,1397,2018-01-01,zipcode,Macclenny
ZCTA5 32064,12,6888,39827,645,88700,5859,2290,4940,1010,1541,1327,697,365,3019,2354,665,2354,1196,1158,2018-01-01,zipcode,Live oak
ZCTA5 32065,12,37160,69791,1208,185100,28162,9080,24168,1812,7132,8579,4248,2397,13170,12373,797,12373,9135,3238,2018-01-01,zipcode,Orange park
ZCTA5 32066,12,7664,39726,534,110500,6182,3906,5294,1418,2140,899,392,445,2415,1753,662,1753,1383,370,2018-01-01,zipcode,Mayo
ZCTA5 32068,12,57226,59722,1170,153600,44405,16264,37988,3791,14417,13371,4707,1702,21170,19383,1787,19383,14768,4615,2018-01-01,zipcode,Middleburg
ZCTA5 32071,12,3856,40852,709,114800,2942,1399,2409,378,1003,761,221,46,1599,1263,336,1263,949,314,2018-01-01,zipcode,O brien
ZCTA5 32072,12,299,-666666666,-666666666,61400,299,58,202,0,76,56,70,0,158,120,38,120,120,0,2018-01-01,zipcode,
ZCTA5 32073,12,41863,57201,1046,166800,33899,12380,29066,2428,8497,11379,4855,1907,16568,15574,994,15574,10058,5516,2018-01-01,zipcode,Orange park
ZCTA5 32079,12,461,39097,1336,92500,461,439,461,43,87,60,155,116,298,239,59,239,20,219,2018-01-01,zipcode,Penney farms
ZCTA5 32080,12,21943,73350,1172,352300,19578,9438,17272,603,3306,4564,4912,3887,15670,9535,6135,9535,7128,2407,2018-01-01,zipcode,Saint augustine
ZCTA5 32081,12,13266,115250,1689,371300,9710,3844,8616,43,1078,2385,2989,2121,4941,4374,567,4374,3574,800,2018-01-01,zipcode,Ponte vedra
ZCTA5 32082,12,30898,107717,1400,489400,26037,11197,23186,426,2950,5781,8493,5536,15558,12745,2813,12745,10339,2406,2018-01-01,zipcode,Ponte vedra beach
ZCTA5 32083,12,3563,37647,738,100500,3181,2716,2906,769,1122,864,114,37,597,492,105,492,310,182,2018-01-01,zipcode,Raiford
ZCTA5 32084,12,34892,48691,971,187800,29535,11716,24521,2617,7992,7148,4766,1998,15723,12861,2862,12861,8226,4635,2018-01-01,zipcode,Saint augustine
ZCTA5 32086,12,29568,56647,1132,214000,25466,11170,22370,1451,5667,8525,4539,2188,13196,11586,1610,11586,8626,2960,2018-01-01,zipcode,Saint augustine
ZCTA5 32087,12,5979,46825,805,75500,4739,2940,3897,948,1854,784,220,91,1619,1468,151,1468,1125,343,2018-01-01,zipcode,Sanderson
ZCTA5 32091,12,15311,44211,817,86300,12042,5699,10684,1881,4214,3486,829,274,6721,5619,1102,5619,3497,2122,2018-01-01,zipcode,Starke
ZCTA5 32092,12,34642,89018,1708,270200,26400,9322,24337,1648,5059,7379,6577,3674,13572,11984,1588,11984,10424,1560,2018-01-01,zipcode,Saint augustine
ZCTA5 32094,12,2254,43750,-666666666,70700,2015,1338,1924,267,1019,454,125,59,1233,910,323,910,786,124,2018-01-01,zipcode,Wellborn
ZCTA5 32095,12,10006,66731,1180,257900,7669,3146,6924,437,1875,1936,1690,986,3931,3784,147,3784,2905,879,2018-01-01,zipcode,Saint augustine
ZCTA5 32096,12,2179,38033,508,93000,1852,997,1666,282,623,448,182,131,1348,1015,333,1015,762,253,2018-01-01,zipcode,White springs
ZCTA5 32097,12,18518,67279,1206,185100,14616,5427,12629,1244,4479,4009,2076,821,7129,6578,551,6578,5282,1296,2018-01-01,zipcode,Yulee
ZCTA5 32102,12,2195,35051,1133,130100,2017,1184,1762,274,630,504,253,101,1819,1109,710,1109,893,216,2018-01-01,zipcode,Astor
ZCTA5 32110,12,8009,34188,758,116900,6771,3508,5792,966,2576,1618,466,166,3577,2916,661,2916,1980,936,2018-01-01,zipcode,Bunnell
ZCTA5 32112,12,8054,36940,583,86200,6029,3277,5112,1642,1945,1058,328,139,3945,2849,1096,2849,2091,758,2018-01-01,zipcode,Crescent city
ZCTA5 32113,12,5366,35000,963,84500,4433,2265,3783,706,1797,1015,188,77,2697,1942,755,1942,1536,406,2018-01-01,zipcode,Citra
ZCTA5 32114,12,32923,25894,852,97300,27633,13895,21279,3402,6633,7173,2751,1320,16303,13528,2775,13528,4192,9336,2018-01-01,zipcode,Daytona beach
ZCTA5 32117,12,24602,35690,935,89300,19946,8994,17518,2242,6890,5866,1777,743,12436,9823,2613,9823,5214,4609,2018-01-01,zipcode,Daytona beach
ZCTA5 32118,12,17349,41278,911,219500,15775,8390,14615,1113,3869,4589,3225,1819,15818,9024,6794,9024,5737,3287,2018-01-01,zipcode,Daytona beach
ZCTA5 32119,12,22398,38951,992,131900,19560,9302,16631,1794,5767,5666,2327,1077,11838,10021,1817,10021,6140,3881,2018-01-01,zipcode,Daytona beach
ZCTA5 32124,12,5823,58125,1679,215600,5044,3063,4408,868,1458,958,622,502,1792,1598,194,1598,1318,280,2018-01-01,zipcode,Daytona beach
ZCTA5 32127,12,30415,49903,1119,172900,26421,12675,23487,2227,7585,7717,3518,2440,16285,12777,3508,12777,9611,3166,2018-01-01,zipcode,Port orange
ZCTA5 32128,12,19806,75787,1522,252300,16468,7603,14692,893,3140,4569,3839,2251,8993,7854,1139,7854,6692,1162,2018-01-01,zipcode,Port orange
ZCTA5 32129,12,22149,44331,1102,130900,19230,8375,16608,1583,5595,6146,2426,858,10743,9722,1021,9722,6458,3264,2018-01-01,zipcode,Port orange
ZCTA5 32130,12,5581,50341,1004,167700,4681,2188,4019,726,1439,1127,463,264,2344,1945,399,1945,1532,413,2018-01-01,zipcode,De leon springs
ZCTA5 32131,12,4560,41553,792,127700,3855,2181,3590,556,1495,935,344,260,2064,1736,328,1736,1270,466,2018-01-01,zipcode,East palatka
ZCTA5 32132,12,7514,41224,875,132600,6504,3057,5933,537,2240,2363,431,362,3720,3302,418,3302,2570,732,2018-01-01,zipcode,Edgewater
ZCTA5 32133,12,34,-666666666,-666666666,-666666666,34,9,34,0,16,18,0,0,73,25,48,25,25,0,2018-01-01,zipcode,Eastlake weir
ZCTA5 32134,12,7376,34288,791,68600,6247,3840,5560,1024,2489,1540,269,238,5908,3050,2858,3050,2530,520,2018-01-01,zipcode,Fort mc coy
ZCTA5 32136,12,7933,52419,1070,234000,7137,4067,6808,418,1719,2295,1418,958,5426,3721,1705,3721,3036,685,2018-01-01,zipcode,Flagler beach
ZCTA5 32137,12,43813,58155,1225,226800,37418,20992,33616,2363,10880,10865,5910,3598,22051,16689,5362,16689,13339,3350,2018-01-01,zipcode,Palm coast
ZCTA5 32139,12,854,29688,-666666666,70000,777,619,768,231,289,200,41,7,780,452,328,452,432,20,2018-01-01,zipcode,Georgetown
ZCTA5 32140,12,1393,51591,-666666666,60800,1277,562,1175,256,421,440,24,34,745,548,197,548,490,58,2018-01-01,zipcode,Florahome
ZCTA5 32141,12,18828,50266,1039,148700,16060,8227,14486,1659,5811,4918,1213,885,8505,7379,1126,7379,5955,1424,2018-01-01,zipcode,Edgewater
ZCTA5 32145,12,5659,39295,849,83200,4415,1880,3812,706,1334,1339,245,188,2237,1875,362,1875,1510,365,2018-01-01,zipcode,Hastings
ZCTA5 32147,12,556,-666666666,-666666666,22400,427,190,341,53,172,74,42,0,258,174,84,174,130,44,2018-01-01,zipcode,Hollister
ZCTA5 32148,12,10450,31014,706,62100,7957,4676,6986,1375,3194,1826,376,215,5494,4043,1451,4043,2802,1241,2018-01-01,zipcode,Interlachen
ZCTA5 32157,12,202,51250,825,169300,188,122,158,0,77,45,21,15,256,106,150,106,64,42,2018-01-01,zipcode,
ZCTA5 32159,12,30135,45198,1007,174900,27702,19149,26550,2165,9257,8496,3839,2793,18984,15267,3717,15267,12509,2758,2018-01-01,zipcode,Lady lake
ZCTA5 32162,12,54530,61654,1586,261400,53812,46326,53662,1739,13940,15984,12923,9076,36672,30152,6520,30152,28919,1233,2018-01-01,zipcode,The villages
ZCTA5 32164,12,45207,52466,1175,186000,37381,17690,33325,2697,11857,12028,4142,2601,18784,16303,2481,16303,11512,4791,2018-01-01,zipcode,Palm coast
ZCTA5 32168,12,27186,50557,1012,208500,23377,11835,21278,2158,6467,7286,3544,1823,13796,11549,2247,11549,8978,2571,2018-01-01,zipcode,New smyrna beach
ZCTA5 32169,12,10502,67245,1321,348000,9736,5594,9348,333,1900,3174,2295,1646,11742,5448,6294,5448,4207,1241,2018-01-01,zipcode,New smyrna beach
ZCTA5 32174,12,50869,52527,1032,203300,43898,21844,39793,2497,11321,14276,7405,4294,25016,22123,2893,22123,17208,4915,2018-01-01,zipcode,Ormond beach
ZCTA5 32176,12,14629,46875,1143,214800,13216,7237,12168,784,3245,4158,2305,1676,10644,7090,3554,7090,5281,1809,2018-01-01,zipcode,Ormond beach
ZCTA5 32177,12,26377,34645,711,87800,20815,9779,18366,3280,7901,4899,1507,779,11740,10138,1602,10138,6595,3543,2018-01-01,zipcode,Palatka
ZCTA5 32179,12,8075,31626,725,66700,6736,3624,6112,981,2891,1528,406,306,4699,3333,1366,3333,2606,727,2018-01-01,zipcode,Ocklawaha
ZCTA5 32180,12,3934,46757,706,118300,2952,1372,2503,536,765,888,240,74,1499,1240,259,1240,976,264,2018-01-01,zipcode,Pierson
ZCTA5 32181,12,2268,39018,913,92500,1813,1024,1525,246,531,452,197,99,1363,857,506,857,734,123,2018-01-01,zipcode,Pomona park
ZCTA5 32187,12,2186,37591,539,141500,1785,904,1545,221,594,581,124,25,778,733,45,733,568,165,2018-01-01,zipcode,San mateo
ZCTA5 32189,12,5611,31712,860,68900,4882,2884,4374,796,1692,1370,454,62,4023,2557,1466,2557,2207,350,2018-01-01,zipcode,Satsuma
ZCTA5 32190,12,1089,32930,621,115100,929,396,780,246,355,109,53,17,482,371,111,371,269,102,2018-01-01,zipcode,Seville
ZCTA5 32193,12,718,35433,629,110500,597,395,526,79,266,120,34,27,638,329,309,329,239,90,2018-01-01,zipcode,Welaka
ZCTA5 32195,12,2986,44375,1306,121300,2585,1153,2256,271,887,800,225,73,1438,1229,209,1229,1069,160,2018-01-01,zipcode,Weirsdale
ZCTA5 32202,12,6165,26250,600,117000,5920,4432,4937,1326,1468,1147,624,372,2280,1793,487,1793,187,1606,2018-01-01,zipcode,Jacksonville
ZCTA5 32204,12,7507,40483,944,152600,6622,2299,5542,592,1223,1347,1463,917,4499,3825,674,3825,1070,2755,2018-01-01,zipcode,Jacksonville
ZCTA5 32205,12,29499,44546,897,146700,23730,7711,21259,2608,5660,6769,4020,2202,14754,13074,1680,13074,6145,6929,2018-01-01,zipcode,Jacksonville
ZCTA5 32206,12,16500,26565,788,78700,13451,5963,11629,2536,4084,3382,1055,572,8911,6767,2144,6767,2801,3966,2018-01-01,zipcode,Jacksonville
ZCTA5 32207,12,35917,47115,897,157200,28121,8987,24776,3866,6292,7063,4807,2748,16727,14740,1987,14740,7081,7659,2018-01-01,zipcode,Jacksonville
ZCTA5 32208,12,32194,35898,922,76100,25484,11128,22032,3784,8385,7235,1919,709,14649,12336,2313,12336,7022,5314,2018-01-01,zipcode,Jacksonville
ZCTA5 32209,12,35436,24664,768,56300,26442,12768,22575,4841,10104,5632,1371,627,17101,13207,3894,13207,6182,7025,2018-01-01,zipcode,Jacksonville
ZCTA5 32210,12,61496,45006,943,118000,47378,15982,40660,5176,13048,14434,5487,2515,27063,23548,3515,23548,12417,11131,2018-01-01,zipcode,Jacksonville
ZCTA5 32211,12,34607,39375,854,118100,26541,8674,22020,3008,7439,7607,2778,1188,14824,13258,1566,13258,5842,7416,2018-01-01,zipcode,Jacksonville
ZCTA5 32212,12,2499,45119,1605,-666666666,2027,70,548,12,115,337,45,39,256,248,8,248,0,248,2018-01-01,zipcode,Jacksonville
ZCTA5 32216,12,38073,52100,1039,152200,31046,11160,26781,3120,7048,7978,5991,2644,17780,15592,2188,15592,7469,8123,2018-01-01,zipcode,Jacksonville
ZCTA5 32217,12,19411,44389,886,181400,16034,5633,14014,1375,3480,4176,3278,1705,9391,8377,1014,8377,4358,4019,2018-01-01,zipcode,Jacksonville
ZCTA5 32218,12,61846,53969,1036,157600,48284,18340,40140,4096,12871,14722,6285,2166,23613,21429,2184,21429,13228,8201,2018-01-01,zipcode,Jacksonville
ZCTA5 32219,12,11931,50865,916,131600,10156,3999,8504,1156,3304,3084,691,269,4760,4115,645,4115,3354,761,2018-01-01,zipcode,Jacksonville
ZCTA5 32220,12,13179,54253,958,133700,10206,3810,8861,1226,3738,2445,967,485,5268,4627,641,4627,3696,931,2018-01-01,zipcode,Jacksonville
ZCTA5 32221,12,30227,61924,1260,155200,23078,8274,19513,2560,6897,6363,2736,957,10850,10050,800,10050,7487,2563,2018-01-01,zipcode,Jacksonville
ZCTA5 32222,12,9772,60861,1214,174800,7350,2511,6214,561,1451,2833,968,401,4133,3304,829,3304,2322,982,2018-01-01,zipcode,Jacksonville
ZCTA5 32223,12,24039,79878,1156,257900,20047,7111,17824,735,3442,6113,4692,2842,10146,9566,580,9566,7893,1673,2018-01-01,zipcode,Jacksonville
ZCTA5 32224,12,43751,76546,1279,284300,34932,12141,27562,1359,5167,8280,8319,4437,17585,15868,1717,15868,9322,6546,2018-01-01,zipcode,Jacksonville
ZCTA5 32225,12,54496,75517,1284,211700,43613,13360,37470,2432,9398,12326,8953,4361,21797,19956,1841,19956,13946,6010,2018-01-01,zipcode,Jacksonville
ZCTA5 32226,12,16013,77368,1641,209100,12256,4263,10667,1013,3121,3699,2000,834,6330,5544,786,5544,4625,919,2018-01-01,zipcode,Jacksonville
ZCTA5 32227,12,3087,51750,1574,-666666666,2238,289,930,15,209,521,109,76,589,411,178,411,4,407,2018-01-01,zipcode,Jacksonville
ZCTA5 32228,12,368,-666666666,-666666666,-666666666,368,0,84,0,9,56,19,0,0,0,0,0,0,0,2018-01-01,zipcode,Jacksonville
ZCTA5 32233,12,24473,62713,1140,254200,21097,6275,17786,1242,4489,5600,4103,2352,11079,9518,1561,9518,5510,4008,2018-01-01,zipcode,Atlantic beach
ZCTA5 32234,12,5780,52449,869,107000,4792,1641,4228,829,1815,1171,305,108,2526,2183,343,2183,1624,559,2018-01-01,zipcode,Jacksonville
ZCTA5 32244,12,60712,52928,1060,122700,46736,15027,39276,4236,12070,14956,5682,2332,24471,21611,2860,21611,12839,8772,2018-01-01,zipcode,Jacksonville
ZCTA5 32246,12,51275,57507,1180,166200,41645,12205,36112,3302,9277,12382,8020,3131,22446,20148,2298,20148,10777,9371,2018-01-01,zipcode,Jacksonville
ZCTA5 32250,12,26956,79125,1283,343500,22881,7161,20789,956,3167,5617,6776,4273,14720,12378,2342,12378,8408,3970,2018-01-01,zipcode,Jacksonville beach
ZCTA5 32254,12,13039,31141,896,60100,9659,4353,8362,1754,3585,2427,479,117,5868,4624,1244,4624,2248,2376,2018-01-01,zipcode,Jacksonville
ZCTA5 32256,12,45688,62235,1173,263200,38196,11159,32411,1552,5540,9482,9674,6163,22815,20410,2405,20410,7535,12875,2018-01-01,zipcode,Jacksonville
ZCTA5 32257,12,38651,58246,1054,194900,31542,10515,28072,2253,7146,8672,6924,3077,16966,15517,1449,15517,9449,6068,2018-01-01,zipcode,Jacksonville
ZCTA5 32258,12,31990,80207,1377,226300,24857,6404,22771,674,4018,7628,6547,3904,13383,12186,1197,12186,8483,3703,2018-01-01,zipcode,Jacksonville
ZCTA5 32259,12,49969,114033,1805,336500,37388,12392,32135,671,5428,8659,11312,6065,16664,15732,932,15732,13557,2175,2018-01-01,zipcode,Saint johns
ZCTA5 32266,12,7080,89500,1243,381400,5980,1853,4992,142,824,1422,1505,1099,3401,2924,477,2924,2003,921,2018-01-01,zipcode,Neptune beach
ZCTA5 32277,12,32029,49474,993,157500,25002,7785,20651,1784,6035,7773,3829,1230,13294,11913,1381,11913,6198,5715,2018-01-01,zipcode,Jacksonville
ZCTA5 32301,12,30712,42165,978,149700,26643,8200,17994,1276,3366,5685,4418,3249,15536,12947,2589,12947,4146,8801,2018-01-01,zipcode,Tallahassee
ZCTA5 32303,12,50436,48338,1017,148000,42213,11565,31068,1910,6046,10217,7968,4927,23497,21112,2385,21112,10373,10739,2018-01-01,zipcode,Tallahassee
ZCTA5 32304,12,47787,23438,915,90500,44553,17687,14258,2171,3085,4923,2350,1729,20391,16535,3856,16535,2187,14348,2018-01-01,zipcode,Tallahassee
ZCTA5 32305,12,20659,39723,836,100000,15868,6504,12850,1709,4287,4183,1781,890,9190,7789,1401,7789,4805,2984,2018-01-01,zipcode,Tallahassee
ZCTA5 32308,12,22441,61260,1054,220200,18652,6416,16197,573,2144,4111,4561,4808,11188,10318,870,10318,5672,4646,2018-01-01,zipcode,Tallahassee
ZCTA5 32309,12,31610,80544,1110,252700,24991,8810,22004,521,3109,5855,6857,5662,13034,12391,643,12391,9741,2650,2018-01-01,zipcode,Tallahassee
ZCTA5 32310,12,15864,36653,841,96500,12718,5550,8945,1159,3482,2467,1216,621,7761,5662,2099,5662,2719,2943,2018-01-01,zipcode,Tallahassee
ZCTA5 32311,12,21038,73731,1179,194900,16979,5351,14650,757,2792,3740,3917,3444,9112,8139,973,8139,5054,3085,2018-01-01,zipcode,Tallahassee
ZCTA5 32312,12,32864,97594,1261,293300,26299,8703,22203,463,2492,5419,7639,6190,13469,12683,786,12683,10376,2307,2018-01-01,zipcode,Tallahassee
ZCTA5 32317,12,14665,92598,1445,250600,11536,3667,9844,280,1707,2368,3199,2290,5689,5333,356,5333,4837,496,2018-01-01,zipcode,Tallahassee
ZCTA5 32320,12,3832,49167,692,139200,3122,1270,2786,626,903,832,250,175,2112,1512,600,1512,1028,484,2018-01-01,zipcode,Apalachicola
ZCTA5 32321,12,6277,34792,577,57400,5489,3618,4505,958,2197,907,264,179,2534,1616,918,1616,1182,434,2018-01-01,zipcode,Bristol
ZCTA5 32322,12,4152,35116,735,128900,3606,2705,3290,744,1274,870,262,140,1981,1132,849,1132,901,231,2018-01-01,zipcode,Carrabelle
ZCTA5 32323,12,422,42554,-666666666,49000,334,197,334,65,142,50,27,50,451,155,296,155,124,31,2018-01-01,zipcode,
ZCTA5 32324,12,4726,32614,663,81200,3981,2632,3531,980,1259,878,283,131,1993,1673,320,1673,1061,612,2018-01-01,zipcode,Chattahoochee
ZCTA5 32327,12,28319,64221,857,147800,22965,10299,20458,2383,7501,6803,2440,1331,11094,9616,1478,9616,7734,1882,2018-01-01,zipcode,Crawfordville
ZCTA5 32328,12,3032,45357,884,157300,2624,1183,2258,298,781,626,344,209,3101,1274,1827,1274,1025,249,2018-01-01,zipcode,Eastpoint
ZCTA5 32330,12,828,41250,781,76000,519,275,492,125,202,122,33,10,339,280,59,280,149,131,2018-01-01,zipcode,Greensboro
ZCTA5 32331,12,4269,39312,685,76900,3578,1879,3035,591,1194,751,304,195,2013,1613,400,1613,1337,276,2018-01-01,zipcode,Greenville
ZCTA5 32332,12,1315,31938,604,60300,1051,548,878,212,409,186,40,31,641,526,115,526,338,188,2018-01-01,zipcode,Gretna
ZCTA5 32333,12,10506,47784,750,119800,9064,4438,8113,1381,2759,2168,1104,701,5503,4735,768,4735,3630,1105,2018-01-01,zipcode,Havana
ZCTA5 32334,12,2088,42218,586,139600,1678,814,1502,161,680,343,243,75,1052,765,287,765,611,154,2018-01-01,zipcode,Hosford
ZCTA5 32336,12,1373,50506,-666666666,96400,1065,412,971,156,262,284,180,89,876,557,319,557,496,61,2018-01-01,zipcode,Lamont
ZCTA5 32340,12,11294,34882,685,93000,9455,5745,8260,1685,3159,2150,738,528,4910,3896,1014,3896,2791,1105,2018-01-01,zipcode,Madison
ZCTA5 32343,12,3301,54526,903,137600,2420,580,2051,365,621,566,307,192,1402,1277,125,1277,963,314,2018-01-01,zipcode,Midway
ZCTA5 32344,12,12360,43485,772,120100,10676,5995,9638,1762,3302,2516,1265,793,5892,5023,869,5023,3830,1193,2018-01-01,zipcode,Monticello
ZCTA5 32346,12,1769,44375,877,108100,1514,719,1303,320,379,445,130,29,1687,800,887,800,593,207,2018-01-01,zipcode,Panacea
ZCTA5 32347,12,7795,42226,665,86000,6257,3063,5306,885,2047,1886,333,155,3644,2880,764,2880,2519,361,2018-01-01,zipcode,Perry
ZCTA5 32348,12,12673,33145,707,75900,10695,7327,9406,2515,4168,2083,481,159,4814,3664,1150,3664,2843,821,2018-01-01,zipcode,Perry
ZCTA5 32350,12,1184,36705,811,117400,1068,678,995,111,323,440,96,25,725,559,166,559,497,62,2018-01-01,zipcode,Pinetta
ZCTA5 32351,12,18643,36082,617,88200,14360,8220,12442,2933,4644,3192,1148,525,7225,6206,1019,6206,4165,2041,2018-01-01,zipcode,Quincy
ZCTA5 32352,12,6698,46604,733,88600,5383,2288,4621,642,1862,1260,526,331,2763,2383,380,2383,1828,555,2018-01-01,zipcode,Quincy
ZCTA5 32355,12,224,41250,1028,152500,181,65,164,12,56,55,34,7,159,100,59,100,84,16,2018-01-01,zipcode,Saint marks
ZCTA5 32356,12,91,-666666666,-666666666,-666666666,91,91,91,0,91,0,0,0,67,46,21,46,46,0,2018-01-01,zipcode,Salem
ZCTA5 32358,12,1889,56719,818,146500,1485,707,1374,93,417,521,260,83,1418,785,633,785,689,96,2018-01-01,zipcode,Sopchoppy
ZCTA5 32359,12,1162,38564,929,113600,1119,738,1119,223,573,293,23,7,2474,732,1742,732,477,255,2018-01-01,zipcode,Steinhatchee
ZCTA5 32361,12,256,54286,-666666666,82000,180,63,170,27,78,60,5,0,112,84,28,84,77,7,2018-01-01,zipcode,Wacissa
ZCTA5 32399,12,0,-666666666,-666666666,-666666666,0,0,0,0,0,0,0,0,0,0,0,0,0,0,2018-01-01,zipcode,Tallahassee
ZCTA5 32401,12,22566,37691,858,128500,18197,8356,16146,2734,5302,5127,1909,1074,11282,9323,1959,9323,4622,4701,2018-01-01,zipcode,Panama city
ZCTA5 32403,12,3374,64875,1562,-666666666,2148,583,1410,35,148,505,455,267,1003,810,193,810,0,810,2018-01-01,zipcode,Panama city
ZCTA5 32404,12,40029,50681,951,155100,31954,12715,27362,3029,9124,11175,2629,1405,17179,14384,2795,14384,9375,5009,2018-01-01,zipcode,Panama city
ZCTA5 32405,12,32064,47988,1002,171500,25732,10097,22324,1717,7507,7513,3503,2084,14186,12496,1690,12496,7098,5398,2018-01-01,zipcode,Panama city
ZCTA5 32407,12,10433,60908,1283,219400,9072,3050,7722,515,2237,2823,1452,695,7931,4503,3428,4503,2389,2114,2018-01-01,zipcode,Panama city beach
ZCTA5 32408,12,18141,56740,1080,223000,14907,4713,12658,734,3566,4389,2754,1215,17382,7408,9974,7408,4612,2796,2018-01-01,zipcode,Panama city
ZCTA5 32409,12,10191,55466,907,159100,8141,3240,7034,1080,2317,2772,658,207,4168,3618,550,3618,3014,604,2018-01-01,zipcode,Panama city
ZCTA5 32410,12,987,55417,1241,220800,956,547,935,32,239,332,187,145,1552,506,1046,506,386,120,2018-01-01,zipcode,Mexico beach
ZCTA5 32413,12,14619,63477,1030,237600,12463,5058,11642,822,3245,3757,2718,1100,17644,6288,11356,6288,4561,1727,2018-01-01,zipcode,Panama city beach
ZCTA5 32420,12,1983,31858,641,78500,1697,994,1515,403,590,412,77,33,1215,849,366,849,734,115,2018-01-01,zipcode,Alford
ZCTA5 32421,12,5256,44571,697,68100,4002,1649,3409,539,1370,1063,348,89,2208,1814,394,1814,1497,317,2018-01-01,zipcode,Altha
ZCTA5 32423,12,1025,70195,784,79200,864,425,791,76,232,387,82,14,540,425,115,425,375,50,2018-01-01,zipcode,Bascom
ZCTA5 32424,12,7182,36176,642,86600,5963,4106,5425,1552,2242,1140,319,172,2638,1968,670,1968,1576,392,2018-01-01,zipcode,Blountstown
ZCTA5 32425,12,13480,37434,664,95200,11054,6626,9727,2193,3667,2867,677,323,5912,4672,1240,4672,3412,1260,2018-01-01,zipcode,Bonifay
ZCTA5 32426,12,914,29821,739,76800,744,408,592,170,235,123,34,30,463,349,114,349,296,53,2018-01-01,zipcode,Campbellton
ZCTA5 32427,12,926,24474,810,81500,826,479,681,236,259,119,26,41,497,406,91,406,337,69,2018-01-01,zipcode,Caryville
ZCTA5 32428,12,17179,39990,764,117500,14256,8178,12610,2315,5052,3506,1226,511,7091,5585,1506,5585,4320,1265,2018-01-01,zipcode,Chipley
ZCTA5 32430,12,1064,53000,-666666666,90000,923,325,768,62,367,271,61,7,617,420,197,420,366,54,2018-01-01,zipcode,Clarksville
ZCTA5 32431,12,3975,43520,659,85000,3231,1429,2821,622,1241,726,173,59,2219,1615,604,1615,1208,407,2018-01-01,zipcode,Cottondale
ZCTA5 32432,12,0,-666666666,-666666666,-666666666,0,0,0,0,0,0,0,0,0,0,0,0,0,0,2018-01-01,zipcode,Cypress
ZCTA5 32433,12,17586,35575,762,104800,13997,7142,12290,2387,4878,3839,680,506,7495,6306,1189,6306,4439,1867,2018-01-01,zipcode,Defuniak springs
ZCTA5 32435,12,7325,44118,727,129900,5889,2413,5068,800,1837,1485,519,427,3804,2883,921,2883,2098,785,2018-01-01,zipcode,Defuniak springs
ZCTA5 32437,12,921,25536,-666666666,77500,591,263,556,43,322,178,12,1,379,304,75,304,203,101,2018-01-01,zipcode,Ebro
ZCTA5 32438,12,3473,31496,464,74500,3037,1802,2650,450,1364,759,77,0,1978,1397,581,1397,1282,115,2018-01-01,zipcode,Fountain
ZCTA5 32439,12,9964,54637,970,208500,8191,2775,7173,733,2147,2608,1191,494,4955,3953,1002,3953,2914,1039,2018-01-01,zipcode,Freeport
ZCTA5 32440,12,7762,44014,649,110400,6751,4067,5705,1266,2210,1511,448,270,2427,2015,412,2015,1411,604,2018-01-01,zipcode,Graceville
ZCTA5 32442,12,3132,39961,629,133500,2556,1086,2258,483,930,584,137,124,1734,1431,303,1431,1046,385,2018-01-01,zipcode,Grand ridge
ZCTA5 32443,12,3322,34701,681,88500,2593,1188,2305,405,867,707,196,130,1720,1264,456,1264,997,267,2018-01-01,zipcode,Greenwood
ZCTA5 32444,12,21730,66822,1039,197100,17366,6262,14972,676,3803,5407,3016,2070,8934,8085,849,8085,6001,2084,2018-01-01,zipcode,Lynn haven
ZCTA5 32445,12,2525,36838,719,86200,2239,1702,1944,663,747,397,102,35,600,475,125,475,332,143,2018-01-01,zipcode,Malone
ZCTA5 32446,12,11303,45596,696,146200,9504,5006,8169,1187,2536,2735,932,779,4725,3968,757,3968,2668,1300,2018-01-01,zipcode,Marianna
ZCTA5 32447,12,161,-666666666,-666666666,-666666666,101,101,0,0,0,0,0,0,0,0,0,0,0,0,2018-01-01,zipcode,Marianna
ZCTA5 32448,12,8480,26738,463,86100,6912,3295,6168,756,2464,2094,470,384,4680,3890,790,3890,2536,1354,2018-01-01,zipcode,Marianna
ZCTA5 32449,12,637,38438,-666666666,73400,499,270,423,81,139,203,0,0,319,231,88,231,213,18,2018-01-01,zipcode,Wewahitchka
ZCTA5 32455,12,4514,40785,680,87400,3829,1685,3233,983,1190,736,216,108,2328,1723,605,1723,1308,415,2018-01-01,zipcode,Ponce de leon
ZCTA5 32456,12,8437,47770,1161,186600,6997,3032,6234,508,1896,2111,940,779,6409,3356,3053,3356,2403,953,2018-01-01,zipcode,Port saint joe
ZCTA5 32459,12,15400,80335,1411,377700,12608,4397,11612,472,2004,3806,3918,1412,13987,6356,7631,6356,4917,1439,2018-01-01,zipcode,Santa rosa beach
ZCTA5 32460,12,5831,40034,644,90800,5084,3526,4506,1010,1922,1232,259,83,1753,1463,290,1463,1090,373,2018-01-01,zipcode,Sneads
ZCTA5 32461,12,34,-666666666,-666666666,-666666666,34,11,34,0,0,0,34,0,78,23,55,23,23,0,2018-01-01,zipcode,Inlet beach
ZCTA5 32462,12,3641,37485,603,91000,3020,1178,2501,316,1180,813,139,53,1903,1395,508,1395,1051,344,2018-01-01,zipcode,Vernon
ZCTA5 32463,12,171,-666666666,625,67500,126,50,104,21,40,43,0,0,69,65,4,65,37,28,2018-01-01,zipcode,Wausau
ZCTA5 32464,12,4311,39755,449,79200,3584,1782,3213,861,1225,840,243,44,2179,1836,343,1836,1592,244,2018-01-01,zipcode,Westville
ZCTA5 32465,12,8179,39289,847,93100,7256,4802,6386,1381,2747,1680,449,129,3507,2237,1270,2237,1758,479,2018-01-01,zipcode,Wewahitchka
ZCTA5 32466,12,6450,53283,898,122400,5035,2218,4177,671,1637,1666,140,63,2416,2017,399,2017,1827,190,2018-01-01,zipcode,Youngstown
ZCTA5 32501,12,11557,30253,788,120500,9205,4748,7848,1356,2265,2436,1074,717,5315,4323,992,4323,2240,2083,2018-01-01,zipcode,Pensacola
ZCTA5 32502,12,3185,48316,988,139600,2567,904,2369,161,672,827,413,296,1782,1452,330,1452,795,657,2018-01-01,zipcode,Pensacola
ZCTA5 32503,12,34520,49416,888,153600,28448,10637,19951,1626,4688,6956,4049,2632,13470,11984,1486,11984,7416,4568,2018-01-01,zipcode,Pensacola
ZCTA5 32504,12,23080,49845,968,163800,17264,6237,14230,746,3074,5285,3003,2122,10163,9199,964,9199,5159,4040,2018-01-01,zipcode,Pensacola
ZCTA5 32505,12,24965,38214,876,63000,21106,8923,18725,2616,7598,6121,1578,812,13401,10926,2475,10926,5501,5425,2018-01-01,zipcode,Pensacola
ZCTA5 32506,12,36923,48783,1038,116700,28926,11527,24978,2792,6532,10214,3598,1842,16080,14117,1963,14117,7673,6444,2018-01-01,zipcode,Pensacola
ZCTA5 32507,12,31288,47605,943,151000,24607,9358,21407,1594,5155,8523,3751,2384,17706,12952,4754,12952,7339,5613,2018-01-01,zipcode,Pensacola
ZCTA5 32508,12,5381,39417,1256,-666666666,5068,467,939,13,125,413,335,53,632,505,127,505,0,505,2018-01-01,zipcode,Pensacola
ZCTA5 32509,12,702,-666666666,-666666666,-666666666,702,702,702,49,254,278,55,66,0,0,0,0,0,0,2018-01-01,zipcode,Pensacola
ZCTA5 32511,12,1034,-666666666,-666666666,-666666666,1034,42,64,0,8,35,21,0,0,0,0,0,0,0,2018-01-01,zipcode,Pensacola
ZCTA5 32514,12,44759,47175,982,137400,35746,13248,27576,2393,6760,9839,5942,2642,18816,16816,2000,16816,8411,8405,2018-01-01,zipcode,Pensacola
ZCTA5 32526,12,36300,58665,1066,127100,29815,12103,26635,1764,7239,10947,4564,2121,16100,14320,1780,14320,10724,3596,2018-01-01,zipcode,Pensacola
ZCTA5 32530,12,0,-666666666,-666666666,-666666666,0,0,0,0,0,0,0,0,0,0,0,0,0,0,2018-01-01,zipcode,Bagdad
ZCTA5 32531,12,5735,58650,1065,176700,4569,2145,4099,491,1509,1416,440,243,2699,2154,545,2154,1883,271,2018-01-01,zipcode,Baker
ZCTA5 32533,12,27632,71528,1066,162400,22931,9673,20194,1853,5486,6867,4354,1634,11394,10190,1204,10190,8449,1741,2018-01-01,zipcode,Cantonment
ZCTA5 32534,12,14524,49130,1059,112500,12471,4954,10955,659,3083,4670,1898,645,6827,6144,683,6144,4360,1784,2018-01-01,zipcode,Pensacola
ZCTA5 32535,12,5694,38917,693,77300,5156,3276,4658,921,2124,1225,290,98,2066,1818,248,1818,1168,650,2018-01-01,zipcode,Century
ZCTA5 32536,12,23426,68599,1043,192400,17730,6354,14767,1150,3629,6133,2546,1309,9474,8459,1015,8459,5465,2994,2018-01-01,zipcode,Crestview
ZCTA5 32539,12,29265,57757,956,153800,22422,10480,19463,2325,6197,7413,2612,916,10494,9400,1094,9400,6654,2746,2018-01-01,zipcode,Crestview
ZCTA5 32541,12,18908,77609,1457,358900,15866,5046,14082,602,2933,4494,3746,2307,16570,8088,8482,8088,4957,3131,2018-01-01,zipcode,Destin
ZCTA5 32542,12,3081,48409,1442,-666666666,2316,234,1053,8,120,627,246,52,945,658,287,658,0,658,2018-01-01,zipcode,Eglin afb
ZCTA5 32544,12,2003,-666666666,1436,-666666666,1412,112,570,6,44,336,126,58,338,311,27,311,0,311,2018-01-01,zipcode,Hurlburt field
ZCTA5 32547,12,33339,51335,1025,174500,27630,10219,23841,2610,6152,8290,4455,2334,15879,14518,1361,14518,6834,7684,2018-01-01,zipcode,Fort walton beach
ZCTA5 32548,12,21315,52883,994,175900,17743,6054,15670,1372,4013,6421,2289,1575,13200,9502,3698,9502,5363,4139,2018-01-01,zipcode,Fort walton beach
ZCTA5 32550,12,8490,64974,1208,360400,7322,3243,6725,167,889,2466,1978,1225,13550,3866,9684,3866,2732,1134,2018-01-01,zipcode,Miramar beach
ZCTA5 32561,12,9305,103769,1413,394900,7743,2855,6896,194,926,1749,2216,1811,6465,3974,2491,3974,3165,809,2018-01-01,zipcode,Gulf breeze
ZCTA5 32563,12,25550,67546,1182,233800,20280,7341,17938,757,3950,6565,4097,2569,10890,9770,1120,9770,7460,2310,2018-01-01,zipcode,Gulf breeze
ZCTA5 32564,12,2931,75795,1159,168600,2291,978,2213,223,665,928,308,89,1203,1034,169,1034,848,186,2018-01-01,zipcode,Holt
ZCTA5 32565,12,4826,46233,909,114600,4166,1864,3693,320,1500,1219,512,142,2473,2089,384,2089,1647,442,2018-01-01,zipcode,Jay
ZCTA5 32566,12,38112,78368,1288,228000,29676,11034,25655,1306,6109,10313,5259,2668,17296,14019,3277,14019,10843,3176,2018-01-01,zipcode,Navarre
ZCTA5 32567,12,3104,43094,740,121900,2430,1129,2221,326,845,790,167,93,1695,1309,386,1309,1067,242,2018-01-01,zipcode,Laurel hill
ZCTA5 32568,12,2735,53854,938,150600,2211,869,2009,246,650,871,122,120,1212,1038,174,1038,846,192,2018-01-01,zipcode,Mc david
ZCTA5 32569,12,12971,61976,1052,179800,10617,3234,8722,732,2263,3427,1500,800,5353,4915,438,4915,3367,1548,2018-01-01,zipcode,Mary esther
ZCTA5 32570,12,30768,57160,899,139200,24992,11144,21374,2190,6784,8069,3095,1236,13221,11658,1563,11658,8058,3600,2018-01-01,zipcode,Milton
ZCTA5 32571,12,35388,71494,1020,177200,27791,10258,23159,1642,6181,8368,4716,2252,13465,12210,1255,12210,9368,2842,2018-01-01,zipcode,Milton
ZCTA5 32577,12,4321,56619,713,137600,3686,1664,3213,279,920,1274,508,232,1936,1747,189,1747,1522,225,2018-01-01,zipcode,Molino
ZCTA5 32578,12,32833,82569,1168,268500,26000,9154,22756,869,3898,7572,6021,4396,13660,12436,1224,12436,9461,2975,2018-01-01,zipcode,Niceville
ZCTA5 32579,12,10187,71988,1178,269200,8512,3446,7512,477,1568,2280,1775,1412,4649,4360,289,4360,2940,1420,2018-01-01,zipcode,Shalimar
ZCTA5 32580,12,4364,56581,1127,213100,3312,1103,2745,206,647,1190,402,300,1863,1497,366,1497,957,540,2018-01-01,zipcode,Valparaiso
ZCTA5 32583,12,28585,57124,986,134700,24242,13067,21211,3602,6931,6869,2654,1155,9900,8558,1342,8558,6505,2053,2018-01-01,zipcode,Milton
ZCTA5 32601,12,18579,25481,838,147800,17153,6778,9266,565,2074,2432,2087,2108,9753,7628,2125,7628,2163,5465,2018-01-01,zipcode,Gainesville
ZCTA5 32603,12,7195,21992,839,266600,6947,4001,1529,20,135,237,368,769,2257,1718,539,1718,331,1387,2018-01-01,zipcode,Gainesville
ZCTA5 32605,12,24684,69102,1208,183000,20626,7006,17810,754,3035,4166,4576,5279,11245,10107,1138,10107,7183,2924,2018-01-01,zipcode,Gainesville
ZCTA5 32606,12,23766,67984,1220,205900,18775,6682,16078,617,2250,3944,4235,5032,10776,9160,1616,9160,4825,4335,2018-01-01,zipcode,Gainesville
ZCTA5 32607,12,30624,38521,929,205700,26652,9894,15760,811,3437,4559,3413,3540,15239,11911,3328,11911,4065,7846,2018-01-01,zipcode,Gainesville
ZCTA5 32608,12,48905,42424,975,226700,41600,15775,28957,1708,4539,6843,7743,8124,23752,19357,4395,19357,7730,11627,2018-01-01,zipcode,Gainesville
ZCTA5 32609,12,19906,33585,879,98300,16406,6957,13330,2210,3880,4289,1806,1145,8216,6894,1322,6894,3993,2901,2018-01-01,zipcode,Gainesville
ZCTA5 32612,12,7606,-666666666,-666666666,-666666666,7606,6082,27,0,6,16,0,5,5,5,0,5,0,5,2018-01-01,zipcode,Gainesville
ZCTA5 32615,12,14630,56662,1012,167700,11492,4276,10061,619,2413,3421,2186,1422,6464,5572,892,5572,4238,1334,2018-01-01,zipcode,Alachua
ZCTA5 32616,12,1142,31250,722,86300,852,375,795,151,390,186,44,24,432,391,41,391,214,177,2018-01-01,zipcode,
ZCTA5 32617,12,3937,42536,595,133800,3353,1505,2736,364,1099,840,201,232,1767,1491,276,1491,1226,265,2018-01-01,zipcode,Anthony
ZCTA5 32618,12,8058,53987,730,157000,6587,2555,5556,815,1534,1638,875,694,3390,2871,519,2871,2355,516,2018-01-01,zipcode,Archer
ZCTA5 32619,12,5326,40963,763,88600,4303,1959,3512,503,1448,1097,348,116,2393,2037,356,2037,1726,311,2018-01-01,zipcode,Bell
ZCTA5 32621,12,5394,36368,642,74300,4356,2444,3817,807,1609,987,318,96,2555,2131,424,2131,1536,595,2018-01-01,zipcode,Bronson
ZCTA5 32622,12,1004,66250,779,116000,779,367,739,103,262,213,93,68,485,371,114,371,320,51,2018-01-01,zipcode,Brooker
ZCTA5 32625,12,1626,38571,774,138100,1288,583,1152,66,457,316,149,164,1230,680,550,680,505,175,2018-01-01,zipcode,Cedar key
ZCTA5 32626,12,8784,34039,672,93000,7023,3656,6210,1112,2577,1872,479,170,4476,3639,837,3639,2763,876,2018-01-01,zipcode,Chiefland
ZCTA5 32628,12,5040,38460,703,80100,4162,2896,3697,783,1803,839,205,67,1667,1333,334,1333,944,389,2018-01-01,zipcode,Cross city
ZCTA5 32631,12,264,64901,-666666666,274500,253,169,253,0,8,102,46,97,149,149,0,149,149,0,2018-01-01,zipcode,Earleton
ZCTA5 32639,12,123,25568,-666666666,46500,123,71,123,24,67,0,0,32,221,81,140,81,70,11,2018-01-01,zipcode,Gulf hammock
ZCTA5 32640,12,10790,44821,738,109300,9281,4626,8361,1446,3065,2328,806,716,5647,4317,1330,4317,3524,793,2018-01-01,zipcode,Hawthorne
ZCTA5 32641,12,14989,36885,846,95900,11759,5510,9783,1722,3507,3201,890,463,5528,4715,813,4715,2804,1911,2018-01-01,zipcode,Gainesville
ZCTA5 32643,12,11207,56108,916,159600,9386,3945,8179,637,2483,3184,1167,708,4984,4339,645,4339,3600,739,2018-01-01,zipcode,High springs
ZCTA5 32648,12,570,74000,-666666666,160300,401,190,342,51,156,112,16,7,576,184,392,184,168,16,2018-01-01,zipcode,Horseshoe beach
ZCTA5 32653,12,13168,65427,937,191400,10976,4179,9664,420,1716,3117,2337,2074,6166,5745,421,5745,4385,1360,2018-01-01,zipcode,Gainesville
ZCTA5 32656,12,14433,46256,900,105600,11868,5577,10311,1576,3689,3534,1145,367,6603,5473,1130,5473,4347,1126,2018-01-01,zipcode,Keystone heights
ZCTA5 32658,12,376,46250,1125,99000,317,144,283,46,107,101,29,0,122,104,18,104,85,19,2018-01-01,zipcode,La crosse
ZCTA5 32664,12,538,44821,900,108100,477,218,463,67,202,72,78,44,285,229,56,229,173,56,2018-01-01,zipcode,Mc intosh
ZCTA5 32666,12,7147,47067,869,136100,6265,3278,5183,637,1947,1592,478,529,3464,2670,794,2670,2128,542,2018-01-01,zipcode,Melrose
ZCTA5 32667,12,4090,52500,728,236200,3399,1508,2939,108,779,803,631,618,2002,1720,282,1720,1258,462,2018-01-01,zipcode,Micanopy
ZCTA5 32668,12,4700,39277,948,153500,4153,2294,3820,469,1650,1233,344,124,2507,2044,463,2044,1709,335,2018-01-01,zipcode,Morriston
ZCTA5 32669,12,13098,69439,973,194900,9762,2959,8828,450,2137,2899,2170,1172,5433,4662,771,4662,3955,707,2018-01-01,zipcode,Newberry
ZCTA5 32680,12,10111,36117,577,67700,8552,5379,7662,1615,3296,1930,521,300,5971,4550,1421,4550,3578,972,2018-01-01,zipcode,Old town
ZCTA5 32681,12,47,-666666666,-666666666,-666666666,47,32,47,0,47,0,0,0,31,31,0,31,31,0,2018-01-01,zipcode,Orange lake
ZCTA5 32683,12,140,14138,-666666666,-666666666,106,91,106,14,58,34,0,0,59,48,11,48,42,6,2018-01-01,zipcode,Otter creek
ZCTA5 32686,12,4764,36905,586,151300,3954,1911,3283,745,1097,787,394,260,2394,1871,523,1871,1338,533,2018-01-01,zipcode,Reddick
ZCTA5 32692,12,274,-666666666,-666666666,-666666666,250,142,250,35,76,127,12,0,688,142,546,142,142,0,2018-01-01,zipcode,Suwannee
ZCTA5 32693,12,12186,37988,678,88100,9790,5153,8034,1324,3244,2379,798,289,5081,4405,676,4405,3451,954,2018-01-01,zipcode,Trenton
ZCTA5 32694,12,2454,48816,535,119200,1882,706,1517,186,608,465,224,34,1095,838,257,838,603,235,2018-01-01,zipcode,Waldo
ZCTA5 32696,12,12363,48982,752,136400,10144,4462,8923,1188,3609,2789,818,519,5495,4692,803,4692,3708,984,2018-01-01,zipcode,Williston
ZCTA5 32697,12,334,25357,805,180000,235,86,151,41,61,45,0,4,161,102,59,102,8,94,2018-01-01,zipcode,Worthington springs
ZCTA5 32701,12,21997,54546,1120,162200,18656,6498,16679,875,3800,6180,4059,1765,11503,9633,1870,9633,4992,4641,2018-01-01,zipcode,Altamonte springs
ZCTA5 32702,12,2793,37470,2181,63400,2265,1397,1993,307,756,599,177,154,1622,1151,471,1151,768,383,2018-01-01,zipcode,Altoona
ZCTA5 32703,12,50992,49742,1094,168500,40014,14175,34305,4867,10574,10285,6357,2222,19554,17678,1876,17678,10842,6836,2018-01-01,zipcode,Apopka
ZCTA5 32707,12,35369,53373,1143,162400,29958,11385,26301,1596,6164,10939,5652,1950,16319,14371,1948,14371,9332,5039,2018-01-01,zipcode,Casselberry
ZCTA5 32708,12,44826,68774,1247,242000,37255,13682,32535,1695,6445,10522,9372,4501,18117,16702,1415,16702,12493,4209,2018-01-01,zipcode,Winter springs
ZCTA5 32709,12,1986,43462,-666666666,168900,1816,866,1701,308,551,485,207,150,895,818,77,818,724,94,2018-01-01,zipcode,Christmas
ZCTA5 32712,12,46662,69726,1287,227000,36687,12212,32191,4463,8325,10441,5460,3502,17416,15659,1757,15659,12429,3230,2018-01-01,zipcode,Apopka
ZCTA5 32713,12,20697,56002,1078,184600,17257,7901,15473,1028,5434,4706,3125,1180,9095,8297,798,8297,6960,1337,2018-01-01,zipcode,Debary
ZCTA5 32714,12,37223,51814,1185,188000,30715,9694,26865,1943,5279,9935,6647,3061,17289,14829,2460,14829,6978,7851,2018-01-01,zipcode,Altamonte springs
ZCTA5 32720,12,31819,44146,921,177600,26734,12922,22320,2342,6672,7810,3744,1752,14175,12478,1697,12478,8570,3908,2018-01-01,zipcode,Deland
ZCTA5 32724,12,36047,47182,1008,161800,30139,14778,25593,2377,8065,8357,4455,2339,15745,14210,1535,14210,9756,4454,2018-01-01,zipcode,Deland
ZCTA5 32725,12,48008,48830,1123,143100,39048,16871,34043,4119,11154,12929,4283,1558,18548,16693,1855,16693,12930,3763,2018-01-01,zipcode,Deltona
ZCTA5 32726,12,22377,42208,846,145600,18165,7922,15635,2261,6211,4234,2050,879,9908,8657,1251,8657,5451,3206,2018-01-01,zipcode,Eustis
ZCTA5 32730,12,5991,42772,1068,142400,5296,2134,4621,290,1186,1873,897,375,2738,2500,238,2500,988,1512,2018-01-01,zipcode,Casselberry
ZCTA5 32732,12,4809,83962,-666666666,302400,4254,1457,3612,88,850,1587,778,309,2157,1760,397,1760,1727,33,2018-01-01,zipcode,Geneva
ZCTA5 32735,12,4673,58962,1160,129400,3729,1964,3627,402,1182,1411,393,239,2174,2038,136,2038,1792,246,2018-01-01,zipcode,Grand island
ZCTA5 32736,12,9922,73430,1030,258200,8063,3335,7150,705,2160,2435,1189,661,3993,3370,623,3370,3050,320,2018-01-01,zipcode,Eustis
ZCTA5 32738,12,45881,50446,1154,140000,36016,14427,30533,3114,11364,10981,4074,1000,16187,14994,1193,14994,11252,3742,2018-01-01,zipcode,Deltona
ZCTA5 32744,12,3764,45510,985,156200,3171,1379,2899,335,1060,944,434,126,1752,1516,236,1516,1261,255,2018-01-01,zipcode,Lake helen
ZCTA5 32746,12,43232,80756,1397,289500,35553,12458,31386,1208,5229,9837,9531,5581,18812,16676,2136,16676,10674,6002,2018-01-01,zipcode,Lake mary
ZCTA5 32750,12,24389,71842,1195,220100,20510,6732,17912,987,4748,6243,4071,1863,9792,9033,759,9033,6357,2676,2018-01-01,zipcode,Longwood
ZCTA5 32751,12,22073,71382,1280,284400,17851,6521,15195,470,2409,4200,5057,3059,9717,8481,1236,8481,5854,2627,2018-01-01,zipcode,Maitland
ZCTA5 32754,12,10436,52463,821,161700,8667,4082,7896,923,2816,2821,872,464,5324,4038,1286,4038,3613,425,2018-01-01,zipcode,Mims
ZCTA5 32757,12,26679,56206,1036,205800,22749,10343,20462,2240,5930,6295,3584,2413,13266,11303,1963,11303,7884,3419,2018-01-01,zipcode,Mount dora
ZCTA5 32759,12,2787,32456,833,160100,2453,1575,2342,348,956,724,248,66,1551,1228,323,1228,902,326,2018-01-01,zipcode,Oak hill
ZCTA5 32763,12,23098,44390,1110,114400,18935,8500,16650,1748,5982,5843,1978,1099,10248,8996,1252,8996,5599,3397,2018-01-01,zipcode,Orange city
ZCTA5 32764,12,3188,61667,986,214800,2889,1227,2549,299,966,864,306,114,1516,1202,314,1202,1083,119,2018-01-01,zipcode,Osteen
ZCTA5 32765,12,65151,77074,1384,270300,51938,17846,40918,1598,7031,13640,11714,6935,22859,21128,1731,21128,14752,6376,2018-01-01,zipcode,Oviedo
ZCTA5 32766,12,17252,104938,1696,322500,13045,4848,11001,534,1984,3143,3171,2169,5420,5134,286,5134,4517,617,2018-01-01,zipcode,Oviedo
ZCTA5 32767,12,3273,47531,850,93500,2668,1028,2220,495,1079,584,33,29,1433,1063,370,1063,845,218,2018-01-01,zipcode,Paisley
ZCTA5 32771,12,54980,56934,1143,185900,42273,14017,36820,3195,9257,12971,7716,3681,22685,19336,3349,19336,11541,7795,2018-01-01,zipcode,Sanford
ZCTA5 32773,12,30955,44804,1053,124600,24173,9002,20851,2112,7157,7211,3351,1020,13195,11056,2139,11056,6531,4525,2018-01-01,zipcode,Sanford
ZCTA5 32776,12,12416,79602,1309,215400,9742,3185,8596,723,2494,3373,1301,705,4127,3966,161,3966,3316,650,2018-01-01,zipcode,Sorrento
ZCTA5 32778,12,21406,45828,944,135400,18082,9679,16303,1767,5853,5224,2284,1175,11244,9082,2162,9082,6824,2258,2018-01-01,zipcode,Tavares
ZCTA5 32779,12,29737,91996,1384,310400,23942,8986,21184,528,3316,6353,7077,3910,11429,10777,652,10777,8772,2005,2018-01-01,zipcode,Longwood
ZCTA5 32780,12,35399,48531,904,151200,30176,14640,27051,2406,8062,9545,4827,2211,20077,15260,4817,15260,10602,4658,2018-01-01,zipcode,Titusville
ZCTA5 32784,12,12313,45320,727,132600,9800,4564,8315,1471,2593,3014,661,576,5340,4315,1025,4315,3143,1172,2018-01-01,zipcode,Umatilla
ZCTA5 32789,12,26568,73003,1153,437700,22031,9095,19053,1002,2609,3941,6102,5399,12708,11015,1693,11015,7534,3481,2018-01-01,zipcode,Winter park
ZCTA5 32792,12,50991,50943,1130,209600,43498,14772,36139,2290,7708,11975,9423,4743,23744,20657,3087,20657,9590,11067,2018-01-01,zipcode,Winter park
ZCTA5 32796,12,20948,45654,952,126700,17545,8586,15833,1293,5187,5935,2160,1258,10072,8202,1870,8202,6143,2059,2018-01-01,zipcode,Titusville
ZCTA5 32798,12,2595,42591,1061,78800,2442,1556,2199,191,725,868,317,98,1584,1294,290,1294,1208,86,2018-01-01,zipcode,Zellwood
ZCTA5 32801,12,12174,53628,1233,314200,11017,3275,10313,571,1959,2054,3518,2211,8951,7394,1557,7394,1679,5715,2018-01-01,zipcode,Orlando
ZCTA5 32803,12,19583,67009,1235,266300,17737,3897,16011,606,2200,4280,5507,3418,11142,9497,1645,9497,5162,4335,2018-01-01,zipcode,Orlando
ZCTA5 32804,12,17653,72782,1169,305500,14918,4746,13615,582,2982,3267,4481,2303,8885,7722,1163,7722,4887,2835,2018-01-01,zipcode,Orlando
ZCTA5 32805,12,20695,26584,778,115200,16608,7286,14643,3027,5242,3863,1879,632,9140,7706,1434,7706,2529,5177,2018-01-01,zipcode,Orlando
ZCTA5 32806,12,27768,60878,1107,242600,22828,7012,20383,1338,4699,5972,5498,2876,12478,11265,1213,11265,6589,4676,2018-01-01,zipcode,Orlando
ZCTA5 32807,12,34306,42781,1080,138100,27918,9528,23649,5076,8344,6225,2843,1161,13098,11820,1278,11820,5372,6448,2018-01-01,zipcode,Orlando
ZCTA5 32808,12,57443,35186,960,97400,43684,14106,35144,7426,12143,11226,2964,1385,19788,18106,1682,18106,7092,11014,2018-01-01,zipcode,Orlando
ZCTA5 32809,12,28258,43919,973,150100,22756,7729,19486,3869,7039,5379,2268,931,11015,9275,1740,9275,4833,4442,2018-01-01,zipcode,Orlando
ZCTA5 32810,12,39384,48727,1099,128400,30402,8937,26081,3058,8214,9018,4279,1512,14629,13447,1182,13447,6845,6602,2018-01-01,zipcode,Orlando
ZCTA5 32811,12,41246,35911,1080,86800,32271,8662,26323,3734,7463,9347,4045,1734,17581,15429,2152,15429,3751,11678,2018-01-01,zipcode,Orlando
ZCTA5 32812,12,35101,49611,1080,213600,29633,9694,25716,2040,6531,8705,5942,2498,15300,14144,1156,14144,7938,6206,2018-01-01,zipcode,Orlando
ZCTA5 32814,12,7155,93589,1807,440000,5905,1412,5367,112,507,881,1976,1891,3866,3165,701,3165,1431,1734,2018-01-01,zipcode,Orlando
ZCTA5 32817,12,35317,58958,1193,202100,29964,10653,21013,1824,4530,6928,5168,2563,13283,11528,1755,11528,6337,5191,2018-01-01,zipcode,Orlando
ZCTA5 32818,12,55586,43438,1037,155500,41721,12765,34118,6704,10651,10961,4374,1428,18058,16968,1090,16968,9283,7685,2018-01-01,zipcode,Orlando
ZCTA5 32819,12,27442,68964,1290,317300,22943,7504,19783,1293,3239,5807,6395,3049,14114,10142,3972,10142,6481,3661,2018-01-01,zipcode,Orlando
ZCTA5 32820,12,9240,81628,1305,255000,7189,1966,5989,622,1336,2028,1314,689,3093,2836,257,2836,2490,346,2018-01-01,zipcode,Orlando
ZCTA5 32821,12,17374,56090,1312,191500,15008,3767,12935,1008,2470,4489,3750,1218,12057,7232,4825,7232,2888,4344,2018-01-01,zipcode,Orlando
ZCTA5 32822,12,60781,37565,1104,117800,48199,16711,41365,6260,13732,13114,6078,2181,25590,22469,3121,22469,8764,13705,2018-01-01,zipcode,Orlando
ZCTA5 32824,12,46545,60405,1434,204200,36951,11576,31171,3825,7768,10977,6059,2542,15466,13039,2427,13039,8768,4271,2018-01-01,zipcode,Orlando
ZCTA5 32825,12,61550,57839,1201,198600,49559,15842,40828,4014,9601,14356,8948,3909,22489,20407,2082,20407,12632,7775,2018-01-01,zipcode,Orlando
ZCTA5 32826,12,36464,46240,1121,161500,33241,20523,13717,1808,3381,3612,3155,1761,8895,7646,1249,7646,4075,3571,2018-01-01,zipcode,Orlando
ZCTA5 32827,12,9421,76304,1653,284700,7270,2364,6285,334,1234,1495,1943,1279,4097,3498,599,3498,2184,1314,2018-01-01,zipcode,Orlando
ZCTA5 32828,12,65665,70619,1457,251700,51703,16369,41502,3138,7196,13122,11461,6585,22980,21327,1653,21327,13508,7819,2018-01-01,zipcode,Orlando
ZCTA5 32829,12,19888,67782,1424,217100,15267,4496,13377,953,3302,3874,3269,1979,7389,6230,1159,6230,4756,1474,2018-01-01,zipcode,Orlando
ZCTA5 32830,12,5,-666666666,-666666666,-666666666,5,0,5,0,0,5,0,0,5,5,0,5,0,5,2018-01-01,zipcode,Orlando
ZCTA5 32831,12,3280,38125,-666666666,-666666666,3269,3244,2857,1154,1130,490,38,45,115,25,90,25,25,0,2018-01-01,zipcode,Orlando
ZCTA5 32832,12,24325,87310,1591,322500,18305,5409,15824,660,1736,4359,5598,3471,10136,8170,1966,8170,5267,2903,2018-01-01,zipcode,Orlando
ZCTA5 32833,12,9697,59250,891,235000,7544,2342,6827,733,2179,1986,1024,905,3748,3271,477,3271,2556,715,2018-01-01,zipcode,Orlando
ZCTA5 32835,12,46058,54805,1299,223400,37338,8983,31121,2392,7014,9893,7876,3946,18741,16879,1862,16879,6759,10120,2018-01-01,zipcode,Orlando
ZCTA5 32836,12,20154,91060,1273,427700,16253,5929,14450,610,1798,3802,5303,2937,8511,7145,1366,7145,4758,2387,2018-01-01,zipcode,Orlando
ZCTA5 32837,12,54051,60460,1379,222100,42490,13262,36234,3465,8549,11530,8667,4023,20281,17084,3197,17084,9648,7436,2018-01-01,zipcode,Orlando
ZCTA5 32839,12,52371,36011,1033,126700,41773,13909,34613,6809,10634,10544,5210,1416,22728,18160,4568,18160,4044,14116,2018-01-01,zipcode,Orlando
ZCTA5 32901,12,24772,37225,918,134200,22232,11570,17913,1844,5450,5790,2832,1997,12933,10722,2211,10722,5035,5687,2018-01-01,zipcode,Melbourne
ZCTA5 32903,12,14090,79870,1248,329400,11931,4945,10980,285,1835,3280,3346,2234,6954,6012,942,6012,4881,1131,2018-01-01,zipcode,Indialantic
ZCTA5 32904,12,31206,65074,1257,199500,25390,11609,22421,1733,6248,7357,4029,3054,13218,11824,1394,11824,9265,2559,2018-01-01,zipcode,Melbourne
ZCTA5 32905,12,23395,37746,930,111100,19557,8850,16425,2067,5411,5511,2364,1072,11548,9508,2040,9508,4986,4522,2018-01-01,zipcode,Palm bay
ZCTA5 32907,12,44097,49769,1125,141000,36157,16323,30741,3283,10635,11266,4115,1442,16701,14883,1818,14883,11669,3214,2018-01-01,zipcode,Palm bay
ZCTA5 32908,12,13001,57313,1267,147800,9765,3883,8369,829,3195,2813,1118,414,4133,3996,137,3996,3237,759,2018-01-01,zipcode,Palm bay
ZCTA5 32909,12,30798,50285,1004,147800,24356,10186,21440,2144,7692,7546,2557,1501,12071,10760,1311,10760,8493,2267,2018-01-01,zipcode,Palm bay
ZCTA5 32920,12,10181,46806,864,228800,9361,4772,8781,450,2273,3202,1659,1197,8866,5380,3486,5380,3206,2174,2018-01-01,zipcode,Cape canaveral
ZCTA5 32922,12,15741,29066,746,88800,11991,5498,9930,2002,3358,3162,950,458,7613,5925,1688,5925,2308,3617,2018-01-01,zipcode,Cocoa
ZCTA5 32925,12,1506,49758,1417,-666666666,1116,406,829,49,123,354,210,93,492,440,52,440,0,440,2018-01-01,zipcode,Patrick afb
ZCTA5 32926,12,22350,50015,970,145500,19035,8873,16868,1989,5200,6143,2467,1069,9975,8365,1610,8365,6472,1893,2018-01-01,zipcode,Cocoa
ZCTA5 32927,12,26687,60761,1027,134100,21761,8273,19124,1852,6570,7061,2384,1257,11436,9401,2035,9401,8045,1356,2018-01-01,zipcode,Cocoa
ZCTA5 32931,12,14118,60494,1135,313800,12824,6947,11787,435,2616,3606,3091,2039,10931,7155,3776,7155,4763,2392,2018-01-01,zipcode,Cocoa beach
ZCTA5 32934,12,18761,66163,1377,225100,15956,7434,14078,869,3264,4837,2839,2269,7658,7132,526,7132,6093,1039,2018-01-01,zipcode,Melbourne
ZCTA5 32935,12,41550,47344,968,141400,34673,13860,30730,2908,10021,11070,4274,2457,19504,17006,2498,17006,10064,6942,2018-01-01,zipcode,Melbourne
ZCTA5 32937,12,27126,69642,1209,274200,22871,9911,20480,581,4355,6138,5564,3842,13502,11349,2153,11349,8608,2741,2018-01-01,zipcode,Satellite beach
ZCTA5 32940,12,39396,71198,1381,262000,33495,16240,29410,1090,5266,9421,7620,6013,17551,15694,1857,15694,12890,2804,2018-01-01,zipcode,Melbourne
ZCTA5 32948,12,7908,39683,744,150700,5825,2679,4493,1610,1269,1026,539,49,2180,1776,404,1776,1282,494,2018-01-01,zipcode,Fellsmere
ZCTA5 32949,12,2629,65227,1114,311500,2105,851,1944,88,572,839,238,207,1209,956,253,956,910,46,2018-01-01,zipcode,Grant
ZCTA5 32950,12,4222,67716,886,258900,3701,1553,3307,109,966,1133,754,345,1798,1683,115,1683,1562,121,2018-01-01,zipcode,Malabar
ZCTA5 32951,12,12029,71091,1535,329700,10697,6023,10147,379,2104,2891,2710,2063,7218,5310,1908,5310,4442,868,2018-01-01,zipcode,Melbourne beach
ZCTA5 32952,12,20732,73469,1114,270300,17598,7459,15539,668,3567,5144,3726,2434,9808,8432,1376,8432,6902,1530,2018-01-01,zipcode,Merritt island
ZCTA5 32953,12,24181,57281,955,245300,20389,8793,17933,1410,4696,5847,3967,2013,11475,9861,1614,9861,7247,2614,2018-01-01,zipcode,Merritt island
ZCTA5 32955,12,39127,68946,1224,207700,32192,13257,29065,1712,7376,10062,6130,3785,17722,15167,2555,15167,11475,3692,2018-01-01,zipcode,Rockledge
ZCTA5 32958,12,27676,50752,995,171100,24125,13726,22098,2066,8310,6900,3018,1804,13611,10839,2772,10839,8930,1909,2018-01-01,zipcode,Sebastian
ZCTA5 32960,12,20960,38133,864,158100,17805,8183,15579,1705,5382,5048,2245,1199,11414,8364,3050,8364,4742,3622,2018-01-01,zipcode,Vero beach
ZCTA5 32962,12,26469,47643,968,135400,21867,10017,19785,3229,5327,7452,2594,1183,12931,9025,3906,9025,7283,1742,2018-01-01,zipcode,Vero beach
ZCTA5 32963,12,14790,110471,1518,609500,14044,9376,13481,468,1122,2987,4642,4262,12303,7181,5122,7181,6653,528,2018-01-01,zipcode,Vero beach
ZCTA5 32966,12,17868,46464,1037,123100,15992,9670,14946,1168,4876,4699,2546,1657,10914,7934,2980,7934,5872,2062,2018-01-01,zipcode,Vero beach
ZCTA5 32967,12,21111,49613,965,204200,16841,7914,14876,2164,5008,3923,2171,1610,10456,7604,2852,7604,5723,1881,2018-01-01,zipcode,Vero beach
ZCTA5 32968,12,14015,78349,1287,253800,11662,5184,10196,624,2943,3398,2223,1008,5291,4615,676,4615,4288,327,2018-01-01,zipcode,Vero beach
ZCTA5 32970,12,204,13488,-666666666,59500,204,204,204,0,173,0,15,16,160,82,78,82,82,0,2018-01-01,zipcode,Wabasso
ZCTA5 32976,12,9001,36049,842,84900,8469,6122,8223,836,3471,2741,784,391,6713,4662,2051,4662,4133,529,2018-01-01,zipcode,Sebastian
ZCTA5 33001,12,323,44338,2175,322600,319,172,313,34,152,68,51,8,730,201,529,201,134,67,2018-01-01,zipcode,Long key
ZCTA5 33004,12,16812,44137,1248,190900,13814,4851,12393,1275,3715,4232,2141,1030,8370,6561,1809,6561,3121,3440,2018-01-01,zipcode,Dania
ZCTA5 33009,12,41276,37794,1190,202700,34753,13671,31081,4780,8297,8687,5583,3734,29937,18421,11516,18421,9570,8851,2018-01-01,zipcode,Hallandale
ZCTA5 33010,12,47231,27116,981,213800,40572,18000,36240,12481,12714,6544,3406,1095,15765,15108,657,15108,4680,10428,2018-01-01,zipcode,Hialeah
ZCTA5 33012,12,75666,32241,1105,206400,64872,28420,57737,16501,19166,13217,6580,2273,24936,23929,1007,23929,11160,12769,2018-01-01,zipcode,Hialeah
ZCTA5 33013,12,32980,32461,1102,220900,28617,12598,25895,8595,9729,4496,2257,818,9965,9543,422,9543,5454,4089,2018-01-01,zipcode,Hialeah
ZCTA5 33014,12,41316,38846,1236,243400,34282,14021,30386,6966,9074,7341,4567,2438,14942,14119,823,14119,6094,8025,2018-01-01,zipcode,Hialeah
ZCTA5 33015,12,66272,50426,1347,241300,53393,17647,45035,6555,13700,14301,6993,3486,22384,21075,1309,21075,10986,10089,2018-01-01,zipcode,Hialeah
ZCTA5 33016,12,51003,44330,1328,199400,41968,15056,35910,7886,12035,8497,5366,2126,15446,14948,498,14948,8180,6768,2018-01-01,zipcode,Hialeah
ZCTA5 33018,12,52526,60063,1592,249400,43107,13403,37090,7211,11939,9531,5853,2556,14516,14004,512,14004,10279,3725,2018-01-01,zipcode,Hialeah
ZCTA5 33019,12,14933,80727,1582,427400,12950,5541,12069,575,1863,3484,3278,2869,12568,6880,5688,6880,5076,1804,2018-01-01,zipcode,Hollywood
ZCTA5 33020,12,44578,41641,1050,196100,37090,10735,32719,4799,10426,9864,5156,2474,21803,18546,3257,18546,6143,12403,2018-01-01,zipcode,Hollywood
ZCTA5 33021,12,49350,57926,1303,254600,40328,14720,35224,4299,9187,11392,6076,4270,21386,18255,3131,18255,11829,6426,2018-01-01,zipcode,Hollywood
ZCTA5 33023,12,73671,50406,1235,187200,57989,18582,48438,8177,16266,16682,4977,2336,22025,20500,1525,20500,13523,6977,2018-01-01,zipcode,Hollywood
ZCTA5 33024,12,75306,58893,1327,220100,59584,17965,50541,6630,16642,15238,8017,4014,26011,23426,2585,23426,15739,7687,2018-01-01,zipcode,Hollywood
ZCTA5 33025,12,71763,57219,1405,215500,57489,18060,49794,3114,14767,19066,7925,4922,28017,24198,3819,24198,11355,12843,2018-01-01,zipcode,Hollywood
ZCTA5 33026,12,31045,74362,1668,251100,25601,8236,22266,1407,4724,7323,5331,3481,12070,11307,763,11307,9253,2054,2018-01-01,zipcode,Hollywood
ZCTA5 33027,12,60191,63227,1456,307000,49898,21011,44106,2802,11475,14394,8783,6652,24134,21138,2996,21138,16783,4355,2018-01-01,zipcode,Hollywood
ZCTA5 33028,12,27235,103811,1961,373600,21959,6357,18371,843,3166,5835,5248,3279,9003,8054,949,8054,6149,1905,2018-01-01,zipcode,Pembroke pines
ZCTA5 33029,12,47895,107109,2612,379100,37804,12932,30529,1792,6744,9390,7854,4749,14105,12773,1332,12773,11261,1512,2018-01-01,zipcode,Hollywood
ZCTA5 33030,12,35701,37576,1039,195100,26022,9339,21617,8340,6269,4586,1492,930,9678,9011,667,9011,3431,5580,2018-01-01,zipcode,Homestead
ZCTA5 33031,12,7387,73193,1299,381900,5655,1695,4938,1026,1683,1296,462,471,2052,1925,127,1925,1652,273,2018-01-01,zipcode,Homestead
ZCTA5 33032,12,47067,48341,1204,221100,34966,11244,27962,5841,8126,7796,4466,1733,13255,12314,941,12314,6714,5600,2018-01-01,zipcode,Homestead
ZCTA5 33033,12,58224,45782,1252,197000,42367,15594,35001,8826,9398,9648,4850,2279,16622,15375,1247,15375,8391,6984,2018-01-01,zipcode,Homestead
ZCTA5 33034,12,23281,36363,1058,113200,16419,8130,14194,5959,3842,3418,738,237,5673,4894,779,4894,1810,3084,2018-01-01,zipcode,Homestead
ZCTA5 33035,12,15658,51207,1455,167700,11478,3015,9472,1357,2764,2883,1453,1015,5177,4390,787,4390,1830,2560,2018-01-01,zipcode,Homestead
ZCTA5 33036,12,3274,76080,1397,635100,3090,1316,2832,87,799,900,712,334,3578,1519,2059,1519,1245,274,2018-01-01,zipcode,Islamorada
ZCTA5 33037,12,10955,63979,1443,422100,9515,4252,8974,845,2338,2857,1603,1331,10689,4630,6059,4630,3484,1146,2018-01-01,zipcode,Key largo
ZCTA5 33039,12,356,75046,-666666666,236700,345,52,273,71,128,74,0,0,106,106,0,106,106,0,2018-01-01,zipcode,Homestead
ZCTA5 33040,12,34784,67740,1739,499000,29527,8463,25905,2482,6924,7882,5230,3387,17812,13160,4652,13160,5853,7307,2018-01-01,zipcode,Key west
ZCTA5 33042,12,6524,83530,1822,486900,5900,2356,5636,299,1376,1672,1496,793,4937,3002,1935,3002,2275,727,2018-01-01,zipcode,Summerland key
ZCTA5 33043,12,4928,58479,1675,368100,4279,1667,3998,319,1109,1336,845,389,2937,2023,914,2023,1531,492,2018-01-01,zipcode,Big pine key
ZCTA5 33050,12,9433,55846,1319,403700,8332,3064,7194,692,2336,2211,1328,627,6784,3910,2874,3910,2230,1680,2018-01-01,zipcode,Marathon
ZCTA5 33051,12,569,90625,1313,566800,569,257,569,30,176,125,150,88,1421,349,1072,349,223,126,2018-01-01,zipcode,Key colony beach
ZCTA5 33054,12,32035,24597,857,141400,24801,12131,19976,5462,8752,3734,1663,365,10155,9072,1083,9072,4247,4825,2018-01-01,zipcode,Opa locka
ZCTA5 33055,12,43405,43373,1315,179200,35129,14836,29968,6666,11982,6803,2979,1538,11999,11368,631,11368,8591,2777,2018-01-01,zipcode,Opa locka
ZCTA5 33056,12,36409,40985,1182,164700,28489,11261,23604,4591,8507,7256,2208,1042,10701,9860,841,9860,6224,3636,2018-01-01,zipcode,Miami gardens
ZCTA5 33060,12,37168,43924,1106,238000,29358,11305,25587,5230,8059,7243,3040,2015,14714,12867,1847,12867,5557,7310,2018-01-01,zipcode,Pompano beach
ZCTA5 33062,12,22014,62162,1336,342100,20403,10511,19786,1358,4438,5557,4963,3470,21346,12053,9293,12053,8637,3416,2018-01-01,zipcode,Pompano beach
ZCTA5 33063,12,54937,45964,1387,166400,46633,16361,42107,5205,15042,12484,6741,2635,26343,22261,4082,22261,15313,6948,2018-01-01,zipcode,Pompano beach
ZCTA5 33064,12,61397,49984,1258,172700,48567,15765,42515,8140,14735,10031,7052,2557,24179,20480,3699,20480,13071,7409,2018-01-01,zipcode,Pompano beach
ZCTA5 33065,12,57399,54621,1312,260800,44074,12894,36637,3945,10104,12087,7301,3200,19684,17886,1798,17886,8908,8978,2018-01-01,zipcode,Coral springs
ZCTA5 33066,12,16786,47605,1193,122000,15306,7973,14193,1078,4083,4377,2686,1969,11002,8673,2329,8673,7082,1591,2018-01-01,zipcode,Pompano beach
ZCTA5 33067,12,27784,98750,1641,434400,21728,5908,18345,559,3123,5278,5278,4107,9430,8714,716,8714,6125,2589,2018-01-01,zipcode,Pompano beach
ZCTA5 33068,12,51617,44857,1366,165800,40102,10434,33638,5049,13418,9693,3482,1996,18189,16131,2058,16131,9313,6818,2018-01-01,zipcode,Pompano beach
ZCTA5 33069,12,27612,47279,1274,154000,23879,11126,20780,3121,6430,5662,3738,1829,14426,10453,3973,10453,5144,5309,2018-01-01,zipcode,Pompano beach
ZCTA5 33070,12,5518,68375,1631,487300,4693,1866,4162,392,1064,1245,970,491,4522,2175,2347,2175,1487,688,2018-01-01,zipcode,Tavernier
ZCTA5 33071,12,39839,89440,1525,353900,31400,9224,26773,1460,5136,8598,7482,4097,13472,12879,593,12879,8209,4670,2018-01-01,zipcode,Coral springs
ZCTA5 33073,12,34652,75640,1694,304200,26559,7039,22077,1277,6250,6828,5733,1989,12342,11338,1004,11338,6384,4954,2018-01-01,zipcode,Pompano beach
ZCTA5 33076,12,36600,124303,2344,481700,27425,8996,23161,850,3521,5458,7956,5376,12289,11501,788,11501,9192,2309,2018-01-01,zipcode,Pompano beach
ZCTA5 33101,12,0,-666666666,-666666666,-666666666,0,0,0,0,0,0,0,0,0,0,0,0,0,0,2018-01-01,zipcode,Miami
ZCTA5 33109,12,475,223618,-666666666,2000001,475,296,475,0,55,20,222,178,961,273,688,273,232,41,2018-01-01,zipcode,Miami beach
ZCTA5 33122,12,109,-666666666,2174,-666666666,81,37,69,0,11,11,35,12,47,47,0,47,0,47,2018-01-01,zipcode,Miami
ZCTA5 33125,12,61492,27518,1004,214400,52425,23382,46307,15145,17281,7578,4705,1598,22576,20893,1683,20893,5212,15681,2018-01-01,zipcode,Miami
ZCTA5 33126,12,52987,35319,1228,185000,45530,17162,40257,8166,13594,9163,6860,2474,19590,18026,1564,18026,6140,11886,2018-01-01,zipcode,Miami
ZCTA5 33127,12,33464,30231,961,183900,26451,11009,22679,6572,7930,4815,2293,1069,11414,10096,1318,10096,2828,7268,2018-01-01,zipcode,Miami
ZCTA5 33128,12,7585,18920,773,180100,6404,2750,5768,2473,1891,847,441,116,3456,3113,343,3113,169,2944,2018-01-01,zipcode,Miami
ZCTA5 33129,12,13128,82143,1829,488800,11260,3082,10205,551,1016,1444,3703,3491,8447,6210,2237,6210,3018,3192,2018-01-01,zipcode,Miami
ZCTA5 33130,12,27818,30618,1096,288000,24055,8601,21407,5202,5364,3743,3926,3172,16246,12767,3479,12767,1939,10828,2018-01-01,zipcode,Miami
ZCTA5 33131,12,16715,88917,2252,473700,14842,3419,13700,234,977,1900,5164,5425,15495,9417,6078,9417,3035,6382,2018-01-01,zipcode,Miami
ZCTA5 33132,12,12895,77779,1964,483100,12088,4330,10835,984,1434,2072,3570,2775,9223,6389,2834,6389,1668,4721,2018-01-01,zipcode,Miami
ZCTA5 33133,12,34460,63992,1434,628600,28193,10209,25845,2320,5574,5194,6632,6125,16969,13628,3341,13628,6466,7162,2018-01-01,zipcode,Miami
ZCTA5 33134,12,41861,67818,1376,475700,35905,12504,32648,3343,6173,7181,8583,7368,18720,16304,2416,16304,8650,7654,2018-01-01,zipcode,Miami
ZCTA5 33135,12,39789,27172,998,262300,33829,14019,30028,8979,11317,4687,3540,1505,15573,14517,1056,14517,2854,11663,2018-01-01,zipcode,Miami
ZCTA5 33136,12,14839,24702,824,173700,12313,4632,10641,2544,3643,2539,1374,541,6961,5830,1131,5830,791,5039,2018-01-01,zipcode,Miami
ZCTA5 33137,12,23965,60259,1616,339900,20897,5667,18623,2284,3557,4683,5125,2974,12263,10039,2224,10039,2659,7380,2018-01-01,zipcode,Miami
ZCTA5 33138,12,29867,47604,949,415700,24624,7910,22178,3736,4428,5590,5134,3290,13956,12447,1509,12447,5689,6758,2018-01-01,zipcode,Miami
ZCTA5 33139,12,38606,52278,1426,398800,34243,9489,32026,2988,5350,7006,9374,7308,33000,20882,12118,20882,7237,13645,2018-01-01,zipcode,Miami beach
ZCTA5 33140,12,21807,79804,1632,621200,17886,7007,16390,1414,2172,3551,4742,4511,17812,9181,8631,9181,5342,3839,2018-01-01,zipcode,Miami beach
ZCTA5 33141,12,40005,48096,1273,323600,34823,9651,31369,3708,7882,8170,6550,5059,23519,17739,5780,17739,5391,12348,2018-01-01,zipcode,Miami beach
ZCTA5 33142,12,58574,24106,901,156800,45910,20505,39130,12864,13727,8101,3195,1243,21156,18983,2173,18983,5000,13983,2018-01-01,zipcode,Miami
ZCTA5 33143,12,32197,67170,1321,563400,26567,8732,23489,1294,3803,5970,6860,5562,13799,12274,1525,12274,6599,5675,2018-01-01,zipcode,Miami
ZCTA5 33144,12,30235,44611,1320,281200,26525,10284,24196,5172,7597,6014,3739,1674,9480,9175,305,9175,5362,3813,2018-01-01,zipcode,Miami
ZCTA5 33145,12,31465,51181,1413,340200,27289,9506,24520,4194,7097,5237,4507,3485,12803,11555,1248,11555,5664,5891,2018-01-01,zipcode,Miami
ZCTA5 33146,12,16156,121319,2179,868300,13667,6412,7960,329,609,1428,2504,3090,4920,4077,843,4077,3083,994,2018-01-01,zipcode,Miami
ZCTA5 33147,12,47834,30632,1007,139800,37404,16321,31773,9151,12177,7009,2172,1264,15808,14189,1619,14189,6520,7669,2018-01-01,zipcode,Miami
ZCTA5 33149,12,13054,133958,2448,1218200,9781,3965,8502,129,663,1458,3260,2992,7340,4367,2973,4367,3105,1262,2018-01-01,zipcode,Key biscayne
ZCTA5 33150,12,29839,28069,864,174200,22721,9049,19195,5428,6507,4623,1676,961,10858,9733,1125,9733,2934,6799,2018-01-01,zipcode,Miami
ZCTA5 33154,12,14790,74212,1805,592500,11540,4674,10450,443,1322,2835,3289,2561,10776,6272,4504,6272,3428,2844,2018-01-01,zipcode,Miami beach
ZCTA5 33155,12,47450,63653,1447,335900,40248,14919,35562,5186,9602,9190,7246,4338,15483,14518,965,14518,10378,4140,2018-01-01,zipcode,Miami
ZCTA5 33156,12,34167,112373,1664,812100,27533,10467,23180,1191,3256,4709,7127,6897,12726,10991,1735,10991,7800,3191,2018-01-01,zipcode,Miami
ZCTA5 33157,12,68402,63943,1150,287900,53250,19472,45202,6525,13109,11761,9191,4616,20958,19426,1532,19426,13023,6403,2018-01-01,zipcode,Miami
ZCTA5 33158,12,6641,159914,2338,667000,5121,1864,4414,117,435,644,1329,1889,2285,2110,175,2110,1976,134,2018-01-01,zipcode,Miami
ZCTA5 33160,12,41113,52170,1503,296300,35605,15036,32746,2083,5035,10890,8372,6366,36461,19617,16844,19617,10704,8913,2018-01-01,zipcode,North miami beach
ZCTA5 33161,12,55663,36618,1076,213800,43542,15247,36364,9030,10477,9707,4986,2164,17931,15904,2027,15904,6162,9742,2018-01-01,zipcode,Miami
ZCTA5 33162,12,48185,42643,1110,182800,38187,13169,31727,7106,9330,9747,3973,1571,14727,12927,1800,12927,6959,5968,2018-01-01,zipcode,Miami
ZCTA5 33165,12,56133,50758,1378,287900,47922,19147,41733,8153,13880,8841,7227,3632,16902,16079,823,16079,10768,5311,2018-01-01,zipcode,Miami
ZCTA5 33166,12,24830,53717,1261,341600,21116,8205,18573,2721,4855,5111,3700,2186,9325,7908,1417,7908,3773,4135,2018-01-01,zipcode,Miami
ZCTA5 33167,12,19837,36870,1108,172700,16139,6387,13364,3508,4525,3606,1252,473,5994,5706,288,5706,3093,2613,2018-01-01,zipcode,Miami
ZCTA5 33168,12,29072,45395,1299,171800,23710,9017,19545,5203,7033,4853,1744,712,7159,6701,458,6701,4740,1961,2018-01-01,zipcode,Miami
ZCTA5 33169,12,41525,43331,1142,181700,32112,11795,26976,5081,8656,8286,3403,1550,13292,11777,1515,11777,6180,5597,2018-01-01,zipcode,Miami
ZCTA5 33170,12,13748,42946,1011,253000,10370,4486,8897,1820,3096,2270,1339,372,4070,3823,247,3823,2247,1576,2018-01-01,zipcode,Miami
ZCTA5 33172,12,43083,46983,1462,158700,36005,12621,31902,5144,9200,8140,6183,3235,15660,13687,1973,13687,6076,7611,2018-01-01,zipcode,Miami
ZCTA5 33173,12,32307,69414,1466,307000,26905,10279,23678,2479,5060,6550,6044,3545,11971,10977,994,10977,7733,3244,2018-01-01,zipcode,Miami
ZCTA5 33174,12,34015,46613,1264,253700,29755,12446,24160,6504,6003,5058,4586,2009,10193,9667,526,9667,5582,4085,2018-01-01,zipcode,Miami
ZCTA5 33175,12,55334,55304,1556,281400,47926,19439,41890,7239,13478,10155,7543,3475,16272,15655,617,15655,11703,3952,2018-01-01,zipcode,Miami
ZCTA5 33176,12,52461,70572,1371,376700,43599,15111,38040,3439,8613,11098,8807,6083,18793,17152,1641,17152,11638,5514,2018-01-01,zipcode,Miami
ZCTA5 33177,12,58129,58912,1425,236600,48231,19079,39873,6897,13898,10636,6220,2222,15240,14600,640,14600,10529,4071,2018-01-01,zipcode,Miami
ZCTA5 33178,12,51459,80554,2028,373800,38581,12078,32753,1624,5289,8534,10832,6474,19615,14891,4724,14891,7767,7124,2018-01-01,zipcode,Miami
ZCTA5 33179,12,45243,48456,1228,154600,37175,12566,32041,3842,8499,10358,5801,3541,18131,15886,2245,15886,9501,6385,2018-01-01,zipcode,Miami
ZCTA5 33180,12,31883,70014,1868,377700,27387,11295,25096,1163,3083,7421,7864,5565,23901,14729,9172,14729,9816,4913,2018-01-01,zipcode,Miami
ZCTA5 33181,12,19986,46038,1192,247100,16756,5886,14184,1809,3699,4107,3012,1557,9055,7435,1620,7435,2832,4603,2018-01-01,zipcode,Miami
ZCTA5 33182,12,17379,73785,1786,315700,15020,7863,12824,2889,3424,3011,2569,931,3891,3769,122,3769,3305,464,2018-01-01,zipcode,Miami
ZCTA5 33183,12,37504,56400,1440,233800,31007,11078,26572,3152,7120,8878,4863,2559,12214,11630,584,11630,7370,4260,2018-01-01,zipcode,Miami
ZCTA5 33184,12,21733,50569,1443,238600,19050,8068,16745,4753,4378,3220,3459,935,6371,6104,267,6104,4612,1492,2018-01-01,zipcode,Miami
ZCTA5 33185,12,30959,87438,2205,348900,25236,8632,21163,2534,4983,5490,5754,2402,8226,7954,272,7954,6758,1196,2018-01-01,zipcode,Miami
ZCTA5 33186,12,70614,69823,1676,278900,57677,20086,49778,3684,11505,17921,11052,5616,22986,21383,1603,21383,14387,6996,2018-01-01,zipcode,Miami
ZCTA5 33187,12,19286,75543,1955,329300,15771,5246,13565,2269,3243,3999,2852,1202,5417,5127,290,5127,4576,551,2018-01-01,zipcode,Miami
ZCTA5 33189,12,26937,54834,1158,244400,21057,6927,18300,2507,5811,5414,3294,1274,8591,7943,648,7943,4677,3266,2018-01-01,zipcode,Miami
ZCTA5 33190,12,16305,59057,1304,246000,12104,3428,10105,1085,2080,3554,2478,908,4846,4608,238,4608,1917,2691,2018-01-01,zipcode,Miami
ZCTA5 33193,12,51378,58004,1459,260100,42418,15209,35229,6637,8922,8624,8682,2364,14912,14402,510,14402,9102,5300,2018-01-01,zipcode,Miami
ZCTA5 33194,12,8485,112730,1818,345400,6880,3594,5690,1143,1384,1621,990,552,1563,1563,0,1563,1274,289,2018-01-01,zipcode,Miami
ZCTA5 33196,12,51752,73853,1804,300500,41532,14003,35044,3377,7622,11760,8714,3571,14962,13948,1014,13948,9254,4694,2018-01-01,zipcode,Miami
ZCTA5 33301,12,15062,90497,1965,570700,13792,4375,12631,589,1486,2850,4337,3369,10780,7675,3105,7675,3687,3988,2018-01-01,zipcode,Fort lauderdale
ZCTA5 33304,12,18771,54749,1225,395000,16356,4638,15136,962,2913,4163,4384,2714,12961,9329,3632,9329,3418,5911,2018-01-01,zipcode,Fort lauderdale
ZCTA5 33305,12,12425,67665,1348,395800,11398,3682,10835,383,1908,2615,3998,1931,8087,6466,1621,6466,3988,2478,2018-01-01,zipcode,Fort lauderdale
ZCTA5 33306,12,3378,64125,1044,479300,2980,919,2838,67,366,890,833,682,2205,1752,453,1752,1113,639,2018-01-01,zipcode,Fort lauderdale
ZCTA5 33308,12,27951,62768,1340,377700,25518,11434,24215,1250,5118,5904,6877,5066,23510,15485,8025,15485,10612,4873,2018-01-01,zipcode,Fort lauderdale
ZCTA5 33309,12,40926,54639,1239,170500,32725,9459,29226,4862,9553,7839,4649,2323,14080,12974,1106,12974,7870,5104,2018-01-01,zipcode,Fort lauderdale
ZCTA5 33311,12,73034,35075,1085,140600,54964,22109,46269,11936,16787,12211,3445,1890,26095,22430,3665,22430,9141,13289,2018-01-01,zipcode,Fort lauderdale
ZCTA5 33312,12,53552,54918,1259,239500,42858,14056,37341,5128,10486,11003,7062,3662,20886,17769,3117,17769,10070,7699,2018-01-01,zipcode,Fort lauderdale
ZCTA5 33313,12,62405,36410,1122,117800,48220,16779,39627,7788,14777,11322,3586,2154,23567,19653,3914,19653,8287,11366,2018-01-01,zipcode,Fort lauderdale
ZCTA5 33314,12,26188,44785,1322,165300,21395,7375,17429,2533,5923,4508,3500,965,9899,8768,1131,8768,3802,4966,2018-01-01,zipcode,Fort lauderdale
ZCTA5 33315,12,13362,61890,1361,289300,11856,3451,10919,1224,2877,3044,2510,1264,6937,6029,908,6029,3206,2823,2018-01-01,zipcode,Fort lauderdale
ZCTA5 33316,12,9801,57862,1110,560000,9002,3868,8380,804,1387,2050,2505,1634,7919,5077,2842,5077,3132,1945,2018-01-01,zipcode,Fort lauderdale
ZCTA5 33317,12,38360,65934,1290,285500,30375,10195,26713,3334,7041,7220,6088,3030,13309,12456,853,12456,9268,3188,2018-01-01,zipcode,Fort lauderdale
ZCTA5 33319,12,47021,45531,1218,120500,38591,13389,33600,5127,10743,9976,5158,2596,23167,18181,4986,18181,11711,6470,2018-01-01,zipcode,Fort lauderdale
ZCTA5 33321,12,47974,48986,1396,162600,40724,16372,36449,3721,10968,11261,6661,3838,22254,19836,2418,19836,14496,5340,2018-01-01,zipcode,Fort lauderdale
ZCTA5 33322,12,39049,49681,1632,151900,33801,14038,30558,3140,7923,9535,6204,3756,19792,16111,3681,16111,12957,3154,2018-01-01,zipcode,Fort lauderdale
ZCTA5 33323,12,21195,87667,1936,302000,17200,4718,14749,1106,2903,5004,3705,2031,8195,7038,1157,7038,4929,2109,2018-01-01,zipcode,Fort lauderdale
ZCTA5 33324,12,48807,65297,1609,219000,40093,12005,35637,1710,7279,10814,9350,6484,22393,19217,3176,19217,10707,8510,2018-01-01,zipcode,Fort lauderdale
ZCTA5 33325,12,28987,78367,1618,301400,23313,7269,19939,1536,5371,5644,4637,2751,10514,9099,1415,9099,6974,2125,2018-01-01,zipcode,Fort lauderdale
ZCTA5 33326,12,32946,84910,1827,355900,25993,8584,22703,1098,3767,5943,7077,4818,13723,10847,2876,10847,7422,3425,2018-01-01,zipcode,Fort lauderdale
ZCTA5 33327,12,23762,106414,2617,528800,16539,6516,13585,392,1589,2846,5178,3580,7044,6609,435,6609,5210,1399,2018-01-01,zipcode,Fort lauderdale
ZCTA5 33328,12,28782,85858,1514,341300,23216,7605,19417,1111,4209,5750,4989,3358,10756,10166,590,10166,7828,2338,2018-01-01,zipcode,Fort lauderdale
ZCTA5 33330,12,15226,122204,2657,506800,12477,4220,10072,544,1768,2905,2646,2209,4854,4612,242,4612,4218,394,2018-01-01,zipcode,Fort lauderdale
ZCTA5 33331,12,25854,119518,2332,473400,19977,6228,16953,738,2240,4308,5412,4255,8205,7578,627,7578,6484,1094,2018-01-01,zipcode,Fort lauderdale
ZCTA5 33332,12,11518,127708,2362,598100,9153,3006,7290,308,1026,1688,2160,2108,3598,3210,388,3210,2870,340,2018-01-01,zipcode,Fort lauderdale
ZCTA5 33334,12,29478,51241,1125,261600,25257,6828,22785,3574,6133,6371,4393,2314,13804,12280,1524,12280,6635,5645,2018-01-01,zipcode,Fort lauderdale
ZCTA5 33351,12,35581,58962,1457,203800,27989,8483,23650,2726,6416,7749,5089,1670,12554,11425,1129,11425,6077,5348,2018-01-01,zipcode,Fort lauderdale
ZCTA5 33401,12,28287,48767,1223,228100,24048,9022,19805,2616,4451,5344,4551,2843,16179,11588,4591,11588,4482,7106,2018-01-01,zipcode,West palm beach
ZCTA5 33403,12,12558,50320,1185,172400,10049,3022,8631,1732,2305,2478,1505,611,5097,4236,861,4236,1905,2331,2018-01-01,zipcode,West palm beach
ZCTA5 33404,12,28717,42044,1091,147900,22453,9286,19426,3035,6563,5219,2847,1762,15275,10002,5273,10002,5460,4542,2018-01-01,zipcode,West palm beach
ZCTA5 33405,12,20537,49770,1139,262000,16906,5665,15084,3179,4238,3393,2550,1724,8078,7021,1057,7021,4070,2951,2018-01-01,zipcode,West palm beach
ZCTA5 33406,12,26858,60142,1246,185300,21873,7332,18514,2778,5993,5638,3054,1051,9414,8580,834,8580,5505,3075,2018-01-01,zipcode,West palm beach
ZCTA5 33407,12,30928,41085,1086,163600,24792,8143,21165,4432,6528,5383,3004,1818,13123,10719,2404,10719,4576,6143,2018-01-01,zipcode,West palm beach
ZCTA5 33408,12,18248,73890,1319,349600,16503,7589,15269,855,2909,4144,4566,2795,12770,9025,3745,9025,6986,2039,2018-01-01,zipcode,North palm beach
ZCTA5 33409,12,33875,49256,1204,154600,26688,8414,21847,3859,5649,6238,4307,1794,12966,11116,1850,11116,4788,6328,2018-01-01,zipcode,West palm beach
ZCTA5 33410,12,35597,69037,1516,296200,30728,11275,27885,2015,6021,8740,7389,3720,17325,14869,2456,14869,9785,5084,2018-01-01,zipcode,Palm beach gardens
ZCTA5 33411,12,71587,68507,1362,267700,57720,20601,50198,4828,13470,15383,10663,5854,28217,24028,4189,24028,17610,6418,2018-01-01,zipcode,West palm beach
ZCTA5 33412,12,14918,89052,1947,348000,12827,5136,11516,729,2939,3532,2666,1650,6291,5320,971,5320,4648,672,2018-01-01,zipcode,West palm beach
ZCTA5 33413,12,17473,60635,1439,232300,13468,4396,11281,1688,2895,3888,1794,1016,5671,5099,572,5099,3249,1850,2018-01-01,zipcode,West palm beach
ZCTA5 33414,12,61301,86034,1751,349700,47875,16260,41091,2328,8339,12572,11211,6641,23331,19617,3714,19617,14423,5194,2018-01-01,zipcode,Wellington
ZCTA5 33415,12,51582,42077,1129,114400,40534,13455,33828,7261,11619,9251,4309,1388,18970,16516,2454,16516,9280,7236,2018-01-01,zipcode,West palm beach
ZCTA5 33417,12,33287,36228,1099,71100,26946,10895,23789,4114,7720,6823,3815,1317,18796,14246,4550,14246,8261,5985,2018-01-01,zipcode,West palm beach
ZCTA5 33418,12,40225,90130,1693,381600,34570,14612,31973,1371,5394,8559,9424,7225,21415,16864,4551,16864,13338,3526,2018-01-01,zipcode,Palm beach gardens
ZCTA5 33426,12,23155,57983,1534,183300,19697,6836,17152,1546,5326,5708,3195,1377,11121,9361,1760,9361,5614,3747,2018-01-01,zipcode,Boynton beach
ZCTA5 33428,12,41189,67500,1604,270500,33386,11644,28441,2132,7225,8460,7194,3430,15463,13682,1781,13682,9804,3878,2018-01-01,zipcode,Boca raton
ZCTA5 33430,12,22603,24840,616,102000,16704,7663,13567,5419,4334,2699,825,290,8453,7249,1204,7249,2254,4995,2018-01-01,zipcode,Belle glade
ZCTA5 33431,12,20967,74614,1573,380400,18116,7477,13876,662,2301,3544,4286,3083,9652,7576,2076,7576,5235,2341,2018-01-01,zipcode,Boca raton
ZCTA5 33432,12,19578,72425,1583,586800,18233,7937,16258,831,3078,3969,4385,3995,15480,10269,5211,10269,6469,3800,2018-01-01,zipcode,Boca raton
ZCTA5 33433,12,39954,62710,1755,287600,33933,15848,30168,1122,6291,7807,8923,6025,23462,18180,5282,18180,12503,5677,2018-01-01,zipcode,Boca raton
ZCTA5 33434,12,20006,56760,1103,235000,17852,9701,16841,1095,3537,4096,4581,3532,13811,9694,4117,9694,8087,1607,2018-01-01,zipcode,Boca raton
ZCTA5 33435,12,36423,46283,1423,160400,30640,12080,26817,4738,7325,7926,4613,2215,18250,13441,4809,13441,7735,5706,2018-01-01,zipcode,Boynton beach
ZCTA5 33436,12,44249,55735,1419,220400,37064,15360,33403,3010,7912,10352,8421,3708,21537,17401,4136,17401,12600,4801,2018-01-01,zipcode,Boynton beach
ZCTA5 33437,12,38921,61472,1462,275400,35192,21834,33574,1717,8111,9612,7867,6267,21355,18402,2953,18402,15978,2424,2018-01-01,zipcode,Boynton beach
ZCTA5 33438,12,265,56500,-666666666,112500,256,72,211,0,155,22,34,0,148,84,64,84,78,6,2018-01-01,zipcode,Canal point
ZCTA5 33440,12,19878,37359,795,71600,15657,6323,12872,4405,4624,2828,724,291,7953,6467,1486,6467,4147,2320,2018-01-01,zipcode,Clewiston
ZCTA5 33441,12,27050,46098,1179,211900,22986,7483,20242,3245,6544,5626,3382,1445,13748,11029,2719,11029,5377,5652,2018-01-01,zipcode,Deerfield beach
ZCTA5 33442,12,28846,45781,1589,131400,24791,10959,22390,1424,7152,6937,4262,2615,19407,13692,5715,13692,9090,4602,2018-01-01,zipcode,Deerfield beach
ZCTA5 33444,12,23770,53352,1270,277200,19815,6459,17119,3825,4603,4557,2799,1335,9449,8257,1192,8257,4313,3944,2018-01-01,zipcode,Delray beach
ZCTA5 33445,12,32261,53929,1540,203500,27972,11250,24478,2692,5631,6709,5706,3740,16963,13655,3308,13655,8439,5216,2018-01-01,zipcode,Delray beach
ZCTA5 33446,12,24983,56361,1109,272800,22898,14739,22143,1292,5005,5907,5691,4248,17680,12932,4748,12932,11040,1892,2018-01-01,zipcode,Delray beach
ZCTA5 33449,12,11602,116269,1913,417400,9149,3694,7603,273,1045,1976,2329,1980,4397,3802,595,3802,3590,212,2018-01-01,zipcode,Lake worth
ZCTA5 33455,12,22415,54113,1050,250600,19549,9912,18000,1447,4736,5438,4116,2263,12089,9854,2235,9854,8112,1742,2018-01-01,zipcode,Hobe sound
ZCTA5 33458,12,56642,82555,1513,346900,45588,13782,40036,3095,7568,11180,11394,6799,23633,21197,2436,21197,15051,6146,2018-01-01,zipcode,Jupiter
ZCTA5 33460,12,32688,37863,1048,199400,26073,8476,22672,7321,6008,5244,2704,1395,13269,11310,1959,11310,4729,6581,2018-01-01,zipcode,Lake worth
ZCTA5 33461,12,46344,41081,1156,128400,36342,12372,30896,8249,9462,8499,3227,1459,17679,14912,2767,14912,7079,7833,2018-01-01,zipcode,Lake worth
ZCTA5 33462,12,33173,52165,1175,200200,27646,10005,24678,4046,7800,6749,3977,2106,15213,12124,3089,12124,7159,4965,2018-01-01,zipcode,Lake worth
ZCTA5 33463,12,62043,52352,1274,174800,47109,14286,39048,8791,9938,11143,6676,2500,21018,18184,2834,18184,12596,5588,2018-01-01,zipcode,Lake worth
ZCTA5 33467,12,53339,69644,1204,286700,44726,19142,39394,3211,9656,11772,8706,6049,23398,19875,3523,19875,17141,2734,2018-01-01,zipcode,Lake worth
ZCTA5 33469,12,15195,76662,1350,356800,13378,6334,12178,319,2233,3538,3846,2242,8835,6805,2030,6805,5823,982,2018-01-01,zipcode,Jupiter
ZCTA5 33470,12,26384,83668,1805,306600,21721,6922,18028,2629,5333,6153,2724,1189,8826,7881,945,7881,7105,776,2018-01-01,zipcode,Loxahatchee
ZCTA5 33471,12,7155,38690,709,67000,6226,4006,5431,1438,2154,1246,422,171,3209,2086,1123,2086,1563,523,2018-01-01,zipcode,Moore haven
ZCTA5 33472,12,20039,74700,2142,279400,17088,8758,15742,492,3523,4911,4073,2743,8953,7940,1013,7940,7247,693,2018-01-01,zipcode,Boynton beach
ZCTA5 33473,12,11300,137895,2848,564800,8404,3350,7540,54,1216,1622,2673,1975,4191,3540,651,3540,2998,542,2018-01-01,zipcode,Boynton beach
ZCTA5 33476,12,8618,21748,563,96100,6540,2915,5439,1965,1653,1312,396,113,3120,2735,385,2735,1048,1687,2018-01-01,zipcode,Pahokee
ZCTA5 33477,12,13710,74614,1614,385200,12972,7491,12495,368,2493,3285,3720,2629,12145,7356,4789,7356,6002,1354,2018-01-01,zipcode,Jupiter
ZCTA5 33478,12,13015,103333,1857,371700,10607,3551,9784,526,2232,3303,2388,1335,4776,4506,270,4506,4403,103,2018-01-01,zipcode,Jupiter
ZCTA5 33480,12,10027,110756,1668,943000,9505,6219,9359,236,745,2289,3241,2848,11592,5615,5977,5615,4804,811,2018-01-01,zipcode,Palm beach
ZCTA5 33483,12,11904,83592,1660,544700,11039,5160,10369,451,1526,2260,3745,2387,9025,6051,2974,6051,4203,1848,2018-01-01,zipcode,Delray beach
ZCTA5 33484,12,26146,41044,1304,137600,24782,15239,23586,1573,6613,7125,4847,3428,18687,14332,4355,14332,11098,3234,2018-01-01,zipcode,Delray beach
ZCTA5 33486,12,24146,78931,1441,399100,19754,7252,17487,631,3928,4295,5611,3022,10738,9097,1641,9097,7286,1811,2018-01-01,zipcode,Boca raton
ZCTA5 33487,12,20176,80947,1798,386700,17309,7569,16113,573,2287,4580,5284,3389,12645,9168,3477,9168,7179,1989,2018-01-01,zipcode,Boca raton
ZCTA5 33493,12,5543,35104,819,83400,4873,3997,4401,1860,1587,705,169,80,794,540,254,540,257,283,2018-01-01,zipcode,South bay
ZCTA5 33496,12,21825,86461,1779,370400,19029,10220,17316,672,2740,4046,5311,4547,11982,9701,2281,9701,8403,1298,2018-01-01,zipcode,Boca raton
ZCTA5 33498,12,14404,99514,2646,404500,11623,4611,10386,360,1762,2710,3228,2326,5497,5165,332,5165,4879,286,2018-01-01,zipcode,Boca raton
ZCTA5 33503,12,204,-666666666,-666666666,267900,204,74,126,80,9,37,0,0,50,50,0,50,45,5,2018-01-01,zipcode,Balm
ZCTA5 33510,12,28176,58631,1118,160000,22656,8489,19352,1408,6405,6412,3715,1412,11237,10310,927,10310,6175,4135,2018-01-01,zipcode,Brandon
ZCTA5 33511,12,57642,57868,1209,186600,46189,15094,40167,3038,9708,14302,8899,4220,23945,21972,1973,21972,10746,11226,2018-01-01,zipcode,Brandon
ZCTA5 33513,12,12303,37761,697,93300,10481,6555,8963,1753,3672,2590,643,305,5171,3819,1352,3819,3091,728,2018-01-01,zipcode,Bushnell
ZCTA5 33514,12,2350,39145,816,87100,1654,759,1419,412,452,437,44,74,804,690,114,690,406,284,2018-01-01,zipcode,Center hill
ZCTA5 33521,12,430,32143,628,65000,338,186,332,46,184,86,14,2,300,184,116,184,138,46,2018-01-01,zipcode,Coleman
ZCTA5 33523,12,18387,45839,786,113000,14666,6280,12128,2569,4529,3130,1197,703,7701,6371,1330,6371,4287,2084,2018-01-01,zipcode,Dade city
ZCTA5 33525,12,20449,52865,783,141600,17129,8683,14177,1837,4820,4498,2094,928,8674,7249,1425,7249,5252,1997,2018-01-01,zipcode,Dade city
ZCTA5 33527,12,14850,55841,889,220600,11689,4758,10033,2665,3173,2634,1119,442,5321,4753,568,4753,3521,1232,2018-01-01,zipcode,Dover
ZCTA5 33534,12,16487,49596,1024,165200,11947,4329,9803,2099,3177,2887,1152,488,5522,4942,580,4942,3193,1749,2018-01-01,zipcode,Gibsonton
ZCTA5 33538,12,4523,35849,780,85000,3851,2092,3506,746,1453,907,271,129,2866,1939,927,1939,1502,437,2018-01-01,zipcode,Lake panasoffkee
ZCTA5 33540,12,8737,35602,773,70900,7428,4137,6756,1123,2850,2004,578,201,5261,3846,1415,3846,2742,1104,2018-01-01,zipcode,Zephyrhills
ZCTA5 33541,12,19900,39334,954,69300,17463,11247,16304,2529,6591,5005,1410,769,12560,8868,3692,8868,6953,1915,2018-01-01,zipcode,Zephyrhills
ZCTA5 33542,12,21101,33956,815,69400,18093,10832,16425,2522,6367,5482,1412,642,13315,9792,3523,9792,6901,2891,2018-01-01,zipcode,Zephyrhills
ZCTA5 33543,12,26172,80443,1413,208200,20537,7240,17765,1071,3786,5777,4331,2800,10049,8944,1105,8944,7177,1767,2018-01-01,zipcode,Wesley chapel
ZCTA5 33544,12,27606,81115,1474,241200,20776,6266,17915,1582,3828,4945,4934,2626,9838,9304,534,9304,6572,2732,2018-01-01,zipcode,Wesley chapel
ZCTA5 33545,12,18522,77705,1510,198100,13832,3939,11694,691,2450,4458,2712,1383,6207,5814,393,5814,4294,1520,2018-01-01,zipcode,Wesley chapel
ZCTA5 33547,12,24813,103167,1772,316900,17442,5796,14972,798,2655,3548,4671,3300,8524,7916,608,7916,6556,1360,2018-01-01,zipcode,Lithia
ZCTA5 33548,12,7063,106182,1354,346500,5783,2177,5088,163,1010,1487,1543,885,2688,2545,143,2545,2262,283,2018-01-01,zipcode,Lutz
ZCTA5 33549,12,18015,71176,1047,220300,14859,5761,12996,782,3110,4428,2785,1891,7320,6858,462,6858,5278,1580,2018-01-01,zipcode,Lutz
ZCTA5 33556,12,22978,100456,1301,361800,18291,6874,16131,941,3307,4500,4441,2942,8936,7958,978,7958,7238,720,2018-01-01,zipcode,Odessa
ZCTA5 33558,12,22843,78391,1037,329300,17784,5972,15478,567,2903,4324,4914,2770,9516,8688,828,8688,5947,2741,2018-01-01,zipcode,Lutz
ZCTA5 33559,12,17731,63414,1174,176100,14703,4141,12016,788,2754,3989,2540,1945,7335,6663,672,6663,3843,2820,2018-01-01,zipcode,Lutz
ZCTA5 33563,12,27875,44121,915,122200,21214,7770,17862,3617,6938,4786,1848,673,10819,9683,1136,9683,5269,4414,2018-01-01,zipcode,Plant city
ZCTA5 33565,12,17311,53883,948,157500,13940,6149,12450,2135,4972,3455,1321,567,6767,6085,682,6085,4791,1294,2018-01-01,zipcode,Plant city
ZCTA5 33566,12,20602,61201,959,191600,15788,5820,13468,2303,4337,3327,2400,1101,7720,7035,685,7035,5096,1939,2018-01-01,zipcode,Plant city
ZCTA5 33567,12,12318,49403,730,173700,9247,3208,7901,2180,2519,2001,887,314,3924,3692,232,3692,2766,926,2018-01-01,zipcode,Plant city
ZCTA5 33569,12,27428,65761,1345,201400,21354,7928,18550,1324,5018,6461,3635,2112,10316,9617,699,9617,7742,1875,2018-01-01,zipcode,Riverview
ZCTA5 33570,12,27821,50809,892,158200,21528,8680,18687,3467,5992,6219,1847,1162,11695,9311,2384,9311,6712,2599,2018-01-01,zipcode,Ruskin
ZCTA5 33572,12,18998,83642,1574,260400,15546,5465,14289,790,3085,4924,3428,2062,8374,7613,761,7613,6433,1180,2018-01-01,zipcode,Apollo beach
ZCTA5 33573,12,22412,46681,1801,162500,21198,16181,20678,1029,5806,7123,3944,2776,14916,12630,2286,12630,10031,2599,2018-01-01,zipcode,Sun city center
ZCTA5 33576,12,4654,58431,740,183000,4220,2618,3865,230,1140,1507,561,427,2380,2061,319,2061,1829,232,2018-01-01,zipcode,San antonio
ZCTA5 33578,12,49634,61604,1198,181200,38524,10511,32994,2277,8410,12104,7111,3092,19851,18564,1287,18564,9919,8645,2018-01-01,zipcode,Riverview
ZCTA5 33579,12,34271,81635,1687,207400,25417,7220,21782,2111,5231,7378,4440,2622,11374,10390,984,10390,8065,2325,2018-01-01,zipcode,Riverview
ZCTA5 33584,12,27153,62899,1128,160600,21351,7475,18753,1970,6237,6295,3073,1178,10079,9258,821,9258,7099,2159,2018-01-01,zipcode,Seffner
ZCTA5 33585,12,1394,47339,781,164000,1101,585,1031,120,613,233,41,24,565,480,85,480,399,81,2018-01-01,zipcode,Sumterville
ZCTA5 33592,12,11068,38297,813,101300,8874,4007,7402,1305,2867,1854,985,391,4515,3989,526,3989,2674,1315,2018-01-01,zipcode,Thonotosassa
ZCTA5 33594,12,35465,63853,1353,176800,28005,10070,24927,2506,7350,8292,4705,2074,13521,12663,858,12663,10256,2407,2018-01-01,zipcode,Valrico
ZCTA5 33596,12,30015,99210,1618,260400,23706,8080,20277,822,4222,6010,6130,3093,10366,9893,473,9893,8546,1347,2018-01-01,zipcode,Valrico
ZCTA5 33597,12,8207,50385,791,106800,6773,3096,5952,1147,2319,1840,480,166,3738,2843,895,2843,2411,432,2018-01-01,zipcode,Webster
ZCTA5 33598,12,18226,61650,817,221800,13633,5556,11925,3671,3252,2831,1316,855,6226,5453,773,5453,4164,1289,2018-01-01,zipcode,Wimauma
ZCTA5 33602,12,14409,71043,1551,305300,12765,3813,11588,1011,1663,2715,3044,3155,9260,7865,1395,7865,3084,4781,2018-01-01,zipcode,Tampa
ZCTA5 33603,12,21044,43012,984,165100,16973,5325,14849,2296,4409,3990,2938,1216,9387,8467,920,8467,4440,4027,2018-01-01,zipcode,Tampa
ZCTA5 33604,12,38690,40621,939,140100,31753,11383,27606,5378,9714,7171,3510,1833,16865,14951,1914,14951,7443,7508,2018-01-01,zipcode,Tampa
ZCTA5 33605,12,17457,26954,920,93700,13631,5959,11570,3099,3972,2675,1357,467,8209,7041,1168,7041,2539,4502,2018-01-01,zipcode,Tampa
ZCTA5 33606,12,19466,79598,1342,505600,17348,6338,12108,491,1605,2269,4434,3309,9191,8030,1161,8030,3566,4464,2018-01-01,zipcode,Tampa
ZCTA5 33607,12,23813,41794,1257,144500,19667,6822,17274,3430,5003,3548,3546,1747,12272,10644,1628,10644,4159,6485,2018-01-01,zipcode,Tampa
ZCTA5 33609,12,18413,63873,1141,347200,15545,4417,13517,950,2090,3285,4181,3011,9389,8476,913,8476,4468,4008,2018-01-01,zipcode,Tampa
ZCTA5 33610,12,45963,34878,971,99300,33383,13187,28208,5460,11145,7221,2971,1411,17671,16005,1666,16005,6773,9232,2018-01-01,zipcode,Tampa
ZCTA5 33611,12,31791,64523,1103,257700,26597,8410,24416,1561,5156,6047,7519,4133,16633,14838,1795,14838,8321,6517,2018-01-01,zipcode,Tampa
ZCTA5 33612,12,49312,33196,887,127700,38707,15489,31510,5880,11490,8508,3869,1763,20808,18487,2321,18487,6304,12183,2018-01-01,zipcode,Tampa
ZCTA5 33613,12,34941,32676,852,158200,29840,10114,20399,3524,5125,5521,4098,2131,16607,14335,2272,14335,4272,10063,2018-01-01,zipcode,Tampa
ZCTA5 33614,12,48029,39746,961,152300,39245,12643,33270,7038,10969,8646,4660,1957,20096,18484,1612,18484,7232,11252,2018-01-01,zipcode,Tampa
ZCTA5 33615,12,45851,49506,1059,155800,37924,12584,32623,4231,10981,8591,6132,2688,19738,17479,2259,17479,9406,8073,2018-01-01,zipcode,Tampa
ZCTA5 33616,12,16145,60538,1292,187100,12874,3689,11034,825,3468,3148,2157,1436,7455,6519,936,6519,3027,3492,2018-01-01,zipcode,Tampa
ZCTA5 33617,12,45652,37257,967,147400,35988,11451,29434,3461,8380,8718,5409,3466,19989,18006,1983,18006,6666,11340,2018-01-01,zipcode,Tampa
ZCTA5 33618,12,27081,70545,1078,273000,22727,7439,19994,646,4012,6246,5440,3650,12439,11423,1016,11423,7446,3977,2018-01-01,zipcode,Tampa
ZCTA5 33619,12,39747,41318,1119,102100,31302,12368,25856,5557,9368,6831,2691,1409,14255,13156,1099,13156,6005,7151,2018-01-01,zipcode,Tampa
ZCTA5 33620,12,5402,-666666666,-666666666,-666666666,5402,4329,45,11,0,24,10,0,23,11,12,11,0,11,2018-01-01,zipcode,Tampa
ZCTA5 33621,12,2533,67708,2135,-666666666,1443,472,991,0,210,421,213,147,621,563,58,563,0,563,2018-01-01,zipcode,Tampa
ZCTA5 33624,12,38618,68125,1225,212400,32126,9602,28378,1617,6822,9397,7071,3471,16115,15017,1098,15017,9641,5376,2018-01-01,zipcode,Tampa
ZCTA5 33625,12,26242,68300,1263,208500,21447,6228,19021,1332,5366,6046,4293,1984,10759,10180,579,10180,6845,3335,2018-01-01,zipcode,Tampa
ZCTA5 33626,12,29964,106560,1485,347700,22692,6750,20081,663,2726,4741,7290,4661,12387,11371,1016,11371,7440,3931,2018-01-01,zipcode,Tampa
ZCTA5 33629,12,25999,115180,1245,492300,19732,6632,17926,400,1916,3571,6377,5662,11464,10454,1010,10454,8308,2146,2018-01-01,zipcode,Tampa
ZCTA5 33634,12,22733,58013,1249,162400,18635,6322,16107,2082,5283,4171,3230,1341,8059,7568,491,7568,4620,2948,2018-01-01,zipcode,Tampa
ZCTA5 33635,12,18353,60267,1361,164700,14460,4532,12990,1061,3708,4009,2497,1715,7845,7120,725,7120,4342,2778,2018-01-01,zipcode,Tampa
ZCTA5 33637,12,17345,52635,1103,146000,13731,3790,10494,1153,2595,3543,2044,1159,7150,6258,892,6258,2391,3867,2018-01-01,zipcode,Tampa
ZCTA5 33647,12,67730,84967,1302,284500,52957,14971,44140,1999,6239,10858,14844,10200,26436,24218,2218,24218,13572,10646,2018-01-01,zipcode,Tampa
ZCTA5 33701,12,15209,35770,859,344500,14038,5954,12729,987,2756,3021,3494,2471,11768,8629,3139,8629,3017,5612,2018-01-01,zipcode,Saint petersburg
ZCTA5 33702,12,30562,50214,981,157600,25811,8881,23152,2203,6497,7127,4749,2576,15581,13070,2511,13070,8111,4959,2018-01-01,zipcode,Saint petersburg
ZCTA5 33703,12,25457,69575,1345,208200,21270,7735,19244,1192,4188,6032,4872,2960,12015,10694,1321,10694,8096,2598,2018-01-01,zipcode,Saint petersburg
ZCTA5 33704,12,16503,78090,978,364800,14017,4920,12883,565,2162,2940,4007,3209,8602,7372,1230,7372,5241,2131,2018-01-01,zipcode,Saint petersburg
ZCTA5 33705,12,27596,48171,1033,177100,23057,9646,19499,2206,5249,5981,3681,2382,14171,10546,3625,10546,5762,4784,2018-01-01,zipcode,Saint petersburg
ZCTA5 33706,12,16294,75212,1155,397600,15052,7110,14374,608,2698,4532,3873,2663,13876,8513,5363,8513,6154,2359,2018-01-01,zipcode,Saint petersburg
ZCTA5 33707,12,25143,47259,1041,185800,22705,11309,21167,1603,5810,6592,4730,2432,15782,12349,3433,12349,8329,4020,2018-01-01,zipcode,Saint petersburg
ZCTA5 33708,12,16098,59189,1167,282700,14823,7673,14075,751,3272,4796,3314,1942,13960,8310,5650,8310,6063,2247,2018-01-01,zipcode,Saint petersburg
ZCTA5 33709,12,25455,42146,931,111000,21817,9979,19659,2726,7340,6134,2459,1000,14378,10886,3492,10886,7943,2943,2018-01-01,zipcode,Saint petersburg
ZCTA5 33710,12,33883,57815,985,177500,28634,9749,25296,2082,7535,8009,5367,2303,15593,13341,2252,13341,10084,3257,2018-01-01,zipcode,Saint petersburg
ZCTA5 33711,12,20366,39720,1140,151000,16697,7713,13395,1730,4812,3615,2013,1225,9427,7224,2203,7224,4137,3087,2018-01-01,zipcode,Saint petersburg
ZCTA5 33712,12,25674,45077,985,163300,21139,8291,17891,1907,4902,5992,3545,1545,11770,9366,2404,9366,4857,4509,2018-01-01,zipcode,Saint petersburg
ZCTA5 33713,12,32350,54067,1102,149400,27257,9173,23629,3314,6584,7726,4250,1755,14784,12724,2060,12724,8231,4493,2018-01-01,zipcode,Saint petersburg
ZCTA5 33714,12,20375,35301,971,89000,16503,6319,14538,3195,4950,4535,1336,522,10056,7999,2057,7999,4947,3052,2018-01-01,zipcode,Saint petersburg
ZCTA5 33715,12,7488,89301,1606,375300,6969,4097,6652,126,1001,1802,2095,1628,6848,3769,3079,3769,3327,442,2018-01-01,zipcode,Saint petersburg
ZCTA5 33716,12,18043,53713,1212,206500,15339,3686,13464,416,2636,4457,4096,1859,10562,8882,1680,8882,1561,7321,2018-01-01,zipcode,Saint petersburg
ZCTA5 33744,12,145,-666666666,-666666666,-666666666,145,134,134,22,90,22,0,0,0,0,0,0,0,0,2018-01-01,zipcode,Bay pines
ZCTA5 33755,12,25445,39461,962,174200,20499,7846,17784,2309,6104,5818,2579,974,11153,9300,1853,9300,4856,4444,2018-01-01,zipcode,Clearwater
ZCTA5 33756,12,33649,42241,910,182600,27363,11428,24445,3377,5549,8906,4717,1896,16086,13356,2730,13356,7811,5545,2018-01-01,zipcode,Clearwater
ZCTA5 33759,12,18366,51316,1253,164700,15337,6520,13408,1398,3963,4034,2624,1389,8874,7785,1089,7785,4383,3402,2018-01-01,zipcode,Clearwater
ZCTA5 33760,12,17260,48195,1038,120800,14291,5067,12097,1628,3855,4189,1791,634,7769,6600,1169,6600,3054,3546,2018-01-01,zipcode,Clearwater
ZCTA5 33761,12,19744,50703,994,160200,17299,8181,16105,824,4264,5446,3808,1763,10410,8951,1459,8951,7323,1628,2018-01-01,zipcode,Clearwater
ZCTA5 33762,12,8093,65161,1342,229800,7315,3794,6473,817,1757,1657,1242,1000,3098,2652,446,2652,1939,713,2018-01-01,zipcode,Clearwater
ZCTA5 33763,12,20195,42992,1061,115800,18035,8731,16238,1704,5313,4963,2661,1597,11384,9416,1968,9416,6561,2855,2018-01-01,zipcode,Clearwater
ZCTA5 33764,12,26282,50800,1120,171800,22285,9334,20228,1315,6502,6851,3848,1712,14541,11353,3188,11353,8028,3325,2018-01-01,zipcode,Clearwater
ZCTA5 33765,12,14270,42224,1005,152300,11912,4111,10644,1168,3347,3712,1284,1133,6466,5899,567,5899,2695,3204,2018-01-01,zipcode,Clearwater
ZCTA5 33767,12,7714,80625,1725,431500,7287,4176,6917,279,1416,1910,1688,1624,8378,4111,4267,4111,3305,806,2018-01-01,zipcode,Clearwater beach
ZCTA5 33770,12,25688,44321,1034,166000,22463,9008,20066,1999,6639,6916,2946,1566,14170,11686,2484,11686,6505,5181,2018-01-01,zipcode,Largo
ZCTA5 33771,12,30346,41473,981,82000,25914,11658,23825,2385,8583,7808,3626,1423,17188,13867,3321,13867,7641,6226,2018-01-01,zipcode,Largo
ZCTA5 33772,12,22517,50833,1116,191500,19233,8354,17421,1238,5271,6026,3369,1517,12461,9934,2527,9934,7297,2637,2018-01-01,zipcode,Seminole
ZCTA5 33773,12,17768,52241,1009,172900,15333,5878,13518,1009,4404,4565,2432,1108,8477,7263,1214,7263,5266,1997,2018-01-01,zipcode,Largo
ZCTA5 33774,12,19108,50085,1008,203300,16125,7351,14803,1109,4283,5336,2635,1440,10120,8237,1883,8237,5827,2410,2018-01-01,zipcode,Largo
ZCTA5 33776,12,12872,74332,1462,268400,11112,4713,10118,312,2637,3079,2577,1513,5681,5115,566,5115,4640,475,2018-01-01,zipcode,Seminole
ZCTA5 33777,12,17179,55650,1233,167200,14552,6134,13335,1238,4030,4118,2339,1610,8343,7115,1228,7115,5598,1517,2018-01-01,zipcode,Seminole
ZCTA5 33778,12,14710,46037,1040,141800,12376,5472,11214,1001,3745,4313,1528,627,7487,6003,1484,6003,4669,1334,2018-01-01,zipcode,Largo
ZCTA5 33781,12,25059,40055,898,136000,20872,8487,18444,2670,6614,5419,2538,1203,11827,10179,1648,10179,5994,4185,2018-01-01,zipcode,Pinellas park
ZCTA5 33782,12,23052,48382,1148,137300,19032,8469,17466,1707,6196,5717,2400,1446,10802,9455,1347,9455,6884,2571,2018-01-01,zipcode,Pinellas park
ZCTA5 33785,12,5515,67838,1204,426600,5179,2440,4959,189,911,1478,1512,869,6152,3002,3150,3002,2054,948,2018-01-01,zipcode,Indian rocks beach
ZCTA5 33786,12,1632,78571,2479,591300,1450,871,1380,46,224,299,461,350,1167,778,389,778,680,98,2018-01-01,zipcode,Belleair beach
ZCTA5 33801,12,35305,35696,804,78700,28649,14279,21655,4650,7836,5769,2440,960,14749,12271,2478,12271,6193,6078,2018-01-01,zipcode,Lakeland
ZCTA5 33803,12,29675,51502,996,133100,24528,10070,21532,1993,6797,5892,4333,2517,14581,12015,2566,12015,7378,4637,2018-01-01,zipcode,Lakeland
ZCTA5 33805,12,25709,35198,950,79900,20194,9235,16970,3358,6528,4293,1911,880,10547,9018,1529,9018,4223,4795,2018-01-01,zipcode,Lakeland
ZCTA5 33809,12,30137,52268,1057,154100,25469,11051,22263,2505,8008,7198,3053,1499,13027,10886,2141,10886,7511,3375,2018-01-01,zipcode,Lakeland
ZCTA5 33810,12,50302,54509,1105,142900,39888,16790,34685,4646,12463,11120,4161,2295,20101,17503,2598,17503,13149,4354,2018-01-01,zipcode,Lakeland
ZCTA5 33811,12,21739,57589,1001,166500,17488,6842,15324,1390,5697,4693,2482,1062,9033,7782,1251,7782,5548,2234,2018-01-01,zipcode,Lakeland
ZCTA5 33812,12,13450,79405,1146,180800,10443,3442,9082,563,2808,2917,1673,1121,5161,4484,677,4484,3593,891,2018-01-01,zipcode,Lakeland
ZCTA5 33813,12,37211,82354,1149,206700,29735,11285,25845,1038,7002,7601,6227,3977,14174,12766,1408,12766,10446,2320,2018-01-01,zipcode,Lakeland
ZCTA5 33815,12,14328,30973,734,26600,11295,5494,9614,2035,4495,2116,724,244,7651,5395,2256,5395,3027,2368,2018-01-01,zipcode,Lakeland
ZCTA5 33823,12,32139,50066,844,133400,25864,11684,22290,3764,7859,6429,2961,1277,12819,10923,1896,10923,7906,3017,2018-01-01,zipcode,Auburndale
ZCTA5 33825,12,26526,36595,757,82800,21615,12421,18968,3785,7086,5292,1553,1252,11653,9082,2571,9082,6437,2645,2018-01-01,zipcode,Avon park
ZCTA5 33827,12,2930,61425,1026,162700,2445,1275,1882,248,627,634,239,134,1216,907,309,907,804,103,2018-01-01,zipcode,Babson park
ZCTA5 33830,12,27476,50521,820,113600,21776,8579,18420,2175,7621,4983,2771,870,11328,9437,1891,9437,6176,3261,2018-01-01,zipcode,Bartow
ZCTA5 33834,12,7695,44167,731,77600,5959,3628,5051,1401,2260,863,409,118,2310,1754,556,1754,1140,614,2018-01-01,zipcode,Bowling green
ZCTA5 33837,12,27428,55877,1211,169100,21842,9495,19268,2399,5443,6658,3355,1413,12569,8882,3687,8882,6671,2211,2018-01-01,zipcode,Davenport
ZCTA5 33838,12,4178,36299,847,115200,2914,1300,2535,702,1021,661,92,59,1554,1183,371,1183,683,500,2018-01-01,zipcode,Dundee
ZCTA5 33839,12,3267,45417,842,112700,2488,1023,2162,470,818,620,186,68,1147,1037,110,1037,686,351,2018-01-01,zipcode,Eagle lake
ZCTA5 33841,12,8944,42838,738,88200,6994,3266,6056,1029,2867,1348,517,295,4071,2980,1091,2980,2220,760,2018-01-01,zipcode,Fort meade
ZCTA5 33843,12,11136,42200,680,70900,9561,6028,8138,2363,2878,1916,559,422,5153,3457,1696,3457,2697,760,2018-01-01,zipcode,Frostproof
ZCTA5 33844,12,35280,39759,875,113200,27253,12176,23661,4862,8819,6768,2105,1107,16640,11760,4880,11760,7519,4241,2018-01-01,zipcode,Haines city
ZCTA5 33847,12,171,-666666666,-666666666,-666666666,124,52,72,25,36,5,6,0,48,37,11,37,35,2,2018-01-01,zipcode,Homeland
ZCTA5 33848,12,1059,-666666666,-666666666,54600,778,342,573,232,267,57,0,17,488,186,302,186,116,70,2018-01-01,zipcode,Intercession city
ZCTA5 33849,12,1191,46875,-666666666,96700,978,442,839,207,383,213,25,11,446,335,111,335,291,44,2018-01-01,zipcode,Kathleen
ZCTA5 33850,12,7802,42768,918,102300,6264,2961,5486,1001,2128,1423,441,493,3806,3087,719,3087,2039,1048,2018-01-01,zipcode,Lake alfred
ZCTA5 33851,12,1105,49500,1096,119600,853,349,782,77,390,222,84,9,414,348,66,348,332,16,2018-01-01,zipcode,Lake hamilton
ZCTA5 33852,12,21202,36972,751,120300,18179,10559,16288,2213,7331,4423,1557,764,12233,8301,3932,8301,6801,1500,2018-01-01,zipcode,Lake placid
ZCTA5 33853,12,12254,38300,758,114900,9043,3353,8086,1884,2393,2422,928,459,4906,4225,681,4225,2077,2148,2018-01-01,zipcode,Lake wales
ZCTA5 33854,12,236,30982,614,38500,212,138,212,22,78,69,30,13,653,160,493,160,70,90,2018-01-01,zipcode,Lakeshore
ZCTA5 33855,12,0,-666666666,-666666666,-666666666,0,0,0,0,0,0,0,0,0,0,0,0,0,0,2018-01-01,zipcode,Indian lake estates
ZCTA5 33856,12,330,31094,537,-666666666,330,305,330,0,171,111,48,0,433,215,218,215,0,215,2018-01-01,zipcode,Nalcrest
ZCTA5 33857,12,2071,27165,554,110200,1558,748,1510,451,764,268,27,0,1445,893,552,893,538,355,2018-01-01,zipcode,Lorida
ZCTA5 33859,12,10364,39407,860,89900,8624,4758,7322,1252,2687,2400,592,391,5069,4219,850,4219,2901,1318,2018-01-01,zipcode,Lake wales
ZCTA5 33860,12,25150,51665,971,122100,19136,7766,16598,2445,6917,4566,1790,880,9387,7979,1408,7979,6091,1888,2018-01-01,zipcode,Mulberry
ZCTA5 33865,12,1078,43500,-666666666,83900,941,410,880,163,467,177,73,0,290,248,42,248,190,58,2018-01-01,zipcode,Ona
ZCTA5 33867,12,393,-666666666,-666666666,107300,393,265,393,46,104,101,105,37,290,205,85,205,205,0,2018-01-01,zipcode,River ranch
ZCTA5 33868,12,12092,52787,867,101300,10083,5860,9233,1807,3852,2415,756,403,4590,3809,781,3809,3119,690,2018-01-01,zipcode,Polk city
ZCTA5 33870,12,21760,31195,674,78000,18532,10286,16552,3515,6065,4779,1344,849,11865,8728,3137,8728,5614,3114,2018-01-01,zipcode,Sebring
ZCTA5 33872,12,15778,41381,875,84000,13844,9098,12896,1084,4249,4608,1920,1035,9332,6922,2410,6922,5367,1555,2018-01-01,zipcode,Sebring
ZCTA5 33873,12,13762,36250,688,85300,10390,4397,8538,2017,4039,1492,640,350,5377,4357,1020,4357,2659,1698,2018-01-01,zipcode,Wauchula
ZCTA5 33875,12,10928,50380,895,124200,9469,4875,8730,898,2886,2618,1611,717,5555,4631,924,4631,3940,691,2018-01-01,zipcode,Sebring
ZCTA5 33876,12,4689,49828,982,99200,4023,2626,3722,525,1544,1154,313,186,2692,2000,692,2000,1734,266,2018-01-01,zipcode,Sebring
ZCTA5 33877,12,589,-666666666,-666666666,-666666666,435,310,241,66,134,41,0,0,172,134,38,134,42,92,2018-01-01,zipcode,Waverly
ZCTA5 33880,12,41346,42623,870,106300,32284,14336,27803,6761,10040,7597,2108,1297,16414,13648,2766,13648,8937,4711,2018-01-01,zipcode,Winter haven
ZCTA5 33881,12,33463,40871,838,88500,27407,14450,23960,4206,8751,7049,2670,1284,15368,12680,2688,12680,8599,4081,2018-01-01,zipcode,Winter haven
ZCTA5 33884,12,32069,58227,1112,168300,26493,11788,23126,1875,6940,8254,3874,2183,14556,11945,2611,11945,8424,3521,2018-01-01,zipcode,Winter haven
ZCTA5 33890,12,4872,35446,713,77100,3529,1646,2965,627,1610,502,110,116,1813,1463,350,1463,1189,274,2018-01-01,zipcode,Zolfo springs
ZCTA5 33896,12,9746,61738,1408,181300,8100,2664,6809,481,1883,2587,1313,545,5141,3097,2044,3097,1842,1255,2018-01-01,zipcode,Davenport
ZCTA5 33897,12,19855,53130,1439,150900,15857,6338,13876,1248,5038,5104,1843,643,12073,6345,5728,6345,4607,1738,2018-01-01,zipcode,Davenport
ZCTA5 33898,12,17107,43237,871,113400,14158,7057,12573,2274,4871,3539,1225,664,9351,6314,3037,6314,4878,1436,2018-01-01,zipcode,Lake wales
ZCTA5 33901,12,20950,35758,838,171300,17504,7911,15583,3020,4497,4058,2521,1487,10969,8876,2093,8876,3728,5148,2018-01-01,zipcode,Fort myers
ZCTA5 33903,12,22122,39783,870,96300,19710,11968,18416,2695,6630,5574,2235,1282,14502,10508,3994,10508,8155,2353,2018-01-01,zipcode,North fort myers
ZCTA5 33904,12,31859,51558,1069,222100,28278,13555,26417,2277,9550,8270,4423,1897,19946,13854,6092,13854,10472,3382,2018-01-01,zipcode,Cape coral
ZCTA5 33905,12,37081,47430,994,146000,30380,13672,26334,6391,8705,6593,2849,1796,14596,11385,3211,11385,7169,4216,2018-01-01,zipcode,Fort myers
ZCTA5 33907,12,24198,42566,1060,148300,19860,7182,17778,2697,5432,4909,3126,1614,12759,9546,3213,9546,4140,5406,2018-01-01,zipcode,Fort myers
ZCTA5 33908,12,36071,56593,1376,253100,33149,20600,31191,1721,8421,8254,7604,5191,31168,17557,13611,17557,12371,5186,2018-01-01,zipcode,Fort myers
ZCTA5 33909,12,31467,54280,1149,173400,25167,9627,21543,2195,8217,7043,2927,1161,11786,10445,1341,10445,6302,4143,2018-01-01,zipcode,Cape coral
ZCTA5 33912,12,18402,73271,1302,265800,16529,8957,15147,727,3521,4623,3694,2582,11215,7905,3310,7905,6622,1283,2018-01-01,zipcode,Fort myers
ZCTA5 33913,12,23816,80713,1486,289600,20543,9630,17426,1130,3501,4965,4693,3137,12171,8271,3900,8271,6983,1288,2018-01-01,zipcode,Fort myers
ZCTA5 33914,12,37375,64484,1193,270800,32267,14148,29290,2006,9538,9609,5183,2954,20234,14735,5499,14735,11025,3710,2018-01-01,zipcode,Cape coral
ZCTA5 33916,12,23438,36765,943,94400,17410,6170,14888,3683,4537,3745,1803,1120,10963,8169,2794,8169,2961,5208,2018-01-01,zipcode,Fort myers
ZCTA5 33917,12,29439,45736,824,92100,26151,15414,24515,2870,10004,7036,2885,1720,17120,12471,4649,12471,10145,2326,2018-01-01,zipcode,North fort myers
ZCTA5 33919,12,30764,55669,1184,195700,26913,13072,25269,1707,6110,8062,5524,3866,18660,14047,4613,14047,10342,3705,2018-01-01,zipcode,Fort myers
ZCTA5 33920,12,5993,78750,859,263900,5044,2132,4470,575,1362,1614,585,334,2473,1958,515,1958,1730,228,2018-01-01,zipcode,Alva
ZCTA5 33921,12,861,68661,-666666666,925700,845,521,762,35,51,434,194,48,1837,321,1516,321,268,53,2018-01-01,zipcode,Boca grande
ZCTA5 33922,12,3731,41607,959,174200,3321,2048,3119,287,992,1054,483,303,2677,1656,1021,1656,1348,308,2018-01-01,zipcode,Bokeelia
ZCTA5 33924,12,200,-666666666,-666666666,-666666666,200,75,188,78,37,35,26,12,1904,49,1855,49,36,13,2018-01-01,zipcode,Captiva
ZCTA5 33928,12,24682,75302,1589,305900,21387,12134,20481,1125,4446,5832,5350,3728,17163,10908,6255,10908,9278,1630,2018-01-01,zipcode,Estero
ZCTA5 33930,12,903,44018,-666666666,-666666666,618,117,516,116,277,87,0,36,442,371,71,371,326,45,2018-01-01,zipcode,Felda
ZCTA5 33931,12,10675,58019,1097,321600,10421,7456,10204,688,2860,3032,2070,1554,14985,5623,9362,5623,4762,861,2018-01-01,zipcode,Fort myers beach
ZCTA5 33935,12,21968,41605,746,87700,16437,6880,13633,4539,4609,3204,606,675,7955,6229,1726,6229,4347,1882,2018-01-01,zipcode,Labelle
ZCTA5 33936,12,23787,40732,920,114800,19467,9282,17230,3306,6589,4620,1783,932,9770,8130,1640,8130,5020,3110,2018-01-01,zipcode,Lehigh acres
ZCTA5 33944,12,268,-666666666,-666666666,-666666666,165,138,165,0,165,0,0,0,137,104,33,104,104,0,2018-01-01,zipcode,Palmdale
ZCTA5 33945,12,0,-666666666,-666666666,-666666666,0,0,0,0,0,0,0,0,187,0,187,0,0,0,2018-01-01,zipcode,Pineland
ZCTA5 33946,12,2325,74063,1592,416200,2261,1552,2225,118,760,550,599,198,2883,1184,1699,1184,1040,144,2018-01-01,zipcode,Placida
ZCTA5 33947,12,8901,51078,1172,233000,8273,5506,7804,454,2691,2813,1126,720,5651,4100,1551,4100,3470,630,2018-01-01,zipcode,Rotonda west
ZCTA5 33948,12,16361,45197,976,163800,14336,7596,13061,1173,4559,4656,1510,1163,8843,6826,2017,6826,5524,1302,2018-01-01,zipcode,Port charlotte
ZCTA5 33950,12,22017,56855,966,280000,20767,13935,19645,1278,4890,6371,4365,2741,15536,11210,4326,11210,9157,2053,2018-01-01,zipcode,Punta gorda
ZCTA5 33952,12,33662,39761,953,131900,29066,13981,26192,3078,9703,8762,3108,1541,16330,13739,2591,13739,9647,4092,2018-01-01,zipcode,Port charlotte
ZCTA5 33953,12,6885,56888,985,214900,6410,4160,6002,468,1938,2190,828,578,3893,2986,907,2986,2669,317,2018-01-01,zipcode,Port charlotte
ZCTA5 33954,12,9294,55546,1312,193800,7952,3985,7070,618,2555,2334,1023,540,4043,3599,444,3599,2843,756,2018-01-01,zipcode,Port charlotte
ZCTA5 33955,12,11406,60169,1066,235500,10439,7236,9721,1531,2914,2749,1637,890,6515,4376,2139,4376,3935,441,2018-01-01,zipcode,Punta gorda
ZCTA5 33956,12,3437,54464,1089,197600,3295,2341,3108,147,967,942,620,432,3244,1637,1607,1637,1457,180,2018-01-01,zipcode,Saint james city
ZCTA5 33957,12,7224,102135,1443,720500,6695,4243,6525,147,907,1513,1998,1960,8929,3678,5251,3678,3117,561,2018-01-01,zipcode,Sanibel
ZCTA5 33960,12,719,49464,1089,168800,665,317,627,51,283,182,92,19,615,329,286,329,289,40,2018-01-01,zipcode,Venus
ZCTA5 33965,12,1659,-666666666,-666666666,-666666666,1659,821,11,0,0,11,0,0,0,0,0,0,0,0,2018-01-01,zipcode,Fort myers
ZCTA5 33966,12,10185,61911,1052,256000,8802,4418,7885,406,1893,2191,1888,1507,5672,4343,1329,4343,3065,1278,2018-01-01,zipcode,Fort myers
ZCTA5 33967,12,25041,64896,1232,206400,20452,5928,16522,2165,4142,5407,3458,1350,9764,8231,1533,8231,6082,2149,2018-01-01,zipcode,Fort myers
ZCTA5 33971,12,27255,50212,1089,148100,20194,7208,16322,3317,5800,4902,1530,773,8176,7284,892,7284,5014,2270,2018-01-01,zipcode,Lehigh acres
ZCTA5 33972,12,15299,58151,1079,162200,12111,4813,10115,1709,3624,3422,1000,360,5242,4453,789,4453,3025,1428,2018-01-01,zipcode,Lehigh acres
ZCTA5 33973,12,14875,39250,963,195300,9533,3137,7662,1995,2945,1933,542,247,4284,3811,473,3811,790,3021,2018-01-01,zipcode,Lehigh acres
ZCTA5 33974,12,17119,47831,1117,145800,12653,4306,10721,1772,4192,3177,1121,459,5320,4580,740,4580,2846,1734,2018-01-01,zipcode,Lehigh acres
ZCTA5 33976,12,18554,48957,1117,133300,12969,3936,10688,2616,3737,2979,1088,268,4930,4614,316,4614,2960,1654,2018-01-01,zipcode,Lehigh acres
ZCTA5 33980,12,13336,43559,834,140800,11700,7723,10709,1090,3120,3926,1574,999,8046,5796,2250,5796,4256,1540,2018-01-01,zipcode,Punta gorda
ZCTA5 33981,12,10729,54461,1209,231300,9532,5498,9118,704,3307,3178,1217,712,6272,4530,1742,4530,3795,735,2018-01-01,zipcode,Port charlotte
ZCTA5 33982,12,11025,47067,839,113200,9384,5406,8444,1403,2809,2986,659,587,5211,4117,1094,4117,3440,677,2018-01-01,zipcode,Punta gorda
ZCTA5 33983,12,14422,54683,993,201000,12307,6615,11201,843,3658,3867,1819,1014,7630,5849,1781,5849,4765,1084,2018-01-01,zipcode,Punta gorda
ZCTA5 33990,12,32901,54022,1087,201300,27964,11971,25361,2208,9409,8757,3412,1575,14074,11404,2670,11404,7974,3430,2018-01-01,zipcode,Cape coral
ZCTA5 33991,12,22354,66095,1435,231600,17589,6597,15195,752,5128,4712,3137,1466,9264,7484,1780,7484,5659,1825,2018-01-01,zipcode,Cape coral
ZCTA5 33993,12,24856,58935,1359,199300,20480,8506,17457,1755,6761,5419,2323,1199,9715,8056,1659,8056,6206,1850,2018-01-01,zipcode,Cape coral
ZCTA5 34101,12,0,-666666666,-666666666,-666666666,0,0,0,0,0,0,0,0,15,0,15,0,0,0,2018-01-01,zipcode,Naples
ZCTA5 34102,12,11454,80609,1180,968600,10307,5818,9608,811,1406,2244,3104,2043,9716,5555,4161,5555,3925,1630,2018-01-01,zipcode,Naples
ZCTA5 34103,12,12802,84972,1319,695600,11882,7199,11205,763,2378,2638,2935,2491,11174,6126,5048,6126,4810,1316,2018-01-01,zipcode,Naples
ZCTA5 34104,12,24121,51793,1139,242100,20848,10027,18915,2279,5520,5312,3506,2298,15068,10467,4601,10467,7250,3217,2018-01-01,zipcode,Naples
ZCTA5 34105,12,17248,88223,1526,438500,15188,8043,14064,539,2415,4226,4192,2692,10440,7688,2752,7688,5359,2329,2018-01-01,zipcode,Naples
ZCTA5 34108,12,16636,90907,1358,692700,15379,9017,14552,617,3088,3154,4125,3568,14423,8014,6409,8014,6461,1553,2018-01-01,zipcode,Naples
ZCTA5 34109,12,24662,66038,1357,387700,20868,9938,19254,988,4386,4276,6050,3554,14753,11148,3605,11148,6824,4324,2018-01-01,zipcode,Naples
ZCTA5 34110,12,24008,77197,1567,377100,21659,12639,20418,925,4105,5404,5510,4474,16335,10901,5434,10901,8431,2470,2018-01-01,zipcode,Naples
ZCTA5 34112,12,27543,55687,1034,214300,24574,13208,22532,2739,7162,5959,3999,2673,19354,12201,7153,12201,9177,3024,2018-01-01,zipcode,Naples
ZCTA5 34113,12,21409,51992,1232,259400,18081,8818,15535,2913,4234,3950,2782,1656,13066,8177,4889,8177,5611,2566,2018-01-01,zipcode,Naples
ZCTA5 34114,12,16727,59800,1205,237000,14960,8530,13570,1668,4191,3937,2333,1441,12567,7251,5316,7251,6074,1177,2018-01-01,zipcode,Naples
ZCTA5 34116,12,36531,50579,1168,228600,27966,7313,23896,6881,8462,5043,2343,1167,10448,9620,828,9620,5092,4528,2018-01-01,zipcode,Naples
ZCTA5 34117,12,15794,73010,1529,276400,13110,4189,11059,1598,3449,3088,2059,865,5167,4664,503,4664,4314,350,2018-01-01,zipcode,Naples
ZCTA5 34119,12,31632,87992,1460,433300,26597,13167,23806,967,5425,6362,6350,4702,16246,12767,3479,12767,9691,3076,2018-01-01,zipcode,Naples
ZCTA5 34120,12,32502,79244,1581,311100,25044,9022,22197,2720,6213,6041,3930,3293,13053,10156,2897,10156,8623,1533,2018-01-01,zipcode,Naples
ZCTA5 34134,12,13977,83135,1156,475700,13248,9026,12802,406,2790,3149,3688,2769,14012,7139,6873,7139,6095,1044,2018-01-01,zipcode,Bonita springs
ZCTA5 34135,12,46064,61809,1217,261900,40173,21226,36228,5922,8403,9914,7254,4735,27842,18232,9610,18232,14223,4009,2018-01-01,zipcode,Bonita springs
ZCTA5 34137,12,454,23219,-666666666,-666666666,195,114,195,0,99,96,0,0,114,114,0,114,16,98,2018-01-01,zipcode,
ZCTA5 34138,12,268,-666666666,-666666666,143800,268,166,268,0,96,101,56,15,326,119,207,119,119,0,2018-01-01,zipcode,Chokoloskee
ZCTA5 34139,12,486,-666666666,788,118400,301,114,266,31,94,78,41,22,475,177,298,177,157,20,2018-01-01,zipcode,Everglades city
ZCTA5 34140,12,437,-666666666,-666666666,-666666666,346,221,290,0,44,116,130,0,480,144,336,144,100,44,2018-01-01,zipcode,Goodland
ZCTA5 34141,12,67,-666666666,-666666666,-666666666,58,22,36,0,0,14,4,18,17,17,0,17,3,14,2018-01-01,zipcode,Ochopee
ZCTA5 34142,12,30955,32128,773,137300,22450,7305,16761,9748,3923,1703,942,445,7897,6701,1196,6701,2727,3974,2018-01-01,zipcode,Immokalee
ZCTA5 34145,12,17692,79157,1595,598200,16469,9859,15800,1265,3083,4286,4427,2739,18700,8515,10185,8515,7310,1205,2018-01-01,zipcode,Marco island
ZCTA5 34201,12,3930,92876,1929,413800,3618,2154,3475,162,488,744,986,1095,2619,1817,802,1817,1691,126,2018-01-01,zipcode,Bradenton
ZCTA5 34202,12,23739,96919,1816,419300,19700,9374,17661,526,2782,4341,5595,4417,11224,9193,2031,9193,7095,2098,2018-01-01,zipcode,Bradenton
ZCTA5 34203,12,37632,51569,1038,190500,30925,14158,28140,3760,9554,7957,4274,2595,18325,14093,4232,14093,10282,3811,2018-01-01,zipcode,Bradenton
ZCTA5 34205,12,32534,40613,954,126100,26199,11424,23215,3783,8113,7135,2668,1516,15684,12686,2998,12686,7243,5443,2018-01-01,zipcode,Bradenton
ZCTA5 34207,12,36738,37906,948,72500,30285,13975,26146,4977,10140,6806,2592,1631,19275,15023,4252,15023,8499,6524,2018-01-01,zipcode,Bradenton
ZCTA5 34208,12,39538,47139,1021,161800,30442,12536,25780,5270,9664,5954,3393,1499,14411,12339,2072,12339,6932,5407,2018-01-01,zipcode,Bradenton
ZCTA5 34209,12,34794,57995,1171,215900,30784,15234,27590,1652,8847,8885,5131,3075,18313,14484,3829,14484,10621,3863,2018-01-01,zipcode,Bradenton
ZCTA5 34210,12,17023,47547,1103,200000,14992,7477,13077,1003,3731,4224,2389,1730,11125,7262,3863,7262,4245,3017,2018-01-01,zipcode,Bradenton
ZCTA5 34211,12,7885,103385,1675,377000,6668,3484,6140,219,1404,1813,1769,935,4131,3191,940,3191,2868,323,2018-01-01,zipcode,Bradenton
ZCTA5 34212,12,19301,91971,1558,339100,15537,6079,13775,397,2541,4598,3860,2379,8444,6942,1502,6942,5605,1337,2018-01-01,zipcode,Bradenton
ZCTA5 34215,12,560,45000,-666666666,831100,544,350,498,0,109,173,125,91,540,262,278,262,221,41,2018-01-01,zipcode,Cortez
ZCTA5 34216,12,874,70833,1148,858600,823,511,792,40,154,242,186,170,1367,416,951,416,381,35,2018-01-01,zipcode,Anna maria
ZCTA5 34217,12,5127,61228,1211,546800,4787,2810,4648,97,806,1614,1080,1051,6478,2761,3717,2761,2041,720,2018-01-01,zipcode,Bradenton beach
ZCTA5 34219,12,23792,81918,1724,258200,19061,7481,17332,903,4562,6295,3827,1745,9621,8349,1272,8349,7573,776,2018-01-01,zipcode,Parrish
ZCTA5 34221,12,44294,53329,1055,151600,36978,17691,32317,4330,11482,9597,4443,2465,20221,15392,4829,15392,12091,3301,2018-01-01,zipcode,Palmetto
ZCTA5 34222,12,11184,51103,1011,95100,9785,5565,9150,736,3056,3543,1200,615,7253,5182,2071,5182,4015,1167,2018-01-01,zipcode,Ellenton
ZCTA5 34223,12,17370,53430,938,220000,16300,11321,15648,742,5890,4610,2595,1811,13401,8667,4734,8667,7098,1569,2018-01-01,zipcode,Englewood
ZCTA5 34224,12,15913,44673,929,152800,14493,8576,13409,1306,5515,3691,1727,1170,10803,7459,3344,7459,5957,1502,2018-01-01,zipcode,Englewood
ZCTA5 34228,12,7233,104825,1435,720700,7118,5439,6993,252,682,1502,2228,2329,9319,3835,5484,3835,3555,280,2018-01-01,zipcode,Longboat key
ZCTA5 34229,12,7824,91972,1191,428400,6873,3644,6322,221,1224,1508,1699,1670,4205,3407,798,3407,2859,548,2018-01-01,zipcode,Osprey
ZCTA5 34231,12,30267,51758,1114,226300,26474,11167,24314,1817,6989,7555,4617,3336,18297,14425,3872,14425,8907,5518,2018-01-01,zipcode,Sarasota
ZCTA5 34232,12,34639,64331,1345,207600,29261,10687,26204,2151,9263,7258,5145,2387,15201,13538,1663,13538,9236,4302,2018-01-01,zipcode,Sarasota
ZCTA5 34233,12,17989,60589,1440,249000,15239,6816,13662,880,3819,3587,3283,2093,8931,7797,1134,7797,5911,1886,2018-01-01,zipcode,Sarasota
ZCTA5 34234,12,21865,35891,952,117800,17819,8136,14998,2576,5476,3715,1948,1283,10315,8698,1617,8698,4566,4132,2018-01-01,zipcode,Sarasota
ZCTA5 34235,12,14671,56761,1347,217200,12788,6488,11407,709,2863,3419,2450,1966,8386,6473,1913,6473,4954,1519,2018-01-01,zipcode,Sarasota
ZCTA5 34236,12,12920,53247,1030,655700,11870,7281,11544,940,1627,2847,3179,2951,10718,7003,3715,7003,4251,2752,2018-01-01,zipcode,Sarasota
ZCTA5 34237,12,17307,42341,1074,137900,14851,5537,13204,2201,4617,3530,1986,870,8471,6960,1511,6960,3552,3408,2018-01-01,zipcode,Sarasota
ZCTA5 34238,12,19364,72426,1581,354700,17815,10772,16669,471,3075,4290,4563,4270,12514,9886,2628,9886,7465,2421,2018-01-01,zipcode,Sarasota
ZCTA5 34239,12,15499,56059,1245,263300,13208,4990,12064,936,2733,3343,3181,1871,8573,6912,1661,6912,4864,2048,2018-01-01,zipcode,Sarasota
ZCTA5 34240,12,11142,88430,1542,399400,9118,4377,8144,349,2025,2200,1956,1614,5456,3954,1502,3954,3704,250,2018-01-01,zipcode,Sarasota
ZCTA5 34241,12,14675,82616,1609,340100,12358,5476,11102,459,2687,3339,2644,1973,6639,5727,912,5727,4962,765,2018-01-01,zipcode,Sarasota
ZCTA5 34242,12,7706,100352,1531,690500,7060,4196,6697,212,804,1663,2184,1834,10834,3860,6974,3860,3293,567,2018-01-01,zipcode,Sarasota
ZCTA5 34243,12,32235,61541,1472,266000,28060,13515,25284,1288,6180,7686,5997,4133,15428,13399,2029,13399,9926,3473,2018-01-01,zipcode,Sarasota
ZCTA5 34251,12,5922,82154,1262,307300,4913,1628,4322,538,1655,1268,515,346,2119,1815,304,1815,1678,137,2018-01-01,zipcode,Myakka city
ZCTA5 34266,12,32246,33810,678,81500,26318,13573,22387,6716,9798,3767,1511,595,12369,10053,2316,10053,6695,3358,2018-01-01,zipcode,Arcadia
ZCTA5 34268,12,128,23286,-666666666,-666666666,109,109,109,64,45,0,0,0,155,80,75,80,51,29,2018-01-01,zipcode,Nocatee
ZCTA5 34269,12,4025,41535,871,126800,3653,2387,3422,303,1328,931,608,252,2578,1863,715,1863,1637,226,2018-01-01,zipcode,Arcadia
ZCTA5 34275,12,20074,60258,1053,283700,17897,9981,16297,705,4924,4672,3560,2436,11340,9229,2111,9229,7491,1738,2018-01-01,zipcode,Nokomis
ZCTA5 34285,12,18069,52701,1179,192000,17561,12117,16607,654,5196,4697,3599,2461,15226,9741,5485,9741,7412,2329,2018-01-01,zipcode,Venice
ZCTA5 34286,12,18625,64500,1407,165300,14600,5736,12549,1494,4378,4306,1886,485,7246,6264,982,6264,5130,1134,2018-01-01,zipcode,North port
ZCTA5 34287,12,27532,50627,1037,140500,24208,13610,22376,2229,9028,6631,2869,1619,14935,11122,3813,11122,8100,3022,2018-01-01,zipcode,North port
ZCTA5 34288,12,12304,56746,1216,181900,9983,4871,9016,724,3206,3555,939,592,4888,4419,469,4419,3569,850,2018-01-01,zipcode,North port
ZCTA5 34289,12,3734,54922,1185,192200,3231,1176,2448,81,388,1071,665,243,1970,1563,407,1563,572,991,2018-01-01,zipcode,North port
ZCTA5 34291,12,6119,57841,1354,182000,4949,2155,4440,395,1899,1500,431,215,2126,2126,0,2126,1767,359,2018-01-01,zipcode,North port
ZCTA5 34292,12,16054,61759,1429,296700,14631,10450,13922,678,3456,3996,3409,2383,9663,7814,1849,7814,6046,1768,2018-01-01,zipcode,Venice
ZCTA5 34293,12,37969,57835,1258,222100,34132,19325,31925,1709,9412,10142,6722,3940,22392,17457,4935,17457,14773,2684,2018-01-01,zipcode,Venice
ZCTA5 34420,12,18107,42040,796,103000,14604,5852,12691,1747,5486,4158,1041,259,7940,6561,1379,6561,4754,1807,2018-01-01,zipcode,Belleview
ZCTA5 34428,12,9369,38250,709,109200,7998,4147,7183,1028,2636,2469,736,314,5315,4025,1290,4025,3049,976,2018-01-01,zipcode,Crystal river
ZCTA5 34429,12,8272,42398,962,118200,7551,4407,6647,591,2512,2098,844,602,5051,3765,1286,3765,3163,602,2018-01-01,zipcode,Crystal river
ZCTA5 34431,12,7958,38553,788,109100,6704,3866,6088,639,2781,1759,552,357,4174,3473,701,3473,2903,570,2018-01-01,zipcode,Dunnellon
ZCTA5 34432,12,12583,41921,892,133100,10887,6841,10179,1412,3517,3222,1470,558,6553,5505,1048,5505,4640,865,2018-01-01,zipcode,Dunnellon
ZCTA5 34433,12,5957,52525,829,128200,5181,2729,4719,593,1784,1560,593,189,3359,2725,634,2725,2403,322,2018-01-01,zipcode,Dunnellon
ZCTA5 34434,12,7731,47369,1153,137500,6385,3080,5817,517,2546,2050,575,129,3917,2961,956,2961,2403,558,2018-01-01,zipcode,Dunnellon
ZCTA5 34436,12,8225,36401,698,89700,7082,4055,6306,1094,2607,1904,315,386,4576,3591,985,3591,2966,625,2018-01-01,zipcode,Floral city
ZCTA5 34442,12,13953,46612,825,161400,12677,8447,11912,1171,4275,3235,1898,1333,8643,6535,2108,6535,5780,755,2018-01-01,zipcode,Hernando
ZCTA5 34445,12,0,-666666666,-666666666,-666666666,0,0,0,0,0,0,0,0,0,0,0,0,0,0,2018-01-01,zipcode,Holder
ZCTA5 34446,12,16647,44962,954,136000,14811,10050,13804,1578,5048,4352,1951,875,9378,7632,1746,7632,6782,850,2018-01-01,zipcode,Homosassa
ZCTA5 34448,12,10620,38397,774,77200,9341,5862,8545,1005,3673,2977,690,200,6472,4780,1692,4780,3739,1041,2018-01-01,zipcode,Homosassa
ZCTA5 34449,12,2966,25970,504,80000,2690,1539,2555,434,1051,738,206,126,1830,1388,442,1388,942,446,2018-01-01,zipcode,Inglis
ZCTA5 34450,12,10747,36630,738,116900,9274,5486,8510,921,3178,2802,854,755,6090,5072,1018,5072,3685,1387,2018-01-01,zipcode,Inverness
ZCTA5 34452,12,11400,38151,834,108200,9826,5433,8676,1026,3606,2730,822,492,5781,4933,848,4933,3942,991,2018-01-01,zipcode,Inverness
ZCTA5 34453,12,11427,39495,899,102600,9521,5510,8650,1480,3304,2727,779,360,5709,4418,1291,4418,3478,940,2018-01-01,zipcode,Inverness
ZCTA5 34461,12,10664,44536,705,161100,9611,6145,8591,1169,3137,2559,1117,609,5521,4232,1289,4232,3325,907,2018-01-01,zipcode,Lecanto
ZCTA5 34465,12,17603,37870,853,145400,14900,8969,13871,1328,5107,4891,1593,952,9100,7929,1171,7929,6299,1630,2018-01-01,zipcode,Beverly hills
ZCTA5 34470,12,19856,36440,833,98600,16212,7353,14021,1636,5251,4842,1632,660,9477,7924,1553,7924,4644,3280,2018-01-01,zipcode,Ocala
ZCTA5 34471,12,24898,49805,883,170700,20044,8569,17013,1419,5343,4930,3145,2176,11338,9586,1752,9586,6311,3275,2018-01-01,zipcode,Ocala
ZCTA5 34472,12,31632,42003,946,100200,24302,10817,19920,2489,7452,6681,2254,1044,11928,10499,1429,10499,7569,2930,2018-01-01,zipcode,Ocala
ZCTA5 34473,12,19522,52949,998,148300,15611,6949,14190,1823,5760,4314,1823,470,7955,6742,1213,6742,5221,1521,2018-01-01,zipcode,Ocala
ZCTA5 34474,12,16659,43394,999,131600,13485,5525,11900,1427,3493,3794,2042,1144,7934,6730,1204,6730,3187,3543,2018-01-01,zipcode,Ocala
ZCTA5 34475,12,12882,23955,692,79400,10185,6198,8657,2046,3430,2178,674,329,5195,4068,1127,4068,1969,2099,2018-01-01,zipcode,Ocala
ZCTA5 34476,12,22665,51241,853,144200,19833,11990,18306,1751,6347,6354,2646,1208,11490,9693,1797,9693,8665,1028,2018-01-01,zipcode,Ocala
ZCTA5 34479,12,13533,43879,842,99400,10765,4542,9521,1109,4008,2932,1036,436,5754,5128,626,5128,3616,1512,2018-01-01,zipcode,Ocala
ZCTA5 34480,12,19029,53160,795,141700,15112,5817,13006,1101,4767,3915,1713,1510,7927,6679,1248,6679,4806,1873,2018-01-01,zipcode,Ocala
ZCTA5 34481,12,19147,42276,926,115100,17981,13383,17346,1371,5577,5863,3118,1417,11587,9769,1818,9769,8825,944,2018-01-01,zipcode,Ocala
ZCTA5 34482,12,25244,41820,778,141300,21674,13546,19562,4014,7166,5451,2167,764,9522,7479,2043,7479,5772,1707,2018-01-01,zipcode,Ocala
ZCTA5 34484,12,3604,42697,853,213400,2826,1422,2513,219,810,958,368,158,1928,1548,380,1548,947,601,2018-01-01,zipcode,Oxford
ZCTA5 34488,12,10499,33302,794,58100,8599,5129,7728,1089,3438,2407,656,138,5524,4139,1385,4139,3208,931,2018-01-01,zipcode,Silver springs
ZCTA5 34491,12,24936,46338,930,165600,22276,14833,21127,2057,8268,6462,3002,1338,15024,11817,3207,11817,10342,1475,2018-01-01,zipcode,Summerfield
ZCTA5 34498,12,576,40938,1012,159400,464,285,437,51,159,130,67,30,500,279,221,279,210,69,2018-01-01,zipcode,Yankeetown
ZCTA5 34601,12,21847,38699,794,100900,18117,10194,16243,2514,5909,4697,2078,1045,11424,9267,2157,9267,6436,2831,2018-01-01,zipcode,Brooksville
ZCTA5 34602,12,7314,53675,928,140000,6126,3296,5587,1032,2114,1320,682,439,2939,2614,325,2614,2121,493,2018-01-01,zipcode,Brooksville
ZCTA5 34604,12,11573,53694,898,145900,9528,4616,8448,1082,3122,2733,1016,495,4385,3989,396,3989,3382,607,2018-01-01,zipcode,Brooksville
ZCTA5 34606,12,26274,41744,931,119000,22419,13345,20404,2255,7521,6927,2499,1202,13913,11723,2190,11723,8819,2904,2018-01-01,zipcode,Spring hill
ZCTA5 34607,12,8778,44213,969,194500,7975,4816,7148,717,2304,2467,1140,520,5181,4043,1138,4043,3317,726,2018-01-01,zipcode,Spring hill
ZCTA5 34608,12,34476,45573,991,124600,28515,13953,24750,3370,9336,8654,2309,1081,14720,13208,1512,13208,9366,3842,2018-01-01,zipcode,Spring hill
ZCTA5 34609,12,41250,52582,1111,152600,33243,16146,29304,2873,9619,11164,3782,1866,17421,15419,2002,15419,12301,3118,2018-01-01,zipcode,Spring hill
ZCTA5 34610,12,14656,49551,997,138300,12084,5882,10376,1783,3956,3150,980,507,5717,5051,666,5051,4020,1031,2018-01-01,zipcode,Spring hill
ZCTA5 34613,12,17433,43059,950,94700,15599,9840,14525,1972,5562,4690,1500,801,10182,8142,2040,8142,6968,1174,2018-01-01,zipcode,Brooksville
ZCTA5 34614,12,7237,49841,1036,143200,5964,2773,5131,624,1971,1739,474,323,2937,2596,341,2596,2346,250,2018-01-01,zipcode,Brooksville
ZCTA5 34637,12,8209,80691,1644,223500,7004,4689,6251,858,1608,1822,1147,816,2553,2118,435,2118,1796,322,2018-01-01,zipcode,Land o lakes
ZCTA5 34638,12,26512,92393,1422,241700,19153,5635,16607,904,3514,5607,4596,1986,9071,8484,587,8484,6868,1616,2018-01-01,zipcode,Land o lakes
ZCTA5 34639,12,27522,80380,1264,233900,22009,7339,19092,1324,4268,6428,4796,2276,10124,9606,518,9606,7791,1815,2018-01-01,zipcode,Land o lakes
ZCTA5 34652,12,23409,37171,891,95200,20244,10585,18281,2274,6922,6016,2007,1062,14568,10538,4030,10538,6521,4017,2018-01-01,zipcode,New port richey
ZCTA5 34653,12,35015,40321,989,94300,29153,14489,25815,3053,9647,9053,2736,1326,17301,14609,2692,14609,8941,5668,2018-01-01,zipcode,New port richey
ZCTA5 34654,12,23021,48903,1031,150200,19355,9903,17071,2097,6123,5774,1971,1106,10459,8854,1605,8854,6728,2126,2018-01-01,zipcode,New port richey
ZCTA5 34655,12,39385,61845,1161,214700,32995,15319,30135,1827,9130,10146,5843,3189,19378,16595,2783,16595,13116,3479,2018-01-01,zipcode,New port richey
ZCTA5 34661,12,138,31250,-666666666,-666666666,101,34,83,0,75,8,0,0,69,42,27,42,34,8,2018-01-01,zipcode,Nobleton
ZCTA5 34667,12,33960,42472,896,125200,29649,17781,27261,3250,10235,8737,3361,1678,19588,15450,4138,15450,11073,4377,2018-01-01,zipcode,Hudson
ZCTA5 34668,12,47309,36261,949,83100,38939,18915,34087,4636,13437,11551,3124,1339,22919,19363,3556,19363,11857,7506,2018-01-01,zipcode,Port richey
ZCTA5 34669,12,12752,47072,987,137600,10676,5099,9375,834,4021,3072,997,451,5822,4990,832,4990,4071,919,2018-01-01,zipcode,Hudson
ZCTA5 34677,12,22152,62288,1132,222400,18598,7027,16014,991,4282,4929,3830,1982,10230,8810,1420,8810,6321,2489,2018-01-01,zipcode,Oldsmar
ZCTA5 34679,12,103,-666666666,-666666666,146400,86,65,86,0,68,6,6,6,71,53,18,53,36,17,2018-01-01,zipcode,Aripeka
ZCTA5 34681,12,775,58438,-666666666,406300,706,335,647,26,99,110,288,124,501,355,146,355,355,0,2018-01-01,zipcode,Crystal beach
ZCTA5 34683,12,33162,62766,1183,261200,28147,11353,24807,1344,5652,8824,6208,2779,15912,13367,2545,13367,10078,3289,2018-01-01,zipcode,Palm harbor
ZCTA5 34684,12,28784,51853,1299,181600,25561,11984,23013,1163,6568,7992,4998,2292,14765,13167,1598,13167,8758,4409,2018-01-01,zipcode,Palm harbor
ZCTA5 34685,12,18899,84403,1317,334600,15815,6696,13872,499,2850,3800,4290,2433,8023,7295,728,7295,5481,1814,2018-01-01,zipcode,Palm harbor
ZCTA5 34688,12,6497,85766,1625,343600,5610,2617,5203,226,930,1658,1510,879,3613,2839,774,2839,2536,303,2018-01-01,zipcode,Tarpon springs
ZCTA5 34689,12,27496,47262,845,185400,23477,11693,20829,2247,6197,6537,3651,2197,13499,10624,2875,10624,7526,3098,2018-01-01,zipcode,Tarpon springs
ZCTA5 34690,12,12028,35364,1007,70100,10285,5231,9161,1265,4124,2663,826,283,6792,5394,1398,5394,3428,1966,2018-01-01,zipcode,Holiday
ZCTA5 34691,12,20473,39836,998,81100,16689,7958,15095,1521,6506,4640,1827,601,11876,8575,3301,8575,5700,2875,2018-01-01,zipcode,Holiday
ZCTA5 34695,12,18096,72813,1249,241700,15115,5583,13690,595,3426,3975,3773,1921,8321,7295,1026,7295,5935,1360,2018-01-01,zipcode,Safety harbor
ZCTA5 34698,12,38909,48246,1057,179500,34236,16029,31808,2673,9089,9743,6709,3594,21621,18237,3384,18237,12155,6082,2018-01-01,zipcode,Dunedin
ZCTA5 34705,12,2649,54708,956,104600,2024,739,1792,242,674,732,132,12,1122,896,226,896,686,210,2018-01-01,zipcode,Astatula
ZCTA5 34711,12,60564,67795,1309,217000,48855,20282,42888,3437,11009,16065,7747,4630,24101,21224,2877,21224,16528,4696,2018-01-01,zipcode,Clermont
ZCTA5 34714,12,21743,54141,1175,171400,17011,5503,14194,1010,4286,4832,3396,670,9506,7266,2240,7266,3781,3485,2018-01-01,zipcode,Clermont
ZCTA5 34715,12,17948,59202,1226,219600,14468,5859,12299,1329,3412,4635,2015,908,6246,5669,577,5669,3717,1952,2018-01-01,zipcode,Clermont
ZCTA5 34731,12,13218,46800,953,156900,11253,5448,10294,925,3675,3272,1496,926,6753,5682,1071,5682,4500,1182,2018-01-01,zipcode,Fruitland park
ZCTA5 34734,12,4225,62014,1286,278100,3172,1287,2647,268,809,814,461,295,1363,1363,0,1363,1195,168,2018-01-01,zipcode,Gotha
ZCTA5 34736,12,18213,58628,1310,174200,14533,5983,12845,1932,3904,3981,2081,947,6759,6104,655,6104,4994,1110,2018-01-01,zipcode,Groveland
ZCTA5 34737,12,2551,58011,1147,211500,2115,983,1896,205,599,572,348,172,1303,979,324,979,810,169,2018-01-01,zipcode,Howey in the hills
ZCTA5 34739,12,334,-666666666,-666666666,93200,235,136,235,56,95,33,51,0,415,170,245,170,134,36,2018-01-01,zipcode,Kenansville
ZCTA5 34741,12,45920,37148,1056,151200,35896,12240,30424,4737,10234,10617,3360,1476,19850,15205,4645,15205,4535,10670,2018-01-01,zipcode,Kissimmee
ZCTA5 34743,12,44335,43915,1244,161700,34729,12862,29106,4672,10422,9460,3359,1193,13304,11779,1525,11779,7552,4227,2018-01-01,zipcode,Kissimmee
ZCTA5 34744,12,55210,48991,1202,196800,43263,16027,36355,4902,9998,12783,6081,2591,18504,15738,2766,15738,9678,6060,2018-01-01,zipcode,Kissimmee
ZCTA5 34746,12,43249,54056,1407,187100,34348,12464,29253,3207,8707,10606,4650,2083,21749,12766,8983,12766,8455,4311,2018-01-01,zipcode,Kissimmee
ZCTA5 34747,12,19413,63591,1406,300000,16122,4923,13335,379,2921,3938,3801,2296,24308,7147,17161,7147,3370,3777,2018-01-01,zipcode,Kissimmee
ZCTA5 34748,12,39230,43969,894,150200,33447,21166,31016,3606,11765,9753,3613,2279,20941,17577,3364,17577,12666,4911,2018-01-01,zipcode,Leesburg
ZCTA5 34753,12,5818,43750,1001,121900,4448,1868,3907,837,1676,1160,148,86,1828,1783,45,1783,1430,353,2018-01-01,zipcode,Mascotte
ZCTA5 34756,12,3704,70565,1057,253800,2895,990,2352,196,541,954,442,219,1429,1238,191,1238,1018,220,2018-01-01,zipcode,Montverde
ZCTA5 34758,12,41094,49329,1207,164200,31850,12528,25661,4001,9908,7809,2610,1333,12914,10311,2603,10311,7065,3246,2018-01-01,zipcode,Kissimmee
ZCTA5 34759,12,39850,50952,1243,173100,30757,15981,26139,4788,7677,8031,3792,1851,15234,11633,3601,11633,8679,2954,2018-01-01,zipcode,Kissimmee
ZCTA5 34760,12,874,62614,973,208200,678,160,612,54,226,249,75,8,332,290,42,290,223,67,2018-01-01,zipcode,Oakland
ZCTA5 34761,12,45639,63923,1267,223900,34732,11016,30166,4213,6661,8774,7183,3335,16271,15349,922,15349,10338,5011,2018-01-01,zipcode,Ocoee
ZCTA5 34762,12,484,60781,-666666666,77600,470,243,442,108,240,66,12,16,269,230,39,230,230,0,2018-01-01,zipcode,Okahumpka
ZCTA5 34769,12,25018,45951,985,141800,19689,8090,17156,2519,6237,5839,1922,639,10222,8159,2063,8159,5278,2881,2018-01-01,zipcode,Saint cloud
ZCTA5 34771,12,17351,72769,1139,269500,13999,6064,11468,984,3723,4029,1936,796,6609,5265,1344,5265,4689,576,2018-01-01,zipcode,Saint cloud
ZCTA5 34772,12,30746,66652,1397,210800,23250,8441,20042,2137,6194,7787,2916,1008,10615,8659,1956,8659,7220,1439,2018-01-01,zipcode,Saint cloud
ZCTA5 34773,12,3771,64529,1113,180000,2577,1219,2183,295,492,770,433,193,1535,994,541,994,755,239,2018-01-01,zipcode,Saint cloud
ZCTA5 34785,12,34933,59268,871,277900,33308,25707,31936,3334,9841,9247,5139,4375,17080,13482,3598,13482,11715,1767,2018-01-01,zipcode,Wildwood
ZCTA5 34786,12,43458,102375,1756,438800,31562,9745,27566,803,3048,6540,11273,5902,15410,13908,1502,13908,10026,3882,2018-01-01,zipcode,Windermere
ZCTA5 34787,12,64723,70723,1137,292800,49886,16187,42919,4339,9708,11312,11089,6471,24301,21956,2345,21956,15547,6409,2018-01-01,zipcode,Winter garden
ZCTA5 34788,12,16886,42605,1004,76400,14920,8685,14094,1393,5405,4879,1590,827,9673,7810,1863,7810,6520,1290,2018-01-01,zipcode,Leesburg
ZCTA5 34797,12,1084,79056,-666666666,167000,977,489,927,0,394,326,91,116,641,421,220,421,406,15,2018-01-01,zipcode,Yalaha
ZCTA5 34945,12,5019,46576,1075,177600,4296,2491,3703,968,1139,1057,349,190,1779,1438,341,1438,1257,181,2018-01-01,zipcode,Fort pierce
ZCTA5 34946,12,5950,30657,815,80300,5022,2539,4175,745,1545,1328,419,138,2968,2258,710,2258,1488,770,2018-01-01,zipcode,Fort pierce
ZCTA5 34947,12,13188,32818,949,99800,9800,3872,8122,1711,3640,1874,559,338,4798,3991,807,3991,1500,2491,2018-01-01,zipcode,Fort pierce
ZCTA5 34949,12,7429,63718,1200,270000,7171,4902,6911,274,1595,2230,1618,1194,7856,4048,3808,4048,3305,743,2018-01-01,zipcode,Fort pierce
ZCTA5 34950,12,17027,25278,792,84200,12996,5816,10972,3313,3864,2745,801,249,7393,5915,1478,5915,2439,3476,2018-01-01,zipcode,Fort pierce
ZCTA5 34951,12,15978,42272,949,101600,14105,7406,12651,1772,4766,3848,1410,855,8642,6982,1660,6982,5938,1044,2018-01-01,zipcode,Fort pierce
ZCTA5 34952,12,40063,44462,1190,123800,34657,16425,31239,3165,10958,11353,4080,1683,21172,16892,4280,16892,11559,5333,2018-01-01,zipcode,Port saint lucie
ZCTA5 34953,12,69685,61171,1344,184600,54118,17818,45512,6890,14957,15495,5875,2295,23854,21593,2261,21593,17509,4084,2018-01-01,zipcode,Port saint lucie
ZCTA5 34956,12,10057,39282,824,81700,7735,4130,6515,2381,2146,1513,316,159,2627,2153,474,2153,1433,720,2018-01-01,zipcode,Indiantown
ZCTA5 34957,12,23078,54349,1103,234200,20737,11223,19051,1108,5974,5875,3783,2311,17602,10772,6830,10772,8326,2446,2018-01-01,zipcode,Jensen beach
ZCTA5 34972,12,20496,37151,693,87100,16343,8758,13667,4379,5078,2788,1065,357,7245,5663,1582,5663,3651,2012,2018-01-01,zipcode,Okeechobee
ZCTA5 34974,12,24163,41952,780,90900,20206,10843,18039,3211,7214,5515,1577,522,14156,9779,4377,9779,7654,2125,2018-01-01,zipcode,Okeechobee
ZCTA5 34981,12,5139,52841,998,230500,4226,1822,3664,380,1586,971,368,359,2139,1805,334,1805,1067,738,2018-01-01,zipcode,Fort pierce
ZCTA5 34982,12,25981,37947,1014,104400,21151,10209,18354,3408,6840,5320,1795,991,11300,10036,1264,10036,6912,3124,2018-01-01,zipcode,Fort pierce
ZCTA5 34983,12,42737,54359,1376,164100,34880,15068,30515,3818,10972,10612,3183,1930,15268,13795,1473,13795,10723,3072,2018-01-01,zipcode,Port saint lucie
ZCTA5 34984,12,15663,61667,1342,167000,12997,4556,11422,1330,3418,4434,1471,769,6185,5512,673,5512,4511,1001,2018-01-01,zipcode,Port saint lucie
ZCTA5 34986,12,26317,54167,1347,228300,22148,14210,20251,2247,5506,5567,4160,2771,13613,11362,2251,11362,8692,2670,2018-01-01,zipcode,Port saint lucie
ZCTA5 34987,12,8660,72581,1766,267000,6898,3881,6463,325,1438,2165,1557,978,3900,3361,539,3361,2413,948,2018-01-01,zipcode,Port saint lucie
ZCTA5 34990,12,30101,79817,1526,347900,25708,12488,22972,1247,4290,7707,6177,3551,13759,11919,1840,11919,10299,1620,2018-01-01,zipcode,Palm city
ZCTA5 34994,12,16909,45905,1061,170000,14208,6798,12590,1239,3299,4511,2186,1355,9380,6961,2419,6961,4210,2751,2018-01-01,zipcode,Stuart
ZCTA5 34996,12,11119,65798,1176,275200,10029,5757,9567,441,2123,2948,2162,1893,8723,5598,3125,5598,4621,977,2018-01-01,zipcode,Stuart
ZCTA5 34997,12,44018,54215,1109,236900,37341,16609,33749,3711,9206,11616,5972,3244,21004,17670,3334,17670,13629,4041,2018-01-01,zipcode,Stuart
ZCTA5 35004,01,11762,60822,905,155700,9009,2697,7822,432,2573,3283,1128,406,4700,4533,167,4533,3544,989,2018-01-01,zipcode,Moody
ZCTA5 35005,01,7528,47490,921,94300,5851,2673,5230,914,1873,1626,639,178,3144,2663,481,2663,1943,720,2018-01-01,zipcode,Adamsville
ZCTA5 35006,01,2927,45743,819,84200,2346,1323,2009,290,954,568,122,75,1555,1084,471,1084,897,187,2018-01-01,zipcode,Adger
ZCTA5 35007,01,26328,71173,978,165000,19788,6879,17257,2142,4385,5572,3318,1840,9710,8979,731,8979,7232,1747,2018-01-01,zipcode,Alabaster
ZCTA5 35010,01,20625,38584,630,104600,16652,8151,14495,3189,4430,4476,1588,812,10427,8312,2115,8312,5640,2672,2018-01-01,zipcode,Alexander city
ZCTA5 35013,01,40,-666666666,-666666666,-666666666,40,40,40,40,0,0,0,0,20,15,5,15,8,7,2018-01-01,zipcode,Allgood
ZCTA5 35014,01,4780,46709,981,86700,4079,2590,3688,773,1456,1031,203,225,1964,1698,266,1698,1470,228,2018-01-01,zipcode,Alpine
ZCTA5 35016,01,16112,43863,580,130600,13136,5983,11330,1344,3390,4126,1606,864,7313,6381,932,6381,4786,1595,2018-01-01,zipcode,Arab
ZCTA5 35019,01,1991,30441,708,124100,1616,902,1404,212,662,384,132,14,963,820,143,820,640,180,2018-01-01,zipcode,Baileyton
ZCTA5 35020,01,26345,29067,731,67400,20925,9498,17688,3301,6884,5547,1441,515,13018,10018,3000,10018,5142,4876,2018-01-01,zipcode,Bessemer
ZCTA5 35022,01,20271,58195,893,173000,16759,6168,14523,1271,4202,4616,2962,1472,8912,8137,775,8137,6556,1581,2018-01-01,zipcode,Bessemer
ZCTA5 35023,01,24293,53013,867,114800,19378,8983,16514,2270,6482,5476,1444,842,9334,8333,1001,8333,6167,2166,2018-01-01,zipcode,Bessemer
ZCTA5 35031,01,8060,43663,575,115100,6492,3575,5426,1342,1823,1677,352,232,3619,2845,774,2845,2014,831,2018-01-01,zipcode,Blountsville
ZCTA5 35032,01,44,29250,-666666666,73300,35,22,35,4,17,9,0,5,18,17,1,17,14,3,2018-01-01,zipcode,Bon air
ZCTA5 35033,01,3107,37548,615,115100,2525,1261,2126,435,657,743,149,142,1619,1233,386,1233,1049,184,2018-01-01,zipcode,Bremen
ZCTA5 35034,01,6030,34408,778,62800,4898,3615,3954,1135,1697,770,282,70,1553,1081,472,1081,773,308,2018-01-01,zipcode,Brent
ZCTA5 35035,01,1179,86750,-666666666,126300,1096,464,942,42,505,184,144,67,678,389,289,389,389,0,2018-01-01,zipcode,Brierfield
ZCTA5 35036,01,367,16150,243,81300,214,69,159,53,70,22,14,0,153,129,24,129,28,101,2018-01-01,zipcode,Brookside
ZCTA5 35040,01,17141,63763,993,145300,12869,3742,11290,936,3097,3973,2268,1016,6980,6275,705,6275,5139,1136,2018-01-01,zipcode,Calera
ZCTA5 35042,01,5961,49719,634,120600,4986,2039,4438,507,2060,1313,297,261,2620,2211,409,2211,1589,622,2018-01-01,zipcode,Centreville
ZCTA5 35043,01,11461,87398,1556,231900,8424,2798,7382,257,1415,2520,2245,945,3909,3671,238,3671,3440,231,2018-01-01,zipcode,Chelsea
ZCTA5 35044,01,7351,38560,537,95800,5785,2503,4895,944,2036,1592,222,101,3327,2994,333,2994,1848,1146,2018-01-01,zipcode,Childersburg
ZCTA5 35045,01,14778,45323,682,113500,11969,5486,10417,1737,4435,2627,1042,576,6649,5748,901,5748,4113,1635,2018-01-01,zipcode,Clanton
ZCTA5 35046,01,4641,46831,674,121400,3640,1749,3308,577,1354,785,393,199,2677,1935,742,1935,1532,403,2018-01-01,zipcode,Clanton
ZCTA5 35049,01,3366,46250,593,125600,2733,1214,2338,490,818,742,155,133,1583,1288,295,1288,1088,200,2018-01-01,zipcode,Cleveland
ZCTA5 35051,01,9000,47460,626,150600,7334,3810,6281,1147,2450,1276,903,505,3560,3102,458,3102,2415,687,2018-01-01,zipcode,Columbiana
ZCTA5 35052,01,275,-666666666,-666666666,-666666666,275,226,275,86,80,80,29,0,19,19,0,19,0,19,2018-01-01,zipcode,Cook springs
ZCTA5 35053,01,2519,50577,891,164200,2189,1281,1957,397,569,534,302,155,2735,924,1811,924,840,84,2018-01-01,zipcode,Crane hill
ZCTA5 35054,01,3777,45469,604,169800,3152,1804,2765,493,1160,580,366,166,2139,1655,484,1655,1450,205,2018-01-01,zipcode,Cropwell
ZCTA5 35055,01,20884,42252,627,126300,16258,7090,13871,2479,4551,4000,1801,1040,8812,7837,975,7837,4881,2956,2018-01-01,zipcode,Cullman
ZCTA5 35057,01,13542,51868,732,147900,10644,4348,9159,1643,3147,3087,867,415,6086,4773,1313,4773,3915,858,2018-01-01,zipcode,Cullman
ZCTA5 35058,01,9234,41788,677,123300,7477,3519,6798,1216,2585,2159,549,289,4208,3577,631,3577,2674,903,2018-01-01,zipcode,Cullman
ZCTA5 35060,01,332,22961,-666666666,45200,294,214,273,85,126,46,0,16,271,161,110,161,138,23,2018-01-01,zipcode,Docena
ZCTA5 35061,01,1212,39313,1003,76800,1004,378,847,189,166,417,72,3,563,417,146,417,270,147,2018-01-01,zipcode,Dolomite
ZCTA5 35062,01,7631,48125,766,113300,6064,2823,5222,863,1759,1683,493,424,3362,2928,434,2928,2511,417,2018-01-01,zipcode,Dora
ZCTA5 35063,01,3671,45260,799,81200,2961,1636,2633,617,925,933,104,54,1771,1303,468,1303,1179,124,2018-01-01,zipcode,Empire
ZCTA5 35064,01,11171,37199,721,97100,9168,3974,7329,847,2250,2894,942,396,5574,4514,1060,4514,2616,1898,2018-01-01,zipcode,Fairfield
ZCTA5 35068,01,8072,57723,948,149100,6381,2060,5407,602,1643,1885,874,403,3535,3315,220,3315,2261,1054,2018-01-01,zipcode,Fultondale
ZCTA5 35070,01,258,34063,779,103800,182,84,152,42,51,59,0,0,103,94,9,94,68,26,2018-01-01,zipcode,Garden city
ZCTA5 35071,01,16181,66928,960,166400,12921,4882,11169,672,3580,3828,1887,1202,6920,6316,604,6316,5034,1282,2018-01-01,zipcode,Gardendale
ZCTA5 35072,01,4901,42011,498,80300,3943,1919,3510,729,1392,1045,219,125,2624,1855,769,1855,1521,334,2018-01-01,zipcode,Goodwater
ZCTA5 35073,01,2396,43281,802,85400,1988,1029,1725,306,731,538,119,31,1141,956,185,956,760,196,2018-01-01,zipcode,Graysville
ZCTA5 35074,01,0,-666666666,-666666666,-666666666,0,0,0,0,0,0,0,0,0,0,0,0,0,0,2018-01-01,zipcode,Green pond
ZCTA5 35077,01,13547,40411,649,106000,11171,5761,9519,1794,3246,3442,705,332,5984,4951,1033,4951,3711,1240,2018-01-01,zipcode,Hanceville
ZCTA5 35078,01,1919,56833,730,161600,1585,687,1409,274,531,407,122,75,892,722,170,722,598,124,2018-01-01,zipcode,Harpersville
ZCTA5 35079,01,9267,55265,646,128200,7429,3517,6406,814,2519,2329,481,263,3731,3197,534,3197,2935,262,2018-01-01,zipcode,Hayden
ZCTA5 35080,01,17889,87346,1188,183400,13217,3653,11456,456,1886,3516,3917,1681,6453,6261,192,6261,5730,531,2018-01-01,zipcode,Helena
ZCTA5 35082,01,0,-666666666,-666666666,-666666666,0,0,0,0,0,0,0,0,9,0,9,0,0,0,2018-01-01,zipcode,Hollins
ZCTA5 35083,01,3353,34637,721,104600,2587,1482,2261,510,903,651,172,25,1438,1294,144,1294,1009,285,2018-01-01,zipcode,Holly pond
ZCTA5 35085,01,9116,38943,731,83700,7145,3025,5936,1133,2615,1539,394,255,3630,3270,360,3270,2551,719,2018-01-01,zipcode,Jemison
ZCTA5 35087,01,2253,28534,689,95600,1898,949,1642,319,548,681,24,70,1070,956,114,956,560,396,2018-01-01,zipcode,Joppa
ZCTA5 35089,01,2034,30306,594,89800,1862,903,1631,359,640,504,92,36,996,793,203,793,653,140,2018-01-01,zipcode,Kellyton
ZCTA5 35091,01,3072,86250,872,190700,2198,629,1921,134,676,633,271,207,1119,1028,91,1028,945,83,2018-01-01,zipcode,Kimberly
ZCTA5 35094,01,14438,58988,812,162700,11263,4318,10039,1287,2907,3193,1785,867,6276,5571,705,5571,4343,1228,2018-01-01,zipcode,Leeds
ZCTA5 35096,01,7610,54808,866,107800,6497,2504,5641,964,1845,1798,719,315,4059,2988,1071,2988,2409,579,2018-01-01,zipcode,Lincoln
ZCTA5 35097,01,2004,49063,782,111600,1550,851,1375,278,604,365,81,47,664,648,16,648,541,107,2018-01-01,zipcode,Locust fork
ZCTA5 35098,01,1068,36250,-666666666,87800,845,395,753,154,232,265,39,63,616,451,165,451,438,13,2018-01-01,zipcode,Logan
ZCTA5 35111,01,16893,76288,728,194800,13949,4998,11819,1025,3920,4064,1945,865,6768,6044,724,6044,5193,851,2018-01-01,zipcode,Mc calla
ZCTA5 35112,01,280,-666666666,-666666666,-666666666,240,125,240,10,151,79,0,0,202,136,66,136,122,14,2018-01-01,zipcode,Margaret
ZCTA5 35114,01,8624,82102,1096,192900,6757,2018,5670,422,921,1822,1501,1004,3218,3075,143,3075,2619,456,2018-01-01,zipcode,Alabaster
ZCTA5 35115,01,15105,40514,751,124500,12466,5294,9156,1440,3579,2328,1177,632,6007,5405,602,5405,3670,1735,2018-01-01,zipcode,Montevallo
ZCTA5 35116,01,4372,62544,853,153600,3572,1435,3167,270,1131,1112,487,167,1857,1718,139,1718,1410,308,2018-01-01,zipcode,Morris
ZCTA5 35117,01,5235,70982,726,158900,4205,1408,3646,296,1174,1369,605,202,2145,2019,126,2019,1806,213,2018-01-01,zipcode,Mount olive
ZCTA5 35118,01,3040,56983,744,129400,2442,1166,2194,363,862,742,120,107,1312,1110,202,1110,914,196,2018-01-01,zipcode,Mulga
ZCTA5 35119,01,259,-666666666,-666666666,-666666666,197,67,197,106,40,51,0,0,78,78,0,78,51,27,2018-01-01,zipcode,New castle
ZCTA5 35120,01,14055,61161,688,145400,10873,3639,9059,1443,3155,2906,1026,529,5596,5009,587,5009,4165,844,2018-01-01,zipcode,Odenville
ZCTA5 35121,01,15426,46847,695,131600,12454,6348,10550,2533,3054,3553,890,520,6520,5710,810,5710,3840,1870,2018-01-01,zipcode,Oneonta
ZCTA5 35124,01,24438,75701,1062,186600,19570,5816,16849,1363,2990,5760,4424,2312,10009,9292,717,9292,7699,1593,2018-01-01,zipcode,Pelham
ZCTA5 35125,01,10941,40560,712,120500,9117,4102,8185,1734,3035,2480,620,316,5009,4405,604,4405,2822,1583,2018-01-01,zipcode,Pell city
ZCTA5 35126,01,20825,64349,978,145600,16891,6275,14308,1332,4866,5472,1844,794,8138,7600,538,7600,6383,1217,2018-01-01,zipcode,Pinson
ZCTA5 35127,01,10185,69524,1162,154400,8404,3134,7137,504,2201,2800,993,639,4094,3745,349,3745,3306,439,2018-01-01,zipcode,Pleasant grove
ZCTA5 35128,01,10651,60046,795,169100,8719,3181,7581,938,2532,2543,1133,435,5001,4291,710,4291,3104,1187,2018-01-01,zipcode,Pell city
ZCTA5 35130,01,2892,38333,479,76300,2329,1093,2029,468,938,489,76,58,1714,1232,482,1232,956,276,2018-01-01,zipcode,Quinton
ZCTA5 35131,01,4332,38906,607,122400,3413,1753,2863,605,1251,700,171,136,1820,1507,313,1507,1135,372,2018-01-01,zipcode,Ragland
ZCTA5 35133,01,3690,50517,522,123400,2795,1503,2597,287,967,990,256,97,1652,1366,286,1366,1274,92,2018-01-01,zipcode,Remlap
ZCTA5 35135,01,2128,54138,745,184500,1575,445,1454,116,451,647,157,83,951,792,159,792,581,211,2018-01-01,zipcode,Riverside
ZCTA5 35136,01,2076,41184,281,118300,1736,939,1524,253,472,580,162,57,1246,786,460,786,638,148,2018-01-01,zipcode,Rockford
ZCTA5 35139,01,170,-666666666,-666666666,20300,148,99,148,103,39,6,0,0,77,77,0,77,71,6,2018-01-01,zipcode,Sayre
ZCTA5 35143,01,3183,55500,608,162900,2585,1226,2360,364,842,699,365,90,2225,1236,989,1236,1139,97,2018-01-01,zipcode,Shelby
ZCTA5 35146,01,11870,66969,684,176800,9551,4431,8658,1290,3058,2292,1397,621,4107,3616,491,3616,3243,373,2018-01-01,zipcode,Springville
ZCTA5 35147,01,6094,77007,1284,184400,4645,1497,4088,435,862,1350,1003,438,2427,2177,250,2177,1888,289,2018-01-01,zipcode,Sterrett
ZCTA5 35148,01,2444,38828,522,103000,1949,957,1686,230,664,684,90,18,1176,995,181,995,686,309,2018-01-01,zipcode,Sumiton
ZCTA5 35149,01,413,41139,-666666666,114700,413,139,271,95,154,22,0,0,222,181,41,181,141,40,2018-01-01,zipcode,Sycamore
ZCTA5 35150,01,17448,32496,596,93900,13559,6454,11768,2207,4253,3753,1098,457,8529,6971,1558,6971,4455,2516,2018-01-01,zipcode,Sylacauga
ZCTA5 35151,01,7516,41797,713,98600,6135,3319,5181,1093,1656,1566,538,328,3778,2838,940,2838,2435,403,2018-01-01,zipcode,Sylacauga
ZCTA5 35160,01,26312,34666,569,90900,21896,11681,18645,3897,6595,5592,1477,1084,12347,10087,2260,10087,6654,3433,2018-01-01,zipcode,Talladega
ZCTA5 35171,01,3679,48646,658,105500,2850,1374,2351,505,960,476,311,99,1504,1316,188,1316,1091,225,2018-01-01,zipcode,Thorsby
ZCTA5 35172,01,3177,29811,668,74400,2642,1397,2393,639,979,595,140,40,1384,1226,158,1226,797,429,2018-01-01,zipcode,Trafford
ZCTA5 35173,01,27371,85378,1102,229300,20795,7598,18499,1230,4182,6301,4414,2372,10060,9430,630,9430,8508,922,2018-01-01,zipcode,Trussville
ZCTA5 35175,01,5714,51411,633,117500,4413,2047,3887,852,1292,1092,374,277,2485,2008,477,2008,1720,288,2018-01-01,zipcode,Union grove
ZCTA5 35176,01,902,-666666666,715,64100,729,285,563,212,207,104,32,8,371,349,22,349,234,115,2018-01-01,zipcode,Vandiver
ZCTA5 35178,01,3814,39145,615,87400,2802,1270,2317,406,757,923,181,50,1631,1331,300,1331,1163,168,2018-01-01,zipcode,Vincent
ZCTA5 35179,01,8929,44859,705,132300,7076,3015,6240,1163,2576,1911,342,248,3784,3310,474,3310,2749,561,2018-01-01,zipcode,Vinemont
ZCTA5 35180,01,14092,58968,589,139600,11199,5053,9728,1142,3857,3320,940,469,5616,5164,452,5164,4444,720,2018-01-01,zipcode,Warrior
ZCTA5 35183,01,1062,56512,-666666666,77300,892,301,801,114,401,276,0,10,363,310,53,310,297,13,2018-01-01,zipcode,Weogufka
ZCTA5 35184,01,4356,41639,713,86400,3498,1921,3204,683,1436,630,319,136,2413,1652,761,1652,1276,376,2018-01-01,zipcode,West blocton
ZCTA5 35186,01,5092,62670,931,170600,4311,1959,3729,416,1355,1162,496,300,2340,2013,327,2013,1699,314,2018-01-01,zipcode,Wilsonville
ZCTA5 35187,01,5,-666666666,-666666666,-666666666,5,5,5,0,0,5,0,0,10,3,7,3,3,0,2018-01-01,zipcode,Wilton
ZCTA5 35188,01,4001,60739,837,115000,3104,1307,2590,212,1439,740,155,44,1238,1110,128,1110,882,228,2018-01-01,zipcode,Woodstock
ZCTA5 35203,01,2996,16617,562,201600,2901,1726,2529,615,808,477,347,282,1819,1574,245,1574,294,1280,2018-01-01,zipcode,Birmingham
ZCTA5 35204,01,9399,21425,577,63000,7923,4048,6894,1561,2441,1970,598,324,6005,4397,1608,4397,1506,2891,2018-01-01,zipcode,Birmingham
ZCTA5 35205,01,20109,36391,765,182300,17991,6021,13368,916,2344,3351,4020,2737,12548,9489,3059,9489,2601,6888,2018-01-01,zipcode,Birmingham
ZCTA5 35206,01,17350,32807,809,78300,13782,5627,11996,2045,4287,3964,1210,490,8558,6722,1836,6722,3458,3264,2018-01-01,zipcode,Birmingham
ZCTA5 35207,01,9102,24419,549,60400,6651,3380,5751,1229,1935,1800,489,298,4538,3514,1024,3514,1977,1537,2018-01-01,zipcode,Birmingham
ZCTA5 35208,01,13864,33020,861,71700,10639,4840,9090,1111,3299,3623,782,275,7076,5426,1650,5426,2806,2620,2018-01-01,zipcode,Birmingham
ZCTA5 35209,01,27768,56525,954,326200,22444,6208,17449,749,2401,3919,5372,5008,15370,12335,3035,12335,5847,6488,2018-01-01,zipcode,Birmingham
ZCTA5 35210,01,13484,51623,917,140000,11239,4181,10001,1188,2715,2490,2412,1196,6553,5961,592,5961,4026,1935,2018-01-01,zipcode,Birmingham
ZCTA5 35211,01,24594,31396,775,79400,20364,8414,17492,2794,4751,5971,2630,1346,15159,11437,3722,11437,5222,6215,2018-01-01,zipcode,Birmingham
ZCTA5 35212,01,11896,29171,576,132100,9222,3675,7888,1191,2614,2335,1083,665,6202,4859,1343,4859,2169,2690,2018-01-01,zipcode,Birmingham
ZCTA5 35213,01,13516,113472,1335,530600,10505,3611,9278,40,592,1200,4281,3165,6102,5559,543,5559,4230,1329,2018-01-01,zipcode,Birmingham
ZCTA5 35214,01,18264,47385,782,102500,14962,6689,13174,1114,3881,4954,2209,1016,8671,7307,1364,7307,5258,2049,2018-01-01,zipcode,Birmingham
ZCTA5 35215,01,48483,41787,850,100300,35324,12584,29606,3660,9730,10996,3667,1553,20673,18078,2595,18078,9897,8181,2018-01-01,zipcode,Birmingham
ZCTA5 35216,01,37546,60650,1005,274400,28404,7432,24845,1314,3851,6420,7838,5422,16699,15117,1582,15117,8097,7020,2018-01-01,zipcode,Birmingham
ZCTA5 35217,01,13286,33387,697,76800,10718,4926,9246,1701,3806,2602,856,281,6146,4889,1257,4889,2731,2158,2018-01-01,zipcode,Birmingham
ZCTA5 35218,01,7178,26506,759,65200,5515,2347,4815,631,1646,2129,315,94,3808,2928,880,2928,1210,1718,2018-01-01,zipcode,Birmingham
ZCTA5 35221,01,4803,35691,828,65100,3984,1893,3371,475,1345,1062,327,162,2531,1828,703,1828,1206,622,2018-01-01,zipcode,Birmingham
ZCTA5 35222,01,9033,60989,730,231100,7427,2406,6645,602,1030,1542,1964,1507,4671,4077,594,4077,2254,1823,2018-01-01,zipcode,Birmingham
ZCTA5 35223,01,11251,131295,1616,490000,8861,3488,7802,41,224,1280,3073,3184,4492,4152,340,4152,3568,584,2018-01-01,zipcode,Birmingham
ZCTA5 35224,01,5168,34435,781,64100,4154,1638,3512,404,1258,1497,303,50,2855,2079,776,2079,1296,783,2018-01-01,zipcode,Birmingham
ZCTA5 35226,01,35542,100686,1200,265200,27092,7902,24529,516,3152,5118,8750,6993,14264,13344,920,13344,10552,2792,2018-01-01,zipcode,Birmingham
ZCTA5 35228,01,10349,32943,867,68400,8609,3512,7389,1142,2806,2425,852,164,4829,4083,746,4083,2490,1593,2018-01-01,zipcode,Birmingham
ZCTA5 35229,01,1219,-666666666,-666666666,-666666666,1219,785,0,0,0,0,0,0,0,0,0,0,0,0,2018-01-01,zipcode,Birmingham
ZCTA5 35233,01,1715,41500,1213,185900,1631,725,997,48,106,160,331,352,1317,864,453,864,119,745,2018-01-01,zipcode,Birmingham
ZCTA5 35234,01,5450,26008,592,61300,4753,2527,4320,1021,1356,1548,318,77,2691,1977,714,1977,925,1052,2018-01-01,zipcode,Birmingham
ZCTA5 35235,01,20926,55609,980,119800,16581,5394,14550,1515,4063,5253,2439,1280,8987,8191,796,8191,5683,2508,2018-01-01,zipcode,Birmingham
ZCTA5 35242,01,55122,91966,1097,347400,44217,14144,38505,1162,4048,10098,14754,8443,23744,21757,1987,21757,15215,6542,2018-01-01,zipcode,Birmingham
ZCTA5 35243,01,17259,82965,1210,352400,14174,4543,12633,157,869,2723,5124,3760,9020,7724,1296,7724,4708,3016,2018-01-01,zipcode,Birmingham
ZCTA5 35244,01,31930,86971,1121,293600,25738,7314,22462,854,2656,5650,8307,4995,13753,12609,1144,12609,8636,3973,2018-01-01,zipcode,Birmingham
ZCTA5 35254,01,1574,20057,659,83800,1553,1082,249,45,151,25,0,28,213,189,24,189,63,126,2018-01-01,zipcode,Birmingham
ZCTA5 35401,01,37194,25147,781,110600,32632,18740,16286,3139,5487,3828,2060,1772,18172,11118,7054,11118,3740,7378,2018-01-01,zipcode,Tuscaloosa
ZCTA5 35404,01,22783,40616,881,133000,19058,7140,13550,1661,4513,4046,2279,1051,10971,8105,2866,8105,4145,3960,2018-01-01,zipcode,Tuscaloosa
ZCTA5 35405,01,45473,56240,851,169400,36415,12295,29368,2315,8001,9229,6372,3451,20012,17060,2952,17060,9691,7369,2018-01-01,zipcode,Tuscaloosa
ZCTA5 35406,01,17190,102403,1042,341400,13014,4569,11632,414,867,2039,4357,3955,7552,6576,976,6576,5152,1424,2018-01-01,zipcode,Tuscaloosa
ZCTA5 35441,01,1089,40865,579,67900,836,434,713,116,295,199,68,35,829,403,426,403,351,52,2018-01-01,zipcode,Akron
ZCTA5 35442,01,6237,30332,550,93400,5283,3144,4591,1147,1357,1431,506,150,2432,1857,575,1857,1356,501,2018-01-01,zipcode,Aliceville
ZCTA5 35443,01,2157,14983,608,34300,1524,951,1014,172,624,184,22,12,1176,611,565,611,360,251,2018-01-01,zipcode,Boligee
ZCTA5 35444,01,3962,50875,806,107600,3257,1357,2672,516,965,841,277,73,1534,1415,119,1415,1121,294,2018-01-01,zipcode,Brookwood
ZCTA5 35446,01,2081,45250,854,123000,1637,780,1423,266,550,414,128,65,806,730,76,730,602,128,2018-01-01,zipcode,Buhl
ZCTA5 35447,01,2898,33750,403,96600,2315,1099,1945,393,731,594,181,46,1659,1146,513,1146,838,308,2018-01-01,zipcode,Carrollton
ZCTA5 35452,01,3061,52589,870,170700,2529,1208,2249,362,866,666,199,156,1302,1104,198,1104,910,194,2018-01-01,zipcode,Coker
ZCTA5 35453,01,10863,56044,775,138400,8305,3321,7183,1403,2819,2156,547,258,4503,3785,718,3785,3205,580,2018-01-01,zipcode,Cottondale
ZCTA5 35456,01,3461,53462,948,117200,2877,1078,2383,458,996,691,158,80,1425,1172,253,1172,982,190,2018-01-01,zipcode,Duncanville
ZCTA5 35457,01,0,-666666666,-666666666,-666666666,0,0,0,0,0,0,0,0,0,0,0,0,0,0,2018-01-01,zipcode,Echola
ZCTA5 35458,01,595,34167,-666666666,170100,498,198,412,42,254,68,34,14,174,174,0,174,133,41,2018-01-01,zipcode,Elrod
ZCTA5 35459,01,1304,36500,525,66200,1067,590,856,193,366,200,50,47,630,444,186,444,361,83,2018-01-01,zipcode,Emelle
ZCTA5 35460,01,864,22163,625,97900,806,468,596,62,170,219,91,54,480,362,118,362,274,88,2018-01-01,zipcode,Epes
ZCTA5 35461,01,2120,40104,-666666666,134100,1752,907,1539,203,612,564,89,71,1082,849,233,849,771,78,2018-01-01,zipcode,Ethelsville
ZCTA5 35462,01,4258,21295,611,79200,3580,2154,3405,1017,969,1052,196,171,2655,1771,884,1771,1176,595,2018-01-01,zipcode,Eutaw
ZCTA5 35463,01,1794,53897,-666666666,128100,1426,531,1301,119,478,453,230,21,750,704,46,704,615,89,2018-01-01,zipcode,Fosters
ZCTA5 35464,01,690,12500,310,-666666666,473,342,404,68,167,106,57,6,338,268,70,268,143,125,2018-01-01,zipcode,Gainesville
ZCTA5 35466,01,5567,50968,517,103500,4426,1925,3924,486,1519,1212,446,261,2633,2165,468,2165,1655,510,2018-01-01,zipcode,Gordo
ZCTA5 35469,01,188,-666666666,-666666666,-666666666,166,145,166,32,67,45,19,3,180,66,114,66,34,32,2018-01-01,zipcode,Knoxville
ZCTA5 35470,01,4676,14983,583,106500,3898,2251,2195,271,754,495,328,347,2415,1753,662,1753,901,852,2018-01-01,zipcode,Livingston
ZCTA5 35473,01,16305,64045,867,175400,12883,4717,10795,990,2823,3012,2299,1671,6847,6104,743,6104,4099,2005,2018-01-01,zipcode,Northport
ZCTA5 35474,01,6454,51228,770,126000,5103,2143,4340,649,1663,1173,550,305,2710,2238,472,2238,1841,397,2018-01-01,zipcode,Moundville
ZCTA5 35475,01,15583,77537,768,186700,12375,4078,10651,843,3408,3197,1916,1287,6293,5398,895,5398,4755,643,2018-01-01,zipcode,Northport
ZCTA5 35476,01,7473,35777,760,134000,5962,2508,5152,644,1672,1594,754,488,3273,2829,444,2829,1357,1472,2018-01-01,zipcode,Northport
ZCTA5 35477,01,171,54191,-666666666,-666666666,134,48,109,0,60,35,7,7,158,53,105,53,53,0,2018-01-01,zipcode,Panola
ZCTA5 35480,01,1330,83375,1644,181500,1122,460,1085,106,378,372,99,130,510,423,87,423,359,64,2018-01-01,zipcode,Ralph
ZCTA5 35481,01,3669,27917,429,79700,3119,1687,2624,612,1084,725,111,92,1802,1457,345,1457,970,487,2018-01-01,zipcode,Reform
ZCTA5 35490,01,4206,54202,995,114700,3076,1062,2704,550,1024,679,323,128,1671,1358,313,1358,1017,341,2018-01-01,zipcode,Vance
ZCTA5 35501,01,9644,37712,578,91500,7539,3417,6517,1251,2441,2080,440,305,4762,3693,1069,3693,2249,1444,2018-01-01,zipcode,Jasper
ZCTA5 35503,01,9074,49542,729,117000,7403,3194,6290,1140,2128,2299,503,220,4297,3473,824,3473,2639,834,2018-01-01,zipcode,Jasper
ZCTA5 35504,01,13160,50305,610,147000,10747,4849,9243,1199,3113,3050,1199,682,6150,5076,1074,5076,3927,1149,2018-01-01,zipcode,Jasper
ZCTA5 35540,01,2436,43844,365,90200,2054,1012,1790,321,751,505,120,93,1138,1041,97,1041,777,264,2018-01-01,zipcode,Addison
ZCTA5 35541,01,3390,45640,439,147300,2997,1564,2584,481,943,672,192,296,2705,1444,1261,1444,1308,136,2018-01-01,zipcode,Arley
ZCTA5 35542,01,965,36150,720,82000,884,495,739,213,286,166,74,0,581,461,120,461,431,30,2018-01-01,zipcode,Bankston
ZCTA5 35543,01,1285,32957,541,62200,999,473,790,172,310,249,28,31,489,441,48,441,316,125,2018-01-01,zipcode,Bear creek
ZCTA5 35544,01,476,45000,574,27300,383,169,365,105,109,115,31,5,326,240,86,240,168,72,2018-01-01,zipcode,Beaverton
ZCTA5 35545,01,122,30592,-666666666,30000,108,60,81,41,19,16,0,5,67,59,8,59,52,7,2018-01-01,zipcode,Belk
ZCTA5 35546,01,3801,46207,296,88200,3003,1390,2569,489,1093,627,197,163,1614,1484,130,1484,1266,218,2018-01-01,zipcode,Berry
ZCTA5 35548,01,1704,35573,400,65000,1409,739,1209,326,447,331,58,47,889,707,182,707,549,158,2018-01-01,zipcode,Brilliant
ZCTA5 35549,01,3512,34476,547,61500,2877,1613,2520,662,963,692,100,103,1735,1438,297,1438,995,443,2018-01-01,zipcode,Carbon hill
ZCTA5 35550,01,5761,40286,618,74300,4678,2397,4167,837,1694,1243,227,166,2762,2367,395,2367,1833,534,2018-01-01,zipcode,Cordova
ZCTA5 35552,01,887,34375,275,52600,639,322,500,85,202,177,36,0,392,332,60,332,311,21,2018-01-01,zipcode,Detroit
ZCTA5 35553,01,4422,34706,482,67900,3692,2046,3271,947,1255,592,335,142,2370,1596,774,1596,1320,276,2018-01-01,zipcode,Double springs
ZCTA5 35554,01,1054,33000,529,59100,856,358,760,115,384,236,25,0,549,462,87,462,374,88,2018-01-01,zipcode,Eldridge
ZCTA5 35555,01,9617,39398,573,86800,7826,3712,6751,865,2720,2027,831,308,5015,3869,1146,3869,2788,1081,2018-01-01,zipcode,Fayette
ZCTA5 35559,01,12,-666666666,-666666666,-666666666,12,0,12,12,0,0,0,0,10,6,4,6,6,0,2018-01-01,zipcode,Glen allen
ZCTA5 35563,01,4501,38114,518,106200,3719,1756,3317,538,1336,1086,194,163,2247,1837,410,1837,1357,480,2018-01-01,zipcode,Guin
ZCTA5 35564,01,2112,26594,578,97600,1731,925,1501,312,562,495,71,61,1058,925,133,925,730,195,2018-01-01,zipcode,Hackleburg
ZCTA5 35565,01,13266,34163,543,72000,10439,5011,9561,2045,3669,2937,550,360,6494,5321,1173,5321,4147,1174,2018-01-01,zipcode,Haleyville
ZCTA5 35570,01,11270,36168,522,90900,9431,4567,8205,1859,2637,2616,729,364,5679,4742,937,4742,3389,1353,2018-01-01,zipcode,Hamilton
ZCTA5 35571,01,811,43264,618,74400,719,323,619,141,178,220,53,27,529,351,178,351,288,63,2018-01-01,zipcode,Hodges
ZCTA5 35572,01,1319,31250,-666666666,195800,1061,450,886,211,256,305,67,47,968,508,460,508,467,41,2018-01-01,zipcode,Houston
ZCTA5 35574,01,1692,36649,361,103200,1407,724,1320,206,550,339,114,111,929,743,186,743,640,103,2018-01-01,zipcode,Kennedy
ZCTA5 35575,01,1043,40792,490,75800,814,402,710,174,286,164,63,23,486,433,53,433,342,91,2018-01-01,zipcode,Lynn
ZCTA5 35576,01,2958,46361,445,85200,2590,1129,2352,321,1027,713,188,103,1565,1377,188,1377,1039,338,2018-01-01,zipcode,Millport
ZCTA5 35577,01,41,-666666666,-666666666,-666666666,35,15,16,0,12,2,2,0,46,6,40,6,6,0,2018-01-01,zipcode,Natural bridge
ZCTA5 35578,01,5806,37275,542,88700,4769,2764,4172,1013,1689,1044,285,141,2684,2190,494,2190,1900,290,2018-01-01,zipcode,Nauvoo
ZCTA5 35579,01,3513,40994,462,70000,2754,1281,2490,580,1021,727,152,10,1776,1367,409,1367,1073,294,2018-01-01,zipcode,Oakman
ZCTA5 35580,01,3708,40919,615,71600,2884,1154,2541,577,917,917,42,88,1673,1383,290,1383,1150,233,2018-01-01,zipcode,Parrish
ZCTA5 35581,01,5709,37402,753,84200,4241,2258,3659,741,1007,1317,330,264,2534,2019,515,2019,1553,466,2018-01-01,zipcode,Phil campbell
ZCTA5 35582,01,4444,36850,441,84200,3273,1438,2831,633,1194,691,179,134,2002,1649,353,1649,1184,465,2018-01-01,zipcode,Red bay
ZCTA5 35584,01,387,38125,800,49100,295,165,268,64,94,99,5,6,179,134,45,134,120,14,2018-01-01,zipcode,Sipsey
ZCTA5 35585,01,1215,42414,-666666666,128900,1043,537,893,96,340,260,119,78,623,515,108,515,383,132,2018-01-01,zipcode,Spruce pine
ZCTA5 35586,01,4164,29076,393,85700,3258,1615,3014,583,1177,993,169,92,2316,1824,492,1824,1375,449,2018-01-01,zipcode,Sulligent
ZCTA5 35587,01,676,35563,-666666666,54700,602,346,496,125,206,150,1,14,411,299,112,299,289,10,2018-01-01,zipcode,Townley
ZCTA5 35592,01,4655,36299,360,73300,3657,1836,3090,584,1203,807,317,179,2325,1899,426,1899,1398,501,2018-01-01,zipcode,Vernon
ZCTA5 35593,01,1691,40885,463,84100,1329,531,1182,271,429,327,100,55,796,650,146,650,541,109,2018-01-01,zipcode,Vina
ZCTA5 35594,01,7208,38878,546,108900,5716,2720,4880,815,1669,1539,570,287,3467,2738,729,2738,2019,719,2018-01-01,zipcode,Winfield
ZCTA5 35601,01,32666,41204,647,98300,25429,12103,22217,5278,6116,6262,3344,1217,14464,12393,2071,12393,7515,4878,2018-01-01,zipcode,Decatur
ZCTA5 35603,01,31468,53396,647,168200,25802,10352,21990,2171,6009,7626,4268,1916,13938,13050,888,13050,9068,3982,2018-01-01,zipcode,Decatur
ZCTA5 35610,01,1702,41198,479,157300,1481,690,1420,229,654,333,122,82,869,785,84,785,616,169,2018-01-01,zipcode,Anderson
ZCTA5 35611,01,25744,38210,634,123300,21103,9499,17848,3827,6145,4698,2209,969,11589,9678,1911,9678,5977,3701,2018-01-01,zipcode,Athens
ZCTA5 35613,01,25577,77179,810,175400,20632,9612,18207,2472,5014,5354,3726,1641,8175,7621,554,7621,6805,816,2018-01-01,zipcode,Athens
ZCTA5 35614,01,7638,42936,690,107700,5930,2824,5145,1176,1828,1539,429,173,3045,2743,302,2743,2091,652,2018-01-01,zipcode,Athens
ZCTA5 35615,01,245,-666666666,-666666666,-666666666,245,75,245,75,0,0,170,0,143,109,34,109,91,18,2018-01-01,zipcode,Belle mina
ZCTA5 35616,01,3667,41636,702,84400,3077,1550,2681,609,908,841,142,181,2244,1605,639,1605,1309,296,2018-01-01,zipcode,Cherokee
ZCTA5 35618,01,1851,30655,422,78200,1489,834,1281,303,517,333,68,60,1111,849,262,849,558,291,2018-01-01,zipcode,Courtland
ZCTA5 35619,01,4428,50036,658,105300,3787,1816,3253,855,1075,1093,156,74,2073,1694,379,1694,1435,259,2018-01-01,zipcode,Danville
ZCTA5 35620,01,9026,53401,765,125000,7430,2942,6336,887,2411,2280,449,309,3538,3240,298,3240,2629,611,2018-01-01,zipcode,Elkmont
ZCTA5 35621,01,2951,45991,495,109600,2492,1107,2108,482,788,546,197,95,1355,1253,102,1253,1073,180,2018-01-01,zipcode,Eva
ZCTA5 35622,01,7879,52198,731,87600,6103,2618,5518,998,2108,1780,411,221,3325,2655,670,2655,2190,465,2018-01-01,zipcode,Falkville
ZCTA5 35630,01,33172,34781,642,108900,27882,12489,21021,3342,6392,6207,3161,1919,17520,14890,2630,14890,6654,8236,2018-01-01,zipcode,Florence
ZCTA5 35633,01,20747,55859,821,138900,16399,6974,14469,1686,5279,3738,2447,1319,9269,8260,1009,8260,6980,1280,2018-01-01,zipcode,Florence
ZCTA5 35634,01,9793,70996,736,177400,8423,3799,7466,534,2830,2110,1203,789,4327,3972,355,3972,3482,490,2018-01-01,zipcode,Florence
ZCTA5 35640,01,24570,55706,647,135200,19571,7898,16725,1831,5499,5868,2165,1362,10558,9210,1348,9210,7385,1825,2018-01-01,zipcode,Hartselle
ZCTA5 35643,01,3696,48568,548,115400,3208,1467,2738,856,1107,548,138,89,1628,1465,163,1465,1344,121,2018-01-01,zipcode,Hillsboro
ZCTA5 35645,01,14011,61442,631,160800,11368,5118,10013,1031,3781,2693,1434,1074,6041,5322,719,5322,4506,816,2018-01-01,zipcode,Killen
ZCTA5 35646,01,4734,42028,483,100700,3968,2089,3504,639,1553,948,137,227,2474,1857,617,1857,1410,447,2018-01-01,zipcode,Leighton
ZCTA5 35647,01,1185,46979,384,117600,1010,398,839,117,401,152,136,33,425,409,16,409,336,73,2018-01-01,zipcode,Lester
ZCTA5 35648,01,3250,49961,563,119200,2591,980,2144,300,985,488,199,172,1381,1256,125,1256,1030,226,2018-01-01,zipcode,Lexington
ZCTA5 35649,01,89,108750,-666666666,400000,72,27,71,4,5,14,29,19,34,34,0,34,34,0,2018-01-01,zipcode,Mooresville
ZCTA5 35650,01,13992,43727,537,119700,11090,5587,9746,2050,4102,2491,733,370,6088,5265,823,5265,3956,1309,2018-01-01,zipcode,Moulton
ZCTA5 35651,01,1255,33456,733,104400,985,603,841,102,499,194,30,16,543,461,82,461,347,114,2018-01-01,zipcode,Mount hope
ZCTA5 35652,01,8700,50233,718,135400,7090,3139,6180,683,2476,1807,794,420,4526,3514,1012,3514,2729,785,2018-01-01,zipcode,Rogersville
ZCTA5 35653,01,11043,42485,581,84700,8589,3630,7057,2021,2687,1552,465,332,4741,3667,1074,3667,2366,1301,2018-01-01,zipcode,Russellville
ZCTA5 35654,01,8006,41168,550,98200,6309,2660,5361,1126,2154,1425,427,229,3767,2865,902,2865,1977,888,2018-01-01,zipcode,Russellville
ZCTA5 35660,01,8986,34688,657,91600,7398,3617,6554,1296,2059,1802,902,495,5045,4045,1000,4045,2370,1675,2018-01-01,zipcode,Sheffield
ZCTA5 35661,01,16881,57127,815,145400,13837,5828,12046,1123,3941,3770,2168,1044,7520,6744,776,6744,5314,1430,2018-01-01,zipcode,Muscle shoals
ZCTA5 35670,01,6667,51495,633,119300,5435,2162,4687,625,1571,1527,702,262,3237,2570,667,2570,2113,457,2018-01-01,zipcode,Somerville
ZCTA5 35671,01,2185,-666666666,572,79000,1869,624,1571,243,726,279,225,98,1114,899,215,899,596,303,2018-01-01,zipcode,Tanner
ZCTA5 35672,01,6189,52236,568,98500,4824,2470,4161,578,1793,1180,326,284,2946,2353,593,2353,1902,451,2018-01-01,zipcode,Town creek
ZCTA5 35673,01,7720,54379,549,125300,5954,2629,5331,1017,1796,1565,713,240,3191,2726,465,2726,2286,440,2018-01-01,zipcode,Trinity
ZCTA5 35674,01,18690,51127,675,105600,14867,6688,12845,2194,4925,3855,1171,700,8493,7070,1423,7070,5066,2004,2018-01-01,zipcode,Tuscumbia
ZCTA5 35677,01,1799,38802,844,101300,1382,637,1203,174,588,259,136,46,1099,744,355,744,589,155,2018-01-01,zipcode,Waterloo
ZCTA5 35739,01,5048,51563,734,143300,3898,1245,3563,560,1208,998,526,271,2187,1956,231,1956,1514,442,2018-01-01,zipcode,Ardmore
ZCTA5 35740,01,3219,30071,478,89100,2651,1396,2280,365,956,695,200,64,1647,1435,212,1435,966,469,2018-01-01,zipcode,Bridgeport
ZCTA5 35741,01,2984,78942,946,275800,2578,1081,2196,119,386,601,656,434,1470,1323,147,1323,998,325,2018-01-01,zipcode,Brownsboro
ZCTA5 35744,01,2201,34800,418,107100,1782,948,1429,295,713,273,76,72,990,788,202,788,653,135,2018-01-01,zipcode,Dutton
ZCTA5 35745,01,188,30938,-666666666,153700,170,87,141,14,65,45,11,6,145,84,61,84,69,15,2018-01-01,zipcode,Estillfork
ZCTA5 35746,01,604,33087,-666666666,-666666666,510,287,468,192,190,72,14,0,353,259,94,259,229,30,2018-01-01,zipcode,Fackler
ZCTA5 35747,01,5231,50016,612,151600,4297,1936,3758,462,1580,1072,366,278,2658,2139,519,2139,1584,555,2018-01-01,zipcode,Grant
ZCTA5 35748,01,7257,62394,602,176600,5799,2501,5160,715,1823,1103,910,609,2888,2700,188,2700,2231,469,2018-01-01,zipcode,Gurley
ZCTA5 35749,01,22295,88455,1149,181400,17225,5403,14758,816,2955,4544,4017,2426,8790,8088,702,8088,6913,1175,2018-01-01,zipcode,Harvest
ZCTA5 35750,01,12294,50284,801,126000,10106,3690,8709,1107,3158,2689,1246,509,5594,4918,676,4918,3876,1042,2018-01-01,zipcode,Hazel green
ZCTA5 35751,01,237,18304,-666666666,212500,234,72,196,11,95,69,9,12,126,85,41,85,64,21,2018-01-01,zipcode,Hollytree
ZCTA5 35752,01,2680,45293,828,87500,2176,1174,1925,303,852,514,223,33,1148,966,182,966,809,157,2018-01-01,zipcode,Hollywood
ZCTA5 35754,01,5259,53245,549,152700,4465,1881,3940,867,932,1202,806,133,2119,1816,303,1816,1403,413,2018-01-01,zipcode,Laceys spring
ZCTA5 35755,01,686,37297,448,169900,586,237,461,49,99,178,61,74,437,259,178,259,179,80,2018-01-01,zipcode,Langston
ZCTA5 35756,01,14202,87409,1316,224300,10358,3333,8945,628,1349,2413,2701,1854,5329,4890,439,4890,4401,489,2018-01-01,zipcode,Madison
ZCTA5 35757,01,16379,92018,1063,199000,12860,4251,11049,573,1667,3230,3314,2265,6251,5895,356,5895,5073,822,2018-01-01,zipcode,Madison
ZCTA5 35758,01,45736,85353,919,233800,36560,11255,31249,1118,4025,8201,10542,7363,19323,18208,1115,18208,12111,6097,2018-01-01,zipcode,Madison
ZCTA5 35759,01,7606,87260,1153,188100,6192,1948,5271,291,1043,1922,1405,610,3029,2942,87,2942,2706,236,2018-01-01,zipcode,Meridianville
ZCTA5 35760,01,4869,49832,752,126100,3921,1535,3427,659,1324,921,418,105,2224,1893,331,1893,1485,408,2018-01-01,zipcode,New hope
ZCTA5 35761,01,12568,63528,854,154400,9957,3678,8689,1163,2343,2544,1805,834,5287,4894,393,4894,4303,591,2018-01-01,zipcode,New market
ZCTA5 35763,01,18201,110264,1179,274400,13680,5178,11956,375,1778,2606,4126,3071,6748,6519,229,6519,6066,453,2018-01-01,zipcode,Owens cross roads
ZCTA5 35764,01,497,46125,675,90000,417,220,382,103,186,75,12,6,226,203,23,203,172,31,2018-01-01,zipcode,Paint rock
ZCTA5 35765,01,3926,31192,525,91800,3306,1893,2877,651,922,878,248,178,1885,1483,402,1483,1158,325,2018-01-01,zipcode,Pisgah
ZCTA5 35766,01,123,-666666666,-666666666,129200,93,44,93,9,32,29,6,17,92,55,37,55,41,14,2018-01-01,zipcode,Princeton
ZCTA5 35768,01,11164,41854,620,99800,9291,4311,8198,1412,3295,2225,706,560,5571,4497,1074,4497,3034,1463,2018-01-01,zipcode,Scottsboro
ZCTA5 35769,01,9968,42369,638,143500,7995,3495,7172,836,2471,2214,1120,531,5220,4020,1200,4020,3008,1012,2018-01-01,zipcode,Scottsboro
ZCTA5 35771,01,3916,47639,683,114400,3083,1291,2777,568,1091,843,192,83,1606,1387,219,1387,974,413,2018-01-01,zipcode,Section
ZCTA5 35772,01,4409,32449,533,82800,3479,1827,3131,578,1475,833,174,71,2240,1789,451,1789,1235,554,2018-01-01,zipcode,Stevenson
ZCTA5 35773,01,12775,51959,846,119300,10223,3387,8903,1149,2876,2882,1349,647,5278,4807,471,4807,3715,1092,2018-01-01,zipcode,Toney
ZCTA5 35774,01,237,45833,-666666666,73000,237,158,180,20,117,29,14,0,94,82,12,82,75,7,2018-01-01,zipcode,Trenton
ZCTA5 35775,01,1083,31750,-666666666,108500,837,335,836,150,209,321,134,22,451,417,34,417,332,85,2018-01-01,zipcode,Valhermoso springs
ZCTA5 35776,01,3592,38182,613,86900,2898,1392,2434,471,1050,625,164,124,1643,1334,309,1334,1100,234,2018-01-01,zipcode,Woodville
ZCTA5 35801,01,23724,69276,832,258600,19787,9087,17391,1645,2872,4056,5168,3650,10850,9839,1011,9839,6604,3235,2018-01-01,zipcode,Huntsville
ZCTA5 35802,01,21829,67029,822,231700,18221,7142,16124,650,2372,4425,5154,3523,11601,10128,1473,10128,5966,4162,2018-01-01,zipcode,Huntsville
ZCTA5 35803,01,25710,76796,895,180100,20860,8071,18672,870,3035,4972,6133,3662,11838,11125,713,11125,8968,2157,2018-01-01,zipcode,Huntsville
ZCTA5 35805,01,21200,25329,609,75300,15759,5974,12766,3077,3834,3997,1386,472,10632,9180,1452,9180,2861,6319,2018-01-01,zipcode,Huntsville
ZCTA5 35806,01,21888,68255,945,235200,18318,5808,15455,872,1843,3852,5844,3044,11150,10343,807,10343,4873,5470,2018-01-01,zipcode,Huntsville
ZCTA5 35808,01,1445,84375,1318,-666666666,1157,205,718,11,73,307,182,145,365,330,35,330,5,325,2018-01-01,zipcode,Huntsville
ZCTA5 35810,01,29503,37879,847,85500,24149,10113,18970,3108,5648,6272,2421,1521,12706,11387,1319,11387,7311,4076,2018-01-01,zipcode,Huntsville
ZCTA5 35811,01,27658,62688,810,164100,22373,8202,19524,2178,5108,6300,3883,2055,11864,10837,1027,10837,8650,2187,2018-01-01,zipcode,Huntsville
ZCTA5 35816,01,13923,25270,682,83600,11740,4017,8234,1119,2225,2890,1368,632,7869,6517,1352,6517,1419,5098,2018-01-01,zipcode,Huntsville
ZCTA5 35824,01,8645,86222,951,230400,7084,1478,5675,161,575,1883,1556,1500,3867,3750,117,3750,1945,1805,2018-01-01,zipcode,Huntsville
ZCTA5 35896,01,700,-666666666,-666666666,-666666666,700,419,7,0,0,7,0,0,0,0,0,0,0,0,2018-01-01,zipcode,Huntsville
ZCTA5 35901,01,20049,37809,603,112300,16153,7688,13976,2529,4172,4481,1709,1085,9419,7540,1879,7540,4866,2674,2018-01-01,zipcode,Gadsden
ZCTA5 35903,01,17125,36949,679,91600,14142,6521,11615,1926,4089,3835,1098,667,8349,6503,1846,6503,4075,2428,2018-01-01,zipcode,Gadsden
ZCTA5 35904,01,14030,36763,635,68700,11462,5683,9992,1854,3497,3127,1044,470,6677,5258,1419,5258,4199,1059,2018-01-01,zipcode,Gadsden
ZCTA5 35905,01,6144,58219,592,127400,5009,2338,4634,631,1325,1728,434,516,2787,2401,386,2401,1915,486,2018-01-01,zipcode,Gadsden
ZCTA5 35906,01,9875,49419,762,159900,7896,3409,7049,534,2024,2424,1211,856,4719,4149,570,4149,2620,1529,2018-01-01,zipcode,Rainbow city
ZCTA5 35907,01,8511,71368,865,158500,7034,2645,6169,396,1423,2569,1239,542,3679,3247,432,3247,2798,449,2018-01-01,zipcode,Gadsden
ZCTA5 35950,01,21556,40945,676,104500,15666,6568,13219,3168,4067,3899,1462,623,7970,7424,546,7424,4684,2740,2018-01-01,zipcode,Albertville
ZCTA5 35951,01,12911,36473,652,95000,9702,4278,8248,2362,2851,2208,637,190,4905,4338,567,4338,2951,1387,2018-01-01,zipcode,Albertville
ZCTA5 35952,01,7482,40826,588,91000,5898,3045,5041,1207,1745,1564,362,163,3211,2691,520,2691,2121,570,2018-01-01,zipcode,Altoona
ZCTA5 35953,01,7522,50072,701,107000,5935,2794,5198,1037,1907,1834,264,156,3360,2657,703,2657,2166,491,2018-01-01,zipcode,Ashville
ZCTA5 35954,01,11818,40664,673,86100,9497,4119,8132,1344,3298,2808,348,334,5768,4359,1409,4359,3221,1138,2018-01-01,zipcode,Attalla
ZCTA5 35956,01,9161,49789,662,109200,7298,3345,6280,1006,2307,2176,448,343,3653,3256,397,3256,2679,577,2018-01-01,zipcode,Boaz
ZCTA5 35957,01,16135,38342,628,100200,12227,5582,10359,2179,3120,3346,1046,668,6546,5705,841,5705,3571,2134,2018-01-01,zipcode,Boaz
ZCTA5 35958,01,3832,43092,621,125700,3111,1697,2626,528,1014,704,260,120,1667,1545,122,1545,1152,393,2018-01-01,zipcode,Bryant
ZCTA5 35959,01,4843,40589,561,104700,3909,2076,3419,763,1377,881,241,157,3693,1995,1698,1995,1538,457,2018-01-01,zipcode,Cedar bluff
ZCTA5 35960,01,9668,42073,549,145200,8079,4243,7299,1221,2729,2201,502,646,6576,4158,2418,4158,3227,931,2018-01-01,zipcode,Centre
ZCTA5 35961,01,7003,38535,635,85900,5620,2746,4850,1454,1655,1439,200,102,2928,2489,439,2489,1683,806,2018-01-01,zipcode,Collinsville
ZCTA5 35962,01,9516,37230,675,84800,7189,3434,5965,2007,1906,1322,410,320,3589,3141,448,3141,2219,922,2018-01-01,zipcode,Crossville
ZCTA5 35963,01,1139,26637,-666666666,92600,1002,564,927,142,323,306,110,46,673,481,192,481,360,121,2018-01-01,zipcode,Dawson
ZCTA5 35966,01,3682,36432,685,96200,3125,1596,2647,690,1125,554,87,191,1743,1470,273,1470,1099,371,2018-01-01,zipcode,Flat rock
ZCTA5 35967,01,16373,39746,609,112000,12428,5344,10755,2959,3131,3093,795,777,7569,6177,1392,6177,4187,1990,2018-01-01,zipcode,Fort payne
ZCTA5 35968,01,4584,41443,580,132600,3796,1775,3219,856,1018,951,259,135,1769,1571,198,1571,1165,406,2018-01-01,zipcode,Fort payne
ZCTA5 35971,01,5428,39980,692,92000,4318,1963,3570,811,1335,1046,230,148,2262,1949,313,1949,1431,518,2018-01-01,zipcode,Fyffe
ZCTA5 35972,01,1211,58472,-666666666,107400,905,413,802,127,365,175,64,71,415,415,0,415,330,85,2018-01-01,zipcode,Gallant
ZCTA5 35973,01,2856,33011,815,88800,2339,1262,1971,584,678,515,163,31,1601,1185,416,1185,1041,144,2018-01-01,zipcode,Gaylesville
ZCTA5 35974,01,1514,28798,642,86900,1127,574,1007,294,346,204,125,38,757,641,116,641,334,307,2018-01-01,zipcode,Geraldine
ZCTA5 35975,01,463,-666666666,-666666666,-666666666,416,334,416,112,153,95,48,8,186,172,14,172,142,30,2018-01-01,zipcode,Groveoak
ZCTA5 35976,01,17252,48841,624,165100,14229,6770,12737,2051,3601,3568,2340,1177,8104,6825,1279,6825,5126,1699,2018-01-01,zipcode,Guntersville
ZCTA5 35978,01,4789,40104,605,89000,3809,1826,3514,676,1498,929,290,121,2301,1830,471,1830,1508,322,2018-01-01,zipcode,Henagar
ZCTA5 35979,01,1608,40500,-666666666,132800,1232,473,1060,185,483,322,55,15,821,678,143,678,516,162,2018-01-01,zipcode,Higdon
ZCTA5 35980,01,5154,39340,613,78500,3865,1790,3047,842,946,868,140,251,2104,1735,369,1735,1350,385,2018-01-01,zipcode,Horton
ZCTA5 35981,01,1860,39402,277,95300,1617,737,1384,170,642,446,97,29,788,673,115,673,485,188,2018-01-01,zipcode,Ider
ZCTA5 35983,01,3733,52852,732,159900,3193,1488,2769,312,1059,981,235,182,2458,1473,985,1473,1142,331,2018-01-01,zipcode,Leesburg
ZCTA5 35984,01,1573,35167,858,171700,1402,800,1365,199,340,352,341,133,1422,764,658,764,619,145,2018-01-01,zipcode,Mentone
ZCTA5 35986,01,8130,38046,591,116300,6474,2854,5545,1038,1984,2034,274,215,3664,3142,522,3142,2224,918,2018-01-01,zipcode,Rainsville
ZCTA5 35987,01,2625,39766,593,83500,2042,934,1705,314,773,481,70,67,1055,969,86,969,751,218,2018-01-01,zipcode,Steele
ZCTA5 35988,01,2192,45819,636,95200,1642,586,1363,291,465,414,119,74,805,751,54,751,545,206,2018-01-01,zipcode,Sylvania
ZCTA5 35989,01,3519,37750,608,92700,2671,1296,2266,483,842,491,235,215,1706,1329,377,1329,1043,286,2018-01-01,zipcode,Valley head
ZCTA5 35990,01,117,48214,950,-666666666,93,39,44,7,28,9,0,0,40,30,10,30,14,16,2018-01-01,zipcode,Walnut grove
ZCTA5 36003,01,1898,27841,539,83400,1728,983,1497,375,647,322,90,63,1138,913,225,913,694,219,2018-01-01,zipcode,Autaugaville
ZCTA5 36005,01,1640,46250,473,90100,1362,660,1066,195,415,279,102,75,727,502,225,502,421,81,2018-01-01,zipcode,Banks
ZCTA5 36006,01,913,47148,474,168200,848,384,739,112,300,176,50,101,546,423,123,423,359,64,2018-01-01,zipcode,Billingsley
ZCTA5 36009,01,2278,34074,439,88700,1884,907,1641,225,682,415,238,81,1261,922,339,922,674,248,2018-01-01,zipcode,Brantley
ZCTA5 36010,01,4856,36639,499,81600,4022,2010,3154,754,1290,672,287,151,2383,1656,727,1656,1178,478,2018-01-01,zipcode,Brundidge
ZCTA5 36013,01,650,103259,-666666666,422000,546,199,475,14,65,239,84,73,225,225,0,225,206,19,2018-01-01,zipcode,Cecil
ZCTA5 36016,01,4807,33142,529,78000,4273,2863,3783,1314,1458,700,232,79,1857,1439,418,1439,935,504,2018-01-01,zipcode,Clayton
ZCTA5 36017,01,2936,25288,436,54200,2508,1899,2218,705,836,526,107,44,900,649,251,649,447,202,2018-01-01,zipcode,Clio
ZCTA5 36020,01,999,42273,769,161800,802,409,681,110,214,208,107,42,411,364,47,364,278,86,2018-01-01,zipcode,Coosada
ZCTA5 36022,01,12141,67513,748,170700,9822,3773,8195,858,2713,2492,1548,584,4816,4385,431,4385,3833,552,2018-01-01,zipcode,Deatsville
ZCTA5 36024,01,4942,57970,736,145200,4160,1975,3742,454,1332,1022,630,304,2984,2011,973,2011,1583,428,2018-01-01,zipcode,Eclectic
ZCTA5 36025,01,6756,46714,903,148400,5961,4028,5194,1297,2190,1094,350,263,1478,1388,90,1388,892,496,2018-01-01,zipcode,Elmore
ZCTA5 36026,01,1002,44028,-666666666,198600,835,412,748,83,223,217,195,30,1150,437,713,437,313,124,2018-01-01,zipcode,Equality
ZCTA5 36027,01,15496,34588,618,109500,12044,5546,10397,2285,3543,2993,969,607,7747,6111,1636,6111,3431,2680,2018-01-01,zipcode,Eufaula
ZCTA5 36028,01,1674,37604,395,108300,1398,696,1192,216,415,341,136,84,956,693,263,693,583,110,2018-01-01,zipcode,Dozier
ZCTA5 36029,01,1160,44525,-666666666,156000,978,356,918,214,341,195,121,47,433,345,88,345,307,38,2018-01-01,zipcode,Fitzpatrick
ZCTA5 36030,01,645,29688,-666666666,80000,587,299,492,26,331,83,39,13,326,190,136,190,156,34,2018-01-01,zipcode,Forest home
ZCTA5 36031,01,175,31250,-666666666,66300,158,128,129,71,48,10,0,0,96,84,12,84,79,5,2018-01-01,zipcode,Fort davis
ZCTA5 36032,01,2336,35545,573,58900,1770,744,1470,291,590,361,109,119,1191,889,302,889,652,237,2018-01-01,zipcode,Fort deposit
ZCTA5 36033,01,4426,38575,575,69900,3503,1883,3063,535,1346,814,166,202,2234,1381,853,1381,978,403,2018-01-01,zipcode,Georgiana
ZCTA5 36034,01,974,40417,529,50500,782,336,603,75,243,192,36,57,435,330,105,330,296,34,2018-01-01,zipcode,Glenwood
ZCTA5 36035,01,1468,44563,638,114600,1133,423,1023,158,445,212,126,82,909,563,346,563,484,79,2018-01-01,zipcode,Goshen
ZCTA5 36036,01,1796,42250,662,94000,1599,697,1346,363,532,273,114,64,1070,766,304,766,640,126,2018-01-01,zipcode,Grady
ZCTA5 36037,01,13306,39346,622,92000,10342,4511,8966,1434,3761,2193,979,599,6513,4489,2024,4489,3019,1470,2018-01-01,zipcode,Greenville
ZCTA5 36038,01,47,33333,-666666666,156300,47,31,47,10,14,23,0,0,18,18,0,18,18,0,2018-01-01,zipcode,Gantt
ZCTA5 36039,01,240,50481,-666666666,82700,240,127,201,47,63,63,28,0,75,75,0,75,56,19,2018-01-01,zipcode,Hardaway
ZCTA5 36040,01,3584,23968,635,62600,2878,1529,2533,612,1115,484,209,113,1647,1474,173,1474,925,549,2018-01-01,zipcode,Hayneville
ZCTA5 36041,01,1401,44671,-666666666,69900,1103,466,922,208,425,232,29,28,606,455,151,455,405,50,2018-01-01,zipcode,Highland home
ZCTA5 36042,01,1774,49792,583,79100,1472,685,1328,279,639,218,136,56,827,579,248,579,511,68,2018-01-01,zipcode,Honoraville
ZCTA5 36043,01,3636,37917,1049,175800,3040,1672,2603,545,942,505,377,234,1745,1445,300,1445,1170,275,2018-01-01,zipcode,Hope hull
ZCTA5 36046,01,1413,46625,-666666666,87900,1191,562,1082,241,466,249,114,12,749,576,173,576,548,28,2018-01-01,zipcode,Lapine
ZCTA5 36047,01,1150,38710,-666666666,103700,837,425,769,136,316,202,106,9,617,470,147,470,382,88,2018-01-01,zipcode,Letohatchee
ZCTA5 36048,01,1470,35787,560,65700,1209,587,1010,391,397,163,42,17,723,513,210,513,394,119,2018-01-01,zipcode,Louisville
ZCTA5 36049,01,6067,41042,523,77500,4860,2286,4227,903,1516,943,637,228,2785,2206,579,2206,1480,726,2018-01-01,zipcode,Luverne
ZCTA5 36051,01,2106,69423,832,86000,1771,584,1588,265,682,374,146,121,912,832,80,832,665,167,2018-01-01,zipcode,Marbury
ZCTA5 36052,01,308,66563,-666666666,561500,264,119,264,7,59,79,91,28,212,157,55,157,144,13,2018-01-01,zipcode,Mathews
ZCTA5 36053,01,1790,25282,447,78300,1341,610,1196,370,330,354,87,55,1116,703,413,703,497,206,2018-01-01,zipcode,Midway
ZCTA5 36054,01,16080,58573,809,138800,12068,3961,9704,1062,2964,3110,1542,1026,6329,5823,506,5823,4060,1763,2018-01-01,zipcode,Millbrook
ZCTA5 36064,01,9780,105830,1082,288500,7336,2194,6515,329,908,1532,2112,1634,3875,3559,316,3559,3277,282,2018-01-01,zipcode,Pike road
ZCTA5 36066,01,19097,62089,1122,169700,14856,5413,13085,1076,3158,3584,2901,2366,8710,7950,760,7950,4834,3116,2018-01-01,zipcode,Prattville
ZCTA5 36067,01,28727,53578,793,129800,22329,9487,18934,2534,6693,5548,2528,1631,11262,10351,911,10351,7910,2441,2018-01-01,zipcode,Prattville
ZCTA5 36069,01,1939,44255,595,103400,1793,759,1538,324,474,365,219,156,1043,863,180,863,749,114,2018-01-01,zipcode,Ramer
ZCTA5 36071,01,457,39107,583,95000,394,194,373,140,119,83,31,0,221,155,66,155,114,41,2018-01-01,zipcode,Rutledge
ZCTA5 36075,01,2159,39500,670,85400,1778,898,1623,277,570,464,191,121,1076,880,196,880,634,246,2018-01-01,zipcode,Shorter
ZCTA5 36078,01,13178,54149,671,139800,10316,4479,8815,1534,2940,2787,1005,549,5708,4857,851,4857,3458,1399,2018-01-01,zipcode,Tallassee
ZCTA5 36079,01,10159,48438,699,131800,8162,2925,6665,887,2392,1739,1066,581,4444,3299,1145,3299,2444,855,2018-01-01,zipcode,Troy
ZCTA5 36080,01,2084,65406,-666666666,196200,1847,973,1647,147,759,398,237,106,1062,791,271,791,724,67,2018-01-01,zipcode,Titus
ZCTA5 36081,01,15894,27711,592,120800,13232,5951,8577,1990,2269,2072,1343,903,8468,6180,2288,6180,2815,3365,2018-01-01,zipcode,Troy
ZCTA5 36082,01,1271,-666666666,-666666666,-666666666,1271,1034,26,0,0,13,13,0,0,0,0,0,0,0,2018-01-01,zipcode,Troy
ZCTA5 36083,01,7542,32019,570,76900,6255,2829,5397,984,1451,1565,767,630,4752,3428,1324,3428,2189,1239,2018-01-01,zipcode,Tuskegee
ZCTA5 36088,01,4802,27743,645,81000,4231,2085,1795,318,399,611,206,261,2017,1303,714,1303,551,752,2018-01-01,zipcode,Tuskegee institute
ZCTA5 36089,01,7391,29602,675,80300,5949,2990,5027,1144,2172,1074,348,289,3184,2645,539,2645,1949,696,2018-01-01,zipcode,Union springs
ZCTA5 36091,01,3526,40125,541,79200,2883,1395,2522,410,1123,616,219,154,1797,1451,346,1451,1115,336,2018-01-01,zipcode,Verbena
ZCTA5 36092,01,19843,54499,859,138200,16241,7893,13904,2072,5083,3968,1976,805,8700,7441,1259,7441,5306,2135,2018-01-01,zipcode,Wetumpka
ZCTA5 36093,01,11147,86869,1272,237600,8498,3238,7244,332,1547,2270,1898,1197,4070,3896,174,3896,3495,401,2018-01-01,zipcode,Wetumpka
ZCTA5 36104,01,8342,23652,698,73500,6813,3688,4945,1285,1363,1170,540,587,4046,2888,1158,2888,914,1974,2018-01-01,zipcode,Montgomery
ZCTA5 36105,01,9815,30660,835,64300,8297,3947,7280,2016,2661,1749,543,311,5223,3996,1227,3996,2516,1480,2018-01-01,zipcode,Montgomery
ZCTA5 36106,01,15094,55255,974,158200,12272,4475,10048,696,1889,2734,2410,2319,6994,6245,749,6245,3526,2719,2018-01-01,zipcode,Montgomery
ZCTA5 36107,01,7688,30797,800,68900,5872,2252,4879,1198,1632,1021,583,445,4152,3101,1051,3101,1336,1765,2018-01-01,zipcode,Montgomery
ZCTA5 36108,01,18299,24690,595,64500,14456,7231,12621,3794,4152,3050,1106,519,9433,7520,1913,7520,4275,3245,2018-01-01,zipcode,Montgomery
ZCTA5 36109,01,24907,53548,937,117300,20577,8340,17262,1705,4755,5250,3505,2047,10975,10118,857,10118,7253,2865,2018-01-01,zipcode,Montgomery
ZCTA5 36110,01,11829,31305,820,58200,9232,4712,7651,2217,2648,1900,566,320,5563,4320,1243,4320,2283,2037,2018-01-01,zipcode,Montgomery
ZCTA5 36111,01,12369,49988,829,144200,9426,3211,7978,1088,2094,1967,1701,1128,5586,4841,745,4841,2712,2129,2018-01-01,zipcode,Montgomery
ZCTA5 36112,01,320,-666666666,-666666666,-666666666,320,11,157,0,31,98,0,28,0,0,0,0,0,0,2018-01-01,zipcode,Montgomery
ZCTA5 36113,01,1809,92813,1572,-666666666,1463,972,1306,93,450,395,151,217,309,274,35,274,0,274,2018-01-01,zipcode,Montgomery
ZCTA5 36115,01,964,62019,1348,-666666666,630,168,449,8,88,237,52,64,269,269,0,269,0,269,2018-01-01,zipcode,Montgomery
ZCTA5 36116,01,44556,43683,859,104500,34176,11359,27952,3861,7004,9097,4727,3263,20074,17198,2876,17198,8611,8587,2018-01-01,zipcode,Montgomery
ZCTA5 36117,01,53841,62753,974,179600,42229,13401,35466,2320,6766,10499,9485,6396,23977,22287,1690,22287,13151,9136,2018-01-01,zipcode,Montgomery
ZCTA5 36201,01,18052,28402,578,66700,14565,7243,12716,3419,4459,4000,615,223,9661,7234,2427,7234,4351,2883,2018-01-01,zipcode,Anniston
ZCTA5 36203,01,18033,54835,849,148600,14350,4991,12515,1633,3828,4312,1691,1051,7765,6970,795,6970,4700,2270,2018-01-01,zipcode,Oxford
ZCTA5 36205,01,688,59375,800,214400,585,243,443,64,57,127,66,129,290,202,88,202,126,76,2018-01-01,zipcode,Anniston
ZCTA5 36206,01,11541,44226,643,94400,9083,3866,7830,1214,2802,2601,593,620,5155,4486,669,4486,3323,1163,2018-01-01,zipcode,Anniston
ZCTA5 36207,01,19746,50809,764,143600,16154,7081,14084,1393,4350,4658,1738,1945,9743,8288,1455,8288,5871,2417,2018-01-01,zipcode,Anniston
ZCTA5 36250,01,4958,70606,906,120500,3894,1410,3479,360,949,1419,509,242,1970,1788,182,1788,1494,294,2018-01-01,zipcode,Alexandria
ZCTA5 36251,01,4895,34362,417,88800,4147,1943,3340,853,1016,1111,229,131,2438,1905,533,1905,1311,594,2018-01-01,zipcode,Ashland
ZCTA5 36255,01,871,44297,-666666666,132900,621,251,520,128,253,96,0,43,389,355,34,355,318,37,2018-01-01,zipcode,Cragford
ZCTA5 36256,01,1638,46600,660,89600,1312,525,1207,204,480,375,105,43,838,652,186,652,550,102,2018-01-01,zipcode,Daviston
ZCTA5 36258,01,1337,56848,543,164100,1128,550,1054,181,436,271,79,87,852,558,294,558,451,107,2018-01-01,zipcode,Delta
ZCTA5 36260,01,4001,41537,601,118400,3112,1412,2676,565,963,885,229,34,1832,1581,251,1581,1168,413,2018-01-01,zipcode,Eastaboga
ZCTA5 36262,01,1427,36750,535,82300,1056,465,935,194,458,216,66,1,643,507,136,507,395,112,2018-01-01,zipcode,Fruithurst
ZCTA5 36263,01,434,26154,600,85700,419,290,362,70,152,35,25,80,306,218,88,218,118,100,2018-01-01,zipcode,Graham
ZCTA5 36264,01,8523,36169,573,116500,6838,3489,5961,1538,2061,1497,484,381,3994,3306,688,3306,2412,894,2018-01-01,zipcode,Heflin
ZCTA5 36265,01,20694,49356,624,148700,17308,7440,12912,1362,3328,4648,2082,1492,8640,7697,943,7697,4651,3046,2018-01-01,zipcode,Jacksonville
ZCTA5 36266,01,5276,45720,596,111600,4049,1652,3549,853,1391,958,191,156,2740,1975,765,1975,1302,673,2018-01-01,zipcode,Lineville
ZCTA5 36267,01,12,-666666666,-666666666,-666666666,12,0,12,12,0,0,0,0,12,12,0,12,12,0,2018-01-01,zipcode,Millerville
ZCTA5 36268,01,5814,52561,768,117000,4568,1775,3950,705,1544,1327,248,126,2654,2362,292,2362,1991,371,2018-01-01,zipcode,Munford
ZCTA5 36269,01,1535,55536,547,78300,1071,535,974,194,472,182,120,6,519,482,37,482,388,94,2018-01-01,zipcode,Muscadine
ZCTA5 36271,01,5952,53448,678,97100,4893,1698,4313,903,1410,1492,297,211,2863,2283,580,2283,1896,387,2018-01-01,zipcode,Ohatchee
ZCTA5 36272,01,13221,38513,495,79100,10642,5344,9276,2055,3529,2658,647,387,6583,5331,1252,5331,4248,1083,2018-01-01,zipcode,Piedmont
ZCTA5 36273,01,3015,45208,654,132900,2468,1015,2215,428,974,497,221,95,1434,1249,185,1249,981,268,2018-01-01,zipcode,Ranburne
ZCTA5 36274,01,11295,40568,603,81900,9108,4279,7882,1533,2777,2385,848,339,5405,4350,1055,4350,3124,1226,2018-01-01,zipcode,Roanoke
ZCTA5 36276,01,2615,31000,494,78100,2168,1060,1719,578,540,452,116,33,1140,892,248,892,675,217,2018-01-01,zipcode,Wadley
ZCTA5 36277,01,5529,54449,826,102700,4305,1682,3741,511,1136,1599,359,136,2347,1993,354,1993,1534,459,2018-01-01,zipcode,Weaver
ZCTA5 36278,01,4755,39330,707,134900,3805,2066,3319,627,1091,951,331,319,3182,1863,1319,1863,1362,501,2018-01-01,zipcode,Wedowee
ZCTA5 36279,01,2339,55913,-666666666,153300,2005,911,1838,399,628,532,71,208,1246,961,285,961,901,60,2018-01-01,zipcode,Wellington
ZCTA5 36280,01,3875,47847,746,90500,3080,1640,2819,595,1247,672,146,159,1892,1461,431,1461,1149,312,2018-01-01,zipcode,Woodland
ZCTA5 36301,01,37527,40702,721,112600,29451,12443,25284,4012,8902,8327,2565,1478,16760,14049,2711,14049,8595,5454,2018-01-01,zipcode,Dothan
ZCTA5 36303,01,31005,42724,692,142700,24494,10538,21048,2856,5900,7030,3358,1904,14407,11678,2729,11678,6941,4737,2018-01-01,zipcode,Dothan
ZCTA5 36305,01,15816,64987,942,179500,12340,4680,10944,716,2535,3904,2358,1431,6902,6128,774,6128,4222,1906,2018-01-01,zipcode,Dothan
ZCTA5 36310,01,6055,40641,496,92200,5195,2933,4517,1005,1620,1196,350,346,4127,2566,1561,2566,2073,493,2018-01-01,zipcode,Abbeville
ZCTA5 36311,01,2715,41484,494,75200,2266,1232,1912,450,689,538,74,161,1413,1098,315,1098,943,155,2018-01-01,zipcode,Ariton
ZCTA5 36312,01,6030,41429,659,98400,4898,2336,4195,654,1626,1343,357,215,2743,2266,477,2266,1741,525,2018-01-01,zipcode,Ashford
ZCTA5 36313,01,240,83421,-666666666,140300,166,60,166,31,0,123,12,0,138,90,48,90,67,23,2018-01-01,zipcode,Bellwood
ZCTA5 36314,01,445,46902,575,122700,366,144,350,80,153,36,49,32,249,199,50,199,179,20,2018-01-01,zipcode,Black
ZCTA5 36316,01,1921,68229,646,156300,1572,663,1422,117,433,631,169,72,890,739,151,739,613,126,2018-01-01,zipcode,Chancellor
ZCTA5 36317,01,569,34286,493,64300,533,340,501,170,156,118,45,12,361,248,113,248,201,47,2018-01-01,zipcode,Clopton
ZCTA5 36318,01,1571,36908,677,70500,1234,649,1012,205,354,412,35,6,729,581,148,581,472,109,2018-01-01,zipcode,Coffee springs
ZCTA5 36319,01,1917,40761,739,77900,1582,837,1472,222,471,583,128,68,1001,806,195,806,621,185,2018-01-01,zipcode,Columbia
ZCTA5 36320,01,3708,39835,607,88400,2964,1273,2682,486,1179,764,205,48,1734,1351,383,1351,1098,253,2018-01-01,zipcode,Cottonwood
ZCTA5 36321,01,1744,41974,809,91400,1337,511,1140,190,484,324,97,45,733,620,113,620,481,139,2018-01-01,zipcode,Cowarts
ZCTA5 36322,01,9201,43227,708,106400,7336,3237,6191,970,2160,2213,626,222,4642,3463,1179,3463,1962,1501,2018-01-01,zipcode,Daleville
ZCTA5 36323,01,7810,42832,634,89100,6556,3109,5601,1314,1831,1798,450,208,3653,2921,732,2921,2062,859,2018-01-01,zipcode,Elba
ZCTA5 36330,01,36607,57985,831,168200,28445,10492,24634,2567,6128,9008,4623,2308,16285,14119,2166,14119,8567,5552,2018-01-01,zipcode,Enterprise
ZCTA5 36340,01,5721,31140,438,107900,4553,2384,4033,1111,1582,862,248,230,2636,2308,328,2308,1487,821,2018-01-01,zipcode,Geneva
ZCTA5 36343,01,1343,41750,625,75700,1175,649,1012,262,408,275,49,18,744,505,239,505,456,49,2018-01-01,zipcode,Gordon
ZCTA5 36344,01,5850,43062,620,107200,4762,2171,4202,784,1498,1460,322,138,2811,2179,632,2179,1502,677,2018-01-01,zipcode,Hartford
ZCTA5 36345,01,8845,57618,619,141800,6896,2720,6122,959,2016,1790,868,489,3633,3223,410,3223,2602,621,2018-01-01,zipcode,Headland
ZCTA5 36346,01,1491,45167,586,92600,1151,549,976,188,378,262,89,59,632,552,80,552,427,125,2018-01-01,zipcode,Jack
ZCTA5 36350,01,6628,41282,641,125200,5040,1965,4439,585,1375,1719,501,259,3132,2696,436,2696,1647,1049,2018-01-01,zipcode,Midland city
ZCTA5 36351,01,3410,48663,713,106900,2783,1278,2441,395,889,789,215,153,1598,1386,212,1386,1032,354,2018-01-01,zipcode,New brockton
ZCTA5 36352,01,5305,55094,747,151000,4472,1724,3744,667,1006,1377,316,378,2005,1875,130,1875,1497,378,2018-01-01,zipcode,Newton
ZCTA5 36353,01,1720,43250,533,105200,1417,625,1124,189,333,445,104,53,882,672,210,672,593,79,2018-01-01,zipcode,Newville
ZCTA5 36360,01,19117,43605,635,109000,15535,7361,13653,2068,4643,4708,1449,785,9162,7664,1498,7664,5011,2653,2018-01-01,zipcode,Ozark
ZCTA5 36362,01,5134,63839,1197,-666666666,3457,809,2314,21,298,1134,626,235,1452,1246,206,1246,0,1246,2018-01-01,zipcode,Fort rucker
ZCTA5 36370,01,878,48333,779,86800,732,372,695,182,293,203,7,10,413,352,61,352,282,70,2018-01-01,zipcode,Pansey
ZCTA5 36371,01,597,34479,794,109300,508,282,460,74,156,161,54,15,340,273,67,273,198,75,2018-01-01,zipcode,Pinckard
ZCTA5 36373,01,410,43103,-666666666,67900,393,211,300,68,145,83,0,4,365,182,183,182,167,15,2018-01-01,zipcode,Shorterville
ZCTA5 36374,01,691,58750,-666666666,108500,628,258,573,158,200,175,7,33,527,339,188,339,309,30,2018-01-01,zipcode,Skipperville
ZCTA5 36375,01,6962,41419,739,80200,5788,2606,4864,1121,1809,1330,421,183,3319,2766,553,2766,2031,735,2018-01-01,zipcode,Slocomb
ZCTA5 36376,01,2224,42708,700,86200,1866,909,1653,313,712,437,129,62,1117,826,291,826,687,139,2018-01-01,zipcode,Webb
ZCTA5 36401,01,8109,33116,573,84500,6614,3693,5722,846,3032,1226,397,221,4542,2939,1603,2939,2143,796,2018-01-01,zipcode,Evergreen
ZCTA5 36420,01,10369,44229,658,108900,8337,3630,7271,1125,2624,2193,755,574,5022,4109,913,4109,2889,1220,2018-01-01,zipcode,Andalusia
ZCTA5 36421,01,9861,41857,588,107300,7768,3465,6860,993,2002,2570,947,348,5065,3940,1125,3940,2998,942,2018-01-01,zipcode,Andalusia
ZCTA5 36425,01,1127,19567,542,40900,932,513,751,87,348,195,86,35,646,433,213,433,319,114,2018-01-01,zipcode,Beatrice
ZCTA5 36426,01,15293,37910,572,94300,12376,6204,10845,1917,4198,3040,1090,600,7434,6090,1344,6090,4188,1902,2018-01-01,zipcode,Brewton
ZCTA5 36432,01,2223,32321,382,65500,1850,1006,1639,489,734,310,87,19,1228,749,479,749,603,146,2018-01-01,zipcode,Castleberry
ZCTA5 36435,01,426,25741,-666666666,84000,302,179,291,93,83,98,0,17,285,134,151,134,122,12,2018-01-01,zipcode,Coy
ZCTA5 36436,01,372,37014,-666666666,61500,354,202,327,71,169,72,15,0,290,203,87,203,162,41,2018-01-01,zipcode,Dickinson
ZCTA5 36439,01,728,46705,936,149300,536,257,467,64,168,122,55,58,290,241,49,241,151,90,2018-01-01,zipcode,Excel
ZCTA5 36441,01,4107,37692,564,86500,3071,1386,2869,373,1485,756,164,91,1854,1509,345,1509,1167,342,2018-01-01,zipcode,Flomaton
ZCTA5 36442,01,2985,31875,506,86000,2475,1292,2272,394,899,788,114,77,1664,1211,453,1211,856,355,2018-01-01,zipcode,Florala
ZCTA5 36444,01,924,19728,-666666666,64800,740,595,605,194,210,154,7,40,557,335,222,335,212,123,2018-01-01,zipcode,Franklin
ZCTA5 36445,01,4713,40417,640,93300,3488,1966,3070,587,1485,714,224,60,2237,1766,471,1766,1174,592,2018-01-01,zipcode,Frisco city
ZCTA5 36446,01,472,17656,-666666666,80500,376,210,274,63,138,59,0,14,245,153,92,153,105,48,2018-01-01,zipcode,Fulton
ZCTA5 36451,01,4330,48721,563,122200,3488,1786,3153,434,1329,1021,265,104,2446,1811,635,1811,1302,509,2018-01-01,zipcode,Grove hill
ZCTA5 36453,01,2423,39881,595,76500,2059,972,1748,296,652,578,139,83,1122,950,172,950,683,267,2018-01-01,zipcode,Kinston
ZCTA5 36454,01,39,-666666666,-666666666,-666666666,39,34,30,0,16,0,9,5,49,17,32,17,17,0,2018-01-01,zipcode,Lenox
ZCTA5 36455,01,250,31250,625,60000,203,94,194,42,76,66,6,4,161,111,50,111,86,25,2018-01-01,zipcode,Lockhart
ZCTA5 36456,01,1393,33125,379,58200,1152,682,962,151,401,313,69,28,718,507,211,507,384,123,2018-01-01,zipcode,Mc kenzie
ZCTA5 36460,01,9644,32048,500,118000,7712,3705,6675,942,2963,1661,693,416,4713,3663,1050,3663,2085,1578,2018-01-01,zipcode,Monroeville
ZCTA5 36467,01,9769,36847,588,91100,7881,3737,6846,1545,2513,1943,553,292,4915,4002,913,4002,2836,1166,2018-01-01,zipcode,Opp
ZCTA5 36470,01,178,-666666666,-666666666,-666666666,178,77,178,54,124,0,0,0,99,77,22,77,22,55,2018-01-01,zipcode,Perdue hill
ZCTA5 36471,01,1057,22031,518,77000,905,609,773,126,496,99,18,34,810,441,369,441,244,197,2018-01-01,zipcode,Peterman
ZCTA5 36473,01,21,-666666666,-666666666,-666666666,14,2,9,0,0,0,0,9,26,7,19,7,7,0,2018-01-01,zipcode,Range
ZCTA5 36474,01,3099,42159,518,74000,2573,1160,2236,372,945,764,98,57,1645,1250,395,1250,1103,147,2018-01-01,zipcode,Red level
ZCTA5 36475,01,2127,28802,542,64100,1685,989,1524,263,743,293,158,67,1257,893,364,893,685,208,2018-01-01,zipcode,Repton
ZCTA5 36476,01,18,20250,-666666666,-666666666,18,10,10,2,4,4,0,0,21,9,12,9,8,1,2018-01-01,zipcode,River falls
ZCTA5 36477,01,3898,25109,522,66600,3053,1546,2658,532,1060,820,125,121,2107,1624,483,1624,1113,511,2018-01-01,zipcode,Samson
ZCTA5 36480,01,1564,31912,664,91900,1367,852,1160,137,455,359,77,132,1141,612,529,612,407,205,2018-01-01,zipcode,Uriah
ZCTA5 36481,01,522,15729,-666666666,34200,431,272,310,99,138,73,0,0,322,137,185,137,58,79,2018-01-01,zipcode,Vredenburgh
ZCTA5 36482,01,573,34922,-666666666,78600,537,329,501,184,191,112,0,14,404,281,123,281,259,22,2018-01-01,zipcode,Whatley
ZCTA5 36483,01,392,34500,-666666666,77600,363,220,337,41,159,108,29,0,202,172,30,172,167,5,2018-01-01,zipcode,Wing
ZCTA5 36502,01,18192,31623,603,107900,14726,8297,12372,2486,5986,2500,885,515,7345,5965,1380,5965,3991,1974,2018-01-01,zipcode,Atmore
ZCTA5 36505,01,1965,58005,1147,119300,1467,511,1222,299,175,451,190,107,670,607,63,607,445,162,2018-01-01,zipcode,Axis
ZCTA5 36507,01,22096,43596,662,130700,16965,7852,14413,2130,5550,4509,1528,696,8285,7287,998,7287,5009,2278,2018-01-01,zipcode,Bay minette
ZCTA5 36509,01,2076,37760,720,73200,1621,645,1261,523,386,286,52,14,759,625,134,625,378,247,2018-01-01,zipcode,Bayou la batre
ZCTA5 36511,01,383,20159,-666666666,113100,345,315,345,177,144,24,0,0,350,250,100,250,215,35,2018-01-01,zipcode,Bon secour
ZCTA5 36512,01,47,-666666666,-666666666,-666666666,47,47,47,18,29,0,0,0,25,25,0,25,25,0,2018-01-01,zipcode,Bucks
ZCTA5 36513,01,1024,32670,-666666666,-666666666,661,461,566,338,145,39,0,44,273,252,21,252,153,99,2018-01-01,zipcode,Calvert
ZCTA5 36518,01,2468,47647,754,129000,2157,1139,1829,232,765,544,160,128,1433,992,441,992,778,214,2018-01-01,zipcode,Chatom
ZCTA5 36521,01,5386,52582,782,118300,4515,2160,3996,827,1882,1070,139,78,2145,2021,124,2021,1760,261,2018-01-01,zipcode,Chunchula
ZCTA5 36522,01,7685,44880,760,108300,5786,2729,4821,781,2103,1351,461,125,2964,2567,397,2567,1804,763,2018-01-01,zipcode,Citronelle
ZCTA5 36523,01,2890,46944,847,87500,2356,1249,2188,652,864,466,99,107,1225,1044,181,1044,713,331,2018-01-01,zipcode,Coden
ZCTA5 36524,01,1255,35588,658,88100,986,592,797,156,377,194,50,20,951,482,469,482,413,69,2018-01-01,zipcode,Coffeeville
ZCTA5 36525,01,1928,46250,789,119300,1487,660,1279,186,513,383,144,53,790,701,89,701,466,235,2018-01-01,zipcode,Creola
ZCTA5 36526,01,34669,71632,1108,196400,26956,8621,23248,1216,4755,8032,6262,2983,13934,12665,1269,12665,9319,3346,2018-01-01,zipcode,Daphne
ZCTA5 36527,01,15262,91235,1235,285100,11368,3679,9843,430,1473,3126,2833,1981,5860,5620,240,5620,4026,1594,2018-01-01,zipcode,Daphne
ZCTA5 36528,01,1229,84861,979,240500,1117,528,1018,41,260,313,202,202,1941,551,1390,551,484,67,2018-01-01,zipcode,Dauphin island
ZCTA5 36529,01,237,-666666666,-666666666,219400,195,116,172,9,103,33,27,0,161,103,58,103,103,0,2018-01-01,zipcode,Deer park
ZCTA5 36530,01,6939,47321,834,167900,5758,2506,4905,582,1650,1595,795,283,3584,2721,863,2721,2147,574,2018-01-01,zipcode,Elberta
ZCTA5 36532,01,33743,67580,1079,245900,26340,11522,23522,1404,4520,6460,6921,4217,14741,12248,2493,12248,9819,2429,2018-01-01,zipcode,Fairhope
ZCTA5 36535,01,30187,45684,773,164900,25295,10830,22766,2665,6921,7768,3893,1519,14863,11973,2890,11973,8205,3768,2018-01-01,zipcode,Foley
ZCTA5 36538,01,407,28722,-666666666,21300,336,211,310,139,119,52,0,0,304,178,126,178,178,0,2018-01-01,zipcode,Frankville
ZCTA5 36539,01,809,33403,-666666666,-666666666,665,394,443,60,226,115,19,23,372,289,83,289,235,54,2018-01-01,zipcode,Fruitdale
ZCTA5 36540,01,696,-666666666,-666666666,54400,623,351,465,152,227,75,4,7,291,213,78,213,158,55,2018-01-01,zipcode,Gainestown
ZCTA5 36541,01,15635,54037,1074,107800,11624,4637,10110,1866,3697,3133,906,508,5813,5112,701,5112,4596,516,2018-01-01,zipcode,Grand bay
ZCTA5 36542,01,13932,50787,1034,242400,12583,5202,11131,455,2666,4095,2437,1478,16717,6706,10011,6706,4026,2680,2018-01-01,zipcode,Gulf shores
ZCTA5 36543,01,189,93226,-666666666,93200,154,58,154,0,31,105,0,18,62,62,0,62,62,0,2018-01-01,zipcode,Huxford
ZCTA5 36544,01,11396,43411,871,108300,9083,3877,7738,1912,3423,1803,509,91,4734,4057,677,4057,3084,973,2018-01-01,zipcode,Irvington
ZCTA5 36545,01,10030,30966,593,103000,7982,4578,6613,1228,3063,1499,400,423,4835,3631,1204,3631,2428,1203,2018-01-01,zipcode,Jackson
ZCTA5 36548,01,839,31953,-666666666,110200,742,362,648,43,212,309,31,53,552,420,132,420,378,42,2018-01-01,zipcode,Leroy
ZCTA5 36549,01,4996,48904,940,121100,4511,2519,4171,238,1657,1382,570,324,2869,2093,776,2093,1910,183,2018-01-01,zipcode,Lillian
ZCTA5 36550,01,489,-666666666,-666666666,-666666666,489,308,348,73,41,96,103,35,238,186,52,186,142,44,2018-01-01,zipcode,Little river
ZCTA5 36551,01,9029,54976,936,145000,7404,3340,6530,1132,2336,1894,784,384,3460,3043,417,3043,2465,578,2018-01-01,zipcode,Loxley
ZCTA5 36553,01,3246,41622,440,93000,2716,1508,2011,456,1008,423,108,16,1495,1062,433,1062,999,63,2018-01-01,zipcode,Mc intosh
ZCTA5 36555,01,791,54792,862,257300,738,382,704,25,236,163,223,57,495,358,137,358,316,42,2018-01-01,zipcode,Magnolia springs
ZCTA5 36556,01,601,-666666666,-666666666,48200,496,326,388,49,171,147,21,0,408,235,173,235,143,92,2018-01-01,zipcode,Malcolm
ZCTA5 36558,01,3414,45795,484,70900,2741,1332,2400,516,963,540,188,193,1891,1298,593,1298,1157,141,2018-01-01,zipcode,Millry
ZCTA5 36559,01,99,-666666666,-666666666,-666666666,99,65,63,0,0,33,16,14,97,50,47,50,33,17,2018-01-01,zipcode,Montrose
ZCTA5 36560,01,3381,37931,658,65400,2948,1580,2561,802,1066,534,111,48,1537,1316,221,1316,959,357,2018-01-01,zipcode,Mount vernon
ZCTA5 36561,01,6803,80057,1178,337000,5856,2647,5369,261,1090,1393,1823,802,13336,2982,10354,2982,2274,708,2018-01-01,zipcode,Orange beach
ZCTA5 36562,01,1463,44737,-666666666,102200,1188,518,1030,237,514,199,80,0,529,450,79,450,426,24,2018-01-01,zipcode,Perdido
ZCTA5 36564,01,52,-666666666,-666666666,-666666666,52,52,52,0,0,11,10,31,170,41,129,41,41,0,2018-01-01,zipcode,Point clear
ZCTA5 36567,01,13935,46783,755,133600,10870,4796,9415,1784,3626,2721,989,295,5786,4981,805,4981,3552,1429,2018-01-01,zipcode,Robertsdale
ZCTA5 36568,01,67,-666666666,-666666666,-666666666,67,49,67,26,23,0,0,18,58,58,0,58,58,0,2018-01-01,zipcode,Saint elmo
ZCTA5 36569,01,648,41685,-666666666,58500,589,355,580,67,279,190,41,3,348,257,91,257,215,42,2018-01-01,zipcode,Saint stephens
ZCTA5 36571,01,15407,60408,929,138200,11946,4819,9980,1512,3679,3059,1141,589,5944,5249,695,5249,3834,1415,2018-01-01,zipcode,Saraland
ZCTA5 36572,01,6165,63287,872,150000,4922,2240,4399,500,1854,1298,508,239,2332,2262,70,2262,1899,363,2018-01-01,zipcode,Satsuma
ZCTA5 36574,01,878,63839,-666666666,155900,744,354,668,70,364,120,79,35,541,365,176,365,332,33,2018-01-01,zipcode,Seminole
ZCTA5 36575,01,21095,59016,881,144000,15972,6551,14024,1972,5796,3987,1611,658,7940,7391,549,7391,5974,1417,2018-01-01,zipcode,Semmes
ZCTA5 36576,01,3796,44744,911,163200,3270,1166,2903,534,1066,661,539,103,1847,1613,234,1613,1196,417,2018-01-01,zipcode,Silverhill
ZCTA5 36578,01,1186,58625,728,256100,954,360,864,59,222,389,107,87,589,465,124,465,430,35,2018-01-01,zipcode,Stapleton
ZCTA5 36579,01,1204,39306,547,127300,983,523,901,183,306,197,104,111,1103,470,633,470,389,81,2018-01-01,zipcode,Stockton
ZCTA5 36580,01,5762,43393,699,147100,4621,2053,3525,645,1243,1102,326,209,2413,1874,539,1874,1428,446,2018-01-01,zipcode,Summerdale
ZCTA5 36581,01,136,50273,-666666666,9999,113,81,113,0,109,4,0,0,104,57,47,57,43,14,2018-01-01,zipcode,Sunflower
ZCTA5 36582,01,24628,52676,713,123600,18853,7236,16130,2472,5938,4767,2278,675,9980,8917,1063,8917,6625,2292,2018-01-01,zipcode,Theodore
ZCTA5 36583,01,843,37361,-666666666,172200,623,395,560,64,248,161,69,18,322,295,27,295,244,51,2018-01-01,zipcode,Tibbie
ZCTA5 36584,01,741,68750,-666666666,105300,604,284,571,144,218,168,41,0,454,275,179,275,233,42,2018-01-01,zipcode,Vinegar bend
ZCTA5 36585,01,1031,27672,483,-666666666,677,322,644,85,216,239,27,77,379,299,80,299,244,55,2018-01-01,zipcode,Wagarville
ZCTA5 36587,01,9475,53177,920,117000,7886,3681,6659,1254,2803,1833,582,187,4251,3193,1058,3193,2864,329,2018-01-01,zipcode,Wilmer
ZCTA5 36590,01,0,-666666666,-666666666,-666666666,0,0,0,0,0,0,0,0,0,0,0,0,0,0,2018-01-01,zipcode,Theodore
ZCTA5 36602,01,939,23958,443,194000,939,510,850,116,161,342,120,111,794,649,145,649,103,546,2018-01-01,zipcode,Mobile
ZCTA5 36603,01,10395,19203,579,82300,8945,6804,7537,2216,2699,1940,479,203,3784,2733,1051,2733,991,1742,2018-01-01,zipcode,Mobile
ZCTA5 36604,01,9567,47695,817,156100,7771,2588,6640,626,1305,1966,1700,1043,5124,4036,1088,4036,2245,1791,2018-01-01,zipcode,Mobile
ZCTA5 36605,01,26306,31834,816,77800,20060,9253,16869,2746,6906,4881,1651,685,12829,10079,2750,10079,5777,4302,2018-01-01,zipcode,Mobile
ZCTA5 36606,01,18879,37837,836,99600,14870,5482,12694,1417,4475,3284,2362,1156,9515,7921,1594,7921,3995,3926,2018-01-01,zipcode,Mobile
ZCTA5 36607,01,6270,39813,755,109400,5235,2391,4661,802,1320,1209,813,517,3397,2593,804,2593,1347,1246,2018-01-01,zipcode,Mobile
ZCTA5 36608,01,35591,49068,862,159500,29425,12265,23324,1887,5478,6798,5533,3628,17037,14876,2161,14876,8063,6813,2018-01-01,zipcode,Mobile
ZCTA5 36609,01,24282,39778,802,143500,19498,7158,16746,1340,4099,6201,3186,1920,13394,11352,2042,11352,5097,6255,2018-01-01,zipcode,Mobile
ZCTA5 36610,01,10646,22639,698,48800,8276,5111,6976,1590,2953,1852,437,144,5712,4100,1612,4100,2084,2016,2018-01-01,zipcode,Mobile
ZCTA5 36611,01,5837,32855,898,75500,4035,1787,3364,604,1192,1082,307,179,2529,2049,480,2049,1124,925,2018-01-01,zipcode,Mobile
ZCTA5 36612,01,4926,22531,731,59900,3468,1910,2738,627,1133,811,79,88,2023,1660,363,1660,782,878,2018-01-01,zipcode,Mobile
ZCTA5 36613,01,13475,37911,837,99700,10480,5666,8613,1484,3443,2626,781,279,5102,4282,820,4282,3357,925,2018-01-01,zipcode,Eight mile
ZCTA5 36615,01,0,-666666666,-666666666,-666666666,0,0,0,0,0,0,0,0,0,0,0,0,0,0,2018-01-01,zipcode,Mobile
ZCTA5 36616,01,8,-666666666,-666666666,-666666666,8,0,0,0,0,0,0,0,21,8,13,8,0,8,2018-01-01,zipcode,Mobile
ZCTA5 36617,01,13386,27626,874,72800,10664,5566,9366,1463,3786,2643,917,557,6135,5053,1082,5053,2771,2282,2018-01-01,zipcode,Mobile
ZCTA5 36618,01,17451,47049,858,110100,14050,6157,11739,1364,3970,3940,1423,1042,7291,6596,695,6596,5262,1334,2018-01-01,zipcode,Mobile
ZCTA5 36619,01,15422,55516,878,130300,12162,5247,10662,1352,4157,3167,1508,478,6450,5725,725,5725,4510,1215,2018-01-01,zipcode,Mobile
ZCTA5 36688,01,216,-666666666,-666666666,-666666666,216,135,0,0,0,0,0,0,0,0,0,0,0,0,2018-01-01,zipcode,Mobile
ZCTA5 36693,01,20220,60667,941,151900,16599,6254,14444,801,3555,4901,3433,1754,8834,7893,941,7893,5136,2757,2018-01-01,zipcode,Mobile
ZCTA5 36695,01,51088,69674,1032,182600,40219,14335,33514,2260,8139,10494,8424,4197,20327,18736,1591,18736,12650,6086,2018-01-01,zipcode,Mobile
ZCTA5 36701,01,21301,34377,654,92700,16541,7744,14308,2390,4723,4571,1448,1176,11199,8832,2367,8832,5299,3533,2018-01-01,zipcode,Selma
ZCTA5 36703,01,13502,27030,608,76000,10512,4994,8506,1729,3387,2468,542,380,6036,5224,812,5224,2689,2535,2018-01-01,zipcode,Selma
ZCTA5 36720,01,1012,11875,780,-666666666,682,540,506,223,96,130,47,10,402,340,62,340,246,94,2018-01-01,zipcode,Alberta
ZCTA5 36722,01,298,-666666666,-666666666,90000,263,117,239,38,124,60,17,0,237,141,96,141,84,57,2018-01-01,zipcode,Arlington
ZCTA5 36723,01,219,-666666666,-666666666,-666666666,135,86,125,39,28,58,0,0,209,82,127,82,40,42,2018-01-01,zipcode,Boykin
ZCTA5 36726,01,4884,33365,481,88200,3801,2118,3258,621,1414,793,325,105,2447,1709,738,1709,1009,700,2018-01-01,zipcode,Camden
ZCTA5 36727,01,6,-666666666,-666666666,-666666666,6,6,6,0,6,0,0,0,52,6,46,6,6,0,2018-01-01,zipcode,Campbell
ZCTA5 36728,01,287,35556,-666666666,-666666666,275,135,246,76,90,59,14,7,225,136,89,136,106,30,2018-01-01,zipcode,Catherine
ZCTA5 36732,01,8231,28750,493,133600,6510,3130,5425,681,1816,1745,699,484,4071,3258,813,3258,1953,1305,2018-01-01,zipcode,Demopolis
ZCTA5 36736,01,1371,36622,-666666666,71900,861,522,726,161,294,105,87,79,533,394,139,394,351,43,2018-01-01,zipcode,Dixons mills
ZCTA5 36738,01,745,28654,-666666666,93600,690,488,574,110,286,130,37,11,338,250,88,250,228,22,2018-01-01,zipcode,Faunsdale
ZCTA5 36740,01,1347,30750,574,54800,1069,641,976,198,321,322,123,12,907,433,474,433,363,70,2018-01-01,zipcode,Forkland
ZCTA5 36742,01,1606,39219,807,105500,1518,769,1355,300,573,337,66,79,1098,735,363,735,589,146,2018-01-01,zipcode,Gallion
ZCTA5 36744,01,6487,27600,470,85500,5205,2725,4325,656,1909,1134,436,190,3485,2619,866,2619,1561,1058,2018-01-01,zipcode,Greensboro
ZCTA5 36748,01,2707,37694,600,81200,2415,1388,2171,312,973,582,138,166,1583,1215,368,1215,853,362,2018-01-01,zipcode,Linden
ZCTA5 36749,01,779,37054,-666666666,97100,718,423,622,116,286,162,47,11,368,297,71,297,251,46,2018-01-01,zipcode,Jones
ZCTA5 36750,01,2538,52600,500,110000,2034,1011,1808,369,792,500,75,72,1185,988,197,988,722,266,2018-01-01,zipcode,Maplesville
ZCTA5 36751,01,585,-666666666,660,-666666666,412,268,342,242,72,9,11,8,279,216,63,216,170,46,2018-01-01,zipcode,Lower peach tree
ZCTA5 36752,01,1162,54167,-666666666,117400,978,417,867,114,219,376,103,55,681,498,183,498,448,50,2018-01-01,zipcode,Lowndesboro
ZCTA5 36753,01,8,-666666666,-666666666,-666666666,8,8,8,8,0,0,0,0,28,8,20,8,0,8,2018-01-01,zipcode,Mc williams
ZCTA5 36754,01,400,-666666666,-666666666,-666666666,367,169,315,129,117,64,0,5,234,170,64,170,120,50,2018-01-01,zipcode,Magnolia
ZCTA5 36756,01,5792,25483,600,80700,4959,3273,3382,746,1321,772,221,322,2552,1723,829,1723,1222,501,2018-01-01,zipcode,Marion
ZCTA5 36758,01,1355,39861,390,79600,1025,447,886,115,456,196,68,51,575,517,58,517,427,90,2018-01-01,zipcode,Plantersville
ZCTA5 36759,01,1805,32569,-666666666,62800,1485,829,1330,315,378,428,131,78,899,725,174,725,609,116,2018-01-01,zipcode,Marion junction
ZCTA5 36761,01,884,27292,826,59200,726,418,557,170,200,121,43,23,608,378,230,378,291,87,2018-01-01,zipcode,Minter
ZCTA5 36763,01,275,31250,-666666666,55000,148,97,138,67,29,33,5,4,87,71,16,71,57,14,2018-01-01,zipcode,Myrtlewood
ZCTA5 36765,01,1239,19342,1018,61400,1014,674,919,221,540,118,30,10,611,518,93,518,453,65,2018-01-01,zipcode,Newbern
ZCTA5 36766,01,18,-666666666,-666666666,-666666666,18,14,18,10,0,2,5,1,21,16,5,16,11,5,2018-01-01,zipcode,Oak hill
ZCTA5 36767,01,1456,22938,504,43600,1235,720,1053,386,317,236,92,22,1050,686,364,686,496,190,2018-01-01,zipcode,Orrville
ZCTA5 36768,01,898,19255,692,39700,816,530,645,130,214,192,61,48,674,347,327,347,278,69,2018-01-01,zipcode,Pine apple
ZCTA5 36769,01,2830,32326,563,72700,2349,1412,1941,340,900,440,189,72,1339,967,372,967,634,333,2018-01-01,zipcode,Pine hill
ZCTA5 36773,01,433,25441,606,105100,358,250,216,72,33,89,14,8,250,186,64,186,99,87,2018-01-01,zipcode,Safford
ZCTA5 36775,01,839,33465,647,54100,653,329,609,137,198,228,40,6,526,352,174,352,282,70,2018-01-01,zipcode,Sardis
ZCTA5 36776,01,1694,29808,-666666666,94400,1390,751,1090,174,362,358,159,37,804,550,254,550,442,108,2018-01-01,zipcode,Sawyerville
ZCTA5 36782,01,2691,38026,706,60800,2046,1138,1873,321,714,689,126,23,1325,992,333,992,859,133,2018-01-01,zipcode,Sweet water
ZCTA5 36783,01,678,23514,455,65000,595,374,565,56,296,133,38,42,601,342,259,342,286,56,2018-01-01,zipcode,Thomaston
ZCTA5 36784,01,7370,38108,532,126500,5977,3118,5202,957,2191,1227,624,203,3644,2856,788,2856,1712,1144,2018-01-01,zipcode,Thomasville
ZCTA5 36785,01,1039,24318,756,62300,878,519,781,182,287,214,84,14,731,532,199,532,407,125,2018-01-01,zipcode,Tyler
ZCTA5 36786,01,2804,19141,484,53900,1885,1155,1715,382,687,344,211,91,1644,1024,620,1024,735,289,2018-01-01,zipcode,Uniontown
ZCTA5 36790,01,312,40227,-666666666,52300,253,117,171,45,91,35,0,0,118,118,0,118,83,35,2018-01-01,zipcode,Stanton
ZCTA5 36792,01,1103,69253,-666666666,101000,946,495,854,64,402,328,22,38,678,453,225,453,375,78,2018-01-01,zipcode,Randolph
ZCTA5 36793,01,229,26912,-666666666,58800,201,72,118,8,81,11,0,18,216,98,118,98,85,13,2018-01-01,zipcode,Lawley
ZCTA5 36801,01,24840,40146,680,159900,19859,7489,17146,2097,5156,5182,2615,2096,11182,9963,1219,9963,5851,4112,2018-01-01,zipcode,Opelika
ZCTA5 36804,01,18582,48596,790,106800,14562,5960,12616,1528,3783,4530,1907,868,7228,6861,367,6861,5290,1571,2018-01-01,zipcode,Opelika
ZCTA5 36830,01,39078,53632,869,250500,31841,11779,22489,1288,2915,5530,6695,6061,17478,15294,2184,15294,7706,7588,2018-01-01,zipcode,Auburn
ZCTA5 36832,01,24509,27638,851,99100,20930,8515,10796,1159,2025,3096,2846,1670,12766,9834,2932,9834,3877,5957,2018-01-01,zipcode,Auburn
ZCTA5 36849,01,4108,-666666666,-666666666,-666666666,4108,3121,20,0,9,4,7,0,0,0,0,0,0,0,2018-01-01,zipcode,Auburn university
ZCTA5 36850,01,2654,33363,370,60000,2276,1163,1790,372,658,549,130,81,1400,1049,351,1049,854,195,2018-01-01,zipcode,Camp hill
ZCTA5 36852,01,2317,24847,745,111600,1756,863,1466,156,604,524,156,26,1033,826,207,826,625,201,2018-01-01,zipcode,Cusseta
ZCTA5 36853,01,7828,53470,796,157400,6681,3784,5887,983,1944,1380,986,594,5926,3258,2668,3258,2599,659,2018-01-01,zipcode,Dadeville
ZCTA5 36854,01,16045,44914,806,109400,12519,5026,10422,1397,3747,3545,1251,482,7500,6078,1422,6078,3929,2149,2018-01-01,zipcode,Valley
ZCTA5 36855,01,1543,44412,544,113700,1235,533,1096,259,402,250,113,72,746,578,168,578,470,108,2018-01-01,zipcode,Five points
ZCTA5 36856,01,7415,72715,1468,195600,5344,1928,4677,534,1059,1655,910,519,2631,2427,204,2427,2017,410,2018-01-01,zipcode,Fort mitchell
ZCTA5 36858,01,260,28889,611,90300,229,133,213,28,106,34,29,16,232,138,94,138,113,25,2018-01-01,zipcode,Hatchechubbee
ZCTA5 36859,01,18,-666666666,-666666666,-666666666,18,18,18,18,0,0,0,0,8,8,0,8,8,0,2018-01-01,zipcode,
ZCTA5 36860,01,1889,34872,530,62500,1561,937,1463,472,517,339,97,38,980,696,284,696,541,155,2018-01-01,zipcode,Hurtsboro
ZCTA5 36861,01,2817,46364,672,131300,2436,1110,2300,442,805,547,340,166,1939,1300,639,1300,1098,202,2018-01-01,zipcode,Jacksons gap
ZCTA5 36862,01,5882,33096,576,78300,4883,2517,4369,1051,1706,1221,226,165,2945,2469,476,2469,1656,813,2018-01-01,zipcode,Lafayette
ZCTA5 36863,01,11604,36884,671,96500,9640,4121,8162,1567,3186,2195,865,349,6080,4774,1306,4774,3317,1457,2018-01-01,zipcode,Lanett
ZCTA5 36865,01,34,-666666666,-666666666,-666666666,28,17,22,0,15,6,1,0,20,13,7,13,13,0,2018-01-01,zipcode,Loachapoka
ZCTA5 36866,01,3758,40164,601,74900,3058,1115,2760,391,1088,852,282,147,2039,1698,341,1698,1367,331,2018-01-01,zipcode,Notasulga
ZCTA5 36867,01,22983,43144,831,136800,18005,6058,15172,1954,4331,5495,2003,1389,10849,9394,1455,9394,4746,4648,2018-01-01,zipcode,Phenix city
ZCTA5 36869,01,21064,35156,769,107200,16357,7281,13556,2522,4589,4603,1032,810,9855,8060,1795,8060,4692,3368,2018-01-01,zipcode,Phenix city
ZCTA5 36870,01,21208,51257,844,136900,16298,6301,13650,1762,4159,5564,1290,875,8372,7443,929,7443,5375,2068,2018-01-01,zipcode,Phenix city
ZCTA5 36871,01,1478,35179,-666666666,90200,1258,706,1143,107,487,379,154,16,700,539,161,539,439,100,2018-01-01,zipcode,Pittsview
ZCTA5 36874,01,7511,53393,1053,157200,6082,2586,5275,434,1559,1858,776,648,3552,3029,523,3029,2606,423,2018-01-01,zipcode,Salem
ZCTA5 36875,01,3174,54081,880,126800,2756,1189,2621,305,926,993,261,136,1809,1462,347,1462,1100,362,2018-01-01,zipcode,Seale
ZCTA5 36877,01,13058,55221,860,145600,10379,3756,9018,1058,2543,3657,1122,638,5331,4803,528,4803,3338,1465,2018-01-01,zipcode,Smiths station
ZCTA5 36879,01,1936,81908,613,214100,1571,519,1385,132,352,331,272,298,885,742,143,742,630,112,2018-01-01,zipcode,Waverly
ZCTA5 36901,01,327,23167,507,35600,327,208,293,33,212,48,0,0,205,182,23,182,110,72,2018-01-01,zipcode,Bellamy
ZCTA5 36904,01,3738,35632,505,97700,3064,1608,2636,362,1065,788,329,92,2036,1526,510,1526,1080,446,2018-01-01,zipcode,Butler
ZCTA5 36907,01,1515,26875,712,79700,1276,712,1045,127,407,191,196,124,916,702,214,702,576,126,2018-01-01,zipcode,Cuba
ZCTA5 36908,01,2069,53371,320,83500,1704,990,1555,215,608,556,138,38,1093,795,298,795,713,82,2018-01-01,zipcode,Gilbertown
ZCTA5 36910,01,21,-666666666,-666666666,-666666666,11,11,0,0,0,0,0,0,41,11,30,11,0,11,2018-01-01,zipcode,Jachin
ZCTA5 36912,01,2272,31683,593,75600,1914,1068,1716,276,673,586,59,122,1253,911,342,911,683,228,2018-01-01,zipcode,Lisman
ZCTA5 36913,01,19,-666666666,-666666666,-666666666,19,19,19,19,0,0,0,0,9,9,0,9,9,0,2018-01-01,zipcode,Melvin
ZCTA5 36915,01,805,-666666666,-666666666,58500,587,285,456,45,159,141,64,47,404,282,122,282,170,112,2018-01-01,zipcode,Needham
ZCTA5 36916,01,846,32500,475,67200,726,497,686,210,236,173,11,56,544,376,168,376,323,53,2018-01-01,zipcode,Pennington
ZCTA5 36919,01,1748,29254,507,55700,1435,919,1244,329,511,319,54,31,1004,725,279,725,604,121,2018-01-01,zipcode,Silas
ZCTA5 36921,01,819,25774,563,73500,733,403,634,144,218,162,101,9,519,373,146,373,355,18,2018-01-01,zipcode,Toxey
ZCTA5 36922,01,375,37823,-666666666,63800,328,142,324,119,91,89,7,18,338,214,124,214,183,31,2018-01-01,zipcode,Ward
ZCTA5 36925,01,3520,28583,605,49100,2778,1397,2319,475,859,605,177,203,1588,1257,331,1257,849,408,2018-01-01,zipcode,York
ZCTA5 75001,48,15000,73094,1300,310000,13314,2073,11590,561,1318,3102,4561,2048,9492,8361,1131,8361,1461,6900,2018-01-01,zipcode,Addison
ZCTA5 75002,48,70597,101661,1506,254300,52686,14291,44606,2616,7600,13395,14346,6649,23015,22236,779,22236,17508,4728,2018-01-01,zipcode,Allen
ZCTA5 75006,48,51136,61844,1118,184000,39522,11254,33588,7084,8378,8005,6966,3155,18621,18022,599,18022,9054,8968,2018-01-01,zipcode,Carrollton
ZCTA5 75007,48,54701,84541,1189,219400,44667,12677,38323,3957,8007,10537,11596,4226,19911,19356,555,19356,14148,5208,2018-01-01,zipcode,Carrollton
ZCTA5 75009,48,11941,94523,1527,285800,8695,2630,7725,771,1777,2521,1964,692,3963,3633,330,3633,2860,773,2018-01-01,zipcode,Celina
ZCTA5 75010,48,28974,81164,1245,291800,23322,5312,19899,1218,2848,6083,6707,3043,11971,11482,489,11482,5108,6374,2018-01-01,zipcode,Carrollton
ZCTA5 75013,48,40675,129627,1416,395700,30182,8486,25828,677,2286,5934,9770,7161,14375,13663,712,13663,10046,3617,2018-01-01,zipcode,Allen
ZCTA5 75019,48,42597,121279,1373,369400,32955,8639,29230,796,2290,6014,11607,8523,16546,15953,593,15953,11270,4683,2018-01-01,zipcode,Coppell
ZCTA5 75020,48,22487,50241,812,107000,18169,7712,15836,1682,4839,5808,2209,1298,10209,8829,1380,8829,5624,3205,2018-01-01,zipcode,Denison
ZCTA5 75021,48,8950,51250,795,113500,6951,2835,6289,826,2311,2152,649,351,3647,3369,278,3369,2584,785,2018-01-01,zipcode,Denison
ZCTA5 75022,48,25640,160885,1733,405100,19184,5440,16430,434,1584,3119,7248,4045,8087,7933,154,7933,7395,538,2018-01-01,zipcode,Flower mound
ZCTA5 75023,48,50061,86449,1399,234700,40611,12671,35461,1957,5129,10786,11602,5987,18853,18121,732,18121,11586,6535,2018-01-01,zipcode,Plano
ZCTA5 75024,48,42876,96674,1335,382100,34317,9190,30008,685,2301,5321,12921,8780,18690,17726,964,17726,7557,10169,2018-01-01,zipcode,Plano
ZCTA5 75025,48,53688,117793,1417,328400,41833,12550,36301,1223,3095,7397,14082,10504,19435,18780,655,18780,13027,5753,2018-01-01,zipcode,Plano
ZCTA5 75028,48,46782,122861,1669,296400,35901,9789,31037,1082,3781,8200,11790,6184,16393,15826,567,15826,13158,2668,2018-01-01,zipcode,Flower mound
ZCTA5 75032,48,32317,106869,1236,303300,24536,7777,20973,1834,3087,6330,6055,3667,11434,10973,461,10973,8978,1995,2018-01-01,zipcode,Rockwall
ZCTA5 75034,48,102646,121401,1314,387500,74510,22079,64865,2337,6765,15607,25097,15059,38051,35506,2545,35506,24828,10678,2018-01-01,zipcode,Frisco
ZCTA5 75035,48,69802,130851,1769,327900,49640,12529,43266,1538,3567,10685,16584,10892,23375,22460,915,22460,18061,4399,2018-01-01,zipcode,Frisco
ZCTA5 75038,48,30153,56636,1049,248300,22840,5310,19544,1635,4251,4763,5655,3240,13605,12279,1326,12279,2084,10195,2018-01-01,zipcode,Irving
ZCTA5 75039,48,19297,90961,1431,449300,16028,2674,14858,271,1011,2843,5769,4964,10592,9697,895,9697,1593,8104,2018-01-01,zipcode,Irving
ZCTA5 75040,48,63153,61517,1139,135600,48120,14836,39148,10814,9772,11526,5054,1982,19412,18460,952,18460,13189,5271,2018-01-01,zipcode,Garland
ZCTA5 75041,48,32257,49029,977,117800,23278,7604,18970,6712,5444,4481,1684,649,10064,9379,685,9379,5709,3670,2018-01-01,zipcode,Garland
ZCTA5 75042,48,39178,46704,928,125600,29133,9720,23477,8727,5574,5989,2400,787,12117,11483,634,11483,5846,5637,2018-01-01,zipcode,Garland
ZCTA5 75043,48,61440,61466,1089,153500,46316,13261,39720,5840,9547,14007,6952,3374,22220,21054,1166,21054,12260,8794,2018-01-01,zipcode,Garland
ZCTA5 75044,48,41901,67854,1224,183500,34376,10774,29200,3594,5523,8622,7883,3578,15698,15054,644,15054,10161,4893,2018-01-01,zipcode,Garland
ZCTA5 75048,48,25034,101161,1342,209500,19642,5781,16359,1974,3751,5398,3549,1687,7948,7626,322,7626,6780,846,2018-01-01,zipcode,Sachse
ZCTA5 75050,48,42916,55753,1026,115000,32685,9234,25997,6199,7761,6813,3508,1716,16349,14690,1659,14690,6352,8338,2018-01-01,zipcode,Grand prairie
ZCTA5 75051,48,41479,41154,894,95800,30243,10440,24363,8368,8790,5104,1539,562,13870,12798,1072,12798,6006,6792,2018-01-01,zipcode,Grand prairie
ZCTA5 75052,48,95516,77230,1270,161600,73035,19958,60666,8677,15433,20068,11795,4693,31067,29698,1369,29698,22032,7666,2018-01-01,zipcode,Grand prairie
ZCTA5 75054,48,10635,123963,2055,306700,7631,1910,6407,234,716,1996,2233,1228,3197,3082,115,3082,2658,424,2018-01-01,zipcode,Grand prairie
ZCTA5 75056,48,59211,87941,1350,248300,46431,10128,40233,2496,7263,12667,12278,5529,23225,21956,1269,21956,13697,8259,2018-01-01,zipcode,The colony
ZCTA5 75057,48,14111,55743,1172,126600,10865,2352,9021,2240,2017,2479,1785,500,5670,5022,648,5022,1805,3217,2018-01-01,zipcode,Lewisville
ZCTA5 75058,48,2564,82778,1076,245000,2005,740,1709,186,438,502,417,166,944,846,98,846,671,175,2018-01-01,zipcode,Gunter
ZCTA5 75060,48,48664,55051,947,123500,35286,10389,28941,10413,7899,6456,3058,1115,14672,14003,669,14003,8666,5337,2018-01-01,zipcode,Irving
ZCTA5 75061,48,54862,45822,919,139400,40186,11354,32358,11785,8421,7315,3273,1564,18791,17381,1410,17381,6609,10772,2018-01-01,zipcode,Irving
ZCTA5 75062,48,48629,52331,993,142100,36871,10316,29948,6709,7384,8435,4880,2540,17045,16126,919,16126,6813,9313,2018-01-01,zipcode,Irving
ZCTA5 75063,48,38952,91431,1212,341700,29614,6966,26805,685,1979,5170,10149,8822,16719,15903,816,15903,6332,9571,2018-01-01,zipcode,Irving
ZCTA5 75065,48,12389,78567,1206,176400,9739,2852,8633,648,2209,3147,1897,732,4734,4492,242,4492,3385,1107,2018-01-01,zipcode,Lake dallas
ZCTA5 75067,48,67487,62921,1145,194700,51884,11321,44536,5553,9920,13433,11371,4259,26962,24965,1997,24965,9528,15437,2018-01-01,zipcode,Lewisville
ZCTA5 75068,48,61043,99472,1652,236900,43800,10347,38208,2620,6728,12277,10542,6041,20155,19329,826,19329,15587,3742,2018-01-01,zipcode,Little elm
ZCTA5 75069,48,37834,55435,1050,253500,30035,10751,25270,4799,5951,6744,5223,2553,14886,13853,1033,13853,7136,6717,2018-01-01,zipcode,Mckinney
ZCTA5 75070,48,98219,101462,1462,294500,72316,20340,62667,1969,7501,19518,23023,10656,36491,34661,1830,34661,25028,9633,2018-01-01,zipcode,Mckinney
ZCTA5 75071,48,52939,97277,1562,282300,38776,12073,32854,2375,4894,10953,9617,5015,17562,16901,661,16901,12258,4643,2018-01-01,zipcode,Mckinney
ZCTA5 75074,48,51147,69214,1231,204200,40108,10989,33089,5913,6661,8822,8223,3470,18201,17124,1077,17124,9694,7430,2018-01-01,zipcode,Plano
ZCTA5 75075,48,36917,76610,1218,246900,31021,10112,26129,2136,3874,7844,7952,4323,15132,14219,913,14219,9039,5180,2018-01-01,zipcode,Plano
ZCTA5 75076,48,7847,49989,893,135300,6273,2563,5736,419,1675,2288,1006,348,4384,3159,1225,3159,2506,653,2018-01-01,zipcode,Pottsboro
ZCTA5 75077,48,37080,106571,1451,280400,29521,8501,25518,975,4170,8309,8382,3682,13324,12912,412,12912,10421,2491,2018-01-01,zipcode,Lewisville
ZCTA5 75078,48,23580,143669,1506,435300,16061,4767,13847,263,1672,3826,5702,2384,7458,6897,561,6897,6079,818,2018-01-01,zipcode,Prosper
ZCTA5 75080,48,51710,72660,1306,258400,41020,14396,32726,3133,3779,7433,11355,7026,20240,19098,1142,19098,10551,8547,2018-01-01,zipcode,Richardson
ZCTA5 75081,48,39309,74125,1309,208600,31569,10041,27612,2068,4564,8604,8725,3651,15875,14975,900,14975,8521,6454,2018-01-01,zipcode,Richardson
ZCTA5 75082,48,23579,115264,1479,313300,18835,5733,16220,389,1779,3296,6483,4273,8969,8543,426,8543,6210,2333,2018-01-01,zipcode,Richardson
ZCTA5 75087,48,33638,96789,1374,255900,25668,9169,22135,1102,4008,6897,6667,3461,12232,11746,486,11746,9278,2468,2018-01-01,zipcode,Rockwall
ZCTA5 75088,48,26234,89022,1556,201400,21200,5920,18400,1296,4408,6706,4022,1968,9552,9104,448,9104,7807,1297,2018-01-01,zipcode,Rowlett
ZCTA5 75089,48,34374,102520,1688,209100,26398,6564,22552,1276,5217,8036,5364,2659,11200,10997,203,10997,9684,1313,2018-01-01,zipcode,Rowlett
ZCTA5 75090,48,24580,40607,867,86500,18742,7315,15305,2937,5330,5118,1247,673,9330,8286,1044,8286,5135,3151,2018-01-01,zipcode,Sherman
ZCTA5 75092,48,24575,57923,886,154800,19444,6894,16826,1456,4150,6563,3094,1563,11041,9920,1121,9920,5444,4476,2018-01-01,zipcode,Sherman
ZCTA5 75093,48,47411,108718,1372,431900,38887,12744,34473,999,3460,6985,13786,9243,20397,19131,1266,19131,12108,7023,2018-01-01,zipcode,Plano
ZCTA5 75094,48,23370,133125,2137,332500,16816,5064,14421,802,2100,3540,5106,2873,6202,6140,62,6140,5291,849,2018-01-01,zipcode,Plano
ZCTA5 75098,48,56764,93511,1435,207900,41331,10610,34723,2862,8104,11004,9108,3645,18051,17370,681,17370,13759,3611,2018-01-01,zipcode,Wylie
ZCTA5 75101,48,615,45625,860,65700,437,181,373,176,115,64,13,5,217,190,27,190,144,46,2018-01-01,zipcode,Bardwell
ZCTA5 75102,48,1177,54038,938,96000,926,368,805,185,245,208,158,9,591,440,151,440,372,68,2018-01-01,zipcode,Barry
ZCTA5 75103,48,14458,51621,976,123400,11638,5503,10105,1384,3227,3621,1413,460,6101,5241,860,5241,4156,1085,2018-01-01,zipcode,Canton
ZCTA5 75104,48,49341,70975,1295,155800,36812,10794,30505,2594,7046,11737,5577,3551,16737,15820,917,15820,11001,4819,2018-01-01,zipcode,Cedar hill
ZCTA5 75105,48,190,41944,-666666666,106300,161,98,119,17,25,68,9,0,86,66,20,66,61,5,2018-01-01,zipcode,Chatfield
ZCTA5 75109,48,4555,67195,1087,141800,3620,1410,3120,271,953,1108,451,337,2043,1718,325,1718,1424,294,2018-01-01,zipcode,Corsicana
ZCTA5 75110,48,29213,44598,787,93400,22279,8107,18638,4686,4934,6232,1717,1069,11663,10283,1380,10283,6464,3819,2018-01-01,zipcode,Corsicana
ZCTA5 75114,48,6392,67566,1163,121900,5010,1453,4254,783,1570,1296,449,156,2158,1960,198,1960,1567,393,2018-01-01,zipcode,Crandall
ZCTA5 75115,48,52833,69512,1128,163600,39991,12146,34946,3556,7646,13926,6258,3560,19666,18722,944,18722,12004,6718,2018-01-01,zipcode,Desoto
ZCTA5 75116,48,20044,46472,993,125400,14641,5156,12377,2515,3431,4175,1474,782,7010,6514,496,6514,3576,2938,2018-01-01,zipcode,Duncanville
ZCTA5 75117,48,3776,50705,750,145000,3007,1421,2600,362,818,864,400,156,1778,1518,260,1518,1146,372,2018-01-01,zipcode,Edgewood
ZCTA5 75119,48,28319,56333,908,120400,21423,7842,17925,4265,6002,5103,1796,759,10002,9164,838,9164,6083,3081,2018-01-01,zipcode,Ennis
ZCTA5 75124,48,4003,50061,673,115700,3369,1615,2997,443,1133,937,293,191,2161,1614,547,1614,1240,374,2018-01-01,zipcode,Eustace
ZCTA5 75125,48,6333,59920,1056,81600,4695,2212,4018,1389,1206,969,212,242,2232,2091,141,2091,1551,540,2018-01-01,zipcode,Ferris
ZCTA5 75126,48,44740,95309,1322,198800,31765,8140,26955,1914,7118,9360,5660,2903,13953,13398,555,13398,11518,1880,2018-01-01,zipcode,Forney
ZCTA5 75127,48,1740,39333,691,99700,1351,699,1135,236,459,323,64,53,640,584,56,584,432,152,2018-01-01,zipcode,Fruitvale
ZCTA5 75132,48,1705,80556,-666666666,191500,1097,275,996,39,264,366,187,140,596,504,92,504,426,78,2018-01-01,zipcode,Fate
ZCTA5 75134,48,22337,52628,1018,119300,15834,4721,13023,1984,3967,4889,1526,657,7620,7145,475,7145,4088,3057,2018-01-01,zipcode,Lancaster
ZCTA5 75135,48,7725,80029,984,159700,5527,1904,4748,393,1886,1883,468,118,2472,2373,99,2373,1883,490,2018-01-01,zipcode,Caddo mills
ZCTA5 75137,48,19586,62308,1230,147400,15408,5250,12694,1569,3411,4162,2045,1507,7169,6776,393,6776,4817,1959,2018-01-01,zipcode,Duncanville
ZCTA5 75140,48,7290,46942,714,108900,5625,2712,4784,1184,1611,1379,405,205,2759,2337,422,2337,1714,623,2018-01-01,zipcode,Grand saline
ZCTA5 75141,48,5880,37969,923,80300,4764,3081,3770,1203,1408,934,157,68,1266,1176,90,1176,787,389,2018-01-01,zipcode,Hutchins
ZCTA5 75142,48,19059,53931,918,106400,14480,5510,12392,2568,4535,3730,1040,519,6351,5781,570,5781,4249,1532,2018-01-01,zipcode,Kaufman
ZCTA5 75143,48,14304,46288,804,97500,11559,5672,10187,2083,3752,2719,1102,531,7463,5466,1997,5466,4350,1116,2018-01-01,zipcode,Kemp
ZCTA5 75144,48,3265,44233,696,85000,2614,1133,2237,283,860,741,190,163,1650,1259,391,1259,876,383,2018-01-01,zipcode,Kerens
ZCTA5 75146,48,18986,57346,1050,129200,13792,3867,11474,1344,3274,4264,1736,856,7214,6783,431,6783,4374,2409,2018-01-01,zipcode,Lancaster
ZCTA5 75147,48,7052,44559,847,111400,5480,2037,4652,507,2122,1308,523,192,2800,2510,290,2510,1718,792,2018-01-01,zipcode,Mabank
ZCTA5 75148,48,6060,35267,775,84900,4817,2454,4191,745,1407,1461,416,162,3317,2249,1068,2249,1571,678,2018-01-01,zipcode,Malakoff
ZCTA5 75149,48,54979,48441,1023,111400,40169,13403,32480,7988,9547,10411,3179,1355,18893,17603,1290,17603,10655,6948,2018-01-01,zipcode,Mesquite
ZCTA5 75150,48,62452,52439,1060,122800,46729,14326,37897,7694,11618,11751,4746,2088,23147,21248,1899,21248,9484,11764,2018-01-01,zipcode,Mesquite
ZCTA5 75152,48,5097,62753,1056,101300,3637,1058,2898,625,941,856,323,153,1722,1562,160,1562,1177,385,2018-01-01,zipcode,Palmer
ZCTA5 75153,48,397,44167,673,69300,313,142,279,89,77,83,30,0,144,124,20,124,109,15,2018-01-01,zipcode,Powell
ZCTA5 75154,48,39949,75543,1145,170900,29992,9492,25044,3561,6690,8736,4148,1909,13386,12580,806,12580,9728,2852,2018-01-01,zipcode,Red oak
ZCTA5 75155,48,2815,49156,782,83500,1948,800,1671,559,550,452,86,24,926,825,101,825,689,136,2018-01-01,zipcode,Rice
ZCTA5 75156,48,16108,47311,748,101200,13232,6780,11568,2003,4239,3559,1265,502,9355,6546,2809,6546,5161,1385,2018-01-01,zipcode,Mabank
ZCTA5 75157,48,240,36750,844,67500,177,76,158,49,69,31,6,3,119,89,30,89,73,16,2018-01-01,zipcode,Rosser
ZCTA5 75158,48,3859,60202,1051,157500,3079,1368,2797,302,1053,911,300,231,1505,1373,132,1373,1232,141,2018-01-01,zipcode,Scurry
ZCTA5 75159,48,19469,51382,991,103700,14771,7073,12709,3714,4428,3169,906,492,5546,5286,260,5286,3758,1528,2018-01-01,zipcode,Seagoville
ZCTA5 75160,48,25317,50819,956,122300,19574,7244,16705,2904,5588,5440,1925,848,9082,8328,754,8328,5178,3150,2018-01-01,zipcode,Terrell
ZCTA5 75161,48,7005,49670,941,122800,5465,2256,4726,829,2016,1440,274,167,2316,2153,163,2153,1703,450,2018-01-01,zipcode,Terrell
ZCTA5 75163,48,2851,41442,1021,77900,2455,1332,2247,461,904,644,183,55,1727,1237,490,1237,914,323,2018-01-01,zipcode,Trinidad
ZCTA5 75164,48,643,49899,1094,113200,490,159,426,62,241,96,16,11,281,263,18,263,197,66,2018-01-01,zipcode,Josephine
ZCTA5 75165,48,43498,65659,1057,166100,33583,11789,27905,3605,7533,10417,4535,1815,16483,15240,1243,15240,9286,5954,2018-01-01,zipcode,Waxahachie
ZCTA5 75166,48,4297,94375,1644,236300,3104,780,2618,93,590,1027,592,316,1318,1318,0,1318,1121,197,2018-01-01,zipcode,Lavon
ZCTA5 75167,48,11662,98902,1366,228500,8788,2675,7602,1018,2023,2509,1642,410,3801,3523,278,3523,3269,254,2018-01-01,zipcode,Waxahachie
ZCTA5 75169,48,13793,46124,771,98000,11245,5191,9868,1982,3740,2970,894,282,6324,5096,1228,5096,3907,1189,2018-01-01,zipcode,Wills point
ZCTA5 75172,48,4294,41224,859,64200,3108,1238,2623,909,713,793,195,13,1276,1205,71,1205,702,503,2018-01-01,zipcode,Wilmer
ZCTA5 75173,48,4131,72284,1064,185300,3268,1048,2933,376,990,983,391,193,1625,1456,169,1456,1292,164,2018-01-01,zipcode,Nevada
ZCTA5 75180,48,23711,46714,985,89600,16217,5199,12706,5132,3474,3321,608,171,7006,6202,804,6202,3733,2469,2018-01-01,zipcode,Balch springs
ZCTA5 75181,48,28882,86242,1641,164700,21045,5937,17497,1997,4890,6209,2839,1562,8242,8084,158,8084,7007,1077,2018-01-01,zipcode,Mesquite
ZCTA5 75182,48,6218,140486,-666666666,366300,4697,1462,4100,282,763,1127,1168,760,1886,1834,52,1834,1815,19,2018-01-01,zipcode,Sunnyvale
ZCTA5 75189,48,27179,85207,1402,189700,20301,5979,17196,1990,5412,5519,3206,1069,9234,8731,503,8731,7370,1361,2018-01-01,zipcode,Royse city
ZCTA5 75201,48,15891,93983,1684,514200,15112,2163,12712,314,820,1814,5931,3833,11090,9532,1558,9532,1123,8409,2018-01-01,zipcode,Dallas
ZCTA5 75202,48,2059,83500,1488,261600,1952,250,1675,7,53,347,843,425,1781,1344,437,1344,291,1053,2018-01-01,zipcode,Dallas
ZCTA5 75203,48,17301,35266,803,84800,13012,4010,10813,3627,3020,2260,1423,483,7435,6551,884,6551,1753,4798,2018-01-01,zipcode,Dallas
ZCTA5 75204,48,30797,74540,1436,351100,27712,5350,23100,2363,1988,3819,8322,6608,20195,17390,2805,17390,3558,13832,2018-01-01,zipcode,Dallas
ZCTA5 75205,48,24879,146902,1498,1177500,19992,7746,14971,158,673,1786,6645,5709,10636,9238,1398,9238,5954,3284,2018-01-01,zipcode,Dallas
ZCTA5 75206,48,38375,67500,1232,375000,33779,6727,28924,2796,2715,4977,11659,6777,23526,20324,3202,20324,5430,14894,2018-01-01,zipcode,Dallas
ZCTA5 75207,48,7813,76552,1582,-666666666,7703,5720,6558,1591,1740,1549,1118,560,1697,1494,203,1494,9,1485,2018-01-01,zipcode,Dallas
ZCTA5 75208,48,29720,61051,972,244100,23288,6663,19789,5929,3641,3824,4000,2395,11648,10380,1268,10380,5564,4816,2018-01-01,zipcode,Dallas
ZCTA5 75209,48,14188,86813,1322,603300,11790,3532,10823,982,1086,2213,3935,2607,7561,6636,925,6636,4039,2597,2018-01-01,zipcode,Dallas
ZCTA5 75210,48,8578,26727,715,66400,6035,2580,5009,2172,1470,1132,143,92,3439,2823,616,2823,661,2162,2018-01-01,zipcode,Dallas
ZCTA5 75211,48,79010,41154,889,97600,57332,20425,44344,20333,12846,7815,2433,917,23378,21846,1532,21846,10900,10946,2018-01-01,zipcode,Dallas
ZCTA5 75212,48,26320,32696,649,90700,18678,8126,14469,6835,4591,2299,529,215,8352,7608,744,7608,3867,3741,2018-01-01,zipcode,Dallas
ZCTA5 75214,48,33906,85211,1137,461700,27376,7697,25132,1390,2100,5073,9681,6888,17855,15887,1968,15887,8555,7332,2018-01-01,zipcode,Dallas
ZCTA5 75215,48,16681,28089,811,69400,12988,5448,11323,2958,3657,3239,1147,322,7926,6450,1476,6450,2144,4306,2018-01-01,zipcode,Dallas
ZCTA5 75216,48,54150,26326,817,65200,39741,19777,33857,11574,12795,7368,1550,570,20863,18415,2448,18415,9002,9413,2018-01-01,zipcode,Dallas
ZCTA5 75217,48,86896,38225,898,80800,60202,25417,47616,21491,14668,9477,1432,548,25849,23629,2220,23629,14419,9210,2018-01-01,zipcode,Dallas
ZCTA5 75218,48,21576,77669,1114,303500,18381,5498,17099,1280,2576,4095,5367,3781,11250,10417,833,10417,6891,3526,2018-01-01,zipcode,Dallas
ZCTA5 75219,48,23419,72967,1338,295300,21715,3877,19941,1746,2037,3644,7564,4950,16888,14592,2296,14592,5042,9550,2018-01-01,zipcode,Dallas
ZCTA5 75220,48,43088,46417,838,256400,32425,8542,26520,12413,5562,3414,3108,2023,16095,14476,1619,14476,4522,9954,2018-01-01,zipcode,Dallas
ZCTA5 75223,48,15128,47790,885,114500,11130,3734,9290,4027,1795,1625,1210,633,5138,4589,549,4589,2407,2182,2018-01-01,zipcode,Dallas
ZCTA5 75224,48,37280,40306,843,101600,26360,9495,19680,7140,5613,4276,1945,706,11952,10994,958,10994,5318,5676,2018-01-01,zipcode,Dallas
ZCTA5 75225,48,21296,167656,2018,1041300,16406,6959,15091,132,537,1833,7273,5316,9854,8804,1050,8804,6711,2093,2018-01-01,zipcode,Dallas
ZCTA5 75226,48,4674,46891,1153,-666666666,4134,1495,3702,1198,539,967,724,274,1946,1785,161,1785,114,1671,2018-01-01,zipcode,Dallas
ZCTA5 75227,48,58995,40975,911,98800,41298,16228,33180,11626,10226,7843,2475,1010,19191,17672,1519,17672,10219,7453,2018-01-01,zipcode,Dallas
ZCTA5 75228,48,73606,42470,841,130800,54004,17373,44676,13003,12272,11309,5592,2500,28120,25797,2323,25797,12019,13778,2018-01-01,zipcode,Dallas
ZCTA5 75229,48,31790,93416,989,371900,24899,6855,21908,5150,2772,3773,6053,4160,11870,10935,935,10935,7882,3053,2018-01-01,zipcode,Dallas
ZCTA5 75230,48,27872,87904,1028,597600,23697,7302,21042,1188,1820,4010,7858,6166,14363,13237,1126,13237,8195,5042,2018-01-01,zipcode,Dallas
ZCTA5 75231,48,41072,39322,862,327700,31207,8116,26283,6410,5879,6044,5501,2449,19798,16956,2842,16956,2996,13960,2018-01-01,zipcode,Dallas
ZCTA5 75232,48,31941,36507,946,96800,24359,11554,20701,5048,7279,5869,1566,939,11755,10943,812,10943,6178,4765,2018-01-01,zipcode,Dallas
ZCTA5 75233,48,16092,47399,929,138600,11852,3817,9513,2713,2946,2098,1088,668,5461,5025,436,5025,2509,2516,2018-01-01,zipcode,Dallas
ZCTA5 75234,48,33737,66332,1257,167200,27227,8579,22813,4367,5368,6149,4938,1991,12959,12016,943,12016,7319,4697,2018-01-01,zipcode,Dallas
ZCTA5 75235,48,19141,49294,1167,134600,16266,5110,13597,3811,3287,2414,2454,1631,8745,7853,892,7853,1885,5968,2018-01-01,zipcode,Dallas
ZCTA5 75236,48,19447,40672,929,123000,13628,4139,11024,2864,3080,3213,1384,483,7393,6686,707,6686,2317,4369,2018-01-01,zipcode,Dallas
ZCTA5 75237,48,20773,27296,837,120200,14412,4895,11223,2229,3669,3733,1170,422,9328,8441,887,8441,1235,7206,2018-01-01,zipcode,Dallas
ZCTA5 75238,48,33220,62868,919,341200,24314,7390,21254,3329,3174,4852,6272,3627,13814,12776,1038,12776,6345,6431,2018-01-01,zipcode,Dallas
ZCTA5 75240,48,28537,47437,991,238500,21047,4753,17048,4906,3361,3433,3692,1656,11263,10194,1069,10194,2454,7740,2018-01-01,zipcode,Dallas
ZCTA5 75241,48,30682,32419,883,78800,23122,11113,19122,4064,7204,5782,1476,596,11734,10811,923,10811,6344,4467,2018-01-01,zipcode,Dallas
ZCTA5 75243,48,67848,40954,888,217400,51881,13422,43732,6918,9066,14508,8628,4612,31202,27936,3266,27936,6744,21192,2018-01-01,zipcode,Dallas
ZCTA5 75244,48,13701,85914,1388,402400,11260,2662,10007,327,853,2038,4310,2479,6624,6115,509,6115,2992,3123,2018-01-01,zipcode,Dallas
ZCTA5 75246,48,2357,26090,709,169900,2049,719,1875,514,362,581,301,117,1518,1306,212,1306,149,1157,2018-01-01,zipcode,Dallas
ZCTA5 75247,48,730,17798,868,-666666666,730,469,718,178,239,218,26,57,240,210,30,210,0,210,2018-01-01,zipcode,Dallas
ZCTA5 75248,48,36829,84236,1139,373400,30545,8752,27684,1666,3485,6172,9877,6484,17631,16389,1242,16389,8682,7707,2018-01-01,zipcode,Dallas
ZCTA5 75249,48,16482,54856,1443,145600,12097,3368,9924,1673,2422,3782,1449,598,5205,5143,62,5143,3795,1348,2018-01-01,zipcode,Dallas
ZCTA5 75251,48,2414,63438,1289,-666666666,2243,712,1842,88,208,562,520,464,1944,1583,361,1583,0,1583,2018-01-01,zipcode,Dallas
ZCTA5 75252,48,26511,61151,963,348400,22656,6400,18935,980,2053,4124,6937,4841,14176,12402,1774,12402,5162,7240,2018-01-01,zipcode,Dallas
ZCTA5 75253,48,23894,43028,988,46800,15868,5173,12642,5578,3422,2930,568,144,7159,6453,706,6453,3991,2462,2018-01-01,zipcode,Dallas
ZCTA5 75254,48,26828,51276,1087,387300,20179,3485,17112,2617,2830,4439,4743,2483,13256,11720,1536,11720,2186,9534,2018-01-01,zipcode,Dallas
ZCTA5 75270,48,0,-666666666,-666666666,-666666666,0,0,0,0,0,0,0,0,0,0,0,0,0,0,2018-01-01,zipcode,Dallas
ZCTA5 75287,48,54882,51045,1004,289300,44853,7767,38610,1930,6710,12222,12192,5556,30860,27735,3125,27735,5691,22044,2018-01-01,zipcode,Dallas
ZCTA5 75390,48,0,-666666666,-666666666,-666666666,0,0,0,0,0,0,0,0,0,0,0,0,0,0,2018-01-01,zipcode,Dallas
ZCTA5 75401,48,18869,35091,788,65700,14030,5653,12173,2513,4694,3307,987,672,7412,6626,786,6626,3396,3230,2018-01-01,zipcode,Greenville
ZCTA5 75402,48,17516,65391,902,140400,13887,5249,12013,1269,3355,3722,2172,1495,7232,6517,715,6517,4630,1887,2018-01-01,zipcode,Greenville
ZCTA5 75407,48,16582,60763,1109,172200,12396,3923,10390,1395,3615,3401,1562,417,5862,5516,346,5516,3798,1718,2018-01-01,zipcode,Princeton
ZCTA5 75409,48,15379,86304,1604,178800,10688,3297,9372,1341,2831,2703,1592,905,4923,4566,357,4566,3478,1088,2018-01-01,zipcode,Anna
ZCTA5 75410,48,5726,64069,619,155000,4600,2189,4140,629,1578,1284,351,298,2547,2113,434,2113,1717,396,2018-01-01,zipcode,Alba
ZCTA5 75411,48,1278,59583,871,75200,1068,509,995,162,370,340,63,60,632,507,125,507,375,132,2018-01-01,zipcode,Arthur city
ZCTA5 75412,48,567,51250,-666666666,72200,472,158,436,54,158,193,31,0,402,288,114,288,272,16,2018-01-01,zipcode,Bagwell
ZCTA5 75413,48,246,-666666666,996,63500,174,63,153,35,67,37,8,6,123,90,33,90,55,35,2018-01-01,zipcode,Bailey
ZCTA5 75414,48,2879,61000,734,127700,2198,861,1890,238,485,694,313,160,1166,1006,160,1006,825,181,2018-01-01,zipcode,Bells
ZCTA5 75415,48,190,85865,-666666666,-666666666,171,120,154,15,75,41,23,0,110,79,31,79,69,10,2018-01-01,zipcode,Ben franklin
ZCTA5 75416,48,3103,44529,805,89200,2419,1040,1854,276,681,465,341,91,1344,1133,211,1133,856,277,2018-01-01,zipcode,Blossom
ZCTA5 75417,48,2628,40263,568,72900,2019,783,1784,371,556,659,138,60,1266,1016,250,1016,886,130,2018-01-01,zipcode,Bogata
ZCTA5 75418,48,14376,43466,756,106100,12046,6887,10477,1767,3786,3213,983,728,5711,4868,843,4868,3291,1577,2018-01-01,zipcode,Bonham
ZCTA5 75420,48,981,72384,702,126800,792,281,682,106,286,209,61,20,404,351,53,351,280,71,2018-01-01,zipcode,Brashear
ZCTA5 75421,48,492,63750,769,115800,409,153,328,36,96,174,11,11,266,199,67,199,188,11,2018-01-01,zipcode,Brookston
ZCTA5 75422,48,3301,57245,844,108600,2555,1158,2239,356,589,788,328,178,1253,1095,158,1095,908,187,2018-01-01,zipcode,Campbell
ZCTA5 75423,48,2801,61678,819,123400,2321,1025,2122,203,823,743,284,69,1284,1047,237,1047,888,159,2018-01-01,zipcode,Celeste
ZCTA5 75424,48,3103,78359,1116,149900,2484,883,2111,405,717,701,199,89,1282,1121,161,1121,913,208,2018-01-01,zipcode,Blue ridge
ZCTA5 75426,48,4625,34988,640,53900,4126,2209,3457,488,1508,1045,353,63,2823,1959,864,1959,1244,715,2018-01-01,zipcode,Clarksville
ZCTA5 75428,48,10951,33196,820,79400,9245,3990,5915,641,1879,1687,828,880,4593,3747,846,3747,1761,1986,2018-01-01,zipcode,Commerce
ZCTA5 75431,48,2424,49583,634,58800,1952,869,1757,369,819,475,71,23,1042,842,200,842,596,246,2018-01-01,zipcode,Como
ZCTA5 75432,48,3509,43281,582,76500,2710,1227,2246,384,700,572,350,240,1557,1292,265,1292,834,458,2018-01-01,zipcode,Cooper
ZCTA5 75433,48,2614,52132,818,95400,2168,998,1926,327,647,559,252,141,1240,1017,223,1017,829,188,2018-01-01,zipcode,Cumby
ZCTA5 75435,48,1271,36750,489,57300,1014,422,856,165,372,230,81,8,579,497,82,497,347,150,2018-01-01,zipcode,Deport
ZCTA5 75436,48,2159,50551,493,86200,1662,842,1438,211,620,500,74,33,1041,807,234,807,612,195,2018-01-01,zipcode,Detroit
ZCTA5 75437,48,1361,64135,-666666666,114700,1098,471,992,121,345,343,139,44,536,481,55,481,443,38,2018-01-01,zipcode,Dike
ZCTA5 75438,48,908,68636,707,104500,695,283,622,54,259,180,89,40,423,350,73,350,298,52,2018-01-01,zipcode,Dodd city
ZCTA5 75439,48,1087,62109,823,109100,857,336,721,122,256,256,52,35,428,401,27,401,236,165,2018-01-01,zipcode,Ector
ZCTA5 75440,48,6506,49963,667,130300,5282,2598,4839,698,1958,1557,450,176,3276,2567,709,2567,2136,431,2018-01-01,zipcode,Emory
ZCTA5 75441,48,122,50887,-666666666,-666666666,101,44,89,0,37,0,36,16,80,66,14,66,66,0,2018-01-01,zipcode,Enloe
ZCTA5 75442,48,9681,69703,1099,150900,7702,3170,6735,727,2468,2391,836,313,3722,3292,430,3292,2408,884,2018-01-01,zipcode,Farmersville
ZCTA5 75446,48,3398,37946,752,87500,2616,1421,2083,335,658,583,351,156,1511,1190,321,1190,900,290,2018-01-01,zipcode,Honey grove
ZCTA5 75447,48,1256,77464,863,163000,952,334,781,67,271,411,22,10,483,407,76,407,336,71,2018-01-01,zipcode,Ivanhoe
ZCTA5 75448,48,724,-666666666,-666666666,68800,556,274,487,66,134,247,40,0,260,247,13,247,227,20,2018-01-01,zipcode,Klondike
ZCTA5 75449,48,1351,36319,740,75300,1112,512,945,121,319,340,98,67,774,585,189,585,419,166,2018-01-01,zipcode,Ladonia
ZCTA5 75450,48,141,-666666666,-666666666,109700,106,50,106,0,32,65,9,0,119,56,63,56,43,13,2018-01-01,zipcode,Lake creek
ZCTA5 75451,48,1135,38373,603,112500,982,413,873,120,215,373,132,33,709,549,160,549,462,87,2018-01-01,zipcode,Leesburg
ZCTA5 75452,48,4312,56287,815,110700,3250,1352,2764,389,1114,687,412,162,1689,1453,236,1453,958,495,2018-01-01,zipcode,Leonard
ZCTA5 75453,48,2878,52500,879,120500,2451,1133,2150,373,787,679,270,41,1435,1122,313,1122,923,199,2018-01-01,zipcode,Lone oak
ZCTA5 75454,48,9583,96889,1660,270400,6898,2169,5768,366,1394,2229,1167,612,2892,2892,0,2892,2479,413,2018-01-01,zipcode,Melissa
ZCTA5 75455,48,28460,47169,727,99700,21091,7842,17229,4154,5464,4770,2072,769,10553,9300,1253,9300,5945,3355,2018-01-01,zipcode,Mount pleasant
ZCTA5 75457,48,6464,51783,833,133100,5193,2016,4393,485,1508,1318,814,268,3508,2303,1205,2303,1718,585,2018-01-01,zipcode,Mount vernon
ZCTA5 75459,48,5285,64535,785,124400,4182,1204,3523,331,1330,1364,404,94,2087,1898,189,1898,1417,481,2018-01-01,zipcode,Howe
ZCTA5 75460,48,23191,33851,686,72100,18321,7995,15796,2890,5575,5456,1483,392,11273,9366,1907,9366,4688,4678,2018-01-01,zipcode,Paris
ZCTA5 75462,48,11611,59016,767,145500,8989,3274,7937,754,2235,2585,1555,808,4881,4449,432,4449,3454,995,2018-01-01,zipcode,Paris
ZCTA5 75468,48,797,51198,-666666666,66300,660,438,580,44,269,202,16,49,391,324,67,324,312,12,2018-01-01,zipcode,Pattonville
ZCTA5 75469,48,276,39844,550,85000,267,181,247,40,120,67,5,15,156,117,39,117,101,16,2018-01-01,zipcode,Pecan gap
ZCTA5 75470,48,434,62946,-666666666,50000,347,173,328,68,136,59,34,31,184,162,22,162,162,0,2018-01-01,zipcode,Petty
ZCTA5 75471,48,1488,70469,-666666666,87600,1092,449,794,186,308,237,63,0,478,413,65,413,336,77,2018-01-01,zipcode,Pickton
ZCTA5 75472,48,3685,46414,744,102600,3070,1484,2651,402,1075,859,203,112,1656,1357,299,1357,967,390,2018-01-01,zipcode,Point
ZCTA5 75473,48,3672,64094,747,105500,2896,1142,2569,342,862,958,282,125,1469,1371,98,1371,1132,239,2018-01-01,zipcode,Powderly
ZCTA5 75474,48,14744,48072,878,90800,12082,5871,10451,2350,3885,3203,774,239,6626,5334,1292,5334,4143,1191,2018-01-01,zipcode,Quinlan
ZCTA5 75475,48,148,30938,-666666666,127300,138,95,104,6,52,19,27,0,61,55,6,55,50,5,2018-01-01,zipcode,Randolph
ZCTA5 75476,48,1162,56563,937,143300,1052,502,987,191,247,406,87,56,555,477,78,477,417,60,2018-01-01,zipcode,Ravenna
ZCTA5 75477,48,1204,45313,551,68100,1003,385,830,116,278,280,125,31,499,402,97,402,260,142,2018-01-01,zipcode,Roxton
ZCTA5 75478,48,949,46563,800,109600,746,356,679,135,186,272,68,18,423,369,54,369,289,80,2018-01-01,zipcode,Saltillo
ZCTA5 75479,48,1819,52414,618,87700,1519,696,1330,182,501,451,132,64,784,680,104,680,547,133,2018-01-01,zipcode,Savoy
ZCTA5 75480,48,1857,59097,630,233900,1497,652,1313,181,288,511,254,79,1339,631,708,631,581,50,2018-01-01,zipcode,Scroggins
ZCTA5 75481,48,366,51250,-666666666,79500,285,129,242,34,102,69,25,12,195,139,56,139,121,18,2018-01-01,zipcode,Sulphur bluff
ZCTA5 75482,48,25003,50154,777,100300,19288,7608,16585,2552,6029,4648,2234,1122,10687,9413,1274,9413,6153,3260,2018-01-01,zipcode,Sulphur springs
ZCTA5 75486,48,2099,56176,797,98900,1634,803,1421,330,417,390,233,51,999,808,191,808,709,99,2018-01-01,zipcode,Sumner
ZCTA5 75487,48,1987,49583,581,91000,1470,619,1304,187,360,534,127,96,801,700,101,700,504,196,2018-01-01,zipcode,Talco
ZCTA5 75488,48,566,49821,-666666666,125000,467,255,444,34,199,141,62,8,373,236,137,236,190,46,2018-01-01,zipcode,Telephone
ZCTA5 75489,48,1122,53688,887,102500,835,355,729,27,228,372,73,29,433,425,8,425,272,153,2018-01-01,zipcode,Tom bean
ZCTA5 75490,48,2518,72143,1077,129400,1944,619,1761,288,639,600,161,73,1042,906,136,906,791,115,2018-01-01,zipcode,Trenton
ZCTA5 75491,48,4913,72371,621,136800,3907,1311,3317,362,899,1265,558,233,2132,1793,339,1793,1360,433,2018-01-01,zipcode,Whitewright
ZCTA5 75492,48,394,52500,669,128100,338,141,297,8,110,119,38,22,194,184,10,184,163,21,2018-01-01,zipcode,Windom
ZCTA5 75493,48,533,42115,625,55300,311,87,231,106,67,52,6,0,156,126,30,126,84,42,2018-01-01,zipcode,Winfield
ZCTA5 75494,48,9489,40474,779,114700,7505,3856,6543,1022,2130,2541,669,181,4464,3473,991,3473,2670,803,2018-01-01,zipcode,Winnsboro
ZCTA5 75495,48,8564,78673,1060,180100,6805,2286,5507,359,1863,2110,947,228,3117,2871,246,2871,2363,508,2018-01-01,zipcode,Van alstyne
ZCTA5 75496,48,3812,64900,549,114400,3004,1258,2544,270,933,907,299,135,1581,1270,311,1270,1045,225,2018-01-01,zipcode,Wolfe city
ZCTA5 75497,48,3368,63417,731,169400,3006,1783,2813,417,796,965,519,116,1913,1479,434,1479,1207,272,2018-01-01,zipcode,Yantis
ZCTA5 75501,48,35834,36690,695,95200,27702,12510,23861,3176,8530,8745,2357,1053,15203,12874,2329,12874,7614,5260,2018-01-01,zipcode,Texarkana
ZCTA5 75503,48,25710,60730,859,168600,19862,8257,16947,1109,4126,5626,3985,2101,11047,9600,1447,9600,6021,3579,2018-01-01,zipcode,Texarkana
ZCTA5 75550,48,790,39453,616,65800,719,360,629,89,272,168,65,35,512,343,169,343,278,65,2018-01-01,zipcode,Annona
ZCTA5 75551,48,10679,46642,725,97600,8242,3771,7448,1088,2835,1914,1185,426,5052,4100,952,4100,3218,882,2018-01-01,zipcode,Atlanta
ZCTA5 75554,48,2077,44327,502,81600,1735,770,1311,172,634,281,165,59,1040,819,221,819,710,109,2018-01-01,zipcode,Avery
ZCTA5 75555,48,1672,53008,742,76900,1299,608,1179,156,615,266,83,59,920,659,261,659,584,75,2018-01-01,zipcode,Bivins
ZCTA5 75556,48,1321,43043,779,69800,950,438,755,129,380,154,61,31,482,410,72,410,288,122,2018-01-01,zipcode,Bloomburg
ZCTA5 75558,48,1770,44719,-666666666,56700,1247,443,982,290,529,153,10,0,588,465,123,465,410,55,2018-01-01,zipcode,Cookville
ZCTA5 75559,48,5168,40691,591,81100,4140,2272,3731,500,1474,1148,440,169,2668,2033,635,2033,1557,476,2018-01-01,zipcode,De kalb
ZCTA5 75560,48,857,38125,690,67200,731,265,644,135,277,113,61,58,464,374,90,374,297,77,2018-01-01,zipcode,Douglassville
ZCTA5 75561,48,5099,45497,725,74300,3958,1599,3575,508,1332,1307,265,163,2260,1953,307,1953,1317,636,2018-01-01,zipcode,Hooks
ZCTA5 75562,48,177,44087,-666666666,70200,177,77,160,0,35,118,7,0,117,117,0,117,117,0,2018-01-01,zipcode,Kildare
ZCTA5 75563,48,4709,41719,545,92700,3920,2077,3470,481,1582,934,326,147,2262,1891,371,1891,1401,490,2018-01-01,zipcode,Linden
ZCTA5 75565,48,173,31328,825,-666666666,166,92,132,23,73,25,11,0,122,91,31,91,60,31,2018-01-01,zipcode,Mc leod
ZCTA5 75566,48,730,43750,879,128100,670,431,652,82,376,130,50,14,485,374,111,374,353,21,2018-01-01,zipcode,Marietta
ZCTA5 75567,48,5275,65330,895,89500,4080,1749,3478,208,1874,984,323,89,2014,1752,262,1752,1358,394,2018-01-01,zipcode,Maud
ZCTA5 75568,48,2459,40948,591,80300,1817,700,1582,217,709,509,122,25,1291,1038,253,1038,685,353,2018-01-01,zipcode,Naples
ZCTA5 75569,48,3350,40046,904,111100,2402,1039,1839,111,808,648,156,116,1386,1339,47,1339,725,614,2018-01-01,zipcode,Nash
ZCTA5 75570,48,11024,50786,598,106800,9731,5767,8485,1704,3284,2360,881,256,3944,3205,739,3205,2121,1084,2018-01-01,zipcode,New boston
ZCTA5 75571,48,2971,53077,540,105200,2222,954,1989,89,867,722,231,80,1444,1072,372,1072,941,131,2018-01-01,zipcode,Omaha
ZCTA5 75572,48,4173,51161,574,65600,3413,1610,2854,387,1213,793,247,214,1882,1662,220,1662,1279,383,2018-01-01,zipcode,Queen city
ZCTA5 75573,48,103,85729,-666666666,83900,83,52,83,4,13,9,30,27,54,40,14,40,40,0,2018-01-01,zipcode,Redwater
ZCTA5 75574,48,1704,56371,578,80000,1427,692,1226,176,423,412,162,53,865,734,131,734,590,144,2018-01-01,zipcode,Simms
ZCTA5 75601,48,16144,41932,731,126900,12708,5505,10980,1889,3226,3932,1158,775,6962,6043,919,6043,3588,2455,2018-01-01,zipcode,Longview
ZCTA5 75602,48,22159,39428,758,82800,16591,6715,12921,3401,4232,3712,1106,470,8455,7140,1315,7140,4235,2905,2018-01-01,zipcode,Longview
ZCTA5 75603,48,5954,50265,732,97000,4635,1997,4056,600,1295,1501,439,221,2888,2248,640,2248,1856,392,2018-01-01,zipcode,Longview
ZCTA5 75604,48,31011,51158,862,143000,23148,8097,19654,2800,5812,6660,2944,1438,12605,11361,1244,11361,6205,5156,2018-01-01,zipcode,Longview
ZCTA5 75605,48,30011,60807,905,181800,24101,8762,20956,1329,5294,7904,4540,1889,13288,12213,1075,12213,7398,4815,2018-01-01,zipcode,Longview
ZCTA5 75630,48,2178,42029,-666666666,98200,2015,1210,1970,241,796,623,220,90,1592,1148,444,1148,1018,130,2018-01-01,zipcode,Avinger
ZCTA5 75631,48,3151,60660,777,104900,2376,976,2113,299,733,863,137,81,1365,1117,248,1117,819,298,2018-01-01,zipcode,Beckville
ZCTA5 75633,48,13553,51795,731,108300,10544,4488,8874,1260,2965,2986,1120,543,6251,5182,1069,5182,3723,1459,2018-01-01,zipcode,Carthage
ZCTA5 75638,48,5777,43206,773,76200,4675,2097,4075,493,1608,1252,420,302,2665,2356,309,2356,1780,576,2018-01-01,zipcode,Daingerfield
ZCTA5 75639,48,2821,31744,809,80300,2386,1202,2074,454,809,662,130,19,1569,1150,419,1150,889,261,2018-01-01,zipcode,De berry
ZCTA5 75640,48,4585,44625,1051,118000,3414,1537,3022,449,1084,769,506,214,1969,1767,202,1767,1412,355,2018-01-01,zipcode,Diana
ZCTA5 75641,48,133,40833,-666666666,85600,108,57,102,20,23,50,9,0,66,52,14,52,40,12,2018-01-01,zipcode,Easton
ZCTA5 75642,48,71,-666666666,-666666666,-666666666,71,22,62,17,21,24,0,0,60,26,34,26,26,0,2018-01-01,zipcode,Elysian fields
ZCTA5 75643,48,2421,52344,658,85400,1907,856,1683,336,549,549,168,81,1167,860,307,860,714,146,2018-01-01,zipcode,Gary
ZCTA5 75644,48,13387,43710,739,117000,10239,4760,8752,1369,3165,2812,880,526,5334,4528,806,4528,3308,1220,2018-01-01,zipcode,Gilmer
ZCTA5 75645,48,10158,62992,932,149300,8276,3084,7222,872,2436,2414,1057,443,4274,3398,876,3398,3031,367,2018-01-01,zipcode,Gilmer
ZCTA5 75647,48,12719,48079,945,113000,10209,4216,8659,1363,2720,3188,1136,252,5274,4517,757,4517,3311,1206,2018-01-01,zipcode,Gladewater
ZCTA5 75650,48,9493,64264,858,168100,7170,2546,6206,491,1851,2513,848,503,3721,3373,348,3373,2293,1080,2018-01-01,zipcode,Hallsville
ZCTA5 75651,48,1870,50833,791,116000,1458,532,1303,226,452,458,137,30,987,756,231,756,702,54,2018-01-01,zipcode,Harleton
ZCTA5 75652,48,16946,48526,722,145100,14174,8221,11570,2582,3759,3559,1117,553,5344,4559,785,4559,3116,1443,2018-01-01,zipcode,Henderson
ZCTA5 75654,48,12450,48925,724,115800,9156,3673,7961,1542,2072,2945,878,524,5277,4616,661,4616,3685,931,2018-01-01,zipcode,Henderson
ZCTA5 75656,48,4204,42470,580,89200,3310,1457,2929,563,1311,695,231,129,1960,1554,406,1554,1163,391,2018-01-01,zipcode,Hughes springs
ZCTA5 75657,48,7722,36131,766,93100,6385,3105,5555,861,2260,1625,545,264,4556,3249,1307,3249,2385,864,2018-01-01,zipcode,Jefferson
ZCTA5 75661,48,2917,49950,605,93900,2585,1350,2080,416,673,510,390,91,2091,1049,1042,1049,803,246,2018-01-01,zipcode,Karnack
ZCTA5 75662,48,25702,59326,795,116800,19874,7701,16502,3339,4518,5907,1957,781,10437,8894,1543,8894,6417,2477,2018-01-01,zipcode,Kilgore
ZCTA5 75667,48,1142,40333,778,99000,914,504,817,219,245,280,59,14,530,450,80,450,320,130,2018-01-01,zipcode,Laneville
ZCTA5 75668,48,2285,37738,570,105600,1833,945,1589,232,652,475,154,76,1163,926,237,926,620,306,2018-01-01,zipcode,Lone star
ZCTA5 75669,48,489,68237,-666666666,109600,440,209,358,59,103,159,22,15,318,193,125,193,172,21,2018-01-01,zipcode,Long branch
ZCTA5 75670,48,18056,39626,686,68200,13498,6019,10809,2303,4296,2722,1027,461,7332,5931,1401,5931,3722,2209,2018-01-01,zipcode,Marshall
ZCTA5 75672,48,15970,54705,866,131100,12703,5778,11086,1553,3660,3457,1642,774,7159,5893,1266,5893,4541,1352,2018-01-01,zipcode,Marshall
ZCTA5 75681,48,2148,48958,607,110700,1833,983,1655,238,696,406,192,123,1202,908,294,908,745,163,2018-01-01,zipcode,Mount enterprise
ZCTA5 75682,48,507,54583,-666666666,109400,398,198,346,85,120,97,16,28,204,172,32,172,170,2,2018-01-01,zipcode,New london
ZCTA5 75683,48,3873,40481,698,84800,3125,1438,2544,595,906,812,221,10,1808,1480,328,1480,1174,306,2018-01-01,zipcode,Ore city
ZCTA5 75684,48,7607,53321,810,95500,5817,2577,5074,1011,1808,1821,358,76,2923,2413,510,2413,1757,656,2018-01-01,zipcode,Overton
ZCTA5 75686,48,13132,43947,743,90500,10108,4484,8694,1342,3112,2583,1206,451,5886,4829,1057,4829,3534,1295,2018-01-01,zipcode,Pittsburg
ZCTA5 75691,48,3587,55250,726,113900,2697,1135,2486,617,864,755,216,34,1953,1398,555,1398,968,430,2018-01-01,zipcode,Tatum
ZCTA5 75692,48,4747,54392,905,93200,3835,1886,3368,554,1287,1038,271,218,1964,1530,434,1530,1284,246,2018-01-01,zipcode,Waskom
ZCTA5 75693,48,7122,61983,1030,151600,5383,1530,4531,580,1510,1528,708,205,2511,2366,145,2366,1631,735,2018-01-01,zipcode,White oak
ZCTA5 75701,48,35549,47919,882,136900,28384,11658,22479,3031,5327,8248,4122,1751,14227,12129,2098,12129,6868,5261,2018-01-01,zipcode,Tyler
ZCTA5 75702,48,27766,33066,714,73800,20416,7910,16099,5687,4414,4722,965,311,9194,7660,1534,7660,3966,3694,2018-01-01,zipcode,Tyler
ZCTA5 75703,48,41842,57934,928,211700,33195,11652,27688,1604,4579,10933,6789,3783,18659,16692,1967,16692,9095,7597,2018-01-01,zipcode,Tyler
ZCTA5 75704,48,10352,38385,819,102700,7986,3840,6761,1962,1974,2006,505,314,3621,3088,533,3088,2329,759,2018-01-01,zipcode,Tyler
ZCTA5 75705,48,3555,41563,908,106200,2862,1000,2582,350,960,922,220,130,1237,987,250,987,845,142,2018-01-01,zipcode,Tyler
ZCTA5 75706,48,9505,55801,739,88600,7050,2570,5993,1794,1338,2149,615,97,3577,2841,736,2841,1946,895,2018-01-01,zipcode,Tyler
ZCTA5 75707,48,14157,65000,1184,168600,11208,4530,9482,690,2248,3355,1928,1261,6183,5388,795,5388,3927,1461,2018-01-01,zipcode,Tyler
ZCTA5 75708,48,8417,41270,789,82100,6077,2361,4623,1579,1652,1110,229,53,2837,2393,444,2393,1639,754,2018-01-01,zipcode,Tyler
ZCTA5 75709,48,5004,54935,993,143600,4194,1572,3594,440,890,1041,722,501,2392,1885,507,1885,1019,866,2018-01-01,zipcode,Tyler
ZCTA5 75750,48,3483,55192,642,136600,2893,1094,2584,271,985,811,365,152,1497,1366,131,1366,1143,223,2018-01-01,zipcode,Arp
ZCTA5 75751,48,16855,43568,804,90300,13062,6075,10830,1948,3707,2875,1441,859,6891,5692,1199,5692,3614,2078,2018-01-01,zipcode,Athens
ZCTA5 75752,48,7222,51153,827,123800,5967,2802,5214,558,971,2121,1068,496,3750,2763,987,2763,2339,424,2018-01-01,zipcode,Athens
ZCTA5 75754,48,6304,53796,880,155800,5358,2209,4408,656,1152,1892,459,249,2866,2372,494,2372,1766,606,2018-01-01,zipcode,Ben wheeler
ZCTA5 75755,48,5303,49135,748,121700,4213,1773,3495,626,1117,1196,405,151,2402,1942,460,1942,1314,628,2018-01-01,zipcode,Big sandy
ZCTA5 75756,48,4611,57826,848,94100,3424,1367,2759,542,751,827,434,205,1732,1546,186,1546,1374,172,2018-01-01,zipcode,Brownsboro
ZCTA5 75757,48,12408,65897,760,193600,9719,4028,8198,726,1902,2694,1899,977,4978,4315,663,4315,3851,464,2018-01-01,zipcode,Bullard
ZCTA5 75758,48,8119,51082,746,119600,6789,3178,6146,627,2141,2057,804,517,4170,3422,748,3422,2624,798,2018-01-01,zipcode,Chandler
ZCTA5 75759,48,46,-666666666,-666666666,55800,35,23,33,4,14,12,3,0,45,25,20,25,21,4,2018-01-01,zipcode,Cuney
ZCTA5 75760,48,2392,46887,648,79500,1903,942,1776,272,822,430,182,70,1234,1006,228,1006,786,220,2018-01-01,zipcode,Cushing
ZCTA5 75762,48,12697,76903,1125,171600,9655,3743,8597,477,1611,3021,2429,1059,5513,4648,865,4648,3694,954,2018-01-01,zipcode,Flint
ZCTA5 75763,48,6463,55122,728,114700,5185,2622,4612,627,1555,1666,414,350,2969,2340,629,2340,1961,379,2018-01-01,zipcode,Frankston
ZCTA5 75764,48,166,63750,538,57200,129,36,116,27,32,45,11,1,70,70,0,70,57,13,2018-01-01,zipcode,Gallatin
ZCTA5 75765,48,7292,46742,782,130500,6382,3800,5387,608,1721,1830,873,355,4208,2928,1280,2928,2442,486,2018-01-01,zipcode,Hawkins
ZCTA5 75766,48,27008,45316,700,92100,20474,8663,17310,4286,5292,5025,1856,851,11378,9730,1648,9730,6613,3117,2018-01-01,zipcode,Jacksonville
ZCTA5 75770,48,3223,60541,673,110300,2706,1322,2311,265,713,950,215,168,1472,1198,274,1198,990,208,2018-01-01,zipcode,Larue
ZCTA5 75771,48,20488,64267,976,159500,16378,7682,14460,1539,4079,5011,2667,1164,8489,7143,1346,7143,5561,1582,2018-01-01,zipcode,Lindale
ZCTA5 75773,48,13640,47824,775,134800,10904,5433,9574,1680,3294,3284,823,493,5950,4862,1088,4862,3741,1121,2018-01-01,zipcode,Mineola
ZCTA5 75778,48,3172,50349,662,116500,2527,1537,2308,286,801,734,336,151,1681,1231,450,1231,973,258,2018-01-01,zipcode,Murchison
ZCTA5 75779,48,135,51250,-666666666,66300,76,28,76,14,44,10,8,0,60,34,26,34,34,0,2018-01-01,zipcode,Neches
ZCTA5 75780,48,238,62813,469,-666666666,192,65,122,68,40,14,0,0,90,59,31,59,42,17,2018-01-01,zipcode,New summerfield
ZCTA5 75783,48,7917,51071,743,103800,6602,3410,5978,900,2164,2035,663,216,3659,3040,619,3040,2411,629,2018-01-01,zipcode,Quitman
ZCTA5 75784,48,957,41208,790,88900,701,315,533,113,213,148,33,26,341,301,40,301,278,23,2018-01-01,zipcode,Reklaw
ZCTA5 75785,48,11265,48787,815,87800,9180,5287,7800,1597,2608,2460,766,369,3959,3314,645,3314,2474,840,2018-01-01,zipcode,Rusk
ZCTA5 75788,48,109,-666666666,-666666666,-666666666,109,71,109,0,38,71,0,0,71,71,0,71,49,22,2018-01-01,zipcode,Sacul
ZCTA5 75789,48,7972,50625,881,154200,6021,2507,5308,688,1752,1818,762,288,3190,2802,388,2802,2283,519,2018-01-01,zipcode,Troup
ZCTA5 75790,48,4154,61048,698,121600,3200,1214,2737,280,879,983,446,149,1701,1512,189,1512,1166,346,2018-01-01,zipcode,Van
ZCTA5 75791,48,13305,73231,995,162900,10381,3324,8559,881,1649,3426,1655,948,4817,4365,452,4365,3370,995,2018-01-01,zipcode,Whitehouse
ZCTA5 75792,48,2765,44688,821,83800,2343,1069,2084,186,755,940,111,92,1314,1111,203,1111,748,363,2018-01-01,zipcode,Winona
ZCTA5 75801,48,16346,38412,746,102600,12353,4982,10253,1496,3450,3353,1320,634,7112,5844,1268,5844,3515,2329,2018-01-01,zipcode,Palestine
ZCTA5 75803,48,22170,44848,747,89400,18805,11433,16531,3438,6296,5112,1053,632,7250,6052,1198,6052,4547,1505,2018-01-01,zipcode,Palestine
ZCTA5 75831,48,5494,43011,700,86600,4269,2031,3876,752,1497,1160,355,112,2695,1931,764,1931,1442,489,2018-01-01,zipcode,Buffalo
ZCTA5 75832,48,121,-666666666,-666666666,-666666666,121,14,98,0,23,75,0,0,17,9,8,9,0,9,2018-01-01,zipcode,Cayuga
ZCTA5 75833,48,3144,59375,794,121200,2622,1340,2325,304,780,666,373,202,2123,1263,860,1263,933,330,2018-01-01,zipcode,Centerville
ZCTA5 75835,48,11105,28907,681,85900,8762,4155,7406,1662,2449,2141,851,303,5896,4526,1370,4526,2755,1771,2018-01-01,zipcode,Crockett
ZCTA5 75838,48,577,60114,-666666666,-666666666,474,226,402,117,127,117,18,23,402,249,153,249,214,35,2018-01-01,zipcode,Donie
ZCTA5 75839,48,5330,39903,802,76900,4098,1873,3431,539,1250,1267,230,145,2472,2066,406,2066,1723,343,2018-01-01,zipcode,Elkhart
ZCTA5 75840,48,6627,56228,716,117600,5201,2170,4516,699,1644,1374,610,189,3237,2403,834,2403,1739,664,2018-01-01,zipcode,Fairfield
ZCTA5 75844,48,6001,40824,676,80100,4886,2175,4310,523,1665,1427,608,87,3734,2438,1296,2438,1957,481,2018-01-01,zipcode,Grapeland
ZCTA5 75845,48,3137,45548,728,77700,2606,1414,2174,351,746,769,231,77,1743,1177,566,1177,929,248,2018-01-01,zipcode,Groveton
ZCTA5 75846,48,2909,37325,691,78100,2120,1036,1916,496,841,414,113,52,1909,1061,848,1061,806,255,2018-01-01,zipcode,Jewett
ZCTA5 75847,48,1856,37202,510,70400,1475,823,1385,250,438,402,213,82,1071,762,309,762,561,201,2018-01-01,zipcode,Kennard
ZCTA5 75848,48,122,48438,-666666666,57100,92,47,50,14,7,25,4,0,60,55,5,55,41,14,2018-01-01,zipcode,Kirvin
ZCTA5 75849,48,78,30750,631,37500,78,52,57,8,34,14,1,0,42,33,9,33,22,11,2018-01-01,zipcode,Latexo
ZCTA5 75850,48,674,54309,-666666666,162500,574,284,507,123,156,50,146,32,385,288,97,288,281,7,2018-01-01,zipcode,Leona
ZCTA5 75851,48,4878,50642,738,117100,4566,3744,4290,914,1821,1158,231,166,1427,861,566,861,726,135,2018-01-01,zipcode,Lovelady
ZCTA5 75852,48,4462,41607,1020,116100,4225,3816,3447,888,1462,911,123,63,701,425,276,425,333,92,2018-01-01,zipcode,Midway
ZCTA5 75853,48,538,35556,491,82000,508,269,459,102,195,128,15,19,393,288,105,288,241,47,2018-01-01,zipcode,Montalba
ZCTA5 75855,48,2968,37386,717,78500,2340,1438,2166,321,781,791,179,94,1651,1093,558,1093,903,190,2018-01-01,zipcode,Oakwood
ZCTA5 75856,48,98,-666666666,-666666666,-666666666,67,28,67,0,32,18,17,0,78,22,56,22,22,0,2018-01-01,zipcode,Pennington
ZCTA5 75858,48,0,-666666666,-666666666,-666666666,0,0,0,0,0,0,0,0,22,0,22,0,0,0,2018-01-01,zipcode,Ratcliff
ZCTA5 75859,48,1815,32038,1003,77300,1526,912,1374,221,411,489,218,35,1324,823,501,823,703,120,2018-01-01,zipcode,Streetman
ZCTA5 75860,48,6572,52280,650,84700,5398,3182,4845,992,1489,1985,290,89,2687,1981,706,1981,1494,487,2018-01-01,zipcode,Teague
ZCTA5 75861,48,9153,59010,802,84600,8748,7939,8335,2388,3083,2561,229,74,1040,707,333,707,368,339,2018-01-01,zipcode,Tennessee colony
ZCTA5 75862,48,10044,39200,764,77900,8218,4676,7466,1373,2848,2337,658,250,6546,4199,2347,4199,3313,886,2018-01-01,zipcode,Trinity
ZCTA5 75901,48,31134,49130,820,101200,23540,9058,19646,4201,6112,6069,2298,966,12066,10642,1424,10642,6978,3664,2018-01-01,zipcode,Lufkin
ZCTA5 75904,48,34059,49631,827,113900,26144,10598,22029,3374,6469,7771,3058,1357,14292,12366,1926,12366,7435,4931,2018-01-01,zipcode,Lufkin
ZCTA5 75925,48,4083,36419,694,89900,2991,1575,2528,325,939,919,262,83,1891,1491,400,1491,971,520,2018-01-01,zipcode,Alto
ZCTA5 75926,48,1103,45667,918,78500,890,376,812,55,351,315,68,23,659,442,217,442,357,85,2018-01-01,zipcode,Apple springs
ZCTA5 75928,48,1212,41110,-666666666,61500,1054,499,814,76,374,353,11,0,693,339,354,339,296,43,2018-01-01,zipcode,Bon wier
ZCTA5 75929,48,1682,47417,-666666666,111700,1414,853,1264,133,444,567,64,56,1615,705,910,705,572,133,2018-01-01,zipcode,Broaddus
ZCTA5 75930,48,2026,28398,772,71700,1708,963,1438,224,698,380,59,77,1154,750,404,750,674,76,2018-01-01,zipcode,Bronson
ZCTA5 75931,48,2075,48837,766,95100,1771,948,1641,267,680,446,180,68,2112,900,1212,900,816,84,2018-01-01,zipcode,Brookeland
ZCTA5 75932,48,1691,47560,828,98800,1398,907,1170,232,337,503,70,28,1256,573,683,573,528,45,2018-01-01,zipcode,Burkeville
ZCTA5 75933,48,1469,28833,-666666666,48800,1197,684,1090,276,503,295,16,0,542,444,98,444,444,0,2018-01-01,zipcode,Call
ZCTA5 75934,48,204,85089,-666666666,68000,164,32,140,0,62,61,11,6,145,68,77,68,40,28,2018-01-01,zipcode,Camden
ZCTA5 75935,48,14025,40661,565,74400,10259,4679,8416,2180,2551,2411,1016,258,5815,4827,988,4827,3412,1415,2018-01-01,zipcode,Center
ZCTA5 75936,48,1095,56333,1594,78900,829,385,691,124,184,306,70,7,527,326,201,326,276,50,2018-01-01,zipcode,Chester
ZCTA5 75937,48,925,40179,425,95700,743,397,631,80,244,215,75,17,434,339,95,339,292,47,2018-01-01,zipcode,Chireno
ZCTA5 75938,48,2809,43056,723,99000,2335,1440,2189,278,1001,615,212,83,1706,1046,660,1046,895,151,2018-01-01,zipcode,Colmesneil
ZCTA5 75939,48,4912,41667,492,65500,3844,1419,3160,630,1152,1044,198,136,2321,1870,451,1870,1256,614,2018-01-01,zipcode,Corrigan
ZCTA5 75941,48,8826,45777,587,83200,6907,3514,5955,1449,1834,1892,582,198,3128,2629,499,2629,1964,665,2018-01-01,zipcode,Diboll
ZCTA5 75942,48,222,50451,-666666666,-666666666,116,29,116,29,40,47,0,0,164,67,97,67,67,0,2018-01-01,zipcode,Doucette
ZCTA5 75943,48,1344,42228,632,61100,1069,371,888,143,327,262,132,24,672,515,157,515,381,134,2018-01-01,zipcode,Douglass
ZCTA5 75944,48,1265,45530,717,77700,1086,588,987,156,397,312,89,33,834,532,302,532,475,57,2018-01-01,zipcode,Etoile
ZCTA5 75946,48,3543,46542,833,109000,2794,1350,2399,402,799,859,285,54,1636,1338,298,1338,898,440,2018-01-01,zipcode,Garrison
ZCTA5 75948,48,6269,32750,547,146700,5268,3406,4991,656,1699,1755,589,292,5453,2533,2920,2533,2270,263,2018-01-01,zipcode,Hemphill
ZCTA5 75949,48,7501,36775,696,83400,5933,2966,5255,992,1937,1941,231,154,3721,2873,848,2873,2177,696,2018-01-01,zipcode,Huntington
ZCTA5 75951,48,16183,40630,759,98000,12256,5337,10467,1818,4487,2573,959,630,7525,5448,2077,5448,3751,1697,2018-01-01,zipcode,Jasper
ZCTA5 75954,48,2698,43315,714,63000,2287,1114,1934,489,712,431,184,118,1537,1083,454,1083,852,231,2018-01-01,zipcode,Joaquin
ZCTA5 75956,48,8510,45371,647,110100,6816,3390,5985,905,2673,1755,264,388,3725,3109,616,3109,2404,705,2018-01-01,zipcode,Kirbyville
ZCTA5 75959,48,678,47917,-666666666,78300,615,351,536,56,245,138,30,67,755,274,481,274,263,11,2018-01-01,zipcode,Milam
ZCTA5 75960,48,712,-666666666,-666666666,44000,503,173,436,71,66,260,39,0,419,305,114,305,284,21,2018-01-01,zipcode,Moscow
ZCTA5 75961,48,15644,36023,793,104600,12403,4404,8877,1329,2686,2937,1248,677,7320,6163,1157,6163,3132,3031,2018-01-01,zipcode,Nacogdoches
ZCTA5 75962,48,3189,-666666666,-666666666,-666666666,3189,2333,39,0,0,23,16,0,0,0,0,0,0,0,2018-01-01,zipcode,
ZCTA5 75964,48,19717,41571,673,86100,13934,5332,12023,3437,3613,3073,1211,689,8017,6825,1192,6825,4224,2601,2018-01-01,zipcode,Nacogdoches
ZCTA5 75965,48,18281,48579,780,179900,15187,5842,10480,609,2287,3070,2681,1833,8642,7504,1138,7504,3548,3956,2018-01-01,zipcode,Nacogdoches
ZCTA5 75966,48,4619,44470,588,68900,3743,2008,3106,388,1261,938,402,117,2321,1680,641,1680,1392,288,2018-01-01,zipcode,Newton
ZCTA5 75968,48,1846,27569,641,57100,1521,878,1325,213,592,357,94,69,979,682,297,682,528,154,2018-01-01,zipcode,Pineland
ZCTA5 75969,48,3965,49848,718,108100,3331,1444,2943,548,1273,721,191,210,1710,1374,336,1374,1195,179,2018-01-01,zipcode,Pollok
ZCTA5 75972,48,5997,36265,525,87200,4872,2845,4366,987,1719,1006,395,259,3388,2407,981,2407,1880,527,2018-01-01,zipcode,San augustine
ZCTA5 75973,48,2657,44848,470,66600,2095,1021,1920,349,892,408,207,64,1787,1069,718,1069,919,150,2018-01-01,zipcode,Shelbyville
ZCTA5 75974,48,3411,38517,613,72000,2723,1428,2328,678,701,607,261,81,1527,1236,291,1236,920,316,2018-01-01,zipcode,Tenaha
ZCTA5 75975,48,3703,40476,546,88400,2879,1339,2493,539,669,926,253,106,1936,1402,534,1402,1068,334,2018-01-01,zipcode,Timpson
ZCTA5 75976,48,680,27589,327,106800,535,307,482,121,160,155,43,3,309,249,60,249,118,131,2018-01-01,zipcode,Wells
ZCTA5 75977,48,395,22386,663,67600,387,211,336,86,145,105,0,0,309,254,55,254,208,46,2018-01-01,zipcode,Wiergate
ZCTA5 75978,48,143,74236,-666666666,135400,109,26,94,0,40,37,0,17,58,51,7,51,45,6,2018-01-01,zipcode,Woden
ZCTA5 75979,48,11852,37268,719,81000,10069,6252,8173,1502,3812,1914,752,193,5397,3525,1872,3525,2875,650,2018-01-01,zipcode,Woodville
ZCTA5 75980,48,2472,37696,781,81200,2003,1188,1670,293,748,512,102,15,2009,1043,966,1043,816,227,2018-01-01,zipcode,Zavalla
ZCTA5 76001,48,32185,86682,1354,177900,24596,7548,20225,1768,4206,6719,5024,2508,10713,10116,597,10116,8344,1772,2018-01-01,zipcode,Arlington
ZCTA5 76002,48,36209,86033,1812,171900,26468,6548,21614,2641,4831,7179,4509,2454,9818,9646,172,9646,8086,1560,2018-01-01,zipcode,Arlington
ZCTA5 76006,48,24774,47741,949,238400,19844,4193,16928,973,3686,5429,4350,2490,13701,11700,2001,11700,2997,8703,2018-01-01,zipcode,Arlington
ZCTA5 76008,48,17910,128632,1483,309600,13056,4140,11313,342,1725,3145,4153,1948,6146,5796,350,5796,5175,621,2018-01-01,zipcode,Aledo
ZCTA5 76009,48,21041,55493,892,106000,15755,5867,13323,2885,4905,4178,943,412,7655,6902,753,6902,5465,1437,2018-01-01,zipcode,Alvarado
ZCTA5 76010,48,57668,36461,873,92100,41301,13870,31234,12583,9257,6309,2441,644,19643,17389,2254,17389,5693,11696,2018-01-01,zipcode,Arlington
ZCTA5 76011,48,22640,37159,889,113200,17763,4715,14466,2920,3551,4782,2369,844,11089,9626,1463,9626,1939,7687,2018-01-01,zipcode,Arlington
ZCTA5 76012,48,26919,61214,981,186300,21495,7927,18243,1940,3202,5973,4369,2759,11145,10342,803,10342,6310,4032,2018-01-01,zipcode,Arlington
ZCTA5 76013,48,33760,52352,909,174300,27514,9861,21984,1513,4593,7389,5532,2957,14011,13193,818,13193,6820,6373,2018-01-01,zipcode,Arlington
ZCTA5 76014,48,36156,52071,1148,107700,26870,8772,21946,5268,6656,6845,2330,847,12221,10883,1338,10883,5580,5303,2018-01-01,zipcode,Arlington
ZCTA5 76015,48,16253,55644,1131,135100,12997,4447,10765,1587,2453,3711,1906,1108,7093,6267,826,6267,3053,3214,2018-01-01,zipcode,Arlington
ZCTA5 76016,48,31318,81411,1422,185600,25687,8979,21989,1377,4303,6916,6275,3118,11855,11245,610,11245,8949,2296,2018-01-01,zipcode,Arlington
ZCTA5 76017,48,47355,70871,1102,166700,37842,11819,31709,2386,6795,11870,7089,3569,17989,16972,1017,16972,11321,5651,2018-01-01,zipcode,Arlington
ZCTA5 76018,48,31729,67081,1408,134900,24566,6894,19662,2867,5163,6877,3319,1436,9696,9477,219,9477,6809,2668,2018-01-01,zipcode,Arlington
ZCTA5 76020,48,28207,63560,849,147800,22779,8968,19745,2027,7227,6660,2673,1158,11400,10119,1281,10119,7588,2531,2018-01-01,zipcode,Azle
ZCTA5 76021,48,35741,71376,1049,217600,29420,8809,26044,1306,4952,8942,7493,3351,16133,15378,755,15378,8583,6795,2018-01-01,zipcode,Bedford
ZCTA5 76022,48,13532,56476,1106,152100,11071,3366,9814,580,2134,4141,1726,1233,6087,5722,365,5722,2942,2780,2018-01-01,zipcode,Bedford
ZCTA5 76023,48,6533,58651,1014,143700,5302,2270,4565,706,1428,1612,690,129,2454,2325,129,2325,1749,576,2018-01-01,zipcode,Boyd
ZCTA5 76028,48,69413,78175,1210,180000,52842,17605,45878,3520,13353,16832,8209,3964,25584,24119,1465,24119,18758,5361,2018-01-01,zipcode,Burleson
ZCTA5 76031,48,16855,54052,865,95500,13243,5573,11349,2313,4231,3234,1243,328,6469,5848,621,5848,4468,1380,2018-01-01,zipcode,Cleburne
ZCTA5 76033,48,26310,54961,906,125300,20499,8135,17031,2739,6030,4969,2288,1005,10474,9831,643,9831,6134,3697,2018-01-01,zipcode,Cleburne
ZCTA5 76034,48,26001,175096,1865,488500,20719,7470,18352,218,1739,4367,6942,5086,9050,8886,164,8886,8554,332,2018-01-01,zipcode,Colleyville
ZCTA5 76035,48,1654,97426,1264,284300,1452,525,1241,172,257,388,206,218,660,605,55,605,582,23,2018-01-01,zipcode,Cresson
ZCTA5 76036,48,25597,72671,1212,168500,19581,6490,16463,1374,4598,6611,2892,988,9275,8483,792,8483,6338,2145,2018-01-01,zipcode,Crowley
ZCTA5 76039,48,35394,67200,1192,183500,28289,6554,25211,2205,5043,8376,6448,3139,16052,14872,1180,14872,6211,8661,2018-01-01,zipcode,Euless
ZCTA5 76040,48,32005,57560,908,170200,24460,6665,21242,2663,5069,7073,4340,2097,12822,11478,1344,11478,5158,6320,2018-01-01,zipcode,Euless
ZCTA5 76041,48,568,-666666666,-666666666,103600,478,82,358,46,137,73,102,0,202,161,41,161,138,23,2018-01-01,zipcode,Forreston
ZCTA5 76043,48,7499,54412,1018,204600,5839,2473,4995,650,1835,1461,794,255,3255,2776,479,2776,1875,901,2018-01-01,zipcode,Glen rose
ZCTA5 76044,48,3810,67857,874,189900,3070,1248,2651,287,1011,924,321,108,1644,1484,160,1484,1156,328,2018-01-01,zipcode,Godley
ZCTA5 76048,48,24118,49844,870,148200,19263,9115,17043,2329,5730,5341,2491,1152,11816,9437,2379,9437,6392,3045,2018-01-01,zipcode,Granbury
ZCTA5 76049,48,29279,68155,967,205800,24137,11298,21467,1768,5919,7490,4103,2187,12788,11174,1614,11174,9218,1956,2018-01-01,zipcode,Granbury
ZCTA5 76050,48,6241,69194,916,163100,4924,1951,4372,552,1355,1709,521,235,2498,2218,280,2218,1801,417,2018-01-01,zipcode,Grandview
ZCTA5 76051,48,52454,85667,1278,294400,41834,10099,34986,2835,5398,10542,11048,5163,21126,20081,1045,20081,10812,9269,2018-01-01,zipcode,Grapevine
ZCTA5 76052,48,22744,109311,1484,264300,16285,4287,13925,857,3214,4811,3852,1191,7575,7209,366,7209,6533,676,2018-01-01,zipcode,Haslet
ZCTA5 76053,48,30939,55174,1054,145800,23576,7207,20145,3216,5687,6465,3272,1505,11845,10770,1075,10770,5978,4792,2018-01-01,zipcode,Hurst
ZCTA5 76054,48,12119,96875,1378,231600,9606,3198,8627,363,1418,3040,2736,1070,4466,4371,95,4371,3784,587,2018-01-01,zipcode,Hurst
ZCTA5 76055,48,2703,46739,798,78600,2156,963,1994,441,670,608,185,90,1101,1008,93,1008,750,258,2018-01-01,zipcode,Itasca
ZCTA5 76058,48,18535,56587,909,124000,13771,5519,11638,2267,4533,3589,812,437,6887,6115,772,6115,4894,1221,2018-01-01,zipcode,Joshua
ZCTA5 76059,48,5211,43944,842,106600,4014,1734,2892,554,724,896,548,170,1719,1569,150,1569,594,975,2018-01-01,zipcode,Keene
ZCTA5 76060,48,8198,75534,957,200400,6530,2218,5416,787,1644,1463,990,532,2924,2749,175,2749,2050,699,2018-01-01,zipcode,Kennedale
ZCTA5 76061,48,39,-666666666,-666666666,-666666666,39,0,39,0,0,39,0,0,20,20,0,20,20,0,2018-01-01,zipcode,Lillian
ZCTA5 76063,48,71555,95407,1366,234900,53508,15477,45046,2878,8628,15434,12296,5810,24394,23178,1216,23178,17669,5509,2018-01-01,zipcode,Mansfield
ZCTA5 76064,48,1808,64375,942,175900,1238,506,1127,130,436,377,65,119,618,547,71,547,446,101,2018-01-01,zipcode,Maypearl
ZCTA5 76065,48,35643,93071,1127,222600,26876,8209,22940,1392,5661,8533,5187,2167,12212,11755,457,11755,9692,2063,2018-01-01,zipcode,Midlothian
ZCTA5 76066,48,2443,58810,543,169400,2180,896,1927,331,518,787,190,101,1224,1053,171,1053,850,203,2018-01-01,zipcode,Millsap
ZCTA5 76067,48,20215,42034,766,88500,15580,6377,13081,2256,4990,4100,1353,382,8518,6865,1653,6865,4627,2238,2018-01-01,zipcode,Mineral wells
ZCTA5 76070,48,853,89868,-666666666,220000,716,325,662,64,158,162,239,39,276,268,8,268,268,0,2018-01-01,zipcode,Nemo
ZCTA5 76071,48,4508,55104,877,153500,3408,1379,2703,600,914,792,355,42,1506,1321,185,1321,988,333,2018-01-01,zipcode,Newark
ZCTA5 76073,48,5774,71786,1055,147100,4375,1603,3809,516,1368,1354,433,138,2190,1944,246,1944,1651,293,2018-01-01,zipcode,Paradise
ZCTA5 76077,48,342,14821,-666666666,-666666666,342,264,285,13,78,132,22,40,221,154,67,154,154,0,2018-01-01,zipcode,Rainbow
ZCTA5 76078,48,10168,67113,1161,150100,7468,2563,6525,720,2301,2281,935,288,3338,3143,195,3143,2694,449,2018-01-01,zipcode,Rhome
ZCTA5 76082,48,18951,61732,987,147300,14997,6059,12933,2101,4626,4370,1415,421,7192,6392,800,6392,5113,1279,2018-01-01,zipcode,Springtown
ZCTA5 76084,48,8453,58708,951,109300,6570,2945,5451,1183,1975,1690,384,219,2595,2337,258,2337,1849,488,2018-01-01,zipcode,Venus
ZCTA5 76085,48,11119,70648,795,207700,8771,3429,7728,939,2620,2662,1019,488,3838,3572,266,3572,3007,565,2018-01-01,zipcode,Weatherford
ZCTA5 76086,48,23383,59253,1038,124500,18389,6850,15107,1961,5094,5538,1709,805,9008,8157,851,8157,4246,3911,2018-01-01,zipcode,Weatherford
ZCTA5 76087,48,27089,95876,1268,231400,21187,7957,18784,1476,3609,6359,5012,2328,11348,9640,1708,9640,8536,1104,2018-01-01,zipcode,Weatherford
ZCTA5 76088,48,11827,72773,986,208000,9396,3592,8020,991,2812,2827,985,405,4445,4048,397,4048,3184,864,2018-01-01,zipcode,Weatherford
ZCTA5 76092,48,30908,230750,1445,657300,22361,8168,19287,119,1918,4068,7668,5514,9472,9165,307,9165,8434,731,2018-01-01,zipcode,Southlake
ZCTA5 76093,48,1753,49500,758,92500,1311,617,1131,201,509,289,94,38,739,666,73,666,424,242,2018-01-01,zipcode,Rio vista
ZCTA5 76102,48,9417,68824,1343,232400,8327,4282,7174,1083,1531,1597,1663,1300,4138,3542,596,3542,1085,2457,2018-01-01,zipcode,Fort worth
ZCTA5 76103,48,14508,40712,802,93300,11489,4705,9609,2869,2558,2466,1182,534,5827,5056,771,5056,3060,1996,2018-01-01,zipcode,Fort worth
ZCTA5 76104,48,18327,27471,869,64300,13367,6546,11158,3579,3549,2569,985,476,7497,6306,1191,6306,2625,3681,2018-01-01,zipcode,Fort worth
ZCTA5 76105,48,21822,29423,805,61500,15461,7099,12252,5574,3722,2412,395,149,7343,6566,777,6566,3346,3220,2018-01-01,zipcode,Fort worth
ZCTA5 76106,48,40014,36980,890,79300,28149,10977,22040,10797,7378,3004,766,95,10859,10292,567,10292,5179,5113,2018-01-01,zipcode,Fort worth
ZCTA5 76107,48,29851,63817,1092,274200,25385,8595,21899,2447,4100,4817,6451,4084,16183,14065,2118,14065,6881,7184,2018-01-01,zipcode,Fort worth
ZCTA5 76108,48,43178,65864,998,140200,33154,10447,28657,3532,9378,9060,4553,2134,16189,15336,853,15336,10338,4998,2018-01-01,zipcode,Fort worth
ZCTA5 76109,48,23512,76856,1159,430700,19347,7286,14430,515,1493,2262,5451,4709,11061,9737,1324,9737,5455,4282,2018-01-01,zipcode,Fort worth
ZCTA5 76110,48,31825,46313,871,115900,24445,8940,19433,7491,3863,3180,2857,2042,11362,10378,984,10378,6109,4269,2018-01-01,zipcode,Fort worth
ZCTA5 76111,48,22320,46840,923,88800,16263,5249,13196,5512,3984,2209,1126,365,7310,6641,669,6641,4034,2607,2018-01-01,zipcode,Fort worth
ZCTA5 76112,48,41743,42269,854,109400,31925,12078,27444,5273,7835,8823,3677,1836,19092,16491,2601,16491,8063,8428,2018-01-01,zipcode,Fort worth
ZCTA5 76114,48,25416,49713,943,90400,19647,6940,16690,4061,6127,4415,1536,551,9743,8893,850,8893,5127,3766,2018-01-01,zipcode,Fort worth
ZCTA5 76115,48,20507,37607,846,75500,14763,5351,11529,5796,2819,1713,704,497,6469,5847,622,5847,2894,2953,2018-01-01,zipcode,Fort worth
ZCTA5 76116,48,50640,48575,911,180100,40152,13446,34075,4665,8261,10292,7150,3707,24558,21506,3052,21506,7923,13583,2018-01-01,zipcode,Fort worth
ZCTA5 76117,48,31860,48280,898,99100,24008,7887,19941,5357,7549,5255,1264,516,11129,10270,859,10270,5630,4640,2018-01-01,zipcode,Haltom city
ZCTA5 76118,48,16300,71439,924,162400,12317,3569,10602,1210,2863,3407,2457,665,5869,5521,348,5521,4198,1323,2018-01-01,zipcode,Fort worth
ZCTA5 76119,48,50213,34985,869,70700,36094,15840,29486,10555,9458,7278,1483,712,16258,14423,1835,14423,7367,7056,2018-01-01,zipcode,Fort worth
ZCTA5 76120,48,18820,50663,963,149900,14229,3734,11855,1422,3344,4380,2015,694,8118,7191,927,7191,2930,4261,2018-01-01,zipcode,Fort worth
ZCTA5 76123,48,34056,84460,1552,161500,25218,7144,20551,1408,5451,6649,4467,2576,11121,10647,474,10647,8257,2390,2018-01-01,zipcode,Fort worth
ZCTA5 76126,48,22825,87878,1139,195700,17355,5590,16030,769,3502,5272,4034,2453,9388,8496,892,8496,6955,1541,2018-01-01,zipcode,Fort worth
ZCTA5 76127,48,2049,69348,1707,-666666666,1986,1539,1552,314,513,612,72,41,62,62,0,62,7,55,2018-01-01,zipcode,Naval air station jrb
ZCTA5 76129,48,2920,-666666666,-666666666,-666666666,2920,2155,70,0,0,55,15,0,0,0,0,0,0,0,2018-01-01,zipcode,Fort worth
ZCTA5 76131,48,40463,83708,1456,173000,28482,7888,24433,2556,5895,8399,5410,2173,12960,12313,647,12313,8887,3426,2018-01-01,zipcode,Fort worth
ZCTA5 76132,48,27058,53688,989,291500,21458,6954,18640,794,3699,5162,5155,3830,13587,12711,876,12711,4018,8693,2018-01-01,zipcode,Fort worth
ZCTA5 76133,48,51369,53696,1049,125000,39300,13481,33165,4647,10622,9462,5704,2730,20104,18264,1840,18264,11429,6835,2018-01-01,zipcode,Fort worth
ZCTA5 76134,48,26484,47763,995,108200,19348,7115,15766,3360,5889,4561,1232,724,9058,8320,738,8320,4945,3375,2018-01-01,zipcode,Fort worth
ZCTA5 76135,48,23230,62603,927,145400,17801,5979,15131,2621,4030,4911,2426,1143,8791,8152,639,8152,5553,2599,2018-01-01,zipcode,Fort worth
ZCTA5 76137,48,60061,72336,1273,159300,45392,12107,37077,3853,8262,13304,8568,3090,21131,19982,1149,19982,12301,7681,2018-01-01,zipcode,Fort worth
ZCTA5 76140,48,30661,54142,1138,102600,22487,7883,18499,3815,6460,5399,1834,991,10722,9606,1116,9606,6639,2967,2018-01-01,zipcode,Fort worth
ZCTA5 76148,48,23586,71151,1382,121500,18361,5036,15563,1993,4799,5958,2074,739,7964,7775,189,7775,6241,1534,2018-01-01,zipcode,Fort worth
ZCTA5 76155,48,5494,57424,1114,-666666666,4635,593,3990,145,710,1162,1302,671,3146,2888,258,2888,0,2888,2018-01-01,zipcode,Fort worth
ZCTA5 76164,48,15685,36586,862,66900,11789,4354,9371,5085,2694,1200,301,91,4908,4379,529,4379,2498,1881,2018-01-01,zipcode,Fort worth
ZCTA5 76177,48,9361,93233,1285,222200,7069,1397,6178,59,1032,2157,2306,624,3981,3618,363,3618,2162,1456,2018-01-01,zipcode,Fort worth
ZCTA5 76179,48,60286,86456,1469,176200,44572,12770,38168,3304,9754,12801,8987,3322,20710,19425,1285,19425,14576,4849,2018-01-01,zipcode,Fort worth
ZCTA5 76180,48,36964,57142,1112,159100,29012,8761,24451,2561,5701,8741,5388,2060,15531,14390,1141,14390,6840,7550,2018-01-01,zipcode,North richland hills
ZCTA5 76182,48,31031,88314,1163,217800,24393,7206,21592,1240,4608,7358,6060,2326,11461,11071,390,11071,9102,1969,2018-01-01,zipcode,North richland hills
ZCTA5 76201,48,27965,29724,869,154900,26324,9662,11893,1267,1683,3874,3278,1791,11332,9927,1405,9927,1969,7958,2018-01-01,zipcode,Denton
ZCTA5 76205,48,22093,47139,1064,209500,19081,6611,13093,1507,2948,3636,3205,1797,8269,7548,721,7548,2746,4802,2018-01-01,zipcode,Denton
ZCTA5 76207,48,14342,61836,1136,216500,11740,4916,10059,913,2032,3184,2779,1151,5710,5431,279,5431,3445,1986,2018-01-01,zipcode,Denton
ZCTA5 76208,48,24687,81151,1173,248600,18560,4883,15625,1798,3199,4540,4070,2018,8504,8036,468,8036,5212,2824,2018-01-01,zipcode,Denton
ZCTA5 76209,48,24838,53869,1023,159500,19560,4883,15157,1710,3408,4974,3178,1887,10163,9122,1041,9122,4285,4837,2018-01-01,zipcode,Denton
ZCTA5 76210,48,44231,90080,1375,214300,34981,10830,29346,2274,5217,10662,7217,3976,15327,14656,671,14656,11295,3361,2018-01-01,zipcode,Denton
ZCTA5 76225,48,3035,68026,754,155200,2395,887,1897,152,665,709,267,104,1214,1056,158,1056,831,225,2018-01-01,zipcode,Alvord
ZCTA5 76226,48,25100,132935,1620,382000,18881,5792,16801,681,2148,4081,6537,3354,8657,8292,365,8292,7575,717,2018-01-01,zipcode,Argyle
ZCTA5 76227,48,32000,91293,1641,210900,23205,5266,20506,1055,4374,7435,5616,2026,10818,10543,275,10543,8279,2264,2018-01-01,zipcode,Aubrey
ZCTA5 76228,48,999,61172,675,102300,825,373,726,76,252,231,123,44,489,355,134,355,302,53,2018-01-01,zipcode,Bellevue
ZCTA5 76230,48,9762,53158,897,131100,7752,3388,6761,765,2633,2335,643,385,5031,4111,920,4111,2947,1164,2018-01-01,zipcode,Bowie
ZCTA5 76233,48,3327,76435,1032,146400,2557,821,2242,220,635,855,463,69,1377,1201,176,1201,908,293,2018-01-01,zipcode,Collinsville
ZCTA5 76234,48,16187,65470,1042,165700,12549,4102,10588,1184,3083,3988,1676,657,6517,5895,622,5895,4478,1417,2018-01-01,zipcode,Decatur
ZCTA5 76238,48,353,64844,659,89600,313,143,282,15,103,121,32,11,173,151,22,151,112,39,2018-01-01,zipcode,Era
ZCTA5 76239,48,1214,69444,832,161700,994,523,900,79,333,272,137,79,620,514,106,514,404,110,2018-01-01,zipcode,Forestburg
ZCTA5 76240,48,27419,50527,852,142200,21564,7842,18418,2783,5921,6385,2118,1211,11918,10822,1096,10822,6693,4129,2018-01-01,zipcode,Gainesville
ZCTA5 76244,48,76882,101866,1655,237400,53894,11881,45897,1714,7566,14898,15690,6029,24866,24115,751,24115,19027,5088,2018-01-01,zipcode,Keller
ZCTA5 76245,48,2068,49611,668,89900,1762,709,1555,133,470,629,281,42,1399,812,587,812,661,151,2018-01-01,zipcode,Gordonville
ZCTA5 76247,48,14260,90848,1217,175600,10618,3009,9291,826,2230,3479,2147,609,4467,4246,221,4246,3449,797,2018-01-01,zipcode,Justin
ZCTA5 76248,48,39376,129550,1325,342900,30105,9570,25653,1086,3699,6637,9534,4697,13227,12983,244,12983,10497,2486,2018-01-01,zipcode,Keller
ZCTA5 76249,48,8550,81207,1177,169100,6700,1903,5766,675,1513,1715,1367,496,3142,2852,290,2852,2218,634,2018-01-01,zipcode,Krum
ZCTA5 76250,48,1017,80789,1100,184400,786,287,709,18,164,275,154,98,409,404,5,404,353,51,2018-01-01,zipcode,Lindsay
ZCTA5 76251,48,671,49750,870,144800,532,265,502,83,189,167,44,19,343,267,76,267,201,66,2018-01-01,zipcode,Montague
ZCTA5 76252,48,2834,74000,863,184300,2196,567,1747,103,512,519,411,202,1209,1052,157,1052,807,245,2018-01-01,zipcode,Muenster
ZCTA5 76253,48,294,54286,550,-666666666,218,65,202,35,114,48,4,1,106,96,10,96,69,27,2018-01-01,zipcode,Myra
ZCTA5 76255,48,5444,44921,629,101000,4353,1877,3945,781,1374,1191,381,218,3036,2294,742,2294,1572,722,2018-01-01,zipcode,Nocona
ZCTA5 76258,48,6876,65839,1044,182500,5591,1874,4584,679,1216,1543,757,389,2931,2643,288,2643,1813,830,2018-01-01,zipcode,Pilot point
ZCTA5 76259,48,6042,75183,1257,168200,4615,1389,3965,761,960,1384,629,231,1916,1861,55,1861,1385,476,2018-01-01,zipcode,Ponder
ZCTA5 76261,48,235,59643,-666666666,73600,211,128,187,20,86,24,46,11,144,100,44,100,76,24,2018-01-01,zipcode,Ringgold
ZCTA5 76262,48,37183,114633,1238,355400,27416,7894,24192,997,3775,6421,8694,4305,12879,12350,529,12350,9625,2725,2018-01-01,zipcode,Roanoke
ZCTA5 76263,48,158,-666666666,-666666666,-666666666,119,61,119,0,62,31,26,0,78,53,25,53,27,26,2018-01-01,zipcode,Rosston
ZCTA5 76264,48,1508,58500,814,120600,1311,448,1110,68,398,532,101,11,819,650,169,650,468,182,2018-01-01,zipcode,Sadler
ZCTA5 76265,48,1602,51908,694,99000,1239,456,1025,135,388,344,116,42,941,641,300,641,496,145,2018-01-01,zipcode,Saint jo
ZCTA5 76266,48,15695,71076,1158,170100,12331,3759,10522,1290,3506,3207,1862,657,5737,5365,372,5365,4118,1247,2018-01-01,zipcode,Sanger
ZCTA5 76268,48,273,44000,1167,42700,192,107,185,38,78,52,11,6,98,98,0,98,71,27,2018-01-01,zipcode,Southmayd
ZCTA5 76270,48,1834,75781,439,130100,1507,699,1264,264,507,349,119,25,930,649,281,649,457,192,2018-01-01,zipcode,Sunset
ZCTA5 76271,48,1741,72768,1033,159700,1302,446,1092,154,330,324,228,56,693,591,102,591,481,110,2018-01-01,zipcode,Tioga
ZCTA5 76272,48,4130,67500,687,121900,3341,1232,2903,407,911,999,481,105,1657,1550,107,1550,1269,281,2018-01-01,zipcode,Valley view
ZCTA5 76273,48,9575,64841,901,143000,7632,2920,6519,838,2048,2475,801,357,4022,3579,443,3579,2706,873,2018-01-01,zipcode,Whitesboro
ZCTA5 76301,48,15056,26505,663,52100,11614,4656,9941,2247,3716,2754,887,337,8223,6485,1738,6485,3050,3435,2018-01-01,zipcode,Wichita falls
ZCTA5 76302,48,13083,45978,786,110100,10187,4222,8374,1062,2486,3033,1388,405,5559,4980,579,4980,2922,2058,2018-01-01,zipcode,Wichita falls
ZCTA5 76305,48,4352,54583,618,118400,3572,1611,3265,325,1254,1001,523,162,2261,1849,412,1849,1605,244,2018-01-01,zipcode,Wichita falls
ZCTA5 76306,48,15201,45470,803,75500,11550,4516,9824,1366,3356,3263,1379,460,6986,5744,1242,5744,3443,2301,2018-01-01,zipcode,Wichita falls
ZCTA5 76308,48,19092,49864,822,139300,15810,5408,11807,562,2765,3828,2915,1737,8994,8048,946,8048,4700,3348,2018-01-01,zipcode,Wichita falls
ZCTA5 76309,48,13695,44898,774,92100,10097,3619,8647,1170,2540,2782,1393,762,6173,5186,987,5186,3285,1901,2018-01-01,zipcode,Wichita falls
ZCTA5 76310,48,18362,66368,818,135200,14226,4848,12882,1140,3227,4429,2630,1456,7863,7214,649,7214,4989,2225,2018-01-01,zipcode,Wichita falls
ZCTA5 76311,48,8784,62011,1238,-666666666,8000,778,1921,67,351,849,432,222,647,635,12,635,6,629,2018-01-01,zipcode,Sheppard afb
ZCTA5 76351,48,2047,43542,611,81800,1597,616,1343,103,539,349,237,115,1003,839,164,839,609,230,2018-01-01,zipcode,Archer city
ZCTA5 76354,48,12021,51236,843,106000,9541,3568,8059,823,2662,2779,1324,471,5712,4883,829,4883,3305,1578,2018-01-01,zipcode,Burkburnett
ZCTA5 76357,48,622,47500,692,63800,474,175,404,24,165,121,68,26,280,224,56,224,178,46,2018-01-01,zipcode,Byers
ZCTA5 76360,48,3533,38835,667,40800,3100,1545,2860,466,1232,811,252,99,2192,1609,583,1609,1120,489,2018-01-01,zipcode,Electra
ZCTA5 76363,48,523,71875,414,29200,386,167,310,53,101,113,41,2,222,157,65,157,135,22,2018-01-01,zipcode,Goree
ZCTA5 76364,48,152,66250,675,75000,111,24,99,1,44,23,20,11,100,60,40,60,40,20,2018-01-01,zipcode,Harrold
ZCTA5 76365,48,4419,47900,719,86600,3632,1731,3149,293,1246,1009,436,165,2460,1784,676,1784,1407,377,2018-01-01,zipcode,Henrietta
ZCTA5 76366,48,1841,52400,685,96800,1527,652,1285,153,438,511,138,45,1031,722,309,722,568,154,2018-01-01,zipcode,Holliday
ZCTA5 76367,48,14917,57742,947,90300,12694,8048,11390,2489,4576,3009,934,382,4115,3672,443,3672,3037,635,2018-01-01,zipcode,Iowa park
ZCTA5 76370,48,257,52750,-666666666,28200,241,101,216,45,104,48,15,4,171,119,52,119,107,12,2018-01-01,zipcode,Megargel
ZCTA5 76371,48,1376,39881,516,48300,1071,481,923,159,358,228,116,62,799,544,255,544,451,93,2018-01-01,zipcode,Munday
ZCTA5 76372,48,1179,37308,446,86900,911,467,721,104,310,201,73,33,598,446,152,446,321,125,2018-01-01,zipcode,Newcastle
ZCTA5 76373,48,187,38315,-666666666,-666666666,165,64,151,24,83,31,13,0,105,83,22,83,83,0,2018-01-01,zipcode,Oklaunion
ZCTA5 76374,48,3906,49702,620,56500,3229,1351,2857,553,849,825,472,158,2067,1648,419,1648,1207,441,2018-01-01,zipcode,Olney
ZCTA5 76377,48,793,35994,398,58000,629,284,563,95,230,217,21,0,432,317,115,317,292,25,2018-01-01,zipcode,Petrolia
ZCTA5 76379,48,610,61250,633,97500,489,156,335,43,141,97,34,20,196,176,20,176,135,41,2018-01-01,zipcode,Scotland
ZCTA5 76380,48,3639,41313,444,69500,2943,1367,2577,309,827,934,392,115,2717,1492,1225,1492,1069,423,2018-01-01,zipcode,Seymour
ZCTA5 76384,48,12289,48640,638,73800,9878,3530,8496,1853,2785,2478,1061,319,5929,5029,900,5029,3149,1880,2018-01-01,zipcode,Vernon
ZCTA5 76388,48,255,48173,675,29800,236,115,175,35,86,32,14,8,169,103,66,103,81,22,2018-01-01,zipcode,Weinert
ZCTA5 76389,48,1413,72933,632,123100,1158,355,933,120,409,224,163,17,584,497,87,497,415,82,2018-01-01,zipcode,Windthorst
ZCTA5 76401,48,30324,48109,848,148500,24679,9296,16374,1877,3559,5575,3516,1847,12999,10265,2734,10265,5949,4316,2018-01-01,zipcode,Stephenville
ZCTA5 76402,48,881,-666666666,-666666666,-666666666,881,585,5,0,0,0,5,0,0,0,0,0,0,0,2018-01-01,zipcode,Stephenville
ZCTA5 76424,48,8811,43726,603,68700,6957,3395,5939,1414,1775,1780,622,348,4367,3016,1351,3016,2440,576,2018-01-01,zipcode,Breckenridge
ZCTA5 76426,48,12251,49205,918,146500,9977,4484,8691,1705,2912,2666,959,449,4654,4205,449,4205,2784,1421,2018-01-01,zipcode,Bridgeport
ZCTA5 76427,48,760,44125,703,66000,599,335,445,75,215,100,43,12,394,294,100,294,189,105,2018-01-01,zipcode,Bryson
ZCTA5 76429,48,119,41860,-666666666,-666666666,119,33,119,0,46,62,7,4,243,79,164,79,38,41,2018-01-01,zipcode,Caddo
ZCTA5 76430,48,2318,45187,567,83000,1768,630,1462,243,330,521,234,134,1231,888,343,888,749,139,2018-01-01,zipcode,Albany
ZCTA5 76431,48,3415,46795,984,96400,2469,1284,2212,657,751,539,178,87,1511,1174,337,1174,943,231,2018-01-01,zipcode,Chico
ZCTA5 76432,48,1166,39946,912,114100,936,447,827,97,288,307,112,23,693,503,190,503,454,49,2018-01-01,zipcode,Blanket
ZCTA5 76433,48,1517,68906,1008,269200,1300,605,1082,40,311,359,205,167,779,567,212,567,508,59,2018-01-01,zipcode,Bluff dale
ZCTA5 76435,48,467,35263,-666666666,40000,406,229,399,42,186,115,44,12,383,194,189,194,180,14,2018-01-01,zipcode,Carbon
ZCTA5 76436,48,237,60833,-666666666,285400,178,97,162,24,44,23,44,27,147,88,59,88,75,13,2018-01-01,zipcode,Carlton
ZCTA5 76437,48,5706,38429,606,74500,4852,2507,3887,739,1047,1618,279,204,2979,2077,902,2077,1618,459,2018-01-01,zipcode,Cisco
ZCTA5 76442,48,7813,49714,546,108000,6148,2843,5372,1029,1835,1482,688,338,4022,2940,1082,2940,2361,579,2018-01-01,zipcode,Comanche
ZCTA5 76443,48,2056,35469,625,83900,1653,996,1503,186,572,490,228,27,1177,932,245,932,725,207,2018-01-01,zipcode,Cross plains
ZCTA5 76444,48,3585,41421,524,90100,2887,1365,2610,326,1023,731,404,126,1885,1513,372,1513,1155,358,2018-01-01,zipcode,De leon
ZCTA5 76445,48,165,-666666666,-666666666,70700,157,109,138,21,48,65,0,4,194,108,86,108,101,7,2018-01-01,zipcode,Desdemona
ZCTA5 76446,48,7686,49014,680,113800,5893,2346,5147,1162,1385,1538,719,343,3721,2696,1025,2696,2173,523,2018-01-01,zipcode,Dublin
ZCTA5 76448,48,5547,35000,595,82600,4430,2454,3943,492,1523,1246,380,302,3035,1894,1141,1894,1420,474,2018-01-01,zipcode,Eastland
ZCTA5 76449,48,2506,57738,600,124800,2152,889,1984,196,669,753,251,115,2924,978,1946,978,811,167,2018-01-01,zipcode,Graford
ZCTA5 76450,48,13020,49327,704,97700,10187,4216,8990,1401,3227,2585,1200,577,6597,5071,1526,5071,4115,956,2018-01-01,zipcode,Graham
ZCTA5 76452,48,108,71806,-666666666,-666666666,60,6,45,27,6,12,0,0,35,26,9,26,12,14,2018-01-01,zipcode,Energy
ZCTA5 76453,48,1275,63750,745,179800,1154,620,1073,64,368,316,214,111,789,569,220,569,516,53,2018-01-01,zipcode,Gordon
ZCTA5 76454,48,1553,39330,450,61300,1226,668,974,149,422,282,111,10,977,551,426,551,397,154,2018-01-01,zipcode,Gorman
ZCTA5 76455,48,973,52386,586,78300,785,328,663,91,281,161,124,6,560,349,211,349,299,50,2018-01-01,zipcode,Gustine
ZCTA5 76457,48,3764,39973,717,124800,3010,1239,2551,494,979,694,271,113,2111,1318,793,1318,972,346,2018-01-01,zipcode,Hico
ZCTA5 76458,48,6025,50169,759,83700,4976,2852,4164,910,1673,993,391,197,2579,2012,567,2012,1673,339,2018-01-01,zipcode,Jacksboro
ZCTA5 76459,48,241,107692,-666666666,56400,168,50,141,30,57,50,0,4,141,106,35,106,100,6,2018-01-01,zipcode,Jermyn
ZCTA5 76460,48,348,63750,-666666666,181900,281,136,231,11,18,142,32,28,217,134,83,134,110,24,2018-01-01,zipcode,Loving
ZCTA5 76462,48,3372,80644,969,201400,2764,1077,2420,278,809,733,452,148,1411,1140,271,1140,1030,110,2018-01-01,zipcode,Lipan
ZCTA5 76463,48,382,40972,967,67300,350,156,304,35,159,87,14,9,301,183,118,183,161,22,2018-01-01,zipcode,Mingus
ZCTA5 76464,48,532,40982,532,44400,463,240,436,57,142,137,59,41,398,233,165,233,174,59,2018-01-01,zipcode,Moran
ZCTA5 76466,48,244,-666666666,-666666666,-666666666,244,93,244,0,107,137,0,0,268,146,122,146,92,54,2018-01-01,zipcode,Olden
ZCTA5 76469,48,78,33875,-666666666,56300,72,60,72,8,27,26,9,2,46,37,9,37,37,0,2018-01-01,zipcode,Putnam
ZCTA5 76470,48,3479,32898,315,55100,2795,1470,2307,539,766,728,181,93,1834,1195,639,1195,851,344,2018-01-01,zipcode,Ranger
ZCTA5 76471,48,1940,44306,618,54100,1574,790,1355,123,448,501,194,89,1173,685,488,685,585,100,2018-01-01,zipcode,Rising star
ZCTA5 76472,48,1699,52452,951,112300,1381,515,1247,228,342,289,237,151,817,717,100,717,548,169,2018-01-01,zipcode,Santo
ZCTA5 76474,48,196,59688,-666666666,118900,186,116,180,13,62,52,31,22,133,97,36,97,88,9,2018-01-01,zipcode,Sidney
ZCTA5 76475,48,892,39583,695,88600,705,311,660,104,220,189,89,58,744,334,410,334,257,77,2018-01-01,zipcode,Strawn
ZCTA5 76476,48,2623,66902,892,177900,2148,870,1859,212,556,621,394,76,1142,989,153,989,866,123,2018-01-01,zipcode,Tolar
ZCTA5 76481,48,255,-666666666,-666666666,-666666666,110,56,110,0,74,36,0,0,110,54,56,54,36,18,2018-01-01,zipcode,South bend
ZCTA5 76483,48,1065,41806,453,66700,905,405,789,144,305,192,126,22,697,485,212,485,318,167,2018-01-01,zipcode,Throckmorton
ZCTA5 76484,48,921,44267,721,145000,787,586,660,96,213,206,99,46,610,375,235,375,298,77,2018-01-01,zipcode,Palo pinto
ZCTA5 76486,48,1105,52679,656,84800,953,436,871,126,332,326,59,28,674,468,206,468,400,68,2018-01-01,zipcode,Perrin
ZCTA5 76487,48,3201,55833,1102,157400,2352,962,1966,320,807,602,180,57,1321,1034,287,1034,886,148,2018-01-01,zipcode,Poolville
ZCTA5 76490,48,79,31736,-666666666,-666666666,79,19,62,0,19,32,6,5,72,45,27,45,40,5,2018-01-01,zipcode,Whitt
ZCTA5 76491,48,318,58036,725,49200,246,100,210,20,72,96,19,3,245,141,104,141,125,16,2018-01-01,zipcode,Woodson
ZCTA5 76501,48,16801,45623,709,117400,13095,5522,11134,2063,3376,3994,1154,547,7064,6236,828,6236,3836,2400,2018-01-01,zipcode,Temple
ZCTA5 76502,48,40622,68735,1086,159300,30310,10854,26371,1452,6226,9135,5844,3714,16189,14826,1363,14826,9975,4851,2018-01-01,zipcode,Temple
ZCTA5 76504,48,23666,40368,839,93100,18189,7024,15284,2236,5317,4892,1834,1005,10471,8929,1542,8929,3566,5363,2018-01-01,zipcode,Temple
ZCTA5 76508,48,8,-666666666,-666666666,-666666666,8,8,0,0,0,0,0,0,0,0,0,0,0,0,2018-01-01,zipcode,Temple
ZCTA5 76511,48,2753,41532,599,93100,2246,1310,1933,527,767,457,148,34,852,736,116,736,559,177,2018-01-01,zipcode,Bartlett
ZCTA5 76513,48,37916,62734,844,167400,29051,10641,22788,2634,6017,7223,3953,2961,14626,13268,1358,13268,8901,4367,2018-01-01,zipcode,Belton
ZCTA5 76518,48,1880,43896,800,85900,1392,689,1103,192,416,360,104,31,651,543,108,543,465,78,2018-01-01,zipcode,Buckholts
ZCTA5 76519,48,401,37063,-666666666,201200,218,73,143,26,59,28,13,17,249,115,134,115,106,9,2018-01-01,zipcode,Burlington
ZCTA5 76520,48,7921,44708,669,91400,6122,3180,5348,1130,1999,1476,569,174,3867,2944,923,2944,1963,981,2018-01-01,zipcode,Cameron
ZCTA5 76522,48,36204,53399,892,115100,27621,10256,23262,1440,5910,11475,3128,1309,15357,13561,1796,13561,7817,5744,2018-01-01,zipcode,Copperas cove
ZCTA5 76523,48,0,-666666666,-666666666,-666666666,0,0,0,0,0,0,0,0,0,0,0,0,0,0,2018-01-01,zipcode,Davilla
ZCTA5 76524,48,2944,62986,903,130800,2344,842,1976,299,718,673,185,101,1180,1038,142,1038,918,120,2018-01-01,zipcode,Eddy
ZCTA5 76525,48,1082,52708,700,100300,885,425,792,132,220,262,112,66,660,437,223,437,335,102,2018-01-01,zipcode,Evant
ZCTA5 76527,48,3681,57734,770,168600,2807,1144,2466,310,888,908,274,86,1422,1233,189,1233,848,385,2018-01-01,zipcode,Florence
ZCTA5 76528,48,16825,49523,738,107200,13205,6048,11892,1893,3677,4481,1283,558,7102,6123,979,6123,4432,1691,2018-01-01,zipcode,Gatesville
ZCTA5 76530,48,2037,47917,739,146100,1750,800,1529,219,733,366,167,44,845,740,105,740,543,197,2018-01-01,zipcode,Granger
ZCTA5 76531,48,4740,47279,769,130100,3936,2045,3590,631,1157,949,626,227,2657,1928,729,1928,1647,281,2018-01-01,zipcode,Hamilton
ZCTA5 76534,48,2857,50972,680,129800,2008,777,1805,242,660,597,185,121,1141,961,180,961,684,277,2018-01-01,zipcode,Holland
ZCTA5 76537,48,5631,68790,1176,166900,4375,1223,3604,374,1130,1320,552,228,1926,1805,121,1805,1360,445,2018-01-01,zipcode,Jarrell
ZCTA5 76538,48,860,78250,1229,122400,657,276,564,37,163,206,109,49,392,303,89,303,220,83,2018-01-01,zipcode,Jonesboro
ZCTA5 76539,48,8566,67833,842,164900,6974,3220,5998,429,1395,2928,838,408,3546,3132,414,3132,2743,389,2018-01-01,zipcode,Kempner
ZCTA5 76541,48,18198,30921,695,69300,14132,4885,11228,2071,3709,4495,748,205,10264,7762,2502,7762,2164,5598,2018-01-01,zipcode,Killeen
ZCTA5 76542,48,49857,62612,1040,147300,36736,11658,29839,2148,6443,13660,5239,2349,19155,17384,1771,17384,9806,7578,2018-01-01,zipcode,Killeen
ZCTA5 76543,48,30378,41950,834,89400,22428,6699,18385,1976,5206,8509,1845,849,13769,11899,1870,11899,4303,7596,2018-01-01,zipcode,Killeen
ZCTA5 76544,48,25561,43683,1232,84400,20007,3119,8757,352,2120,4697,1228,360,6473,3793,2680,3793,42,3751,2018-01-01,zipcode,Fort hood
ZCTA5 76548,48,30329,72982,877,190200,23054,8576,19182,1696,3878,6708,4649,2251,11835,10363,1472,10363,6319,4044,2018-01-01,zipcode,Harker heights
ZCTA5 76549,48,51767,54408,1072,133300,36518,11677,28627,1424,6444,14624,4347,1788,19577,17267,2310,17267,8670,8597,2018-01-01,zipcode,Killeen
ZCTA5 76550,48,12905,50776,772,131800,10188,4040,8906,999,2898,3265,1204,540,5769,4950,819,4950,3544,1406,2018-01-01,zipcode,Lampasas
ZCTA5 76554,48,2139,53250,922,119000,1607,573,1343,193,462,483,157,48,845,714,131,714,523,191,2018-01-01,zipcode,Little river academy
ZCTA5 76556,48,1372,47941,605,100600,1123,570,935,131,444,243,75,42,660,542,118,542,452,90,2018-01-01,zipcode,Milano
ZCTA5 76557,48,5184,60625,716,133900,4250,1704,3466,459,1408,1122,252,225,2206,1854,352,1854,1543,311,2018-01-01,zipcode,Moody
ZCTA5 76559,48,5849,56058,903,134300,4101,1138,3428,246,930,1571,473,208,2312,2062,250,2062,1125,937,2018-01-01,zipcode,Nolanville
ZCTA5 76561,48,1059,56250,763,82700,789,319,711,126,232,246,84,23,464,400,64,400,298,102,2018-01-01,zipcode,Oglesby
ZCTA5 76565,48,104,-666666666,-666666666,-666666666,104,65,65,13,25,17,0,10,41,41,0,41,41,0,2018-01-01,zipcode,Pottsville
ZCTA5 76566,48,292,-666666666,-666666666,184400,237,128,231,0,124,59,48,0,155,124,31,124,87,37,2018-01-01,zipcode,Purmela
ZCTA5 76567,48,9170,50092,723,99000,7314,3120,6299,972,2460,2120,473,274,4263,3723,540,3723,2256,1467,2018-01-01,zipcode,Rockdale
ZCTA5 76569,48,2297,62333,942,85600,1869,763,1584,129,576,655,165,59,875,792,83,792,604,188,2018-01-01,zipcode,Rogers
ZCTA5 76570,48,2723,40391,643,61300,2116,1127,2007,341,807,416,393,50,1330,848,482,848,668,180,2018-01-01,zipcode,Rosebud
ZCTA5 76571,48,7737,85096,715,279900,6016,2170,5205,152,1102,1698,1233,1020,3036,2693,343,2693,2251,442,2018-01-01,zipcode,Salado
ZCTA5 76573,48,23,-666666666,-666666666,-666666666,23,18,14,10,4,0,0,0,9,9,0,9,4,5,2018-01-01,zipcode,Schwertner
ZCTA5 76574,48,19026,51613,861,152600,15371,5807,13544,2662,5269,3525,1401,687,7091,6531,560,6531,4284,2247,2018-01-01,zipcode,Taylor
ZCTA5 76577,48,3052,57803,829,147100,2568,1012,2101,351,705,659,341,45,1351,1194,157,1194,898,296,2018-01-01,zipcode,Thorndale
ZCTA5 76578,48,1443,67976,1033,162900,1102,308,935,72,377,358,116,12,582,456,126,456,379,77,2018-01-01,zipcode,Thrall
ZCTA5 76579,48,4732,55975,1045,116600,3453,1336,2966,297,1062,1156,377,74,1662,1524,138,1524,1172,352,2018-01-01,zipcode,Troy
ZCTA5 76596,48,1317,-666666666,-666666666,-666666666,1317,1317,1226,335,305,529,46,11,0,0,0,0,0,0,2018-01-01,zipcode,Gatesville
ZCTA5 76597,48,2817,-666666666,-666666666,-666666666,2817,2817,2770,846,1002,825,75,22,0,0,0,0,0,0,2018-01-01,zipcode,Gatesville
ZCTA5 76598,48,506,-666666666,-666666666,-666666666,506,506,450,116,151,178,5,0,0,0,0,0,0,0,2018-01-01,zipcode,Gatesville
ZCTA5 76599,48,2084,-666666666,-666666666,-666666666,2084,2084,1905,478,515,846,63,3,0,0,0,0,0,0,2018-01-01,zipcode,Gatesville
ZCTA5 76621,48,870,69167,750,148100,644,198,579,37,136,204,135,67,466,334,132,334,292,42,2018-01-01,zipcode,Abbott
ZCTA5 76622,48,1066,63409,790,99200,892,377,827,126,303,235,111,52,545,400,145,400,307,93,2018-01-01,zipcode,Aquilla
ZCTA5 76623,48,190,58750,-666666666,71900,124,47,116,51,22,38,2,3,56,56,0,56,51,5,2018-01-01,zipcode,Avalon
ZCTA5 76624,48,1925,63448,764,110300,1565,696,1376,228,414,500,179,55,932,734,198,734,535,199,2018-01-01,zipcode,Axtell
ZCTA5 76626,48,1192,52212,845,94300,884,426,738,53,276,252,115,42,525,423,102,423,312,111,2018-01-01,zipcode,Blooming grove
ZCTA5 76627,48,1574,66083,850,85200,1198,412,1004,126,444,299,64,71,607,521,86,521,476,45,2018-01-01,zipcode,Blum
ZCTA5 76628,48,34,-666666666,-666666666,-666666666,31,11,27,10,0,17,0,0,36,19,17,19,17,2,2018-01-01,zipcode,Brandon
ZCTA5 76629,48,1627,38370,632,82300,1429,706,1173,179,477,352,125,40,1172,714,458,714,459,255,2018-01-01,zipcode,Bremond
ZCTA5 76630,48,1271,66023,942,132900,1043,580,865,93,278,351,121,22,548,390,158,390,344,46,2018-01-01,zipcode,Bruceville
ZCTA5 76631,48,592,68125,1018,75000,479,172,358,48,116,132,44,18,244,181,63,181,154,27,2018-01-01,zipcode,Bynum
ZCTA5 76632,48,1732,39375,1078,73400,1317,615,961,263,297,316,85,0,774,531,243,531,429,102,2018-01-01,zipcode,Chilton
ZCTA5 76633,48,5286,85110,956,197800,4183,1596,3653,200,1090,1240,841,282,1963,1867,96,1867,1637,230,2018-01-01,zipcode,China spring
ZCTA5 76634,48,7225,55911,806,128000,6068,2801,5534,634,1772,1929,901,298,3976,2847,1129,2847,2211,636,2018-01-01,zipcode,Clifton
ZCTA5 76635,48,1216,36118,613,60200,898,370,801,241,221,268,35,36,552,403,149,403,315,88,2018-01-01,zipcode,Coolidge
ZCTA5 76636,48,1404,54844,711,123200,1188,469,1046,139,375,381,113,38,657,556,101,556,460,96,2018-01-01,zipcode,Covington
ZCTA5 76637,48,558,50288,510,101400,462,255,391,102,123,104,32,30,337,239,98,239,189,50,2018-01-01,zipcode,Cranfills gap
ZCTA5 76638,48,3064,78150,888,220400,2333,946,2078,128,508,755,405,282,1227,1125,102,1125,957,168,2018-01-01,zipcode,Crawford
ZCTA5 76639,48,1471,46204,525,86000,1172,523,1003,204,297,278,162,62,815,584,231,584,387,197,2018-01-01,zipcode,Dawson
ZCTA5 76640,48,3157,38922,891,79400,2415,899,2199,428,835,603,237,96,1391,1220,171,1220,865,355,2018-01-01,zipcode,Elm mott
ZCTA5 76641,48,1688,43654,724,84100,1417,717,1243,300,441,333,97,72,771,646,125,646,507,139,2018-01-01,zipcode,Frost
ZCTA5 76642,48,6750,46948,690,96100,5340,2853,4425,644,1463,1541,573,204,3065,2408,657,2408,1780,628,2018-01-01,zipcode,Groesbeck
ZCTA5 76643,48,14347,73600,1126,159600,11445,3678,10066,817,2387,3584,2148,1130,5413,5164,249,5164,3813,1351,2018-01-01,zipcode,Hewitt
ZCTA5 76645,48,10459,43683,766,87500,7995,3162,6424,1465,2039,1932,650,338,4501,3606,895,3606,2188,1418,2018-01-01,zipcode,Hillsboro
ZCTA5 76648,48,2789,53160,731,97600,2245,1018,1923,245,652,707,232,87,1234,1003,231,1003,741,262,2018-01-01,zipcode,Hubbard
ZCTA5 76649,48,635,46458,733,93800,509,272,458,65,194,88,85,26,378,261,117,261,232,29,2018-01-01,zipcode,Iredell
ZCTA5 76650,48,148,53571,-666666666,65000,106,30,100,23,41,21,10,5,106,54,52,54,46,8,2018-01-01,zipcode,Irene
ZCTA5 76651,48,3221,53641,840,98200,2588,883,2271,297,839,876,194,65,1486,1237,249,1237,838,399,2018-01-01,zipcode,Italy
ZCTA5 76652,48,1352,46676,820,88100,1066,547,993,121,496,268,73,35,628,499,129,499,434,65,2018-01-01,zipcode,Kopperl
ZCTA5 76653,48,1253,54375,669,121500,1033,525,927,148,420,289,38,32,619,440,179,440,352,88,2018-01-01,zipcode,Kosse
ZCTA5 76654,48,159,40250,-666666666,80000,120,53,109,21,41,33,11,3,58,55,3,55,50,5,2018-01-01,zipcode,Leroy
ZCTA5 76655,48,8652,95795,1007,174600,6836,2200,5772,262,1531,2245,1233,501,3243,3024,219,3024,2550,474,2018-01-01,zipcode,Lorena
ZCTA5 76656,48,2499,54792,535,121400,1884,724,1572,263,512,540,231,26,973,722,251,722,575,147,2018-01-01,zipcode,Lott
ZCTA5 76657,48,9897,63457,1049,186400,7620,2657,6524,837,1616,2216,1057,798,3769,3443,326,3443,2425,1018,2018-01-01,zipcode,Mc gregor
ZCTA5 76660,48,587,50375,725,84000,441,134,356,66,147,106,25,12,247,175,72,175,136,39,2018-01-01,zipcode,Malone
ZCTA5 76661,48,8060,27102,448,54200,6722,4379,5723,1700,2341,1293,265,124,3442,2293,1149,2293,1420,873,2018-01-01,zipcode,Marlin
ZCTA5 76664,48,3762,46000,775,88100,2824,1226,2288,260,907,700,328,93,1522,1262,260,1262,953,309,2018-01-01,zipcode,Mart
ZCTA5 76665,48,2523,48750,651,106700,1989,915,1710,280,527,589,181,133,1263,981,282,981,666,315,2018-01-01,zipcode,Meridian
ZCTA5 76666,48,285,43750,745,110200,226,105,214,20,72,98,19,5,149,118,31,118,101,17,2018-01-01,zipcode,Mertens
ZCTA5 76667,48,11096,41968,713,87100,8821,3763,7541,1713,2468,2342,729,289,4551,3704,847,3704,2699,1005,2018-01-01,zipcode,Mexia
ZCTA5 76670,48,1598,48578,1000,101900,1249,441,1083,238,386,356,62,41,596,499,97,499,391,108,2018-01-01,zipcode,Milford
ZCTA5 76671,48,1722,47674,765,98100,1401,691,1216,250,515,296,95,60,1177,734,443,734,592,142,2018-01-01,zipcode,Morgan
ZCTA5 76673,48,1697,46042,683,100600,1087,462,912,230,306,286,69,21,618,478,140,478,354,124,2018-01-01,zipcode,Mount calm
ZCTA5 76676,48,297,59375,-666666666,91300,223,78,196,46,59,56,32,3,144,106,38,106,97,9,2018-01-01,zipcode,Penelope
ZCTA5 76678,48,258,38393,819,-666666666,159,53,149,32,32,58,10,17,102,74,28,74,33,41,2018-01-01,zipcode,Prairie hill
ZCTA5 76679,48,1376,61071,493,106800,1054,346,933,94,364,300,142,33,714,526,188,526,455,71,2018-01-01,zipcode,Purdon
ZCTA5 76680,48,265,-666666666,-666666666,63500,230,137,214,48,63,73,30,0,154,99,55,99,99,0,2018-01-01,zipcode,Reagan
ZCTA5 76681,48,675,51500,947,88300,495,224,424,77,167,127,43,10,382,258,124,258,196,62,2018-01-01,zipcode,Richland
ZCTA5 76682,48,2817,51916,865,93100,2228,953,1951,228,743,578,302,100,1227,1020,207,1020,762,258,2018-01-01,zipcode,Riesel
ZCTA5 76685,48,20,-666666666,-666666666,-666666666,20,6,20,0,6,0,14,0,52,20,32,20,6,14,2018-01-01,zipcode,Satin
ZCTA5 76686,48,205,42500,725,78300,158,72,150,15,51,48,29,7,113,88,25,88,65,23,2018-01-01,zipcode,Tehuacana
ZCTA5 76687,48,1898,40846,756,136900,1608,946,1522,127,715,507,111,62,1217,749,468,749,591,158,2018-01-01,zipcode,Thornton
ZCTA5 76689,48,3359,56028,843,117800,2584,1053,2249,332,715,660,353,189,1684,1277,407,1277,1053,224,2018-01-01,zipcode,Valley mills
ZCTA5 76690,48,1063,32880,803,84300,794,332,656,174,268,141,48,25,476,371,105,371,253,118,2018-01-01,zipcode,Walnut springs
ZCTA5 76691,48,6568,62893,829,115200,5261,1816,4514,457,1374,1813,617,253,2860,2366,494,2366,1819,547,2018-01-01,zipcode,West
ZCTA5 76692,48,10474,44167,656,101400,8797,4277,7806,1096,2889,2226,1118,477,5599,4116,1483,4116,3202,914,2018-01-01,zipcode,Whitney
ZCTA5 76693,48,1629,40278,746,98400,1265,519,1030,163,327,397,112,31,793,540,253,540,329,211,2018-01-01,zipcode,Wortham
ZCTA5 76701,48,2002,31689,992,233800,1737,809,1189,215,306,331,180,157,890,724,166,724,143,581,2018-01-01,zipcode,Waco
ZCTA5 76704,48,7538,20699,670,83900,5676,3148,4258,695,1787,1469,194,113,3778,3173,605,3173,1068,2105,2018-01-01,zipcode,Waco
ZCTA5 76705,48,31230,42679,746,95300,24425,10737,19018,4353,5680,6703,1565,717,12154,10477,1677,10477,6051,4426,2018-01-01,zipcode,Waco
ZCTA5 76706,48,38597,31606,855,111400,30854,13034,16210,3039,5115,4869,1950,1237,15114,13206,1908,13206,5207,7999,2018-01-01,zipcode,Waco
ZCTA5 76707,48,15418,27132,816,71700,11111,4596,8623,2831,2517,2157,713,405,5846,5015,831,5015,2367,2648,2018-01-01,zipcode,Waco
ZCTA5 76708,48,27467,49578,868,132500,20311,7052,16624,3162,4539,5404,2270,1249,10396,9550,846,9550,5712,3838,2018-01-01,zipcode,Waco
ZCTA5 76710,48,24685,46477,764,130500,19781,6886,16864,1800,4622,5529,3035,1878,11622,10653,969,10653,5212,5441,2018-01-01,zipcode,Waco
ZCTA5 76711,48,9772,40961,982,64300,7504,2411,6019,2024,1519,1752,464,260,3779,3265,514,3265,1729,1536,2018-01-01,zipcode,Waco
ZCTA5 76712,48,25503,69897,967,195600,19987,6808,17547,1166,2692,5944,4989,2756,10651,9922,729,9922,6939,2983,2018-01-01,zipcode,Woodway
ZCTA5 76798,48,1568,-666666666,-666666666,-666666666,1568,1294,6,0,0,6,0,0,0,0,0,0,0,0,2018-01-01,zipcode,Waco
ZCTA5 76801,48,25319,43773,774,96800,20100,9044,16764,2506,6275,4803,2305,875,12009,9155,2854,9155,6216,2939,2018-01-01,zipcode,Brownwood
ZCTA5 76802,48,5183,53984,761,119800,4102,1639,3489,374,1120,1287,533,175,2186,1900,286,1900,1429,471,2018-01-01,zipcode,Early
ZCTA5 76820,48,136,95114,-666666666,339100,136,67,136,0,48,42,35,11,166,75,91,75,64,11,2018-01-01,zipcode,Art
ZCTA5 76821,48,4578,42336,598,79300,3761,1843,3393,635,1216,961,516,65,2419,1737,682,1737,1257,480,2018-01-01,zipcode,Ballinger
ZCTA5 76823,48,2840,48361,471,79100,2348,1030,2104,266,783,735,213,107,1456,1105,351,1105,937,168,2018-01-01,zipcode,Bangs
ZCTA5 76824,48,11,-666666666,-666666666,-666666666,11,11,11,0,0,11,0,0,11,11,0,11,0,11,2018-01-01,zipcode,Bend
ZCTA5 76825,48,6798,45402,720,83100,5415,2122,4690,1025,1445,1420,560,240,3281,2658,623,2658,1915,743,2018-01-01,zipcode,Brady
ZCTA5 76827,48,391,41528,-666666666,113600,307,173,306,65,102,83,37,19,244,159,85,159,138,21,2018-01-01,zipcode,Brookesmith
ZCTA5 76828,48,214,75156,-666666666,109600,168,75,168,8,57,80,17,6,220,81,139,81,74,7,2018-01-01,zipcode,Burkett
ZCTA5 76831,48,36,-666666666,-666666666,-666666666,36,19,36,0,17,19,0,0,104,19,85,19,19,0,2018-01-01,zipcode,Castell
ZCTA5 76832,48,687,50156,1091,153600,527,239,507,110,181,146,62,8,340,219,121,219,142,77,2018-01-01,zipcode,Cherokee
ZCTA5 76834,48,5328,43624,690,64800,4228,1956,3817,801,1280,1178,354,204,3304,2243,1061,2243,1551,692,2018-01-01,zipcode,Coleman
ZCTA5 76836,48,16,-666666666,-666666666,-666666666,16,8,16,16,0,0,0,0,29,12,17,12,12,0,2018-01-01,zipcode,Doole
ZCTA5 76837,48,3279,37125,715,82000,2913,2140,2202,1018,564,371,150,99,907,595,312,595,379,216,2018-01-01,zipcode,Eden
ZCTA5 76841,48,25,-666666666,-666666666,-666666666,25,0,25,7,8,10,0,0,66,17,49,17,17,0,2018-01-01,zipcode,Fort mc kavett
ZCTA5 76842,48,266,59063,-666666666,323400,212,135,162,17,37,108,0,0,190,70,120,70,59,11,2018-01-01,zipcode,Fredonia
ZCTA5 76844,48,3706,44250,400,104600,2973,1388,2529,528,733,853,298,117,2054,1293,761,1293,1022,271,2018-01-01,zipcode,Goldthwaite
ZCTA5 76845,48,254,64643,-666666666,225000,211,109,192,27,53,57,36,19,210,102,108,102,82,20,2018-01-01,zipcode,Gouldbusk
ZCTA5 76848,48,64,31042,-666666666,-666666666,64,51,64,0,36,28,0,0,80,37,43,37,37,0,2018-01-01,zipcode,Hext
ZCTA5 76849,48,3880,42390,691,137500,3143,1170,2778,446,941,856,319,216,2605,1650,955,1650,1208,442,2018-01-01,zipcode,Junction
ZCTA5 76852,48,206,54028,667,123200,193,79,178,16,56,66,27,13,213,103,110,103,83,20,2018-01-01,zipcode,Lohn
ZCTA5 76853,48,1544,54875,756,89600,1109,533,1007,71,280,373,206,77,884,530,354,530,411,119,2018-01-01,zipcode,Lometa
ZCTA5 76854,48,263,26438,-666666666,-666666666,263,168,219,63,45,89,12,10,377,157,220,157,122,35,2018-01-01,zipcode,London
ZCTA5 76856,48,3650,39111,817,152600,3058,1036,2577,326,854,883,382,132,2187,1478,709,1478,1032,446,2018-01-01,zipcode,Mason
ZCTA5 76857,48,1596,36919,509,72800,1412,845,1279,126,367,450,238,98,1605,746,859,746,591,155,2018-01-01,zipcode,May
ZCTA5 76858,48,256,28813,-666666666,50000,196,101,186,57,32,49,29,19,198,101,97,101,84,17,2018-01-01,zipcode,Melvin
ZCTA5 76859,48,1978,41131,613,55600,1685,595,1571,308,514,450,169,130,1624,911,713,911,562,349,2018-01-01,zipcode,Menard
ZCTA5 76861,48,1927,58333,678,107700,1466,547,1178,184,438,307,183,66,820,608,212,608,443,165,2018-01-01,zipcode,Miles
ZCTA5 76862,48,189,58250,-666666666,233300,174,76,158,12,81,42,17,6,273,73,200,73,50,23,2018-01-01,zipcode,Millersview
ZCTA5 76864,48,822,37188,664,158900,651,412,598,84,201,179,98,36,515,295,220,295,258,37,2018-01-01,zipcode,Mullin
ZCTA5 76865,48,144,-666666666,-666666666,128800,144,99,132,35,64,26,0,7,122,62,60,62,55,7,2018-01-01,zipcode,Norton
ZCTA5 76866,48,727,50368,529,150700,630,271,592,103,181,225,75,8,416,179,237,179,161,18,2018-01-01,zipcode,Paint rock
ZCTA5 76869,48,100,60000,-666666666,-666666666,92,43,92,12,47,13,5,15,132,36,96,36,24,12,2018-01-01,zipcode,Pontotoc
ZCTA5 76870,48,230,42500,675,91100,157,79,143,21,58,32,29,3,150,82,68,82,66,16,2018-01-01,zipcode,Priddy
ZCTA5 76871,48,700,47232,519,76000,611,261,595,79,195,207,76,38,608,312,296,312,240,72,2018-01-01,zipcode,Richland springs
ZCTA5 76872,48,896,58750,685,118100,750,331,669,47,203,230,133,56,616,387,229,387,327,60,2018-01-01,zipcode,Rochelle
ZCTA5 76873,48,36,29167,-666666666,-666666666,36,27,36,4,22,3,0,7,74,22,52,22,18,4,2018-01-01,zipcode,Rockwood
ZCTA5 76874,48,0,-666666666,-666666666,-666666666,0,0,0,0,0,0,0,0,154,0,154,0,0,0,2018-01-01,zipcode,Roosevelt
ZCTA5 76875,48,522,42019,885,106500,437,135,407,29,199,126,35,18,304,242,62,242,181,61,2018-01-01,zipcode,Rowena
ZCTA5 76877,48,4332,43399,696,99700,3545,1754,2944,878,969,692,303,102,2059,1469,590,1469,945,524,2018-01-01,zipcode,San saba
ZCTA5 76878,48,1857,44313,629,102800,1549,780,1353,214,491,460,156,32,975,681,294,681,450,231,2018-01-01,zipcode,Santa anna
ZCTA5 76882,48,233,33889,-666666666,117300,209,163,206,9,70,54,59,14,176,106,70,106,94,12,2018-01-01,zipcode,Talpa
ZCTA5 76884,48,148,48333,-666666666,32500,122,69,95,0,40,32,10,13,71,48,23,48,36,12,2018-01-01,zipcode,Valera
ZCTA5 76885,48,322,91806,-666666666,330000,216,62,159,0,50,83,9,17,185,101,84,101,91,10,2018-01-01,zipcode,Valley spring
ZCTA5 76887,48,110,52679,-666666666,225000,110,43,110,0,67,21,22,0,122,70,52,70,70,0,2018-01-01,zipcode,Voca
ZCTA5 76888,48,129,44167,-666666666,151000,109,75,105,19,30,50,0,6,194,66,128,66,53,13,2018-01-01,zipcode,Voss
ZCTA5 76890,48,1100,60956,-666666666,134200,892,428,784,121,252,278,88,45,478,348,130,348,285,63,2018-01-01,zipcode,Zephyr
ZCTA5 76901,48,30552,55480,926,112700,24001,8164,20619,2659,7386,6246,2732,1596,12675,11403,1272,11403,7688,3715,2018-01-01,zipcode,San angelo
ZCTA5 76903,48,31749,35854,745,81700,25122,10374,21386,5711,7398,5650,1950,677,13888,11842,2046,11842,7112,4730,2018-01-01,zipcode,San angelo
ZCTA5 76904,48,35697,63362,871,194000,28356,9816,22218,1013,4880,7602,5980,2743,15246,14077,1169,14077,8066,6011,2018-01-01,zipcode,San angelo
ZCTA5 76905,48,12769,58505,1005,131000,8996,2954,7659,1134,2278,2589,1192,466,4779,4404,375,4404,2845,1559,2018-01-01,zipcode,San angelo
ZCTA5 76908,48,2534,-666666666,-666666666,-666666666,2534,315,249,0,65,106,78,0,8,0,8,0,0,0,2018-01-01,zipcode,Goodfellow afb
ZCTA5 76930,48,96,75714,-666666666,81800,91,33,91,16,56,14,5,0,61,42,19,42,31,11,2018-01-01,zipcode,Barnhart
ZCTA5 76932,48,3769,70441,844,94700,2727,951,2265,462,878,701,174,50,1321,1148,173,1148,793,355,2018-01-01,zipcode,Big lake
ZCTA5 76933,48,1273,45988,688,82600,1008,406,888,192,319,261,73,43,734,565,169,565,406,159,2018-01-01,zipcode,Bronte
ZCTA5 76934,48,1160,57917,758,86000,946,513,758,120,263,230,81,64,440,368,72,368,308,60,2018-01-01,zipcode,Carlsbad
ZCTA5 76935,48,1912,72240,-666666666,171500,1503,790,1407,78,373,598,274,84,709,633,76,633,607,26,2018-01-01,zipcode,Christoval
ZCTA5 76936,48,3061,55677,474,69800,2270,723,2001,430,481,760,257,73,1474,1105,369,1105,871,234,2018-01-01,zipcode,Eldorado
ZCTA5 76937,48,30,-666666666,-666666666,-666666666,30,7,23,0,0,9,14,0,14,14,0,14,14,0,2018-01-01,zipcode,Eola
ZCTA5 76939,48,10,-666666666,-666666666,-666666666,10,0,10,0,0,5,0,5,13,5,8,5,5,0,2018-01-01,zipcode,Knickerbocker
ZCTA5 76940,48,115,-666666666,-666666666,-666666666,113,31,108,0,4,76,28,0,78,53,25,53,53,0,2018-01-01,zipcode,Mereta
ZCTA5 76941,48,1360,47000,1016,141700,1039,449,879,52,302,366,115,44,741,548,193,548,448,100,2018-01-01,zipcode,Mertzon
ZCTA5 76943,48,3527,50904,550,82200,2733,1058,2359,508,813,707,246,85,1843,1358,485,1358,968,390,2018-01-01,zipcode,Ozona
ZCTA5 76945,48,1712,45508,566,72100,1409,669,1297,185,455,381,164,112,1400,835,565,835,641,194,2018-01-01,zipcode,Robert lee
ZCTA5 76949,48,7,-666666666,-666666666,-666666666,6,5,5,2,3,0,0,0,10,0,10,0,0,0,2018-01-01,zipcode,Silver
ZCTA5 76950,48,3883,60272,641,95700,3033,969,2677,665,804,738,372,98,2110,1494,616,1494,999,495,2018-01-01,zipcode,Sonora
ZCTA5 76951,48,1141,59286,918,64700,892,296,782,110,359,189,71,53,604,462,142,462,398,64,2018-01-01,zipcode,Sterling city
ZCTA5 76953,48,100,-666666666,-666666666,-666666666,100,38,85,1,37,42,5,0,95,68,27,68,29,39,2018-01-01,zipcode,Tennyson
ZCTA5 76955,48,180,191125,-666666666,-666666666,138,45,129,0,8,57,54,10,63,63,0,63,51,12,2018-01-01,zipcode,Vancourt
ZCTA5 76957,48,0,-666666666,-666666666,-666666666,0,0,0,0,0,0,0,0,0,0,0,0,0,0,2018-01-01,zipcode,Wall
ZCTA5 76958,48,146,51131,-666666666,189600,137,87,121,0,59,33,13,16,103,67,36,67,52,15,2018-01-01,zipcode,Water valley
ZCTA5 77002,48,13571,67043,1432,240600,13465,9261,10803,2206,3112,2267,1982,1236,4677,3739,938,3739,731,3008,2018-01-01,zipcode,Houston
ZCTA5 77003,48,9876,64006,1135,295700,8222,1954,7117,1500,1076,1504,1675,1362,5292,4544,748,4544,1969,2575,2018-01-01,zipcode,Houston
ZCTA5 77004,48,36959,50485,969,271100,32863,13491,20986,2159,3729,4946,5151,5001,16644,13036,3608,13036,4368,8668,2018-01-01,zipcode,Houston
ZCTA5 77005,48,28552,189500,1753,1002100,22306,8647,17796,279,576,1907,6328,8706,10929,10118,811,10118,7421,2697,2018-01-01,zipcode,Houston
ZCTA5 77006,48,22632,85000,1385,457800,20751,3665,18177,588,889,3674,6440,6586,14712,12862,1850,12862,4572,8290,2018-01-01,zipcode,Houston
ZCTA5 77007,48,37492,124355,1675,409000,33773,4743,30638,999,1769,4606,13277,9987,21794,19602,2192,19602,10312,9290,2018-01-01,zipcode,Houston
ZCTA5 77008,48,34184,104167,1264,419500,29488,5574,27560,1939,3099,5043,10240,7239,17801,16262,1539,16262,9594,6668,2018-01-01,zipcode,Houston
ZCTA5 77009,48,36260,53116,893,269400,29012,9142,25392,6788,5044,5421,4696,3443,16099,13848,2251,13848,7728,6120,2018-01-01,zipcode,Houston
ZCTA5 77010,48,862,240417,3161,-666666666,851,244,826,0,1,82,429,314,871,576,295,576,82,494,2018-01-01,zipcode,Houston
ZCTA5 77011,48,17803,30682,651,85900,13479,5293,11241,5761,2574,1965,758,183,6907,5831,1076,5831,2610,3221,2018-01-01,zipcode,Houston
ZCTA5 77012,48,19468,36532,736,76700,14375,5018,12359,6480,3185,1880,733,81,7042,5997,1045,5997,2387,3610,2018-01-01,zipcode,Houston
ZCTA5 77013,48,20706,39766,910,87800,15484,6568,12469,5220,3495,2824,703,227,6548,5937,611,5937,2280,3657,2018-01-01,zipcode,Houston
ZCTA5 77014,48,36455,48790,969,139200,26754,8054,21359,4106,5731,7482,2845,1195,12797,11583,1214,11583,4940,6643,2018-01-01,zipcode,Houston
ZCTA5 77015,48,56155,46300,890,102000,40388,14082,32152,10708,9182,8413,2550,1299,19131,17306,1825,17306,9056,8250,2018-01-01,zipcode,Houston
ZCTA5 77016,48,30184,34885,846,65700,23344,10416,19275,6020,6738,4798,1109,610,11019,9741,1278,9741,6017,3724,2018-01-01,zipcode,Houston
ZCTA5 77017,48,32720,48345,848,96000,25272,9015,20455,7949,6384,4441,1182,499,11145,9953,1192,9953,5254,4699,2018-01-01,zipcode,Houston
ZCTA5 77018,48,28235,87827,867,379000,21897,7410,20012,2647,3603,3706,6055,4001,12295,11067,1228,11067,7683,3384,2018-01-01,zipcode,Houston
ZCTA5 77019,48,21319,117367,1659,560000,18992,5039,16670,624,1136,2357,6749,5804,12044,10935,1109,10935,5643,5292,2018-01-01,zipcode,Houston
ZCTA5 77020,48,25749,30187,698,77900,19313,7839,15908,6267,4724,3428,1030,459,9687,8454,1233,8454,3827,4627,2018-01-01,zipcode,Houston
ZCTA5 77021,48,26655,37318,896,94400,21602,8452,17554,2705,5013,4791,3156,1889,12549,10904,1645,10904,4227,6677,2018-01-01,zipcode,Houston
ZCTA5 77022,48,28277,30900,740,93800,21339,8652,17908,8007,5192,3345,1072,292,10664,9398,1266,9398,4282,5116,2018-01-01,zipcode,Houston
ZCTA5 77023,48,29074,40261,786,121200,22351,7962,18525,6628,5155,3938,1999,805,10960,9744,1216,9744,4465,5279,2018-01-01,zipcode,Houston
ZCTA5 77024,48,38379,116920,1557,938100,30001,12392,26542,692,1774,4077,10928,9071,17067,15173,1894,15173,9987,5186,2018-01-01,zipcode,Houston
ZCTA5 77025,48,28955,74792,1231,440200,23784,7302,20971,1506,2172,2977,6217,8099,14383,12819,1564,12819,5310,7509,2018-01-01,zipcode,Houston
ZCTA5 77026,48,22380,29393,676,63000,17898,8233,15552,5477,5618,3234,941,282,9707,7995,1712,7995,3288,4707,2018-01-01,zipcode,Houston
ZCTA5 77027,48,16962,95835,1532,713200,15097,3751,13405,308,491,2193,5733,4680,11269,9245,2024,9245,3108,6137,2018-01-01,zipcode,Houston
ZCTA5 77028,48,16721,30108,836,58700,12762,5429,10871,2959,4137,2882,648,245,6643,5654,989,5654,3168,2486,2018-01-01,zipcode,Houston
ZCTA5 77029,48,18090,34967,789,73900,13557,5615,11426,4760,3046,2843,500,277,6482,5697,785,5697,3398,2299,2018-01-01,zipcode,Houston
ZCTA5 77030,48,10963,86034,1510,521100,8879,2981,7550,116,231,753,2473,3977,5600,4876,724,4876,2028,2848,2018-01-01,zipcode,Houston
ZCTA5 77031,48,17536,50155,886,143300,13588,3553,10706,2695,2628,2797,1865,721,6553,6000,553,6000,2700,3300,2018-01-01,zipcode,Houston
ZCTA5 77032,48,14093,30855,902,82100,9265,3742,6930,2515,1865,1813,487,250,4556,4210,346,4210,1535,2675,2018-01-01,zipcode,Houston
ZCTA5 77033,48,29903,36438,897,64100,22385,10248,18411,5100,6582,5208,1206,315,10388,8996,1392,8996,5609,3387,2018-01-01,zipcode,Houston
ZCTA5 77034,48,40532,48764,934,116600,29063,8752,22229,6317,6581,6333,2119,879,13791,12371,1420,12371,5410,6961,2018-01-01,zipcode,Houston
ZCTA5 77035,48,38524,43503,864,210100,28977,8482,25048,6085,5685,6118,4311,2849,15884,14126,1758,14126,5962,8164,2018-01-01,zipcode,Houston
ZCTA5 77036,48,76831,30632,785,142800,56959,16878,46959,17049,13375,9168,5114,2253,31123,26917,4206,26917,4951,21966,2018-01-01,zipcode,Houston
ZCTA5 77037,48,20463,42906,925,103500,15034,5053,12279,6983,3610,1289,342,55,5766,5428,338,5428,3855,1573,2018-01-01,zipcode,Houston
ZCTA5 77038,48,31365,41523,941,111700,21791,7427,17779,7761,4592,4061,906,459,9143,8731,412,8731,4787,3944,2018-01-01,zipcode,Houston
ZCTA5 77039,48,28385,36347,882,95000,20247,8327,15615,8205,4283,2472,524,131,8363,7570,793,7570,4674,2896,2018-01-01,zipcode,Houston
ZCTA5 77040,48,48290,56974,986,162200,38122,11373,32324,6848,8116,8467,6328,2565,18831,17924,907,17924,10000,7924,2018-01-01,zipcode,Houston
ZCTA5 77041,48,34885,82986,1381,176000,27598,8870,23138,3856,5518,5582,5371,2811,12281,11484,797,11484,8618,2866,2018-01-01,zipcode,Houston
ZCTA5 77042,48,42515,48269,1041,244000,33617,8937,28311,3192,4708,7846,8360,4205,21896,19198,2698,19198,4805,14393,2018-01-01,zipcode,Houston
ZCTA5 77043,48,25447,64298,1068,228700,20238,5934,17530,3480,3536,4153,4431,1930,10405,9200,1205,9200,5381,3819,2018-01-01,zipcode,Houston
ZCTA5 77044,48,45885,78483,1231,180100,31887,9037,27370,4207,7204,7905,5397,2657,14544,13456,1088,13456,10217,3239,2018-01-01,zipcode,Houston
ZCTA5 77045,48,37279,56826,932,80400,27659,10059,21960,6169,7251,5528,2083,929,10964,10475,489,10475,6930,3545,2018-01-01,zipcode,Houston
ZCTA5 77046,48,970,81803,1815,343000,961,244,913,0,37,267,284,325,716,678,38,678,201,477,2018-01-01,zipcode,Houston
ZCTA5 77047,48,29693,64648,1218,134300,22459,6576,18889,2430,4620,6482,3133,2224,10541,9816,725,9816,7138,2678,2018-01-01,zipcode,Houston
ZCTA5 77048,48,17721,42691,749,75700,13203,4983,11177,1848,3733,3628,1165,803,6841,5753,1088,5753,3656,2097,2018-01-01,zipcode,Houston
ZCTA5 77049,48,35230,58774,1063,141800,25226,7319,19871,5295,5165,6245,2096,1070,11651,10639,1012,10639,7076,3563,2018-01-01,zipcode,Houston
ZCTA5 77050,48,4999,56275,744,81100,3772,1388,3119,1161,882,733,274,69,1528,1428,100,1428,1105,323,2018-01-01,zipcode,Houston
ZCTA5 77051,48,17052,27496,805,76500,13199,5870,10688,2239,3718,3564,919,248,7521,6427,1094,6427,2604,3823,2018-01-01,zipcode,Houston
ZCTA5 77053,48,30938,50465,1164,87200,22772,7885,18350,5561,6126,4661,1397,605,8852,8613,239,8613,5572,3041,2018-01-01,zipcode,Houston
ZCTA5 77054,48,22704,50665,1152,137000,20493,6208,16498,239,1474,4950,4425,5410,15335,12614,2721,12614,1950,10664,2018-01-01,zipcode,Houston
ZCTA5 77055,48,44680,53263,946,428200,33578,10400,29051,7325,6565,4927,6041,4193,16703,15178,1525,15178,6626,8552,2018-01-01,zipcode,Houston
ZCTA5 77056,48,21807,109515,1573,630500,19055,5582,17288,391,1231,2885,7973,4808,13781,11003,2778,11003,4695,6308,2018-01-01,zipcode,Houston
ZCTA5 77057,48,41503,59104,1106,339100,33502,8690,29098,3767,3089,5508,9598,7136,22738,19836,2902,19836,6544,13292,2018-01-01,zipcode,Houston
ZCTA5 77058,48,16911,57027,1054,178500,14368,4094,11775,695,1549,4441,3088,2002,9421,8210,1211,8210,2354,5856,2018-01-01,zipcode,Houston
ZCTA5 77059,48,16944,134688,1648,300400,13429,4729,11981,598,917,2223,4521,3722,6103,5832,271,5832,5301,531,2018-01-01,zipcode,Houston
ZCTA5 77060,48,44828,30342,794,99100,30125,9860,24103,10482,6964,5136,1185,336,16369,13837,2532,13837,3276,10561,2018-01-01,zipcode,Houston
ZCTA5 77061,48,25607,38500,774,120500,18795,6007,15406,5093,5093,3149,1361,710,9766,8664,1102,8664,3048,5616,2018-01-01,zipcode,Houston
ZCTA5 77062,48,26358,92166,1158,191600,20576,7086,17955,1165,2746,5545,5266,3233,9926,9601,325,9601,7536,2065,2018-01-01,zipcode,Houston
ZCTA5 77063,48,38961,45262,1039,221400,31420,9259,26985,3098,4259,7312,8465,3851,20698,18455,2243,18455,4564,13891,2018-01-01,zipcode,Houston
ZCTA5 77064,48,49790,70324,1243,155300,38939,11819,33031,5284,7950,9837,7160,2800,17267,16364,903,16364,9418,6946,2018-01-01,zipcode,Houston
ZCTA5 77065,48,38265,56362,1126,160700,29774,9076,25241,3114,6707,7971,5003,2446,16100,15104,996,15104,7033,8071,2018-01-01,zipcode,Houston
ZCTA5 77066,48,36703,60106,1169,135500,28318,8924,23361,4825,7056,6085,3965,1430,11137,10650,487,10650,7283,3367,2018-01-01,zipcode,Houston
ZCTA5 77067,48,34575,41859,879,110100,24673,7791,19643,5897,5928,5601,1637,580,11282,10187,1095,10187,4118,6069,2018-01-01,zipcode,Houston
ZCTA5 77068,48,10991,81728,1072,201200,9239,3069,7780,1021,1600,2348,1896,915,4347,3940,407,3940,2706,1234,2018-01-01,zipcode,Houston
ZCTA5 77069,48,18622,67431,1215,242900,14820,4970,13208,383,1629,4611,4614,1971,8703,8020,683,8020,4441,3579,2018-01-01,zipcode,Houston
ZCTA5 77070,48,53239,66983,1247,183700,41171,12053,34679,2259,7183,12223,8877,4137,21698,20053,1645,20053,10010,10043,2018-01-01,zipcode,Houston
ZCTA5 77071,48,28558,46801,917,134800,21542,6876,18321,2806,4668,5023,3444,2380,11189,10040,1149,10040,5322,4718,2018-01-01,zipcode,Houston
ZCTA5 77072,48,61818,41557,973,102400,46713,15244,37815,13384,10319,8885,3675,1552,19847,18096,1751,18096,8495,9601,2018-01-01,zipcode,Houston
ZCTA5 77073,48,41745,52095,1026,131000,30059,8808,24045,4360,6765,9075,2838,1007,14228,13140,1088,13140,7415,5725,2018-01-01,zipcode,Houston
ZCTA5 77074,48,41386,40214,863,123600,30443,9927,25485,8023,7492,4986,3671,1313,14961,13181,1780,13181,4405,8776,2018-01-01,zipcode,Houston
ZCTA5 77075,48,43933,53633,934,135800,32138,10015,26287,7585,8412,6956,2659,675,13703,13042,661,13042,7146,5896,2018-01-01,zipcode,Houston
ZCTA5 77076,48,34985,37072,913,98500,24649,9056,19476,9592,6459,2570,682,173,10661,9816,845,9816,4699,5117,2018-01-01,zipcode,Houston
ZCTA5 77077,48,58131,65922,1205,284400,46989,13497,41100,1790,5366,11006,13381,9557,29995,26605,3390,26605,9428,17177,2018-01-01,zipcode,Houston
ZCTA5 77078,48,15411,37356,909,76200,11258,4692,9223,2513,3808,2011,591,300,5208,4672,536,4672,2760,1912,2018-01-01,zipcode,Houston
ZCTA5 77079,48,33768,100107,1321,485800,24562,8692,21644,1471,2266,4168,8174,5565,14399,12159,2240,12159,7630,4529,2018-01-01,zipcode,Houston
ZCTA5 77080,48,45832,44814,938,191400,34215,10408,28839,9257,7757,6148,3862,1815,16584,15243,1341,15243,6541,8702,2018-01-01,zipcode,Houston
ZCTA5 77081,48,52078,31196,803,270800,36839,9262,30798,11372,8447,4874,4215,1890,20615,18656,1959,18656,980,17676,2018-01-01,zipcode,Houston
ZCTA5 77082,48,55527,53313,1136,155000,44063,12750,38375,5022,8715,11221,8599,4818,24885,22334,2551,22334,7774,14560,2018-01-01,zipcode,Houston
ZCTA5 77083,48,79996,54650,1017,138800,61705,20915,49986,9816,13274,14441,8562,3893,23314,22434,880,22434,14821,7613,2018-01-01,zipcode,Houston
ZCTA5 77084,48,107700,65742,1228,151800,80953,23078,66819,10313,15887,21574,13741,5304,37236,34864,2372,34864,21540,13324,2018-01-01,zipcode,Houston
ZCTA5 77085,48,18274,56288,1104,113800,14100,4651,11053,3793,3004,2584,1031,641,5372,5228,144,5228,3626,1602,2018-01-01,zipcode,Houston
ZCTA5 77086,48,29178,47303,959,107600,21024,7337,16759,5926,5539,3730,1225,339,8478,8025,453,8025,4735,3290,2018-01-01,zipcode,Houston
ZCTA5 77087,48,36869,37222,772,89800,27281,10486,22067,9360,6564,4187,1437,519,12094,11089,1005,11089,5535,5554,2018-01-01,zipcode,Houston
ZCTA5 77088,48,57003,44422,883,108200,41915,15772,34646,9255,11325,9321,3449,1296,18902,17396,1506,17396,10777,6619,2018-01-01,zipcode,Houston
ZCTA5 77089,48,53866,68204,1103,147500,42398,13247,33938,5966,9362,10821,5217,2572,18315,16997,1318,16997,11121,5876,2018-01-01,zipcode,Houston
ZCTA5 77090,48,39381,39879,964,143300,28745,8078,22899,3642,5951,8626,3173,1507,18141,15892,2249,15892,3463,12429,2018-01-01,zipcode,Houston
ZCTA5 77091,48,27078,35940,790,116400,20317,7992,17493,4970,5555,4404,1816,748,11257,9785,1472,9785,3945,5840,2018-01-01,zipcode,Houston
ZCTA5 77092,48,39035,40521,875,166100,29802,8761,24528,6484,8213,5522,3069,1240,15210,14105,1105,14105,4804,9301,2018-01-01,zipcode,Houston
ZCTA5 77093,48,46875,31261,826,79100,33250,14734,26621,14220,7713,3998,519,171,14140,12591,1549,12591,7285,5306,2018-01-01,zipcode,Houston
ZCTA5 77094,48,9710,175840,1936,402400,7336,2679,6581,143,486,1149,2719,2084,3625,3277,348,3277,2725,552,2018-01-01,zipcode,Houston
ZCTA5 77095,48,71878,94290,1245,205000,55976,16171,47356,3478,8791,15229,13427,6431,25832,24175,1657,24175,18325,5850,2018-01-01,zipcode,Houston
ZCTA5 77096,48,33769,64022,972,345300,26609,8306,23111,1897,3680,5604,6110,5820,15601,13595,2006,13595,6639,6956,2018-01-01,zipcode,Houston
ZCTA5 77098,48,13549,87200,1588,499500,12249,2519,10932,183,277,1550,4667,4255,9315,8130,1185,8130,2243,5887,2018-01-01,zipcode,Houston
ZCTA5 77099,48,53357,39783,922,112500,39489,12652,32190,8990,9169,9008,3754,1269,18276,17046,1230,17046,6045,11001,2018-01-01,zipcode,Houston
ZCTA5 77201,48,0,-666666666,-666666666,-666666666,0,0,0,0,0,0,0,0,0,0,0,0,0,0,2018-01-01,zipcode,Houston
ZCTA5 77301,48,33660,43178,873,122700,25658,8933,20784,7592,5644,4869,1829,850,11730,10510,1220,10510,5325,5185,2018-01-01,zipcode,Conroe
ZCTA5 77302,48,18972,68864,1067,163100,13889,5224,11878,1980,3849,3572,1744,733,6923,6338,585,6338,5237,1101,2018-01-01,zipcode,Conroe
ZCTA5 77303,48,20163,52171,1072,124900,15207,5349,12668,3543,4254,3492,1066,313,7136,6707,429,6707,4969,1738,2018-01-01,zipcode,Conroe
ZCTA5 77304,48,30785,63489,1065,219300,24131,7842,20259,1748,4840,6007,4626,3038,13456,12431,1025,12431,7052,5379,2018-01-01,zipcode,Conroe
ZCTA5 77306,48,13245,46071,946,98700,9637,3933,7496,2711,2450,1956,307,72,4592,3974,618,3974,3023,951,2018-01-01,zipcode,Conroe
ZCTA5 77316,48,24199,96455,1105,296400,17907,6182,15498,1506,4229,5018,3268,1477,8538,7993,545,7993,6973,1020,2018-01-01,zipcode,Montgomery
ZCTA5 77318,48,15380,61777,1163,209600,12403,5485,10942,945,3614,3614,1933,836,6850,5806,1044,5806,4434,1372,2018-01-01,zipcode,Willis
ZCTA5 77320,48,35762,51078,892,131800,31042,19666,26515,4269,11502,6286,3298,1160,11672,9105,2567,9105,5615,3490,2018-01-01,zipcode,Huntsville
ZCTA5 77326,48,46,-666666666,-666666666,-666666666,46,46,46,0,46,0,0,0,112,46,66,46,46,0,2018-01-01,zipcode,Ace
ZCTA5 77327,48,23034,41504,739,95000,16536,8097,14320,3543,5451,3984,1015,327,9220,7795,1425,7795,5323,2472,2018-01-01,zipcode,Cleveland
ZCTA5 77328,48,15928,58518,789,113400,11814,5542,10023,2592,4162,2255,843,171,5574,4781,793,4781,3727,1054,2018-01-01,zipcode,Cleveland
ZCTA5 77331,48,7699,49331,781,150100,6464,3516,5695,868,2713,1293,537,284,4376,2784,1592,2784,2418,366,2018-01-01,zipcode,Coldspring
ZCTA5 77334,48,313,39364,-666666666,-666666666,258,138,258,74,64,120,0,0,121,121,0,121,75,46,2018-01-01,zipcode,Dodge
ZCTA5 77335,48,2912,55183,1002,100900,2399,909,2132,311,960,667,177,17,1602,1176,426,1176,1019,157,2018-01-01,zipcode,Goodrich
ZCTA5 77336,48,12424,69512,1079,163800,9441,3673,8043,1132,2416,3214,1091,190,4772,4400,372,4400,3496,904,2018-01-01,zipcode,Huffman
ZCTA5 77338,48,42787,54489,1004,139900,31093,9063,26023,3861,7761,10129,3303,969,15197,14282,915,14282,7733,6549,2018-01-01,zipcode,Humble
ZCTA5 77339,48,41205,73710,1298,182800,31887,10581,27329,1079,4759,10188,7719,3584,16920,15474,1446,15474,10077,5397,2018-01-01,zipcode,Kingwood
ZCTA5 77340,48,30866,33643,879,171700,27274,14640,16799,2081,5132,4845,3187,1554,12109,10986,1123,10986,4319,6667,2018-01-01,zipcode,Huntsville
ZCTA5 77342,48,0,-666666666,-666666666,-666666666,0,0,0,0,0,0,0,0,0,0,0,0,0,0,2018-01-01,zipcode,Huntsville
ZCTA5 77345,48,28804,132955,1476,281700,22006,8960,18414,546,1733,4669,7461,4005,9963,9508,455,9508,8421,1087,2018-01-01,zipcode,Kingwood
ZCTA5 77346,48,65967,103478,1398,193800,47413,14284,41084,2557,8052,13787,11775,4913,21631,20953,678,20953,17458,3495,2018-01-01,zipcode,Humble
ZCTA5 77350,48,192,-666666666,-666666666,43300,135,66,117,34,6,47,25,5,87,70,17,70,68,2,2018-01-01,zipcode,Leggett
ZCTA5 77351,48,33740,46897,727,109700,27920,14530,24528,5199,8660,6937,2711,1021,16680,12016,4664,12016,9107,2909,2018-01-01,zipcode,Livingston
ZCTA5 77354,48,36679,83951,1186,243700,27721,9509,24261,2630,6562,7485,5294,2290,12857,12171,686,12171,9903,2268,2018-01-01,zipcode,Magnolia
ZCTA5 77355,48,28074,83668,1096,246800,22466,7974,18822,2144,5051,6034,4135,1458,9904,9386,518,9386,7905,1481,2018-01-01,zipcode,Magnolia
ZCTA5 77356,48,26753,81498,1360,248500,22358,9196,20017,673,3893,7888,5367,2196,14037,11315,2722,11315,9241,2074,2018-01-01,zipcode,Montgomery
ZCTA5 77357,48,25359,52962,846,123200,18876,7501,14590,4273,4229,4320,1293,475,8452,7659,793,7659,5613,2046,2018-01-01,zipcode,New caney
ZCTA5 77358,48,5480,55625,916,154500,4080,1909,3312,445,1346,1190,189,142,2526,1824,702,1824,1358,466,2018-01-01,zipcode,New waverly
ZCTA5 77359,48,475,83341,-666666666,-666666666,475,276,475,0,372,51,52,0,253,171,82,171,171,0,2018-01-01,zipcode,Oakhurst
ZCTA5 77360,48,5036,43897,863,87800,4121,2047,3700,544,1617,1086,359,94,3648,2210,1438,2210,1739,471,2018-01-01,zipcode,Onalaska
ZCTA5 77362,48,5960,74240,1643,171700,4301,1586,3523,431,1216,1016,718,142,1890,1733,157,1733,1519,214,2018-01-01,zipcode,Pinehurst
ZCTA5 77363,48,2956,41571,1000,156500,2472,1082,2288,254,850,697,347,140,1591,1310,281,1310,1110,200,2018-01-01,zipcode,Plantersville
ZCTA5 77364,48,1551,33654,835,114700,1399,834,1364,255,525,399,99,86,1391,818,573,818,711,107,2018-01-01,zipcode,Pointblank
ZCTA5 77365,48,34781,73873,1116,188600,27242,9510,22316,3927,5287,7777,3440,1885,12025,11176,849,11176,8444,2732,2018-01-01,zipcode,Porter
ZCTA5 77367,48,115,-666666666,-666666666,-666666666,107,65,92,39,35,18,0,0,108,67,41,67,38,29,2018-01-01,zipcode,Riverside
ZCTA5 77368,48,166,38250,-666666666,-666666666,166,153,166,58,71,24,13,0,162,68,94,68,68,0,2018-01-01,zipcode,Romayor
ZCTA5 77369,48,571,45357,-666666666,66900,514,336,483,171,147,118,47,0,323,238,85,238,215,23,2018-01-01,zipcode,Rye
ZCTA5 77371,48,7910,40459,573,67200,6182,3046,5461,1020,2787,1292,256,106,3122,2510,612,2510,1888,622,2018-01-01,zipcode,Shepherd
ZCTA5 77372,48,13238,60324,943,99600,9796,3816,8063,1919,3157,2355,524,108,4689,4222,467,4222,3199,1023,2018-01-01,zipcode,Splendora
ZCTA5 77373,48,59093,69046,1369,147200,44880,14018,37864,3314,10635,14751,6455,2709,21378,19975,1403,19975,14203,5772,2018-01-01,zipcode,Spring
ZCTA5 77374,48,348,19353,-666666666,44800,274,159,193,34,89,70,0,0,225,173,52,173,128,45,2018-01-01,zipcode,Thicket
ZCTA5 77375,48,52785,72049,1171,183600,38639,10985,32159,3022,7550,10832,7591,3164,18180,17002,1178,17002,12041,4961,2018-01-01,zipcode,Tomball
ZCTA5 77376,48,535,39044,-666666666,15400,535,444,465,114,322,29,0,0,316,249,67,249,249,0,2018-01-01,zipcode,Votaw
ZCTA5 77377,48,37016,99276,1441,255000,27893,9319,23728,1756,3866,7925,7324,2857,12296,11950,346,11950,9926,2024,2018-01-01,zipcode,Tomball
ZCTA5 77378,48,16201,58249,964,122000,11748,4419,10038,2201,3590,3194,736,317,5801,5157,644,5157,3844,1313,2018-01-01,zipcode,Willis
ZCTA5 77379,48,79986,102008,1271,244800,60691,19699,53358,2539,8891,16336,16910,8682,28392,27041,1351,27041,21184,5857,2018-01-01,zipcode,Spring
ZCTA5 77380,48,25879,70444,1318,258100,21768,6706,18992,1229,2715,5416,6137,3495,13182,11686,1496,11686,4732,6954,2018-01-01,zipcode,Spring
ZCTA5 77381,48,36507,110774,1374,350300,29189,11641,26172,588,2551,6261,10456,6316,14919,14137,782,14137,10611,3526,2018-01-01,zipcode,Spring
ZCTA5 77382,48,39861,134383,1811,408200,29007,10637,24198,600,2030,5619,9388,6561,14178,13204,974,13204,9553,3651,2018-01-01,zipcode,Spring
ZCTA5 77384,48,17926,82708,1289,313300,14285,5058,12730,668,1929,3752,3649,2732,8054,7163,891,7163,4588,2575,2018-01-01,zipcode,Conroe
ZCTA5 77385,48,25572,94226,1250,215800,19341,5473,16400,1502,3521,5182,4227,1968,8913,8600,313,8600,6833,1767,2018-01-01,zipcode,Conroe
ZCTA5 77386,48,54802,108029,1467,220800,38738,9851,33876,1870,4803,11793,10870,4540,17549,17158,391,17158,13022,4136,2018-01-01,zipcode,Spring
ZCTA5 77388,48,49487,90483,1566,187400,38572,11878,31975,2589,6021,11098,8157,4110,16968,16553,415,16553,12627,3926,2018-01-01,zipcode,Spring
ZCTA5 77389,48,35349,125781,1583,314200,24564,7301,22297,868,3456,5611,8121,4241,12512,11245,1267,11245,9019,2226,2018-01-01,zipcode,Spring
ZCTA5 77396,48,57775,66455,1177,150000,42973,13310,37243,6266,9911,11663,5681,3722,18951,17960,991,17960,10401,7559,2018-01-01,zipcode,Humble
ZCTA5 77401,48,19283,185795,1612,837300,14803,4970,13329,302,767,1534,4476,6250,7565,7008,557,7008,5809,1199,2018-01-01,zipcode,Bellaire
ZCTA5 77406,48,46841,116758,1308,286100,35765,12014,31641,1883,5735,9707,9225,5091,16137,15096,1041,15096,13113,1983,2018-01-01,zipcode,Richmond
ZCTA5 77407,48,51142,97747,1421,227100,36645,9737,31855,2213,4613,9493,10006,5530,15986,15337,649,15337,12906,2431,2018-01-01,zipcode,Richmond
ZCTA5 77412,48,55,-666666666,-666666666,-666666666,49,6,49,6,14,12,17,0,18,12,6,12,12,0,2018-01-01,zipcode,Altair
ZCTA5 77414,48,23989,48469,824,113900,18465,7463,15753,3741,4442,4752,2034,784,12085,8646,3439,8646,5191,3455,2018-01-01,zipcode,Bay city
ZCTA5 77415,48,85,-666666666,-666666666,-666666666,47,14,33,0,0,0,33,0,17,17,0,17,17,0,2018-01-01,zipcode,Cedar lane
ZCTA5 77417,48,2652,45988,945,108900,2210,1000,1897,519,662,456,220,40,1224,1018,206,1018,651,367,2018-01-01,zipcode,Beasley
ZCTA5 77418,48,10381,61420,819,235800,8601,3730,7278,960,1792,2358,1479,689,4703,4115,588,4115,3030,1085,2018-01-01,zipcode,Bellville
ZCTA5 77419,48,1452,55982,-666666666,130900,895,175,706,179,219,131,177,0,594,433,161,433,398,35,2018-01-01,zipcode,Blessing
ZCTA5 77420,48,2161,50000,824,113000,1817,683,1488,281,472,625,74,36,1054,906,148,906,711,195,2018-01-01,zipcode,Boling
ZCTA5 77422,48,13542,52583,903,107300,11336,5948,9504,1376,3855,3290,696,287,6146,4834,1312,4834,3896,938,2018-01-01,zipcode,Brazoria
ZCTA5 77423,48,11901,62083,922,206000,9122,3072,7526,1707,2540,1769,979,531,3870,3592,278,3592,2724,868,2018-01-01,zipcode,Brookshire
ZCTA5 77426,48,2096,69345,1171,189600,1685,700,1415,190,231,676,204,114,1048,781,267,781,556,225,2018-01-01,zipcode,Chappell hill
ZCTA5 77428,48,0,-666666666,-666666666,-666666666,0,0,0,0,0,0,0,0,0,0,0,0,0,0,2018-01-01,zipcode,Collegeport
ZCTA5 77429,48,88344,107072,1368,234700,63667,19370,55477,2322,9026,16623,19119,8387,29776,28386,1390,28386,24171,4215,2018-01-01,zipcode,Cypress
ZCTA5 77430,48,2104,79000,-666666666,127600,1665,656,1485,118,551,324,350,142,1033,784,249,784,696,88,2018-01-01,zipcode,Damon
ZCTA5 77432,48,103,-666666666,-666666666,-666666666,77,22,77,28,0,22,15,12,62,37,25,37,15,22,2018-01-01,zipcode,Danevang
ZCTA5 77433,48,82257,109084,1517,257800,56522,16477,48949,3709,8472,12997,16104,7667,26332,24884,1448,24884,21226,3658,2018-01-01,zipcode,Cypress
ZCTA5 77434,48,4765,38673,715,54700,3644,1613,3045,813,1104,738,288,102,2078,1624,454,1624,1233,391,2018-01-01,zipcode,Eagle lake
ZCTA5 77435,48,4258,65339,918,161500,3229,1190,2789,406,838,696,564,285,1817,1545,272,1545,1265,280,2018-01-01,zipcode,East bernard
ZCTA5 77436,48,48,-666666666,-666666666,-666666666,31,18,31,0,0,0,18,13,13,13,0,13,13,0,2018-01-01,zipcode,Egypt
ZCTA5 77437,48,16906,51465,744,153600,12546,4426,10604,2456,2937,3222,1320,669,6751,6137,614,6137,3979,2158,2018-01-01,zipcode,El campo
ZCTA5 77440,48,23,-666666666,-666666666,-666666666,23,0,23,23,0,0,0,0,23,23,0,23,0,23,2018-01-01,zipcode,Elmaton
ZCTA5 77441,48,11308,166524,664,429100,8620,3385,7491,353,845,1591,2963,1739,3927,3670,257,3670,3548,122,2018-01-01,zipcode,Fulshear
ZCTA5 77442,48,794,56406,-666666666,106000,677,242,595,105,202,153,98,37,532,361,171,361,313,48,2018-01-01,zipcode,Garwood
ZCTA5 77443,48,245,-666666666,-666666666,-666666666,112,0,112,0,112,0,0,0,53,53,0,53,53,0,2018-01-01,zipcode,Glen flora
ZCTA5 77444,48,632,52292,731,-666666666,501,188,418,108,152,94,42,22,357,245,112,245,178,67,2018-01-01,zipcode,Guy
ZCTA5 77445,48,13524,45028,861,124700,9915,3437,7951,1742,2688,2106,989,426,5346,4579,767,4579,2463,2116,2018-01-01,zipcode,Hempstead
ZCTA5 77446,48,6116,25688,1034,168300,5838,3359,699,84,151,302,68,94,1005,719,286,719,130,589,2018-01-01,zipcode,Prairie view
ZCTA5 77447,48,15219,72656,1176,153600,11476,4062,9471,1649,3298,2924,1139,461,5171,4842,329,4842,4009,833,2018-01-01,zipcode,Hockley
ZCTA5 77448,48,182,-666666666,-666666666,-666666666,144,24,144,41,70,0,33,0,71,71,0,71,17,54,2018-01-01,zipcode,Hungerford
ZCTA5 77449,48,122814,76163,1492,153100,88698,21994,73771,10587,17639,24969,15257,5319,36374,34991,1383,34991,24254,10737,2018-01-01,zipcode,Katy
ZCTA5 77450,48,73683,97681,1374,257900,56077,18719,48050,2707,6974,13289,16205,8875,26154,24841,1313,24841,17443,7398,2018-01-01,zipcode,Katy
ZCTA5 77451,48,62,25179,-666666666,63100,54,24,35,2,27,6,0,0,39,25,14,25,23,2,2018-01-01,zipcode,Kendleton
ZCTA5 77453,48,352,25776,670,-666666666,157,50,154,41,49,64,0,0,122,98,24,98,41,57,2018-01-01,zipcode,Lane city
ZCTA5 77454,48,15,-666666666,-666666666,-666666666,15,0,15,0,0,0,0,15,15,15,0,15,15,0,2018-01-01,zipcode,Lissie
ZCTA5 77455,48,2267,57692,679,123500,1785,587,1576,376,556,471,104,69,957,794,163,794,702,92,2018-01-01,zipcode,Louise
ZCTA5 77456,48,1588,43241,-666666666,86100,1227,488,1095,207,461,297,130,0,681,596,85,596,511,85,2018-01-01,zipcode,Markham
ZCTA5 77457,48,396,32625,-666666666,130400,344,190,320,45,74,148,53,0,1078,199,879,199,190,9,2018-01-01,zipcode,Matagorda
ZCTA5 77458,48,87,-666666666,-666666666,-666666666,87,35,61,1,27,24,9,0,113,61,52,61,36,25,2018-01-01,zipcode,Midfield
ZCTA5 77459,48,69546,107692,1735,264200,53454,17199,45187,2310,6268,11301,15959,9349,22608,21874,734,21874,18419,3455,2018-01-01,zipcode,Missouri city
ZCTA5 77460,48,77,-666666666,-666666666,-666666666,40,11,40,21,10,9,0,0,20,20,0,20,10,10,2018-01-01,zipcode,Nada
ZCTA5 77461,48,11352,70758,857,145000,8856,3051,7655,1691,2504,2047,1082,331,4166,3840,326,3840,2984,856,2018-01-01,zipcode,Needville
ZCTA5 77464,48,173,58571,764,136100,142,67,114,32,41,30,9,2,83,76,7,76,44,32,2018-01-01,zipcode,Orchard
ZCTA5 77465,48,7001,41976,751,111100,5520,2351,4579,808,1823,1252,354,342,3826,2691,1135,2691,2180,511,2018-01-01,zipcode,Palacios
ZCTA5 77466,48,401,63393,974,111700,368,69,271,62,109,66,23,11,201,167,34,167,94,73,2018-01-01,zipcode,Pattison
ZCTA5 77467,48,13,-666666666,-666666666,-666666666,13,0,13,0,0,13,0,0,31,13,18,13,0,13,2018-01-01,zipcode,Pierce
ZCTA5 77468,48,42,-666666666,-666666666,-666666666,42,20,42,0,0,22,0,20,48,20,28,20,20,0,2018-01-01,zipcode,Pledger
ZCTA5 77469,48,48824,75793,1112,215600,38056,14449,32199,4808,7505,9446,6695,3745,16302,15544,758,15544,11270,4274,2018-01-01,zipcode,Richmond
ZCTA5 77470,48,465,43274,-666666666,54800,402,146,270,92,129,26,19,4,218,179,39,179,144,35,2018-01-01,zipcode,Rock island
ZCTA5 77471,48,41139,51841,1006,142900,29731,10160,24150,5972,6946,6971,2761,1500,14642,13055,1587,13055,7258,5797,2018-01-01,zipcode,Rosenberg
ZCTA5 77473,48,90,20417,-666666666,-666666666,54,22,49,0,23,26,0,0,37,31,6,31,10,21,2018-01-01,zipcode,San felipe
ZCTA5 77474,48,12825,70479,824,167300,9786,3089,8401,1740,2569,2387,1356,349,5079,4507,572,4507,3431,1076,2018-01-01,zipcode,Sealy
ZCTA5 77475,48,889,68309,-666666666,84900,769,295,690,66,254,244,73,53,575,335,240,335,335,0,2018-01-01,zipcode,Sheridan
ZCTA5 77476,48,187,37917,-666666666,309600,136,55,126,33,37,34,13,9,89,71,18,71,61,10,2018-01-01,zipcode,Simonton
ZCTA5 77477,48,36563,60765,1225,159600,29922,8574,24533,3601,5465,6822,6040,2605,13965,13101,864,13101,6057,7044,2018-01-01,zipcode,Stafford
ZCTA5 77478,48,25277,92287,1468,285500,21514,8489,18876,1324,2552,4452,6596,3952,9745,9295,450,9295,7093,2202,2018-01-01,zipcode,Sugar land
ZCTA5 77479,48,92146,139312,1818,358900,69668,23791,60315,3306,5714,10992,21932,18371,29713,28469,1244,28469,23961,4508,2018-01-01,zipcode,Sugar land
ZCTA5 77480,48,8178,61909,889,113500,6238,2709,5420,610,1983,2101,681,45,3509,2933,576,2933,2401,532,2018-01-01,zipcode,Sweeny
ZCTA5 77481,48,14,-666666666,-666666666,-666666666,14,6,14,0,0,14,0,0,11,8,3,8,2,6,2018-01-01,zipcode,Thompsons
ZCTA5 77482,48,1886,37750,867,90700,1699,922,1522,248,451,657,99,67,1101,912,189,912,777,135,2018-01-01,zipcode,Van vleck
ZCTA5 77483,48,226,-666666666,-666666666,-666666666,147,0,91,13,67,11,0,0,216,79,137,79,24,55,2018-01-01,zipcode,Wadsworth
ZCTA5 77484,48,11059,66600,827,193700,8387,2853,6813,1245,2147,2275,814,332,4185,3679,506,3679,2779,900,2018-01-01,zipcode,Waller
ZCTA5 77485,48,4475,53266,790,137200,3389,1631,3027,641,1167,770,318,131,1713,1494,219,1494,1027,467,2018-01-01,zipcode,Wallis
ZCTA5 77486,48,7563,71662,1097,132900,5869,2485,4872,519,1387,2224,426,316,3038,2673,365,2673,2071,602,2018-01-01,zipcode,West columbia
ZCTA5 77488,48,14533,43327,721,106600,11582,4916,9545,2208,2791,3274,650,622,6243,5379,864,5379,3301,2078,2018-01-01,zipcode,Wharton
ZCTA5 77489,48,36548,66450,1333,124000,28524,8478,23999,2717,6542,8033,4714,1993,12362,11963,399,11963,9010,2953,2018-01-01,zipcode,Missouri city
ZCTA5 77493,48,32257,86614,1336,198700,24338,7374,20563,2160,5275,6575,4182,2371,10352,9817,535,9817,7868,1949,2018-01-01,zipcode,Katy
ZCTA5 77494,48,114989,139669,1620,343000,80868,26335,69744,2042,6917,17134,25518,18133,36981,35342,1639,35342,27491,7851,2018-01-01,zipcode,Katy
ZCTA5 77498,48,51505,79658,1474,198400,39999,12832,32875,3818,7156,9369,8394,4138,16100,15216,884,15216,11111,4105,2018-01-01,zipcode,Sugar land
ZCTA5 77502,48,38272,50035,915,98000,27576,9840,22233,8487,6827,5386,1095,438,11632,10803,829,10803,6580,4223,2018-01-01,zipcode,Pasadena
ZCTA5 77503,48,25738,50445,915,100900,18508,6271,15057,3847,5017,4603,1135,455,8475,7910,565,7910,4074,3836,2018-01-01,zipcode,Pasadena
ZCTA5 77504,48,23875,42973,908,143500,17513,5593,14369,2852,5104,4104,1661,648,10147,8697,1450,8697,3534,5163,2018-01-01,zipcode,Pasadena
ZCTA5 77505,48,24022,78487,1175,180700,18984,6086,15518,1552,4393,5933,2557,1083,9072,8300,772,8300,5603,2697,2018-01-01,zipcode,Pasadena
ZCTA5 77506,48,38568,38311,826,77000,26521,9514,21408,9878,6907,3718,739,166,12187,10954,1233,10954,4395,6559,2018-01-01,zipcode,Pasadena
ZCTA5 77507,48,0,-666666666,-666666666,-666666666,0,0,0,0,0,0,0,0,0,0,0,0,0,0,2018-01-01,zipcode,Pasadena
ZCTA5 77510,48,14823,75383,899,168600,11951,4405,10162,1051,3662,4310,916,223,6239,5374,865,5374,4210,1164,2018-01-01,zipcode,Santa fe
ZCTA5 77511,48,46869,61446,945,142400,36021,13501,30141,4824,9685,11048,3169,1415,18160,16252,1908,16252,11372,4880,2018-01-01,zipcode,Alvin
ZCTA5 77514,48,5102,42500,809,104600,4080,2048,3462,1125,1053,902,138,244,2255,1778,477,1778,1435,343,2018-01-01,zipcode,Anahuac
ZCTA5 77515,48,32554,61794,873,118700,25907,11194,22365,4218,7833,6684,2786,844,12225,10939,1286,10939,7369,3570,2018-01-01,zipcode,Angleton
ZCTA5 77517,48,5429,64238,1119,190800,4457,1949,3699,347,1450,1506,341,55,2072,1767,305,1767,1682,85,2018-01-01,zipcode,Santa fe
ZCTA5 77518,48,10684,39820,842,101000,7674,2547,6758,1733,2318,1720,678,309,4079,3631,448,3631,2239,1392,2018-01-01,zipcode,Bacliff
ZCTA5 77519,48,1129,63493,-666666666,65100,915,416,865,111,460,194,84,16,517,405,112,405,392,13,2018-01-01,zipcode,Batson
ZCTA5 77520,48,35970,47817,891,84500,26557,9936,22147,6876,5808,6994,1628,841,14196,12442,1754,12442,7001,5441,2018-01-01,zipcode,Baytown
ZCTA5 77521,48,59722,68318,952,142200,44338,15203,35383,5522,9534,13781,4777,1769,21632,19650,1982,19650,12189,7461,2018-01-01,zipcode,Baytown
ZCTA5 77523,48,22101,102019,897,225000,15810,4938,13570,1022,3365,5772,2391,1020,7326,6874,452,6874,5951,923,2018-01-01,zipcode,Baytown
ZCTA5 77530,48,32922,57716,889,95300,23700,8700,18864,6372,6594,4648,897,353,9777,9249,528,9249,6184,3065,2018-01-01,zipcode,Channelview
ZCTA5 77531,48,16141,61903,893,118500,12161,3947,10291,2260,3104,3351,1194,382,7126,5969,1157,5969,3223,2746,2018-01-01,zipcode,Clute
ZCTA5 77532,48,29608,65805,936,147200,23139,8762,19741,2969,6431,7043,2454,844,10899,10387,512,10387,8240,2147,2018-01-01,zipcode,Crosby
ZCTA5 77533,48,719,39688,615,68600,566,270,491,74,248,112,39,18,413,301,112,301,192,109,2018-01-01,zipcode,Daisetta
ZCTA5 77534,48,2303,92063,864,153900,1849,618,1521,158,371,687,204,101,985,847,138,847,710,137,2018-01-01,zipcode,Danbury
ZCTA5 77535,48,34291,52825,878,108200,27996,14464,23511,4869,9748,7012,1281,601,11134,9885,1249,9885,7885,2000,2018-01-01,zipcode,Dayton
ZCTA5 77536,48,33015,81177,1252,159800,25826,8320,21213,2247,5970,8619,3232,1145,11644,10874,770,10874,8247,2627,2018-01-01,zipcode,Deer park
ZCTA5 77538,48,1030,57500,788,111700,864,446,732,203,224,207,74,24,395,336,59,336,309,27,2018-01-01,zipcode,Devers
ZCTA5 77539,48,44041,74972,1006,162900,34649,11765,29640,4531,8227,10125,4601,2156,17761,15579,2182,15579,11217,4362,2018-01-01,zipcode,Dickinson
ZCTA5 77541,48,18677,47313,821,90300,13723,5045,10768,2874,3579,3175,925,215,8856,6479,2377,6479,3787,2692,2018-01-01,zipcode,Freeport
ZCTA5 77545,48,24954,79869,1431,164900,17998,4788,14623,2133,3317,4487,2752,1934,7438,7192,246,7192,5974,1218,2018-01-01,zipcode,Fresno
ZCTA5 77546,48,53320,100217,1338,231300,40758,13633,34758,1643,6460,10551,10757,5347,18663,17894,769,17894,13999,3895,2018-01-01,zipcode,Friendswood
ZCTA5 77547,48,10028,42872,886,72000,7159,2621,5619,2437,1394,1335,359,94,2819,2624,195,2624,1634,990,2018-01-01,zipcode,Galena park
ZCTA5 77550,48,21449,38048,863,154300,18435,7585,15782,2522,3707,4635,2951,1967,14076,9837,4239,9837,4200,5637,2018-01-01,zipcode,Galveston
ZCTA5 77551,48,21861,48394,974,166100,18344,8042,15445,3103,4308,4410,2285,1339,10074,8425,1649,8425,3390,5035,2018-01-01,zipcode,Galveston
ZCTA5 77554,48,8769,73242,1058,281100,7970,3319,6141,347,1044,2095,1521,1134,10069,3733,6336,3733,2424,1309,2018-01-01,zipcode,Galveston
ZCTA5 77560,48,610,102583,-666666666,189000,444,117,383,71,146,116,35,15,381,235,146,235,223,12,2018-01-01,zipcode,Hankamer
ZCTA5 77561,48,79,-666666666,-666666666,114800,71,30,71,15,44,6,6,0,39,39,0,39,39,0,2018-01-01,zipcode,Hardin
ZCTA5 77562,48,10380,60130,949,102600,8137,3587,6702,1341,2266,2323,411,361,3943,3676,267,3676,2859,817,2018-01-01,zipcode,Highlands
ZCTA5 77563,48,10680,60858,889,148000,8036,3115,7122,928,2311,2707,848,328,5062,4015,1047,4015,2849,1166,2018-01-01,zipcode,Hitchcock
ZCTA5 77564,48,1678,60511,-666666666,97500,1290,686,1138,304,503,194,137,0,862,637,225,637,562,75,2018-01-01,zipcode,Hull
ZCTA5 77565,48,7945,63322,1231,245300,6504,2350,5684,264,989,2225,1523,683,4162,3589,573,3589,1878,1711,2018-01-01,zipcode,Kemah
ZCTA5 77566,48,29602,83927,1158,172100,22804,7318,19530,1253,4372,7184,4795,1926,12201,11272,929,11272,7763,3509,2018-01-01,zipcode,Lake jackson
ZCTA5 77568,48,15571,45355,893,99700,12342,4967,10643,1682,3856,3615,1097,393,6714,5660,1054,5660,3746,1914,2018-01-01,zipcode,La marque
ZCTA5 77571,48,37360,73742,1017,140400,29791,9740,25434,2674,7935,10112,3228,1485,14073,13296,777,13296,9940,3356,2018-01-01,zipcode,La porte
ZCTA5 77573,48,86926,106067,1346,237500,65091,19069,55647,2554,10309,17263,16394,9127,30918,29602,1316,29602,22140,7462,2018-01-01,zipcode,League city
ZCTA5 77575,48,16640,57710,858,108300,12482,5540,10386,1959,3835,3227,848,517,6839,5765,1074,5765,4181,1584,2018-01-01,zipcode,Liberty
ZCTA5 77577,48,1582,66923,687,130400,1233,609,1125,284,250,424,139,28,783,572,211,572,528,44,2018-01-01,zipcode,Liverpool
ZCTA5 77578,48,20310,100347,1510,244800,14783,4177,12882,634,2639,4347,3245,2017,6703,6011,692,6011,5345,666,2018-01-01,zipcode,Manvel
ZCTA5 77580,48,715,-666666666,-666666666,331800,382,163,382,0,33,194,155,0,220,220,0,220,220,0,2018-01-01,zipcode,Mont belvieu
ZCTA5 77581,48,49612,94494,1171,217000,38030,12941,31792,1828,6699,10794,8392,4079,17999,16904,1095,16904,13127,3777,2018-01-01,zipcode,Pearland
ZCTA5 77583,48,36903,70658,747,185800,28844,14210,24072,5525,7179,6594,2796,1978,10164,9146,1018,9146,7046,2100,2018-01-01,zipcode,Rosharon
ZCTA5 77584,48,87986,106415,1440,236700,65025,17154,57205,3260,7446,17120,17065,12314,31208,29612,1596,29612,21626,7986,2018-01-01,zipcode,Pearland
ZCTA5 77585,48,998,40972,-666666666,18700,829,496,674,228,294,100,52,0,411,330,81,330,296,34,2018-01-01,zipcode,Saratoga
ZCTA5 77586,48,22527,93760,1111,231900,18202,5756,15432,486,2644,5473,4797,2032,9664,8824,840,8824,5683,3141,2018-01-01,zipcode,Seabrook
ZCTA5 77587,48,17040,45643,829,93100,11868,4519,9575,4180,3192,1522,501,180,5075,4615,460,4615,2640,1975,2018-01-01,zipcode,South houston
ZCTA5 77590,48,31498,44915,908,101500,23930,9642,20275,4353,6672,6696,1914,640,12835,11086,1749,11086,6610,4476,2018-01-01,zipcode,Texas city
ZCTA5 77591,48,14447,47078,975,130100,11189,4080,9707,1170,2875,3846,1417,399,6306,5380,926,5380,2824,2556,2018-01-01,zipcode,Texas city
ZCTA5 77597,48,983,51083,-666666666,-666666666,676,288,555,88,200,198,60,9,389,264,125,264,225,39,2018-01-01,zipcode,Wallisville
ZCTA5 77598,48,26473,54181,1061,143100,21106,4728,16777,2480,2904,5748,3962,1683,12146,11012,1134,11012,2331,8681,2018-01-01,zipcode,Webster
ZCTA5 77611,48,8633,72574,850,139300,6734,2241,5771,390,2002,2282,902,195,3541,3188,353,3188,2404,784,2018-01-01,zipcode,Bridge city
ZCTA5 77612,48,9513,56970,782,123200,7674,4137,6426,801,3030,2054,452,89,4084,3252,832,3252,2857,395,2018-01-01,zipcode,Buna
ZCTA5 77613,48,963,51712,728,109900,842,449,805,121,372,223,47,42,468,449,19,449,338,111,2018-01-01,zipcode,China
ZCTA5 77614,48,278,-666666666,-666666666,-666666666,278,220,254,50,113,91,0,0,235,179,56,179,141,38,2018-01-01,zipcode,Deweyville
ZCTA5 77615,48,910,65288,580,84400,679,278,545,67,312,139,21,6,398,309,89,309,267,42,2018-01-01,zipcode,Evadale
ZCTA5 77616,48,563,40750,-666666666,80000,550,240,486,53,245,143,45,0,516,305,211,305,288,17,2018-01-01,zipcode,Fred
ZCTA5 77617,48,34,-666666666,-666666666,-666666666,34,27,34,9,7,10,8,0,136,25,111,25,25,0,2018-01-01,zipcode,
ZCTA5 77619,48,15760,54288,933,110100,12556,5001,10828,1328,4128,3707,1313,352,6648,5992,656,5992,4235,1757,2018-01-01,zipcode,Groves
ZCTA5 77622,48,1292,74018,1056,114900,984,434,831,79,382,262,73,35,548,441,107,441,372,69,2018-01-01,zipcode,Hamshire
ZCTA5 77623,48,439,63611,-666666666,102800,361,158,334,28,155,79,34,38,227,144,83,144,129,15,2018-01-01,zipcode,High island
ZCTA5 77624,48,619,-666666666,-666666666,93000,549,243,515,104,208,132,54,17,412,288,124,288,233,55,2018-01-01,zipcode,Hillister
ZCTA5 77625,48,10025,60865,762,81800,8022,3573,6442,958,2929,1936,336,283,4325,3393,932,3393,2856,537,2018-01-01,zipcode,Kountze
ZCTA5 77627,48,21636,74129,862,138700,17540,6200,14444,708,4390,5528,2576,1242,9703,8789,914,8789,6225,2564,2018-01-01,zipcode,Nederland
ZCTA5 77629,48,702,49276,499,103400,540,223,465,86,122,164,60,33,312,265,47,265,228,37,2018-01-01,zipcode,Nome
ZCTA5 77630,48,29026,48352,815,100100,22389,8910,19367,2444,7368,6641,2028,886,13424,11536,1888,11536,7612,3924,2018-01-01,zipcode,Orange
ZCTA5 77632,48,23288,64531,853,120700,18384,7348,15598,1388,5918,5454,2298,540,10115,8649,1466,8649,7276,1373,2018-01-01,zipcode,Orange
ZCTA5 77640,48,15796,35236,839,67300,12382,6106,10774,2010,4198,3065,993,508,8413,6341,2072,6341,3878,2463,2018-01-01,zipcode,Port arthur
ZCTA5 77642,48,39142,34736,757,64200,28907,12894,23911,6911,8269,6117,1985,629,16472,13815,2657,13815,7454,6361,2018-01-01,zipcode,Port arthur
ZCTA5 77650,48,1860,41442,804,191100,1612,767,1374,157,438,357,239,183,2723,866,1857,866,643,223,2018-01-01,zipcode,Port bolivar
ZCTA5 77651,48,12853,65625,935,161100,10278,3883,8852,660,2501,3540,1431,720,5364,5006,358,5006,3642,1364,2018-01-01,zipcode,Port neches
ZCTA5 77655,48,330,45000,-666666666,105800,308,140,261,48,113,77,23,0,181,156,25,156,137,19,2018-01-01,zipcode,Sabine pass
ZCTA5 77656,48,16041,50768,666,98800,12701,5918,11278,1550,4513,3939,989,287,7667,6076,1591,6076,4832,1244,2018-01-01,zipcode,Silsbee
ZCTA5 77657,48,21612,72367,845,161300,16303,6156,13901,1233,4940,4924,1998,806,8455,7666,789,7666,5883,1783,2018-01-01,zipcode,Lumberton
ZCTA5 77659,48,4773,64583,858,164300,3620,1531,3213,275,1017,1018,609,294,1988,1709,279,1709,1381,328,2018-01-01,zipcode,Sour lake
ZCTA5 77660,48,1205,72625,-666666666,83200,937,443,818,158,297,305,48,10,636,359,277,359,317,42,2018-01-01,zipcode,Spurger
ZCTA5 77661,48,742,-666666666,-666666666,-666666666,580,347,356,176,128,25,14,13,288,243,45,243,171,72,2018-01-01,zipcode,Stowell
ZCTA5 77662,48,26077,50765,748,91000,20613,9150,17295,2646,7350,5426,1517,356,11335,9748,1587,9748,7934,1814,2018-01-01,zipcode,Vidor
ZCTA5 77663,48,1431,-666666666,-666666666,175300,1128,882,1111,82,386,544,69,30,666,574,92,574,505,69,2018-01-01,zipcode,Village mills
ZCTA5 77664,48,2667,56833,-666666666,90700,2203,1244,1824,116,855,554,156,143,1256,934,322,934,869,65,2018-01-01,zipcode,Warren
ZCTA5 77665,48,6236,47234,904,118200,4936,1881,4403,831,1738,1155,469,210,2880,2364,516,2364,1756,608,2018-01-01,zipcode,Winnie
ZCTA5 77701,48,13889,31080,727,53300,10293,4854,8779,2670,3180,2273,496,160,6283,5024,1259,5024,2763,2261,2018-01-01,zipcode,Beaumont
ZCTA5 77702,48,2762,43936,840,83500,2126,710,1777,256,526,623,232,140,1387,1130,257,1130,565,565,2018-01-01,zipcode,Beaumont
ZCTA5 77703,48,13809,27169,689,62600,10028,4680,8422,1970,3768,2220,367,97,6025,4984,1041,4984,2502,2482,2018-01-01,zipcode,Beaumont
ZCTA5 77705,48,40251,39414,718,83300,34618,21647,28670,5894,10473,8927,2374,1002,12548,10775,1773,10775,6697,4078,2018-01-01,zipcode,Beaumont
ZCTA5 77706,48,29792,64636,908,166900,23904,8437,20803,1041,4300,6981,5131,3350,13928,13034,894,13034,7247,5787,2018-01-01,zipcode,Beaumont
ZCTA5 77707,48,18609,50929,950,107200,14036,5321,11387,1356,3145,3907,1988,991,7224,6714,510,6714,4672,2042,2018-01-01,zipcode,Beaumont
ZCTA5 77708,48,12918,48438,850,109000,9578,3299,7879,883,2471,2730,1202,593,5360,4867,493,4867,2447,2420,2018-01-01,zipcode,Beaumont
ZCTA5 77713,48,13469,62509,1103,150500,11018,3740,9571,804,2593,3320,2164,690,6703,5751,952,5751,3775,1976,2018-01-01,zipcode,Beaumont
ZCTA5 77801,48,15115,31315,826,106900,12066,3950,7105,1711,1622,1613,1184,975,7193,6126,1067,6126,963,5163,2018-01-01,zipcode,Bryan
ZCTA5 77802,48,26128,56669,950,170400,21306,7192,17563,1299,3488,5255,4351,3170,11661,10958,703,10958,5602,5356,2018-01-01,zipcode,Bryan
ZCTA5 77803,48,31978,40907,837,84500,23709,9453,19362,6979,6286,4675,1099,323,10461,9546,915,9546,5582,3964,2018-01-01,zipcode,Bryan
ZCTA5 77807,48,11119,62664,944,163800,8658,3364,6961,1126,2056,2141,1102,536,4031,3425,606,3425,2053,1372,2018-01-01,zipcode,Bryan
ZCTA5 77808,48,11941,64961,987,214000,9322,3365,8344,932,2252,2546,1486,1128,4837,4546,291,4546,4034,512,2018-01-01,zipcode,Bryan
ZCTA5 77830,48,2901,74688,564,250400,2175,878,1938,211,603,654,259,211,1409,1086,323,1086,948,138,2018-01-01,zipcode,Anderson
ZCTA5 77831,48,3170,50183,830,120000,2506,1188,2285,318,967,706,166,128,1869,1218,651,1218,1063,155,2018-01-01,zipcode,Bedias
ZCTA5 77833,48,29737,56799,835,177000,23772,10196,19095,2816,6252,5245,3137,1645,12284,10071,2213,10071,7498,2573,2018-01-01,zipcode,Brenham
ZCTA5 77835,48,2317,49821,-666666666,120300,1969,1022,1925,169,650,433,452,221,1905,1170,735,1170,881,289,2018-01-01,zipcode,Burton
ZCTA5 77836,48,11913,58608,751,120900,9426,3939,8233,1559,3317,1931,1018,408,5606,4493,1113,4493,3607,886,2018-01-01,zipcode,Caldwell
ZCTA5 77837,48,1869,34970,679,106000,1478,612,1269,212,492,387,110,68,954,671,283,671,460,211,2018-01-01,zipcode,Calvert
ZCTA5 77840,48,59971,25359,908,177900,54528,25679,19622,1506,2657,5299,4751,5409,24850,21152,3698,21152,2707,18445,2018-01-01,zipcode,College station
ZCTA5 77845,48,63078,78706,1158,240100,49445,16059,36420,1854,4282,8816,11067,10401,24711,23285,1426,23285,15568,7717,2018-01-01,zipcode,College station
ZCTA5 77853,48,1160,50313,725,96900,1024,495,908,291,273,167,134,43,657,459,198,459,388,71,2018-01-01,zipcode,Dime box
ZCTA5 77855,48,195,-666666666,-666666666,-666666666,72,19,72,9,30,33,0,0,158,43,115,43,10,33,2018-01-01,zipcode,Flynn
ZCTA5 77856,48,5348,48694,805,154800,4256,1910,3708,348,1238,1303,636,183,3007,2064,943,2064,1623,441,2018-01-01,zipcode,Franklin
ZCTA5 77857,48,700,58750,590,215000,567,252,533,90,186,176,57,24,416,301,115,301,231,70,2018-01-01,zipcode,Gause
ZCTA5 77859,48,6822,62031,642,91800,5085,1711,4387,951,1727,1183,347,179,2938,2427,511,2427,1853,574,2018-01-01,zipcode,Hearne
ZCTA5 77861,48,2398,58558,771,142700,2012,845,1764,262,650,526,244,82,1173,902,271,902,778,124,2018-01-01,zipcode,Iola
ZCTA5 77864,48,7198,49467,696,111800,5351,2273,4609,886,1500,1353,689,181,3368,2829,539,2829,1981,848,2018-01-01,zipcode,Madisonville
ZCTA5 77865,48,2273,69000,625,117200,1938,960,1459,157,632,434,209,27,1036,726,310,726,672,54,2018-01-01,zipcode,Marquez
ZCTA5 77867,48,130,45714,-666666666,83200,101,32,94,40,27,18,3,6,67,58,9,58,51,7,2018-01-01,zipcode,Mumford
ZCTA5 77868,48,17028,50462,719,121700,13556,7376,11430,2919,3994,3019,877,621,5449,4589,860,4589,3253,1336,2018-01-01,zipcode,Navasota
ZCTA5 77871,48,2841,49866,786,142600,2449,1133,2201,282,826,598,300,195,1639,1153,486,1153,876,277,2018-01-01,zipcode,Normangee
ZCTA5 77872,48,1819,52019,831,109300,1354,597,1179,147,530,332,112,58,978,697,281,697,635,62,2018-01-01,zipcode,North zulch
ZCTA5 77873,48,1284,41708,553,141300,1015,340,800,81,260,261,113,85,631,517,114,517,397,120,2018-01-01,zipcode,Richards
ZCTA5 77876,48,85,-666666666,-666666666,-666666666,85,42,58,0,7,39,12,0,94,22,72,22,7,15,2018-01-01,zipcode,Shiro
ZCTA5 77878,48,302,31891,-666666666,-666666666,266,140,206,38,33,105,27,3,154,125,29,125,83,42,2018-01-01,zipcode,Snook
ZCTA5 77879,48,5582,55239,717,88400,4566,2007,3935,561,1515,1192,438,229,3260,2096,1164,2096,1690,406,2018-01-01,zipcode,Somerville
ZCTA5 77880,48,1197,55735,-666666666,149600,979,452,950,176,233,257,122,162,926,512,414,512,431,81,2018-01-01,zipcode,Washington
ZCTA5 77901,48,43123,42996,842,94800,33087,11683,26215,6154,8849,7758,2448,1006,16980,14697,2283,14697,7804,6893,2018-01-01,zipcode,Victoria
ZCTA5 77904,48,28135,77123,987,183900,21911,8120,19253,1686,4742,6784,4042,1999,11432,10416,1016,10416,7337,3079,2018-01-01,zipcode,Victoria
ZCTA5 77905,48,14645,72237,984,144600,11406,4234,10293,1461,3109,3792,1417,514,5890,5359,531,5359,4674,685,2018-01-01,zipcode,Victoria
ZCTA5 77950,48,160,49375,529,83000,144,69,139,22,44,47,20,6,153,77,76,77,59,18,2018-01-01,zipcode,Austwell
ZCTA5 77951,48,1880,31145,664,43100,1559,633,1400,340,702,294,64,0,880,686,194,686,442,244,2018-01-01,zipcode,Bloomington
ZCTA5 77954,48,11939,55606,846,112700,9603,4683,8669,1561,3394,2719,695,300,4568,3802,766,3802,2624,1178,2018-01-01,zipcode,Cuero
ZCTA5 77957,48,8617,54438,797,102400,6727,2758,5674,878,1844,1924,749,279,3758,3068,690,3068,1993,1075,2018-01-01,zipcode,Edna
ZCTA5 77960,48,56,-666666666,-666666666,-666666666,56,0,56,0,0,56,0,0,108,56,52,56,56,0,2018-01-01,zipcode,Fannin
ZCTA5 77961,48,303,97712,-666666666,113900,234,77,234,0,27,154,53,0,239,145,94,145,107,38,2018-01-01,zipcode,Francitas
ZCTA5 77962,48,3704,59812,907,112200,2758,948,2378,549,894,643,239,53,1399,1209,190,1209,890,319,2018-01-01,zipcode,Ganado
ZCTA5 77963,48,5712,54223,584,119100,4614,2300,3884,524,1118,1533,457,252,2749,1939,810,1939,1628,311,2018-01-01,zipcode,Goliad
ZCTA5 77964,48,8304,51769,681,176500,6586,2675,5833,874,2336,1643,718,262,4583,3283,1300,3283,2367,916,2018-01-01,zipcode,Hallettsville
ZCTA5 77968,48,3198,68814,597,190100,2461,1067,2179,169,622,825,411,152,1305,1117,188,1117,1016,101,2018-01-01,zipcode,Inez
ZCTA5 77969,48,127,-666666666,-666666666,-666666666,127,44,127,12,26,73,16,0,58,38,20,38,38,0,2018-01-01,zipcode,La salle
ZCTA5 77970,48,303,63750,844,74600,271,110,214,72,45,69,26,2,175,131,44,131,82,49,2018-01-01,zipcode,La ward
ZCTA5 77971,48,1013,81968,759,82200,738,235,738,107,254,284,93,0,563,408,155,408,257,151,2018-01-01,zipcode,Lolita
ZCTA5 77973,48,0,-666666666,-666666666,-666666666,0,0,0,0,0,0,0,0,0,0,0,0,0,0,2018-01-01,zipcode,Mcfaddin
ZCTA5 77974,48,355,105625,1031,176000,272,77,262,18,90,100,38,16,183,147,36,147,119,28,2018-01-01,zipcode,Meyersville
ZCTA5 77975,48,1714,62353,765,125300,1389,635,1211,204,494,334,112,67,1041,680,361,680,497,183,2018-01-01,zipcode,Moulton
ZCTA5 77976,48,99,-666666666,-666666666,195800,91,26,85,0,36,27,10,12,55,43,12,43,37,6,2018-01-01,zipcode,Nursery
ZCTA5 77977,48,601,32434,612,63900,517,194,426,174,122,111,4,15,272,243,29,243,163,80,2018-01-01,zipcode,Placedo
ZCTA5 77978,48,757,67250,957,86500,558,150,492,37,184,195,43,33,385,288,97,288,168,120,2018-01-01,zipcode,Point comfort
ZCTA5 77979,48,17648,57500,723,109600,13752,5082,11780,2321,3887,3805,1180,587,8203,6182,2021,6182,4375,1807,2018-01-01,zipcode,Port lavaca
ZCTA5 77982,48,971,53173,758,207400,783,406,603,70,163,262,79,29,1656,289,1367,289,181,108,2018-01-01,zipcode,Port o connor
ZCTA5 77983,48,2301,42727,701,152700,1785,910,1481,360,536,387,141,57,1317,764,553,764,581,183,2018-01-01,zipcode,Seadrift
ZCTA5 77984,48,4028,60901,765,184000,3203,1449,2909,323,1094,803,541,148,2159,1587,572,1587,1303,284,2018-01-01,zipcode,Shiner
ZCTA5 77987,48,270,54773,-666666666,78400,208,75,182,10,115,40,16,1,119,108,11,108,95,13,2018-01-01,zipcode,Sweet home
ZCTA5 77988,48,558,47500,-666666666,121000,343,160,275,64,44,104,28,35,196,156,40,156,142,14,2018-01-01,zipcode,Telferner
ZCTA5 77990,48,878,43292,777,81300,659,285,604,102,195,194,99,14,509,311,198,311,215,96,2018-01-01,zipcode,Tivoli
ZCTA5 77991,48,395,70060,1063,82300,188,78,136,3,74,48,0,11,98,75,23,75,55,20,2018-01-01,zipcode,Vanderbilt
ZCTA5 77993,48,186,-666666666,-666666666,1020800,186,77,165,0,106,45,8,6,108,57,51,57,33,24,2018-01-01,zipcode,Weesatche
ZCTA5 77994,48,451,39545,-666666666,-666666666,366,147,330,28,170,67,65,0,295,186,109,186,151,35,2018-01-01,zipcode,Westhoff
ZCTA5 77995,48,10411,50959,666,112700,7886,3168,6605,1278,2879,1654,685,109,4608,3767,841,3767,2903,864,2018-01-01,zipcode,Yoakum
ZCTA5 78001,48,0,-666666666,-666666666,-666666666,0,0,0,0,0,0,0,0,0,0,0,0,0,0,2018-01-01,zipcode,Artesia wells
ZCTA5 78002,48,7329,45509,795,88300,5592,2679,4663,1372,1729,1305,209,48,2033,1857,176,1857,1311,546,2018-01-01,zipcode,Atascosa
ZCTA5 78003,48,9539,54932,911,155100,8270,4009,7439,843,2628,2318,1093,557,4994,3708,1286,3708,2979,729,2018-01-01,zipcode,Bandera
ZCTA5 78004,48,934,96484,-666666666,355700,862,413,816,18,249,233,131,185,411,399,12,399,372,27,2018-01-01,zipcode,Bergheim
ZCTA5 78005,48,668,-666666666,-666666666,84300,572,320,564,325,118,79,32,10,219,219,0,219,219,0,2018-01-01,zipcode,Bigfoot
ZCTA5 78006,48,32931,80339,1148,326200,25980,10365,22813,1164,4710,7199,6630,3110,12464,11466,998,11466,8214,3252,2018-01-01,zipcode,Boerne
ZCTA5 78007,48,187,68333,725,119400,130,64,106,24,61,18,3,0,86,56,30,56,34,22,2018-01-01,zipcode,Calliham
ZCTA5 78008,48,220,-666666666,-666666666,-666666666,220,136,220,87,51,0,40,42,379,176,203,176,136,40,2018-01-01,zipcode,Campbellton
ZCTA5 78009,48,8620,54824,1036,134600,6713,2861,5638,908,1250,2307,763,410,3003,2779,224,2779,2285,494,2018-01-01,zipcode,Castroville
ZCTA5 78010,48,3353,48804,851,132500,2783,1227,2275,348,663,774,340,150,1620,1282,338,1282,1037,245,2018-01-01,zipcode,Center point
ZCTA5 78011,48,1925,40833,587,48900,1452,627,1270,379,608,222,29,32,778,600,178,600,498,102,2018-01-01,zipcode,Charlotte
ZCTA5 78012,48,321,61786,-666666666,69700,258,113,244,73,86,49,9,27,197,130,67,130,123,7,2018-01-01,zipcode,Christine
ZCTA5 78013,48,6143,71328,889,180600,5206,1684,4294,844,1254,1306,597,293,2319,1892,427,1892,1547,345,2018-01-01,zipcode,Comfort
ZCTA5 78014,48,5631,50500,626,85200,4538,2076,3756,1097,1669,533,341,116,2306,1780,526,1780,1208,572,2018-01-01,zipcode,Cotulla
ZCTA5 78015,48,15119,122002,1516,425300,11954,4557,10324,179,1419,2646,3964,2116,5145,5019,126,5019,4416,603,2018-01-01,zipcode,Boerne
ZCTA5 78016,48,10026,52435,659,112600,7856,3401,6861,1649,2225,1968,799,220,4102,3501,601,3501,2726,775,2018-01-01,zipcode,Devine
ZCTA5 78017,48,5498,48235,781,61800,4441,2639,3085,864,1205,703,176,137,1496,1044,452,1044,557,487,2018-01-01,zipcode,Dilley
ZCTA5 78019,48,1470,52802,675,53700,1247,756,1040,474,333,138,87,8,620,391,229,391,288,103,2018-01-01,zipcode,Encinal
ZCTA5 78021,48,318,-666666666,-666666666,-666666666,251,230,251,52,178,4,17,0,193,73,120,73,69,4,2018-01-01,zipcode,Fowlerton
ZCTA5 78022,48,4027,55862,815,100000,3204,1586,2845,722,797,882,320,124,2222,1338,884,1338,996,342,2018-01-01,zipcode,George west
ZCTA5 78023,48,31003,124860,1521,296100,23532,7732,19616,792,2903,6049,5742,4130,9154,8931,223,8931,8168,763,2018-01-01,zipcode,Helotes
ZCTA5 78024,48,1152,49593,-666666666,347600,1015,596,986,51,208,337,207,183,1064,482,582,482,368,114,2018-01-01,zipcode,Hunt
ZCTA5 78025,48,4749,51393,858,129800,3980,1673,3316,433,1169,957,575,182,2151,1804,347,1804,1415,389,2018-01-01,zipcode,Ingram
ZCTA5 78026,48,5935,52484,951,90300,4399,1915,3698,934,1690,841,185,48,2389,1895,494,1895,1396,499,2018-01-01,zipcode,Jourdanton
ZCTA5 78027,48,409,-666666666,-666666666,333600,336,201,336,33,84,30,115,74,179,111,68,111,111,0,2018-01-01,zipcode,Kendalia
ZCTA5 78028,48,40447,52472,844,173200,33452,15731,29219,3168,7892,10489,5012,2658,18498,16657,1841,16657,11741,4916,2018-01-01,zipcode,Kerrville
ZCTA5 78029,48,0,-666666666,-666666666,-666666666,0,0,0,0,0,0,0,0,0,0,0,0,0,0,2018-01-01,zipcode,Kerrville
ZCTA5 78039,48,1747,64688,573,100300,1517,470,1225,189,353,307,336,40,663,626,37,626,536,90,2018-01-01,zipcode,La coste
ZCTA5 78040,48,42041,23446,650,75700,29738,15209,23713,11198,6335,4544,1280,356,13691,11731,1960,11731,5171,6560,2018-01-01,zipcode,Laredo
ZCTA5 78041,48,47261,47655,831,155100,35447,14742,28408,7726,7213,6440,4514,2515,15577,14111,1466,14111,7586,6525,2018-01-01,zipcode,Laredo
ZCTA5 78043,48,44838,35474,801,98000,31811,12981,24598,9038,7017,5380,2273,890,13797,12402,1395,12402,6961,5441,2018-01-01,zipcode,Laredo
ZCTA5 78044,48,456,41750,-666666666,-666666666,370,216,350,176,107,33,23,11,318,116,202,116,76,40,2018-01-01,zipcode,Laredo
ZCTA5 78045,48,65982,68957,1162,168500,46492,14061,36972,5334,7979,10486,9287,3886,19761,18703,1058,18703,14247,4456,2018-01-01,zipcode,Laredo
ZCTA5 78046,48,70320,35910,832,90400,45732,20236,34749,15298,10480,6562,2027,382,17599,16145,1454,16145,11661,4484,2018-01-01,zipcode,Laredo
ZCTA5 78050,48,444,40644,-666666666,142000,316,172,290,201,72,17,0,0,177,155,22,155,91,64,2018-01-01,zipcode,Leming
ZCTA5 78052,48,7362,59519,759,98900,5667,2264,4716,747,1944,1360,372,293,2295,2090,205,2090,1632,458,2018-01-01,zipcode,Lytle
ZCTA5 78055,48,1817,41068,635,177500,1397,907,1224,175,519,263,179,88,1044,573,471,573,454,119,2018-01-01,zipcode,Medina
ZCTA5 78056,48,1936,109653,-666666666,378100,1539,819,1481,14,228,478,435,326,881,680,201,680,589,91,2018-01-01,zipcode,Mico
ZCTA5 78057,48,588,33875,-666666666,153000,540,188,464,74,94,204,55,37,362,282,80,282,261,21,2018-01-01,zipcode,Moore
ZCTA5 78058,48,1121,86806,475,306400,1028,423,919,149,139,327,133,171,824,450,374,450,387,63,2018-01-01,zipcode,Mountain home
ZCTA5 78059,48,5910,69113,791,151500,4864,2124,4068,807,1388,1141,508,224,2379,1924,455,1924,1765,159,2018-01-01,zipcode,Natalia
ZCTA5 78060,48,115,-666666666,-666666666,-666666666,115,0,115,0,31,0,0,84,56,31,25,31,31,0,2018-01-01,zipcode,Oakville
ZCTA5 78061,48,13034,43153,644,76700,10194,5190,8285,2891,2954,1887,452,101,3973,3181,792,3181,2162,1019,2018-01-01,zipcode,Pearsall
ZCTA5 78063,48,9591,54103,876,164800,8054,3357,7354,811,1811,2889,1232,611,4942,3646,1296,3646,3206,440,2018-01-01,zipcode,Pipe creek
ZCTA5 78064,48,16043,68136,931,150000,11890,4673,10202,1538,3867,2711,1479,607,6195,5398,797,5398,3885,1513,2018-01-01,zipcode,Pleasanton
ZCTA5 78065,48,10735,50562,700,84800,8173,3233,6868,1735,2996,1467,491,179,3941,3274,667,3274,2426,848,2018-01-01,zipcode,Poteet
ZCTA5 78066,48,640,63494,-666666666,258000,423,139,255,0,84,47,102,22,224,202,22,202,119,83,2018-01-01,zipcode,Rio medina
ZCTA5 78067,48,648,-666666666,-666666666,103500,508,236,485,184,168,54,18,61,401,207,194,207,184,23,2018-01-01,zipcode,San ygnacio
ZCTA5 78069,48,6376,48702,691,89600,4754,1803,3788,910,1268,1224,263,123,1961,1715,246,1715,1438,277,2018-01-01,zipcode,Somerset
ZCTA5 78070,48,16241,81712,1250,291500,13371,5483,11690,827,2941,4260,2322,1340,6313,5687,626,5687,5164,523,2018-01-01,zipcode,Spring branch
ZCTA5 78071,48,4437,42885,710,104000,3584,2198,3176,630,1358,942,170,76,1657,1062,595,1062,799,263,2018-01-01,zipcode,Three rivers
ZCTA5 78072,48,468,70833,831,100900,370,160,351,21,136,89,39,66,281,160,121,160,126,34,2018-01-01,zipcode,Tilden
ZCTA5 78073,48,8893,46919,771,78900,6550,2677,5364,1777,1948,1301,206,132,2497,2221,276,2221,1619,602,2018-01-01,zipcode,Von ormy
ZCTA5 78075,48,206,-666666666,-666666666,111900,176,14,76,0,38,31,7,0,72,59,13,59,41,18,2018-01-01,zipcode,Whitsett
ZCTA5 78076,48,13184,30259,487,69300,9216,4018,7286,2826,2158,1555,564,183,5736,4049,1687,4049,2841,1208,2018-01-01,zipcode,Zapata
ZCTA5 78101,48,6175,79000,938,214400,5408,2048,4693,597,1752,1268,579,497,2478,2214,264,2214,2028,186,2018-01-01,zipcode,Adkins
ZCTA5 78102,48,28662,41072,909,92400,23251,14502,19480,5253,6763,5575,1132,757,8815,7209,1606,7209,4377,2832,2018-01-01,zipcode,Beeville
ZCTA5 78104,48,69,65278,-666666666,-666666666,69,24,62,0,47,12,3,0,51,38,13,38,29,9,2018-01-01,zipcode,Beeville
ZCTA5 78107,48,409,-666666666,-666666666,-666666666,272,125,244,77,112,55,0,0,195,166,29,166,79,87,2018-01-01,zipcode,Berclair
ZCTA5 78108,48,37359,94670,1711,213100,27680,9417,22869,1055,4984,8227,4915,3688,12110,11655,455,11655,9517,2138,2018-01-01,zipcode,Cibolo
ZCTA5 78109,48,40011,68613,1216,148300,29052,9761,23606,2257,6018,9808,3291,2232,12615,11721,894,11721,8394,3327,2018-01-01,zipcode,Converse
ZCTA5 78112,48,8505,51910,1003,84100,6092,2376,5144,1341,1850,1571,318,64,2370,2170,200,2170,1850,320,2018-01-01,zipcode,Elmendorf
ZCTA5 78113,48,3029,70000,925,163100,2314,839,2004,195,822,504,415,68,1247,1106,141,1106,839,267,2018-01-01,zipcode,Falls city
ZCTA5 78114,48,23091,68044,851,156200,18155,7590,15498,2533,5854,4556,1555,1000,8200,7451,749,7451,5825,1626,2018-01-01,zipcode,Floresville
ZCTA5 78116,48,281,-666666666,-666666666,217600,233,143,211,30,109,36,22,14,187,88,99,88,88,0,2018-01-01,zipcode,Gillett
ZCTA5 78117,48,408,71719,740,208900,399,212,353,28,132,117,68,8,299,207,92,207,175,32,2018-01-01,zipcode,Hobson
ZCTA5 78118,48,4057,45655,808,88000,3134,1695,2702,676,1033,533,344,116,1519,1079,440,1079,767,312,2018-01-01,zipcode,Karnes city
ZCTA5 78119,48,7672,47838,623,88800,6401,3881,5260,1522,1816,1362,437,123,2723,1854,869,1854,1349,505,2018-01-01,zipcode,Kenedy
ZCTA5 78121,48,13078,90196,1048,253500,10166,3723,8696,729,2549,2781,1905,732,4669,4327,342,4327,3908,419,2018-01-01,zipcode,La vernia
ZCTA5 78122,48,384,51620,-666666666,135600,348,143,330,143,106,31,16,34,249,185,64,185,151,34,2018-01-01,zipcode,Leesville
ZCTA5 78123,48,2412,53656,866,147100,1983,798,1783,345,563,509,285,81,1408,1101,307,1101,761,340,2018-01-01,zipcode,Mc queeney
ZCTA5 78124,48,6353,71250,972,169800,5217,2142,4715,553,1775,1533,591,263,2329,2248,81,2248,1881,367,2018-01-01,zipcode,Marion
ZCTA5 78125,48,78,57500,-666666666,-666666666,75,38,66,18,4,23,4,17,74,34,40,34,26,8,2018-01-01,zipcode,Mineral
ZCTA5 78130,48,74172,62813,1124,188400,57337,19669,49324,5115,14711,15403,9952,4143,29561,26343,3218,26343,16802,9541,2018-01-01,zipcode,New braunfels
ZCTA5 78132,48,28620,101443,1097,355200,22706,9365,19591,789,4209,5476,5968,3149,10506,9812,694,9812,8435,1377,2018-01-01,zipcode,New braunfels
ZCTA5 78133,48,18398,62637,986,216100,15503,7143,13898,1126,4201,4650,2471,1450,9976,7385,2591,7385,5998,1387,2018-01-01,zipcode,Canyon lake
ZCTA5 78140,48,3936,54447,832,75700,2909,1041,2313,738,1039,393,100,43,1468,1229,239,1229,795,434,2018-01-01,zipcode,Nixon
ZCTA5 78141,48,485,55278,725,90500,415,215,365,79,132,104,41,9,367,202,165,202,171,31,2018-01-01,zipcode,Nordheim
ZCTA5 78142,48,154,117031,-666666666,75000,127,46,101,23,33,14,7,24,74,45,29,45,31,14,2018-01-01,zipcode,Normanna
ZCTA5 78143,48,249,29427,-666666666,68100,125,94,81,43,0,38,0,0,39,39,0,39,39,0,2018-01-01,zipcode,Pandora
ZCTA5 78144,48,43,25521,-666666666,-666666666,43,31,43,0,12,19,0,12,43,43,0,43,19,24,2018-01-01,zipcode,Panna maria
ZCTA5 78145,48,145,65313,-666666666,116700,101,40,91,17,39,35,0,0,59,53,6,53,34,19,2018-01-01,zipcode,Pawnee
ZCTA5 78146,48,525,44583,815,65000,442,232,358,35,126,164,33,0,243,163,80,163,105,58,2018-01-01,zipcode,Pettus
ZCTA5 78147,48,2151,70556,764,148800,1613,480,1275,199,482,356,163,75,749,658,91,658,456,202,2018-01-01,zipcode,Poth
ZCTA5 78148,48,21750,63043,965,166000,16998,6363,14481,1147,3483,5595,2569,1687,8444,7860,584,7860,4469,3391,2018-01-01,zipcode,Universal city
ZCTA5 78150,48,27,-666666666,-666666666,-666666666,27,0,13,0,0,13,0,0,0,0,0,0,0,0,2018-01-01,zipcode,Jbsa randolph
ZCTA5 78151,48,1538,56607,668,104900,1244,560,1042,190,407,318,75,52,668,495,173,495,356,139,2018-01-01,zipcode,Runge
ZCTA5 78152,48,2174,85375,1098,201200,1761,628,1540,66,650,458,263,103,756,657,99,657,607,50,2018-01-01,zipcode,Saint hedwig
ZCTA5 78154,48,40085,77985,1265,192700,30370,10125,26113,1702,6277,8390,6091,3653,14436,13825,611,13825,9745,4080,2018-01-01,zipcode,Schertz
ZCTA5 78155,48,48863,55679,849,144000,38894,15379,32602,5243,12524,8677,4345,1813,19528,17460,2068,17460,12558,4902,2018-01-01,zipcode,Seguin
ZCTA5 78159,48,1122,62828,471,63900,852,402,671,154,257,207,45,8,465,368,97,368,289,79,2018-01-01,zipcode,Smiley
ZCTA5 78160,48,4786,58813,884,142900,3747,1596,3306,444,1266,1070,335,191,2010,1671,339,1671,1334,337,2018-01-01,zipcode,Stockdale
ZCTA5 78161,48,712,40230,-666666666,96100,559,235,449,16,185,162,47,39,336,301,35,301,272,29,2018-01-01,zipcode,Sutherland springs
ZCTA5 78162,48,404,34779,2589,76000,314,138,275,52,101,77,45,0,190,113,77,113,90,23,2018-01-01,zipcode,Tuleta
ZCTA5 78163,48,11106,121528,1083,348500,8685,3631,7593,456,1893,2303,1964,977,3969,3738,231,3738,3525,213,2018-01-01,zipcode,Bulverde
ZCTA5 78164,48,3287,44487,695,115800,2749,1325,2525,460,921,724,267,153,2082,1362,720,1362,1168,194,2018-01-01,zipcode,Yorktown
ZCTA5 78201,48,46775,35285,786,99000,37332,15022,30855,8868,9298,7687,3138,1864,18256,16314,1942,16314,7757,8557,2018-01-01,zipcode,San antonio
ZCTA5 78202,48,11433,25300,804,73000,8593,4210,7259,2512,2211,1673,462,401,4506,3848,658,3848,1886,1962,2018-01-01,zipcode,San antonio
ZCTA5 78203,48,6403,30744,775,64500,4750,1943,4027,1385,1178,944,307,213,2297,1976,321,1976,948,1028,2018-01-01,zipcode,San antonio
ZCTA5 78204,48,12211,38784,858,85700,10145,3822,8635,1918,2873,2260,1009,575,4880,4279,601,4279,2440,1839,2018-01-01,zipcode,San antonio
ZCTA5 78205,48,1224,31434,591,360100,1163,480,1070,123,177,317,174,279,1508,949,559,949,149,800,2018-01-01,zipcode,San antonio
ZCTA5 78207,48,54601,25415,663,57700,40027,19285,33328,15582,10002,5798,1426,520,17393,15351,2042,15351,7274,8077,2018-01-01,zipcode,San antonio
ZCTA5 78208,48,5031,28049,755,80100,3701,1915,3235,1218,986,800,148,83,1945,1552,393,1552,539,1013,2018-01-01,zipcode,San antonio
ZCTA5 78209,48,42045,72266,1096,346800,34088,12510,29222,1763,3461,6668,9912,7418,19995,17823,2172,17823,10239,7584,2018-01-01,zipcode,San antonio
ZCTA5 78210,48,36723,36316,788,87900,28496,11538,24530,7295,7851,6474,1869,1041,13995,12469,1526,12469,6700,5769,2018-01-01,zipcode,San antonio
ZCTA5 78211,48,32568,36983,834,67800,25014,9948,20120,8053,6827,4083,796,361,10038,9157,881,9157,5890,3267,2018-01-01,zipcode,San antonio
ZCTA5 78212,48,29225,45903,817,157900,24905,9829,20080,3816,4729,4776,3911,2848,12631,10805,1826,10805,5150,5655,2018-01-01,zipcode,San antonio
ZCTA5 78213,48,43931,44347,893,121900,34917,12257,28503,5575,7356,9226,4057,2289,17409,16098,1311,16098,7803,8295,2018-01-01,zipcode,San antonio
ZCTA5 78214,48,26946,35715,759,74000,20202,8882,16237,5330,5797,3999,845,266,8106,7609,497,7609,4380,3229,2018-01-01,zipcode,San antonio
ZCTA5 78215,48,2974,64836,1387,346900,2773,462,2367,112,225,510,945,575,2017,1783,234,1783,96,1687,2018-01-01,zipcode,San antonio
ZCTA5 78216,48,41765,47944,942,179900,33601,9687,28124,3130,6924,8329,6364,3377,19700,17177,2523,17177,6266,10911,2018-01-01,zipcode,San antonio
ZCTA5 78217,48,33960,46028,925,135400,26814,8632,22637,2560,6479,8475,3378,1745,15133,13786,1347,13786,5721,8065,2018-01-01,zipcode,San antonio
ZCTA5 78218,48,36359,40921,901,105100,28052,10441,22936,4059,5900,8216,3265,1496,13894,12458,1436,12458,5962,6496,2018-01-01,zipcode,San antonio
ZCTA5 78219,48,16897,35847,946,84600,12659,5249,10551,1554,3094,4447,1129,327,6120,5785,335,5785,2760,3025,2018-01-01,zipcode,San antonio
ZCTA5 78220,48,16348,29524,870,71900,12321,6048,10495,3023,3657,2673,833,309,6057,5381,676,5381,3011,2370,2018-01-01,zipcode,San antonio
ZCTA5 78221,48,39523,40029,813,82400,30138,11621,25229,7749,9177,6352,1427,524,12535,11535,1000,11535,6915,4620,2018-01-01,zipcode,San antonio
ZCTA5 78222,48,25574,51544,893,111900,18624,7155,15654,3081,5373,5302,1366,532,8153,7472,681,7472,5303,2169,2018-01-01,zipcode,San antonio
ZCTA5 78223,48,55088,40434,831,91100,41460,15768,34657,7708,12269,10598,3221,861,19502,17808,1694,17808,10422,7386,2018-01-01,zipcode,San antonio
ZCTA5 78224,48,20795,45145,926,89500,15377,5750,12438,3096,4104,4107,809,322,6022,5692,330,5692,3433,2259,2018-01-01,zipcode,San antonio
ZCTA5 78225,48,13915,32405,797,68500,10463,4490,8919,2689,3381,2227,499,123,4631,4174,457,4174,2860,1314,2018-01-01,zipcode,San antonio
ZCTA5 78226,48,7109,30228,698,68900,5555,2592,4840,1771,1581,1206,158,124,2992,2457,535,2457,984,1473,2018-01-01,zipcode,San antonio
ZCTA5 78227,48,49907,40294,869,87200,36287,14788,30072,8532,9957,9274,1677,632,15655,14396,1259,14396,7629,6767,2018-01-01,zipcode,San antonio
ZCTA5 78228,48,62126,40779,824,91500,48712,21082,39574,11805,13056,10193,3282,1238,20040,18437,1603,18437,10868,7569,2018-01-01,zipcode,San antonio
ZCTA5 78229,48,31771,38332,930,150300,26078,8207,22099,2338,5741,7385,4077,2558,16097,13932,2165,13932,2356,11576,2018-01-01,zipcode,San antonio
ZCTA5 78230,48,45369,61030,994,218600,36820,12228,31271,1793,5305,8542,9599,6032,20300,18638,1662,18638,9102,9536,2018-01-01,zipcode,San antonio
ZCTA5 78231,48,8536,89683,1180,276500,7080,2594,6355,282,729,1656,1962,1726,3489,3304,185,3304,2367,937,2018-01-01,zipcode,San antonio
ZCTA5 78232,48,37732,73043,1140,234000,31115,9978,26703,1009,4051,8614,7767,5262,16054,15536,518,15536,8960,6576,2018-01-01,zipcode,San antonio
ZCTA5 78233,48,48507,56155,1081,130300,37479,12811,31709,3029,10602,11896,4414,1768,17714,16920,794,16920,9677,7243,2018-01-01,zipcode,San antonio
ZCTA5 78234,48,5430,66767,1732,-666666666,3416,818,2021,90,172,1012,489,258,990,953,37,953,57,896,2018-01-01,zipcode,Jbsa ft sam houston
ZCTA5 78235,48,1176,44896,1201,-666666666,973,275,827,108,233,371,54,61,554,531,23,531,0,531,2018-01-01,zipcode,San antonio
ZCTA5 78236,48,6882,76771,1750,-666666666,6016,468,1510,25,113,735,512,125,471,402,69,402,0,402,2018-01-01,zipcode,Jbsa lackland
ZCTA5 78237,48,39349,30003,806,61300,29783,13796,25058,10990,8344,4734,798,192,11831,11073,758,11073,7099,3974,2018-01-01,zipcode,San antonio
ZCTA5 78238,48,25052,48967,994,130500,19329,6661,16311,2186,5170,5821,2330,804,9844,8974,870,8974,4147,4827,2018-01-01,zipcode,San antonio
ZCTA5 78239,48,29255,60313,1156,133900,23115,9126,19416,2518,5400,6934,3012,1552,10040,9020,1020,9020,6539,2481,2018-01-01,zipcode,San antonio
ZCTA5 78240,48,59502,54430,1006,163400,47462,15448,39613,3071,7535,13070,10130,5807,26129,23610,2519,23610,8391,15219,2018-01-01,zipcode,San antonio
ZCTA5 78242,48,34844,42298,880,76000,24555,8951,18768,6976,6054,4253,1136,349,9671,8855,816,8855,4981,3874,2018-01-01,zipcode,San antonio
ZCTA5 78243,48,424,-666666666,-666666666,-666666666,424,0,136,0,10,75,51,0,0,0,0,0,0,0,2018-01-01,zipcode,San antonio
ZCTA5 78244,48,32474,61457,1219,121300,24408,7701,20037,2733,5249,7996,2953,1106,10145,9422,723,9422,6561,2861,2018-01-01,zipcode,San antonio
ZCTA5 78245,48,76177,67013,1163,148900,55018,16907,44278,5946,12173,16448,6649,3062,23072,21675,1397,21675,14880,6795,2018-01-01,zipcode,San antonio
ZCTA5 78247,48,53315,77811,1228,169800,41509,12185,35739,2334,8930,13075,7596,3804,18500,17408,1092,17408,13298,4110,2018-01-01,zipcode,San antonio
ZCTA5 78248,48,14369,112072,1306,320300,11597,4117,9975,116,1054,2844,3331,2630,5801,5539,262,5539,4308,1231,2018-01-01,zipcode,San antonio
ZCTA5 78249,48,59508,64657,1196,188900,50481,14589,33946,1818,4753,12176,9941,5258,21608,20073,1535,20073,11050,9023,2018-01-01,zipcode,San antonio
ZCTA5 78250,48,60967,68658,1172,143700,47296,14060,39597,3202,9752,15327,8180,3136,19267,18794,473,18794,14269,4525,2018-01-01,zipcode,San antonio
ZCTA5 78251,48,60107,65233,1099,161800,46229,12479,38445,3057,9036,15284,7201,3867,21281,20144,1137,20144,11026,9118,2018-01-01,zipcode,San antonio
ZCTA5 78252,48,12153,58474,1227,118700,8816,4105,7455,1881,1816,2708,802,248,2817,2743,74,2743,2028,715,2018-01-01,zipcode,San antonio
ZCTA5 78253,48,44036,99500,1381,234900,31194,8802,26609,1293,4874,9604,6248,4590,13741,12812,929,12812,10359,2453,2018-01-01,zipcode,San antonio
ZCTA5 78254,48,58540,84447,1262,187300,42038,11722,35030,2362,6883,12335,8958,4492,17610,17020,590,17020,13622,3398,2018-01-01,zipcode,San antonio
ZCTA5 78255,48,14703,125550,1447,312100,10592,3398,9233,313,1252,2597,2736,2335,4645,4360,285,4360,3822,538,2018-01-01,zipcode,San antonio
ZCTA5 78256,48,11464,101368,1297,412100,9354,2251,6367,151,345,1821,2313,1737,4867,4114,753,4114,1672,2442,2018-01-01,zipcode,San antonio
ZCTA5 78257,48,6521,118190,1188,588400,5161,1886,4487,126,426,1030,1606,1299,3261,2754,507,2754,1537,1217,2018-01-01,zipcode,San antonio
ZCTA5 78258,48,46418,102425,1379,320700,35126,12737,29739,1047,3034,7626,10842,7190,17201,16079,1122,16079,10707,5372,2018-01-01,zipcode,San antonio
ZCTA5 78259,48,26508,96233,1294,257500,20444,6586,17749,546,2732,5189,5374,3908,9735,9101,634,9101,6540,2561,2018-01-01,zipcode,San antonio
ZCTA5 78260,48,27696,115069,1769,312500,20054,6248,17437,711,2361,5086,5565,3714,9060,8692,368,8692,7865,827,2018-01-01,zipcode,San antonio
ZCTA5 78261,48,17127,92442,1468,288800,12482,3644,10653,349,1568,3283,3387,2066,6119,5735,384,5735,4713,1022,2018-01-01,zipcode,San antonio
ZCTA5 78263,48,5208,70985,869,175200,4535,1425,3780,303,1460,1270,467,280,1710,1620,90,1620,1444,176,2018-01-01,zipcode,San antonio
ZCTA5 78264,48,11174,49571,877,84900,8341,3538,6601,1803,2260,1908,481,149,3542,3089,453,3089,2551,538,2018-01-01,zipcode,San antonio
ZCTA5 78266,48,6633,119529,1921,378200,5166,2329,4562,123,631,910,1540,1358,2391,2304,87,2304,2201,103,2018-01-01,zipcode,San antonio
ZCTA5 78330,48,899,43077,985,80000,651,319,570,107,221,142,61,39,342,318,24,318,262,56,2018-01-01,zipcode,Agua dulce
ZCTA5 78332,48,28953,40827,720,75700,21677,9502,18055,4542,6593,4564,1840,516,11082,9349,1733,9349,6089,3260,2018-01-01,zipcode,Alice
ZCTA5 78335,48,0,-666666666,-666666666,-666666666,0,0,0,0,0,0,0,0,0,0,0,0,0,0,2018-01-01,zipcode,Aransas pass
ZCTA5 78336,48,11436,45574,942,127300,8987,4049,7543,1869,2837,2069,523,245,6052,4213,1839,4213,2477,1736,2018-01-01,zipcode,Aransas pass
ZCTA5 78338,48,51,53125,-666666666,-666666666,27,7,27,7,8,0,0,12,19,16,3,16,5,11,2018-01-01,zipcode,Armstrong
ZCTA5 78339,48,330,51776,-666666666,64100,310,122,255,75,98,55,27,0,258,163,95,163,127,36,2018-01-01,zipcode,Banquete
ZCTA5 78340,48,440,52500,675,85900,374,191,336,31,123,111,39,32,353,188,165,188,164,24,2018-01-01,zipcode,Bayside
ZCTA5 78341,48,2107,32614,477,41400,1662,736,1368,287,427,417,122,115,1365,808,557,808,560,248,2018-01-01,zipcode,Benavides
ZCTA5 78342,48,427,40446,839,29700,336,133,264,89,60,91,11,13,144,132,12,132,79,53,2018-01-01,zipcode,Ben bolt
ZCTA5 78343,48,4278,45417,749,83400,3389,1466,2768,652,871,857,300,88,1890,1486,404,1486,1100,386,2018-01-01,zipcode,Bishop
ZCTA5 78344,48,353,57596,-666666666,95300,289,149,237,30,125,34,43,5,202,123,79,123,88,35,2018-01-01,zipcode,Bruni
ZCTA5 78349,48,603,47578,-666666666,62400,479,279,396,88,159,132,17,0,333,177,156,177,170,7,2018-01-01,zipcode,Concepcion
ZCTA5 78351,48,366,30156,838,33800,275,164,214,103,66,18,27,0,202,125,77,125,89,36,2018-01-01,zipcode,Driscoll
ZCTA5 78352,48,487,32216,-666666666,32100,287,148,251,80,123,48,0,0,135,111,24,111,111,0,2018-01-01,zipcode,Edroy
ZCTA5 78353,48,274,31029,-666666666,63200,265,166,240,119,65,56,0,0,299,140,159,140,116,24,2018-01-01,zipcode,Encino
ZCTA5 78355,48,7156,27813,626,65300,5474,2600,4079,1154,1150,1020,498,257,2848,1992,856,1992,1231,761,2018-01-01,zipcode,Falfurrias
ZCTA5 78357,48,2867,46518,722,57100,2042,730,1633,348,659,502,112,12,1262,869,393,869,533,336,2018-01-01,zipcode,Freer
ZCTA5 78358,48,561,32031,921,61700,517,323,493,92,148,149,75,29,377,274,103,274,171,103,2018-01-01,zipcode,Fulton
ZCTA5 78359,48,2065,49911,822,61000,1605,594,1263,337,501,331,69,25,761,645,116,645,423,222,2018-01-01,zipcode,Gregory
ZCTA5 78361,48,5386,32483,496,67900,3913,1900,3252,812,1183,843,272,142,2630,1735,895,1735,1262,473,2018-01-01,zipcode,Hebbronville
ZCTA5 78362,48,10184,62978,1138,136900,7888,2909,6390,1007,2423,2083,609,268,4126,3641,485,3641,2578,1063,2018-01-01,zipcode,Ingleside
ZCTA5 78363,48,29949,41333,821,88400,23510,9196,16290,3344,4092,4795,2850,1209,12512,10459,2053,10459,5290,5169,2018-01-01,zipcode,Kingsville
ZCTA5 78368,48,9725,42443,727,62600,7495,3347,6366,2047,1967,1882,335,135,4324,3242,1082,3242,2379,863,2018-01-01,zipcode,Mathis
ZCTA5 78369,48,393,21932,-666666666,41400,250,172,224,106,73,36,9,0,214,131,83,131,95,36,2018-01-01,zipcode,Mirando city
ZCTA5 78370,48,4846,54903,804,102000,3608,1539,3209,919,943,852,364,131,1895,1575,320,1575,1150,425,2018-01-01,zipcode,Odem
ZCTA5 78371,48,271,63487,648,75000,238,95,186,12,68,95,11,0,249,117,132,117,82,35,2018-01-01,zipcode,Oilton
ZCTA5 78372,48,6174,39496,906,92500,4019,2053,3185,810,1370,803,198,4,2208,1597,611,1597,1206,391,2018-01-01,zipcode,Orange grove
ZCTA5 78373,48,4174,54115,1077,308100,3781,1437,3204,104,892,995,777,436,4948,2023,2925,2023,1236,787,2018-01-01,zipcode,Port aransas
ZCTA5 78374,48,17885,70893,1256,163500,13467,4890,11529,939,3069,4398,2105,1018,6987,6197,790,6197,4231,1966,2018-01-01,zipcode,Portland
ZCTA5 78375,48,2956,46920,679,56700,2490,1103,2167,613,829,452,236,37,1216,907,309,907,720,187,2018-01-01,zipcode,Premont
ZCTA5 78376,48,655,44375,575,47200,535,302,485,212,203,50,20,0,393,224,169,224,138,86,2018-01-01,zipcode,Realitos
ZCTA5 78377,48,3712,51803,639,86900,2884,1322,2352,393,922,788,182,67,1727,1245,482,1245,837,408,2018-01-01,zipcode,Refugio
ZCTA5 78379,48,1471,55714,1077,70000,1223,518,968,254,258,232,143,81,759,482,277,482,398,84,2018-01-01,zipcode,Riviera
ZCTA5 78380,48,24438,47398,780,74000,18361,7691,15278,4138,4753,4425,1316,646,9122,7783,1339,7783,5410,2373,2018-01-01,zipcode,Robstown
ZCTA5 78382,48,21578,46406,871,165400,18047,8338,15986,2300,4632,5321,2263,1470,13840,8144,5696,8144,6591,1553,2018-01-01,zipcode,Rockport
ZCTA5 78383,48,3958,62692,636,122200,3406,1652,3233,536,933,1091,437,236,2674,1588,1086,1588,1458,130,2018-01-01,zipcode,Sandia
ZCTA5 78384,48,5622,26167,706,40500,4321,2259,3670,1536,927,898,185,124,2651,1670,981,1670,897,773,2018-01-01,zipcode,San diego
ZCTA5 78385,48,523,36458,525,27500,386,196,386,267,79,24,13,3,222,183,39,183,66,117,2018-01-01,zipcode,Sarita
ZCTA5 78387,48,9481,42500,661,66500,7072,2918,5804,1410,1963,1881,330,220,3924,3230,694,3230,2199,1031,2018-01-01,zipcode,Sinton
ZCTA5 78389,48,1641,35000,894,65800,1442,783,1096,262,458,273,83,20,696,538,158,538,449,89,2018-01-01,zipcode,Skidmore
ZCTA5 78390,48,5416,41915,753,78300,4249,1850,3437,907,1100,1137,209,84,2421,1895,526,1895,1239,656,2018-01-01,zipcode,Taft
ZCTA5 78391,48,244,49750,-666666666,53800,164,59,139,56,43,22,18,0,97,73,24,73,64,9,2018-01-01,zipcode,Tynan
ZCTA5 78393,48,2166,45573,852,76500,1760,807,1578,399,560,488,87,44,1107,817,290,817,615,202,2018-01-01,zipcode,Woodsboro
ZCTA5 78401,48,5402,27153,746,62600,4770,3188,4115,1253,1359,1128,254,121,2206,1740,466,1740,373,1367,2018-01-01,zipcode,Corpus christi
ZCTA5 78402,48,231,64338,1375,163900,231,128,220,25,44,69,45,37,348,137,211,137,64,73,2018-01-01,zipcode,Corpus christi
ZCTA5 78404,48,18376,42101,880,102000,14693,5975,12620,3106,3512,3006,1760,1236,8225,6990,1235,6990,3510,3480,2018-01-01,zipcode,Corpus christi
ZCTA5 78405,48,15326,27566,703,54400,12077,5377,10202,4587,3410,1834,277,94,5999,5293,706,5293,2757,2536,2018-01-01,zipcode,Corpus christi
ZCTA5 78406,48,2074,55396,1139,47100,1663,1158,1298,491,471,269,56,11,440,383,57,383,276,107,2018-01-01,zipcode,Corpus christi
ZCTA5 78407,48,3078,50433,917,62800,2347,932,1871,435,862,475,53,46,1314,1043,271,1043,552,491,2018-01-01,zipcode,Corpus christi
ZCTA5 78408,48,11787,36250,693,73700,8817,3541,7433,2604,2669,1734,198,228,4853,4271,582,4271,1920,2351,2018-01-01,zipcode,Corpus christi
ZCTA5 78409,48,2678,55754,590,78100,2006,625,1698,400,548,620,122,8,1133,967,166,967,512,455,2018-01-01,zipcode,Corpus christi
ZCTA5 78410,48,28065,71939,1067,150900,20951,7776,17734,2464,5105,6655,2369,1141,10448,9479,969,9479,6419,3060,2018-01-01,zipcode,Corpus christi
ZCTA5 78411,48,25999,59083,1004,116900,21270,7046,18270,2367,4633,6886,2660,1724,11267,10075,1192,10075,6030,4045,2018-01-01,zipcode,Corpus christi
ZCTA5 78412,48,40268,47196,1022,122500,31862,11635,23088,2263,6254,8188,4229,2154,16058,14775,1283,14775,6748,8027,2018-01-01,zipcode,Corpus christi
ZCTA5 78413,48,40778,73478,1137,172000,31945,9228,26443,1817,6810,9264,5646,2906,16388,15026,1362,15026,8343,6683,2018-01-01,zipcode,Corpus christi
ZCTA5 78414,48,39642,84199,1202,198300,29694,9260,25703,1410,5488,9380,5613,3812,15372,14416,956,14416,9235,5181,2018-01-01,zipcode,Corpus christi
ZCTA5 78415,48,40439,44975,945,96700,31273,11275,26003,6095,9278,7932,1880,818,14726,13442,1284,13442,7997,5445,2018-01-01,zipcode,Corpus christi
ZCTA5 78416,48,15635,39035,858,71600,11430,4929,9837,3844,3270,2244,392,87,5660,5091,569,5091,3044,2047,2018-01-01,zipcode,Corpus christi
ZCTA5 78417,48,4558,47661,708,90900,3402,1109,2781,906,976,632,233,34,1470,1328,142,1328,927,401,2018-01-01,zipcode,Corpus christi
ZCTA5 78418,48,30629,66590,1062,193700,24978,9102,21876,1960,5895,7812,3972,2237,15169,12273,2896,12273,7499,4774,2018-01-01,zipcode,Corpus christi
ZCTA5 78419,48,793,56563,1680,-666666666,601,125,345,4,84,125,115,17,172,161,11,161,0,161,2018-01-01,zipcode,Corpus christi
ZCTA5 78501,48,63554,36618,683,101900,48815,19926,40202,12150,7865,10036,7447,2704,23977,20913,3064,20913,10936,9977,2018-01-01,zipcode,Mcallen
ZCTA5 78503,48,22034,31915,852,95800,15831,7237,12975,4928,2698,1872,2496,981,7863,6390,1473,6390,4010,2380,2018-01-01,zipcode,Mcallen
ZCTA5 78504,48,56000,65211,868,148800,41352,13718,34084,4392,6380,10575,8300,4437,19596,17936,1660,17936,12369,5567,2018-01-01,zipcode,Mcallen
ZCTA5 78516,48,35097,34701,538,55700,23884,11194,18794,7582,5287,3987,1542,396,11649,9539,2110,9539,7184,2355,2018-01-01,zipcode,Alamo
ZCTA5 78520,48,62414,32355,637,85300,46175,21262,35702,12904,8604,7677,4727,1790,20121,17963,2158,17963,10852,7111,2018-01-01,zipcode,Brownsville
ZCTA5 78521,48,92108,30099,708,71400,65503,30496,50950,22057,12075,10587,4702,1529,28186,25264,2922,25264,14873,10391,2018-01-01,zipcode,Brownsville
ZCTA5 78526,48,46799,54587,853,109200,33756,13271,26330,7636,5381,6231,5488,1594,13783,12619,1164,12619,9236,3383,2018-01-01,zipcode,Brownsville
ZCTA5 78535,48,747,48029,820,60000,559,237,455,196,191,55,0,13,233,217,16,217,136,81,2018-01-01,zipcode,Combes
ZCTA5 78536,48,275,-666666666,-666666666,58900,228,80,194,80,54,40,20,0,140,93,47,93,80,13,2018-01-01,zipcode,Delmita
ZCTA5 78537,48,47346,28803,550,55000,32058,14925,24513,11472,5900,4833,1858,450,14719,12137,2582,12137,9321,2816,2018-01-01,zipcode,Donna
ZCTA5 78538,48,11524,32731,494,53700,8003,3684,6425,3033,1341,1416,558,77,3683,3091,592,3091,2306,785,2018-01-01,zipcode,Edcouch
ZCTA5 78539,48,35321,57784,767,137300,25577,8115,20483,3306,4134,5797,4132,3114,12421,11164,1257,11164,6432,4732,2018-01-01,zipcode,Edinburg
ZCTA5 78541,48,44680,34985,744,88600,31613,11788,24145,8026,5416,6003,3292,1408,14174,12817,1357,12817,6879,5938,2018-01-01,zipcode,Edinburg
ZCTA5 78542,48,75569,38609,619,78600,50953,22219,39038,15923,9561,8563,3925,1066,18757,16670,2087,16670,12762,3908,2018-01-01,zipcode,Edinburg
ZCTA5 78543,48,9118,31424,540,51300,6536,2903,5568,2013,2031,990,434,100,2848,2491,357,2491,1770,721,2018-01-01,zipcode,Elsa
ZCTA5 78545,48,572,-666666666,-666666666,37100,384,197,330,266,39,16,9,0,239,162,77,162,136,26,2018-01-01,zipcode,Falcon heights
ZCTA5 78548,48,727,-666666666,-666666666,51000,541,261,425,251,87,72,15,0,243,180,63,180,172,8,2018-01-01,zipcode,Grulla
ZCTA5 78549,48,861,15541,-666666666,48400,541,375,439,310,85,15,21,8,324,254,70,254,221,33,2018-01-01,zipcode,Hargill
ZCTA5 78550,48,52216,36948,716,78100,36988,15160,30542,8431,8815,8076,3393,1827,19136,16638,2498,16638,8652,7986,2018-01-01,zipcode,Harlingen
ZCTA5 78552,48,38553,48990,828,94500,28543,12566,24021,5744,6410,6992,3366,1509,14707,12117,2590,12117,9515,2602,2018-01-01,zipcode,Harlingen
ZCTA5 78557,48,14022,35191,638,91800,10134,4194,7661,3207,1452,1435,1366,201,3754,3523,231,3523,2590,933,2018-01-01,zipcode,Hidalgo
ZCTA5 78558,48,1000,49375,-666666666,77000,749,285,581,256,194,98,33,0,255,206,49,206,158,48,2018-01-01,zipcode,La blanca
ZCTA5 78559,48,12709,38179,617,62800,9468,4175,8147,2141,2359,2407,961,279,4633,3945,688,3945,2893,1052,2018-01-01,zipcode,La feria
ZCTA5 78560,48,5084,38500,686,81100,3550,1655,2885,1253,705,678,151,98,1482,1354,128,1354,890,464,2018-01-01,zipcode,La joya
ZCTA5 78561,48,688,36250,610,38100,530,222,384,162,121,91,10,0,201,175,26,175,132,43,2018-01-01,zipcode,Lasara
ZCTA5 78562,48,4163,31301,438,48900,3241,2109,2615,1391,731,355,138,0,912,793,119,793,600,193,2018-01-01,zipcode,La villa
ZCTA5 78563,48,190,42833,-666666666,93000,190,137,190,17,82,43,35,13,119,78,41,78,61,17,2018-01-01,zipcode,Linn
ZCTA5 78564,48,207,-666666666,-666666666,-666666666,90,22,90,66,13,11,0,0,59,45,14,45,0,45,2018-01-01,zipcode,Lopeno
ZCTA5 78565,48,112,-666666666,-666666666,-666666666,112,88,112,65,0,47,0,0,86,51,35,51,28,23,2018-01-01,zipcode,Los ebanos
ZCTA5 78566,48,18249,41132,741,99200,12833,5698,10081,2874,2651,2652,1387,517,5641,4881,760,4881,3548,1333,2018-01-01,zipcode,Los fresnos
ZCTA5 78567,48,495,30278,-666666666,47200,382,165,365,138,120,76,11,20,198,156,42,156,142,14,2018-01-01,zipcode,Los indios
ZCTA5 78569,48,4092,41250,611,65600,3199,1646,2758,736,1047,555,297,123,1455,1233,222,1233,1045,188,2018-01-01,zipcode,Lyford
ZCTA5 78570,48,34608,33390,570,59500,23511,10384,18818,7329,4574,4822,1407,686,10738,9060,1678,9060,6541,2519,2018-01-01,zipcode,Mercedes
ZCTA5 78572,48,80213,41906,757,88900,57416,26640,46934,15036,11749,10267,7119,2763,30049,24134,5915,24134,16812,7322,2018-01-01,zipcode,Mission
ZCTA5 78573,48,38839,34061,709,87100,26597,10005,19900,8340,4746,4106,1820,888,11043,9920,1123,9920,6680,3240,2018-01-01,zipcode,Mission
ZCTA5 78574,48,62040,34949,713,77500,42206,16974,32275,14692,6852,6176,3343,1212,17378,15443,1935,15443,11867,3576,2018-01-01,zipcode,Mission
ZCTA5 78575,48,12490,58239,841,123700,8659,3569,7151,1463,1302,2214,1288,884,4004,3445,559,3445,2669,776,2018-01-01,zipcode,Olmito
ZCTA5 78576,48,10971,20954,653,61600,6336,2929,4542,2411,1395,505,182,49,3152,2717,435,2717,2036,681,2018-01-01,zipcode,Penitas
ZCTA5 78577,48,77835,39372,750,77600,53349,22538,42818,15606,10793,9986,4837,1596,24650,21609,3041,21609,13211,8398,2018-01-01,zipcode,Pharr
ZCTA5 78578,48,11677,33982,705,127900,9056,4675,8116,2157,2709,1841,966,443,6849,4233,2616,4233,2860,1373,2018-01-01,zipcode,Port isabel
ZCTA5 78579,48,5642,44427,648,57500,4289,1691,3270,1478,771,626,259,136,1426,1293,133,1293,1077,216,2018-01-01,zipcode,Progreso
ZCTA5 78580,48,14719,28040,588,58000,11515,5992,9051,3254,3312,1656,661,168,4425,3726,699,3726,2560,1166,2018-01-01,zipcode,Raymondville
ZCTA5 78582,48,42582,31880,533,68700,29848,12410,23118,10767,5962,3976,1642,771,12816,10702,2114,10702,7968,2734,2018-01-01,zipcode,Rio grande city
ZCTA5 78583,48,7322,35641,486,70100,5651,2905,5011,1292,1600,1383,470,266,3893,2635,1258,2635,2218,417,2018-01-01,zipcode,Rio hondo
ZCTA5 78584,48,19270,23396,557,69700,13761,6520,10919,5798,2577,1381,864,299,6048,4955,1093,4955,3518,1437,2018-01-01,zipcode,Roma
ZCTA5 78585,48,291,-666666666,-666666666,-666666666,217,111,182,92,35,44,0,11,172,94,78,94,94,0,2018-01-01,zipcode,Salineno
ZCTA5 78586,48,56284,31506,651,59700,40646,19394,32419,12051,9463,7130,2430,1345,18510,15758,2752,15758,12230,3528,2018-01-01,zipcode,San benito
ZCTA5 78588,48,204,39219,-666666666,-666666666,167,52,141,28,31,75,3,4,91,57,34,57,41,16,2018-01-01,zipcode,San isidro
ZCTA5 78589,48,41628,36213,685,83000,29462,12656,23144,9815,5279,4980,2270,800,11764,10768,996,10768,8362,2406,2018-01-01,zipcode,San juan
ZCTA5 78590,48,366,39583,-666666666,33600,253,100,217,91,78,36,12,0,109,82,27,82,82,0,2018-01-01,zipcode,San perlita
ZCTA5 78591,48,303,51250,-666666666,-666666666,253,155,234,16,84,105,25,4,146,99,47,99,78,21,2018-01-01,zipcode,Santa elena
ZCTA5 78592,48,840,30391,583,36100,590,284,466,224,139,76,27,0,299,259,40,259,196,63,2018-01-01,zipcode,Santa maria
ZCTA5 78593,48,6008,30909,614,56700,4452,2143,3340,1067,1461,573,199,40,1759,1528,231,1528,1060,468,2018-01-01,zipcode,Santa rosa
ZCTA5 78594,48,1815,27629,-666666666,46500,1362,701,1095,387,371,264,53,20,707,552,155,552,474,78,2018-01-01,zipcode,Sebastian
ZCTA5 78595,48,6053,26795,545,58200,4136,1828,3116,1792,787,389,112,36,1965,1707,258,1707,1334,373,2018-01-01,zipcode,Sullivan city
ZCTA5 78596,48,65885,40039,681,78300,47113,19746,37726,12208,9039,9903,4612,1964,23357,18821,4536,18821,13530,5291,2018-01-01,zipcode,Weslaco
ZCTA5 78597,48,2839,41894,1075,304900,2529,976,2436,190,453,853,443,497,7604,1527,6077,1527,1030,497,2018-01-01,zipcode,South padre island
ZCTA5 78598,48,88,-666666666,-666666666,117700,88,32,88,0,35,26,2,25,403,45,358,45,45,0,2018-01-01,zipcode,Port mansfield
ZCTA5 78602,48,27958,63160,936,173000,22483,10908,19475,2873,6009,5843,2976,1774,10271,8931,1340,8931,6787,2144,2018-01-01,zipcode,Bastrop
ZCTA5 78605,48,6110,62650,763,152500,4918,2058,3935,555,1465,1199,491,225,2290,1991,299,1991,1674,317,2018-01-01,zipcode,Bertram
ZCTA5 78606,48,5460,51676,825,228600,4491,1889,3992,444,1004,1422,782,340,2762,2029,733,2029,1618,411,2018-01-01,zipcode,Blanco
ZCTA5 78607,48,41,-666666666,-666666666,-666666666,41,31,41,0,34,0,7,0,182,32,150,32,24,8,2018-01-01,zipcode,Bluffton
ZCTA5 78608,48,443,110536,-666666666,206400,392,144,338,42,125,83,88,0,296,192,104,192,118,74,2018-01-01,zipcode,Briggs
ZCTA5 78609,48,2044,47708,765,129500,1812,971,1681,155,549,646,226,105,1631,877,754,877,679,198,2018-01-01,zipcode,Buchanan dam
ZCTA5 78610,48,35142,79318,1238,241500,26500,7385,22666,1718,5497,6704,6014,2733,12464,12084,380,12084,9203,2881,2018-01-01,zipcode,Buda
ZCTA5 78611,48,13313,57390,746,167100,10816,4570,9721,1109,3057,3409,1470,676,6492,4743,1749,4743,3473,1270,2018-01-01,zipcode,Burnet
ZCTA5 78612,48,13852,70795,1214,157300,9770,4134,8299,1392,2058,3083,1272,494,4273,3919,354,3919,3299,620,2018-01-01,zipcode,Cedar creek
ZCTA5 78613,48,79699,101832,1355,275900,59123,16382,51100,2065,7947,15920,17266,7902,27616,26122,1494,26122,18193,7929,2018-01-01,zipcode,Cedar park
ZCTA5 78614,48,577,59485,918,173100,470,179,445,47,179,138,73,8,280,237,43,237,184,53,2018-01-01,zipcode,Cost
ZCTA5 78615,48,1229,47500,947,170000,903,404,796,93,277,243,73,110,463,398,65,398,314,84,2018-01-01,zipcode,Coupland
ZCTA5 78616,48,8285,53220,1010,119400,5942,1964,4927,1493,1551,1419,342,122,2764,2468,296,2468,1775,693,2018-01-01,zipcode,Dale
ZCTA5 78617,48,28558,54940,1229,137400,20842,7321,16279,5512,5371,3715,1360,321,7211,6501,710,6501,4986,1515,2018-01-01,zipcode,Del valle
ZCTA5 78618,48,331,60625,940,313500,300,144,281,2,131,81,41,26,305,127,178,127,112,15,2018-01-01,zipcode,Doss
ZCTA5 78619,48,4476,131613,1537,465500,3361,1060,3087,164,498,758,989,678,1636,1556,80,1556,1440,116,2018-01-01,zipcode,Driftwood
ZCTA5 78620,48,16882,101236,1188,382900,13122,4596,11269,656,1881,2959,3875,1898,6242,5805,437,5805,5014,791,2018-01-01,zipcode,Dripping springs
ZCTA5 78621,48,23496,62862,891,156100,17367,5948,15225,3671,4221,4749,1931,653,7782,6957,825,6957,5235,1722,2018-01-01,zipcode,Elgin
ZCTA5 78622,48,195,39844,-666666666,50000,177,50,163,53,69,32,9,0,110,79,31,79,72,7,2018-01-01,zipcode,Fentress
ZCTA5 78623,48,921,82375,-666666666,239900,773,373,720,7,151,300,132,130,444,353,91,353,303,50,2018-01-01,zipcode,Fischer
ZCTA5 78624,48,21945,60020,924,286600,18039,7412,16225,1565,5021,4066,3997,1576,10942,8978,1964,8978,6322,2656,2018-01-01,zipcode,Fredericksburg
ZCTA5 78626,48,33626,66823,1091,209500,26580,9247,21489,2590,6249,6407,4202,2041,11215,10458,757,10458,7055,3403,2018-01-01,zipcode,Georgetown
ZCTA5 78628,48,32946,88564,1154,287500,26105,10374,23296,1265,4671,7596,6073,3691,12007,11546,461,11546,8199,3347,2018-01-01,zipcode,Georgetown
ZCTA5 78629,48,12047,52115,764,128800,9058,3542,7733,1605,3188,1796,823,321,5163,4284,879,4284,2733,1551,2018-01-01,zipcode,Gonzales
ZCTA5 78631,48,2856,51667,981,221100,2249,1013,1956,227,533,683,335,178,1493,1084,409,1084,901,183,2018-01-01,zipcode,Harper
ZCTA5 78632,48,955,49919,992,175000,782,287,741,90,363,213,55,20,536,402,134,402,362,40,2018-01-01,zipcode,Harwood
ZCTA5 78633,48,25847,78207,1675,299200,23065,15501,21886,593,3495,6680,6330,4788,12141,11702,439,11702,10896,806,2018-01-01,zipcode,Georgetown
ZCTA5 78634,48,30934,76468,1348,189600,22333,5016,19575,1569,5677,6824,4005,1500,10037,9300,737,9300,7549,1751,2018-01-01,zipcode,Hutto
ZCTA5 78635,48,464,100769,-666666666,369100,355,131,269,0,51,218,0,0,128,128,0,128,94,34,2018-01-01,zipcode,Hye
ZCTA5 78636,48,3722,64036,825,238200,3224,1299,2903,265,914,817,547,360,2133,1571,562,1571,1151,420,2018-01-01,zipcode,Johnson city
ZCTA5 78638,48,2304,54886,1030,127700,1803,775,1573,274,525,436,241,97,1015,892,123,892,734,158,2018-01-01,zipcode,Kingsbury
ZCTA5 78639,48,8409,47756,839,126800,7303,3618,6381,1193,1732,2387,644,425,4930,3306,1624,3306,2492,814,2018-01-01,zipcode,Kingsland
ZCTA5 78640,48,56645,72474,1370,174800,40972,11813,34633,5830,8609,10887,6172,3135,18339,17378,961,17378,12415,4963,2018-01-01,zipcode,Kyle
ZCTA5 78641,48,65654,94685,1500,236400,48164,13635,41596,3212,7723,14930,11041,4690,21363,20060,1303,20060,16377,3683,2018-01-01,zipcode,Leander
ZCTA5 78642,48,11817,97316,916,283100,8908,2592,7518,564,2063,2501,1713,677,3796,3639,157,3639,3164,475,2018-01-01,zipcode,Liberty hill
ZCTA5 78643,48,6265,55066,813,171200,5258,2435,4869,779,1301,1558,890,341,3778,2253,1525,2253,1777,476,2018-01-01,zipcode,Llano
ZCTA5 78644,48,18274,57135,963,140200,14848,6743,12774,2388,5126,3285,1358,617,6515,6000,515,6000,3910,2090,2018-01-01,zipcode,Lockhart
ZCTA5 78645,48,11254,76396,1057,237100,9363,3696,8663,638,2079,2958,2233,755,5921,4634,1287,4634,3749,885,2018-01-01,zipcode,Leander
ZCTA5 78648,48,8150,47279,749,111900,6355,2676,5320,992,1884,1658,532,254,3232,2964,268,2964,1961,1003,2018-01-01,zipcode,Luling
ZCTA5 78650,48,1672,63750,900,157100,1250,376,1055,182,437,256,129,51,679,506,173,506,376,130,2018-01-01,zipcode,Mc dade
ZCTA5 78652,48,5504,82328,1346,280100,4745,1551,4330,295,1109,1047,1254,625,2509,2169,340,2169,1369,800,2018-01-01,zipcode,Manchaca
ZCTA5 78653,48,22804,69107,1352,168300,15951,4431,13904,2341,3915,4344,2398,906,7579,6846,733,6846,5772,1074,2018-01-01,zipcode,Manor
ZCTA5 78654,48,18450,56992,838,197000,14726,6505,12737,1626,3549,3979,2496,1087,9600,6978,2622,6978,4959,2019,2018-01-01,zipcode,Marble falls
ZCTA5 78655,48,3480,63407,882,124600,2581,954,2211,840,726,319,174,152,1235,1053,182,1053,824,229,2018-01-01,zipcode,Martindale
ZCTA5 78656,48,2157,41152,907,115900,1705,456,1298,165,543,434,133,23,724,712,12,712,362,350,2018-01-01,zipcode,Maxwell
ZCTA5 78657,48,5792,69139,1082,320800,5244,2995,4832,302,1069,1395,1539,527,4862,2565,2297,2565,2194,371,2018-01-01,zipcode,Horseshoe bay
ZCTA5 78659,48,3061,66196,729,147300,2386,864,2037,156,958,634,254,35,1216,970,246,970,893,77,2018-01-01,zipcode,Paige
ZCTA5 78660,48,89830,83499,1355,214600,68307,17256,58857,5807,12425,19141,15392,6092,31020,29945,1075,29945,22182,7763,2018-01-01,zipcode,Pflugerville
ZCTA5 78661,48,345,38750,975,79700,267,132,216,49,106,40,21,0,150,136,14,136,101,35,2018-01-01,zipcode,Prairie lea
ZCTA5 78662,48,2298,79406,992,171100,1992,697,1677,124,488,758,169,138,1065,863,202,863,741,122,2018-01-01,zipcode,Red rock
ZCTA5 78663,48,846,78194,-666666666,-666666666,704,154,626,40,112,292,45,137,514,340,174,340,287,53,2018-01-01,zipcode,Round mountain
ZCTA5 78664,48,62183,72467,1228,193900,47919,11893,39591,3859,8629,14009,9289,3805,21654,20075,1579,20075,11105,8970,2018-01-01,zipcode,Round rock
ZCTA5 78665,48,48362,96049,1413,252000,35348,8756,29863,1253,5442,9859,8804,4505,15774,14639,1135,14639,10610,4029,2018-01-01,zipcode,Round rock
ZCTA5 78666,48,79276,40652,997,159500,68448,23539,39900,5588,11041,11132,8141,3998,30799,28183,2616,28183,10278,17905,2018-01-01,zipcode,San marcos
ZCTA5 78669,48,12106,109963,994,455600,9386,3570,8887,198,1427,2495,3037,1730,5806,4459,1347,4459,3912,547,2018-01-01,zipcode,Spicewood
ZCTA5 78670,48,115,65625,-666666666,120000,115,46,108,8,42,52,6,0,51,51,0,51,40,11,2018-01-01,zipcode,Staples
ZCTA5 78671,48,759,57500,-666666666,158300,668,263,618,173,138,118,175,14,448,354,94,354,325,29,2018-01-01,zipcode,Stonewall
ZCTA5 78672,48,1173,41449,-666666666,129900,1037,595,995,203,300,343,138,11,1098,571,527,571,519,52,2018-01-01,zipcode,Tow
ZCTA5 78675,48,340,56250,-666666666,-666666666,324,122,284,69,100,56,45,14,181,137,44,137,126,11,2018-01-01,zipcode,Willow city
ZCTA5 78676,48,12868,71014,1273,257700,10900,4899,9535,517,1424,3256,2450,1888,6456,5476,980,5476,4588,888,2018-01-01,zipcode,Wimberley
ZCTA5 78677,48,19,-666666666,-666666666,-666666666,15,15,15,0,15,0,0,0,8,8,0,8,8,0,2018-01-01,zipcode,Wrightsboro
ZCTA5 78681,48,56959,103681,1379,281200,42381,11813,35509,1706,4980,10410,12355,6058,18301,17105,1196,17105,13118,3987,2018-01-01,zipcode,Round rock
ZCTA5 78701,48,9427,107190,1950,435400,9272,2028,8341,440,475,1090,3891,2445,7384,5571,1813,5571,1956,3615,2018-01-01,zipcode,Austin
ZCTA5 78702,48,23389,59705,1159,361500,19554,5517,17456,3058,3364,3470,4926,2638,10357,9287,1070,9287,4188,5099,2018-01-01,zipcode,Austin
ZCTA5 78703,48,20890,105207,1452,822800,16991,4028,15737,328,402,1554,6581,6872,10890,9479,1411,9479,5134,4345,2018-01-01,zipcode,Austin
ZCTA5 78704,48,48486,70511,1344,500600,42342,8793,37481,2134,3277,7382,16148,8540,26934,24115,2819,24115,8530,15585,2018-01-01,zipcode,Austin
ZCTA5 78705,48,33948,19188,1238,444700,33313,18266,7153,273,507,1405,3004,1964,10603,8559,2044,8559,902,7657,2018-01-01,zipcode,Austin
ZCTA5 78712,48,860,-666666666,-666666666,-666666666,860,561,9,0,0,0,9,0,0,0,0,0,0,0,2018-01-01,zipcode,Austin
ZCTA5 78717,48,30218,110085,1338,347900,21829,5768,19236,442,1833,4744,7199,5018,10956,10347,609,10347,6128,4219,2018-01-01,zipcode,Austin
ZCTA5 78719,48,1815,58917,840,131800,1494,545,1365,660,381,228,61,35,509,447,62,447,338,109,2018-01-01,zipcode,Austin
ZCTA5 78721,48,12492,44076,1100,245500,10323,3312,8860,2174,2318,1746,1877,745,4619,4278,341,4278,2273,2005,2018-01-01,zipcode,Austin
ZCTA5 78722,48,7110,71340,1359,382700,6143,1130,5624,259,667,802,2434,1462,3475,3107,368,3107,1385,1722,2018-01-01,zipcode,Austin
ZCTA5 78723,48,34569,54707,1049,300600,26935,7017,24053,3967,4708,5560,6075,3743,14446,13000,1446,13000,5890,7110,2018-01-01,zipcode,Austin
ZCTA5 78724,48,24779,45887,1216,133400,17021,5905,13722,4787,3984,2981,1264,706,6873,6458,415,6458,3978,2480,2018-01-01,zipcode,Austin
ZCTA5 78725,48,7886,65345,1504,160200,6026,1357,5372,1130,1680,1485,593,484,2732,2620,112,2620,2155,465,2018-01-01,zipcode,Austin
ZCTA5 78726,48,13867,77935,1189,447400,10993,2632,9077,76,732,2100,4155,2014,6256,5520,736,5520,2456,3064,2018-01-01,zipcode,Austin
ZCTA5 78727,48,29509,78542,1274,271200,24891,6291,22673,1061,2597,5799,8420,4796,14443,13242,1201,13242,6546,6696,2018-01-01,zipcode,Austin
ZCTA5 78728,48,21480,55099,1132,228200,17246,4078,15331,704,3909,4171,4861,1686,10658,9997,661,9997,2665,7332,2018-01-01,zipcode,Austin
ZCTA5 78729,48,29315,76832,1250,261800,24307,5468,21379,1003,3387,5961,7269,3759,13613,12483,1130,12483,5292,7191,2018-01-01,zipcode,Austin
ZCTA5 78730,48,9186,112333,1329,700300,7356,2297,6704,68,416,1110,2920,2190,4090,3810,280,3810,2283,1527,2018-01-01,zipcode,Austin
ZCTA5 78731,48,27175,94048,1266,606000,22339,7167,20193,339,1062,3016,7963,7813,13526,12458,1068,12458,7251,5207,2018-01-01,zipcode,Austin
ZCTA5 78732,48,17849,156599,1496,519100,12763,4146,11220,305,594,2309,4903,3109,6093,5831,262,5831,4403,1428,2018-01-01,zipcode,Austin
ZCTA5 78733,48,8611,154543,1842,579500,6360,2123,5610,88,256,1086,2183,1997,3069,2923,146,2923,2594,329,2018-01-01,zipcode,Austin
ZCTA5 78734,48,18745,115458,1759,406800,15075,5358,13813,573,1459,3704,5306,2771,8629,7424,1205,7424,5971,1453,2018-01-01,zipcode,Austin
ZCTA5 78735,48,17923,97636,1453,482400,13834,4121,12582,528,1411,2422,4914,3307,8424,7352,1072,7352,3760,3592,2018-01-01,zipcode,Austin
ZCTA5 78736,48,9047,109012,1490,330000,7259,2357,6643,131,972,2033,2523,984,3504,3278,226,3278,2624,654,2018-01-01,zipcode,Austin
ZCTA5 78737,48,16160,132245,1565,428000,11917,3730,10799,247,1260,2602,4283,2407,5445,5341,104,5341,4889,452,2018-01-01,zipcode,Austin
ZCTA5 78738,48,15589,130699,1529,553000,11995,4188,10800,119,947,2064,5142,2528,6662,5977,685,5977,4333,1644,2018-01-01,zipcode,Austin
ZCTA5 78739,48,20312,150000,2309,447500,14255,4563,13146,254,1017,2303,5607,3965,6627,6476,151,6476,6127,349,2018-01-01,zipcode,Austin
ZCTA5 78741,48,52716,41852,1082,194000,44075,10031,31962,7107,6775,7756,7551,2773,23723,21474,2249,21474,3309,18165,2018-01-01,zipcode,Austin
ZCTA5 78742,48,828,38958,1067,58300,673,250,515,226,90,153,29,17,291,256,35,256,148,108,2018-01-01,zipcode,Austin
ZCTA5 78744,48,48969,49633,1157,138500,35971,9927,29345,8253,8282,7032,4466,1312,15784,14857,927,14857,6783,8074,2018-01-01,zipcode,Austin
ZCTA5 78745,48,62771,62265,1293,255200,52984,12625,47697,5291,9122,14265,12986,6033,27969,26330,1639,26330,11701,14629,2018-01-01,zipcode,Austin
ZCTA5 78746,48,28495,139951,1519,851900,22237,7449,19973,316,811,2590,8997,7259,11794,10867,927,10867,7516,3351,2018-01-01,zipcode,Austin
ZCTA5 78747,48,20166,81184,1390,222700,15952,4749,13482,1902,3366,3872,2991,1351,6885,6558,327,6558,4978,1580,2018-01-01,zipcode,Austin
ZCTA5 78748,48,50997,77700,1392,256200,40781,9708,36367,2570,6739,10759,11253,5046,20257,19385,872,19385,11720,7665,2018-01-01,zipcode,Austin
ZCTA5 78749,48,37774,98953,1396,322400,30412,6759,27629,491,2782,6093,11117,7146,15960,15428,532,15428,9615,5813,2018-01-01,zipcode,Austin
ZCTA5 78750,48,30847,91585,1353,388900,24422,7157,22154,811,2873,5378,7513,5579,12394,11724,670,11724,7381,4343,2018-01-01,zipcode,Austin
ZCTA5 78751,48,15805,59926,1299,450000,14316,2968,11590,300,1072,1877,4954,3387,8787,7605,1182,7605,2297,5308,2018-01-01,zipcode,Austin
ZCTA5 78752,48,21324,45644,1061,253800,16773,3779,14802,3039,3049,3274,3749,1691,8951,8188,763,8188,2237,5951,2018-01-01,zipcode,Austin
ZCTA5 78753,48,59085,49065,1058,177300,45322,11933,38979,10260,11187,9338,5943,2251,21610,20121,1489,20121,7309,12812,2018-01-01,zipcode,Austin
ZCTA5 78754,48,24408,67224,1204,211000,18436,4493,16165,2163,3128,4404,4016,2454,8555,8192,363,8192,4255,3937,2018-01-01,zipcode,Austin
ZCTA5 78756,48,8323,82705,1236,493200,7389,1484,6954,130,685,967,2978,2194,4722,4336,386,4336,2026,2310,2018-01-01,zipcode,Austin
ZCTA5 78757,48,24823,70489,1178,389000,20063,4975,18326,1520,2398,3835,6453,4120,11622,10720,902,10720,5789,4931,2018-01-01,zipcode,Austin
ZCTA5 78758,48,47470,53547,1142,202200,38193,8595,33579,5533,7641,8035,8582,3788,22078,19976,2102,19976,5761,14215,2018-01-01,zipcode,Austin
ZCTA5 78759,48,42524,81066,1260,414600,35699,9316,32712,664,2981,6837,12516,9714,21912,20454,1458,20454,9308,11146,2018-01-01,zipcode,Austin
ZCTA5 78801,48,22647,42266,657,82000,17426,7128,13992,3875,3678,4285,1652,502,8706,7193,1513,7193,5196,1997,2018-01-01,zipcode,Uvalde
ZCTA5 78802,48,251,-666666666,-666666666,-666666666,195,0,141,0,0,79,62,0,98,79,19,79,79,0,2018-01-01,zipcode,Uvalde
ZCTA5 78827,48,1052,24257,429,56700,839,451,691,209,231,168,34,49,538,412,126,412,304,108,2018-01-01,zipcode,Asherton
ZCTA5 78828,48,81,55156,-666666666,-666666666,81,58,81,0,5,46,14,16,260,30,230,30,30,0,2018-01-01,zipcode,Barksdale
ZCTA5 78829,48,1274,14077,722,29200,891,487,751,470,154,88,39,0,533,306,227,306,244,62,2018-01-01,zipcode,Batesville
ZCTA5 78830,48,887,23958,770,46300,753,451,601,187,262,133,14,5,374,259,115,259,215,44,2018-01-01,zipcode,Big wells
ZCTA5 78832,48,3675,31468,542,72800,3044,1726,2747,731,979,772,224,41,1890,1170,720,1170,868,302,2018-01-01,zipcode,Brackettville
ZCTA5 78833,48,1536,30789,642,62500,1342,752,1196,218,506,295,136,41,1010,528,482,528,409,119,2018-01-01,zipcode,Camp wood
ZCTA5 78834,48,8549,29778,824,81800,6143,2626,5088,1667,1624,984,610,203,3339,2555,784,2555,1792,763,2018-01-01,zipcode,Carrizo springs
ZCTA5 78836,48,162,18462,-666666666,38000,162,142,141,61,53,18,9,0,144,70,74,70,70,0,2018-01-01,zipcode,Catarina
ZCTA5 78837,48,236,-666666666,-666666666,63500,203,97,189,74,50,27,18,20,246,101,145,101,92,9,2018-01-01,zipcode,Comstock
ZCTA5 78838,48,156,38897,-666666666,267700,156,118,156,54,55,23,7,17,289,83,206,83,83,0,2018-01-01,zipcode,Concan
ZCTA5 78839,48,9223,32810,595,52300,6917,2970,5440,1807,1916,1219,319,179,3057,2672,385,2672,1861,811,2018-01-01,zipcode,Crystal city
ZCTA5 78840,48,48143,45732,719,96300,35659,14750,29042,9258,6872,7555,3685,1672,18543,15257,3286,15257,9585,5672,2018-01-01,zipcode,Del rio
ZCTA5 78843,48,577,-666666666,-666666666,-666666666,577,18,62,0,0,0,62,0,35,35,0,35,0,35,2018-01-01,zipcode,Laughlin afb
ZCTA5 78850,48,1305,56964,-666666666,154500,1023,496,834,131,247,256,127,73,596,397,199,397,374,23,2018-01-01,zipcode,D hanis
ZCTA5 78851,48,33,85882,-666666666,-666666666,33,11,33,6,2,8,17,0,26,22,4,22,19,3,2018-01-01,zipcode,Dryden
ZCTA5 78852,48,56838,38169,663,95200,41030,17031,31937,12864,7042,8119,2918,994,17936,15970,1966,15970,10503,5467,2018-01-01,zipcode,Eagle pass
ZCTA5 78860,48,23,-666666666,-666666666,-666666666,23,23,23,23,0,0,0,0,23,23,0,23,23,0,2018-01-01,zipcode,El indio
ZCTA5 78861,48,13965,57060,878,139100,11140,5446,9041,1468,3302,3019,771,481,4831,3842,989,3842,2813,1029,2018-01-01,zipcode,Hondo
ZCTA5 78870,48,847,34432,572,76600,673,315,518,178,154,71,72,43,395,289,106,289,187,102,2018-01-01,zipcode,Knippa
ZCTA5 78871,48,56,-666666666,-666666666,-666666666,56,52,56,0,56,0,0,0,87,24,63,24,24,0,2018-01-01,zipcode,Langtry
ZCTA5 78872,48,1647,25208,557,44400,1215,553,971,455,170,269,43,34,767,544,223,544,386,158,2018-01-01,zipcode,La pryor
ZCTA5 78873,48,1908,35714,925,119000,1529,833,1323,233,227,609,149,105,1523,738,785,738,621,117,2018-01-01,zipcode,Leakey
ZCTA5 78877,48,777,16940,-666666666,99300,522,308,522,258,99,55,42,68,297,255,42,255,181,74,2018-01-01,zipcode,Quemado
ZCTA5 78879,48,137,-666666666,-666666666,111600,137,71,119,0,0,76,43,0,324,61,263,61,55,6,2018-01-01,zipcode,Rio frio
ZCTA5 78880,48,1812,38333,460,68900,1497,648,1252,346,374,279,236,17,1396,586,810,586,468,118,2018-01-01,zipcode,Rocksprings
ZCTA5 78881,48,2122,33421,718,64000,1478,744,1306,396,478,257,107,68,987,696,291,696,570,126,2018-01-01,zipcode,Sabinal
ZCTA5 78883,48,285,51196,-666666666,-666666666,253,212,233,0,79,48,73,33,379,140,239,140,131,9,2018-01-01,zipcode,Tarpley
ZCTA5 78884,48,1224,56466,-666666666,160100,1002,455,862,71,246,311,148,86,825,430,395,430,376,54,2018-01-01,zipcode,Utopia
ZCTA5 78885,48,86,78438,-666666666,483300,86,35,64,14,12,24,8,6,160,31,129,31,29,2,2018-01-01,zipcode,Vanderpool
ZCTA5 78886,48,379,42039,-666666666,194600,329,107,273,24,87,96,41,25,249,149,100,149,120,29,2018-01-01,zipcode,Yancey
ZCTA5 78931,48,253,98889,-666666666,329800,194,87,194,29,59,57,33,16,185,110,75,110,110,0,2018-01-01,zipcode,Bleiblerville
ZCTA5 78932,48,555,61583,723,125000,494,280,395,46,112,141,57,39,364,181,183,181,132,49,2018-01-01,zipcode,Carmine
ZCTA5 78933,48,1294,77607,-666666666,156800,1048,477,1032,171,275,347,185,54,846,540,306,540,420,120,2018-01-01,zipcode,Cat spring
ZCTA5 78934,48,6394,48549,642,129100,4768,2156,4220,634,1671,1030,682,203,3338,2196,1142,2196,1640,556,2018-01-01,zipcode,Columbus
ZCTA5 78935,48,1396,67143,-666666666,298200,1276,428,1043,157,263,310,216,97,478,394,84,394,384,10,2018-01-01,zipcode,Alleyton
ZCTA5 78938,48,387,51429,615,94600,297,91,236,6,104,67,48,11,189,126,63,126,96,30,2018-01-01,zipcode,Ellinger
ZCTA5 78940,48,2347,52909,781,167100,1949,779,1716,101,803,482,246,84,1514,867,647,867,790,77,2018-01-01,zipcode,Fayetteville
ZCTA5 78941,48,3143,55956,659,157000,2703,1458,2369,388,1140,471,310,60,1678,1010,668,1010,851,159,2018-01-01,zipcode,Flatonia
ZCTA5 78942,48,8629,56081,899,115400,6797,2476,5487,967,2086,1599,566,269,3751,2979,772,2979,2068,911,2018-01-01,zipcode,Giddings
ZCTA5 78943,48,283,-666666666,-666666666,-666666666,257,100,257,85,60,83,25,4,163,111,52,111,111,0,2018-01-01,zipcode,Glidden
ZCTA5 78944,48,537,66488,1313,240300,507,234,455,22,164,180,53,36,304,247,57,247,235,12,2018-01-01,zipcode,Industry
ZCTA5 78945,48,10463,58956,747,177000,8366,3500,7227,1335,2764,1961,877,290,5456,3941,1515,3941,3013,928,2018-01-01,zipcode,La grange
ZCTA5 78946,48,1247,47692,935,166100,1197,431,1121,95,578,343,80,25,776,484,292,484,353,131,2018-01-01,zipcode,Ledbetter
ZCTA5 78947,48,4688,55804,782,166400,3704,1612,3278,298,1099,1261,432,188,2148,1715,433,1715,1482,233,2018-01-01,zipcode,Lexington
ZCTA5 78948,48,760,44471,-666666666,221400,723,301,557,139,216,131,63,8,473,303,170,303,272,31,2018-01-01,zipcode,Lincoln
ZCTA5 78949,48,666,64318,-666666666,157900,471,276,464,45,156,159,39,65,403,206,197,206,184,22,2018-01-01,zipcode,Muldoon
ZCTA5 78950,48,1785,50217,-666666666,186300,1523,675,1329,130,567,422,151,59,1263,762,501,762,721,41,2018-01-01,zipcode,New ulm
ZCTA5 78951,48,0,-666666666,-666666666,-666666666,0,0,0,0,0,0,0,0,0,0,0,0,0,0,2018-01-01,zipcode,Oakland
ZCTA5 78953,48,790,73214,1368,151900,740,216,700,109,181,337,54,19,519,400,119,400,327,73,2018-01-01,zipcode,Rosanky
ZCTA5 78954,48,1083,55000,788,325000,1020,529,961,49,306,279,243,84,1032,518,514,518,480,38,2018-01-01,zipcode,Round top
ZCTA5 78956,48,5383,51364,841,146300,4287,1833,3821,781,1500,901,493,146,2817,1828,989,1828,1398,430,2018-01-01,zipcode,Schulenburg
ZCTA5 78957,48,9704,54152,931,164300,7787,3359,6811,908,2142,2118,1187,456,4455,3537,918,3537,2714,823,2018-01-01,zipcode,Smithville
ZCTA5 78959,48,1894,42181,432,78100,1523,657,1333,536,418,273,82,24,947,690,257,690,559,131,2018-01-01,zipcode,Waelder
ZCTA5 78962,48,5239,61618,757,144500,4261,1587,3685,512,1285,1154,490,244,2889,2076,813,2076,1741,335,2018-01-01,zipcode,Weimar
ZCTA5 78963,48,1247,50735,-666666666,133300,909,346,804,144,376,209,69,6,452,356,96,356,348,8,2018-01-01,zipcode,West point
ZCTA5 79001,48,200,73750,-666666666,103600,181,90,177,38,44,41,42,12,123,76,47,76,62,14,2018-01-01,zipcode,Adrian
ZCTA5 79003,48,178,71667,-666666666,102700,141,71,133,29,25,53,20,6,91,70,21,70,45,25,2018-01-01,zipcode,Allison
ZCTA5 79005,48,1639,56786,670,90800,1304,403,1108,233,417,298,104,56,667,588,79,588,445,143,2018-01-01,zipcode,Booker
ZCTA5 79007,48,14447,49307,803,79400,11147,4422,9191,1349,3080,3346,1012,404,6802,4704,2098,4704,3609,1095,2018-01-01,zipcode,Borger
ZCTA5 79009,48,1728,44196,683,75000,1322,534,1033,301,437,193,83,19,734,599,135,599,361,238,2018-01-01,zipcode,Bovina
ZCTA5 79010,48,996,-666666666,-666666666,-666666666,530,411,312,5,169,35,80,23,222,172,50,172,110,62,2018-01-01,zipcode,Boys ranch
ZCTA5 79011,48,188,81250,-666666666,105700,166,45,157,15,53,58,25,6,123,92,31,92,67,25,2018-01-01,zipcode,Briscoe
ZCTA5 79012,48,1341,116250,-666666666,236100,987,153,892,0,131,511,250,0,539,526,13,526,476,50,2018-01-01,zipcode,Bushland
ZCTA5 79013,48,3708,37382,602,58900,2661,927,1845,1385,220,139,101,0,1378,1046,332,1046,626,420,2018-01-01,zipcode,Cactus
ZCTA5 79014,48,4052,63333,825,135200,2909,912,2430,498,718,695,401,118,1654,1310,344,1310,832,478,2018-01-01,zipcode,Canadian
ZCTA5 79015,48,22193,68704,809,191700,17738,4969,12887,667,1781,4997,3729,1713,8672,7723,949,7723,5033,2690,2018-01-01,zipcode,Canyon
ZCTA5 79016,48,138,-666666666,-666666666,-666666666,138,102,12,0,0,6,6,0,0,0,0,0,0,0,2018-01-01,zipcode,Canyon
ZCTA5 79018,48,321,48125,653,49200,258,90,244,7,84,103,26,24,236,158,78,158,80,78,2018-01-01,zipcode,Channing
ZCTA5 79019,48,1779,68214,824,139200,1444,570,1301,157,306,549,189,100,834,652,182,652,518,134,2018-01-01,zipcode,Claude
ZCTA5 79021,48,151,44375,-666666666,75000,103,31,89,41,22,19,3,4,73,52,21,52,19,33,2018-01-01,zipcode,Cotton center
ZCTA5 79022,48,11346,57547,779,107600,8603,3543,7638,1877,2543,2105,842,271,3945,3369,576,3369,2193,1176,2018-01-01,zipcode,Dalhart
ZCTA5 79024,48,475,63333,1010,81100,349,132,302,34,117,89,49,13,210,176,34,176,131,45,2018-01-01,zipcode,Darrouzett
ZCTA5 79025,48,49,29091,-666666666,-666666666,49,23,31,13,18,0,0,0,36,24,12,24,13,11,2018-01-01,zipcode,Dawn
ZCTA5 79027,48,5013,42203,639,83400,3648,1465,2932,800,859,819,278,176,1966,1601,365,1601,838,763,2018-01-01,zipcode,Dimmitt
ZCTA5 79029,48,15984,54513,821,132300,11484,3559,9387,2449,2328,3133,940,537,5709,4892,817,4892,3165,1727,2018-01-01,zipcode,Dumas
ZCTA5 79031,48,1469,54306,625,76800,1055,410,954,252,256,186,216,44,652,507,145,507,370,137,2018-01-01,zipcode,Earth
ZCTA5 79032,48,76,-666666666,-666666666,-666666666,53,19,47,15,21,7,1,3,41,22,19,22,16,6,2018-01-01,zipcode,Edmonson
ZCTA5 79033,48,76,-666666666,-666666666,-666666666,61,39,61,29,5,15,12,0,53,37,16,37,15,22,2018-01-01,zipcode,Farnsworth
ZCTA5 79034,48,585,60694,704,88500,431,140,363,61,96,124,65,17,275,211,64,211,158,53,2018-01-01,zipcode,Follett
ZCTA5 79035,48,5177,55089,714,87000,3733,1396,3129,907,912,641,525,144,1836,1707,129,1707,1209,498,2018-01-01,zipcode,Friona
ZCTA5 79036,48,5135,54683,740,73500,4020,1852,3584,481,1292,1471,259,81,2552,1764,788,1764,1642,122,2018-01-01,zipcode,Fritch
ZCTA5 79039,48,951,57727,686,116500,678,262,632,73,164,238,101,56,431,366,65,366,307,59,2018-01-01,zipcode,Groom
ZCTA5 79040,48,2007,47450,749,113100,1409,493,1030,380,219,259,124,48,792,575,217,575,355,220,2018-01-01,zipcode,Gruver
ZCTA5 79041,48,2983,42878,674,71900,2264,1025,1830,497,584,457,228,64,1345,1105,240,1105,788,317,2018-01-01,zipcode,Hale center
ZCTA5 79042,48,1046,40673,709,79200,801,249,670,35,228,241,106,60,565,425,140,425,315,110,2018-01-01,zipcode,Happy
ZCTA5 79043,48,1447,42105,642,51500,1089,429,861,281,321,206,38,15,600,466,134,466,290,176,2018-01-01,zipcode,Hart
ZCTA5 79044,48,701,46017,1018,83100,491,226,401,187,94,45,56,19,377,305,72,305,118,187,2018-01-01,zipcode,Hartley
ZCTA5 79045,48,18981,52146,782,91100,13718,4565,11204,3091,3772,2958,1015,368,7137,6156,981,6156,3905,2251,2018-01-01,zipcode,Hereford
ZCTA5 79046,48,674,51607,880,77700,490,194,424,81,106,136,77,24,314,249,65,249,173,76,2018-01-01,zipcode,Higgins
ZCTA5 79051,48,0,-666666666,-666666666,-666666666,0,0,0,0,0,0,0,0,0,0,0,0,0,0,2018-01-01,zipcode,Kerrick
ZCTA5 79052,48,1210,44896,632,73300,992,352,724,170,254,185,98,17,565,427,138,427,338,89,2018-01-01,zipcode,Kress
ZCTA5 79053,48,152,64063,568,127500,127,46,101,3,18,58,22,0,64,41,23,41,25,16,2018-01-01,zipcode,Lazbuddie
ZCTA5 79054,48,709,35982,767,33500,497,170,440,46,199,177,7,11,339,249,90,249,190,59,2018-01-01,zipcode,Lefors
ZCTA5 79056,48,73,75000,-666666666,105400,64,47,62,2,13,24,17,6,51,28,23,28,23,5,2018-01-01,zipcode,Lipscomb
ZCTA5 79057,48,1368,45313,546,48600,1040,452,952,146,277,357,153,19,676,524,152,524,358,166,2018-01-01,zipcode,Mclean
ZCTA5 79058,48,0,-666666666,-666666666,-666666666,0,0,0,0,0,0,0,0,20,0,20,0,0,0,2018-01-01,zipcode,Masterson
ZCTA5 79059,48,701,66731,775,117600,547,264,444,45,113,151,106,29,354,264,90,264,208,56,2018-01-01,zipcode,Miami
ZCTA5 79061,48,406,70833,530,58300,294,122,243,28,48,110,48,9,178,150,28,150,99,51,2018-01-01,zipcode,Mobeetie
ZCTA5 79062,48,190,68125,-666666666,-666666666,167,55,112,22,30,24,28,8,95,55,40,55,43,12,2018-01-01,zipcode,Morse
ZCTA5 79063,48,669,54167,507,170100,482,221,442,14,230,106,61,31,270,242,28,242,207,35,2018-01-01,zipcode,Nazareth
ZCTA5 79064,48,2382,41827,629,64200,1829,784,1593,498,618,307,113,57,1084,873,211,873,581,292,2018-01-01,zipcode,Olton
ZCTA5 79065,48,20873,48735,752,80500,16131,7028,13951,2842,4476,4727,1442,464,9116,7325,1791,7325,5456,1869,2018-01-01,zipcode,Pampa
ZCTA5 79068,48,3431,73311,738,121500,2765,894,2304,102,607,800,451,344,1473,1264,209,1264,1014,250,2018-01-01,zipcode,Panhandle
ZCTA5 79070,48,10045,49682,788,99600,7254,2449,5947,1480,1849,1723,695,200,3935,3317,618,3317,2402,915,2018-01-01,zipcode,Perryton
ZCTA5 79072,48,26893,47129,663,83100,20272,8308,16473,3951,5616,4168,1834,904,10314,8584,1730,8584,4985,3599,2018-01-01,zipcode,Plainview
ZCTA5 79078,48,249,84219,625,-666666666,213,71,204,22,99,62,3,18,217,97,120,97,89,8,2018-01-01,zipcode,Sanford
ZCTA5 79079,48,2593,39213,653,81300,2069,795,1776,298,539,674,202,63,1461,1156,305,1156,655,501,2018-01-01,zipcode,Shamrock
ZCTA5 79080,48,519,49231,775,41300,406,238,368,14,120,186,38,10,376,206,170,206,171,35,2018-01-01,zipcode,Skellytown
ZCTA5 79081,48,4001,34604,759,100800,2905,1324,2532,762,756,693,237,84,1634,1339,295,1339,1034,305,2018-01-01,zipcode,Spearman
ZCTA5 79082,48,239,48125,-666666666,106300,164,66,151,34,37,51,20,9,124,85,39,85,78,7,2018-01-01,zipcode,Springlake
ZCTA5 79083,48,1827,41538,818,72000,1501,879,1309,230,362,521,131,65,1233,718,515,718,568,150,2018-01-01,zipcode,Stinnett
ZCTA5 79084,48,2274,56250,675,102100,1782,526,1533,320,402,499,240,72,1055,784,271,784,610,174,2018-01-01,zipcode,Stratford
ZCTA5 79085,48,28,43500,-666666666,-666666666,24,3,21,9,3,9,0,0,19,12,7,12,12,0,2018-01-01,zipcode,Summerfield
ZCTA5 79086,48,2148,46083,783,84000,1550,560,1319,331,382,352,198,56,864,713,151,713,525,188,2018-01-01,zipcode,Sunray
ZCTA5 79087,48,647,58906,696,97000,508,195,435,73,103,154,79,26,326,255,71,255,192,63,2018-01-01,zipcode,Texline
ZCTA5 79088,48,5642,37306,715,74700,4403,2531,3958,1156,1262,1120,323,97,2305,1843,462,1843,1261,582,2018-01-01,zipcode,Tulia
ZCTA5 79091,48,132,34904,-666666666,70400,86,9,86,35,21,14,8,8,66,43,23,43,43,0,2018-01-01,zipcode,Umbarger
ZCTA5 79092,48,1018,61563,883,106800,826,278,761,81,310,242,101,27,407,345,62,345,302,43,2018-01-01,zipcode,Vega
ZCTA5 79093,48,97,-666666666,-666666666,-666666666,82,33,82,13,48,21,0,0,68,52,16,52,52,0,2018-01-01,zipcode,Waka
ZCTA5 79094,48,51,58646,-666666666,57100,51,14,51,0,32,2,17,0,21,17,4,17,17,0,2018-01-01,zipcode,Wayside
ZCTA5 79095,48,2692,44000,644,52900,2083,754,1778,414,564,513,210,77,1220,948,272,948,729,219,2018-01-01,zipcode,Wellington
ZCTA5 79096,48,2196,55417,735,99500,1576,548,1437,315,439,405,211,67,936,816,120,816,582,234,2018-01-01,zipcode,Wheeler
ZCTA5 79097,48,890,74115,792,106500,656,243,563,38,171,183,109,62,380,319,61,319,297,22,2018-01-01,zipcode,White deer
ZCTA5 79098,48,516,74875,675,115800,339,134,271,55,54,128,30,4,173,143,30,143,126,17,2018-01-01,zipcode,Wildorado
ZCTA5 79101,48,2133,26473,758,71400,1854,1096,1719,225,464,643,260,127,1529,1164,365,1164,108,1056,2018-01-01,zipcode,Amarillo
ZCTA5 79102,48,10395,44931,744,98200,7721,2377,6150,1154,1702,2180,821,293,4549,4183,366,4183,1943,2240,2018-01-01,zipcode,Amarillo
ZCTA5 79103,48,10995,45747,895,85900,8165,2501,6865,1541,2428,2298,493,105,4135,3980,155,3980,2830,1150,2018-01-01,zipcode,Amarillo
ZCTA5 79104,48,6988,41548,806,61900,5260,1953,4436,1703,1486,1035,190,22,2747,2400,347,2400,1491,909,2018-01-01,zipcode,Amarillo
ZCTA5 79105,48,0,-666666666,-666666666,-666666666,0,0,0,0,0,0,0,0,23,0,23,0,0,0,2018-01-01,zipcode,Amarillo
ZCTA5 79106,48,27015,42149,781,117400,20599,7180,17428,2488,4915,5880,2466,1679,13128,11422,1706,11422,5633,5789,2018-01-01,zipcode,Amarillo
ZCTA5 79107,48,34844,36247,763,66200,24098,9114,19079,6865,6578,4380,1006,250,12735,11349,1386,11349,6692,4657,2018-01-01,zipcode,Amarillo
ZCTA5 79108,48,16083,52469,860,115000,13873,8621,12664,2608,5034,3722,1039,261,5018,4256,762,4256,3247,1009,2018-01-01,zipcode,Amarillo
ZCTA5 79109,48,44352,57252,789,160900,34766,10488,29846,2471,6384,11839,6273,2879,20661,18257,2404,18257,10893,7364,2018-01-01,zipcode,Amarillo
ZCTA5 79110,48,19138,59583,980,108900,14275,3736,11855,1338,3061,5261,1576,619,7512,6911,601,6911,4798,2113,2018-01-01,zipcode,Amarillo
ZCTA5 79111,48,2333,64275,1017,-666666666,1720,809,1374,212,452,558,85,67,605,576,29,576,14,562,2018-01-01,zipcode,Amarillo
ZCTA5 79118,48,23246,74022,984,156700,17890,5382,15442,1920,4849,5439,2392,842,8485,7768,717,7768,6220,1548,2018-01-01,zipcode,Amarillo
ZCTA5 79119,48,16394,87785,978,254500,12894,3707,11372,568,1703,3817,3333,1951,6750,6349,401,6349,4683,1666,2018-01-01,zipcode,Amarillo
ZCTA5 79121,48,6252,83210,872,200500,5428,1945,4840,328,764,1619,1342,787,3009,2579,430,2579,1723,856,2018-01-01,zipcode,Amarillo
ZCTA5 79124,48,8805,81505,1044,238100,6683,2637,5932,170,1201,2355,1393,813,3619,3402,217,3402,2847,555,2018-01-01,zipcode,Amarillo
ZCTA5 79201,48,7238,41319,742,80300,6056,2880,4970,797,1942,1382,674,175,2829,2250,579,2250,1326,924,2018-01-01,zipcode,Childress
ZCTA5 79220,48,225,32917,556,58600,162,75,133,25,35,29,27,17,160,91,69,91,38,53,2018-01-01,zipcode,Afton
ZCTA5 79225,48,1016,52222,663,39900,827,325,702,222,180,186,88,26,586,362,224,362,275,87,2018-01-01,zipcode,Chillicothe
ZCTA5 79226,48,2898,44714,663,73900,2321,998,1852,198,602,670,268,114,1826,1096,730,1096,823,273,2018-01-01,zipcode,Clarendon
ZCTA5 79227,48,1431,46354,455,45100,1217,486,1070,243,305,350,136,36,960,569,391,569,478,91,2018-01-01,zipcode,Crowell
ZCTA5 79229,48,401,56250,425,50300,322,191,293,38,104,118,24,9,247,143,104,143,123,20,2018-01-01,zipcode,Dickens
ZCTA5 79230,48,176,42143,-666666666,-666666666,132,64,128,57,21,12,28,10,82,42,40,42,39,3,2018-01-01,zipcode,Dodson
ZCTA5 79231,48,96,-666666666,-666666666,-666666666,49,23,49,0,23,26,0,0,26,26,0,26,0,26,2018-01-01,zipcode,Dougherty
ZCTA5 79233,48,116,35000,738,23600,92,29,84,15,23,31,15,0,82,58,24,58,33,25,2018-01-01,zipcode,Estelline
ZCTA5 79234,48,24,42500,-666666666,72500,24,14,24,0,14,4,4,2,57,14,43,14,14,0,2018-01-01,zipcode,Flomot
ZCTA5 79235,48,3470,46250,719,55200,2588,1077,2234,594,658,618,265,99,1800,1389,411,1389,1050,339,2018-01-01,zipcode,Floydada
ZCTA5 79236,48,210,65625,588,38300,160,37,150,18,58,47,15,12,134,87,47,87,34,53,2018-01-01,zipcode,Guthrie
ZCTA5 79237,48,403,30556,588,52500,364,179,328,66,81,143,35,3,318,188,130,188,137,51,2018-01-01,zipcode,Hedley
ZCTA5 79239,48,206,23438,-666666666,80900,178,94,173,15,80,42,23,13,200,100,100,100,59,41,2018-01-01,zipcode,Lakeview
ZCTA5 79240,48,72,-666666666,-666666666,-666666666,54,20,46,0,31,15,0,0,19,12,7,12,5,7,2018-01-01,zipcode,Lelia lake
ZCTA5 79241,48,2200,51979,711,71700,1745,759,1475,420,357,475,179,44,1098,878,220,878,586,292,2018-01-01,zipcode,Lockney
ZCTA5 79243,48,73,40000,-666666666,85000,73,55,69,0,24,34,11,0,40,32,8,32,18,14,2018-01-01,zipcode,Mcadoo
ZCTA5 79244,48,855,44583,625,54600,598,216,535,71,125,248,82,9,482,301,181,301,195,106,2018-01-01,zipcode,Matador
ZCTA5 79245,48,2400,33046,530,49900,1874,825,1602,416,451,544,115,76,1284,982,302,982,599,383,2018-01-01,zipcode,Memphis
ZCTA5 79247,48,68,68750,-666666666,27900,47,15,37,3,15,19,0,0,25,25,0,25,24,1,2018-01-01,zipcode,Odell
ZCTA5 79248,48,1597,33438,363,39800,1111,416,998,223,331,284,107,53,1011,665,346,665,422,243,2018-01-01,zipcode,Paducah
ZCTA5 79250,48,1321,49821,707,65600,1062,462,916,208,279,230,126,73,691,499,192,499,361,138,2018-01-01,zipcode,Petersburg
ZCTA5 79251,48,15,-666666666,-666666666,66000,15,8,15,8,0,4,0,3,23,10,13,10,10,0,2018-01-01,zipcode,Quail
ZCTA5 79252,48,3004,40455,560,37900,2339,1009,2066,353,786,640,197,90,1738,1176,562,1176,848,328,2018-01-01,zipcode,Quanah
ZCTA5 79255,48,631,39667,661,109500,481,194,381,57,124,109,84,7,409,234,175,234,153,81,2018-01-01,zipcode,Quitaque
ZCTA5 79256,48,227,42679,606,53900,205,82,195,38,91,40,23,3,193,131,62,131,87,44,2018-01-01,zipcode,Roaring springs
ZCTA5 79257,48,939,43583,621,56500,802,357,713,91,231,226,108,57,583,393,190,393,324,69,2018-01-01,zipcode,Silverton
ZCTA5 79258,48,47,-666666666,-666666666,59100,47,35,35,0,26,9,0,0,28,20,8,20,20,0,2018-01-01,zipcode,South plains
ZCTA5 79259,48,61,-666666666,-666666666,-666666666,52,10,51,0,0,23,28,0,87,26,61,26,26,0,2018-01-01,zipcode,Tell
ZCTA5 79261,48,357,38194,523,54200,308,144,230,57,65,74,23,11,335,166,169,166,108,58,2018-01-01,zipcode,Turkey
ZCTA5 79311,48,3541,49561,689,81200,2698,1106,2201,440,712,653,335,61,1480,1264,216,1264,868,396,2018-01-01,zipcode,Abernathy
ZCTA5 79312,48,986,49125,482,63100,859,397,699,165,244,182,89,19,474,362,112,362,264,98,2018-01-01,zipcode,Amherst
ZCTA5 79313,48,1566,48409,610,62700,1154,444,997,272,263,333,91,38,737,552,185,552,371,181,2018-01-01,zipcode,Anton
ZCTA5 79314,48,62,-666666666,-666666666,30500,46,31,46,15,17,12,0,2,51,29,22,29,23,6,2018-01-01,zipcode,Bledsoe
ZCTA5 79316,48,11333,43724,727,75400,8581,3987,7205,2311,2272,1780,562,280,4309,3589,720,3589,2410,1179,2018-01-01,zipcode,Brownfield
ZCTA5 79322,48,1998,35500,624,58600,1560,644,1292,304,479,330,140,39,972,742,230,742,548,194,2018-01-01,zipcode,Crosbyton
ZCTA5 79323,48,7432,71160,793,104000,5015,1590,4254,1445,1268,853,519,169,2377,2197,180,2197,1799,398,2018-01-01,zipcode,Denver city
ZCTA5 79324,48,37,-666666666,-666666666,-666666666,28,8,16,0,3,13,0,0,11,11,0,11,11,0,2018-01-01,zipcode,Enochs
ZCTA5 79325,48,2361,54318,694,116500,1830,689,1539,492,459,380,139,69,996,842,154,842,606,236,2018-01-01,zipcode,Farwell
ZCTA5 79326,48,109,-666666666,-666666666,-666666666,79,32,68,0,7,24,12,25,80,46,34,46,46,0,2018-01-01,zipcode,Fieldton
ZCTA5 79329,48,3092,67617,729,120400,2486,840,2052,411,644,486,397,114,1281,1122,159,1122,874,248,2018-01-01,zipcode,Idalou
ZCTA5 79330,48,142,-666666666,-666666666,-666666666,106,73,94,0,61,11,10,12,326,31,295,31,22,9,2018-01-01,zipcode,Justiceburg
ZCTA5 79331,48,12561,43971,619,67600,9918,4971,7983,2196,2938,1871,750,228,4941,4156,785,4156,2951,1205,2018-01-01,zipcode,Lamesa
ZCTA5 79336,48,17406,47458,701,95300,13306,4885,10717,2607,2800,3944,930,436,6956,5980,976,5980,4088,1892,2018-01-01,zipcode,Levelland
ZCTA5 79339,48,6658,39808,806,62000,4857,1987,3987,1043,1291,1095,374,184,2925,2304,621,2304,1526,778,2018-01-01,zipcode,Littlefield
ZCTA5 79342,48,450,96250,423,76400,284,86,268,76,57,69,26,40,182,141,41,141,69,72,2018-01-01,zipcode,Loop
ZCTA5 79343,48,1669,40078,500,69500,1230,436,998,241,366,241,114,36,647,536,111,536,339,197,2018-01-01,zipcode,Lorenzo
ZCTA5 79344,48,92,-666666666,-666666666,-666666666,44,27,27,0,14,9,4,0,51,15,36,15,8,7,2018-01-01,zipcode,Maple
ZCTA5 79345,48,975,55000,619,92300,738,287,611,156,192,156,92,15,403,342,61,342,277,65,2018-01-01,zipcode,Meadow
ZCTA5 79346,48,2248,41042,545,33000,1656,652,1418,521,406,389,75,27,1078,790,288,790,618,172,2018-01-01,zipcode,Morton
ZCTA5 79347,48,7233,46897,668,71400,5369,2010,4493,1087,1592,934,706,174,2642,2219,423,2219,1742,477,2018-01-01,zipcode,Muleshoe
ZCTA5 79350,48,422,47396,733,76300,304,106,239,54,91,90,3,1,164,139,25,139,99,40,2018-01-01,zipcode,New deal
ZCTA5 79351,48,1427,53125,696,70500,1049,425,929,234,251,285,124,35,652,493,159,493,330,163,2018-01-01,zipcode,Odonnell
ZCTA5 79353,48,52,51250,-666666666,-666666666,43,17,28,15,11,2,0,0,10,10,0,10,2,8,2018-01-01,zipcode,Pep
ZCTA5 79355,48,1799,64038,813,91300,1353,472,1139,341,236,369,143,50,814,646,168,646,459,187,2018-01-01,zipcode,Plains
ZCTA5 79356,48,6100,48472,827,76500,5301,3161,4480,1770,1229,891,426,164,1806,1585,221,1585,1018,567,2018-01-01,zipcode,Post
ZCTA5 79357,48,2166,37917,540,54900,1615,648,1415,341,484,423,128,39,1030,759,271,759,549,210,2018-01-01,zipcode,Ralls
ZCTA5 79358,48,1088,55625,696,101200,860,340,760,197,168,204,147,44,487,408,79,408,323,85,2018-01-01,zipcode,Ropesville
ZCTA5 79359,48,2944,46536,671,46000,1965,801,1655,530,617,372,104,32,1028,845,183,845,589,256,2018-01-01,zipcode,Seagraves
ZCTA5 79360,48,16243,58649,737,150200,10948,3911,8837,3531,2546,1660,805,295,5069,4575,494,4575,3633,942,2018-01-01,zipcode,Seminole
ZCTA5 79363,48,5611,59708,822,147200,4105,1426,3476,334,1198,1024,571,349,2078,1913,165,1913,1394,519,2018-01-01,zipcode,Shallowater
ZCTA5 79364,48,7801,48631,680,76600,5835,2170,5183,805,1768,1636,667,307,3514,3017,497,3017,2109,908,2018-01-01,zipcode,Slaton
ZCTA5 79366,48,1056,106875,950,227200,885,276,809,19,159,211,261,159,501,444,57,444,402,42,2018-01-01,zipcode,Ransom canyon
ZCTA5 79367,48,719,40625,956,69100,536,150,405,63,135,151,40,16,269,237,32,237,171,66,2018-01-01,zipcode,Smyer
ZCTA5 79369,48,135,34000,-666666666,-666666666,108,57,108,7,63,22,0,16,54,54,0,54,54,0,2018-01-01,zipcode,Spade
ZCTA5 79370,48,1590,41089,478,54100,1326,647,1159,247,390,337,104,81,1180,599,581,599,458,141,2018-01-01,zipcode,Spur
ZCTA5 79371,48,1416,53750,596,63800,1137,360,961,290,255,272,110,34,663,537,126,537,431,106,2018-01-01,zipcode,Sudan
ZCTA5 79372,48,1209,51563,667,78900,948,339,763,197,200,212,99,55,522,431,91,431,327,104,2018-01-01,zipcode,Sundown
ZCTA5 79373,48,2875,37713,638,74500,2186,1014,1873,418,643,480,242,90,1405,1137,268,1137,754,383,2018-01-01,zipcode,Tahoka
ZCTA5 79376,48,32,-666666666,-666666666,63300,24,13,24,0,0,11,13,0,34,18,16,18,18,0,2018-01-01,zipcode,Tokio
ZCTA5 79377,48,233,55625,-666666666,78000,162,50,143,37,46,33,17,10,135,85,50,85,64,21,2018-01-01,zipcode,Welch
ZCTA5 79378,48,276,61667,1500,-666666666,210,87,194,79,64,37,10,4,127,100,27,100,83,17,2018-01-01,zipcode,Wellman
ZCTA5 79379,48,594,54375,429,71000,487,216,404,67,154,133,31,19,224,177,47,177,138,39,2018-01-01,zipcode,Whiteface
ZCTA5 79380,48,124,39063,681,51000,101,29,92,32,23,19,10,8,66,53,13,53,39,14,2018-01-01,zipcode,Whitharral
ZCTA5 79381,48,1601,50990,802,120200,1212,455,1010,243,251,305,164,47,603,507,96,507,384,123,2018-01-01,zipcode,Wilson
ZCTA5 79382,48,7243,73548,977,182100,5135,1426,4388,493,916,1490,962,527,2793,2532,261,2532,1830,702,2018-01-01,zipcode,Wolfforth
ZCTA5 79401,48,8295,18798,969,77600,7565,3403,2637,518,668,882,248,321,4373,3321,1052,3321,330,2991,2018-01-01,zipcode,Lubbock
ZCTA5 79403,48,18147,38891,788,54600,13252,6083,11022,3031,4270,2950,578,193,6599,5766,833,5766,3463,2303,2018-01-01,zipcode,Lubbock
ZCTA5 79404,48,10400,32254,768,51900,7946,3610,6727,2069,2524,1645,331,158,3902,3299,603,3299,1903,1396,2018-01-01,zipcode,Lubbock
ZCTA5 79406,48,6880,-666666666,-666666666,-666666666,6880,4438,34,0,0,7,27,0,0,0,0,0,0,0,2018-01-01,zipcode,Lubbock
ZCTA5 79407,48,22065,42281,829,100600,17755,5300,13306,1388,4031,4444,2187,1256,10113,9145,968,9145,4177,4968,2018-01-01,zipcode,Lubbock
ZCTA5 79410,48,10160,40468,1132,138800,8818,3430,5088,676,963,1487,808,1154,4492,3939,553,3939,1468,2471,2018-01-01,zipcode,Lubbock
ZCTA5 79411,48,7564,34773,877,72800,6443,2174,4336,1299,1135,1065,577,260,3857,3230,627,3230,1156,2074,2018-01-01,zipcode,Lubbock
ZCTA5 79412,48,16590,35852,813,80100,12219,4561,9316,2763,3238,2221,737,357,6389,5582,807,5582,2823,2759,2018-01-01,zipcode,Lubbock
ZCTA5 79413,48,22181,52521,1063,137000,16957,5573,13535,1522,3225,4344,2912,1532,9567,8539,1028,8539,5002,3537,2018-01-01,zipcode,Lubbock
ZCTA5 79414,48,18608,42823,860,98700,14392,4259,11111,1673,2773,3704,1770,1191,8468,7834,634,7834,3232,4602,2018-01-01,zipcode,Lubbock
ZCTA5 79415,48,17243,30968,827,60500,13689,5149,9521,2566,2958,2554,832,611,7069,6257,812,6257,2380,3877,2018-01-01,zipcode,Lubbock
ZCTA5 79416,48,33796,53355,1048,128900,27170,8805,19865,1894,5038,6469,3758,2706,14671,13048,1623,13048,6423,6625,2018-01-01,zipcode,Lubbock
ZCTA5 79423,48,38547,68297,1020,150700,28953,8461,24422,1902,5682,7976,6092,2770,15509,14434,1075,14434,9979,4455,2018-01-01,zipcode,Lubbock
ZCTA5 79424,48,46174,78303,957,191600,35712,10510,30519,1722,5426,9554,8629,5188,19927,18627,1300,18627,12940,5687,2018-01-01,zipcode,Lubbock
ZCTA5 79501,48,2710,45563,676,76600,2050,946,1782,312,613,579,221,57,1522,1093,429,1093,788,305,2018-01-01,zipcode,Anson
ZCTA5 79502,48,1272,46136,499,57300,1011,469,901,101,394,298,69,39,837,536,301,536,400,136,2018-01-01,zipcode,Aspermont
ZCTA5 79503,48,94,-666666666,-666666666,83100,83,45,80,10,23,25,11,11,89,48,41,48,37,11,2018-01-01,zipcode,Avoca
ZCTA5 79504,48,3204,47202,587,78100,2643,1133,2260,281,716,745,399,119,1398,1127,271,1127,921,206,2018-01-01,zipcode,Baird
ZCTA5 79505,48,287,38333,716,44400,216,111,187,44,65,41,31,6,162,106,56,106,81,25,2018-01-01,zipcode,Benjamin
ZCTA5 79506,48,725,48750,533,69600,644,348,604,58,150,239,135,22,766,388,378,388,324,64,2018-01-01,zipcode,Blackwell
ZCTA5 79508,48,1599,76172,933,168800,1196,397,1035,61,378,308,254,34,614,528,86,528,429,99,2018-01-01,zipcode,Buffalo gap
ZCTA5 79510,48,7379,47819,877,96200,5775,2509,5035,575,2110,1429,674,247,3678,2782,896,2782,2313,469,2018-01-01,zipcode,Clyde
ZCTA5 79511,48,1165,53594,733,102200,880,354,812,142,261,300,95,14,573,471,102,471,410,61,2018-01-01,zipcode,Coahoma
ZCTA5 79512,48,7716,49010,671,73700,6523,4025,5183,1079,1940,1531,525,108,3581,2115,1466,2115,1615,500,2018-01-01,zipcode,Colorado city
ZCTA5 79517,48,203,95263,-666666666,168800,149,37,149,3,16,80,50,0,88,88,0,88,69,19,2018-01-01,zipcode,Fluvanna
ZCTA5 79518,48,30,81250,-666666666,-666666666,30,16,30,3,15,9,0,3,67,17,50,17,17,0,2018-01-01,zipcode,Girard
ZCTA5 79519,48,40,57656,-666666666,77700,40,19,40,0,11,9,14,6,58,27,31,27,27,0,2018-01-01,zipcode,Goldsboro
ZCTA5 79520,48,2290,53333,756,62300,1587,801,1307,202,546,397,123,39,1218,916,302,916,684,232,2018-01-01,zipcode,Hamlin
ZCTA5 79521,48,3761,47399,534,60700,3189,1517,2687,761,938,660,221,107,2166,1301,865,1301,987,314,2018-01-01,zipcode,Haskell
ZCTA5 79525,48,2207,52215,770,105700,1740,768,1522,210,470,533,283,26,1080,998,82,998,758,240,2018-01-01,zipcode,Hawley
ZCTA5 79526,48,975,58158,880,81100,792,364,706,100,298,163,97,48,526,408,118,408,335,73,2018-01-01,zipcode,Hermleigh
ZCTA5 79527,48,191,52857,-666666666,82500,166,74,128,26,40,43,19,0,213,80,133,80,69,11,2018-01-01,zipcode,Ira
ZCTA5 79528,48,719,44643,483,35000,577,273,526,101,176,123,68,58,418,302,116,302,208,94,2018-01-01,zipcode,Jayton
ZCTA5 79529,48,1476,46319,546,39900,1094,521,886,182,237,269,127,71,687,493,194,493,425,68,2018-01-01,zipcode,Knox city
ZCTA5 79530,48,484,59148,-666666666,52000,411,116,386,65,151,80,83,7,250,213,37,213,185,28,2018-01-01,zipcode,Lawn
ZCTA5 79532,48,696,52014,764,50900,521,184,461,125,160,139,30,7,377,257,120,257,215,42,2018-01-01,zipcode,Loraine
ZCTA5 79533,48,412,46042,384,31300,355,135,318,69,81,104,60,4,242,160,82,160,113,47,2018-01-01,zipcode,Lueders
ZCTA5 79534,48,83,-666666666,-666666666,118800,80,45,75,12,16,19,15,13,85,40,45,40,34,6,2018-01-01,zipcode,Mc caulley
ZCTA5 79535,48,157,65417,-666666666,56200,146,110,136,8,45,68,13,2,110,79,31,79,78,1,2018-01-01,zipcode,Maryneal
ZCTA5 79536,48,4879,45250,835,75600,3828,1569,3443,446,1352,1133,376,136,2282,1879,403,1879,1462,417,2018-01-01,zipcode,Merkel
ZCTA5 79537,48,30,-666666666,-666666666,-666666666,30,25,30,0,25,0,5,0,33,19,14,19,19,0,2018-01-01,zipcode,Nolan
ZCTA5 79538,48,238,54531,-666666666,112500,209,97,171,23,42,57,40,9,168,105,63,105,98,7,2018-01-01,zipcode,Novice
ZCTA5 79539,48,169,67639,755,37500,159,73,135,32,29,33,28,13,121,81,40,81,66,15,2018-01-01,zipcode,O brien
ZCTA5 79540,48,77,88000,-666666666,80000,63,14,63,4,28,20,11,0,52,32,20,32,32,0,2018-01-01,zipcode,Old glory
ZCTA5 79541,48,985,-666666666,-666666666,219000,748,253,580,0,182,123,55,220,364,336,28,336,260,76,2018-01-01,zipcode,Ovalo
ZCTA5 79543,48,1179,46696,675,62200,906,428,790,109,268,270,121,22,585,449,136,449,358,91,2018-01-01,zipcode,Roby
ZCTA5 79544,48,567,36458,694,27500,457,202,396,128,110,118,22,18,316,219,97,219,163,56,2018-01-01,zipcode,Rochester
ZCTA5 79545,48,1872,52000,930,78200,1455,563,1171,190,327,328,254,72,886,674,212,674,563,111,2018-01-01,zipcode,Roscoe
ZCTA5 79546,48,1700,37500,517,54700,1381,603,1180,194,439,330,180,37,1111,778,333,778,506,272,2018-01-01,zipcode,Rotan
ZCTA5 79547,48,741,26641,613,32100,595,335,542,171,189,110,54,18,451,311,140,311,230,81,2018-01-01,zipcode,Rule
ZCTA5 79548,48,178,50833,-666666666,132100,136,67,120,16,50,20,27,7,138,64,74,64,52,12,2018-01-01,zipcode,Rule
ZCTA5 79549,48,16024,55819,762,88300,12286,5805,10380,2374,3301,3030,1042,633,6550,5379,1171,5379,4088,1291,2018-01-01,zipcode,Snyder
ZCTA5 79553,48,3305,37819,575,60200,2624,1440,2374,357,1015,587,290,125,2083,1573,510,1573,1094,479,2018-01-01,zipcode,Stamford
ZCTA5 79556,48,12914,44048,685,73200,9902,4191,8268,1635,2753,2769,804,307,5947,4651,1296,4651,3001,1650,2018-01-01,zipcode,Sweetwater
ZCTA5 79560,48,193,48500,910,90600,172,67,151,20,65,46,14,6,123,88,35,88,61,27,2018-01-01,zipcode,Sylvester
ZCTA5 79561,48,716,48906,619,58300,562,243,474,54,162,201,31,26,333,273,60,273,202,71,2018-01-01,zipcode,Trent
ZCTA5 79562,48,3809,84872,1016,202000,2892,806,2490,49,497,981,682,281,1428,1295,133,1295,1208,87,2018-01-01,zipcode,Tuscola
ZCTA5 79563,48,1175,40536,841,65400,848,321,699,118,407,133,24,17,473,399,74,399,290,109,2018-01-01,zipcode,Tye
ZCTA5 79565,48,203,63000,-666666666,-666666666,169,71,149,21,54,50,24,0,124,82,42,82,75,7,2018-01-01,zipcode,Westbrook
ZCTA5 79566,48,376,-666666666,-666666666,231600,327,157,301,34,70,104,71,22,232,162,70,162,129,33,2018-01-01,zipcode,Wingate
ZCTA5 79567,48,3352,37151,608,53700,2496,1026,2034,624,653,423,238,96,1657,1202,455,1202,757,445,2018-01-01,zipcode,Winters
ZCTA5 79601,48,27379,39364,789,99100,24287,13875,17367,3385,6102,4885,1849,1146,9412,7611,1801,7611,3522,4089,2018-01-01,zipcode,Abilene
ZCTA5 79602,48,24672,62652,906,157900,18246,6208,15403,1688,4169,4944,2955,1647,9181,8197,984,8197,6013,2184,2018-01-01,zipcode,Abilene
ZCTA5 79603,48,23064,39586,845,74500,17458,6256,14033,2918,4979,4151,1640,345,9666,8364,1302,8364,5178,3186,2018-01-01,zipcode,Abilene
ZCTA5 79605,48,29639,46859,910,105400,23462,7741,18636,2051,6151,6439,2679,1316,13228,11114,2114,11114,5952,5162,2018-01-01,zipcode,Abilene
ZCTA5 79606,48,25290,62774,969,177000,19620,6530,16120,988,3836,6234,3182,1880,11124,10108,1016,10108,5470,4638,2018-01-01,zipcode,Abilene
ZCTA5 79607,48,3268,50455,1213,-666666666,2308,314,976,14,183,582,153,44,721,628,93,628,0,628,2018-01-01,zipcode,Dyess afb
ZCTA5 79699,48,112,-666666666,-666666666,-666666666,112,64,0,0,0,0,0,0,103,0,103,0,0,0,2018-01-01,zipcode,Abilene
ZCTA5 79701,48,30697,59602,969,120900,22548,7529,18546,5849,5033,4727,2299,638,10680,9656,1024,9656,6534,3122,2018-01-01,zipcode,Midland
ZCTA5 79703,48,23111,74688,1342,152700,17340,4990,14039,2829,4487,4930,1323,470,8132,7646,486,7646,5272,2374,2018-01-01,zipcode,Midland
ZCTA5 79705,48,41242,86860,1273,235600,31553,9193,26772,3390,5876,8086,6680,2740,15666,14442,1224,14442,9858,4584,2018-01-01,zipcode,Midland
ZCTA5 79706,48,25919,76940,1190,163100,17416,5309,14903,2598,4822,4821,2100,562,8381,7795,586,7795,6027,1768,2018-01-01,zipcode,Midland
ZCTA5 79707,48,39020,96667,1290,289900,29705,8036,25410,1772,5645,7878,6977,3138,15300,14550,750,14550,8718,5832,2018-01-01,zipcode,Midland
ZCTA5 79713,48,384,37411,513,112500,298,149,258,54,79,63,32,30,191,165,26,165,120,45,2018-01-01,zipcode,Ackerly
ZCTA5 79714,48,17818,74233,1000,135600,12916,4291,10610,2695,3898,2914,705,398,6207,5508,699,5508,4024,1484,2018-01-01,zipcode,Andrews
ZCTA5 79718,48,886,40521,756,51600,742,241,579,122,198,148,100,11,434,311,123,311,213,98,2018-01-01,zipcode,Balmorhea
ZCTA5 79719,48,598,49375,740,38900,397,162,294,104,80,92,12,6,211,162,49,162,123,39,2018-01-01,zipcode,Barstow
ZCTA5 79720,48,35357,51873,875,93300,28538,13419,24037,4963,8099,7991,2119,865,12589,10540,2049,10540,6925,3615,2018-01-01,zipcode,Big spring
ZCTA5 79730,48,259,44491,-666666666,27300,216,95,209,157,45,5,1,1,136,89,47,89,82,7,2018-01-01,zipcode,Coyanosa
ZCTA5 79731,48,4792,70710,740,93600,3447,1394,2866,668,857,974,269,98,1656,1411,245,1411,1207,204,2018-01-01,zipcode,Crane
ZCTA5 79733,48,224,51875,433,72000,161,60,155,33,42,48,22,10,73,69,4,69,42,27,2018-01-01,zipcode,Forsan
ZCTA5 79734,48,2142,54097,687,114300,1798,912,1632,240,371,446,263,312,1719,990,729,990,830,160,2018-01-01,zipcode,Fort davis
ZCTA5 79735,48,13734,47458,894,77300,10670,5478,9208,2881,3426,2091,477,333,4705,3825,880,3825,2676,1149,2018-01-01,zipcode,Fort stockton
ZCTA5 79738,48,270,77500,-666666666,-666666666,228,109,190,6,65,48,38,33,161,106,55,106,75,31,2018-01-01,zipcode,Gail
ZCTA5 79739,48,1213,66696,825,251200,982,413,771,240,153,211,86,81,474,363,111,363,256,107,2018-01-01,zipcode,Garden city
ZCTA5 79741,48,202,35625,-666666666,69600,195,107,184,11,70,74,24,5,134,115,19,115,97,18,2018-01-01,zipcode,Goldsmith
ZCTA5 79742,48,470,45000,733,33900,381,161,333,114,108,61,35,15,226,178,48,178,148,30,2018-01-01,zipcode,Grandfalls
ZCTA5 79743,48,309,89063,406,60000,243,69,211,21,75,61,29,25,171,107,64,107,60,47,2018-01-01,zipcode,Imperial
ZCTA5 79744,48,1320,65885,721,101400,1039,301,823,160,238,271,114,40,545,459,86,459,354,105,2018-01-01,zipcode,Iraan
ZCTA5 79745,48,6967,56781,874,65200,5205,2134,4052,1427,1123,1177,228,97,2699,2289,410,2289,1872,417,2018-01-01,zipcode,Kermit
ZCTA5 79748,48,250,49167,-666666666,53300,183,92,145,77,35,17,13,3,111,70,41,70,62,8,2018-01-01,zipcode,Knott
ZCTA5 79749,48,363,79583,447,182500,291,118,235,43,41,57,61,33,132,113,19,113,81,32,2018-01-01,zipcode,Lenorah
ZCTA5 79752,48,2444,45938,779,59900,1765,854,1471,319,596,407,76,73,1090,839,251,839,629,210,2018-01-01,zipcode,Mc camey
ZCTA5 79754,48,102,81875,-666666666,-666666666,78,42,75,17,15,43,0,0,68,33,35,33,21,12,2018-01-01,zipcode,Mentone
ZCTA5 79755,48,111,45833,707,197500,103,39,103,26,19,44,14,0,64,58,6,58,23,35,2018-01-01,zipcode,Midkiff
ZCTA5 79756,48,9678,68891,911,89100,7344,2922,6052,1227,2076,1880,603,266,3948,3303,645,3303,2311,992,2018-01-01,zipcode,Monahans
ZCTA5 79758,48,2306,100298,899,250300,1564,375,1400,32,522,646,200,0,887,768,119,768,621,147,2018-01-01,zipcode,Gardendale
ZCTA5 79759,48,16,-666666666,-666666666,-666666666,16,0,16,0,16,0,0,0,8,8,0,8,8,0,2018-01-01,zipcode,Notrees
ZCTA5 79761,48,33960,54791,952,127200,25365,7959,20113,5186,6082,5732,2407,706,12801,11322,1479,11322,7079,4243,2018-01-01,zipcode,Odessa
ZCTA5 79762,48,43881,64889,1090,162100,32908,8862,26698,3655,7926,9364,3962,1791,17600,15683,1917,15683,8757,6926,2018-01-01,zipcode,Odessa
ZCTA5 79763,48,38955,53772,920,105800,27579,9694,22435,7261,6712,6460,1572,430,12890,11703,1187,11703,7885,3818,2018-01-01,zipcode,Odessa
ZCTA5 79764,48,21685,53234,1034,94000,15811,5717,12874,4132,4378,3419,720,225,7865,7205,660,7205,5393,1812,2018-01-01,zipcode,Odessa
ZCTA5 79765,48,14782,96739,1425,223900,10828,2848,9201,847,2079,2824,2233,1218,5607,5272,335,5272,3785,1487,2018-01-01,zipcode,Odessa
ZCTA5 79766,48,6815,53793,961,98700,4676,2149,3646,1442,1127,844,208,25,1951,1788,163,1788,1445,343,2018-01-01,zipcode,Odessa
ZCTA5 79770,48,69,-666666666,-666666666,-666666666,38,19,38,0,0,38,0,0,76,19,57,19,19,0,2018-01-01,zipcode,Orla
ZCTA5 79772,48,13875,59420,845,64900,11124,5659,9270,3479,2562,2298,643,288,3926,3282,644,3282,2321,961,2018-01-01,zipcode,Pecos
ZCTA5 79777,48,236,54219,-666666666,63900,153,62,130,15,55,27,33,0,121,81,40,81,41,40,2018-01-01,zipcode,Pyote
ZCTA5 79778,48,1071,69375,510,84600,803,322,729,158,312,202,48,9,476,400,76,400,300,100,2018-01-01,zipcode,Rankin
ZCTA5 79780,48,250,47500,-666666666,-666666666,173,64,160,42,32,57,29,0,153,102,51,102,73,29,2018-01-01,zipcode,Saragosa
ZCTA5 79781,48,266,43375,680,31800,201,43,177,6,74,70,3,24,186,109,77,109,86,23,2018-01-01,zipcode,Sheffield
ZCTA5 79782,48,4618,67188,827,128800,3295,1139,2667,659,820,677,381,130,1483,1297,186,1297,995,302,2018-01-01,zipcode,Stanton
ZCTA5 79783,48,284,118333,-666666666,175000,206,76,197,12,81,67,24,13,101,84,17,84,72,12,2018-01-01,zipcode,Tarzan
ZCTA5 79785,48,77,95625,-666666666,-666666666,71,28,66,13,15,23,15,0,64,27,37,27,27,0,2018-01-01,zipcode,Toyah
ZCTA5 79788,48,556,54375,680,43500,417,159,377,62,198,103,12,2,245,200,45,200,154,46,2018-01-01,zipcode,Wickett
ZCTA5 79789,48,783,71094,740,50300,510,182,443,73,145,150,61,14,306,259,47,259,203,56,2018-01-01,zipcode,Wink
ZCTA5 79821,48,7482,36513,722,96800,5747,2958,4877,1218,1363,1741,386,169,2057,1905,152,1905,1419,486,2018-01-01,zipcode,Anthony
ZCTA5 79830,48,7883,44395,695,153100,6456,2585,5622,842,1127,1378,1435,840,4353,3284,1069,3284,1858,1426,2018-01-01,zipcode,Alpine
ZCTA5 79831,48,4,-666666666,-666666666,-666666666,4,0,4,0,0,0,4,0,18,4,14,4,4,0,2018-01-01,zipcode,
ZCTA5 79834,48,213,46094,582,-666666666,189,38,179,16,16,80,51,16,131,85,46,85,5,80,2018-01-01,zipcode,Big bend national park
ZCTA5 79835,48,10810,29827,773,80600,7726,3479,6011,2486,1476,1201,591,257,3486,3063,423,3063,1988,1075,2018-01-01,zipcode,Canutillo
ZCTA5 79836,48,5796,38668,678,85100,4184,1602,3373,1017,952,935,292,177,1853,1686,167,1686,1294,392,2018-01-01,zipcode,Clint
ZCTA5 79837,48,278,21563,-666666666,28400,206,113,206,88,40,63,9,6,284,140,144,140,85,55,2018-01-01,zipcode,Dell city
ZCTA5 79838,48,6376,27458,530,58900,4658,2343,3892,2111,1000,664,99,18,2198,1917,281,1917,1189,728,2018-01-01,zipcode,Fabens
ZCTA5 79839,48,2057,27241,624,48800,1511,768,1233,672,414,106,41,0,693,432,261,432,347,85,2018-01-01,zipcode,Fort hancock
ZCTA5 79842,48,434,47353,758,97000,390,173,357,40,60,101,112,44,394,206,188,206,151,55,2018-01-01,zipcode,Marathon
ZCTA5 79843,48,2317,39627,825,144000,1667,535,1461,352,307,303,271,228,1424,837,587,837,525,312,2018-01-01,zipcode,Marfa
ZCTA5 79845,48,4689,25236,427,52000,3678,2020,3106,1816,562,304,338,86,2485,1761,724,1761,878,883,2018-01-01,zipcode,Presidio
ZCTA5 79846,48,105,-666666666,-666666666,-666666666,39,27,23,23,0,0,0,0,66,17,49,17,0,17,2018-01-01,zipcode,Redford
ZCTA5 79847,48,156,47431,2167,22500,104,40,104,0,53,34,17,0,129,81,48,81,36,45,2018-01-01,zipcode,Salt flat
ZCTA5 79848,48,802,30313,697,70000,713,370,669,127,206,258,51,27,736,365,371,365,312,53,2018-01-01,zipcode,Sanderson
ZCTA5 79849,48,12780,32279,706,72700,9217,4063,7157,3231,1894,1252,759,21,3814,3352,462,3352,2417,935,2018-01-01,zipcode,San elizario
ZCTA5 79851,48,1428,43500,450,54100,1184,924,1019,488,273,186,70,2,332,176,156,176,100,76,2018-01-01,zipcode,Sierra blanca
ZCTA5 79852,48,682,26382,362,75500,608,336,570,94,167,159,94,56,590,363,227,363,267,96,2018-01-01,zipcode,Terlingua
ZCTA5 79853,48,2624,33600,490,61400,1794,774,1375,713,361,201,77,23,782,676,106,676,541,135,2018-01-01,zipcode,Tornillo
ZCTA5 79854,48,85,23693,-666666666,-666666666,79,44,79,14,28,21,3,13,140,57,83,57,17,40,2018-01-01,zipcode,Valentine
ZCTA5 79855,48,2155,28750,435,56600,1738,713,1535,517,569,316,104,29,975,659,316,659,456,203,2018-01-01,zipcode,Van horn
ZCTA5 79901,48,10138,13893,414,56000,8180,4981,6826,4117,1323,1064,264,58,4651,3835,816,3835,437,3398,2018-01-01,zipcode,El paso
ZCTA5 79902,48,20543,32868,613,162900,17425,7265,14440,3365,2506,4021,2545,2003,9367,8050,1317,8050,3197,4853,2018-01-01,zipcode,El paso
ZCTA5 79903,48,16399,31201,630,92700,13590,6069,11514,3757,2642,3258,1389,468,7087,6067,1020,6067,3412,2655,2018-01-01,zipcode,El paso
ZCTA5 79904,48,34461,35589,821,99800,24020,10298,19376,4450,5366,6645,2083,832,12528,11006,1522,11006,4495,6511,2018-01-01,zipcode,El paso
ZCTA5 79905,48,22447,22739,466,80500,17500,8698,14924,6518,4050,3362,722,272,8673,7683,990,7683,3941,3742,2018-01-01,zipcode,El paso
ZCTA5 79906,48,5139,52342,1357,-666666666,3174,876,1960,60,353,827,499,221,1464,1189,275,1189,0,1189,2018-01-01,zipcode,El paso
ZCTA5 79907,48,53277,31271,697,88900,41655,18897,33079,11257,10138,8234,2620,830,17744,16483,1261,16483,9790,6693,2018-01-01,zipcode,El paso
ZCTA5 79908,48,5907,64096,1564,-666666666,3970,610,2265,11,371,1222,440,221,911,854,57,854,0,854,2018-01-01,zipcode,El paso
ZCTA5 79911,48,5732,101516,1635,235900,4038,985,3474,40,278,1011,1004,1141,2083,1947,136,1947,1553,394,2018-01-01,zipcode,El paso
ZCTA5 79912,48,80264,58979,898,187800,61607,21186,50675,5404,7557,13416,14742,9556,32077,28539,3538,28539,15233,13306,2018-01-01,zipcode,El paso
ZCTA5 79915,48,35445,30536,604,87300,28497,13308,24182,8488,7215,6101,1836,542,13440,12274,1166,12274,7196,5078,2018-01-01,zipcode,El paso
ZCTA5 79916,48,3039,-666666666,-666666666,-666666666,3014,142,1147,11,162,604,242,128,6,6,0,6,0,6,2018-01-01,zipcode,Fort bliss
ZCTA5 79920,48,6,-666666666,-666666666,-666666666,6,0,0,0,0,0,0,0,0,0,0,0,0,0,2018-01-01,zipcode,
ZCTA5 79922,48,8236,72060,811,267100,6639,2501,5520,560,949,1462,1523,1026,2936,2611,325,2611,2231,380,2018-01-01,zipcode,El paso
ZCTA5 79924,48,59729,41476,839,98800,45280,19536,36443,7900,10317,12157,4502,1567,21792,19824,1968,19824,12469,7355,2018-01-01,zipcode,El paso
ZCTA5 79925,48,39711,47840,813,142400,31314,11122,25325,3070,6516,9236,3859,2644,16316,14669,1647,14669,7608,7061,2018-01-01,zipcode,El paso
ZCTA5 79927,48,41227,34371,736,88100,30611,12936,24078,9743,6865,5889,1163,418,11775,11119,656,11119,8458,2661,2018-01-01,zipcode,El paso
ZCTA5 79928,48,57324,51601,937,116600,39711,13383,31271,6885,8198,10572,4138,1478,16358,15201,1157,15201,12730,2471,2018-01-01,zipcode,El paso
ZCTA5 79930,48,28178,36584,777,93900,22411,8474,18413,5412,4155,5260,2491,1095,12036,10279,1757,10279,5015,5264,2018-01-01,zipcode,El paso
ZCTA5 79932,48,28682,63203,859,165200,21185,7213,17589,2397,3351,5490,4129,2222,9619,8986,633,8986,6547,2439,2018-01-01,zipcode,El paso
ZCTA5 79934,48,26289,68442,1127,138900,18673,5252,15293,1156,3160,5760,3339,1878,10120,8917,1203,8917,5977,2940,2018-01-01,zipcode,El paso
ZCTA5 79935,48,17434,51331,796,146700,14171,5661,11885,2118,2513,4103,2362,789,6709,6155,554,6155,3471,2684,2018-01-01,zipcode,El paso
ZCTA5 79936,48,112355,54692,992,127100,86878,29291,67931,9313,17305,24814,11744,4755,37263,35120,2143,35120,23975,11145,2018-01-01,zipcode,El paso
ZCTA5 79938,48,80143,57128,1030,145100,55019,17657,44372,7478,9061,16686,8228,2919,24392,22438,1954,22438,16749,5689,2018-01-01,zipcode,El paso
ZCTA5 79942,48,22,-666666666,-666666666,-666666666,22,0,22,0,12,0,10,0,10,10,0,10,10,0,2018-01-01,zipcode,El paso
ZCTA5 07001,34,17981,69849,1494,263700,14643,7577,13366,1027,6502,2480,1841,1516,5311,5022,289,5022,2531,2491,2019-01-01,zipcode,Avenel
ZCTA5 07002,34,65091,63947,1255,333700,51262,18247,45531,5192,14149,9235,11663,5292,27318,24967,2351,24967,9604,15363,2019-01-01,zipcode,Bayonne
ZCTA5 07003,34,49260,78034,1379,329900,39967,11505,34455,2803,9403,7939,9060,5250,19593,18577,1016,18577,9564,9013,2019-01-01,zipcode,Bloomfield
ZCTA5 07004,34,7390,122063,1916,517500,5997,2276,5515,335,1479,1088,1866,747,2798,2621,177,2621,2387,234,2019-01-01,zipcode,Fairfield
ZCTA5 07005,34,14939,111946,1409,466700,12233,3429,10490,559,2242,2166,3623,1900,5955,5489,466,5489,4011,1478,2019-01-01,zipcode,Boonton
ZCTA5 07006,34,25553,127921,1593,556500,20802,6589,18300,800,3121,3331,6530,4518,9974,9576,398,9576,7356,2220,2019-01-01,zipcode,Caldwell
ZCTA5 07008,34,23589,73347,1492,272200,18578,6531,16175,2333,5640,4276,2958,968,8399,7925,474,7925,4574,3351,2019-01-01,zipcode,Carteret
ZCTA5 07009,34,12516,123768,1540,473100,10559,4069,9334,430,2273,1672,3295,1664,4642,4530,112,4530,3626,904,2019-01-01,zipcode,Cedar grove
ZCTA5 07010,34,25126,72633,1468,447900,21730,7931,19006,1996,5161,3703,5157,2989,11323,10512,811,10512,4777,5735,2019-01-01,zipcode,Cliffside park
ZCTA5 07011,34,39783,59519,1409,312800,32425,10966,26711,4187,11191,5749,4120,1464,13697,12649,1048,12649,5959,6690,2019-01-01,zipcode,Clifton
ZCTA5 07012,34,12756,81361,1462,355000,10179,3779,9063,752,2327,1917,2599,1468,4831,4578,253,4578,2532,2046,2019-01-01,zipcode,Clifton
ZCTA5 07013,34,26536,92312,1343,365200,22680,8083,19946,2379,4771,4742,5290,2764,10751,10011,740,10011,6988,3023,2019-01-01,zipcode,Clifton
ZCTA5 07014,34,5300,89349,1446,326600,4158,1150,3717,181,1153,815,1046,522,2031,1844,187,1844,1331,513,2019-01-01,zipcode,Clifton
ZCTA5 07016,34,24014,129781,1705,486600,19228,6107,17052,745,3073,3493,5584,4157,9226,8894,332,8894,7030,1864,2019-01-01,zipcode,Cranford
ZCTA5 07017,34,36471,48673,1069,222900,28658,9298,24478,2973,8985,7709,3308,1503,15286,13167,2119,13167,3772,9395,2019-01-01,zipcode,East orange
ZCTA5 07018,34,27942,47094,1163,212400,22080,7771,18015,2465,6449,5571,2405,1125,12412,10377,2035,10377,2247,8130,2019-01-01,zipcode,East orange
ZCTA5 07020,34,12403,127221,2506,600600,10240,2973,9474,251,1277,983,4131,2832,6182,5751,431,5751,2026,3725,2019-01-01,zipcode,Edgewater
ZCTA5 07021,34,2095,213309,2250,848500,1632,561,1442,19,106,163,569,585,838,765,73,765,718,47,2019-01-01,zipcode,Essex fells
ZCTA5 07022,34,14258,57698,1467,364900,12022,3722,10479,2809,3527,1623,1963,557,5509,5236,273,5236,1672,3564,2019-01-01,zipcode,Fairview
ZCTA5 07023,34,7660,147905,2710,467800,5780,1845,5083,62,939,692,1869,1521,2563,2506,57,2506,2217,289,2019-01-01,zipcode,Fanwood
ZCTA5 07024,34,37430,83767,1923,324600,32267,12443,29463,1610,5157,5139,10513,7044,19014,17479,1535,17479,10375,7104,2019-01-01,zipcode,Fort lee
ZCTA5 07026,34,31695,62867,1327,338400,25351,8830,21693,3094,8874,5369,3166,1190,12339,11563,776,11563,4673,6890,2019-01-01,zipcode,Garfield
ZCTA5 07027,34,4338,88892,1551,380800,3609,1029,3158,174,901,779,857,447,1785,1725,60,1725,1016,709,2019-01-01,zipcode,Garwood
ZCTA5 07028,34,7724,198625,1702,649500,5495,1502,4914,71,464,544,2193,1642,2544,2495,49,2495,2279,216,2019-01-01,zipcode,Glen ridge
ZCTA5 07029,34,19901,69389,1468,328600,16118,4790,13926,2294,3830,2455,2697,2650,7627,7266,361,7266,1987,5279,2019-01-01,zipcode,Harrison
ZCTA5 07030,34,53193,147620,2315,720700,46021,9213,40595,1789,3186,2939,20579,12102,27400,25182,2218,25182,8263,16919,2019-01-01,zipcode,Hoboken
ZCTA5 07031,34,15677,84527,1375,363400,13178,4324,11711,1038,3857,2852,2663,1301,6653,6384,269,6384,3350,3034,2019-01-01,zipcode,North arlington
ZCTA5 07032,34,41368,70658,1305,333100,33233,11963,28908,5268,10054,6148,5194,2244,14313,13351,962,13351,6248,7103,2019-01-01,zipcode,Kearny
ZCTA5 07033,34,8161,93208,1521,345500,6382,2069,5370,618,1659,1542,1219,332,2875,2733,142,2733,1909,824,2019-01-01,zipcode,Kenilworth
ZCTA5 07034,34,9143,86799,1203,326300,7615,2251,6739,594,1592,1410,1988,1155,3531,3318,213,3318,2073,1245,2019-01-01,zipcode,Lake hiawatha
ZCTA5 07035,34,10487,98136,1643,333400,8746,2909,7681,566,2179,2060,1797,1079,3956,3726,230,3726,2937,789,2019-01-01,zipcode,Lincoln park
ZCTA5 07036,34,43845,72432,1273,280300,36004,11482,30728,4476,10127,9137,4732,2256,16621,15406,1215,15406,8671,6735,2019-01-01,zipcode,Linden
ZCTA5 07039,34,29846,166629,2811,627000,23254,8486,20745,672,2638,2479,7286,7670,10611,10225,386,10225,8854,1371,2019-01-01,zipcode,Livingston
ZCTA5 07040,34,24696,138870,1679,529400,18604,4892,16144,608,2398,3271,5069,4798,8326,7945,381,7945,6148,1797,2019-01-01,zipcode,Maplewood
ZCTA5 07041,34,6770,134732,1691,789200,5077,1574,4631,146,495,555,1543,1892,2679,2513,166,2513,1647,866,2019-01-01,zipcode,Millburn
ZCTA5 07042,34,26293,108708,1668,516500,20934,6067,18409,755,2684,3270,6117,5583,11272,10436,836,10436,5286,5150,2019-01-01,zipcode,Montclair
ZCTA5 07043,34,12567,205735,2007,750800,9339,3007,7880,131,370,760,3151,3468,4264,4132,132,4132,3405,727,2019-01-01,zipcode,Montclair
ZCTA5 07044,34,13622,125000,1685,454500,10782,3115,9937,135,1565,1876,3524,2837,5626,5310,316,5310,4278,1032,2019-01-01,zipcode,Verona
ZCTA5 07045,34,10670,169095,2976,590700,8731,3102,7703,287,1342,1121,2548,2405,4013,3883,130,3883,3734,149,2019-01-01,zipcode,Montville
ZCTA5 07046,34,4305,242083,1454,862400,3195,1288,2603,44,103,220,980,1256,1416,1357,59,1357,1295,62,2019-01-01,zipcode,Mountain lakes
ZCTA5 07047,34,61619,63908,1437,350600,50291,15718,43362,8139,12810,10103,8459,3851,23287,21794,1493,21794,8756,13038,2019-01-01,zipcode,North bergen
ZCTA5 07050,34,30302,43039,1160,236400,23678,8676,20182,3688,6864,5523,2719,1388,12737,11682,1055,11682,2391,9291,2019-01-01,zipcode,Orange
ZCTA5 07052,34,47342,105584,1486,385200,38721,12512,33960,2478,6459,6698,10845,7480,17634,16414,1220,16414,11413,5001,2019-01-01,zipcode,West orange
ZCTA5 07054,34,29144,99251,1377,461700,24542,7673,21547,1483,3842,3700,7300,5222,11564,11164,400,11164,5613,5551,2019-01-01,zipcode,Parsippany
ZCTA5 07055,34,70090,40944,1183,332600,49831,18902,40221,13376,14220,6288,4248,2089,21222,19854,1368,19854,4444,15410,2019-01-01,zipcode,Passaic
ZCTA5 07057,34,11540,68845,1237,375800,9928,3336,8751,785,3167,1986,1960,853,5101,4683,418,4683,1961,2722,2019-01-01,zipcode,Wallington
ZCTA5 07058,34,5109,132402,1850,643100,3778,767,3467,91,428,616,1359,973,1910,1825,85,1825,1036,789,2019-01-01,zipcode,Pine brook
ZCTA5 07059,34,15689,170096,1652,789600,12597,4667,10961,390,1807,1621,3472,3671,5439,5192,247,5192,4788,404,2019-01-01,zipcode,Warren
ZCTA5 07060,34,45520,58707,1229,275200,35775,10231,29929,7440,9146,7016,4112,2215,15834,14971,863,14971,6018,8953,2019-01-01,zipcode,Plainfield
ZCTA5 07062,34,12745,69590,1308,243200,9352,3101,8145,830,2823,2377,1376,739,4552,4029,523,4029,2397,1632,2019-01-01,zipcode,Plainfield
ZCTA5 07063,34,13589,65377,1352,257700,10379,3308,8882,1769,3475,2023,1035,580,4325,3988,337,3988,2479,1509,2019-01-01,zipcode,Plainfield
ZCTA5 07064,34,3864,89022,1365,293200,3142,1079,2701,340,986,691,438,246,1442,1316,126,1316,1109,207,2019-01-01,zipcode,Port reading
ZCTA5 07065,34,29543,78946,1310,272700,24236,7331,21069,2258,7208,5226,4140,2237,12175,11304,871,11304,6748,4556,2019-01-01,zipcode,Rahway
ZCTA5 07066,34,15735,109924,1433,446700,13382,4133,11667,870,3257,2502,3178,1860,6069,5932,137,5932,4625,1307,2019-01-01,zipcode,Clark
ZCTA5 07067,34,18205,113136,1637,364600,15181,4684,13423,843,3942,3182,3387,2069,6361,6197,164,6197,5461,736,2019-01-01,zipcode,Colonia
ZCTA5 07068,34,5834,129006,2579,485100,4801,1780,4351,135,808,775,1474,1159,2518,2349,169,2349,1820,529,2019-01-01,zipcode,Roseland
ZCTA5 07069,34,6191,156408,2021,660400,5106,2020,4506,58,918,983,1209,1338,2405,2099,306,2099,1744,355,2019-01-01,zipcode,Watchung
ZCTA5 07070,34,18398,101473,1440,473500,15051,5035,12918,616,2810,2647,4180,2665,7227,6977,250,6977,4457,2520,2019-01-01,zipcode,Rutherford
ZCTA5 07071,34,22298,79985,1420,375600,18769,6472,16394,1738,5156,3775,3897,1828,9241,8738,503,8738,4928,3810,2019-01-01,zipcode,Lyndhurst
ZCTA5 07072,34,6178,88827,1290,408600,5309,1854,4734,616,1332,1021,1168,597,2606,2414,192,2414,1524,890,2019-01-01,zipcode,Carlstadt
ZCTA5 07073,34,9584,80896,1586,381100,8006,2774,7187,502,1895,1791,2313,686,4239,3966,273,3966,1356,2610,2019-01-01,zipcode,East rutherford
ZCTA5 07074,34,2716,66976,1199,360100,2147,667,1924,202,700,514,343,165,1022,937,85,937,669,268,2019-01-01,zipcode,Moonachie
ZCTA5 07075,34,8769,110625,1779,411800,7305,2407,6107,220,1489,1481,1750,1167,3365,3315,50,3315,2340,975,2019-01-01,zipcode,Wood ridge
ZCTA5 07076,34,24162,131630,1584,497400,19547,6072,17343,619,3171,2995,5896,4662,9070,8747,323,8747,7168,1579,2019-01-01,zipcode,Scotch plains
ZCTA5 07077,34,2627,76813,1353,285900,2232,694,2000,165,610,494,496,235,1088,970,118,970,667,303,2019-01-01,zipcode,Sewaren
ZCTA5 07078,34,13372,250001,2667,1391900,9437,3286,8304,187,325,503,2830,4459,4244,4143,101,4143,3736,407,2019-01-01,zipcode,Short hills
ZCTA5 07079,34,16662,138525,1697,604300,13760,4886,10035,342,1106,1438,3867,3282,5633,5162,471,5162,3522,1640,2019-01-01,zipcode,South orange
ZCTA5 07080,34,23956,101565,1702,340200,19312,5609,17017,1543,5198,4341,3873,2062,8208,7924,284,7924,6694,1230,2019-01-01,zipcode,South plainfield
ZCTA5 07081,34,17406,111899,1814,436900,13957,4092,12556,501,2456,1842,4224,3533,7103,6901,202,6901,4239,2662,2019-01-01,zipcode,Springfield
ZCTA5 07082,34,5011,130905,2375,577200,3886,1241,3166,66,571,674,1099,756,1777,1579,198,1579,1468,111,2019-01-01,zipcode,Towaco
ZCTA5 07083,34,55162,90971,1542,332300,46649,15323,39967,4454,12062,8954,9615,4882,20001,19094,907,19094,14341,4753,2019-01-01,zipcode,Union
ZCTA5 07086,34,14604,101449,1531,650400,12418,3048,11572,861,2356,1630,3697,3028,7361,6633,728,6633,1999,4634,2019-01-01,zipcode,Weehawken
ZCTA5 07087,34,68256,48965,1225,340900,54636,16839,46421,13209,15218,7962,6686,3346,26904,24512,2392,24512,5102,19410,2019-01-01,zipcode,Union city
ZCTA5 07088,34,3249,64130,1602,237900,2950,1081,2533,364,864,776,424,105,1367,1246,121,1246,762,484,2019-01-01,zipcode,Vauxhall
ZCTA5 07090,34,29856,171064,1608,743800,22132,7558,19411,425,2163,2443,7650,6730,10899,10280,619,10280,8465,1815,2019-01-01,zipcode,Westfield
ZCTA5 07092,34,6890,120750,1739,627300,5536,2412,4971,184,1064,1024,1581,1118,2546,2528,18,2528,2302,226,2019-01-01,zipcode,Mountainside
ZCTA5 07093,34,63979,57473,1323,325900,51973,15337,46086,11389,12718,7583,9453,4943,26024,24117,1907,24117,5553,18564,2019-01-01,zipcode,West new york
ZCTA5 07094,34,20125,114821,1689,460800,16770,5929,14883,1370,3394,2697,4535,2887,8033,7557,476,7557,4395,3162,2019-01-01,zipcode,Secaucus
ZCTA5 07095,34,19989,86615,1697,279800,16043,5177,14332,1228,3969,3586,3402,2147,7975,7438,537,7438,4179,3259,2019-01-01,zipcode,Woodbridge
ZCTA5 07102,34,13505,25677,821,244800,11395,5930,8641,2517,2563,1836,861,864,5824,5501,323,5501,445,5056,2019-01-01,zipcode,Newark
ZCTA5 07103,34,32881,30108,1053,186200,25221,10979,19948,4461,7007,5299,2114,1067,13858,11835,2023,11835,2711,9124,2019-01-01,zipcode,Newark
ZCTA5 07104,34,51075,37424,1083,276700,39306,14049,32755,8472,10093,8130,4457,1603,20774,18934,1840,18934,4319,14615,2019-01-01,zipcode,Newark
ZCTA5 07105,34,52008,44785,1218,326500,41366,14666,36267,12276,13382,5452,3610,1547,18216,17320,896,17320,3773,13547,2019-01-01,zipcode,Newark
ZCTA5 07106,34,33851,41195,1073,218300,26829,8783,22365,3141,8431,6877,2678,1238,13945,11575,2370,11575,3650,7925,2019-01-01,zipcode,Newark
ZCTA5 07107,34,37684,31842,1047,235500,28264,10999,23473,6959,8169,5644,2015,686,15247,13207,2040,13207,2848,10359,2019-01-01,zipcode,Newark
ZCTA5 07108,34,23118,27000,956,203400,16728,6704,13887,2834,5566,3733,1384,370,11025,8928,2097,8928,1446,7482,2019-01-01,zipcode,Newark
ZCTA5 07109,34,36173,70670,1346,295600,29365,9259,24667,3240,8189,6756,4609,1873,13347,12189,1158,12189,6311,5878,2019-01-01,zipcode,Belleville
ZCTA5 07110,34,28397,99507,1349,387700,23240,6895,20626,1094,5354,4319,6043,3816,11418,11033,385,11033,7215,3818,2019-01-01,zipcode,Nutley
ZCTA5 07111,34,54079,45176,1048,182400,41550,12133,35503,5687,13268,9843,4555,2150,23816,20024,3792,20024,5590,14434,2019-01-01,zipcode,Irvington
ZCTA5 07112,34,25016,36246,1125,239000,19789,6095,16444,2135,5866,5669,2192,582,12022,9695,2327,9695,2590,7105,2019-01-01,zipcode,Newark
ZCTA5 07114,34,12024,29682,753,256900,10249,6755,9194,2385,4035,2082,572,120,4318,3375,943,3375,538,2837,2019-01-01,zipcode,Newark
ZCTA5 07201,34,28091,47630,1181,266900,21559,6941,18450,4755,6763,4513,1762,657,9701,8651,1050,8651,1992,6659,2019-01-01,zipcode,Elizabeth
ZCTA5 07202,34,41671,50970,1162,278100,32507,10403,27070,6786,10866,6192,2179,1047,14128,13097,1031,13097,3073,10024,2019-01-01,zipcode,Elizabeth
ZCTA5 07203,34,21637,64718,1183,225100,17541,5411,14527,1758,4922,4641,2264,942,8189,7402,787,7402,4226,3176,2019-01-01,zipcode,Roselle
ZCTA5 07204,34,13581,75000,1275,284000,10883,3130,9352,1072,2262,2276,2532,1210,5134,4948,186,4948,2860,2088,2019-01-01,zipcode,Roselle park
ZCTA5 07205,34,21928,75239,1395,259300,17814,4978,14974,1928,4836,4350,2658,1202,7760,7342,418,7342,4935,2407,2019-01-01,zipcode,Hillside
ZCTA5 07206,34,26995,42727,1191,253900,19162,6875,15708,6141,5936,2647,691,293,8801,7894,907,7894,1996,5898,2019-01-01,zipcode,Elizabethport
ZCTA5 07208,34,31556,49313,1130,324200,23977,6752,20570,4066,7418,4690,2888,1508,11796,11123,673,11123,2801,8322,2019-01-01,zipcode,Elizabeth
ZCTA5 07302,34,46585,136679,2384,695600,39876,7843,37710,1987,3459,3864,14650,13750,24898,22355,2543,22355,5840,16515,2019-01-01,zipcode,Jersey city
ZCTA5 07304,34,43327,48360,1161,304300,33662,11096,29684,4709,9518,5981,6752,2724,17849,16075,1774,16075,4649,11426,2019-01-01,zipcode,Jersey city
ZCTA5 07305,34,64994,55955,1210,311300,50698,18550,42365,6329,13955,9914,8142,4025,25242,22652,2590,22652,9121,13531,2019-01-01,zipcode,Jersey city
ZCTA5 07306,34,52093,59794,1209,358800,42826,15616,37259,5417,7704,6294,11437,6407,21830,20107,1723,20107,4571,15536,2019-01-01,zipcode,Jersey city
ZCTA5 07307,34,41411,63281,1337,406000,33462,10811,29259,4475,7308,5817,7465,4194,16988,15721,1267,15721,4956,10765,2019-01-01,zipcode,Jersey city
ZCTA5 07310,34,13148,147516,2915,765900,11720,3102,10172,187,552,484,3395,5554,6712,6097,615,6097,890,5207,2019-01-01,zipcode,Jersey city
ZCTA5 07311,34,352,188634,2904,-666666666,333,29,333,0,0,20,89,224,253,205,48,205,0,205,2019-01-01,zipcode,Jersey city
ZCTA5 07401,34,6765,170968,1919,757000,5107,1865,4408,78,312,768,1921,1329,2335,2210,125,2210,1848,362,2019-01-01,zipcode,Allendale
ZCTA5 07403,34,8009,94099,1645,303700,6539,1975,5211,280,1449,1191,1525,766,3050,2953,97,2953,1954,999,2019-01-01,zipcode,Bloomingdale
ZCTA5 07405,34,17508,116884,1413,451400,14267,4127,12282,429,2915,2434,4007,2497,6672,6394,278,6394,4916,1478,2019-01-01,zipcode,Butler
ZCTA5 07407,34,20059,77334,1660,362700,16138,5375,13814,1148,5214,3356,2939,1157,7120,6738,382,6738,3807,2931,2019-01-01,zipcode,Elmwood park
ZCTA5 07410,34,33017,123159,1560,424000,26576,8120,22945,1089,4007,4875,7589,5385,11761,11387,374,11387,9030,2357,2019-01-01,zipcode,Fair lawn
ZCTA5 07416,34,5523,68242,1098,194400,4542,1494,3974,321,1660,1189,617,187,2639,2232,407,2232,1650,582,2019-01-01,zipcode,Franklin
ZCTA5 07417,34,10946,172766,2642,945900,8880,3425,7781,110,974,1321,3091,2285,4012,3845,167,3845,3435,410,2019-01-01,zipcode,Franklin lakes
ZCTA5 07418,34,2367,133186,-666666666,271900,1937,512,1541,38,495,438,394,176,836,762,74,762,744,18,2019-01-01,zipcode,Glenwood
ZCTA5 07419,34,8799,88469,1400,222500,6985,2363,6277,331,1808,1864,1547,727,4026,3592,434,3592,2794,798,2019-01-01,zipcode,Hamburg
ZCTA5 07420,34,5148,83796,1620,269200,4241,1349,3732,498,1466,845,682,241,1833,1716,117,1716,1334,382,2019-01-01,zipcode,Haskell
ZCTA5 07421,34,7255,95383,1770,258600,5971,1687,5107,314,1885,1296,1088,524,3251,2653,598,2653,2384,269,2019-01-01,zipcode,Hewitt
ZCTA5 07422,34,6450,100000,1530,222500,5373,1494,4713,180,1558,1348,1104,523,3002,2334,668,2334,2224,110,2019-01-01,zipcode,Highland lakes
ZCTA5 07423,34,4094,216875,2453,756800,2919,867,2718,59,134,242,1307,976,1567,1438,129,1438,1322,116,2019-01-01,zipcode,Ho ho kus
ZCTA5 07424,34,27030,87125,1453,367400,22451,7530,18390,1489,5450,3867,5209,2375,10050,9756,294,9756,6610,3146,2019-01-01,zipcode,Little falls
ZCTA5 07430,34,26275,107081,2004,498400,22001,7749,17572,678,3404,3415,6512,3563,9922,9778,144,9778,7580,2198,2019-01-01,zipcode,Mahwah
ZCTA5 07432,34,7244,121162,1781,513400,5789,1840,5121,260,1413,1118,1507,823,2803,2669,134,2669,1790,879,2019-01-01,zipcode,Midland park
ZCTA5 07435,34,2509,123949,1057,381300,2012,629,1632,30,383,323,552,344,1304,852,452,852,751,101,2019-01-01,zipcode,Newfoundland
ZCTA5 07436,34,12972,126319,1642,468700,10332,3106,8735,302,2067,1967,2813,1586,4531,4237,294,4237,3836,401,2019-01-01,zipcode,Oakland
ZCTA5 07438,34,11567,111169,1484,350000,9587,3255,8055,370,2276,1939,2468,1002,4782,4386,396,4386,4078,308,2019-01-01,zipcode,Oak ridge
ZCTA5 07439,34,2327,89659,1440,223900,1946,481,1693,103,627,537,273,153,950,827,123,827,694,133,2019-01-01,zipcode,Ogdensburg
ZCTA5 07440,34,4469,134766,1307,432500,3430,880,2916,111,816,749,901,339,1596,1513,83,1513,1245,268,2019-01-01,zipcode,Pequannock
ZCTA5 07442,34,11029,102371,1536,302700,9188,2386,7884,619,2840,1428,2086,911,4127,4004,123,4004,2950,1054,2019-01-01,zipcode,Pompton lakes
ZCTA5 07444,34,10722,98281,2095,422700,9080,3855,7914,299,1900,2141,2177,1397,4923,4658,265,4658,3665,993,2019-01-01,zipcode,Pompton plains
ZCTA5 07446,34,14892,147625,1646,598200,11826,4056,10313,220,1342,1627,4519,2605,5813,5512,301,5512,4787,725,2019-01-01,zipcode,Ramsey
ZCTA5 07450,34,25209,184556,2026,762600,18490,6512,16069,563,1545,1751,6295,5915,8569,8310,259,8310,6494,1816,2019-01-01,zipcode,Ridgewood
ZCTA5 07452,34,11780,187000,1840,646600,8742,2845,7453,174,620,1111,3031,2517,3900,3776,124,3776,3569,207,2019-01-01,zipcode,Glen rock
ZCTA5 07456,34,12175,122385,1842,366200,9781,2914,8430,479,2281,1913,2483,1274,4264,4092,172,4092,3899,193,2019-01-01,zipcode,Ringwood
ZCTA5 07457,34,4197,110664,2098,347400,3486,888,3112,141,771,701,876,623,1890,1817,73,1817,1284,533,2019-01-01,zipcode,Riverdale
ZCTA5 07458,34,11467,162837,2506,1013900,9061,3315,7735,231,1027,1389,2522,2566,4088,3859,229,3859,3365,494,2019-01-01,zipcode,Saddle river
ZCTA5 07460,34,3398,109245,2100,279800,2816,775,2370,164,620,681,522,383,1445,1269,176,1269,1187,82,2019-01-01,zipcode,Stockholm
ZCTA5 07461,34,18094,89366,1197,273400,15131,5097,12756,738,4700,3670,2582,1066,7974,6583,1391,6583,5587,996,2019-01-01,zipcode,Sussex
ZCTA5 07462,34,6189,88934,1381,213800,5284,1240,4434,287,1658,1266,862,361,3377,2553,824,2553,1858,695,2019-01-01,zipcode,Vernon
ZCTA5 07463,34,9986,124803,2006,448900,7846,2210,6922,352,1209,1685,2548,1128,3591,3566,25,3566,3123,443,2019-01-01,zipcode,Waldwick
ZCTA5 07465,34,6716,102610,1528,343100,5568,2074,4942,259,1457,1286,1358,582,2715,2553,162,2553,2166,387,2019-01-01,zipcode,Wanaque
ZCTA5 07470,34,53954,123204,1672,468500,44058,16092,37407,2077,8528,6972,11610,8220,18845,18350,495,18350,14588,3762,2019-01-01,zipcode,Wayne
ZCTA5 07480,34,16439,100700,1531,291700,13238,4373,11605,447,3217,3597,2625,1719,6640,6026,614,6026,5357,669,2019-01-01,zipcode,West milford
ZCTA5 07481,34,17017,153736,1730,742900,13224,5130,11370,303,1896,2054,4115,3002,6043,5833,210,5833,5260,573,2019-01-01,zipcode,Wyckoff
ZCTA5 07495,34,0,-666666666,-666666666,-666666666,0,0,0,0,0,0,0,0,0,0,0,0,0,0,2019-01-01,zipcode,Mahwah
ZCTA5 07501,34,32432,30467,1125,247400,24445,11166,20078,6644,8457,3510,1174,293,12058,10745,1313,10745,1486,9259,2019-01-01,zipcode,Paterson
ZCTA5 07502,34,16396,54940,1290,235800,12407,4799,10436,2046,4082,2893,1109,306,4816,4504,312,4504,2246,2258,2019-01-01,zipcode,Paterson
ZCTA5 07503,34,17875,46520,1249,252500,13893,5688,11653,2727,5050,2525,1018,333,5806,5399,407,5399,1653,3746,2019-01-01,zipcode,Paterson
ZCTA5 07504,34,11578,60231,1268,286700,9610,3392,8178,1257,3313,1951,1283,374,4000,3682,318,3682,1244,2438,2019-01-01,zipcode,Paterson
ZCTA5 07505,34,2616,18486,913,-666666666,2145,1004,1929,545,858,365,160,1,1169,1034,135,1034,45,989,2019-01-01,zipcode,Paterson
ZCTA5 07506,34,18784,97692,1485,381000,15514,4199,13747,1293,3900,3425,3574,1555,7329,7118,211,7118,4208,2910,2019-01-01,zipcode,Hawthorne
ZCTA5 07508,34,22627,79444,1444,356000,18176,6217,15652,1665,5800,3702,3177,1308,7878,7541,337,7541,4810,2731,2019-01-01,zipcode,Haledon
ZCTA5 07512,34,10828,105637,1569,371200,9211,2885,8250,754,2916,2051,1914,615,3655,3595,60,3595,2955,640,2019-01-01,zipcode,Totowa
ZCTA5 07513,34,12348,44315,1318,251600,9221,3145,7765,2257,3353,1382,654,119,3595,3324,271,3324,1008,2316,2019-01-01,zipcode,Paterson
ZCTA5 07514,34,18100,43776,1195,219700,13598,4741,11303,2275,5196,2736,906,190,6917,6099,818,6099,1704,4395,2019-01-01,zipcode,Paterson
ZCTA5 07522,34,20615,37658,1172,219500,14944,6081,12301,3257,5776,2043,1023,202,6896,6078,818,6078,1303,4775,2019-01-01,zipcode,Paterson
ZCTA5 07524,34,13750,38794,1172,259900,10017,3706,8142,2116,3707,1267,979,73,4467,4181,286,4181,1069,3112,2019-01-01,zipcode,Paterson
ZCTA5 07601,34,44339,70090,1440,296300,37100,11394,33101,4110,8918,7022,8764,4287,20440,19080,1360,19080,6328,12752,2019-01-01,zipcode,Hackensack
ZCTA5 07603,34,8360,91232,1394,336000,6742,2121,5781,614,1623,1520,1331,693,2912,2792,120,2792,2017,775,2019-01-01,zipcode,Bogota
ZCTA5 07604,34,12082,94801,1445,429100,10065,3137,8570,568,2147,2162,2310,1383,4426,4224,202,4224,2768,1456,2019-01-01,zipcode,Hasbrouck heights
ZCTA5 07605,34,9086,102250,1444,506100,7490,2802,6441,403,1108,1411,2226,1293,3489,3355,134,3355,2127,1228,2019-01-01,zipcode,Leonia
ZCTA5 07606,34,2575,72500,1534,414400,2111,639,1735,217,816,323,221,158,830,794,36,794,368,426,2019-01-01,zipcode,South hackensack
ZCTA5 07607,34,9661,94317,1601,389300,8069,2883,6990,540,2117,1721,1566,1046,3659,3511,148,3511,2306,1205,2019-01-01,zipcode,Maywood
ZCTA5 07608,34,102,36429,1575,-666666666,83,42,73,17,35,19,1,1,40,40,0,40,0,40,2019-01-01,zipcode,Teterboro
ZCTA5 07620,34,1547,130962,-666666666,2000001,1235,571,1132,81,126,100,491,334,610,564,46,564,477,87,2019-01-01,zipcode,Alpine
ZCTA5 07621,34,27373,96335,1420,358200,21873,6678,18606,1495,4532,4342,6052,2185,9258,8946,312,8946,6192,2754,2019-01-01,zipcode,Bergenfield
ZCTA5 07624,34,8565,140357,2188,674000,6969,2544,5890,215,1121,733,2249,1572,2876,2778,98,2778,2291,487,2019-01-01,zipcode,Closter
ZCTA5 07626,34,8699,151442,2686,677500,6643,2564,5820,190,940,964,2220,1506,3013,2812,201,2812,2394,418,2019-01-01,zipcode,Cresskill
ZCTA5 07627,34,4942,154500,2773,681500,3715,1388,3164,102,282,539,1429,812,1747,1680,67,1680,1474,206,2019-01-01,zipcode,Demarest
ZCTA5 07628,34,17624,100219,1306,376100,14565,4370,12746,963,3499,2721,3393,2170,6569,6370,199,6370,4672,1698,2019-01-01,zipcode,Dumont
ZCTA5 07630,34,7596,128093,1847,492000,6175,1993,5390,326,1138,1431,1453,1042,2611,2541,70,2541,2178,363,2019-01-01,zipcode,Emerson
ZCTA5 07631,34,28271,85733,1469,387400,23153,7195,20521,2072,5320,4154,4644,4331,12244,11087,1157,11087,6056,5031,2019-01-01,zipcode,Englewood
ZCTA5 07632,34,5453,149358,3337,991000,4392,1830,4117,189,605,560,1425,1338,2043,1843,200,1843,1659,184,2019-01-01,zipcode,Englewood cliffs
ZCTA5 07640,34,4753,134688,2514,601200,3678,1343,3258,61,422,713,1256,806,1650,1626,24,1626,1514,112,2019-01-01,zipcode,Harrington park
ZCTA5 07641,34,3418,178450,3501,691500,2692,952,2327,58,258,356,854,801,1158,1113,45,1113,1059,54,2019-01-01,zipcode,Haworth
ZCTA5 07642,34,10317,146108,1405,565200,8080,2570,6905,345,1236,1558,2195,1571,3522,3475,47,3475,2958,517,2019-01-01,zipcode,Hillsdale
ZCTA5 07643,34,10782,66098,1349,329300,9198,2756,7871,897,1900,2165,2071,838,4368,4096,272,4096,1750,2346,2019-01-01,zipcode,Little ferry
ZCTA5 07644,34,24430,66595,1348,373000,19910,6742,17128,2943,5398,4488,3059,1240,9271,8805,466,8805,3878,4927,2019-01-01,zipcode,Lodi
ZCTA5 07645,34,8489,146708,1833,619400,6832,2189,5859,192,1019,1143,2031,1474,2997,2975,22,2975,2627,348,2019-01-01,zipcode,Montvale
ZCTA5 07646,34,16545,94344,1438,426800,13390,3908,11784,727,2951,2886,3543,1677,6117,5859,258,5859,3650,2209,2019-01-01,zipcode,New milford
ZCTA5 07647,34,5487,109844,1600,467700,4497,1783,3833,206,962,746,1375,544,1776,1713,63,1713,1426,287,2019-01-01,zipcode,Northvale
ZCTA5 07648,34,5812,122200,1851,626700,4726,1796,4223,220,913,757,1448,885,2215,2160,55,2160,1767,393,2019-01-01,zipcode,Norwood
ZCTA5 07649,34,8141,132358,1651,615500,6341,2259,5629,163,847,1265,1990,1364,2792,2788,4,2788,2470,318,2019-01-01,zipcode,Oradell
ZCTA5 07650,34,20604,68245,1520,558400,17672,6208,15332,1804,3827,2681,5587,1433,7781,7403,378,7403,2719,4684,2019-01-01,zipcode,Palisades park
ZCTA5 07652,34,26503,128306,2011,600200,22268,8949,19338,1658,4067,4175,6068,3370,8766,8232,534,8232,7069,1163,2019-01-01,zipcode,Paramus
ZCTA5 07656,34,8795,137883,1474,589800,7119,2613,6143,275,985,1243,2384,1256,3473,3259,214,3259,2650,609,2019-01-01,zipcode,Park ridge
ZCTA5 07657,34,11227,71699,1584,442500,9534,3271,7983,574,2373,1912,2271,853,4023,3827,196,3827,1728,2099,2019-01-01,zipcode,Ridgefield
ZCTA5 07660,34,12922,86923,1368,349100,10587,2918,9275,703,2430,2275,2493,1374,5060,4720,340,4720,2584,2136,2019-01-01,zipcode,Ridgefield park
ZCTA5 07661,34,11500,124598,1676,520800,9040,2860,7600,371,976,1447,2935,1871,4012,3867,145,3867,2935,932,2019-01-01,zipcode,River edge
ZCTA5 07662,34,5597,84196,1709,380800,4886,1807,4142,441,1324,955,1070,352,2076,2001,75,2001,1487,514,2019-01-01,zipcode,Rochelle park
ZCTA5 07663,34,13845,106776,1700,379000,11712,3934,10445,1102,2957,2658,2688,1040,5549,5328,221,5328,3665,1663,2019-01-01,zipcode,Saddle brook
ZCTA5 07666,34,40458,111821,1483,408500,31946,11664,25983,1612,4797,5147,7742,6685,13703,13072,631,13072,9502,3570,2019-01-01,zipcode,Teaneck
ZCTA5 07670,34,14632,172926,2271,829600,10662,3749,9018,282,619,753,3250,4114,4877,4690,187,4690,3659,1031,2019-01-01,zipcode,Tenafly
ZCTA5 07675,34,27024,131940,1754,589200,21470,6859,19063,1109,2997,4024,6295,4638,10542,10034,508,10034,7568,2466,2019-01-01,zipcode,Westwood
ZCTA5 07676,34,9207,140260,-666666666,509400,7419,2411,6570,249,1165,1452,2462,1242,3445,3320,125,3320,3118,202,2019-01-01,zipcode,Township of washington
ZCTA5 07677,34,5832,171103,2069,812300,4668,1637,3829,23,537,388,1635,1246,2012,1963,49,1963,1746,217,2019-01-01,zipcode,Woodcliff lake
ZCTA5 07701,34,24028,91587,1598,404900,19744,6312,17390,1739,3661,3647,5193,3150,10544,9950,594,9950,6670,3280,2019-01-01,zipcode,Red bank
ZCTA5 07702,34,4086,124474,2735,589400,3193,1246,2775,67,451,506,1067,684,1443,1434,9,1434,1299,135,2019-01-01,zipcode,Shrewsbury
ZCTA5 07703,34,132,-666666666,-666666666,-666666666,132,17,132,9,16,41,14,52,197,52,145,52,36,16,2019-01-01,zipcode,Fort monmouth
ZCTA5 07704,34,5873,179138,2288,731900,4096,1293,3563,102,314,611,1536,1000,1896,1822,74,1822,1701,121,2019-01-01,zipcode,Fair haven
ZCTA5 07711,34,1699,130313,1323,734000,1370,476,1168,13,159,281,411,304,867,605,262,605,517,88,2019-01-01,zipcode,Allenhurst
ZCTA5 07712,34,38435,69830,1208,415100,31864,10189,27778,2385,7133,6689,7002,4569,18719,16726,1993,16726,7792,8934,2019-01-01,zipcode,Asbury park
ZCTA5 07716,34,8142,92222,1248,455700,6885,2267,6256,263,1084,1772,2028,1109,3850,3572,278,3572,2546,1026,2019-01-01,zipcode,Atlantic highlands
ZCTA5 07717,34,1789,92813,1484,884300,1581,719,1452,36,205,284,517,410,1292,897,395,897,598,299,2019-01-01,zipcode,Avon by the sea
ZCTA5 07718,34,7093,125919,1734,355900,5569,1733,4759,342,1435,1304,1101,577,2423,2355,68,2355,2072,283,2019-01-01,zipcode,Belford
ZCTA5 07719,34,21083,100391,1482,459800,17626,5648,15395,806,3681,3610,4829,2469,10348,8395,1953,8395,5981,2414,2019-01-01,zipcode,Belmar
ZCTA5 07720,34,4193,64246,1348,567400,3779,1301,3532,277,557,745,1193,760,3168,2152,1016,2152,1024,1128,2019-01-01,zipcode,Bradley beach
ZCTA5 07721,34,3123,77482,1423,267800,2614,612,2083,132,595,554,517,285,1362,1247,115,1247,747,500,2019-01-01,zipcode,Cliffwood
ZCTA5 07722,34,10089,174635,1945,801500,7865,2782,6441,126,762,1472,2179,1902,3517,3282,235,3282,2932,350,2019-01-01,zipcode,Colts neck
ZCTA5 07723,34,701,65521,1125,1078100,590,312,477,56,114,150,100,57,1168,279,889,279,156,123,2019-01-01,zipcode,Deal
ZCTA5 07724,34,20920,82783,1279,374300,17376,5678,15248,1007,4212,3606,3693,2730,9395,8740,655,8740,5750,2990,2019-01-01,zipcode,Eatontown
ZCTA5 07726,34,43474,118187,1560,460300,35217,12428,30467,1346,6404,7090,8886,6741,16149,15482,667,15482,13138,2344,2019-01-01,zipcode,Englishtown
ZCTA5 07727,34,6806,80177,1059,458900,5350,2183,4718,176,1584,1014,1042,902,2909,2532,377,2532,1777,755,2019-01-01,zipcode,Farmingdale
ZCTA5 07728,34,55088,91855,1672,379500,44725,15786,38208,3960,9817,9354,9343,5734,21116,19954,1162,19954,14679,5275,2019-01-01,zipcode,Freehold
ZCTA5 07730,34,16769,101849,1053,345400,13923,4833,11917,744,4339,2637,2923,1274,5995,5821,174,5821,5094,727,2019-01-01,zipcode,Hazlet
ZCTA5 07731,34,38730,109354,1488,337200,31051,8134,25785,1262,6891,7409,7071,3152,13282,12792,490,12792,11388,1404,2019-01-01,zipcode,Howell
ZCTA5 07732,34,4868,61436,1217,293300,4363,1284,3949,328,903,1396,572,750,3340,2658,682,2658,1681,977,2019-01-01,zipcode,Highlands
ZCTA5 07733,34,16479,148991,1563,659500,13375,5556,11959,581,1652,1983,3928,3815,6090,5831,259,5831,5085,746,2019-01-01,zipcode,Holmdel
ZCTA5 07734,34,12984,62021,1320,223800,10311,3575,8480,1313,3228,2300,1217,422,5978,4861,1117,4861,2897,1964,2019-01-01,zipcode,Keansburg
ZCTA5 07735,34,18223,79467,1209,265700,15129,4985,13350,1120,5010,4233,2122,865,7786,7104,682,7104,5242,1862,2019-01-01,zipcode,Keyport
ZCTA5 07737,34,4032,110319,1239,341700,3282,1103,2646,123,791,790,656,286,1540,1435,105,1435,1253,182,2019-01-01,zipcode,Leonardo
ZCTA5 07738,34,6405,152557,420,577900,5043,1578,4407,125,848,982,1348,1104,2183,2089,94,2089,1871,218,2019-01-01,zipcode,Lincroft
ZCTA5 07739,34,5844,179391,2469,642500,4440,1861,3961,33,267,773,1650,1238,2209,2043,166,2043,1935,108,2019-01-01,zipcode,Little silver
ZCTA5 07740,34,30744,60122,1311,364900,24742,7561,21122,3669,6431,4964,3704,2354,14728,12130,2598,12130,5111,7019,2019-01-01,zipcode,Long branch
ZCTA5 07746,34,18233,154700,2582,564000,14425,5250,12058,324,1864,2184,4228,3458,6159,5874,285,5874,5652,222,2019-01-01,zipcode,Marlboro
ZCTA5 07747,34,31178,109396,1658,370300,25629,7564,22700,1134,4994,5569,7033,3970,12340,11892,448,11892,9087,2805,2019-01-01,zipcode,Matawan
ZCTA5 07748,34,27190,121490,1418,452800,22156,7100,18994,753,4423,4525,6014,3279,9968,9645,323,9645,7956,1689,2019-01-01,zipcode,Middletown
ZCTA5 07750,34,3203,135909,2534,757300,2719,1154,2423,0,284,422,932,785,1914,1414,500,1414,1170,244,2019-01-01,zipcode,Monmouth beach
ZCTA5 07751,34,20149,153644,2239,552000,15481,5065,12772,393,2024,2223,4190,3942,6504,6222,282,6222,5590,632,2019-01-01,zipcode,Morganville
ZCTA5 07753,34,36860,73544,1468,295900,31054,10991,27048,2382,7335,8052,6173,3106,16840,15730,1110,15730,10238,5492,2019-01-01,zipcode,Neptune
ZCTA5 07755,34,6028,103472,1712,400900,4686,1771,4012,275,947,1166,1022,602,2466,2222,244,2222,1982,240,2019-01-01,zipcode,Oakhurst
ZCTA5 07756,34,3047,63093,1281,498700,2987,1059,2827,133,343,624,796,931,3056,1937,1119,1937,749,1188,2019-01-01,zipcode,Ocean grove
ZCTA5 07757,34,5593,89265,-666666666,513800,4714,1852,4178,226,835,977,1344,796,2339,2238,101,2238,1835,403,2019-01-01,zipcode,Oceanport
ZCTA5 07758,34,4528,95488,1480,309200,3568,960,3023,243,889,975,709,207,1680,1572,108,1572,1357,215,2019-01-01,zipcode,Port monmouth
ZCTA5 07760,34,8704,168750,1875,1024400,6486,2511,5675,43,591,956,2245,1840,3761,3128,633,3128,2709,419,2019-01-01,zipcode,Rumson
ZCTA5 07762,34,8242,81311,1496,639600,7231,3230,6363,142,1086,1477,2185,1473,5132,4038,1094,4038,2634,1404,2019-01-01,zipcode,Spring lake
ZCTA5 07764,34,7908,109073,1807,448800,6423,2497,4534,349,1118,1068,1101,898,2797,2485,312,2485,1884,601,2019-01-01,zipcode,West long branch
ZCTA5 07801,34,24570,73496,1490,285300,19686,5032,17282,3241,5502,4592,2736,1211,8807,8123,684,8123,3991,4132,2019-01-01,zipcode,Dover
ZCTA5 07803,34,3530,91219,1706,300800,2812,826,2486,237,560,622,859,208,1373,1257,116,1257,1117,140,2019-01-01,zipcode,Mine hill
ZCTA5 07820,34,8,-666666666,-666666666,-666666666,8,0,8,4,2,0,2,0,0,0,0,0,0,0,2019-01-01,zipcode,Allamuchy
ZCTA5 07821,34,8506,109167,1279,318700,7060,1989,6118,127,1349,1847,1983,812,3837,3352,485,3352,2945,407,2019-01-01,zipcode,Andover
ZCTA5 07822,34,878,75625,-666666666,364000,595,259,538,29,138,107,199,65,279,279,0,279,269,10,2019-01-01,zipcode,Augusta
ZCTA5 07823,34,7871,60842,939,244500,6891,3080,5958,518,1839,1948,1132,521,3666,3331,335,3331,2257,1074,2019-01-01,zipcode,Belvidere
ZCTA5 07825,34,9570,104918,1438,341800,7973,3219,7052,583,1982,1864,1742,881,3910,3489,421,3489,3033,456,2019-01-01,zipcode,Blairstown
ZCTA5 07826,34,5824,85131,1488,287100,4939,2087,4492,279,1633,1264,928,388,2794,2261,533,2261,1857,404,2019-01-01,zipcode,Branchville
ZCTA5 07827,34,4051,75625,1069,215400,3290,1219,2833,175,1162,745,439,312,2107,1668,439,1668,1363,305,2019-01-01,zipcode,Montague
ZCTA5 07828,34,14967,75528,1225,337700,11648,3174,10112,583,3075,2601,2663,1190,6169,5854,315,5854,2864,2990,2019-01-01,zipcode,Budd lake
ZCTA5 07830,34,6813,134375,1042,480400,5314,1676,4631,69,816,902,1475,1369,2472,2338,134,2338,2207,131,2019-01-01,zipcode,Califon
ZCTA5 07832,34,3437,99243,1214,320400,2861,1065,2472,260,774,543,585,310,1477,1273,204,1273,1132,141,2019-01-01,zipcode,Columbia
ZCTA5 07833,34,107,48375,-666666666,174200,107,21,107,5,66,17,11,8,56,56,0,56,41,15,2019-01-01,zipcode,Delaware
ZCTA5 07834,34,17826,124593,1460,420300,14451,4446,12700,452,2234,2704,4122,3188,7238,6803,435,6803,5725,1078,2019-01-01,zipcode,Denville
ZCTA5 07836,34,12579,122292,1478,405600,10155,2849,8434,199,1686,2367,2396,1786,4807,4536,271,4536,3052,1484,2019-01-01,zipcode,Flanders
ZCTA5 07838,34,2927,110139,1460,327100,2460,691,2060,55,518,575,644,268,1217,1139,78,1139,942,197,2019-01-01,zipcode,Great meadows
ZCTA5 07840,34,30514,85094,1235,297700,25160,8056,21004,1514,5397,5216,5908,2969,12473,11754,719,11754,7722,4032,2019-01-01,zipcode,Hackettstown
ZCTA5 07842,34,95,100694,-666666666,-666666666,87,0,78,0,20,9,40,9,45,45,0,45,45,0,2019-01-01,zipcode,Hibernia
ZCTA5 07843,34,11697,86846,1453,234900,9801,2359,8555,358,3211,2593,1588,805,5341,4556,785,4556,3712,844,2019-01-01,zipcode,Hopatcong
ZCTA5 07846,34,67,-666666666,-666666666,228800,41,8,41,0,10,2,13,16,25,15,10,15,15,0,2019-01-01,zipcode,Johnsonburg
ZCTA5 07847,34,1922,112938,1588,313100,1509,346,1415,56,474,463,333,89,746,746,0,746,652,94,2019-01-01,zipcode,Kenvil
ZCTA5 07848,34,4901,87500,1165,335200,4249,1979,3865,371,1096,1063,888,447,1919,1724,195,1724,1482,242,2019-01-01,zipcode,Lafayette
ZCTA5 07849,34,9263,101977,1461,323200,7817,2004,6684,368,1880,1830,1687,919,4078,3670,408,3670,3084,586,2019-01-01,zipcode,Lake hopatcong
ZCTA5 07850,34,6661,86198,1311,288800,5306,1708,4045,205,1429,1316,661,434,2544,2238,306,2238,1665,573,2019-01-01,zipcode,Landing
ZCTA5 07851,34,61,132917,-666666666,343800,56,9,56,0,6,10,31,9,70,29,41,29,26,3,2019-01-01,zipcode,Layton
ZCTA5 07852,34,3946,85938,1548,340900,3278,1116,2660,49,555,761,911,384,1516,1495,21,1495,1305,190,2019-01-01,zipcode,Ledgewood
ZCTA5 07853,34,12915,166806,2271,482100,9987,3520,8269,207,1200,1660,3205,1997,4417,4181,236,4181,4006,175,2019-01-01,zipcode,Long valley
ZCTA5 07856,34,4126,90500,2069,297000,3544,1247,3227,92,972,809,873,481,2147,1748,399,1748,1218,530,2019-01-01,zipcode,Mount arlington
ZCTA5 07857,34,3203,69000,1166,271700,2771,758,2367,326,784,577,479,201,1531,1430,101,1430,678,752,2019-01-01,zipcode,Netcong
ZCTA5 07860,34,25451,87820,1216,264100,21586,7480,18384,1197,5284,5426,4120,2357,11172,9568,1604,9568,7245,2323,2019-01-01,zipcode,Newton
ZCTA5 07863,34,3703,85083,858,250000,3187,1098,2757,315,1114,722,446,160,1583,1465,118,1465,1226,239,2019-01-01,zipcode,Oxford
ZCTA5 07865,34,1910,123250,-666666666,313400,1527,378,1370,41,332,441,335,221,780,665,115,665,612,53,2019-01-01,zipcode,Port murray
ZCTA5 07866,34,23003,110028,1394,354600,19114,6499,16350,568,3451,3839,5598,2894,8915,8623,292,8623,7341,1282,2019-01-01,zipcode,Rockaway
ZCTA5 07869,34,25599,140841,1454,534600,20513,6521,17461,754,2237,3549,5786,5135,9539,9169,370,9169,6895,2274,2019-01-01,zipcode,Randolph
ZCTA5 07870,34,30,-666666666,-666666666,-666666666,30,22,22,0,0,0,9,13,16,16,0,16,7,9,2019-01-01,zipcode,Schooleys mountain
ZCTA5 07871,34,20136,137717,1466,376900,15999,4860,13797,313,2481,3231,5134,2638,7943,7188,755,7188,6478,710,2019-01-01,zipcode,Sparta
ZCTA5 07874,34,8121,97080,1671,259400,6632,1928,5744,214,1709,1497,1651,673,3234,3055,179,3055,2698,357,2019-01-01,zipcode,Stanhope
ZCTA5 07876,34,9943,131165,1676,388800,8192,2931,7277,325,1593,2065,2102,1192,3661,3548,113,3548,3291,257,2019-01-01,zipcode,Succasunna
ZCTA5 07878,34,627,100185,-666666666,312800,529,181,446,0,50,119,196,81,326,240,86,240,214,26,2019-01-01,zipcode,Mount tabor
ZCTA5 07880,34,221,123558,-666666666,130300,221,71,151,36,26,55,15,19,60,60,0,60,60,0,2019-01-01,zipcode,Vienna
ZCTA5 07881,34,6,-666666666,-666666666,-666666666,6,4,6,0,2,4,0,0,14,4,10,4,4,0,2019-01-01,zipcode,
ZCTA5 07882,34,14417,84135,1143,254400,11963,3276,10297,674,3235,3355,2155,878,6116,5676,440,5676,4081,1595,2019-01-01,zipcode,Washington
ZCTA5 07885,34,10094,80685,1672,297700,8364,2696,7211,799,2330,1856,1386,840,4364,3837,527,3837,2401,1436,2019-01-01,zipcode,Wharton
ZCTA5 07901,34,23567,154688,1856,868800,17955,5617,15717,619,2181,1671,5617,5629,8736,8376,360,8376,5702,2674,2019-01-01,zipcode,Summit
ZCTA5 07920,34,27037,151365,1955,662100,21677,8141,18312,551,1744,2214,6511,7292,10278,9802,476,9802,8118,1684,2019-01-01,zipcode,Basking ridge
ZCTA5 07921,34,7474,116250,2031,378100,6515,1759,6060,134,627,1247,2082,1970,4028,3794,234,3794,2896,898,2019-01-01,zipcode,Bedminster
ZCTA5 07922,34,12314,181392,2555,606100,9680,3143,8440,406,1074,1295,2778,2887,4390,4144,246,4144,3932,212,2019-01-01,zipcode,Berkeley heights
ZCTA5 07924,34,7544,165677,1787,680700,6008,1729,5275,254,590,729,2068,1634,2689,2581,108,2581,2219,362,2019-01-01,zipcode,Bernardsville
ZCTA5 07926,34,9,-666666666,-666666666,-666666666,9,0,9,0,0,0,9,0,9,9,0,9,0,9,2019-01-01,zipcode,Brookside
ZCTA5 07927,34,3814,125588,2477,479400,3057,948,2675,172,386,427,791,899,1790,1590,200,1590,1065,525,2019-01-01,zipcode,Cedar knolls
ZCTA5 07928,34,18827,191607,2037,806800,13795,4904,12199,246,1087,1280,4768,4818,6909,6482,427,6482,5527,955,2019-01-01,zipcode,Chatham
ZCTA5 07930,34,8033,148466,1393,648900,6536,2316,5606,114,782,802,2167,1741,3215,3027,188,3027,2779,248,2019-01-01,zipcode,Chester
ZCTA5 07931,34,3203,182642,2417,922600,2512,1148,2103,27,320,362,769,625,1110,1031,79,1031,908,123,2019-01-01,zipcode,Far hills
ZCTA5 07932,34,9902,127273,2441,643800,8336,3047,7166,135,1022,1160,2662,2187,4251,3992,259,3992,2726,1266,2019-01-01,zipcode,Florham park
ZCTA5 07933,34,2981,138929,1674,531800,2537,768,2162,83,239,458,771,611,1116,1116,0,1116,992,124,2019-01-01,zipcode,Gillette
ZCTA5 07934,34,1495,141667,1770,702600,1081,368,1001,11,173,248,322,247,523,516,7,516,461,55,2019-01-01,zipcode,Gladstone
ZCTA5 07935,34,374,183125,-666666666,-666666666,251,66,232,0,37,20,67,108,168,141,27,141,118,23,2019-01-01,zipcode,Green village
ZCTA5 07936,34,11072,136016,2309,608700,9324,3112,7917,632,2173,1537,2264,1311,3857,3771,86,3771,3586,185,2019-01-01,zipcode,East hanover
ZCTA5 07939,34,258,41250,-666666666,-666666666,258,253,247,35,133,61,18,0,43,43,0,43,13,30,2019-01-01,zipcode,Lyons
ZCTA5 07940,34,17523,146620,1807,724000,14271,4830,10643,490,1349,1665,3698,3441,5796,5589,207,5589,3779,1810,2019-01-01,zipcode,Madison
ZCTA5 07945,34,9020,183352,1520,731500,7094,2797,6208,123,604,978,2324,2179,3192,3109,83,3109,2853,256,2019-01-01,zipcode,Mendham
ZCTA5 07946,34,3215,168214,3080,630600,2560,934,2208,33,431,360,847,537,1150,1110,40,1110,1021,89,2019-01-01,zipcode,Millington
ZCTA5 07950,34,19550,127226,2185,480600,15872,5140,14112,723,2405,2362,4543,4079,7430,7147,283,7147,5579,1568,2019-01-01,zipcode,Morris plains
ZCTA5 07960,34,44834,125744,1761,597500,37840,11655,32796,2056,4873,4579,11696,9592,19487,18047,1440,18047,11040,7007,2019-01-01,zipcode,Morristown
ZCTA5 07961,34,0,-666666666,-666666666,-666666666,0,0,0,0,0,0,0,0,0,0,0,0,0,0,2019-01-01,zipcode,Convent station
ZCTA5 07970,34,169,243219,-666666666,341800,169,0,139,0,0,28,71,40,57,57,0,57,57,0,2019-01-01,zipcode,Mount freedom
ZCTA5 07974,34,12391,154655,1754,610800,9361,3041,8123,178,1160,1255,3082,2448,4273,4134,139,4134,3407,727,2019-01-01,zipcode,New providence
ZCTA5 07976,34,734,94432,1408,2000001,664,383,607,24,154,34,273,122,302,302,0,302,228,74,2019-01-01,zipcode,New vernon
ZCTA5 07977,34,731,87188,1338,506600,562,207,404,34,93,68,138,71,251,231,20,231,128,103,2019-01-01,zipcode,Peapack
ZCTA5 07979,34,481,135028,-666666666,629900,464,139,362,0,227,24,68,43,223,205,18,205,205,0,2019-01-01,zipcode,Pottersville
ZCTA5 07980,34,2394,122656,1436,588300,1915,678,1749,61,333,314,419,622,952,905,47,905,641,264,2019-01-01,zipcode,Stirling
ZCTA5 07981,34,9051,118897,1879,509600,7505,2485,6614,344,1552,1323,1939,1456,3632,3558,74,3558,3041,517,2019-01-01,zipcode,Whippany
ZCTA5 08001,34,886,71111,1042,181000,726,300,522,13,184,220,73,32,374,326,48,326,261,65,2019-01-01,zipcode,Alloway
ZCTA5 08002,34,22964,82285,1422,237600,19050,5878,16708,1375,3506,5076,3967,2784,9835,8956,879,8956,5770,3186,2019-01-01,zipcode,Cherry hill
ZCTA5 08003,34,30194,133946,1688,330300,24417,8313,21336,882,2826,3575,7073,6980,11474,10870,604,10870,9587,1283,2019-01-01,zipcode,Cherry hill
ZCTA5 08004,34,12169,96176,1596,191800,10005,3118,9088,966,3092,2895,1621,514,4450,4029,421,4029,3627,402,2019-01-01,zipcode,Atco
ZCTA5 08005,34,24385,73914,1580,255200,20111,9226,17638,1199,6808,5267,2942,1422,10753,9357,1396,9357,8205,1152,2019-01-01,zipcode,Barnegat
ZCTA5 08006,34,322,74479,-666666666,697600,319,197,302,4,65,63,116,54,1173,177,996,177,161,16,2019-01-01,zipcode,Barnegat light
ZCTA5 08007,34,4899,75417,924,181600,3996,1162,3704,284,1109,1048,838,425,2234,2120,114,2120,1248,872,2019-01-01,zipcode,Barrington
ZCTA5 08008,34,6988,87960,1342,808800,6593,3618,6274,93,1275,1273,2192,1441,17549,3510,14039,3510,3213,297,2019-01-01,zipcode,Beach haven
ZCTA5 08009,34,12847,90921,1251,221900,10569,3286,9235,676,2662,2800,2096,1001,5120,4988,132,4988,4248,740,2019-01-01,zipcode,Berlin
ZCTA5 08010,34,10983,64525,1284,170400,9112,2912,8067,1049,3075,2170,1203,570,4782,4343,439,4343,2572,1771,2019-01-01,zipcode,Beverly
ZCTA5 08011,34,0,-666666666,-666666666,-666666666,0,0,0,0,0,0,0,0,0,0,0,0,0,0,2019-01-01,zipcode,Birmingham
ZCTA5 08012,34,38504,74573,1153,204600,31351,10008,27319,2244,8802,8324,5640,2309,15853,14658,1195,14658,9767,4891,2019-01-01,zipcode,Blackwood
ZCTA5 08014,34,481,79338,-666666666,164900,447,165,404,21,254,114,15,0,257,187,70,187,113,74,2019-01-01,zipcode,Bridgeport
ZCTA5 08015,34,19622,66039,1175,166600,15462,5253,13415,1374,5305,4891,1290,555,8117,7161,956,7161,5643,1518,2019-01-01,zipcode,Browns mills
ZCTA5 08016,34,33259,77281,1094,232200,26479,7501,22446,1885,6970,6926,4225,2440,13073,12145,928,12145,8923,3222,2019-01-01,zipcode,Burlington
ZCTA5 08019,34,1119,98500,2104,284200,882,326,723,72,301,204,114,32,401,370,31,370,304,66,2019-01-01,zipcode,Chatsworth
ZCTA5 08020,34,2709,94297,-666666666,278800,2337,1217,2075,129,795,634,367,150,1061,953,108,953,926,27,2019-01-01,zipcode,Clarksboro
ZCTA5 08021,34,44369,53799,1015,146500,35269,11525,30336,2969,10954,9288,5023,2102,20246,18316,1930,18316,9705,8611,2019-01-01,zipcode,Clementon
ZCTA5 08022,34,9004,95917,1054,319600,7848,3429,6950,353,1926,1649,1860,1162,3795,3711,84,3711,3524,187,2019-01-01,zipcode,Columbus
ZCTA5 08023,34,285,28988,1301,116300,267,164,230,23,60,147,0,0,203,143,60,143,34,109,2019-01-01,zipcode,Deepwater
ZCTA5 08026,34,2163,85625,2167,214900,1778,650,1507,85,504,449,326,143,795,760,35,760,727,33,2019-01-01,zipcode,Gibbsboro
ZCTA5 08027,34,4831,73083,1067,174200,3932,1400,3497,296,1475,968,588,170,2099,1926,173,1926,1547,379,2019-01-01,zipcode,Gibbstown
ZCTA5 08028,34,21018,72313,1239,204500,17833,6923,11824,1074,3304,3218,2739,1489,7305,6479,826,6479,4247,2232,2019-01-01,zipcode,Glassboro
ZCTA5 08029,34,4871,66974,640,170300,4180,1328,3568,298,1746,974,314,236,2066,1972,94,1972,1416,556,2019-01-01,zipcode,Glendora
ZCTA5 08030,34,13252,60371,1188,127300,10170,3383,8758,958,3844,2435,1026,495,5130,4623,507,4623,3165,1458,2019-01-01,zipcode,Gloucester city
ZCTA5 08031,34,11398,59646,898,167700,9469,3437,8276,1231,3063,2343,1161,478,4777,4392,385,4392,2761,1631,2019-01-01,zipcode,Bellmawr
ZCTA5 08033,34,15902,124375,1140,449700,12137,3882,11030,141,1381,1881,4008,3619,6383,6054,329,6054,4617,1437,2019-01-01,zipcode,Haddonfield
ZCTA5 08034,34,17967,95012,1347,245500,14519,4710,13225,749,2530,2791,4222,2933,7305,6893,412,6893,5482,1411,2019-01-01,zipcode,Cherry hill
ZCTA5 08035,34,7656,99375,996,285900,6198,1903,5571,271,1099,1243,1944,1014,3148,3004,144,3004,2426,578,2019-01-01,zipcode,Haddon heights
ZCTA5 08036,34,5917,108521,1083,300100,4962,1458,4242,233,1341,1157,995,516,2355,2240,115,2240,2065,175,2019-01-01,zipcode,Hainesport
ZCTA5 08037,34,23765,76073,1193,235100,19397,6901,16763,1923,5841,4763,2967,1269,9233,8325,908,8325,6448,1877,2019-01-01,zipcode,Hammonton
ZCTA5 08038,34,107,84583,-666666666,175000,82,23,67,12,28,24,3,0,45,45,0,45,40,5,2019-01-01,zipcode,Hancocks bridge
ZCTA5 08039,34,182,-666666666,-666666666,312500,134,39,101,53,5,21,18,4,63,45,18,45,21,24,2019-01-01,zipcode,Harrisonville
ZCTA5 08041,34,959,119643,-666666666,373800,713,220,669,41,173,246,145,64,367,330,37,330,297,33,2019-01-01,zipcode,Jobstown
ZCTA5 08042,34,214,157981,-666666666,-666666666,148,23,132,14,22,68,28,0,81,67,14,67,53,14,2019-01-01,zipcode,Juliustown
ZCTA5 08043,34,29218,98888,1420,324200,24081,9107,21258,1666,3940,4059,6471,5122,12155,11017,1138,11017,7353,3664,2019-01-01,zipcode,Voorhees
ZCTA5 08045,34,2725,63850,783,166500,2374,1127,2118,191,868,468,294,297,1212,1129,83,1129,709,420,2019-01-01,zipcode,Lawnside
ZCTA5 08046,34,31654,75382,1651,166000,26364,9156,22297,1600,8103,7228,3700,1666,12108,10693,1415,10693,8476,2217,2019-01-01,zipcode,Willingboro
ZCTA5 08048,34,12195,88397,1314,319700,9856,3148,8504,575,2019,2454,2104,1352,5028,4687,341,4687,3399,1288,2019-01-01,zipcode,Lumberton
ZCTA5 08049,34,5335,62988,1044,165300,4347,1188,3707,261,1282,1197,619,348,2203,2033,170,2033,1431,602,2019-01-01,zipcode,Magnolia
ZCTA5 08050,34,25278,82748,1692,277800,20688,7578,18149,953,6110,4856,4339,1891,13396,9935,3461,9935,8395,1540,2019-01-01,zipcode,Manahawkin
ZCTA5 08051,34,10306,78846,1396,181400,8401,2734,7410,471,2478,1970,1638,853,4388,4176,212,4176,3314,862,2019-01-01,zipcode,Mantua
ZCTA5 08052,34,18642,61335,1203,187500,15703,4906,13688,873,4951,4039,2651,1174,9048,8285,763,8285,3887,4398,2019-01-01,zipcode,Maple shade
ZCTA5 08053,34,45135,100720,1520,290300,36787,10869,32310,1316,7027,8494,10448,5025,18907,17624,1283,17624,13381,4243,2019-01-01,zipcode,Marlton
ZCTA5 08054,34,41422,94832,1617,272800,34047,11222,29957,1180,6151,6743,9271,6612,18104,17302,802,17302,13141,4161,2019-01-01,zipcode,Mount laurel
ZCTA5 08055,34,27322,123132,1369,353400,22083,7416,19282,388,3280,4346,6832,4436,10405,10013,392,10013,8709,1304,2019-01-01,zipcode,Medford
ZCTA5 08056,34,4841,158750,1395,367600,3434,956,3125,49,749,599,734,994,1598,1509,89,1509,1445,64,2019-01-01,zipcode,Mickleton
ZCTA5 08057,34,20660,148233,1280,514600,16301,5458,13921,409,2004,2478,4567,4463,7725,7227,498,7227,5910,1317,2019-01-01,zipcode,Moorestown
ZCTA5 08059,34,5597,76708,966,169100,4665,1391,4090,225,1622,1303,606,334,2314,2127,187,2127,1557,570,2019-01-01,zipcode,Mount ephraim
ZCTA5 08060,34,24353,91616,1239,231900,19770,5893,17155,1033,4864,5165,4234,1859,9637,8885,752,8885,6631,2254,2019-01-01,zipcode,Mount holly
ZCTA5 08061,34,2980,150303,2098,301300,2147,417,1817,19,364,572,591,271,1053,946,107,946,847,99,2019-01-01,zipcode,Mount royal
ZCTA5 08062,34,16194,140609,1148,357100,12046,3190,10528,338,2086,2352,2969,2783,5595,5344,251,5344,4922,422,2019-01-01,zipcode,Mullica hill
ZCTA5 08063,34,3042,65699,1143,150500,2482,893,2116,210,926,676,238,66,1194,1117,77,1117,914,203,2019-01-01,zipcode,National park
ZCTA5 08064,34,206,-666666666,-666666666,-666666666,206,196,206,30,81,55,23,17,30,30,0,30,30,0,2019-01-01,zipcode,New lisbon
ZCTA5 08065,34,7189,72578,1356,175200,5948,1792,5151,235,1750,1718,1052,396,3200,2825,375,2825,1963,862,2019-01-01,zipcode,Palmyra
ZCTA5 08066,34,8402,51647,1015,116800,7021,2515,6189,491,2585,1686,1077,350,4253,3635,618,3635,2200,1435,2019-01-01,zipcode,Paulsboro
ZCTA5 08067,34,1636,87188,1458,229900,1256,462,1136,147,392,298,237,62,690,587,103,587,521,66,2019-01-01,zipcode,Pedricktown
ZCTA5 08068,34,7223,61551,1055,197700,5975,2101,4949,542,1782,1433,872,320,3003,2812,191,2812,1678,1134,2019-01-01,zipcode,Pemberton
ZCTA5 08069,34,12491,51303,998,143500,10107,4063,8453,1515,3231,2694,704,309,5446,4720,726,4720,2459,2261,2019-01-01,zipcode,Penns grove
ZCTA5 08070,34,12330,69035,971,155200,10044,3559,9064,872,3890,2723,981,598,5662,5000,662,5000,3703,1297,2019-01-01,zipcode,Pennsville
ZCTA5 08071,34,9419,77465,1200,187300,7829,2767,6555,381,1751,2250,1431,742,3911,3544,367,3544,2608,936,2019-01-01,zipcode,Pitman
ZCTA5 08072,34,251,73194,-666666666,158300,203,91,184,5,72,62,28,17,100,100,0,100,100,0,2019-01-01,zipcode,Quinton
ZCTA5 08073,34,175,-666666666,-666666666,-666666666,115,32,115,0,47,37,0,31,46,46,0,46,46,0,2019-01-01,zipcode,Rancocas
ZCTA5 08074,34,15,-666666666,-666666666,-666666666,15,0,15,7,0,0,0,8,0,0,0,0,0,0,2019-01-01,zipcode,Richwood
ZCTA5 08075,34,28663,77750,1224,223700,23423,7464,20167,1748,6574,5283,4725,1837,11935,10947,988,10947,7802,3145,2019-01-01,zipcode,Riverside
ZCTA5 08077,34,19121,109068,1641,274700,15827,5072,13638,427,3497,3871,3722,2121,7379,6898,481,6898,6068,830,2019-01-01,zipcode,Riverton
ZCTA5 08078,34,8318,67263,1010,163700,6712,2142,5819,509,2236,1596,1017,461,3306,3149,157,3149,2157,992,2019-01-01,zipcode,Runnemede
ZCTA5 08079,34,10030,45889,910,172600,7708,3510,6726,835,3042,1927,604,318,5015,3870,1145,3870,2348,1522,2019-01-01,zipcode,Salem
ZCTA5 08080,34,37532,103247,1503,259000,30624,9669,26471,1036,7532,7343,7275,3285,13958,13396,562,13396,11878,1518,2019-01-01,zipcode,Sewell
ZCTA5 08081,34,50067,89201,1329,206300,39220,10803,33005,2288,10169,10826,6492,3230,18265,16791,1474,16791,13745,3046,2019-01-01,zipcode,Sicklerville
ZCTA5 08083,34,9489,76433,975,193200,8051,2359,7040,464,2351,2171,1364,690,4023,3718,305,3718,2806,912,2019-01-01,zipcode,Somerdale
ZCTA5 08084,34,6971,79677,991,179100,5736,1754,4908,223,1806,1142,1160,577,2754,2551,203,2551,1969,582,2019-01-01,zipcode,Stratford
ZCTA5 08085,34,20908,126956,1666,293600,15657,4273,13627,865,2952,3363,4067,2380,7282,6755,527,6755,5713,1042,2019-01-01,zipcode,Swedesboro
ZCTA5 08086,34,7642,75326,1412,215300,6393,2279,5657,339,1907,1676,1123,612,3470,3158,312,3158,2206,952,2019-01-01,zipcode,Thorofare
ZCTA5 08087,34,24994,66410,1388,229200,21086,8953,19268,1462,6945,5618,3470,1773,13825,10917,2908,10917,9166,1751,2019-01-01,zipcode,Tuckerton
ZCTA5 08088,34,23936,83160,1480,267800,19756,8029,17467,1068,6017,4513,3850,2019,9766,9269,497,9269,8633,636,2019-01-01,zipcode,Vincentown
ZCTA5 08089,34,4012,65577,955,190300,3433,1404,3020,290,1226,972,392,140,1596,1502,94,1502,1270,232,2019-01-01,zipcode,Waterford works
ZCTA5 08090,34,8087,96015,1384,195900,6559,1922,5678,344,2178,1398,1172,586,2870,2775,95,2775,2524,251,2019-01-01,zipcode,Wenonah
ZCTA5 08091,34,5553,67654,1124,182800,4627,1511,4021,732,1273,1040,820,156,2152,1957,195,1957,1333,624,2019-01-01,zipcode,West berlin
ZCTA5 08092,34,3393,73542,1576,282200,2877,1089,2539,261,874,654,514,236,1663,1377,286,1377,1067,310,2019-01-01,zipcode,West creek
ZCTA5 08093,34,9310,58365,1030,153900,7589,2521,6580,697,3180,1629,790,284,4168,3663,505,3663,2329,1334,2019-01-01,zipcode,Westville
ZCTA5 08094,34,40347,82220,1105,204800,32098,10485,27842,2438,9778,8633,4566,2427,15602,14659,943,14659,12639,2020,2019-01-01,zipcode,Williamstown
ZCTA5 08095,34,39,-666666666,-666666666,-666666666,39,17,17,0,0,17,0,0,43,17,26,17,17,0,2019-01-01,zipcode,Winslow
ZCTA5 08096,34,35190,70780,1201,196100,28834,10007,25458,2317,8408,7242,5155,2336,15116,13717,1399,13717,9673,4044,2019-01-01,zipcode,Woodbury
ZCTA5 08097,34,3329,90333,971,200300,2635,775,2324,133,662,883,439,207,1195,1148,47,1148,1013,135,2019-01-01,zipcode,Woodbury heights
ZCTA5 08098,34,9013,92750,1062,279200,7484,2827,6366,355,1977,1786,1425,823,3639,3269,370,3269,2327,942,2019-01-01,zipcode,Woodstown
ZCTA5 08102,34,7639,21138,680,83400,5651,3025,4362,1794,1328,809,356,75,2967,2415,552,2415,569,1846,2019-01-01,zipcode,Camden
ZCTA5 08103,34,14885,27057,968,83300,11242,5922,9114,2232,3404,2399,686,393,5817,4726,1091,4726,1921,2805,2019-01-01,zipcode,Camden
ZCTA5 08104,34,21936,23617,874,69500,15425,6792,12988,4096,4634,3412,516,330,10327,8350,1977,8350,2923,5427,2019-01-01,zipcode,Camden
ZCTA5 08105,34,27933,33353,969,92300,19991,7372,16282,5713,5225,3552,1382,410,9836,8741,1095,8741,3939,4802,2019-01-01,zipcode,Camden
ZCTA5 08106,34,9515,82295,972,210500,7993,2248,6811,191,2363,1873,1758,626,4033,3793,240,3793,2434,1359,2019-01-01,zipcode,Audubon
ZCTA5 08107,34,13116,58555,1055,187400,10709,3240,9308,795,2922,2839,1800,952,5996,5335,661,5335,2852,2483,2019-01-01,zipcode,Oaklyn
ZCTA5 08108,34,18333,97279,1278,269000,15248,4333,13772,432,2836,3188,4382,2934,8389,7631,758,7631,5108,2523,2019-01-01,zipcode,Collingswood
ZCTA5 08109,34,22235,70153,1032,173200,18038,6104,15670,2015,5193,4562,2691,1209,9228,8422,806,8422,6120,2302,2019-01-01,zipcode,Merchantville
ZCTA5 08110,34,18753,63664,1127,135800,14524,5062,11406,2378,3969,3265,1308,486,6363,5687,676,5687,4404,1283,2019-01-01,zipcode,Pennsauken
ZCTA5 08201,34,10012,62063,1411,188600,8388,2691,7106,807,2334,1899,1521,545,4348,3900,448,3900,2573,1327,2019-01-01,zipcode,Absecon
ZCTA5 08202,34,1527,87604,1333,1108100,1451,890,1373,14,299,265,430,365,5618,809,4809,809,758,51,2019-01-01,zipcode,Avalon
ZCTA5 08203,34,8832,72372,1344,354200,7932,3401,7368,443,1963,2258,1647,1057,9477,4052,5425,4052,3003,1049,2019-01-01,zipcode,Brigantine
ZCTA5 08204,34,18505,71340,1119,293800,15660,6142,13472,777,4199,4151,2884,1461,13485,7735,5750,7735,6021,1714,2019-01-01,zipcode,Cape may
ZCTA5 08205,34,26507,70966,1235,201400,22427,7710,19330,1596,5558,6174,4103,1899,11810,10210,1600,10210,7908,2302,2019-01-01,zipcode,Absecon
ZCTA5 08210,34,16298,71655,1346,260200,13464,5160,11976,1162,3681,3759,2254,1120,8051,6381,1670,6381,5199,1182,2019-01-01,zipcode,Cape may court house
ZCTA5 08212,34,176,62500,-666666666,776500,174,113,173,0,22,13,69,69,611,92,519,92,89,3,2019-01-01,zipcode,Cape may point
ZCTA5 08215,34,14155,67403,1079,213100,11602,4158,10097,1076,3703,2971,1563,784,5894,5310,584,5310,3711,1599,2019-01-01,zipcode,Egg harbor city
ZCTA5 08217,34,85,-666666666,-666666666,-666666666,85,85,85,50,35,0,0,0,0,0,0,0,0,0,2019-01-01,zipcode,Elwood
ZCTA5 08221,34,6742,109013,1583,290000,5436,1901,4826,294,919,1134,1415,1064,2739,2509,230,2509,2142,367,2019-01-01,zipcode,Linwood
ZCTA5 08223,34,4254,78587,1352,277300,3499,1142,3148,60,826,797,953,512,2469,1806,663,1806,1574,232,2019-01-01,zipcode,Marmora
ZCTA5 08224,34,549,82768,1125,243100,419,134,378,36,149,101,83,9,220,185,35,185,158,27,2019-01-01,zipcode,New gretna
ZCTA5 08225,34,8153,87156,1720,223100,6690,2351,5916,523,1768,1460,1436,729,3123,2863,260,2863,2624,239,2019-01-01,zipcode,Northfield
ZCTA5 08226,34,11132,81076,1264,574100,9561,4533,8733,329,2094,1823,2744,1743,20120,5253,14867,5253,3746,1507,2019-01-01,zipcode,Ocean city
ZCTA5 08230,34,5449,95083,1138,313700,4358,1579,3810,85,1007,955,1219,544,2581,2085,496,2085,1892,193,2019-01-01,zipcode,Ocean view
ZCTA5 08232,34,19426,40964,1014,136100,15061,5408,12745,3208,4513,3347,1255,422,7178,6250,928,6250,3158,3092,2019-01-01,zipcode,Pleasantville
ZCTA5 08234,34,41667,81681,1106,211600,32765,9882,28157,3019,9120,7217,6023,2778,15582,13914,1668,13914,12128,1786,2019-01-01,zipcode,Egg harbor township
ZCTA5 08240,34,2404,-666666666,-666666666,-666666666,2404,1187,78,0,24,10,44,0,0,0,0,0,0,0,2019-01-01,zipcode,Pomona
ZCTA5 08241,34,1099,114167,1600,264300,934,329,862,73,169,254,194,172,428,404,24,404,381,23,2019-01-01,zipcode,Port republic
ZCTA5 08242,34,3137,67206,1111,258400,2438,947,2215,295,911,715,165,129,1837,1274,563,1274,962,312,2019-01-01,zipcode,Rio grande
ZCTA5 08243,34,2147,73403,1444,671700,1985,1103,1828,59,496,419,519,335,6927,1111,5816,1111,1008,103,2019-01-01,zipcode,Sea isle city
ZCTA5 08244,34,10394,61319,1148,222100,8250,2654,7179,870,2466,1927,1296,620,5486,4425,1061,4425,2556,1869,2019-01-01,zipcode,Somers point
ZCTA5 08246,34,106,-666666666,-666666666,-666666666,106,92,106,0,92,0,0,14,207,52,155,52,52,0,2019-01-01,zipcode,South seaville
ZCTA5 08247,34,939,99063,1216,1247800,912,545,832,25,139,162,302,204,3295,498,2797,498,451,47,2019-01-01,zipcode,Stone harbor
ZCTA5 08248,34,171,-666666666,-666666666,472400,149,98,111,0,43,0,26,42,488,55,433,55,55,0,2019-01-01,zipcode,Strathmere
ZCTA5 08251,34,9228,56545,1168,190600,7857,2825,6894,719,2920,2025,867,363,6595,4134,2461,4134,3355,779,2019-01-01,zipcode,Villas
ZCTA5 08260,34,12630,50911,1058,336600,11274,5516,10048,904,3821,2857,1584,882,23655,6103,17552,6103,3953,2150,2019-01-01,zipcode,Wildwood
ZCTA5 08270,34,8063,65000,1096,261600,6459,2370,5585,819,1992,1526,767,481,3641,3014,627,3014,2268,746,2019-01-01,zipcode,Woodbine
ZCTA5 08302,34,45056,51161,1108,164400,34338,15773,29269,6790,11923,6740,2578,1238,15486,13927,1559,13927,8342,5585,2019-01-01,zipcode,Bridgeton
ZCTA5 08310,34,1315,53885,1131,107600,1186,604,1056,217,566,189,47,37,621,577,44,577,413,164,2019-01-01,zipcode,Buena
ZCTA5 08311,34,2251,64531,1258,167700,1642,573,1392,367,584,348,82,11,795,647,148,647,472,175,2019-01-01,zipcode,Cedarville
ZCTA5 08312,34,8366,68398,1033,199400,6829,2108,5732,604,1968,1562,1054,544,3312,2967,345,2967,2307,660,2019-01-01,zipcode,Clayton
ZCTA5 08314,34,2908,78796,-666666666,152300,2738,2456,2649,634,1351,552,76,36,202,174,28,174,165,9,2019-01-01,zipcode,Delmont
ZCTA5 08316,34,286,67688,-666666666,131500,196,96,171,35,70,37,12,17,154,99,55,99,99,0,2019-01-01,zipcode,Dorchester
ZCTA5 08317,34,1636,81414,-666666666,251200,1272,534,1094,94,422,463,106,9,534,525,9,525,457,68,2019-01-01,zipcode,Dorothy
ZCTA5 08318,34,12087,85279,1227,217200,10243,3751,8665,815,3234,2208,1681,727,4969,4545,424,4545,4084,461,2019-01-01,zipcode,Elmer
ZCTA5 08319,34,1171,100682,-666666666,258800,995,287,833,55,332,184,150,112,536,414,122,414,411,3,2019-01-01,zipcode,Estell manor
ZCTA5 08320,34,1043,-666666666,-666666666,-666666666,1043,1043,975,122,496,319,38,0,0,0,0,0,0,0,2019-01-01,zipcode,Fairton
ZCTA5 08321,34,123,26250,969,179700,121,85,121,25,66,26,0,4,295,83,212,83,49,34,2019-01-01,zipcode,Fortescue
ZCTA5 08322,34,10902,87530,1193,206900,8793,2788,7760,904,3160,2193,1049,454,3869,3688,181,3688,3353,335,2019-01-01,zipcode,Franklinville
ZCTA5 08323,34,599,77054,1208,203100,494,190,425,19,126,147,85,48,299,231,68,231,179,52,2019-01-01,zipcode,Greenwich
ZCTA5 08324,34,277,123158,-666666666,206900,263,110,213,16,114,56,27,0,153,108,45,108,108,0,2019-01-01,zipcode,Heislerville
ZCTA5 08326,34,1322,63802,1552,147500,1030,318,913,60,355,284,182,32,551,474,77,474,363,111,2019-01-01,zipcode,Landisville
ZCTA5 08327,34,3118,-666666666,-666666666,150000,3114,2958,2993,728,1426,665,138,36,233,175,58,175,146,29,2019-01-01,zipcode,Leesburg
ZCTA5 08328,34,1301,65227,-666666666,165700,1087,379,1001,145,430,266,129,31,526,526,0,526,503,23,2019-01-01,zipcode,Malaga
ZCTA5 08329,34,345,67188,-666666666,283800,290,148,290,0,86,93,85,26,222,152,70,152,114,38,2019-01-01,zipcode,Mauricetown
ZCTA5 08330,34,27552,70231,1450,205100,22057,6959,19144,1619,5663,5508,4368,1986,11791,10566,1225,10566,7757,2809,2019-01-01,zipcode,Mays landing
ZCTA5 08332,34,35414,57265,1056,153900,27613,10452,24139,3738,9921,6440,2788,1252,15630,13741,1889,13741,9223,4518,2019-01-01,zipcode,Millville
ZCTA5 08340,34,1327,75042,1388,252700,971,318,817,61,400,224,101,31,453,453,0,453,371,82,2019-01-01,zipcode,Milmay
ZCTA5 08341,34,2390,33750,807,183500,1897,771,1650,348,516,466,189,131,1088,1032,56,1032,444,588,2019-01-01,zipcode,Minotola
ZCTA5 08343,34,5331,104722,1598,260800,4278,1463,3643,295,1261,1115,610,362,1847,1718,129,1718,1529,189,2019-01-01,zipcode,Monroeville
ZCTA5 08344,34,4514,71321,1402,174900,3778,1377,3292,322,1136,928,529,377,2153,1812,341,1812,1584,228,2019-01-01,zipcode,Newfield
ZCTA5 08345,34,591,59583,946,144700,479,216,426,79,169,104,46,28,349,231,118,231,192,39,2019-01-01,zipcode,Newport
ZCTA5 08346,34,942,80169,-666666666,151700,719,138,589,66,161,300,62,0,397,292,105,292,261,31,2019-01-01,zipcode,Newtonville
ZCTA5 08348,34,155,83750,-666666666,125800,132,44,125,36,56,24,0,9,62,62,0,62,45,17,2019-01-01,zipcode,Port elizabeth
ZCTA5 08349,34,1695,48438,1338,127700,1446,674,1238,131,583,354,153,17,799,697,102,697,617,80,2019-01-01,zipcode,Port norris
ZCTA5 08350,34,699,71000,-666666666,263900,584,88,456,153,126,115,14,48,296,232,64,232,218,14,2019-01-01,zipcode,Richland
ZCTA5 08352,34,563,83833,-666666666,122500,452,173,329,56,124,80,39,30,164,164,0,164,146,18,2019-01-01,zipcode,Rosenhayn
ZCTA5 08353,34,399,63125,880,159100,326,102,285,41,129,71,24,20,172,152,20,152,105,47,2019-01-01,zipcode,Shiloh
ZCTA5 08360,34,41906,50775,1045,156000,32402,12334,27506,6968,9839,6808,2720,1171,15518,14631,887,14631,8672,5959,2019-01-01,zipcode,Vineland
ZCTA5 08361,34,18472,78340,1097,207600,15251,6625,12854,1751,4278,2988,2574,1263,6964,6489,475,6489,5271,1218,2019-01-01,zipcode,Vineland
ZCTA5 08401,34,37999,29232,904,156700,29783,12120,24991,6582,8647,5707,2711,1344,20429,15504,4925,15504,4223,11281,2019-01-01,zipcode,Atlantic city
ZCTA5 08402,34,5997,83045,1315,483700,5349,2395,4856,212,975,1126,1218,1325,7067,2933,4134,2933,2379,554,2019-01-01,zipcode,Margate city
ZCTA5 08403,34,981,124643,1765,886000,888,497,845,21,172,184,290,178,1596,464,1132,464,401,63,2019-01-01,zipcode,Longport
ZCTA5 08406,34,10095,59219,1163,273500,8835,3446,7677,810,2600,1689,1637,941,7747,4366,3381,4366,2856,1510,2019-01-01,zipcode,Ventnor city
ZCTA5 08501,34,6226,117750,1262,415700,5130,1741,4304,97,734,979,1465,1029,2465,2355,110,2355,2179,176,2019-01-01,zipcode,Allentown
ZCTA5 08502,34,11275,201406,2028,637900,8844,2403,7432,123,953,983,2053,3320,3687,3612,75,3612,2845,767,2019-01-01,zipcode,Belle mead
ZCTA5 08505,34,17575,93795,1234,288100,14578,4623,12586,577,2961,3547,3681,1820,7511,6880,631,6880,5176,1704,2019-01-01,zipcode,Bordentown
ZCTA5 08510,34,5692,153194,1857,581800,4798,1546,3715,253,892,833,1234,503,1924,1812,112,1812,1674,138,2019-01-01,zipcode,Millstone township
ZCTA5 08511,34,1005,80750,939,233700,810,183,706,68,254,173,135,76,402,383,19,383,318,65,2019-01-01,zipcode,Cookstown
ZCTA5 08512,34,10819,90389,1284,483700,8654,3215,7602,670,1300,1190,2133,2309,4395,4078,317,4078,2451,1627,2019-01-01,zipcode,Cranbury
ZCTA5 08514,34,4804,100781,1325,368400,4052,1404,3610,313,1099,1046,702,450,2025,1894,131,1894,1714,180,2019-01-01,zipcode,Cream ridge
ZCTA5 08515,34,6432,146719,1517,459500,4938,1849,4028,278,891,889,1168,802,1789,1702,87,1702,1560,142,2019-01-01,zipcode,Chesterfield
ZCTA5 08518,34,5402,64767,1049,205800,4439,1404,3875,445,1216,1209,629,376,2501,2255,246,2255,1500,755,2019-01-01,zipcode,Florence
ZCTA5 08520,34,26861,93419,1381,295700,21305,6606,18364,1652,3803,3733,5552,3624,10070,9281,789,9281,6436,2845,2019-01-01,zipcode,Hightstown
ZCTA5 08525,34,4933,116691,1541,426700,4036,1013,3532,207,591,804,978,952,2001,1864,137,1864,1515,349,2019-01-01,zipcode,Hopewell
ZCTA5 08527,34,56630,94959,1439,361700,45257,15446,39090,2076,11862,12167,9524,3461,21729,20389,1340,20389,17332,3057,2019-01-01,zipcode,Jackson
ZCTA5 08528,34,157,-666666666,-666666666,277300,153,87,126,0,0,13,20,93,64,64,0,64,48,16,2019-01-01,zipcode,Kingston
ZCTA5 08530,34,7496,95341,1343,430900,6442,2330,5737,452,1273,1329,1537,1146,3385,3084,301,3084,2081,1003,2019-01-01,zipcode,Lambertville
ZCTA5 08533,34,6671,104917,1230,340000,5289,1337,4413,351,1704,1061,894,403,2440,2440,0,2440,2096,344,2019-01-01,zipcode,New egypt
ZCTA5 08534,34,12759,138073,1649,476100,10167,3626,8723,290,977,993,3139,3324,4955,4739,216,4739,4132,607,2019-01-01,zipcode,Pennington
ZCTA5 08535,34,4754,177431,1712,587500,3869,939,3320,90,418,826,1303,683,1653,1583,70,1583,1476,107,2019-01-01,zipcode,Millstone township
ZCTA5 08536,34,19691,111258,1654,483400,15276,4496,14014,213,1324,1401,5059,6017,8839,7805,1034,7805,3470,4335,2019-01-01,zipcode,Plainsboro
ZCTA5 08540,34,48672,144204,1761,651000,39636,14686,32194,1123,2112,3103,9336,16520,18998,17485,1513,17485,11748,5737,2019-01-01,zipcode,Princeton
ZCTA5 08542,34,5840,81211,1639,484100,5151,1999,3173,166,626,329,783,1269,1955,1733,222,1733,506,1227,2019-01-01,zipcode,Princeton
ZCTA5 08550,34,19277,192231,2209,626800,15225,5191,13450,212,942,1257,4686,6353,7061,6657,404,6657,5655,1002,2019-01-01,zipcode,Princeton junction
ZCTA5 08551,34,5347,139609,2029,475900,4465,1391,3629,146,779,702,1353,649,1867,1797,70,1797,1659,138,2019-01-01,zipcode,Ringoes
ZCTA5 08553,34,636,111688,1833,521500,517,208,458,14,47,58,159,180,294,243,51,243,199,44,2019-01-01,zipcode,Rocky hill
ZCTA5 08554,34,4123,85725,1342,171700,3239,842,2783,109,1032,900,573,169,1578,1494,84,1494,1205,289,2019-01-01,zipcode,Roebling
ZCTA5 08555,34,851,105556,-666666666,316300,681,203,598,19,148,130,186,115,307,294,13,294,262,32,2019-01-01,zipcode,Roosevelt
ZCTA5 08558,34,7684,210682,1520,681800,5948,2298,5074,84,648,506,1548,2288,2781,2578,203,2578,2303,275,2019-01-01,zipcode,Skillman
ZCTA5 08559,34,5307,115182,1653,472700,4693,1724,3995,268,908,838,1099,882,2323,2118,205,2118,1696,422,2019-01-01,zipcode,Stockton
ZCTA5 08560,34,3695,110038,1855,404000,3281,1379,2750,181,506,457,796,810,1473,1367,106,1367,1245,122,2019-01-01,zipcode,Titusville
ZCTA5 08561,34,325,128289,-666666666,387500,209,27,209,40,13,24,59,73,102,102,0,102,86,16,2019-01-01,zipcode,Windsor
ZCTA5 08562,34,4717,62200,980,220800,3568,1213,3070,335,903,943,593,296,1960,1768,192,1768,1036,732,2019-01-01,zipcode,Wrightstown
ZCTA5 08608,34,889,14886,716,-666666666,789,343,744,98,306,299,11,30,659,539,120,539,11,528,2019-01-01,zipcode,Trenton
ZCTA5 08609,34,12562,34602,1071,83500,10104,3958,7846,2401,3087,1858,376,124,5465,4163,1302,4163,1008,3155,2019-01-01,zipcode,Trenton
ZCTA5 08610,34,30842,64743,1175,199900,24902,8172,21249,2741,8253,5980,2945,1330,12172,11145,1027,11145,7067,4078,2019-01-01,zipcode,Trenton
ZCTA5 08611,34,26744,37482,1068,92600,19796,7109,16576,6309,4402,3774,1433,658,9941,8306,1635,8306,2603,5703,2019-01-01,zipcode,Trenton
ZCTA5 08618,34,39283,40797,1010,172100,31377,14233,23146,4010,8233,6245,2868,1790,16238,13061,3177,13061,5719,7342,2019-01-01,zipcode,Trenton
ZCTA5 08619,34,21560,83612,1377,252300,18461,5789,15955,1539,4169,4438,4052,1757,9276,8709,567,8709,6043,2666,2019-01-01,zipcode,Trenton
ZCTA5 08620,34,11623,94807,1093,266100,9739,3719,8342,606,2820,2398,1722,796,4388,4055,333,4055,3289,766,2019-01-01,zipcode,Trenton
ZCTA5 08628,34,8809,95417,1416,271100,7532,2576,6743,273,1611,1314,2158,1387,4201,3786,415,3786,2384,1402,2019-01-01,zipcode,Trenton
ZCTA5 08629,34,13942,63094,1177,112900,10955,3450,9262,1838,3766,2582,687,389,4426,4077,349,4077,2611,1466,2019-01-01,zipcode,Trenton
ZCTA5 08638,34,22339,54710,1135,172300,18416,7429,15251,2446,5557,3605,2236,1407,9419,8031,1388,8031,4745,3286,2019-01-01,zipcode,Trenton
ZCTA5 08640,34,7668,72031,2078,-666666666,6714,4824,5681,885,1963,1884,679,270,1001,903,98,903,5,898,2019-01-01,zipcode,Joint base mdl
ZCTA5 08641,34,4248,67500,1994,-666666666,2772,560,1897,43,180,1032,457,185,1249,1162,87,1162,0,1162,2019-01-01,zipcode,Joint base mdl
ZCTA5 08648,34,31361,100930,1683,317100,26451,8817,21659,1192,4161,4429,5259,6618,12612,11588,1024,11588,7819,3769,2019-01-01,zipcode,Lawrence township
ZCTA5 08690,34,18349,100650,1471,294200,15635,5164,13657,678,3456,3640,4020,1863,7171,6909,262,6909,5998,911,2019-01-01,zipcode,Trenton
ZCTA5 08691,34,16850,133960,1727,405700,13803,4456,12017,330,2304,2473,3778,3132,6490,6281,209,6281,5451,830,2019-01-01,zipcode,Trenton
ZCTA5 08701,34,102466,52148,1427,335600,56105,25259,43831,5319,13403,11724,7732,5653,26035,23781,2254,23781,11962,11819,2019-01-01,zipcode,Lakewood
ZCTA5 08720,34,808,108750,1705,583300,675,253,579,50,100,150,178,101,252,252,0,252,200,52,2019-01-01,zipcode,Allenwood
ZCTA5 08721,34,21074,88039,1492,283500,16631,5483,14763,1330,5687,4188,2516,1042,8427,7382,1045,7382,6053,1329,2019-01-01,zipcode,Bayville
ZCTA5 08722,34,11226,79777,1641,231500,8761,2555,7277,597,2621,2407,1230,422,3992,3740,252,3740,3217,523,2019-01-01,zipcode,Beachwood
ZCTA5 08723,34,32846,76242,1365,289300,26963,9744,23535,2003,8324,7416,4010,1782,14476,13021,1455,13021,10134,2887,2019-01-01,zipcode,Brick
ZCTA5 08724,34,41293,79656,1522,289700,34499,11714,30249,2025,9079,9026,6919,3200,17941,16510,1431,16510,14270,2240,2019-01-01,zipcode,Brick
ZCTA5 08730,34,4726,140221,2205,639700,3746,1289,3176,64,491,543,1411,667,2085,1755,330,1755,1612,143,2019-01-01,zipcode,Brielle
ZCTA5 08731,34,19968,82907,1542,260200,16394,5978,13948,984,4697,4496,2407,1364,8980,7618,1362,7618,6842,776,2019-01-01,zipcode,Forked river
ZCTA5 08732,34,1421,97059,1651,391900,1174,470,1093,16,239,313,268,257,737,598,139,598,484,114,2019-01-01,zipcode,Island heights
ZCTA5 08733,34,2756,68586,1710,190300,2167,732,1842,248,685,546,255,108,983,927,56,927,604,323,2019-01-01,zipcode,Lakehurst
ZCTA5 08734,34,8836,87868,812,322000,7390,2684,6469,232,2194,1930,1231,882,3668,3373,295,3373,3004,369,2019-01-01,zipcode,Lanoka harbor
ZCTA5 08735,34,3911,77283,1224,642800,3682,2047,3466,136,817,832,939,742,6999,2026,4973,2026,1817,209,2019-01-01,zipcode,Lavallette
ZCTA5 08736,34,13150,127385,1338,637400,10850,3864,9428,186,1544,1842,3442,2414,6254,4904,1350,4904,4314,590,2019-01-01,zipcode,Manasquan
ZCTA5 08738,34,1242,99444,1420,1191700,1147,644,1118,27,181,221,423,266,1815,618,1197,618,576,42,2019-01-01,zipcode,Mantoloking
ZCTA5 08740,34,1601,57426,1651,240800,1341,511,1093,69,481,246,226,71,1220,691,529,691,498,193,2019-01-01,zipcode,Ocean gate
ZCTA5 08741,34,2613,94402,1292,330000,2168,907,1913,55,496,542,501,319,1137,995,142,995,904,91,2019-01-01,zipcode,Pine beach
ZCTA5 08742,34,24430,99316,1578,423800,20269,6214,17734,731,4194,4641,5199,2969,12422,9807,2615,9807,7762,2045,2019-01-01,zipcode,Point pleasant beach
ZCTA5 08750,34,3017,131949,-666666666,943900,2668,1346,2389,23,304,427,921,714,1867,1295,572,1295,1250,45,2019-01-01,zipcode,Sea girt
ZCTA5 08751,34,4474,78648,1173,452700,3767,1418,3232,313,972,763,774,410,5679,2059,3620,2059,1116,943,2019-01-01,zipcode,Seaside heights
ZCTA5 08752,34,2070,71797,1316,642400,1884,830,1752,28,336,478,511,399,3904,1185,2719,1185,888,297,2019-01-01,zipcode,Seaside park
ZCTA5 08753,34,63415,82858,1471,292700,50669,16347,43945,2757,14721,12341,9695,4431,26221,23261,2960,23261,17945,5316,2019-01-01,zipcode,Toms river
ZCTA5 08755,34,25928,70419,1283,282000,21369,9242,18764,1909,6058,5123,3499,2175,10849,10273,576,10273,8622,1651,2019-01-01,zipcode,Toms river
ZCTA5 08757,34,33737,46107,1473,169700,30567,18115,28280,3465,13599,6773,3310,1133,18666,16599,2067,16599,14344,2255,2019-01-01,zipcode,Toms river
ZCTA5 08758,34,7731,69954,1573,327700,6864,3563,6386,459,2373,1772,1204,578,4068,3537,531,3537,2872,665,2019-01-01,zipcode,Waretown
ZCTA5 08759,34,33180,39900,1149,131500,31439,21264,30145,3534,12163,7694,4564,2190,21844,19376,2468,19376,16670,2706,2019-01-01,zipcode,Manchester township
ZCTA5 08801,34,8504,127130,1721,414000,7212,3503,5032,198,808,1077,1591,1358,2709,2564,145,2564,2168,396,2019-01-01,zipcode,Annandale
ZCTA5 08802,34,3963,132281,1577,392600,3117,859,2681,79,585,597,934,486,1426,1399,27,1399,1279,120,2019-01-01,zipcode,Asbury
ZCTA5 08804,34,2541,102609,1125,337900,2078,519,1875,67,324,625,528,331,1054,972,82,972,878,94,2019-01-01,zipcode,Bloomsbury
ZCTA5 08805,34,12253,72287,1456,290700,9646,2809,8087,1210,2846,1964,1233,834,4804,4161,643,4161,2300,1861,2019-01-01,zipcode,Bound brook
ZCTA5 08807,34,38136,131955,1616,484200,30551,10016,26596,1232,4872,4960,8054,7478,13593,13183,410,13183,10854,2329,2019-01-01,zipcode,Bridgewater
ZCTA5 08808,34,133,73459,-666666666,83400,133,5,133,91,11,31,0,0,85,85,0,85,66,19,2019-01-01,zipcode,Broadway
ZCTA5 08809,34,6446,102760,1580,364700,5403,1945,4336,272,833,794,1418,1019,2229,2202,27,2202,1630,572,2019-01-01,zipcode,Clinton
ZCTA5 08810,34,9507,128990,1738,405300,7439,2429,6514,262,895,1025,2476,1856,3216,3096,120,3096,2558,538,2019-01-01,zipcode,Dayton
ZCTA5 08812,34,14223,99648,1307,360300,11261,3369,9512,535,2720,2092,2838,1327,4815,4563,252,4563,3589,974,2019-01-01,zipcode,Dunellen
ZCTA5 08816,34,46697,115029,1436,398800,38001,12218,33587,1882,6563,6359,11190,7593,17218,16435,783,16435,13305,3130,2019-01-01,zipcode,East brunswick
ZCTA5 08817,34,45204,93571,1611,323000,35710,11443,32099,2341,7471,6845,9134,6308,16353,15564,789,15564,8608,6956,2019-01-01,zipcode,Edison
ZCTA5 08820,34,38507,132451,1578,495500,30612,11694,27777,2341,3703,2908,9126,9699,13232,12891,341,12891,9499,3392,2019-01-01,zipcode,Edison
ZCTA5 08821,34,436,56313,-666666666,375700,390,158,289,0,164,64,51,10,171,145,26,145,136,9,2019-01-01,zipcode,Flagtown
ZCTA5 08822,34,29868,115981,1497,429700,24356,7491,21199,1316,4324,4263,6780,4516,11809,11159,650,11159,8746,2413,2019-01-01,zipcode,Flemington
ZCTA5 08823,34,9117,103938,1937,268000,7286,1819,6682,228,1247,1133,2116,1958,4010,3662,348,3662,2516,1146,2019-01-01,zipcode,Franklin park
ZCTA5 08824,34,12077,147109,1388,441200,9597,2847,8442,268,1152,1554,3360,2108,4184,4055,129,4055,3672,383,2019-01-01,zipcode,Kendall park
ZCTA5 08825,34,4384,108189,1284,418800,3727,1019,3290,320,756,809,900,505,1859,1705,154,1705,1239,466,2019-01-01,zipcode,Frenchtown
ZCTA5 08826,34,5060,107669,1305,349900,4272,1105,3726,171,806,795,1204,750,2423,2087,336,2087,1703,384,2019-01-01,zipcode,Glen gardner
ZCTA5 08827,34,4159,105031,550,373600,3496,1160,3160,91,674,938,987,470,1851,1689,162,1689,1491,198,2019-01-01,zipcode,Hampton
ZCTA5 08828,34,2475,93056,1770,253300,2075,506,1844,140,618,468,436,182,1001,956,45,956,724,232,2019-01-01,zipcode,Helmetta
ZCTA5 08829,34,3515,96272,1339,265600,2903,908,2524,146,631,503,739,505,1607,1502,105,1502,1136,366,2019-01-01,zipcode,High bridge
ZCTA5 08830,34,17784,95430,1769,303200,14672,5397,13581,1304,3673,2536,3794,2274,6685,6431,254,6431,4591,1840,2019-01-01,zipcode,Iselin
ZCTA5 08831,34,50944,89331,1389,357700,42570,20305,39467,2468,10784,8267,10350,7598,22397,21111,1286,21111,18706,2405,2019-01-01,zipcode,Monroe township
ZCTA5 08832,34,3152,65761,1408,249000,2589,784,1900,178,834,361,330,197,1081,1052,29,1052,249,803,2019-01-01,zipcode,Keasbey
ZCTA5 08833,34,7984,130694,1837,494400,6862,2545,5858,203,1136,1169,1993,1357,3250,3151,99,3151,2759,392,2019-01-01,zipcode,Lebanon
ZCTA5 08835,34,10230,69625,1355,262000,7981,2508,6704,647,3148,1695,926,288,4245,3761,484,3761,2484,1277,2019-01-01,zipcode,Manville
ZCTA5 08836,34,3776,169583,1445,618800,2930,825,2564,63,333,341,980,847,1343,1327,16,1327,1230,97,2019-01-01,zipcode,Martinsville
ZCTA5 08837,34,16674,87738,1370,331500,13632,4350,12227,988,2883,2598,3370,2388,6596,6100,496,6100,3179,2921,2019-01-01,zipcode,Edison
ZCTA5 08840,34,16594,126671,1564,404200,13175,3767,11936,536,1938,2431,3572,3459,6364,6073,291,6073,4782,1291,2019-01-01,zipcode,Metuchen
ZCTA5 08844,34,39604,129857,1814,438200,31523,8323,27746,795,5156,5254,10275,6266,14811,13803,1008,13803,11722,2081,2019-01-01,zipcode,Hillsborough
ZCTA5 08846,34,13662,75460,1416,307000,10817,3225,9679,1022,3307,2861,1541,948,5190,4868,322,4868,3374,1494,2019-01-01,zipcode,Middlesex
ZCTA5 08848,34,8463,109904,1380,325000,6982,2163,6177,280,1810,1521,1672,894,3503,3172,331,3172,2903,269,2019-01-01,zipcode,Milford
ZCTA5 08850,34,8373,109135,1693,350800,6799,2047,5805,292,1391,1712,1661,749,2980,2827,153,2827,2317,510,2019-01-01,zipcode,Milltown
ZCTA5 08852,34,18368,107061,1664,404300,14261,4250,12670,391,1544,1832,5448,3455,6958,6736,222,6736,4674,2062,2019-01-01,zipcode,Monmouth junction
ZCTA5 08853,34,4836,156058,1325,570000,3918,1102,3328,44,567,779,948,990,1824,1769,55,1769,1564,205,2019-01-01,zipcode,Neshanic station
ZCTA5 08854,34,56946,100034,1646,334300,48776,20868,34288,2604,7203,7302,10314,6865,17130,16176,954,16176,10908,5268,2019-01-01,zipcode,Piscataway
ZCTA5 08857,34,39713,95930,1261,360100,32473,9535,29063,2054,7460,7798,8150,3601,15626,14872,754,14872,9985,4887,2019-01-01,zipcode,Old bridge
ZCTA5 08858,34,111,-666666666,-666666666,-666666666,111,0,72,0,0,0,0,72,35,35,0,35,35,0,2019-01-01,zipcode,Oldwick
ZCTA5 08859,34,22884,82388,1325,316800,18470,5702,16018,1513,4486,4023,4167,1829,8714,8446,268,8446,5318,3128,2019-01-01,zipcode,Parlin
ZCTA5 08861,34,53538,53471,1339,261900,40947,15349,33578,9586,12207,6466,3952,1367,17691,16684,1007,16684,5214,11470,2019-01-01,zipcode,Perth amboy
ZCTA5 08863,34,12094,91272,1458,306700,9880,3243,8814,872,2745,2397,1825,975,4562,4268,294,4268,2974,1294,2019-01-01,zipcode,Fords
ZCTA5 08865,34,28986,70334,1027,197600,23729,8041,20735,2352,7344,5629,3552,1858,13217,11755,1462,11755,7712,4043,2019-01-01,zipcode,Phillipsburg
ZCTA5 08867,34,5204,125354,1497,474300,4228,1243,3531,105,627,840,996,963,1972,1819,153,1819,1560,259,2019-01-01,zipcode,Pittstown
ZCTA5 08869,34,7865,79362,1672,343600,6660,1889,5539,546,1756,1234,1204,799,3316,2995,321,2995,1648,1347,2019-01-01,zipcode,Raritan
ZCTA5 08872,34,19852,79597,1289,294300,15883,4696,14343,1306,4416,3795,3380,1446,7450,7262,188,7262,4230,3032,2019-01-01,zipcode,Sayreville
ZCTA5 08873,34,54148,89784,1583,340100,44748,15720,39193,2200,8900,8723,11079,8291,22249,20419,1830,20419,14344,6075,2019-01-01,zipcode,Somerset
ZCTA5 08876,34,22257,99755,1408,383700,18064,5391,15302,1129,3078,3241,4808,3046,9109,8282,827,8282,5580,2702,2019-01-01,zipcode,Somerville
ZCTA5 08879,34,23064,71982,1338,288300,18516,5954,16613,1574,5440,4855,3239,1505,9435,8645,790,8645,4835,3810,2019-01-01,zipcode,South amboy
ZCTA5 08880,34,4534,85223,1422,248800,3579,906,3072,254,1070,875,569,304,1852,1590,262,1590,904,686,2019-01-01,zipcode,South bound brook
ZCTA5 08882,34,15924,77996,1288,299000,12705,3670,11206,1781,3847,2723,1867,988,6154,5752,402,5752,3595,2157,2019-01-01,zipcode,South river
ZCTA5 08884,34,8269,80074,938,305100,6637,2571,6058,495,2252,1786,1019,506,3299,3207,92,3207,2481,726,2019-01-01,zipcode,Spotswood
ZCTA5 08886,34,7121,109698,1371,316000,5640,1658,4802,218,998,1361,1488,737,2641,2555,86,2555,2096,459,2019-01-01,zipcode,Stewartsville
ZCTA5 08887,34,1049,97688,1603,195500,913,290,846,49,152,214,268,163,526,501,25,501,397,104,2019-01-01,zipcode,Three bridges
ZCTA5 08889,34,10750,128413,1533,469300,8929,3363,7761,404,1549,1434,2747,1627,4312,4233,79,4233,3846,387,2019-01-01,zipcode,Whitehouse station
ZCTA5 08890,34,17,-666666666,-666666666,-666666666,17,0,17,0,8,0,9,0,8,8,0,8,0,8,2019-01-01,zipcode,
ZCTA5 08901,34,57572,43783,1470,251100,46120,22555,26260,9379,6313,4638,3230,2700,16894,15328,1566,15328,2864,12464,2019-01-01,zipcode,New brunswick
ZCTA5 08902,34,40985,96389,1619,342700,32871,9901,28797,2920,6297,5313,8223,6044,15198,14488,710,14488,8073,6415,2019-01-01,zipcode,North brunswick
ZCTA5 08904,34,13883,81402,1467,373700,11416,3385,9732,380,1117,1303,3239,3693,6172,5735,437,5735,2394,3341,2019-01-01,zipcode,Highland park
ZCTA5 32003,12,28676,94154,1488,269600,23003,8112,19616,536,3994,6379,5688,3019,10969,10428,541,10428,8503,1925,2019-01-01,zipcode,Fleming island
ZCTA5 32008,12,4425,33663,665,93500,3541,1845,3258,529,1532,890,224,83,2818,1949,869,1949,1646,303,2019-01-01,zipcode,Branford
ZCTA5 32009,12,3661,68929,1308,157000,3023,912,2419,182,1131,804,244,58,1350,1238,112,1238,1123,115,2019-01-01,zipcode,Bryceville
ZCTA5 32011,12,14509,63772,794,172900,11784,4422,10233,1369,4566,2886,907,505,5896,5374,522,5374,4452,922,2019-01-01,zipcode,Callahan
ZCTA5 32024,12,19452,56830,894,135400,15789,6704,13726,1766,5122,4481,1638,719,7860,6996,864,6996,5837,1159,2019-01-01,zipcode,Lake city
ZCTA5 32025,12,23416,45114,867,118100,18927,10224,15546,2503,5615,5166,1549,713,9062,7756,1306,7756,4435,3321,2019-01-01,zipcode,Lake city
ZCTA5 32026,12,2002,-666666666,-666666666,-666666666,2002,2002,1854,872,679,238,45,20,0,0,0,0,0,0,2019-01-01,zipcode,Raiford
ZCTA5 32033,12,4676,59375,1435,180300,4203,2108,3590,399,1028,1295,534,334,1999,1803,196,1803,1489,314,2019-01-01,zipcode,Elkton
ZCTA5 32034,12,36395,74668,1112,334200,31227,14819,28807,1497,6321,8300,7425,5264,20483,15707,4776,15707,12384,3323,2019-01-01,zipcode,Fernandina beach
ZCTA5 32038,12,10184,39879,776,107700,8380,4295,7455,906,2740,2828,638,343,4795,3944,851,3944,3235,709,2019-01-01,zipcode,Fort white
ZCTA5 32040,12,7329,52528,827,117900,5451,2249,4714,712,2253,1124,489,136,2900,2495,405,2495,2076,419,2019-01-01,zipcode,Glen saint mary
ZCTA5 32043,12,26743,67661,1057,200900,21033,8542,18372,1932,6086,6394,2632,1328,10121,9305,816,9305,7057,2248,2019-01-01,zipcode,Green cove springs
ZCTA5 32044,12,1711,44555,597,-666666666,1388,707,1223,241,506,354,91,31,941,747,194,747,577,170,2019-01-01,zipcode,Hampton
ZCTA5 32046,12,9418,60649,913,150900,7603,3477,6556,931,2839,2172,461,153,3783,3410,373,3410,2593,817,2019-01-01,zipcode,Hilliard
ZCTA5 32052,12,9427,42738,598,83600,8191,5492,7102,2018,3399,1254,344,87,3182,2467,715,2467,1562,905,2019-01-01,zipcode,Jasper
ZCTA5 32053,12,3538,36250,737,80000,2539,1476,2143,582,778,517,203,63,1793,1235,558,1235,944,291,2019-01-01,zipcode,Jennings
ZCTA5 32054,12,11811,42851,617,120400,9702,6100,8499,1864,3279,2482,606,268,4000,3504,496,3504,2403,1101,2019-01-01,zipcode,Lake butler
ZCTA5 32055,12,16590,40000,797,122700,13102,6188,11512,1803,4343,3815,1043,508,6860,5960,900,5960,3991,1969,2019-01-01,zipcode,Lake city
ZCTA5 32058,12,4368,41552,798,101100,3619,2128,2961,681,1410,696,111,63,1464,1218,246,1218,968,250,2019-01-01,zipcode,Lawtey
ZCTA5 32059,12,2418,43321,743,82800,1917,900,1758,363,659,599,96,41,1195,1003,192,1003,842,161,2019-01-01,zipcode,Lee
ZCTA5 32060,12,24064,49731,741,113600,18978,9627,16597,3028,6351,4765,1662,791,9868,7856,2012,7856,5911,1945,2019-01-01,zipcode,Live oak
ZCTA5 32061,12,514,85375,-666666666,190100,433,173,300,95,132,47,26,0,144,122,22,122,87,35,2019-01-01,zipcode,Lulu
ZCTA5 32062,12,1826,56683,-666666666,69600,1601,741,1418,160,717,323,75,143,999,625,374,625,599,26,2019-01-01,zipcode,Mc alpin
ZCTA5 32063,12,13482,67009,814,163500,10710,5022,9388,859,3594,3377,905,653,5050,4404,646,4404,3054,1350,2019-01-01,zipcode,Macclenny
ZCTA5 32064,12,6890,47859,717,110600,5866,2377,4878,652,1491,1353,944,438,3248,2441,807,2441,1410,1031,2019-01-01,zipcode,Live oak
ZCTA5 32065,12,37195,69923,1222,199000,28946,9868,24762,1878,7013,9010,4617,2244,13397,12585,812,12585,9433,3152,2019-01-01,zipcode,Orange park
ZCTA5 32066,12,7420,49953,518,105000,6152,3868,5168,1389,1988,1246,191,354,2386,1770,616,1770,1490,280,2019-01-01,zipcode,Mayo
ZCTA5 32068,12,57305,63486,1165,161900,45017,17137,38541,3392,14540,13695,5134,1780,21624,19670,1954,19670,15393,4277,2019-01-01,zipcode,Middleburg
ZCTA5 32071,12,3903,37424,641,104400,2929,1321,2525,479,919,852,238,37,1747,1359,388,1359,1007,352,2019-01-01,zipcode,O brien
ZCTA5 32072,12,211,88516,-666666666,67800,211,74,211,0,82,55,74,0,145,109,36,109,109,0,2019-01-01,zipcode,
ZCTA5 32073,12,42520,60088,1098,173600,34399,12115,29525,2347,8158,11528,5143,2349,16290,15384,906,15384,9885,5499,2019-01-01,zipcode,Orange park
ZCTA5 32079,12,451,41685,1404,91900,451,423,451,47,85,46,150,123,296,233,63,233,19,214,2019-01-01,zipcode,Penney farms
ZCTA5 32080,12,22261,75719,1201,374500,19664,9560,17511,601,3309,4659,5178,3764,15928,9736,6192,9736,7587,2149,2019-01-01,zipcode,Saint augustine
ZCTA5 32081,12,14856,119105,1924,389900,11055,4286,9724,79,1278,2644,3281,2442,5859,4925,934,4925,4241,684,2019-01-01,zipcode,Ponte vedra
ZCTA5 32082,12,30539,111853,1420,527400,25791,10969,22808,544,2712,5067,9094,5391,15265,12631,2634,12631,10219,2412,2019-01-01,zipcode,Ponte vedra beach
ZCTA5 32083,12,4115,53966,749,113700,3692,3201,3454,890,1322,1055,129,58,631,540,91,540,321,219,2019-01-01,zipcode,Raiford
ZCTA5 32084,12,35761,52592,1021,195400,30715,12618,25601,2558,8316,7437,4887,2403,16266,13015,3251,13015,8797,4218,2019-01-01,zipcode,Saint augustine
ZCTA5 32086,12,29580,56069,1144,228400,25387,11139,22715,1569,5910,8640,4389,2207,13530,11607,1923,11607,8948,2659,2019-01-01,zipcode,Saint augustine
ZCTA5 32087,12,7097,65345,677,75000,5644,3162,4660,1139,2110,1143,201,67,1838,1624,214,1624,1244,380,2019-01-01,zipcode,Sanderson
ZCTA5 32091,12,15256,42036,842,94600,11989,5591,10734,1794,4275,3688,708,269,6754,5645,1109,5645,3521,2124,2019-01-01,zipcode,Starke
ZCTA5 32092,12,37014,90055,1753,280400,28148,9899,25603,1647,5574,7318,6718,4346,14193,12477,1716,12477,10925,1552,2019-01-01,zipcode,Saint augustine
ZCTA5 32094,12,2575,52500,882,76500,2351,1585,2185,322,1088,556,107,112,1286,958,328,958,850,108,2019-01-01,zipcode,Wellborn
ZCTA5 32095,12,11800,75016,1219,317200,8902,3378,7858,300,2016,2087,2160,1295,4442,4099,343,4099,3283,816,2019-01-01,zipcode,Saint augustine
ZCTA5 32096,12,2186,40820,492,85500,1971,1158,1803,277,830,463,147,86,1336,1062,274,1062,775,287,2019-01-01,zipcode,White springs
ZCTA5 32097,12,19030,70263,1198,201900,14924,5242,12982,1319,4473,4154,2089,947,7426,6837,589,6837,5492,1345,2019-01-01,zipcode,Yulee
ZCTA5 32102,12,2283,41250,1152,135600,2005,1133,1740,370,558,462,247,103,1744,1062,682,1062,894,168,2019-01-01,zipcode,Astor
ZCTA5 32110,12,8267,35609,769,126800,6840,3479,5988,942,2745,1546,546,209,3600,3013,587,3013,2008,1005,2019-01-01,zipcode,Bunnell
ZCTA5 32112,12,7646,35722,602,100500,5957,3240,5155,1638,1833,1171,361,152,4019,2947,1072,2947,2070,877,2019-01-01,zipcode,Crescent city
ZCTA5 32113,12,5216,36787,845,84700,4268,1943,3557,687,1575,1031,170,94,2551,1805,746,1805,1459,346,2019-01-01,zipcode,Citra
ZCTA5 32114,12,32847,29220,879,107400,27606,13318,21400,3296,6567,7492,2743,1302,16187,13466,2721,13466,4402,9064,2019-01-01,zipcode,Daytona beach
ZCTA5 32117,12,26425,36915,971,104300,22023,9745,19326,2358,7318,6639,2090,921,12646,10674,1972,10674,5727,4947,2019-01-01,zipcode,Daytona beach
ZCTA5 32118,12,17520,44200,969,234800,15788,8076,14693,1061,4050,4799,2994,1789,15393,9052,6341,9052,5588,3464,2019-01-01,zipcode,Daytona beach
ZCTA5 32119,12,22344,40018,1062,145800,19545,9247,16537,1595,5662,5494,2433,1353,11744,10041,1703,10041,5907,4134,2019-01-01,zipcode,Daytona beach
ZCTA5 32124,12,6117,64757,1770,225700,5379,3210,4796,1010,1503,987,722,574,1968,1781,187,1781,1380,401,2019-01-01,zipcode,Daytona beach
ZCTA5 32127,12,30398,51178,1128,191900,25753,12304,23102,1695,7147,8309,3617,2334,16080,12814,3266,12814,9675,3139,2019-01-01,zipcode,Port orange
ZCTA5 32128,12,21183,73890,1465,264100,17590,8376,15782,703,3423,5137,3981,2538,9380,8421,959,8421,6993,1428,2019-01-01,zipcode,Port orange
ZCTA5 32129,12,22185,45208,1122,139600,19313,8177,16899,1812,5627,6140,2349,971,11075,9829,1246,9829,6652,3177,2019-01-01,zipcode,Port orange
ZCTA5 32130,12,5703,50219,1038,175600,4750,2330,4184,605,1587,1169,528,295,2392,1990,402,1990,1609,381,2019-01-01,zipcode,De leon springs
ZCTA5 32131,12,4365,41431,836,130600,3583,2014,3346,594,1343,761,362,286,2096,1653,443,1653,1232,421,2019-01-01,zipcode,East palatka
ZCTA5 32132,12,7570,46016,879,149000,6659,3219,6165,480,2300,2517,514,354,3733,3365,368,3365,2688,677,2019-01-01,zipcode,Edgewater
ZCTA5 32133,12,17,-666666666,-666666666,-666666666,17,8,17,0,0,17,0,0,59,8,51,8,8,0,2019-01-01,zipcode,Eastlake weir
ZCTA5 32134,12,7754,35087,728,79100,6462,4086,5825,933,2695,1621,350,226,5947,3117,2830,3117,2583,534,2019-01-01,zipcode,Fort mc coy
ZCTA5 32136,12,8306,51734,1153,265100,7440,4326,7128,341,1896,2487,1408,996,5606,3949,1657,3949,3255,694,2019-01-01,zipcode,Flagler beach
ZCTA5 32137,12,43876,60637,1338,242400,38281,21400,34375,2338,11625,10352,6251,3809,22379,17198,5181,17198,13855,3343,2019-01-01,zipcode,Palm coast
ZCTA5 32139,12,971,31438,959,71000,811,537,760,260,287,145,45,23,721,430,291,430,359,71,2019-01-01,zipcode,Georgetown
ZCTA5 32140,12,1439,49219,915,61400,1325,527,1153,206,384,516,23,24,745,560,185,560,475,85,2019-01-01,zipcode,Florahome
ZCTA5 32141,12,19031,52150,1116,161100,16145,8062,14652,1553,5957,4858,1327,957,8600,7605,995,7605,6072,1533,2019-01-01,zipcode,Edgewater
ZCTA5 32145,12,5723,43153,847,88800,4441,1996,3799,678,1410,1306,274,131,2322,1951,371,1951,1593,358,2019-01-01,zipcode,Hastings
ZCTA5 32147,12,790,-666666666,-666666666,21800,587,164,427,58,146,50,173,0,258,214,44,214,167,47,2019-01-01,zipcode,Hollister
ZCTA5 32148,12,10710,34563,707,59900,8191,4509,7139,1248,3541,1692,440,218,5562,4212,1350,4212,2991,1221,2019-01-01,zipcode,Interlachen
ZCTA5 32157,12,363,48500,838,145800,327,131,282,107,76,79,20,0,251,158,93,158,90,68,2019-01-01,zipcode,
ZCTA5 32159,12,29920,45576,1040,186600,27446,18962,26337,1987,9421,8548,3541,2840,18915,15318,3597,15318,12422,2896,2019-01-01,zipcode,Lady lake
ZCTA5 32162,12,54951,63877,1454,271400,54244,47512,53979,1379,13458,16736,13333,9073,37211,30155,7056,30155,28752,1403,2019-01-01,zipcode,The villages
ZCTA5 32164,12,47341,53213,1281,199400,38831,17393,34569,2847,12053,12518,4575,2576,19092,16964,2128,16964,11972,4992,2019-01-01,zipcode,Palm coast
ZCTA5 32168,12,27679,54300,1076,217400,23946,12520,21750,1933,6411,7462,4196,1748,13936,11689,2247,11689,9089,2600,2019-01-01,zipcode,New smyrna beach
ZCTA5 32169,12,10228,69214,1335,367600,9529,5360,9096,355,1731,3256,2150,1604,11823,5415,6408,5415,4267,1148,2019-01-01,zipcode,New smyrna beach
ZCTA5 32174,12,51165,54513,1080,215300,44250,22187,40133,2789,11315,14460,7410,4159,25085,22481,2604,22481,17392,5089,2019-01-01,zipcode,Ormond beach
ZCTA5 32176,12,14460,48153,1204,222900,13096,7057,12156,680,3273,4090,2325,1788,10528,7084,3444,7084,5424,1660,2019-01-01,zipcode,Ormond beach
ZCTA5 32177,12,26845,36592,731,96300,21461,10718,18892,3069,8226,5286,1468,843,11694,10389,1305,10389,6514,3875,2019-01-01,zipcode,Palatka
ZCTA5 32179,12,7919,34338,799,77300,6662,3629,5914,1018,2625,1493,444,334,4760,3254,1506,3254,2563,691,2019-01-01,zipcode,Ocklawaha
ZCTA5 32180,12,4535,49063,825,123000,3447,1647,2975,708,908,1017,247,95,1611,1415,196,1415,1211,204,2019-01-01,zipcode,Pierson
ZCTA5 32181,12,2558,37011,778,92400,2001,1087,1570,233,608,458,179,92,1469,997,472,997,732,265,2019-01-01,zipcode,Pomona park
ZCTA5 32187,12,1871,36509,790,124200,1558,836,1470,251,585,517,77,40,770,724,46,724,541,183,2019-01-01,zipcode,San mateo
ZCTA5 32189,12,5874,35860,822,70200,5042,2680,4542,869,1832,1434,349,58,4061,2631,1430,2631,2058,573,2019-01-01,zipcode,Satsuma
ZCTA5 32190,12,1309,43611,628,119600,1117,450,798,251,288,125,82,52,537,422,115,422,326,96,2019-01-01,zipcode,Seville
ZCTA5 32193,12,705,42083,707,115000,562,360,490,62,247,135,25,21,584,307,277,307,233,74,2019-01-01,zipcode,Welaka
ZCTA5 32195,12,2926,40164,1439,129700,2616,1335,2284,313,916,806,144,105,1455,1215,240,1215,1034,181,2019-01-01,zipcode,Weirsdale
ZCTA5 32202,12,6523,33967,612,117400,6105,4471,5093,1254,1461,1365,637,376,2422,1986,436,1986,219,1767,2019-01-01,zipcode,Jacksonville
ZCTA5 32204,12,7547,45375,987,202400,6582,1921,5578,675,1139,1388,1491,885,4501,3815,686,3815,1035,2780,2019-01-01,zipcode,Jacksonville
ZCTA5 32205,12,30305,46649,930,162800,24088,7503,21652,2621,5664,6909,3993,2465,14893,13020,1873,13020,6045,6975,2019-01-01,zipcode,Jacksonville
ZCTA5 32206,12,16027,28952,783,81900,12915,5599,11234,2496,3793,3354,978,613,8975,6550,2425,6550,2812,3738,2019-01-01,zipcode,Jacksonville
ZCTA5 32207,12,35488,50465,936,164500,27573,8722,24398,3927,5943,6553,4931,3044,16823,14599,2224,14599,7387,7212,2019-01-01,zipcode,Jacksonville
ZCTA5 32208,12,30841,34565,945,78400,24599,11194,21490,3784,7829,7160,1915,802,14479,12334,2145,12334,6687,5647,2019-01-01,zipcode,Jacksonville
ZCTA5 32209,12,34945,25499,779,59800,26250,12245,22620,4872,10238,5667,1356,487,16772,13167,3605,13167,5981,7186,2019-01-01,zipcode,Jacksonville
ZCTA5 32210,12,62048,47047,969,128000,48144,16245,41874,5303,13595,14153,5987,2836,27014,23643,3371,23643,12387,11256,2019-01-01,zipcode,Jacksonville
ZCTA5 32211,12,35657,43699,903,127600,26908,8605,22286,2796,7731,7834,2810,1115,14879,13312,1567,13312,6045,7267,2019-01-01,zipcode,Jacksonville
ZCTA5 32212,12,2466,36827,1685,-666666666,1995,69,552,10,104,301,81,56,239,231,8,231,4,227,2019-01-01,zipcode,Jacksonville
ZCTA5 32216,12,38231,53988,1049,158200,31272,10963,27450,2929,7521,8291,5990,2719,17727,15623,2104,15623,7298,8325,2019-01-01,zipcode,Jacksonville
ZCTA5 32217,12,19899,46313,889,195800,16542,5583,14384,1092,3860,4100,3392,1940,9551,8671,880,8671,4335,4336,2019-01-01,zipcode,Jacksonville
ZCTA5 32218,12,64007,57383,1100,169400,49621,17734,41430,4184,13516,14144,6718,2868,24699,22199,2500,22199,13623,8576,2019-01-01,zipcode,Jacksonville
ZCTA5 32219,12,12685,49910,916,140900,10672,4279,8928,1148,3503,2938,753,586,4829,4335,494,4335,3590,745,2019-01-01,zipcode,Jacksonville
ZCTA5 32220,12,12981,57405,972,144200,10174,3797,8896,1270,3626,2513,1047,440,5183,4703,480,4703,3907,796,2019-01-01,zipcode,Jacksonville
ZCTA5 32221,12,30900,63900,1264,165300,23693,9020,20029,2799,6592,6532,3035,1071,10927,10274,653,10274,7667,2607,2019-01-01,zipcode,Jacksonville
ZCTA5 32222,12,11521,63707,1119,193100,8791,2836,7601,536,1972,3639,1081,373,4775,3945,830,3945,2810,1135,2019-01-01,zipcode,Jacksonville
ZCTA5 32223,12,24571,84905,1187,269100,20574,7025,18430,760,3657,6433,4617,2963,10219,9785,434,9785,8165,1620,2019-01-01,zipcode,Jacksonville
ZCTA5 32224,12,44058,78639,1291,299000,35468,12229,27704,1537,5088,8291,8226,4562,17949,16089,1860,16089,9691,6398,2019-01-01,zipcode,Jacksonville
ZCTA5 32225,12,55018,75758,1341,225500,43889,13546,37474,2144,9218,12339,9311,4462,22021,20210,1811,20210,13793,6417,2019-01-01,zipcode,Jacksonville
ZCTA5 32226,12,15667,81396,1684,223100,12328,4313,10955,1016,3044,3445,2528,922,6470,5577,893,5577,4842,735,2019-01-01,zipcode,Jacksonville
ZCTA5 32227,12,3337,59896,1644,-666666666,2502,264,892,18,199,491,104,80,560,413,147,413,5,408,2019-01-01,zipcode,Jacksonville
ZCTA5 32228,12,470,-666666666,-666666666,-666666666,470,0,107,0,9,68,30,0,0,0,0,0,0,0,2019-01-01,zipcode,Jacksonville
ZCTA5 32233,12,24979,63328,1191,270400,21208,6129,17926,1180,4638,5308,4376,2424,10986,9655,1331,9655,5619,4036,2019-01-01,zipcode,Atlantic beach
ZCTA5 32234,12,5867,59349,799,110700,4898,1885,4384,829,1892,1254,267,142,2548,2253,295,2253,1726,527,2019-01-01,zipcode,Jacksonville
ZCTA5 32244,12,59402,54778,1083,133000,46049,14474,39713,4021,13022,14593,5998,2079,24450,21504,2946,21504,12565,8939,2019-01-01,zipcode,Jacksonville
ZCTA5 32246,12,51589,60038,1201,182100,41946,11953,36701,2954,8982,12449,8757,3559,22777,20318,2459,20318,10688,9630,2019-01-01,zipcode,Jacksonville
ZCTA5 32250,12,27246,88794,1426,366600,23028,7280,21032,1063,3193,5276,7256,4244,14676,12380,2296,12380,8581,3799,2019-01-01,zipcode,Jacksonville beach
ZCTA5 32254,12,13431,33167,900,62000,9941,4369,8671,2064,3639,2350,441,177,5977,4763,1214,4763,2383,2380,2019-01-01,zipcode,Jacksonville
ZCTA5 32256,12,47943,63779,1217,272200,40318,11846,34161,1496,5641,9886,10689,6449,23703,21443,2260,21443,8090,13353,2019-01-01,zipcode,Jacksonville
ZCTA5 32257,12,39000,61036,1092,209800,31315,10119,27872,2218,6776,8613,6786,3479,16918,15541,1377,15541,9678,5863,2019-01-01,zipcode,Jacksonville
ZCTA5 32258,12,34036,81632,1428,236700,26289,6809,23728,655,4433,7894,6765,3981,13981,12802,1179,12802,8776,4026,2019-01-01,zipcode,Jacksonville
ZCTA5 32259,12,52296,118479,1846,349400,39330,13254,34026,601,5541,9305,12116,6463,17444,16519,925,16519,14246,2273,2019-01-01,zipcode,Saint johns
ZCTA5 32266,12,7101,90037,1372,401000,6028,1665,5141,102,618,1515,1782,1124,3490,3048,442,3048,2044,1004,2019-01-01,zipcode,Neptune beach
ZCTA5 32277,12,32327,51188,986,166800,25743,8296,20984,1884,6588,7677,3488,1347,13293,12084,1209,12084,6155,5929,2019-01-01,zipcode,Jacksonville
ZCTA5 32301,12,31317,45235,995,155200,26680,8373,18195,1362,3600,5619,4419,3195,15360,12813,2547,12813,3897,8916,2019-01-01,zipcode,Tallahassee
ZCTA5 32303,12,48507,50726,1041,152000,40068,11203,31314,1827,6097,10474,8006,4910,22872,20680,2192,20680,10548,10132,2019-01-01,zipcode,Tallahassee
ZCTA5 32304,12,49927,23638,944,91800,46650,18201,15162,2104,3523,4777,2511,2247,21697,17635,4062,17635,2177,15458,2019-01-01,zipcode,Tallahassee
ZCTA5 32305,12,20902,40701,862,101600,16305,6268,13030,1972,4021,4307,1667,1063,9200,7723,1477,7723,4724,2999,2019-01-01,zipcode,Tallahassee
ZCTA5 32308,12,22029,65949,1112,229900,18422,6160,16035,509,2217,3928,4661,4720,11275,10321,954,10321,5661,4660,2019-01-01,zipcode,Tallahassee
ZCTA5 32309,12,31597,80902,1104,261400,25217,9409,21972,562,3084,5556,7053,5717,13049,12438,611,12438,10002,2436,2019-01-01,zipcode,Tallahassee
ZCTA5 32310,12,15544,36127,890,98700,12692,5431,8817,1357,3247,2360,1276,577,7708,5621,2087,5621,2479,3142,2019-01-01,zipcode,Tallahassee
ZCTA5 32311,12,22264,74244,1194,209700,18064,5619,15458,653,2807,4005,4287,3706,9411,8401,1010,8401,5299,3102,2019-01-01,zipcode,Tallahassee
ZCTA5 32312,12,32783,100360,1329,302100,26136,9005,22161,514,2202,5295,7585,6565,13583,12544,1039,12544,10531,2013,2019-01-01,zipcode,Tallahassee
ZCTA5 32317,12,14876,88306,1268,260300,11682,3998,10062,298,1939,2386,3187,2252,5842,5474,368,5474,4874,600,2019-01-01,zipcode,Tallahassee
ZCTA5 32320,12,3887,49292,697,154800,3156,1320,2821,643,888,802,295,193,2050,1519,531,1519,1024,495,2019-01-01,zipcode,Apalachicola
ZCTA5 32321,12,6321,35822,627,63800,5520,3815,4463,980,2063,932,263,225,2514,1630,884,1630,1209,421,2019-01-01,zipcode,Bristol
ZCTA5 32322,12,3994,38533,757,150600,3534,2649,3271,721,1290,831,276,153,1969,1142,827,1142,900,242,2019-01-01,zipcode,Carrabelle
ZCTA5 32323,12,137,-666666666,-666666666,-666666666,137,114,137,23,44,30,18,22,421,91,330,91,67,24,2019-01-01,zipcode,
ZCTA5 32324,12,4716,33505,756,67900,4088,2669,3588,897,1435,962,199,95,2128,1757,371,1757,1166,591,2019-01-01,zipcode,Chattahoochee
ZCTA5 32327,12,28525,64308,903,149600,23395,10644,20444,2475,7504,6774,2406,1285,11087,9578,1509,9578,7808,1770,2019-01-01,zipcode,Crawfordville
ZCTA5 32328,12,3415,45625,855,180400,2866,1247,2516,334,829,730,379,244,3149,1423,1726,1423,1111,312,2019-01-01,zipcode,Eastpoint
ZCTA5 32330,12,651,34836,840,75200,443,228,416,110,170,93,30,13,298,229,69,229,131,98,2019-01-01,zipcode,Greensboro
ZCTA5 32331,12,4193,38990,684,73100,3419,1761,2961,545,1265,673,323,155,2005,1593,412,1593,1280,313,2019-01-01,zipcode,Greenville
ZCTA5 32332,12,1077,26094,612,72900,868,474,734,170,324,153,71,16,616,473,143,473,293,180,2019-01-01,zipcode,Gretna
ZCTA5 32333,12,11314,48340,455,117700,9700,4665,8542,1654,2799,2316,1133,640,5670,4828,842,4828,3818,1010,2019-01-01,zipcode,Havana
ZCTA5 32334,12,2024,39596,581,117900,1673,857,1499,131,668,330,287,83,1107,829,278,829,646,183,2019-01-01,zipcode,Hosford
ZCTA5 32336,12,1128,36500,-666666666,111100,861,422,821,113,324,236,88,60,845,462,383,462,399,63,2019-01-01,zipcode,Lamont
ZCTA5 32340,12,11374,34629,658,98200,9608,5836,8430,1655,3371,2131,770,503,4929,3885,1044,3885,2660,1225,2019-01-01,zipcode,Madison
ZCTA5 32343,12,3221,59625,959,147700,2337,498,2052,247,676,614,263,252,1366,1237,129,1237,942,295,2019-01-01,zipcode,Midway
ZCTA5 32344,12,12356,43880,782,148400,10632,5917,9681,1813,3329,2358,1350,831,5929,5047,882,5047,3817,1230,2019-01-01,zipcode,Monticello
ZCTA5 32346,12,1933,48669,1579,116400,1577,691,1486,260,456,508,230,32,1725,924,801,924,748,176,2019-01-01,zipcode,Panacea
ZCTA5 32347,12,7609,49397,626,97500,5877,2765,5229,621,2049,1935,442,182,3696,2950,746,2950,2400,550,2019-01-01,zipcode,Perry
ZCTA5 32348,12,12935,36425,739,71100,10978,7628,9667,2584,4335,2057,436,255,4920,3755,1165,3755,2789,966,2019-01-01,zipcode,Perry
ZCTA5 32350,12,1272,39255,695,107500,1130,671,1078,123,390,420,123,22,756,629,127,629,515,114,2019-01-01,zipcode,Pinetta
ZCTA5 32351,12,18720,37467,656,84300,14268,7919,12329,2859,4392,3309,1164,605,7388,6245,1143,6245,4290,1955,2019-01-01,zipcode,Quincy
ZCTA5 32352,12,6246,47019,681,107500,5039,2162,4490,548,1843,1365,520,214,2827,2380,447,2380,1869,511,2019-01-01,zipcode,Quincy
ZCTA5 32355,12,244,35833,933,170800,213,111,197,18,66,77,29,7,199,124,75,124,86,38,2019-01-01,zipcode,Saint marks
ZCTA5 32356,12,0,-666666666,-666666666,-666666666,0,0,0,0,0,0,0,0,22,0,22,0,0,0,2019-01-01,zipcode,Salem
ZCTA5 32358,12,2021,54797,840,115200,1643,768,1611,155,528,499,297,132,1612,851,761,851,758,93,2019-01-01,zipcode,Sopchoppy
ZCTA5 32359,12,1271,33667,-666666666,108800,1190,787,1150,226,671,204,18,31,2487,704,1783,704,480,224,2019-01-01,zipcode,Steinhatchee
ZCTA5 32361,12,383,58458,-666666666,84100,279,124,273,30,89,134,20,0,191,161,30,161,148,13,2019-01-01,zipcode,Wacissa
ZCTA5 32399,12,0,-666666666,-666666666,-666666666,0,0,0,0,0,0,0,0,0,0,0,0,0,0,2019-01-01,zipcode,Tallahassee
ZCTA5 32401,12,22027,39447,883,126900,17976,7713,15735,2468,5291,5071,1777,1128,11077,9333,1744,9333,4668,4665,2019-01-01,zipcode,Panama city
ZCTA5 32403,12,2779,64132,1639,-666666666,1801,463,1132,19,134,379,408,192,817,641,176,641,0,641,2019-01-01,zipcode,Panama city
ZCTA5 32404,12,39503,53662,975,157400,31340,12220,27074,3060,9250,10834,2437,1493,17026,14263,2763,14263,9810,4453,2019-01-01,zipcode,Panama city
ZCTA5 32405,12,32239,50749,1000,177100,25750,10017,22621,1752,7403,7597,3573,2296,14648,12846,1802,12846,7526,5320,2019-01-01,zipcode,Panama city
ZCTA5 32407,12,10822,63022,1363,222000,9333,3040,8099,533,2140,3034,1568,824,8338,4760,3578,4760,2526,2234,2019-01-01,zipcode,Panama city beach
ZCTA5 32408,12,18864,57643,1127,238600,15550,5195,13527,793,3727,4600,3022,1385,17565,7970,9595,7970,5239,2731,2019-01-01,zipcode,Panama city
ZCTA5 32409,12,10144,60269,685,163300,8147,3352,7129,937,2418,2844,658,272,4363,3743,620,3743,3156,587,2019-01-01,zipcode,Panama city
ZCTA5 32410,12,964,63523,1356,248700,944,494,898,28,171,340,190,169,1486,499,987,499,371,128,2019-01-01,zipcode,Mexico beach
ZCTA5 32413,12,14805,67103,1111,256000,12876,5378,11997,805,3276,3927,2796,1193,18042,6554,11488,6554,4881,1673,2019-01-01,zipcode,Panama city beach
ZCTA5 32420,12,1958,32353,689,82300,1668,961,1512,373,567,440,80,52,1209,896,313,896,787,109,2019-01-01,zipcode,Alford
ZCTA5 32421,12,4834,36857,604,77800,3885,1851,3405,713,1325,1020,275,72,2044,1605,439,1605,1332,273,2019-01-01,zipcode,Altha
ZCTA5 32423,12,966,65288,-666666666,94200,829,419,770,62,218,370,98,22,517,430,87,430,372,58,2019-01-01,zipcode,Bascom
ZCTA5 32424,12,7514,38447,594,91800,6180,3978,5603,1477,2378,1204,361,183,2924,2177,747,2177,1725,452,2019-01-01,zipcode,Blountstown
ZCTA5 32425,12,13586,37296,695,91800,11129,6513,9786,2260,3821,2754,739,212,5803,4692,1111,4692,3425,1267,2019-01-01,zipcode,Bonifay
ZCTA5 32426,12,814,30341,813,81700,689,381,556,152,259,97,28,20,444,319,125,319,275,44,2019-01-01,zipcode,Campbellton
ZCTA5 32427,12,1034,31227,625,89800,927,497,751,205,285,152,53,56,523,464,59,464,345,119,2019-01-01,zipcode,Caryville
ZCTA5 32428,12,17564,38308,773,120100,14566,8359,12876,2322,5003,3723,1265,563,7224,5872,1352,5872,4559,1313,2019-01-01,zipcode,Chipley
ZCTA5 32430,12,1173,40357,-666666666,75400,982,419,862,148,341,297,76,0,575,440,135,440,360,80,2019-01-01,zipcode,Clarksville
ZCTA5 32431,12,4145,43393,673,102500,3382,1664,2948,640,1215,781,211,101,2237,1733,504,1733,1287,446,2019-01-01,zipcode,Cottondale
ZCTA5 32432,12,0,-666666666,-666666666,-666666666,0,0,0,0,0,0,0,0,0,0,0,0,0,0,2019-01-01,zipcode,Cypress
ZCTA5 32433,12,17877,40737,808,100800,14142,6893,12544,2424,4779,3902,957,482,7612,6395,1217,6395,4510,1885,2019-01-01,zipcode,Defuniak springs
ZCTA5 32435,12,7494,44150,725,136900,6124,2354,5269,688,2057,1492,657,375,3795,2971,824,2971,2166,805,2019-01-01,zipcode,Defuniak springs
ZCTA5 32437,12,843,26250,550,92700,583,273,542,89,271,175,6,1,399,330,69,330,216,114,2019-01-01,zipcode,Ebro
ZCTA5 32438,12,3822,30380,467,76100,3356,1932,2916,498,1548,760,86,24,2000,1517,483,1517,1383,134,2019-01-01,zipcode,Fountain
ZCTA5 32439,12,10413,54901,1023,208100,8322,2713,7193,670,2305,2485,1199,534,4906,3995,911,3995,2872,1123,2019-01-01,zipcode,Freeport
ZCTA5 32440,12,7777,44080,655,105400,6918,4109,5848,1275,2413,1427,471,262,2555,2102,453,2102,1444,658,2019-01-01,zipcode,Graceville
ZCTA5 32442,12,3299,36111,608,143600,2606,1142,2359,550,949,613,149,98,1800,1486,314,1486,1040,446,2019-01-01,zipcode,Grand ridge
ZCTA5 32443,12,3165,39716,675,88400,2471,1269,2199,410,812,667,180,130,1656,1229,427,1229,981,248,2019-01-01,zipcode,Greenwood
ZCTA5 32444,12,22163,72021,1196,213400,17473,5829,14753,542,3516,5255,3359,2081,9099,8033,1066,8033,5882,2151,2019-01-01,zipcode,Lynn haven
ZCTA5 32445,12,2497,34638,675,96700,2209,1735,1956,648,837,376,81,14,632,501,131,501,316,185,2019-01-01,zipcode,Malone
ZCTA5 32446,12,11115,49087,743,137000,9434,4672,8033,1073,2564,2877,834,685,4781,4016,765,4016,2604,1412,2019-01-01,zipcode,Marianna
ZCTA5 32447,12,159,-666666666,-666666666,-666666666,88,88,0,0,0,0,0,0,0,0,0,0,0,0,2019-01-01,zipcode,Marianna
ZCTA5 32448,12,8405,27059,461,85400,6706,3061,6056,847,2564,1932,373,340,4540,3871,669,3871,2445,1426,2019-01-01,zipcode,Marianna
ZCTA5 32449,12,552,51898,-666666666,73100,393,185,365,64,146,155,0,0,247,161,86,161,153,8,2019-01-01,zipcode,Wewahitchka
ZCTA5 32455,12,4081,44688,690,86500,3468,1600,2985,791,1294,658,150,92,2260,1641,619,1641,1324,317,2019-01-01,zipcode,Ponce de leon
ZCTA5 32456,12,8036,53713,1150,208900,6624,2836,5912,455,1701,1987,954,815,6307,3339,2968,3339,2402,937,2019-01-01,zipcode,Port saint joe
ZCTA5 32459,12,17213,81766,1605,378200,14161,5415,13013,473,2500,4396,3982,1662,14882,7224,7658,7224,5663,1561,2019-01-01,zipcode,Santa rosa beach
ZCTA5 32460,12,5690,39564,659,89400,4923,3552,4390,1061,1836,1168,218,107,1798,1483,315,1483,1094,389,2019-01-01,zipcode,Sneads
ZCTA5 32461,12,36,-666666666,-666666666,-666666666,36,11,36,0,0,0,36,0,178,25,153,25,25,0,2019-01-01,zipcode,Inlet beach
ZCTA5 32462,12,3488,38542,667,98800,2960,1305,2533,368,1181,782,144,58,1845,1423,422,1423,1111,312,2019-01-01,zipcode,Vernon
ZCTA5 32463,12,216,44167,637,81100,170,59,134,26,35,73,0,0,88,88,0,88,34,54,2019-01-01,zipcode,Wausau
ZCTA5 32464,12,4367,43010,675,103000,3661,1797,3229,719,1225,845,282,158,2303,1857,446,1857,1682,175,2019-01-01,zipcode,Westville
ZCTA5 32465,12,7962,39939,775,90900,7103,4615,6376,1316,2659,1785,456,160,3630,2599,1031,2599,1983,616,2019-01-01,zipcode,Wewahitchka
ZCTA5 32466,12,5795,56033,940,117200,4556,2079,3966,694,1340,1663,173,96,2440,1940,500,1940,1665,275,2019-01-01,zipcode,Youngstown
ZCTA5 32501,12,11134,29422,728,135200,8790,4572,7665,1264,2201,2265,1173,762,5329,4324,1005,4324,2105,2219,2019-01-01,zipcode,Pensacola
ZCTA5 32502,12,3331,53306,1004,160500,2715,927,2487,226,591,835,442,393,1794,1535,259,1535,837,698,2019-01-01,zipcode,Pensacola
ZCTA5 32503,12,34233,50032,913,171200,28124,10786,20497,1535,4678,7325,3991,2968,13636,12086,1550,12086,7475,4611,2019-01-01,zipcode,Pensacola
ZCTA5 32504,12,22562,52824,982,172600,16925,6201,14112,796,3281,4751,2995,2289,9808,8950,858,8950,5312,3638,2019-01-01,zipcode,Pensacola
ZCTA5 32505,12,26354,37789,898,66000,21142,8934,18822,2902,7585,6158,1487,690,13403,11027,2376,11027,5199,5828,2019-01-01,zipcode,Pensacola
ZCTA5 32506,12,36664,50275,1052,123600,29220,11530,25160,2912,6372,10458,3602,1816,16139,14210,1929,14210,8062,6148,2019-01-01,zipcode,Pensacola
ZCTA5 32507,12,31036,48939,959,155600,25282,9734,21357,1839,4969,8343,3887,2319,17739,12914,4825,12914,7514,5400,2019-01-01,zipcode,Pensacola
ZCTA5 32508,12,5383,44107,1328,-666666666,5062,470,1013,11,137,446,353,66,657,545,112,545,0,545,2019-01-01,zipcode,Pensacola
ZCTA5 32509,12,675,-666666666,-666666666,-666666666,675,675,675,49,223,297,26,80,0,0,0,0,0,0,2019-01-01,zipcode,Pensacola
ZCTA5 32511,12,1034,-666666666,-666666666,-666666666,1034,49,109,0,19,64,26,0,0,0,0,0,0,0,2019-01-01,zipcode,Pensacola
ZCTA5 32514,12,42444,49889,1021,145400,34520,12625,27295,2770,6335,9138,6110,2942,18675,16570,2105,16570,8131,8439,2019-01-01,zipcode,Pensacola
ZCTA5 32526,12,37470,60007,1076,134500,30978,12399,27417,2123,7778,10979,4479,2058,16393,14638,1755,14638,11258,3380,2019-01-01,zipcode,Pensacola
ZCTA5 32530,12,40,-666666666,-666666666,-666666666,20,0,20,0,0,20,0,0,7,7,0,7,7,0,2019-01-01,zipcode,Bagdad
ZCTA5 32531,12,5526,57424,991,178100,4517,2017,4175,400,1673,1456,419,227,2688,2206,482,2206,1870,336,2019-01-01,zipcode,Baker
ZCTA5 32533,12,29713,75173,1058,171000,23820,9395,20822,1539,5900,7521,4010,1852,11771,10755,1016,10755,9228,1527,2019-01-01,zipcode,Cantonment
ZCTA5 32534,12,14742,50407,1067,119600,12544,4717,10943,641,3230,4685,1712,675,7010,6437,573,6437,4479,1958,2019-01-01,zipcode,Pensacola
ZCTA5 32535,12,6094,42663,722,79200,5405,3447,4857,909,2096,1419,290,143,2119,1837,282,1837,1238,599,2019-01-01,zipcode,Century
ZCTA5 32536,12,24105,70651,1084,198500,18297,6560,15020,1324,3670,5994,2615,1417,9417,8466,951,8466,5391,3075,2019-01-01,zipcode,Crestview
ZCTA5 32539,12,30131,59712,986,168300,22860,10298,19676,2143,6482,7477,2609,965,10746,9495,1251,9495,6747,2748,2019-01-01,zipcode,Crestview
ZCTA5 32541,12,19066,80469,1554,368000,15919,5138,14247,596,2711,4601,3890,2449,16749,8174,8575,8174,5254,2920,2019-01-01,zipcode,Destin
ZCTA5 32542,12,3128,45391,1472,-666666666,2361,220,1157,9,181,536,334,97,1038,738,300,738,0,738,2019-01-01,zipcode,Eglin afb
ZCTA5 32544,12,1962,38750,1440,-666666666,1464,120,623,7,109,307,176,24,367,304,63,304,0,304,2019-01-01,zipcode,Hurlburt field
ZCTA5 32547,12,34330,52714,1051,182700,28529,10201,24899,2435,6663,8836,4719,2246,16151,14819,1332,14819,7134,7685,2019-01-01,zipcode,Fort walton beach
ZCTA5 32548,12,21708,54776,1022,182000,18320,6270,16162,1185,4122,6571,2548,1736,13332,9643,3689,9643,5585,4058,2019-01-01,zipcode,Fort walton beach
ZCTA5 32550,12,7978,69410,1201,396500,6949,3204,6355,148,880,2155,1863,1309,13359,3628,9731,3628,2594,1034,2019-01-01,zipcode,Miramar beach
ZCTA5 32561,12,9925,102517,1500,419100,8053,3174,7399,267,934,2036,2237,1925,6516,4203,2313,4203,3465,738,2019-01-01,zipcode,Gulf breeze
ZCTA5 32563,12,25912,72045,1282,243000,20715,7512,18525,837,4051,6444,4439,2754,11047,10208,839,10208,7732,2476,2019-01-01,zipcode,Gulf breeze
ZCTA5 32564,12,2959,72143,1191,169000,2254,936,2186,217,632,951,309,77,1148,1012,136,1012,846,166,2019-01-01,zipcode,Holt
ZCTA5 32565,12,5014,51324,948,120600,4270,1920,3749,296,1419,1363,530,141,2438,2072,366,2072,1604,468,2019-01-01,zipcode,Jay
ZCTA5 32566,12,40232,77584,1360,237100,31466,11943,26915,1603,6335,11381,4769,2827,17714,14632,3082,14632,11684,2948,2019-01-01,zipcode,Navarre
ZCTA5 32567,12,3099,46950,732,120700,2430,1033,2211,313,771,890,149,88,1622,1289,333,1289,1038,251,2019-01-01,zipcode,Laurel hill
ZCTA5 32568,12,2853,53486,682,156400,2357,988,2148,275,847,766,123,137,1293,1115,178,1115,956,159,2019-01-01,zipcode,Mc david
ZCTA5 32569,12,12657,61551,1091,191700,10462,3051,8878,719,2256,3381,1751,771,5384,4873,511,4873,3346,1527,2019-01-01,zipcode,Mary esther
ZCTA5 32570,12,31341,57981,965,144500,25177,10418,21799,1933,6657,8840,3192,1177,13482,11949,1533,11949,7981,3968,2019-01-01,zipcode,Milton
ZCTA5 32571,12,35520,72496,1009,186700,27872,10249,23598,1648,6311,8309,4854,2476,13824,12753,1071,12753,10017,2736,2019-01-01,zipcode,Milton
ZCTA5 32577,12,4390,56543,644,139200,3647,1583,3201,262,910,1295,488,246,1951,1762,189,1762,1511,251,2019-01-01,zipcode,Molino
ZCTA5 32578,12,33130,85497,1275,283800,25909,9427,22735,857,3741,7857,5812,4468,13468,12384,1084,12384,9429,2955,2019-01-01,zipcode,Niceville
ZCTA5 32579,12,10338,76639,1193,287000,8748,3748,7640,514,1580,2229,1905,1412,4640,4349,291,4349,2967,1382,2019-01-01,zipcode,Shalimar
ZCTA5 32580,12,4491,64009,1154,224800,3367,1203,2832,182,677,1269,437,267,1927,1533,394,1533,953,580,2019-01-01,zipcode,Valparaiso
ZCTA5 32583,12,29365,60805,1033,141800,25045,13028,21969,4008,7181,6930,2681,1169,9991,8843,1148,8843,6772,2071,2019-01-01,zipcode,Milton
ZCTA5 32601,12,19363,25673,881,159600,17888,6678,9596,539,1885,2729,2315,2128,9978,7907,2071,7907,2036,5871,2019-01-01,zipcode,Gainesville
ZCTA5 32603,12,6949,20660,851,290000,6668,3892,1415,45,94,188,391,697,2311,1732,579,1732,244,1488,2019-01-01,zipcode,Gainesville
ZCTA5 32605,12,25556,69707,1251,193200,21309,7465,18309,845,2986,4612,4783,5083,11409,10248,1161,10248,7263,2985,2019-01-01,zipcode,Gainesville
ZCTA5 32606,12,23442,69974,1210,214000,18597,6433,16092,417,2095,3883,4374,5323,11064,9456,1608,9456,4822,4634,2019-01-01,zipcode,Gainesville
ZCTA5 32607,12,30214,39905,950,216700,26328,9719,15501,853,3064,4361,3552,3671,15299,11802,3497,11802,3979,7823,2019-01-01,zipcode,Gainesville
ZCTA5 32608,12,49659,45887,1036,240300,42226,16155,29321,1728,4111,6822,8109,8551,23763,19118,4645,19118,8112,11006,2019-01-01,zipcode,Gainesville
ZCTA5 32609,12,20105,34826,868,101100,16547,6796,13848,2210,4043,4620,1892,1083,8491,7153,1338,7153,3993,3160,2019-01-01,zipcode,Gainesville
ZCTA5 32612,12,7164,-666666666,-666666666,-666666666,7164,5733,30,0,7,17,1,5,5,5,0,5,0,5,2019-01-01,zipcode,Gainesville
ZCTA5 32615,12,13635,63043,1001,189300,10775,3838,9532,440,2359,3167,2179,1387,6123,5244,879,5244,4103,1141,2019-01-01,zipcode,Alachua
ZCTA5 32616,12,1235,26528,747,87400,905,385,823,160,403,191,43,26,395,378,17,378,214,164,2019-01-01,zipcode,
ZCTA5 32617,12,4541,44701,622,157500,3825,1689,3245,333,1412,1070,293,137,1869,1707,162,1707,1345,362,2019-01-01,zipcode,Anthony
ZCTA5 32618,12,8264,54219,762,161600,6671,2628,5496,797,1627,1665,698,709,3316,2832,484,2832,2343,489,2019-01-01,zipcode,Archer
ZCTA5 32619,12,5639,44328,760,93300,4393,2045,3630,526,1408,1201,347,148,2420,1979,441,1979,1676,303,2019-01-01,zipcode,Bell
ZCTA5 32621,12,4946,36389,643,81000,4105,2174,3526,710,1442,970,336,68,2315,1976,339,1976,1464,512,2019-01-01,zipcode,Bronson
ZCTA5 32622,12,1032,43400,1014,116300,831,394,814,189,267,191,79,88,535,422,113,422,321,101,2019-01-01,zipcode,Brooker
ZCTA5 32625,12,1686,40563,770,179000,1251,545,1127,61,451,331,117,167,1203,629,574,629,458,171,2019-01-01,zipcode,Cedar key
ZCTA5 32626,12,8782,35572,727,97100,7210,3676,6350,915,2657,2047,520,211,4547,3613,934,3613,2784,829,2019-01-01,zipcode,Chiefland
ZCTA5 32628,12,5380,39263,706,72800,4521,3042,3964,833,1864,892,284,91,1892,1537,355,1537,1137,400,2019-01-01,zipcode,Cross city
ZCTA5 32631,12,155,65449,-666666666,271200,142,68,142,0,15,60,45,22,102,102,0,102,102,0,2019-01-01,zipcode,Earleton
ZCTA5 32639,12,194,38011,-666666666,-666666666,155,87,155,26,99,0,0,30,209,97,112,97,86,11,2019-01-01,zipcode,Gulf hammock
ZCTA5 32640,12,11299,47103,728,109900,9559,4949,8519,1272,3083,2674,764,726,5725,4393,1332,4393,3611,782,2019-01-01,zipcode,Hawthorne
ZCTA5 32641,12,14959,37540,863,95800,11674,5289,10037,1680,3713,3208,968,468,5721,4749,972,4749,2841,1908,2019-01-01,zipcode,Gainesville
ZCTA5 32643,12,11666,56171,728,168900,9823,4509,8648,1014,2488,3162,1189,795,5098,4558,540,4558,3862,696,2019-01-01,zipcode,High springs
ZCTA5 32648,12,392,61442,-666666666,-666666666,342,159,291,57,123,91,13,7,582,169,413,169,166,3,2019-01-01,zipcode,Horseshoe beach
ZCTA5 32653,12,14030,66471,935,199100,11499,4793,10158,438,1958,2939,2477,2346,6368,5974,394,5974,4625,1349,2019-01-01,zipcode,Gainesville
ZCTA5 32656,12,15150,50063,863,125300,12242,5527,10612,1333,3798,3808,1207,466,6610,5533,1077,5533,4359,1174,2019-01-01,zipcode,Keystone heights
ZCTA5 32658,12,375,51875,-666666666,98500,322,151,295,56,115,93,31,0,116,98,18,98,85,13,2019-01-01,zipcode,La crosse
ZCTA5 32664,12,391,51875,893,156300,334,175,317,29,101,83,65,39,223,181,42,181,132,49,2019-01-01,zipcode,Mc intosh
ZCTA5 32666,12,6664,47457,826,141000,5822,3104,5035,534,1925,1656,404,516,3714,2745,969,2745,2289,456,2019-01-01,zipcode,Melrose
ZCTA5 32667,12,4352,58892,774,262500,3689,1607,3130,95,790,959,672,614,2168,1811,357,1811,1314,497,2019-01-01,zipcode,Micanopy
ZCTA5 32668,12,4678,41438,1039,149200,4235,2362,3918,562,1662,1216,311,167,2603,2031,572,2031,1755,276,2019-01-01,zipcode,Morriston
ZCTA5 32669,12,14037,70356,980,215200,10638,3572,9517,375,2249,3269,2237,1387,5552,4967,585,4967,4193,774,2019-01-01,zipcode,Newberry
ZCTA5 32680,12,10139,38496,591,74500,8522,5114,7701,1683,3189,1984,505,340,5826,4424,1402,4424,3501,923,2019-01-01,zipcode,Old town
ZCTA5 32681,12,31,-666666666,-666666666,-666666666,31,31,31,0,31,0,0,0,16,16,0,16,16,0,2019-01-01,zipcode,Orange lake
ZCTA5 32683,12,268,-666666666,-666666666,-666666666,148,106,148,10,108,30,0,0,75,65,10,65,59,6,2019-01-01,zipcode,Otter creek
ZCTA5 32686,12,4737,35910,668,169400,3992,2026,3455,785,1138,781,418,333,2484,2011,473,2011,1422,589,2019-01-01,zipcode,Reddick
ZCTA5 32692,12,160,-666666666,-666666666,91900,128,39,128,35,26,54,13,0,611,68,543,68,68,0,2019-01-01,zipcode,Suwannee
ZCTA5 32693,12,11882,38060,689,94200,9910,5314,8148,1318,3266,2562,691,311,5113,4323,790,4323,3386,937,2019-01-01,zipcode,Trenton
ZCTA5 32694,12,2023,47917,559,127700,1563,556,1283,102,531,407,188,55,1002,738,264,738,519,219,2019-01-01,zipcode,Waldo
ZCTA5 32696,12,12436,45457,731,128500,9885,4644,8770,1337,3622,2609,708,494,5403,4620,783,4620,3576,1044,2019-01-01,zipcode,Williston
ZCTA5 32697,12,253,38036,825,-666666666,178,72,120,42,47,27,2,2,160,99,61,99,15,84,2019-01-01,zipcode,Worthington springs
ZCTA5 32701,12,22940,55137,1144,175800,19120,6391,17202,922,3697,6638,4196,1749,11391,9910,1481,9910,4960,4950,2019-01-01,zipcode,Altamonte springs
ZCTA5 32702,12,2796,44470,2463,58900,2304,1412,2068,392,766,555,222,133,1544,1160,384,1160,768,392,2019-01-01,zipcode,Altoona
ZCTA5 32703,12,53763,51257,1129,189900,41993,14918,36004,5385,10478,10881,6857,2403,20093,18259,1834,18259,11676,6583,2019-01-01,zipcode,Apopka
ZCTA5 32707,12,36036,54941,1178,181900,30628,11604,26850,1902,6405,10199,6089,2255,16493,14857,1636,14857,9539,5318,2019-01-01,zipcode,Casselberry
ZCTA5 32708,12,45323,70469,1309,249500,37536,13731,33080,1688,6238,10683,9601,4870,18851,17697,1154,17697,13156,4541,2019-01-01,zipcode,Winter springs
ZCTA5 32709,12,1832,54911,-666666666,191500,1663,667,1516,70,645,509,224,68,794,727,67,727,660,67,2019-01-01,zipcode,Christmas
ZCTA5 32712,12,48151,79252,1415,243500,37897,12714,33106,4434,8784,10633,5848,3407,17318,15790,1528,15790,12613,3177,2019-01-01,zipcode,Apopka
ZCTA5 32713,12,20892,63594,1131,208000,17420,7792,15798,860,5237,5397,3087,1217,9260,8324,936,8324,6722,1602,2019-01-01,zipcode,Debary
ZCTA5 32714,12,37981,52626,1211,200300,31436,9884,27620,1776,6165,9433,7202,3044,17146,15450,1696,15450,7092,8358,2019-01-01,zipcode,Altamonte springs
ZCTA5 32720,12,32421,49195,928,191800,27311,13404,22968,2011,7305,7958,3712,1982,13803,12493,1310,12493,8476,4017,2019-01-01,zipcode,Deland
ZCTA5 32724,12,36961,49722,1006,175000,31114,15284,26442,2261,7776,9530,4610,2265,16165,14711,1454,14711,10361,4350,2019-01-01,zipcode,Deland
ZCTA5 32725,12,49923,52577,1185,160000,40061,17138,34623,4171,11054,13335,4400,1663,18806,16949,1857,16949,13099,3850,2019-01-01,zipcode,Deltona
ZCTA5 32726,12,22485,45405,872,155700,17831,7628,15646,2415,5685,4518,2187,841,9466,8489,977,8489,5313,3176,2019-01-01,zipcode,Eustis
ZCTA5 32730,12,5943,45288,1135,156700,5203,2173,4627,251,1134,1978,869,395,2901,2639,262,2639,941,1698,2019-01-01,zipcode,Casselberry
ZCTA5 32732,12,4576,79087,-666666666,317700,3949,1368,3458,125,826,1460,745,302,2170,1757,413,1757,1703,54,2019-01-01,zipcode,Geneva
ZCTA5 32735,12,4728,57680,1157,137000,3913,2085,3721,439,1131,1228,672,251,2192,2106,86,2106,1792,314,2019-01-01,zipcode,Grand island
ZCTA5 32736,12,10848,79327,1032,272100,8682,3570,7674,636,2108,2762,1421,747,4284,3649,635,3649,3331,318,2019-01-01,zipcode,Eustis
ZCTA5 32738,12,45611,53961,1174,154000,36034,14247,30745,3199,11441,11201,3885,1019,16041,14781,1260,14781,11415,3366,2019-01-01,zipcode,Deltona
ZCTA5 32744,12,3807,46307,1014,164900,3143,1372,2857,421,1035,878,399,124,1740,1494,246,1494,1225,269,2019-01-01,zipcode,Lake helen
ZCTA5 32746,12,45244,87581,1449,306600,37131,12872,32554,1106,5310,9643,10524,5971,18823,17365,1458,17365,11169,6196,2019-01-01,zipcode,Lake mary
ZCTA5 32750,12,25025,71585,1260,239600,20789,6836,18248,1043,5014,6295,3885,2011,9959,9262,697,9262,6402,2860,2019-01-01,zipcode,Longwood
ZCTA5 32751,12,22471,76108,1359,307800,18051,6428,15320,391,2191,4339,5086,3313,9571,8352,1219,8352,5622,2730,2019-01-01,zipcode,Maitland
ZCTA5 32754,12,10984,54336,850,172900,9291,4709,8412,1006,2961,2989,965,491,5410,4161,1249,4161,3696,465,2019-01-01,zipcode,Mims
ZCTA5 32757,12,27990,57106,1072,216600,23231,10497,20828,2131,6141,5962,3744,2850,13245,11369,1876,11369,8159,3210,2019-01-01,zipcode,Mount dora
ZCTA5 32759,12,3014,42500,895,187800,2639,1573,2438,313,1082,684,290,69,1554,1218,336,1218,891,327,2019-01-01,zipcode,Oak hill
ZCTA5 32763,12,23277,45590,1113,133500,19323,8449,17358,1609,6187,6380,2026,1156,10563,9296,1267,9296,5818,3478,2019-01-01,zipcode,Orange city
ZCTA5 32764,12,3165,72148,883,245700,2825,1158,2501,300,918,814,388,81,1483,1151,332,1151,1082,69,2019-01-01,zipcode,Osteen
ZCTA5 32765,12,64268,81459,1494,285400,51358,17705,40475,1331,6333,13117,12137,7557,23371,21821,1550,21821,15254,6567,2019-01-01,zipcode,Oviedo
ZCTA5 32766,12,16855,113471,1801,339400,12945,4473,11061,481,1698,3367,3177,2338,5470,5247,223,5247,4622,625,2019-01-01,zipcode,Oviedo
ZCTA5 32767,12,3334,47869,916,96800,2802,1162,2344,551,1176,542,44,31,1459,1109,350,1109,900,209,2019-01-01,zipcode,Paisley
ZCTA5 32771,12,56266,61983,1165,198700,43719,14664,38156,3696,9012,13138,8473,3837,22918,20450,2468,20450,12227,8223,2019-01-01,zipcode,Sanford
ZCTA5 32773,12,31225,46353,1084,152000,24449,8899,21491,2135,7395,7419,3358,1184,12839,11574,1265,11574,6552,5022,2019-01-01,zipcode,Sanford
ZCTA5 32776,12,12029,74113,1285,229100,9641,3291,8413,791,2194,3504,1179,745,4197,4001,196,4001,3176,825,2019-01-01,zipcode,Sorrento
ZCTA5 32778,12,22454,48441,990,151300,19022,10321,17122,1830,5932,5596,2268,1496,11833,9561,2272,9561,7187,2374,2019-01-01,zipcode,Tavares
ZCTA5 32779,12,29603,93635,1418,335100,24002,8756,21145,505,3240,6231,7244,3925,11524,10962,562,10962,8860,2102,2019-01-01,zipcode,Longwood
ZCTA5 32780,12,36116,51632,947,158200,30548,14470,27515,2099,8219,10224,4515,2458,19939,15226,4713,15226,10569,4657,2019-01-01,zipcode,Titusville
ZCTA5 32784,12,12371,51519,749,143500,9867,4403,8439,1430,2927,2702,765,615,5333,4320,1013,4320,3248,1072,2019-01-01,zipcode,Umatilla
ZCTA5 32789,12,26483,79759,1289,491500,22321,9348,19462,1035,2920,3850,6162,5495,12791,11195,1596,11195,7585,3610,2019-01-01,zipcode,Winter park
ZCTA5 32792,12,51659,52220,1190,227800,44023,14928,36141,2651,7322,11584,9249,5335,23812,20801,3011,20801,9619,11182,2019-01-01,zipcode,Winter park
ZCTA5 32796,12,20609,49165,971,142500,17412,8585,15768,1362,5560,5344,2216,1286,10046,8043,2003,8043,6267,1776,2019-01-01,zipcode,Titusville
ZCTA5 32798,12,2882,48086,1023,95300,2626,1632,2453,251,861,994,266,81,1599,1435,164,1435,1344,91,2019-01-01,zipcode,Zellwood
ZCTA5 32801,12,12243,57266,1331,310200,11328,3115,10664,710,1613,2094,3888,2359,9179,7524,1655,7524,1799,5725,2019-01-01,zipcode,Orlando
ZCTA5 32803,12,20148,75474,1314,284600,18124,3840,16687,689,2382,4107,6192,3317,11193,9600,1593,9600,5022,4578,2019-01-01,zipcode,Orlando
ZCTA5 32804,12,18023,79707,1216,332300,15085,4516,13594,613,2605,3045,4733,2598,9021,7775,1246,7775,5115,2660,2019-01-01,zipcode,Orlando
ZCTA5 32805,12,18908,27530,791,139300,15482,6892,13874,2919,4927,3492,1844,692,9188,7344,1844,7344,2536,4808,2019-01-01,zipcode,Orlando
ZCTA5 32806,12,27661,65987,1176,275000,22795,6929,20659,1301,4585,5662,5998,3113,12271,10985,1286,10985,6478,4507,2019-01-01,zipcode,Orlando
ZCTA5 32807,12,34749,45989,1113,153800,28211,9237,24384,4691,8568,6877,2992,1256,12960,11720,1240,11720,5453,6267,2019-01-01,zipcode,Orlando
ZCTA5 32808,12,59291,36913,995,121400,43819,13620,35678,7581,12168,11759,2820,1350,20282,18544,1738,18544,7408,11136,2019-01-01,zipcode,Orlando
ZCTA5 32809,12,29095,44479,1001,159700,23169,7442,20217,4498,6632,5130,2815,1142,11079,9377,1702,9377,4682,4695,2019-01-01,zipcode,Orlando
ZCTA5 32810,12,37861,51355,1168,156000,29545,8321,25899,2995,8225,8570,4565,1544,14422,13454,968,13454,6984,6470,2019-01-01,zipcode,Orlando
ZCTA5 32811,12,41057,38768,1132,97200,32104,9249,26635,3942,7233,9335,4415,1710,17632,14954,2678,14954,3786,11168,2019-01-01,zipcode,Orlando
ZCTA5 32812,12,35855,55131,1128,239600,29928,9595,26003,2496,6613,8712,5865,2317,15375,14009,1366,14009,7886,6123,2019-01-01,zipcode,Orlando
ZCTA5 32814,12,8021,94581,1834,474000,6436,1538,5836,110,558,817,2267,2084,4242,3542,700,3542,1591,1951,2019-01-01,zipcode,Orlando
ZCTA5 32817,12,35737,62421,1258,220400,30453,10938,21496,1770,4712,7374,4968,2672,13223,11593,1630,11593,6620,4973,2019-01-01,zipcode,Orlando
ZCTA5 32818,12,58198,45795,1072,170300,44460,13377,36338,6808,11213,11695,4826,1796,18377,17421,956,17421,9681,7740,2019-01-01,zipcode,Orlando
ZCTA5 32819,12,27840,73088,1355,335400,22922,7367,19924,1204,3141,5685,6945,2949,14128,10131,3997,10131,6222,3909,2019-01-01,zipcode,Orlando
ZCTA5 32820,12,10442,95089,1438,278000,8059,2153,6467,538,1372,2136,1652,769,3198,2983,215,2983,2468,515,2019-01-01,zipcode,Orlando
ZCTA5 32821,12,17680,55965,1380,207100,15314,3795,13144,794,2372,4316,4355,1307,13120,7231,5889,7231,2804,4427,2019-01-01,zipcode,Orlando
ZCTA5 32822,12,61760,41350,1158,126300,49091,17390,42393,5773,14725,12602,6843,2450,25595,22323,3272,22323,8941,13382,2019-01-01,zipcode,Orlando
ZCTA5 32824,12,46482,67303,1475,227100,36995,11028,31940,3970,8179,10559,6192,3040,16546,12894,3652,12894,9001,3893,2019-01-01,zipcode,Orlando
ZCTA5 32825,12,61289,61236,1250,219500,49715,15868,40843,4377,9982,13875,8776,3833,22937,20184,2753,20184,12782,7402,2019-01-01,zipcode,Orlando
ZCTA5 32826,12,35981,47462,1142,171700,33224,20044,13601,1612,3521,3789,3125,1554,8811,7644,1167,7644,4256,3388,2019-01-01,zipcode,Orlando
ZCTA5 32827,12,9427,83125,1840,289500,7231,2673,6117,270,978,1529,2003,1337,4326,3414,912,3414,2240,1174,2019-01-01,zipcode,Orlando
ZCTA5 32828,12,69497,77284,1549,274000,55420,17713,44351,3441,8121,13072,12438,7279,23680,22160,1520,22160,13827,8333,2019-01-01,zipcode,Orlando
ZCTA5 32829,12,20376,75563,1458,224100,15523,4507,13631,1091,3232,4180,3316,1812,7243,6113,1130,6113,4799,1314,2019-01-01,zipcode,Orlando
ZCTA5 32830,12,6,-666666666,-666666666,-666666666,6,0,6,0,0,6,0,0,6,6,0,6,0,6,2019-01-01,zipcode,Orlando
ZCTA5 32831,12,3228,38875,-666666666,12800,3216,3189,2826,1110,1183,449,36,48,47,27,20,27,27,0,2019-01-01,zipcode,Orlando
ZCTA5 32832,12,27919,89673,1582,335900,21150,6202,18358,798,1907,4968,6863,3822,11600,9406,2194,9406,6012,3394,2019-01-01,zipcode,Orlando
ZCTA5 32833,12,9857,67554,1214,263900,7882,2801,6898,787,2062,2117,1078,854,3794,3357,437,3357,2706,651,2019-01-01,zipcode,Orlando
ZCTA5 32835,12,48078,56927,1327,249100,39127,9112,32608,2617,7023,9986,8590,4392,18961,17491,1470,17491,6782,10709,2019-01-01,zipcode,Orlando
ZCTA5 32836,12,20053,102714,1436,460900,16345,5701,14362,431,1845,3588,5205,3293,8847,7108,1739,7108,4828,2280,2019-01-01,zipcode,Orlando
ZCTA5 32837,12,51310,63339,1413,238300,41471,12849,35161,3359,8764,10933,8113,3992,20374,15791,4583,15791,9365,6426,2019-01-01,zipcode,Orlando
ZCTA5 32839,12,52886,39993,1083,152800,42178,14031,35420,7049,11223,10580,5136,1432,22990,17483,5507,17483,3850,13633,2019-01-01,zipcode,Orlando
ZCTA5 32901,12,25089,39809,963,146400,22016,11395,17865,1792,5083,5830,3051,2109,12691,10508,2183,10508,5117,5391,2019-01-01,zipcode,Melbourne
ZCTA5 32903,12,14557,80181,1351,340000,12159,5281,11130,322,1991,3204,3414,2199,7017,6015,1002,6015,5019,996,2019-01-01,zipcode,Indialantic
ZCTA5 32904,12,32138,66086,1332,215500,26495,11585,22751,1615,6142,7550,4325,3119,13170,11938,1232,11938,9269,2669,2019-01-01,zipcode,Melbourne
ZCTA5 32905,12,23302,40583,973,121500,19275,8894,16456,1785,5621,5501,2333,1216,11307,9432,1875,9432,5188,4244,2019-01-01,zipcode,Palm bay
ZCTA5 32907,12,45037,54951,1123,158100,36995,16322,31470,3045,10924,11769,4058,1674,16336,14834,1502,14834,11885,2949,2019-01-01,zipcode,Palm bay
ZCTA5 32908,12,13397,57816,1370,156400,10240,4160,8566,1046,3393,2764,950,413,4226,3955,271,3955,3188,767,2019-01-01,zipcode,Palm bay
ZCTA5 32909,12,31251,51226,1030,168700,24658,9906,21666,2087,7593,7330,3005,1651,11901,10617,1284,10617,8695,1922,2019-01-01,zipcode,Palm bay
ZCTA5 32920,12,10283,55156,893,247200,9508,4804,8963,505,2100,3142,1851,1365,8999,5372,3627,5372,3350,2022,2019-01-01,zipcode,Cape canaveral
ZCTA5 32922,12,16709,31850,805,104500,12953,5766,10923,2318,3584,3693,921,407,8075,6293,1782,6293,2564,3729,2019-01-01,zipcode,Cocoa
ZCTA5 32925,12,1533,56591,1494,-666666666,1127,429,844,67,108,350,233,86,497,460,37,460,0,460,2019-01-01,zipcode,Patrick afb
ZCTA5 32926,12,21915,51896,962,153600,18976,9301,17059,2172,5417,6099,2103,1268,9947,8279,1668,8279,6645,1634,2019-01-01,zipcode,Cocoa
ZCTA5 32927,12,27377,61633,1059,150000,22190,8332,19887,1701,6795,7260,2861,1270,11923,10032,1891,10032,8666,1366,2019-01-01,zipcode,Cocoa
ZCTA5 32931,12,13771,59874,1159,323100,12636,6776,11805,487,2426,3561,3126,2205,10880,7216,3664,7216,4997,2219,2019-01-01,zipcode,Cocoa beach
ZCTA5 32934,12,19105,71891,1414,244600,16403,7595,14473,1075,3249,4490,3315,2344,7679,7269,410,7269,6320,949,2019-01-01,zipcode,Melbourne
ZCTA5 32935,12,41209,49611,1026,157500,34721,13565,30678,2873,10184,10865,4371,2385,19148,16764,2384,16764,9821,6943,2019-01-01,zipcode,Melbourne
ZCTA5 32937,12,27551,73702,1271,298200,23034,10339,20625,481,4081,6204,5517,4342,13472,11088,2384,11088,8700,2388,2019-01-01,zipcode,Satellite beach
ZCTA5 32940,12,42171,71812,1460,278000,35288,16884,31743,1182,5827,9696,8316,6722,18730,17013,1717,17013,13994,3019,2019-01-01,zipcode,Melbourne
ZCTA5 32948,12,7564,39852,758,140200,5559,2288,4169,1588,1350,903,253,75,2164,1849,315,1849,1311,538,2019-01-01,zipcode,Fellsmere
ZCTA5 32949,12,2468,71094,-666666666,326900,2042,796,1803,66,475,791,240,231,1083,844,239,844,805,39,2019-01-01,zipcode,Grant
ZCTA5 32950,12,4522,68425,1294,281100,3880,1740,3429,183,1155,1147,724,220,1847,1766,81,1766,1589,177,2019-01-01,zipcode,Malabar
ZCTA5 32951,12,11974,74143,1640,344900,10685,6195,10098,407,1845,2837,3106,1903,7247,5369,1878,5369,4530,839,2019-01-01,zipcode,Melbourne beach
ZCTA5 32952,12,20966,75256,1132,287700,17556,7407,15591,603,3523,5318,3881,2266,10047,8266,1781,8266,6992,1274,2019-01-01,zipcode,Merritt island
ZCTA5 32953,12,23939,62310,1021,278100,20200,8799,17774,1279,4245,5903,4232,2115,11662,9657,2005,9657,7076,2581,2019-01-01,zipcode,Merritt island
ZCTA5 32955,12,38889,73167,1270,228800,32597,13571,29453,1631,7052,10196,6684,3890,18276,15317,2959,15317,12116,3201,2019-01-01,zipcode,Rockledge
ZCTA5 32958,12,28617,53607,992,191200,25088,14086,23133,1761,8688,7087,3559,2038,14105,11493,2612,11493,9488,2005,2019-01-01,zipcode,Sebastian
ZCTA5 32960,12,22036,40529,877,166800,18377,8746,16063,1688,5649,5016,2418,1292,11504,8657,2847,8657,5007,3650,2019-01-01,zipcode,Vero beach
ZCTA5 32962,12,26459,48841,993,144700,22491,10172,19981,3348,5864,6937,2628,1204,12769,9021,3748,9021,7483,1538,2019-01-01,zipcode,Vero beach
ZCTA5 32963,12,15027,112755,1336,652400,14226,9424,13561,279,1305,2931,4498,4548,12511,7276,5235,7276,6784,492,2019-01-01,zipcode,Vero beach
ZCTA5 32966,12,18462,50172,1092,144700,16316,9410,15326,1114,4880,4868,2845,1619,10949,7955,2994,7955,6160,1795,2019-01-01,zipcode,Vero beach
ZCTA5 32967,12,22319,51625,922,235400,18195,9425,16441,2362,5159,4458,2696,1766,10852,7886,2966,7886,6091,1795,2019-01-01,zipcode,Vero beach
ZCTA5 32968,12,13154,78948,1281,266400,11083,5050,9479,445,2864,3097,2189,884,5119,4383,736,4383,4040,343,2019-01-01,zipcode,Vero beach
ZCTA5 32970,12,369,13375,-666666666,-666666666,369,304,369,24,329,16,0,0,157,110,47,110,94,16,2019-01-01,zipcode,Wabasso
ZCTA5 32976,12,9092,37577,794,93300,8721,6136,8428,697,3537,2902,892,400,6824,4872,1952,4872,4386,486,2019-01-01,zipcode,Sebastian
ZCTA5 33001,12,331,50216,2015,316000,320,169,318,17,165,70,60,6,681,185,496,185,128,57,2019-01-01,zipcode,Long key
ZCTA5 33004,12,16082,42469,1258,207400,13345,4955,12210,1167,3675,4055,2180,1133,8376,6588,1788,6588,3222,3366,2019-01-01,zipcode,Dania
ZCTA5 33009,12,41578,38665,1247,207900,35027,13641,31385,4778,8562,8124,5751,4170,29808,18467,11341,18467,9598,8869,2019-01-01,zipcode,Hallandale
ZCTA5 33010,12,45246,30000,1021,241600,39061,16785,34839,12669,11144,6520,3446,1060,16062,15294,768,15294,4560,10734,2019-01-01,zipcode,Hialeah
ZCTA5 33012,12,73828,31320,1160,227000,63380,29067,55987,17715,17423,12239,6199,2411,25378,24396,982,24396,11163,13233,2019-01-01,zipcode,Hialeah
ZCTA5 33013,12,31712,36280,1156,246500,27550,11828,24815,8222,9111,4333,2237,912,10111,9698,413,9698,5633,4065,2019-01-01,zipcode,Hialeah
ZCTA5 33014,12,41924,42700,1306,266400,34802,13812,30709,6978,9148,7494,4609,2480,15210,14568,642,14568,6401,8167,2019-01-01,zipcode,Hialeah
ZCTA5 33015,12,67191,53046,1434,262400,54309,17985,45693,6999,14073,13839,7225,3557,22350,21223,1127,21223,10783,10440,2019-01-01,zipcode,Hialeah
ZCTA5 33016,12,51700,49526,1389,221000,42054,14901,35820,7456,11808,7769,6216,2571,15887,15348,539,15348,8200,7148,2019-01-01,zipcode,Hialeah
ZCTA5 33018,12,53419,66889,1658,278800,43761,12993,37940,7590,12348,8943,6272,2787,15064,14637,427,14637,10868,3769,2019-01-01,zipcode,Hialeah
ZCTA5 33019,12,13729,80000,1539,465100,12076,5139,11311,459,1463,3523,3100,2766,12431,6560,5871,6560,4868,1692,2019-01-01,zipcode,Hollywood
ZCTA5 33020,12,45147,43494,1113,216800,37500,10982,33085,4735,10075,9984,5644,2647,21783,18578,3205,18578,6271,12307,2019-01-01,zipcode,Hollywood
ZCTA5 33021,12,49941,60289,1359,267400,40686,14825,35739,3895,9520,10962,6706,4656,21219,18335,2884,18335,11753,6582,2019-01-01,zipcode,Hollywood
ZCTA5 33023,12,73973,52783,1277,214400,57855,18354,48970,8212,17206,16411,4945,2196,22076,20576,1500,20576,13670,6906,2019-01-01,zipcode,Hollywood
ZCTA5 33024,12,76508,61470,1381,242100,60529,18654,51488,6769,16673,14902,8978,4166,25982,23605,2377,23605,15661,7944,2019-01-01,zipcode,Hollywood
ZCTA5 33025,12,73428,58483,1410,239600,59830,18680,52017,3306,17852,18441,7613,4805,28752,25464,3288,25464,11671,13793,2019-01-01,zipcode,Hollywood
ZCTA5 33026,12,31891,80232,1665,269400,26274,8492,22920,1727,4789,7537,5517,3350,12023,11230,793,11230,9172,2058,2019-01-01,zipcode,Hollywood
ZCTA5 33027,12,60679,63414,1484,321600,50009,21058,43745,2647,12403,13872,8138,6685,24067,21520,2547,21520,16934,4586,2019-01-01,zipcode,Hollywood
ZCTA5 33028,12,26848,104271,2050,390000,21671,5943,18369,991,3250,5164,5467,3497,8888,8133,755,8133,6277,1856,2019-01-01,zipcode,Pembroke pines
ZCTA5 33029,12,48161,113082,2735,403700,38754,12696,31531,1653,6917,9366,8314,5281,14295,13124,1171,13124,11607,1517,2019-01-01,zipcode,Hollywood
ZCTA5 33030,12,35303,39925,1045,251600,25103,8595,20900,8345,5773,4167,1782,833,9551,8950,601,8950,3302,5648,2019-01-01,zipcode,Homestead
ZCTA5 33031,12,7124,78547,1982,396900,5580,1763,4695,1032,1585,1050,535,493,1964,1853,111,1853,1550,303,2019-01-01,zipcode,Homestead
ZCTA5 33032,12,50135,54420,1270,251800,36983,11460,30685,6083,9105,8703,4993,1801,14084,13194,890,13194,7535,5659,2019-01-01,zipcode,Homestead
ZCTA5 33033,12,58427,49485,1316,229300,42059,14636,34983,8155,9517,9628,5510,2173,16587,15638,949,15638,8741,6897,2019-01-01,zipcode,Homestead
ZCTA5 33034,12,22142,35529,1107,132400,15295,7583,13140,5374,3672,3185,677,232,5410,4744,666,4744,1566,3178,2019-01-01,zipcode,Homestead
ZCTA5 33035,12,16159,70608,1514,195900,11960,3408,9777,1222,2749,3202,1663,941,5222,4563,659,4563,2157,2406,2019-01-01,zipcode,Homestead
ZCTA5 33036,12,3496,83261,1379,705500,3226,1259,2942,67,737,885,826,427,3638,1529,2109,1529,1212,317,2019-01-01,zipcode,Islamorada
ZCTA5 33037,12,10816,67917,1473,460700,9358,4214,8701,805,2161,2795,1607,1333,10603,4708,5895,4708,3686,1022,2019-01-01,zipcode,Key largo
ZCTA5 33039,12,280,72500,-666666666,341200,270,126,260,57,65,81,0,57,100,100,0,100,100,0,2019-01-01,zipcode,Homestead
ZCTA5 33040,12,34471,69702,1742,557100,29265,8581,25972,2613,7197,7699,5165,3298,18106,13968,4138,13968,6226,7742,2019-01-01,zipcode,Key west
ZCTA5 33042,12,6623,86739,1927,487700,5994,2434,5742,233,1324,1765,1469,951,4969,3070,1899,3070,2351,719,2019-01-01,zipcode,Summerland key
ZCTA5 33043,12,4933,58571,1645,365600,4370,1916,3970,283,1024,1429,824,410,2941,2088,853,2088,1517,571,2019-01-01,zipcode,Big pine key
ZCTA5 33050,12,9443,57537,1332,451600,8225,2844,7339,697,2107,2195,1715,625,6934,4115,2819,4115,2320,1795,2019-01-01,zipcode,Marathon
ZCTA5 33051,12,534,100192,1211,603000,534,280,534,39,132,130,145,88,1366,320,1046,320,227,93,2019-01-01,zipcode,Key colony beach
ZCTA5 33054,12,31797,26919,981,165200,24870,11646,19988,5413,8711,4193,1365,306,10391,9569,822,9569,4255,5314,2019-01-01,zipcode,Opa locka
ZCTA5 33055,12,40883,45306,1315,202300,33233,14639,28592,7524,11432,5891,2828,917,11774,11129,645,11129,8395,2734,2019-01-01,zipcode,Opa locka
ZCTA5 33056,12,36110,41769,1277,181200,27975,11557,23120,4687,8293,6943,2165,1032,10519,9791,728,9791,6152,3639,2019-01-01,zipcode,Miami gardens
ZCTA5 33060,12,37612,44647,1160,261200,30056,11614,26249,5462,8763,6874,3197,1953,15203,13295,1908,13295,5921,7374,2019-01-01,zipcode,Pompano beach
ZCTA5 33062,12,22692,64812,1416,351300,21092,10797,20381,1419,4162,6040,4715,4045,21201,12158,9043,12158,8806,3352,2019-01-01,zipcode,Pompano beach
ZCTA5 33063,12,54707,46450,1432,173500,46954,16583,42578,5093,14808,12883,7208,2586,26827,22907,3920,22907,15508,7399,2019-01-01,zipcode,Pompano beach
ZCTA5 33064,12,61293,53238,1343,188900,49009,15928,42813,8207,13534,10416,7785,2871,24285,20761,3524,20761,12795,7966,2019-01-01,zipcode,Pompano beach
ZCTA5 33065,12,58171,55686,1407,274100,44320,13083,37025,3671,10364,12479,7329,3182,19650,17857,1793,17857,9053,8804,2019-01-01,zipcode,Coral springs
ZCTA5 33066,12,16752,50674,1254,130400,15158,7607,14138,931,3915,4469,2723,2100,10714,8319,2395,8319,6751,1568,2019-01-01,zipcode,Pompano beach
ZCTA5 33067,12,27358,103337,1698,446500,21725,6115,18443,584,3135,5423,4814,4487,9269,8753,516,8753,6095,2658,2019-01-01,zipcode,Pompano beach
ZCTA5 33068,12,52749,45613,1447,182400,40917,10736,34607,4982,13326,10198,3900,2201,18684,16841,1843,16841,9794,7047,2019-01-01,zipcode,Pompano beach
ZCTA5 33069,12,28138,49732,1310,162100,23958,11052,20970,3326,6059,5832,3950,1803,14458,10494,3964,10494,5263,5231,2019-01-01,zipcode,Pompano beach
ZCTA5 33070,12,5132,73676,1654,508400,4436,1640,3955,351,1041,1064,963,536,4265,2070,2195,2070,1407,663,2019-01-01,zipcode,Tavernier
ZCTA5 33071,12,39402,91999,1625,368200,30991,8945,26601,1279,5465,8366,7426,4065,13491,12851,640,12851,8366,4485,2019-01-01,zipcode,Coral springs
ZCTA5 33073,12,35378,77158,1742,325900,27336,7140,22985,1449,6499,7014,6010,2013,12389,11552,837,11552,6701,4851,2019-01-01,zipcode,Pompano beach
ZCTA5 33076,12,39091,136343,2338,521900,28942,10518,24507,921,4000,5191,8025,6370,12886,12006,880,12006,9811,2195,2019-01-01,zipcode,Pompano beach
ZCTA5 33101,12,0,-666666666,-666666666,-666666666,0,0,0,0,0,0,0,0,0,0,0,0,0,0,2019-01-01,zipcode,Miami
ZCTA5 33109,12,408,200577,-666666666,2000001,392,239,392,0,54,14,167,157,885,210,675,210,185,25,2019-01-01,zipcode,Miami beach
ZCTA5 33122,12,205,52321,2133,-666666666,162,73,150,32,13,26,68,11,94,94,0,94,0,94,2019-01-01,zipcode,Miami
ZCTA5 33125,12,61156,27544,1053,246400,51745,23468,45565,15319,16078,6991,5072,2105,22978,21349,1629,21349,5453,15896,2019-01-01,zipcode,Miami
ZCTA5 33126,12,52986,37241,1290,206800,45566,16891,40265,8089,13441,9179,7083,2473,19514,18242,1272,18242,6045,12197,2019-01-01,zipcode,Miami
ZCTA5 33127,12,31902,30633,1027,206200,25056,10406,21725,5827,7454,4933,2373,1138,11719,10207,1512,10207,2889,7318,2019-01-01,zipcode,Miami
ZCTA5 33128,12,7992,19482,837,221000,6782,2859,6117,2662,1787,1010,507,151,3597,3213,384,3213,185,3028,2019-01-01,zipcode,Miami
ZCTA5 33129,12,13750,78105,2050,506800,11679,3138,10649,575,1032,1596,4047,3399,8707,6545,2162,6545,3013,3532,2019-01-01,zipcode,Miami
ZCTA5 33130,12,29737,34937,1171,328600,26191,9268,23326,5129,5672,4180,4522,3823,17316,14007,3309,14007,1863,12144,2019-01-01,zipcode,Miami
ZCTA5 33131,12,18477,101248,2279,468700,16367,3067,15273,242,1187,2180,5715,5949,16318,10349,5969,10349,3413,6936,2019-01-01,zipcode,Miami
ZCTA5 33132,12,13849,80577,2041,485300,13014,4073,11794,1001,1268,2579,3879,3067,9688,6936,2752,6936,1968,4968,2019-01-01,zipcode,Miami
ZCTA5 33133,12,35592,66683,1490,678800,28712,10638,26570,2241,6045,5157,6811,6316,16980,13913,3067,13913,6865,7048,2019-01-01,zipcode,Miami
ZCTA5 33134,12,40265,68868,1467,493800,34176,12131,31419,3225,5908,6703,8491,7092,18599,16167,2432,16167,8373,7794,2019-01-01,zipcode,Miami
ZCTA5 33135,12,38920,27857,1041,288400,33116,13778,29478,8879,10405,4868,3818,1508,15721,14623,1098,14623,2867,11756,2019-01-01,zipcode,Miami
ZCTA5 33136,12,15848,26336,879,207200,12935,4623,11314,2411,3800,2924,1447,732,7336,6268,1068,6268,788,5480,2019-01-01,zipcode,Miami
ZCTA5 33137,12,22955,63650,1755,364600,19642,5216,17769,1799,2859,4408,5376,3327,12915,10134,2781,10134,2695,7439,2019-01-01,zipcode,Miami
ZCTA5 33138,12,30221,51262,1048,471700,24688,7700,22017,3233,4953,5441,4869,3521,14147,12587,1560,12587,5730,6857,2019-01-01,zipcode,Miami
ZCTA5 33139,12,39427,53327,1469,430800,34587,9674,32082,3695,5078,6883,9244,7182,32461,20840,11621,20840,7041,13799,2019-01-01,zipcode,Miami beach
ZCTA5 33140,12,19938,76960,1653,703500,16472,6236,15078,1185,2053,3258,4281,4301,17629,8674,8955,8674,5028,3646,2019-01-01,zipcode,Miami beach
ZCTA5 33141,12,39768,49861,1358,344800,34515,9681,30942,3284,7707,7637,7034,5280,23478,17569,5909,17569,5181,12388,2019-01-01,zipcode,Miami beach
ZCTA5 33142,12,59073,26424,909,171900,45872,19321,39620,13020,13818,7855,3599,1328,21509,19715,1794,19715,5341,14374,2019-01-01,zipcode,Miami
ZCTA5 33143,12,31056,67042,1386,599600,25687,9063,22348,1179,3755,5428,6606,5380,13828,12414,1414,12414,6408,6006,2019-01-01,zipcode,Miami
ZCTA5 33144,12,29344,48632,1386,300000,25834,10362,23517,4959,7146,5959,3954,1499,9683,9262,421,9262,5368,3894,2019-01-01,zipcode,Miami
ZCTA5 33145,12,30713,54288,1478,365800,26628,9489,24094,3563,6834,5328,4867,3502,12873,11640,1233,11640,5644,5996,2019-01-01,zipcode,Miami
ZCTA5 33146,12,16473,117500,2190,903300,13940,6405,7972,317,566,1251,2586,3252,5130,4332,798,4332,3169,1163,2019-01-01,zipcode,Miami
ZCTA5 33147,12,47811,32808,1025,154700,37010,16045,31478,8761,12125,7286,2163,1143,15795,14311,1484,14311,6720,7591,2019-01-01,zipcode,Miami
ZCTA5 33149,12,12943,151190,2548,1208300,9737,3819,8482,171,662,1447,3154,3048,7280,4428,2852,4428,3081,1347,2019-01-01,zipcode,Key biscayne
ZCTA5 33150,12,29652,29782,886,209300,22743,9314,19235,5415,6350,4672,1742,1056,11088,9779,1309,9779,3046,6733,2019-01-01,zipcode,Miami
ZCTA5 33154,12,14634,76690,1831,634700,11390,4655,10134,289,1502,2240,3453,2650,10403,6185,4218,6185,3546,2639,2019-01-01,zipcode,Miami beach
ZCTA5 33155,12,46617,68699,1606,358500,39789,15020,35446,4357,8770,9665,8377,4277,15398,14471,927,14471,10137,4334,2019-01-01,zipcode,Miami
ZCTA5 33156,12,33514,117491,1738,857500,26866,9923,22818,941,2847,4515,7264,7251,12732,11107,1625,11107,7850,3257,2019-01-01,zipcode,Miami
ZCTA5 33157,12,67455,65099,1205,312700,52717,19115,44695,6522,12983,11281,8938,4971,21137,19697,1440,19697,13042,6655,2019-01-01,zipcode,Miami
ZCTA5 33158,12,6469,170673,2122,683400,4928,1908,4145,64,375,621,1292,1793,2261,1997,264,1997,1892,105,2019-01-01,zipcode,Miami
ZCTA5 33160,12,39615,51790,1549,294100,34495,14040,31889,1994,5036,10778,8047,6034,35911,19164,16747,19164,10242,8922,2019-01-01,zipcode,North miami beach
ZCTA5 33161,12,56130,40093,1138,242200,43820,15126,36934,8628,11538,9614,4874,2280,18422,16634,1788,16634,6373,10261,2019-01-01,zipcode,Miami
ZCTA5 33162,12,47123,45080,1154,207900,37227,12814,31331,6636,9858,8778,4360,1699,14703,13093,1610,13093,7316,5777,2019-01-01,zipcode,Miami
ZCTA5 33165,12,55822,53998,1408,321700,47563,19384,41425,8088,12655,9984,7053,3645,16932,16288,644,16288,11129,5159,2019-01-01,zipcode,Miami
ZCTA5 33166,12,24346,54362,1330,368700,20393,7878,17825,2852,4246,4709,3653,2365,9288,7923,1365,7923,3733,4190,2019-01-01,zipcode,Miami
ZCTA5 33167,12,20582,37474,1149,191300,16093,6809,13259,3406,4497,3439,1402,515,6145,5786,359,5786,2976,2810,2019-01-01,zipcode,Miami
ZCTA5 33168,12,27414,48894,1325,207600,22686,8628,18942,4761,7355,4414,1643,769,7147,6737,410,6737,4829,1908,2019-01-01,zipcode,Miami
ZCTA5 33169,12,41626,45711,1198,210100,31994,11781,27302,5088,8453,8545,3570,1646,13437,12163,1274,12163,6488,5675,2019-01-01,zipcode,Miami
ZCTA5 33170,12,14121,45929,1054,282800,11025,4835,9467,2172,3158,2246,1376,515,4141,3893,248,3893,2418,1475,2019-01-01,zipcode,Miami
ZCTA5 33172,12,43356,50139,1590,171100,36116,12348,32342,6618,8253,7574,6303,3594,15829,14017,1812,14017,6356,7661,2019-01-01,zipcode,Miami
ZCTA5 33173,12,33089,68382,1596,328800,28081,10387,24657,2846,5251,6874,6091,3595,11781,10987,794,10987,7309,3678,2019-01-01,zipcode,Miami
ZCTA5 33174,12,34403,51442,1340,272900,30549,12727,24891,6883,5954,5037,4991,2026,10387,9965,422,9965,5615,4350,2019-01-01,zipcode,Miami
ZCTA5 33175,12,53348,58945,1640,302600,46329,18606,40427,7388,12995,9126,7487,3431,16209,15643,566,15643,11668,3975,2019-01-01,zipcode,Miami
ZCTA5 33176,12,52288,72998,1417,417600,43570,15010,38168,3561,7879,11261,9146,6321,18859,17228,1631,17228,11559,5669,2019-01-01,zipcode,Miami
ZCTA5 33177,12,57526,61033,1586,262700,47269,18526,39877,6949,13904,10607,6065,2352,15405,14827,578,14827,10520,4307,2019-01-01,zipcode,Miami
ZCTA5 33178,12,52206,79707,2100,390800,39489,12950,33483,2726,4871,8021,10169,7696,19701,15272,4429,15272,7631,7641,2019-01-01,zipcode,Miami
ZCTA5 33179,12,44341,49016,1278,181100,36857,12297,31777,3694,8818,10494,5353,3418,18239,16181,2058,16181,9495,6686,2019-01-01,zipcode,Miami
ZCTA5 33180,12,32441,74091,1945,393500,27899,11330,25477,1190,3023,7469,8414,5381,23401,14485,8916,14485,9457,5028,2019-01-01,zipcode,Miami
ZCTA5 33181,12,20111,46139,1238,257800,16855,5865,14159,1883,3691,3963,2921,1701,9172,7627,1545,7627,2991,4636,2019-01-01,zipcode,Miami
ZCTA5 33182,12,16607,80213,1853,342500,14375,7253,12231,2619,3164,2862,2566,1020,3864,3771,93,3771,3258,513,2019-01-01,zipcode,Miami
ZCTA5 33183,12,36725,59797,1538,261400,30789,11281,26403,3469,7495,8065,4871,2503,12198,11794,404,11794,7415,4379,2019-01-01,zipcode,Miami
ZCTA5 33184,12,21785,53480,1579,256400,19193,8108,16862,4573,4324,3238,3858,869,6364,6065,299,6065,4609,1456,2019-01-01,zipcode,Miami
ZCTA5 33185,12,31359,89327,2328,367900,25469,8941,21466,2301,5138,5143,6061,2823,8420,8187,233,8187,6943,1244,2019-01-01,zipcode,Miami
ZCTA5 33186,12,68581,70529,1712,299000,55972,19286,48392,3735,11299,16153,11199,6006,22782,21439,1343,21439,14235,7204,2019-01-01,zipcode,Miami
ZCTA5 33187,12,19392,80629,2108,360500,15929,5483,13650,1980,3415,3937,3208,1110,5559,5323,236,5323,4612,711,2019-01-01,zipcode,Miami
ZCTA5 33189,12,25298,58190,1214,263200,19896,6661,17401,2239,5647,4962,3311,1242,8513,7897,616,7897,4801,3096,2019-01-01,zipcode,Miami
ZCTA5 33190,12,16147,64332,1368,266200,12542,3821,10672,1445,2452,3531,2613,631,4909,4675,234,4675,2043,2632,2019-01-01,zipcode,Miami
ZCTA5 33193,12,49999,63337,1544,293600,41323,14204,34481,7032,8467,7693,8862,2427,14916,14427,489,14427,8920,5507,2019-01-01,zipcode,Miami
ZCTA5 33194,12,8081,118125,1825,374100,6584,3484,5558,1062,1167,1439,1316,574,1428,1428,0,1428,1157,271,2019-01-01,zipcode,Miami
ZCTA5 33196,12,53047,76787,1878,331000,42287,14296,35505,3375,7672,11059,9544,3855,15280,14504,776,14504,9647,4857,2019-01-01,zipcode,Miami
ZCTA5 33301,12,14988,99382,2049,559300,13803,4151,12781,481,1494,2778,4416,3612,10873,7768,3105,7768,3547,4221,2019-01-01,zipcode,Fort lauderdale
ZCTA5 33304,12,18351,58290,1299,422700,16404,4843,15199,1167,2659,4203,4683,2487,12969,9549,3420,9549,3396,6153,2019-01-01,zipcode,Fort lauderdale
ZCTA5 33305,12,12222,74095,1372,402600,11190,3625,10756,438,1750,2917,3555,2096,7801,6313,1488,6313,4052,2261,2019-01-01,zipcode,Fort lauderdale
ZCTA5 33306,12,3124,71357,1119,477200,2903,914,2746,57,464,804,753,668,2235,1708,527,1708,1041,667,2019-01-01,zipcode,Fort lauderdale
ZCTA5 33308,12,27294,64792,1442,410100,25093,11391,23858,1213,4797,6043,6668,5137,23267,15194,8073,15194,10352,4842,2019-01-01,zipcode,Fort lauderdale
ZCTA5 33309,12,40844,55134,1320,190000,32633,9317,28862,4412,9354,7603,4686,2807,14474,13402,1072,13402,8071,5331,2019-01-01,zipcode,Fort lauderdale
ZCTA5 33311,12,76073,36649,1109,157700,56604,22930,47485,11474,17829,12626,3558,1998,26580,23494,3086,23494,9716,13778,2019-01-01,zipcode,Fort lauderdale
ZCTA5 33312,12,55298,58144,1356,256800,43910,15075,38238,5644,10623,10625,7626,3720,20770,17943,2827,17943,10258,7685,2019-01-01,zipcode,Fort lauderdale
ZCTA5 33313,12,62842,38201,1186,131900,48727,16888,40216,7977,14617,11344,4297,1981,23885,19959,3926,19959,8514,11445,2019-01-01,zipcode,Fort lauderdale
ZCTA5 33314,12,27261,51635,1483,171400,22003,7156,18001,2751,5410,5094,3579,1167,10442,9244,1198,9244,3814,5430,2019-01-01,zipcode,Fort lauderdale
ZCTA5 33315,12,13801,76507,1457,315000,12132,3277,11213,913,3309,2975,2607,1409,6970,6068,902,6068,3376,2692,2019-01-01,zipcode,Fort lauderdale
ZCTA5 33316,12,9736,67477,1208,595100,9043,3670,8456,671,1388,2139,2528,1730,7857,5061,2796,5061,3120,1941,2019-01-01,zipcode,Fort lauderdale
ZCTA5 33317,12,38427,67878,1396,311600,30891,9855,27022,3592,6722,7273,6317,3118,13490,12668,822,12668,9514,3154,2019-01-01,zipcode,Fort lauderdale
ZCTA5 33319,12,46786,44993,1289,139100,38335,13521,33820,5132,11028,9823,5103,2734,23132,18315,4817,18315,11797,6518,2019-01-01,zipcode,Fort lauderdale
ZCTA5 33321,12,47413,49784,1443,173800,40095,16100,35980,3222,11101,11857,6154,3646,22136,19526,2610,19526,14337,5189,2019-01-01,zipcode,Fort lauderdale
ZCTA5 33322,12,39097,48179,1701,169700,34179,14823,31041,3306,8187,9853,5774,3921,20037,16678,3359,16678,13709,2969,2019-01-01,zipcode,Fort lauderdale
ZCTA5 33323,12,21651,88946,1939,320900,17754,4715,15312,1268,2908,5098,3878,2160,8474,7338,1136,7338,5205,2133,2019-01-01,zipcode,Fort lauderdale
ZCTA5 33324,12,49045,70461,1655,244200,40142,11696,35604,1754,6806,11568,9127,6349,21961,19037,2924,19037,10614,8423,2019-01-01,zipcode,Fort lauderdale
ZCTA5 33325,12,29369,82805,1703,314800,23861,6893,19977,1638,5429,5628,4825,2457,10383,9137,1246,9137,7126,2011,2019-01-01,zipcode,Fort lauderdale
ZCTA5 33326,12,33155,93197,1872,379200,26181,8580,22737,1048,3535,5753,7310,5091,13579,10794,2785,10794,7473,3321,2019-01-01,zipcode,Fort lauderdale
ZCTA5 33327,12,23811,117906,2649,538000,16705,6311,13673,409,2134,2532,4774,3824,6875,6501,374,6501,4880,1621,2019-01-01,zipcode,Fort lauderdale
ZCTA5 33328,12,29626,92227,1599,363500,23888,7341,19639,1221,3958,5845,5259,3356,10744,10151,593,10151,7817,2334,2019-01-01,zipcode,Fort lauderdale
ZCTA5 33330,12,15793,130208,2739,539800,12818,4504,10401,704,1657,2837,2780,2423,4828,4615,213,4615,4236,379,2019-01-01,zipcode,Fort lauderdale
ZCTA5 33331,12,25718,125608,2401,492600,19683,6340,16695,743,2089,4204,5260,4399,7929,7417,512,7417,6446,971,2019-01-01,zipcode,Fort lauderdale
ZCTA5 33332,12,11622,139984,2611,634900,9352,3232,7478,383,889,1599,2353,2254,3516,3173,343,3173,2875,298,2019-01-01,zipcode,Fort lauderdale
ZCTA5 33334,12,29494,52303,1163,290400,25364,7080,22752,3732,5855,6079,4404,2682,13688,12169,1519,12169,6541,5628,2019-01-01,zipcode,Fort lauderdale
ZCTA5 33351,12,35769,60848,1494,229500,28425,8189,24715,2994,7074,7689,5161,1797,12785,11948,837,11948,6410,5538,2019-01-01,zipcode,Fort lauderdale
ZCTA5 33401,12,28687,50824,1364,250900,24362,9045,20096,2377,4699,5337,4475,3208,16134,11406,4728,11406,4419,6987,2019-01-01,zipcode,West palm beach
ZCTA5 33403,12,12794,58371,1219,198100,10091,2985,8817,1481,2183,2685,1793,675,5060,4208,852,4208,2042,2166,2019-01-01,zipcode,West palm beach
ZCTA5 33404,12,29339,44165,1150,154400,23140,9637,20074,2836,6976,5674,2828,1760,15036,9981,5055,9981,5289,4692,2019-01-01,zipcode,West palm beach
ZCTA5 33405,12,20633,55000,1178,276600,16962,5620,14995,3092,4209,3507,2229,1958,7913,6992,921,6992,4222,2770,2019-01-01,zipcode,West palm beach
ZCTA5 33406,12,27585,62785,1281,218800,22341,7126,18880,2766,6118,5502,3396,1098,9513,8776,737,8776,5774,3002,2019-01-01,zipcode,West palm beach
ZCTA5 33407,12,31551,45093,1181,173300,24919,8314,21295,4500,6437,5468,3031,1859,12821,10733,2088,10733,4422,6311,2019-01-01,zipcode,West palm beach
ZCTA5 33408,12,18207,76030,1424,367900,16586,7738,15347,718,2924,4167,4607,2931,12965,9118,3847,9118,7134,1984,2019-01-01,zipcode,North palm beach
ZCTA5 33409,12,33212,49641,1259,167300,26404,8316,21331,3814,5453,6059,4099,1906,12810,10947,1863,10947,4856,6091,2019-01-01,zipcode,West palm beach
ZCTA5 33410,12,35089,76371,1618,326700,30161,10810,27392,1751,6299,8086,7185,4071,16784,14383,2401,14383,9863,4520,2019-01-01,zipcode,Palm beach gardens
ZCTA5 33411,12,72546,75019,1433,284400,58064,20450,50874,4317,13464,15517,11059,6517,28143,24555,3588,24555,18042,6513,2019-01-01,zipcode,West palm beach
ZCTA5 33412,12,15472,101196,2016,375700,13300,5516,11906,689,3028,3606,2884,1699,6351,5390,961,5390,4776,614,2019-01-01,zipcode,West palm beach
ZCTA5 33413,12,17487,64714,1540,254800,13625,4213,11529,1708,3130,3704,1922,1065,5546,5038,508,5038,3313,1725,2019-01-01,zipcode,West palm beach
ZCTA5 33414,12,61323,86553,1860,364300,47823,16827,40762,2146,8419,12345,11459,6393,23436,19749,3687,19749,14348,5401,2019-01-01,zipcode,Wellington
ZCTA5 33415,12,51791,43567,1185,135800,40465,13005,33842,7525,11258,9114,4454,1491,19021,16586,2435,16586,9131,7455,2019-01-01,zipcode,West palm beach
ZCTA5 33417,12,33743,37924,1170,82100,27493,10511,24253,4146,7428,7002,4285,1392,18845,14347,4498,14347,7886,6461,2019-01-01,zipcode,West palm beach
ZCTA5 33418,12,40926,96311,1766,399200,35025,15337,32229,1344,4938,8488,9817,7642,21445,16963,4482,16963,13538,3425,2019-01-01,zipcode,Palm beach gardens
ZCTA5 33426,12,23866,61239,1586,206900,20534,7154,17937,1550,5427,6119,3264,1577,11544,9967,1577,9967,5906,4061,2019-01-01,zipcode,Boynton beach
ZCTA5 33428,12,41441,71239,1663,291200,33510,11912,28611,2008,7040,8133,7866,3564,15592,13836,1756,13836,9756,4080,2019-01-01,zipcode,Boca raton
ZCTA5 33430,12,23172,24615,601,111500,17271,7982,14332,5670,4528,3056,889,189,8675,7498,1177,7498,2259,5239,2019-01-01,zipcode,Belle glade
ZCTA5 33431,12,21610,81381,1758,400800,18374,7762,14187,732,2264,3651,4242,3298,9890,7974,1916,7974,5423,2551,2019-01-01,zipcode,Boca raton
ZCTA5 33432,12,20487,77250,1701,620600,18737,8021,16802,979,2793,4349,4782,3899,15762,10547,5215,10547,6636,3911,2019-01-01,zipcode,Boca raton
ZCTA5 33433,12,40257,63774,1816,294100,34475,16202,30866,1199,6443,7581,9387,6256,23380,18298,5082,18298,12978,5320,2019-01-01,zipcode,Boca raton
ZCTA5 33434,12,20486,60457,1149,246800,18241,10181,17215,1213,3437,3999,4820,3746,13750,9849,3901,9849,8114,1735,2019-01-01,zipcode,Boca raton
ZCTA5 33435,12,36166,52210,1428,172300,30688,11795,27427,4930,7033,8226,4991,2247,18638,13696,4942,13696,8032,5664,2019-01-01,zipcode,Boynton beach
ZCTA5 33436,12,44489,60422,1528,236500,37485,15138,33917,3128,7945,10732,7845,4267,21657,17333,4324,17333,12548,4785,2019-01-01,zipcode,Boynton beach
ZCTA5 33437,12,38152,64612,1536,289500,34919,21657,33460,1616,7580,9716,8175,6373,21444,18312,3132,18312,15962,2350,2019-01-01,zipcode,Boynton beach
ZCTA5 33438,12,367,58750,-666666666,107800,347,114,282,29,121,73,38,21,121,105,16,105,96,9,2019-01-01,zipcode,Canal point
ZCTA5 33440,12,19761,40883,804,86500,15620,5918,12862,4300,4335,3105,852,270,7821,6496,1325,6496,4221,2275,2019-01-01,zipcode,Clewiston
ZCTA5 33441,12,27323,48778,1228,233300,23264,7465,20682,2894,6390,6269,3373,1756,13755,11104,2651,11104,5630,5474,2019-01-01,zipcode,Deerfield beach
ZCTA5 33442,12,28964,49599,1588,151700,24920,11111,22790,1580,6629,7142,4890,2549,19307,13802,5505,13802,9247,4555,2019-01-01,zipcode,Deerfield beach
ZCTA5 33444,12,24597,56722,1392,291000,20545,6484,17871,3799,4747,4819,2981,1525,9930,8705,1225,8705,4528,4177,2019-01-01,zipcode,Delray beach
ZCTA5 33445,12,31703,55274,1643,204400,28163,11625,24867,2131,5649,7022,6150,3915,17673,14077,3596,14077,9257,4820,2019-01-01,zipcode,Delray beach
ZCTA5 33446,12,26006,57383,1199,281500,23986,15545,23187,1398,4885,6411,5737,4756,18016,13456,4560,13456,11406,2050,2019-01-01,zipcode,Delray beach
ZCTA5 33449,12,12321,124107,1840,453800,9593,3922,8116,259,1202,1931,2187,2537,4449,3970,479,3970,3628,342,2019-01-01,zipcode,Lake worth
ZCTA5 33455,12,22200,56987,1036,271600,19488,9973,17922,1401,4658,5276,4222,2365,11962,9613,2349,9613,7895,1718,2019-01-01,zipcode,Hobe sound
ZCTA5 33458,12,58714,85811,1581,365300,46991,14348,41108,2846,7173,12019,11769,7301,24032,21646,2386,21646,15513,6133,2019-01-01,zipcode,Jupiter
ZCTA5 33460,12,32573,42329,1098,211000,25600,8405,22305,6901,5678,5398,2659,1669,12788,11004,1784,11004,4691,6313,2019-01-01,zipcode,Lake worth
ZCTA5 33461,12,47735,44107,1207,152700,37550,12298,32154,8260,10129,8796,3251,1718,17642,15080,2562,15080,7146,7934,2019-01-01,zipcode,Lake worth
ZCTA5 33462,12,33241,53428,1247,216700,27844,10137,24967,3935,7593,6567,4271,2601,15395,12410,2985,12410,7718,4692,2019-01-01,zipcode,Lake worth
ZCTA5 33463,12,63577,54417,1360,200600,49106,14666,40860,9239,10788,11389,6600,2844,20983,18511,2472,18511,12776,5735,2019-01-01,zipcode,Lake worth
ZCTA5 33467,12,54261,71821,1257,303700,45384,19162,40285,3030,9569,12007,9544,6135,23527,20087,3440,20087,17364,2723,2019-01-01,zipcode,Lake worth
ZCTA5 33469,12,14924,82443,1443,389100,12900,6258,11852,365,2081,3465,3806,2135,8692,6593,2099,6593,5721,872,2019-01-01,zipcode,Jupiter
ZCTA5 33470,12,27317,85648,1886,342200,22633,7323,18681,2608,5265,6234,3060,1514,9137,8159,978,8159,7283,876,2019-01-01,zipcode,Loxahatchee
ZCTA5 33471,12,6866,40074,762,69000,5961,3855,5280,1410,2152,1119,396,203,3395,2208,1187,2208,1691,517,2019-01-01,zipcode,Moore haven
ZCTA5 33472,12,19925,76543,2068,299800,17179,8819,15837,738,3440,4718,4169,2772,8877,7967,910,7967,7243,724,2019-01-01,zipcode,Boynton beach
ZCTA5 33473,12,12210,145245,3003,590000,9266,3734,8351,33,1388,1976,2799,2155,4764,3969,795,3969,3411,558,2019-01-01,zipcode,Boynton beach
ZCTA5 33476,12,8513,22199,581,98200,6479,2857,5243,1908,1656,1196,357,126,3019,2665,354,2665,921,1744,2019-01-01,zipcode,Pahokee
ZCTA5 33477,12,12608,81883,1742,423800,11951,7076,11522,400,2002,2901,3703,2516,12178,6990,5188,6990,5806,1184,2019-01-01,zipcode,Jupiter
ZCTA5 33478,12,14067,109847,2191,412700,11630,4129,10577,535,2641,3262,2740,1399,4982,4623,359,4623,4487,136,2019-01-01,zipcode,Jupiter
ZCTA5 33480,12,10031,116901,1692,975900,9561,6310,9448,226,654,2228,3216,3124,11741,5701,6040,5701,4901,800,2019-01-01,zipcode,Palm beach
ZCTA5 33483,12,12703,90280,1797,572900,11791,5535,11073,566,1607,2430,4018,2452,9369,6235,3134,6235,4351,1884,2019-01-01,zipcode,Delray beach
ZCTA5 33484,12,26299,45200,1375,149200,24926,15495,23721,1647,6315,6881,5170,3708,18629,14177,4452,14177,10910,3267,2019-01-01,zipcode,Delray beach
ZCTA5 33486,12,23325,80970,1576,427800,18908,7172,16604,708,3332,3780,5772,3012,10721,9061,1660,9061,7108,1953,2019-01-01,zipcode,Boca raton
ZCTA5 33487,12,20677,76786,1827,406400,17712,7977,16309,528,2578,4375,5354,3474,12662,9332,3330,9332,7298,2034,2019-01-01,zipcode,Boca raton
ZCTA5 33493,12,5532,31850,803,82200,5131,4375,4701,2130,1675,658,175,63,724,483,241,483,255,228,2019-01-01,zipcode,South bay
ZCTA5 33496,12,22530,94816,1809,377800,19734,10338,17992,629,2795,4188,5852,4528,12111,9986,2125,9986,8681,1305,2019-01-01,zipcode,Boca raton
ZCTA5 33498,12,15150,107242,2633,421600,12237,4911,10915,492,1708,2697,3435,2583,5478,5250,228,5250,4906,344,2019-01-01,zipcode,Boca raton
ZCTA5 33503,12,162,-666666666,-666666666,356300,162,57,96,9,34,53,0,0,57,57,0,57,52,5,2019-01-01,zipcode,Balm
ZCTA5 33510,12,29574,59061,1150,171800,24040,9300,20680,1549,6772,6661,4165,1533,11451,10454,997,10454,6411,4043,2019-01-01,zipcode,Brandon
ZCTA5 33511,12,58833,59862,1260,201900,47469,15723,41176,3523,9841,13742,9889,4181,24007,22101,1906,22101,11189,10912,2019-01-01,zipcode,Brandon
ZCTA5 33513,12,12713,39758,760,114000,10454,6547,8978,1615,3870,2590,596,307,4922,3660,1262,3660,2858,802,2019-01-01,zipcode,Bushnell
ZCTA5 33514,12,2717,40994,911,102200,1833,884,1540,444,446,503,45,102,800,717,83,717,474,243,2019-01-01,zipcode,Center hill
ZCTA5 33521,12,557,31167,-666666666,89400,432,235,402,38,194,136,29,5,352,218,134,218,151,67,2019-01-01,zipcode,Coleman
ZCTA5 33523,12,18835,48365,780,119400,15023,6089,12390,2571,4584,3243,1267,725,7983,6612,1371,6612,4438,2174,2019-01-01,zipcode,Dade city
ZCTA5 33525,12,20576,55103,861,154700,17200,8657,14205,1832,4718,4535,2136,984,8608,7203,1405,7203,5394,1809,2019-01-01,zipcode,Dade city
ZCTA5 33527,12,15092,62171,831,229600,12185,4494,10450,2579,3588,2535,1230,518,5322,4738,584,4738,3530,1208,2019-01-01,zipcode,Dover
ZCTA5 33534,12,17123,54125,1015,188000,12235,4040,10118,2100,3177,3136,1257,448,5614,5117,497,5117,3343,1774,2019-01-01,zipcode,Gibsonton
ZCTA5 33538,12,4728,36953,822,85100,4131,2242,3796,648,1640,1047,289,172,2898,1983,915,1983,1579,404,2019-01-01,zipcode,Lake panasoffkee
ZCTA5 33540,12,8652,35812,744,82300,7526,4233,6809,1051,2987,1955,551,265,5074,3803,1271,3803,2826,977,2019-01-01,zipcode,Zephyrhills
ZCTA5 33541,12,21612,41681,1008,76900,18601,11585,17262,2647,6650,5293,1750,922,12651,9319,3332,9319,7292,2027,2019-01-01,zipcode,Zephyrhills
ZCTA5 33542,12,22057,35095,839,72200,19110,11573,16997,2391,6759,5776,1445,626,13322,10010,3312,10010,6807,3203,2019-01-01,zipcode,Zephyrhills
ZCTA5 33543,12,28156,85855,1445,226800,22083,7720,19123,1161,3715,6114,4953,3180,10492,9387,1105,9387,7674,1713,2019-01-01,zipcode,Wesley chapel
ZCTA5 33544,12,28187,84122,1555,254800,21443,6624,18778,1581,4157,5246,4908,2886,10095,9582,513,9582,6827,2755,2019-01-01,zipcode,Wesley chapel
ZCTA5 33545,12,19592,81687,1514,221100,14680,4374,12417,731,2688,4611,2853,1534,6551,6124,427,6124,4521,1603,2019-01-01,zipcode,Wesley chapel
ZCTA5 33547,12,25907,107489,1788,326200,18017,6038,15460,823,2897,3651,4899,3190,8575,7995,580,7995,6742,1253,2019-01-01,zipcode,Lithia
ZCTA5 33548,12,7222,111841,1588,362700,5884,2291,5009,80,888,1478,1622,941,2772,2605,167,2605,2352,253,2019-01-01,zipcode,Lutz
ZCTA5 33549,12,17998,73251,1159,230500,14984,5545,13357,746,3147,4535,3046,1883,7115,6816,299,6816,5290,1526,2019-01-01,zipcode,Lutz
ZCTA5 33556,12,23182,103983,1307,375600,18329,6814,16204,864,3016,4598,4599,3127,8926,8085,841,8085,7173,912,2019-01-01,zipcode,Odessa
ZCTA5 33558,12,24248,82928,1099,342700,18936,6166,16469,654,2845,4528,5137,3305,9725,9047,678,9047,6288,2759,2019-01-01,zipcode,Lutz
ZCTA5 33559,12,18473,68895,1211,206200,15224,4220,12476,820,2897,3900,2993,1866,7304,6743,561,6743,4023,2720,2019-01-01,zipcode,Lutz
ZCTA5 33563,12,28033,46554,952,140000,21787,8130,18712,3740,6926,5030,2250,766,11082,9939,1143,9939,5282,4657,2019-01-01,zipcode,Plant city
ZCTA5 33565,12,17864,53606,924,161300,14169,6190,12690,2310,4758,3607,1451,564,6721,6158,563,6158,4795,1363,2019-01-01,zipcode,Plant city
ZCTA5 33566,12,21505,65064,1064,207200,16778,5917,14524,2550,4802,3636,2361,1175,7856,7369,487,7369,5307,2062,2019-01-01,zipcode,Plant city
ZCTA5 33567,12,12195,60170,858,194500,9435,3314,8051,2227,2593,1939,956,336,4009,3741,268,3741,2846,895,2019-01-01,zipcode,Plant city
ZCTA5 33569,12,28442,70583,1373,215800,22226,8082,19280,1660,5027,6411,4205,1977,10630,9801,829,9801,7914,1887,2019-01-01,zipcode,Riverview
ZCTA5 33570,12,29967,51429,904,165200,23225,9233,20104,3453,6497,6790,2003,1361,11974,9868,2106,9868,7023,2845,2019-01-01,zipcode,Ruskin
ZCTA5 33572,12,20380,88654,1548,276300,16729,5822,15156,804,3132,5035,3850,2335,8726,7887,839,7887,6663,1224,2019-01-01,zipcode,Apollo beach
ZCTA5 33573,12,23170,48644,1776,174400,21873,16496,21430,949,5987,7569,4158,2767,15152,12916,2236,12916,10395,2521,2019-01-01,zipcode,Sun city center
ZCTA5 33576,12,4543,63433,908,199900,4132,2677,3863,245,1083,1452,550,533,2454,2132,322,2132,1904,228,2019-01-01,zipcode,San antonio
ZCTA5 33578,12,52486,64181,1283,197500,40856,11077,35095,2147,9312,12176,7625,3835,21204,19848,1356,19848,11022,8826,2019-01-01,zipcode,Riverview
ZCTA5 33579,12,36005,85033,1708,227000,27039,7321,23741,2380,6005,7508,4952,2896,12060,11096,964,11096,8611,2485,2019-01-01,zipcode,Riverview
ZCTA5 33584,12,26798,62004,1151,171900,21059,7751,18574,2071,6123,5810,3410,1160,10019,9217,802,9217,6970,2247,2019-01-01,zipcode,Seffner
ZCTA5 33585,12,1133,51326,786,165700,948,575,889,130,358,346,38,17,513,471,42,471,340,131,2019-01-01,zipcode,Sumterville
ZCTA5 33592,12,11546,42308,859,112300,9204,4453,7841,1311,3082,1985,1038,425,4575,3980,595,3980,2519,1461,2019-01-01,zipcode,Thonotosassa
ZCTA5 33594,12,34941,64854,1396,188500,28703,10015,25689,2587,7590,8322,4947,2243,13609,12690,919,12690,10155,2535,2019-01-01,zipcode,Valrico
ZCTA5 33596,12,30830,98993,1673,274800,24494,8405,21030,839,4423,6352,6267,3149,10467,10019,448,10019,8733,1286,2019-01-01,zipcode,Valrico
ZCTA5 33597,12,7702,45335,802,105800,6362,3327,5426,1014,2153,1589,503,167,3594,2633,961,2633,2109,524,2019-01-01,zipcode,Webster
ZCTA5 33598,12,20053,66961,832,230600,15554,5856,13449,3597,3804,3204,1706,1138,6866,6138,728,6138,4734,1404,2019-01-01,zipcode,Wimauma
ZCTA5 33602,12,15586,72824,1597,348500,13732,4237,12667,1158,1877,2779,3351,3502,9967,8552,1415,8552,3230,5322,2019-01-01,zipcode,Tampa
ZCTA5 33603,12,21366,48197,1003,192600,17089,5306,15095,2092,4313,4346,2889,1455,9545,8544,1001,8544,4469,4075,2019-01-01,zipcode,Tampa
ZCTA5 33604,12,39604,43094,979,164800,32601,10923,27955,5075,9921,7082,3981,1896,16918,15220,1698,15220,8094,7126,2019-01-01,zipcode,Tampa
ZCTA5 33605,12,17655,25855,996,108100,13660,6058,11688,3358,3856,2719,1234,521,8388,7092,1296,7092,2507,4585,2019-01-01,zipcode,Tampa
ZCTA5 33606,12,20576,80878,1455,538700,18219,6212,12945,443,1328,2162,5090,3922,9710,8406,1304,8406,3510,4896,2019-01-01,zipcode,Tampa
ZCTA5 33607,12,24384,44806,1302,172800,20718,7077,18357,3114,5716,3757,4058,1712,12469,10785,1684,10785,4356,6429,2019-01-01,zipcode,Tampa
ZCTA5 33609,12,18367,71225,1169,359700,15289,4297,13407,867,1948,3168,4199,3225,9273,8311,962,8311,4627,3684,2019-01-01,zipcode,Tampa
ZCTA5 33610,12,46799,36742,1019,115800,34149,13528,29206,5863,11313,7500,3133,1397,17901,16240,1661,16240,6895,9345,2019-01-01,zipcode,Tampa
ZCTA5 33611,12,33070,67421,1146,281700,27506,8589,25314,1640,5615,5661,7900,4498,16809,14850,1959,14850,8679,6171,2019-01-01,zipcode,Tampa
ZCTA5 33612,12,51745,32200,931,146200,40595,16605,32953,6538,12204,8489,3984,1738,20889,18866,2023,18866,6494,12372,2019-01-01,zipcode,Tampa
ZCTA5 33613,12,36270,34932,886,162800,30759,11233,21028,3469,5659,5478,4239,2183,16747,14554,2193,14554,4403,10151,2019-01-01,zipcode,Tampa
ZCTA5 33614,12,49060,41954,999,175100,40259,12582,34700,7128,11714,9002,5030,1826,19878,18397,1481,18397,7323,11074,2019-01-01,zipcode,Tampa
ZCTA5 33615,12,47512,51672,1135,166500,38939,12367,34237,3811,11842,9409,6492,2683,19704,17455,2249,17455,9204,8251,2019-01-01,zipcode,Tampa
ZCTA5 33616,12,16781,63074,1313,197200,13683,3766,11892,779,3883,3223,2616,1391,7631,6797,834,6797,3156,3641,2019-01-01,zipcode,Tampa
ZCTA5 33617,12,47441,39700,999,172500,37425,11560,30580,3480,8581,9876,5267,3376,20039,18212,1827,18212,7071,11141,2019-01-01,zipcode,Tampa
ZCTA5 33618,12,27352,70605,1125,278100,23292,8181,20711,775,4167,6399,5873,3497,12575,11512,1063,11512,7572,3940,2019-01-01,zipcode,Tampa
ZCTA5 33619,12,40092,44085,1160,112200,31758,12330,26316,5032,9603,7394,2626,1661,14315,13208,1107,13208,6006,7202,2019-01-01,zipcode,Tampa
ZCTA5 33620,12,5318,-666666666,-666666666,-666666666,5318,4264,48,11,0,27,10,0,23,11,12,11,0,11,2019-01-01,zipcode,Tampa
ZCTA5 33621,12,2751,72428,2197,-666666666,1609,511,1105,0,236,463,261,145,621,570,51,570,0,570,2019-01-01,zipcode,Tampa
ZCTA5 33624,12,39803,69910,1261,235400,33190,9874,29263,1598,7235,9277,7182,3971,16073,15190,883,15190,9667,5523,2019-01-01,zipcode,Tampa
ZCTA5 33625,12,27305,68634,1317,234600,22405,6785,19598,1334,5515,6156,4319,2274,10972,10374,598,10374,6832,3542,2019-01-01,zipcode,Tampa
ZCTA5 33626,12,30743,107269,1537,360800,23459,7062,20626,703,3134,4559,7553,4677,12621,11519,1102,11519,7716,3803,2019-01-01,zipcode,Tampa
ZCTA5 33629,12,27061,128248,1361,544200,20408,6470,18601,402,1826,3271,6999,6103,11786,10694,1092,10694,8639,2055,2019-01-01,zipcode,Tampa
ZCTA5 33634,12,22719,57423,1313,171500,18730,6391,15966,2117,4939,4198,3169,1543,8024,7438,586,7438,4248,3190,2019-01-01,zipcode,Tampa
ZCTA5 33635,12,18650,63899,1383,197400,14773,4705,13328,1108,3602,3951,2809,1858,7891,7111,780,7111,4444,2667,2019-01-01,zipcode,Tampa
ZCTA5 33637,12,17555,52004,1140,152300,14041,4005,11001,1187,2730,3357,2381,1346,7208,6429,779,6429,2622,3807,2019-01-01,zipcode,Tampa
ZCTA5 33647,12,71004,88649,1383,295900,55525,16510,46971,2112,6401,11201,16153,11104,26924,24854,2070,24854,14110,10744,2019-01-01,zipcode,Tampa
ZCTA5 33701,12,15728,39251,925,376100,14439,6003,12908,916,2504,3235,3800,2453,12123,8878,3245,8878,3104,5774,2019-01-01,zipcode,Saint petersburg
ZCTA5 33702,12,32019,53243,1037,169500,26882,9256,24155,2529,6613,7196,5127,2690,16184,13452,2732,13452,8516,4936,2019-01-01,zipcode,Saint petersburg
ZCTA5 33703,12,25699,77953,1290,248900,21753,7746,19523,1069,3916,6158,4927,3453,12055,10843,1212,10843,8398,2445,2019-01-01,zipcode,Saint petersburg
ZCTA5 33704,12,16982,83031,1018,384400,14563,4821,13518,587,2267,3108,4221,3335,8788,7614,1174,7614,5550,2064,2019-01-01,zipcode,Saint petersburg
ZCTA5 33705,12,28857,50637,1111,182500,24096,9752,20941,2305,5590,6445,3935,2666,14790,10919,3871,10919,6154,4765,2019-01-01,zipcode,Saint petersburg
ZCTA5 33706,12,16321,75636,1166,423300,15388,7603,14729,606,2756,4652,4045,2670,14122,8536,5586,8536,6475,2061,2019-01-01,zipcode,Saint petersburg
ZCTA5 33707,12,24767,51279,1098,210100,22519,11066,21055,1376,5692,6564,4789,2634,15710,12127,3583,12127,8395,3732,2019-01-01,zipcode,Saint petersburg
ZCTA5 33708,12,16083,62924,1230,299700,14817,7852,14033,772,3038,4795,3382,2046,13839,8168,5671,8168,6131,2037,2019-01-01,zipcode,Saint petersburg
ZCTA5 33709,12,24619,42111,949,121900,21283,9786,19183,2581,7077,5956,2530,1039,14303,10615,3688,10615,7770,2845,2019-01-01,zipcode,Saint petersburg
ZCTA5 33710,12,34222,60463,1127,194200,28927,9986,25916,2068,8020,7731,5697,2400,16114,13711,2403,13711,10540,3171,2019-01-01,zipcode,Saint petersburg
ZCTA5 33711,12,19706,46628,1151,161600,16765,7571,13238,1288,4911,3750,2048,1241,9620,6969,2651,6969,4212,2757,2019-01-01,zipcode,Saint petersburg
ZCTA5 33712,12,24738,47690,1047,191000,20728,7917,17483,1800,4692,5928,3417,1646,12169,9196,2973,9196,4885,4311,2019-01-01,zipcode,Saint petersburg
ZCTA5 33713,12,32348,56999,1099,164200,27161,9017,24318,3370,6099,7989,4645,2215,15072,12999,2073,12999,8948,4051,2019-01-01,zipcode,Saint petersburg
ZCTA5 33714,12,21866,38245,996,103700,17785,6846,15498,2845,5525,4836,1729,563,9828,7939,1889,7939,5121,2818,2019-01-01,zipcode,Saint petersburg
ZCTA5 33715,12,7296,91386,1731,384200,6825,4206,6502,141,899,1755,2055,1652,6887,3690,3197,3690,3340,350,2019-01-01,zipcode,Saint petersburg
ZCTA5 33716,12,18242,56867,1274,216800,15988,3619,13945,376,2868,4318,4265,2118,11011,9309,1702,9309,1666,7643,2019-01-01,zipcode,Saint petersburg
ZCTA5 33744,12,122,-666666666,-666666666,-666666666,122,111,111,11,100,0,0,0,0,0,0,0,0,0,2019-01-01,zipcode,Bay pines
ZCTA5 33755,12,26616,39406,954,194300,21324,8188,18714,2628,6319,5998,2862,907,11195,9736,1459,9736,5260,4476,2019-01-01,zipcode,Clearwater
ZCTA5 33756,12,33971,44271,962,195200,28147,11496,24975,2924,6374,8883,4853,1941,16228,13584,2644,13584,7909,5675,2019-01-01,zipcode,Clearwater
ZCTA5 33759,12,18236,52344,1283,175600,15261,6331,13641,1401,3859,4164,2749,1468,8992,7933,1059,7933,4409,3524,2019-01-01,zipcode,Clearwater
ZCTA5 33760,12,17336,52465,1104,147100,14528,5078,12229,1593,3611,4422,1856,747,7784,6651,1133,6651,3076,3575,2019-01-01,zipcode,Clearwater
ZCTA5 33761,12,19794,54151,1196,171200,17221,7996,15946,959,4005,5224,3776,1982,10336,8758,1578,8758,7081,1677,2019-01-01,zipcode,Clearwater
ZCTA5 33762,12,8355,68411,1340,233400,7599,3898,6779,716,1908,1895,1420,840,3032,2693,339,2693,1999,694,2019-01-01,zipcode,Clearwater
ZCTA5 33763,12,19730,44790,1094,128400,17520,8576,15987,1489,5271,4760,2730,1737,11245,9298,1947,9298,6606,2692,2019-01-01,zipcode,Clearwater
ZCTA5 33764,12,27320,52760,1189,193000,23300,9750,21108,1416,6383,7071,4224,2014,14718,11787,2931,11787,8488,3299,2019-01-01,zipcode,Clearwater
ZCTA5 33765,12,14744,46297,1052,158300,12554,4480,11416,1498,3164,3956,1636,1162,6710,6154,556,6154,2939,3215,2019-01-01,zipcode,Clearwater
ZCTA5 33767,12,7452,83770,1776,468300,7066,4304,6726,275,1477,1701,1741,1532,8363,3976,4387,3976,3255,721,2019-01-01,zipcode,Clearwater beach
ZCTA5 33770,12,26627,46355,1053,168200,22949,8931,20304,2104,6802,6873,2895,1630,14096,11621,2475,11621,6692,4929,2019-01-01,zipcode,Largo
ZCTA5 33771,12,30365,42528,1064,79300,25885,11740,23763,2461,8242,7828,3770,1462,17118,13404,3714,13404,7753,5651,2019-01-01,zipcode,Largo
ZCTA5 33772,12,23125,55200,1144,209400,19579,8347,17589,1180,5290,5884,3651,1584,12208,9848,2360,9848,7342,2506,2019-01-01,zipcode,Seminole
ZCTA5 33773,12,17595,52884,1014,185800,15112,5759,13354,1066,4078,4692,2560,958,8340,7115,1225,7115,5243,1872,2019-01-01,zipcode,Largo
ZCTA5 33774,12,18097,55394,1015,222900,15051,6821,13863,1116,3872,4923,2578,1374,9884,7745,2139,7745,5549,2196,2019-01-01,zipcode,Largo
ZCTA5 33776,12,13573,80703,1566,292100,11582,4594,10334,355,2634,3051,2711,1583,5492,4964,528,4964,4534,430,2019-01-01,zipcode,Seminole
ZCTA5 33777,12,16748,65207,1270,184100,13991,5839,12785,814,3807,3910,2584,1670,8136,6803,1333,6803,5582,1221,2019-01-01,zipcode,Seminole
ZCTA5 33778,12,14582,50150,1074,160500,12309,5349,11369,953,3997,4191,1504,724,7571,5981,1590,5981,4681,1300,2019-01-01,zipcode,Largo
ZCTA5 33781,12,24856,42936,906,152600,20487,8028,18459,2988,6294,5337,2723,1117,11500,9772,1728,9772,6070,3702,2019-01-01,zipcode,Pinellas park
ZCTA5 33782,12,23443,54063,1230,152400,19418,8654,17844,1923,6353,5366,2760,1442,10646,9314,1332,9314,6849,2465,2019-01-01,zipcode,Pinellas park
ZCTA5 33785,12,5432,72222,1254,474500,5117,2380,4947,197,815,1569,1505,861,6159,2878,3281,2878,2034,844,2019-01-01,zipcode,Indian rocks beach
ZCTA5 33786,12,1565,85500,2396,612400,1408,820,1348,56,200,294,457,341,1155,742,413,742,646,96,2019-01-01,zipcode,Belleair beach
ZCTA5 33801,12,34370,36031,834,85000,27766,14368,20792,4521,7657,5395,2198,1021,14807,11788,3019,11788,5920,5868,2019-01-01,zipcode,Lakeland
ZCTA5 33803,12,29460,52832,1034,152800,24578,10044,21369,2119,5922,6277,4482,2569,14367,11722,2645,11722,7122,4600,2019-01-01,zipcode,Lakeland
ZCTA5 33805,12,25529,34525,981,92100,20472,9463,17265,3563,6301,4468,1951,982,10709,9041,1668,9041,4444,4597,2019-01-01,zipcode,Lakeland
ZCTA5 33809,12,30347,54465,1078,164500,25597,11174,22458,2556,7649,7762,2924,1567,13053,11147,1906,11147,7750,3397,2019-01-01,zipcode,Lakeland
ZCTA5 33810,12,51139,58285,1089,154800,40698,17357,35714,4687,13119,11647,4076,2185,20186,17545,2641,17545,13229,4316,2019-01-01,zipcode,Lakeland
ZCTA5 33811,12,22293,62678,1095,179400,18245,6985,15895,1564,5622,4870,2720,1119,9132,7975,1157,7975,5762,2213,2019-01-01,zipcode,Lakeland
ZCTA5 33812,12,12998,79688,1240,185500,10152,3591,8895,438,3019,2831,1587,1020,5325,4328,997,4328,3504,824,2019-01-01,zipcode,Lakeland
ZCTA5 33813,12,38214,83521,1199,224200,30548,11527,26822,1434,6986,8283,6315,3804,14232,13055,1177,13055,10469,2586,2019-01-01,zipcode,Lakeland
ZCTA5 33815,12,15148,32193,764,27900,11888,5668,9763,2015,4536,2321,624,267,7739,5690,2049,5690,3272,2418,2019-01-01,zipcode,Lakeland
ZCTA5 33823,12,33615,50309,862,149400,26501,12158,22957,3667,8354,6537,3109,1290,12786,11194,1592,11194,7902,3292,2019-01-01,zipcode,Auburndale
ZCTA5 33825,12,26420,38579,802,89900,21422,12454,18717,3472,6933,5526,1572,1214,11512,9110,2402,9110,6429,2681,2019-01-01,zipcode,Avon park
ZCTA5 33827,12,3062,62631,1238,157100,2503,1284,1905,205,711,630,224,135,1246,953,293,953,832,121,2019-01-01,zipcode,Babson park
ZCTA5 33830,12,28884,51083,833,134900,22502,8880,18989,2437,7821,5173,2533,1025,11362,9687,1675,9687,6287,3400,2019-01-01,zipcode,Bartow
ZCTA5 33834,12,7524,48471,780,72300,5922,3580,5040,1228,2380,884,414,134,2190,1736,454,1736,1074,662,2019-01-01,zipcode,Bowling green
ZCTA5 33837,12,30634,57337,1348,190000,24321,10533,21609,2658,5796,7636,3801,1718,13469,9677,3792,9677,7466,2211,2019-01-01,zipcode,Davenport
ZCTA5 33838,12,4358,38899,898,115600,3050,1490,2681,784,1043,718,81,55,1603,1193,410,1193,686,507,2019-01-01,zipcode,Dundee
ZCTA5 33839,12,3356,50335,823,129700,2674,997,2357,512,839,683,245,78,1336,1119,217,1119,731,388,2019-01-01,zipcode,Eagle lake
ZCTA5 33841,12,8969,43653,759,96800,7052,3335,6125,1154,2674,1508,510,279,3921,3017,904,3017,2300,717,2019-01-01,zipcode,Fort meade
ZCTA5 33843,12,11032,42668,731,71300,9406,6054,8312,2300,2961,2027,597,427,5101,3503,1598,3503,2781,722,2019-01-01,zipcode,Frostproof
ZCTA5 33844,12,36701,41883,937,124300,28902,12879,25064,4908,9436,7126,2338,1256,17135,12153,4982,12153,7866,4287,2019-01-01,zipcode,Haines city
ZCTA5 33847,12,176,65750,-666666666,-666666666,123,58,87,18,32,19,11,7,47,47,0,47,39,8,2019-01-01,zipcode,Homeland
ZCTA5 33848,12,1022,55750,-666666666,57000,756,309,537,219,232,66,0,20,483,169,314,169,98,71,2019-01-01,zipcode,Intercession city
ZCTA5 33849,12,1171,45640,-666666666,96100,946,427,838,214,394,205,13,12,423,300,123,300,256,44,2019-01-01,zipcode,Kathleen
ZCTA5 33850,12,8324,48341,882,120500,6754,3074,6032,1112,1945,1862,512,601,4139,3177,962,3177,2322,855,2019-01-01,zipcode,Lake alfred
ZCTA5 33851,12,1153,48519,1063,144100,925,423,798,57,437,222,74,8,409,350,59,350,323,27,2019-01-01,zipcode,Lake hamilton
ZCTA5 33852,12,21099,39421,778,137600,18354,11201,16623,2210,7512,4559,1607,735,12468,8568,3900,8568,7060,1508,2019-01-01,zipcode,Lake placid
ZCTA5 33853,12,11649,37689,751,149900,9013,3577,7808,1741,2460,1949,1134,524,4937,4082,855,4082,2051,2031,2019-01-01,zipcode,Lake wales
ZCTA5 33854,12,294,33750,617,41000,272,168,259,23,88,86,52,10,618,188,430,188,95,93,2019-01-01,zipcode,Lakeshore
ZCTA5 33855,12,0,-666666666,-666666666,-666666666,0,0,0,0,0,0,0,0,0,0,0,0,0,0,2019-01-01,zipcode,Indian lake estates
ZCTA5 33856,12,270,27986,541,-666666666,270,240,270,0,117,113,40,0,437,191,246,191,0,191,2019-01-01,zipcode,Nalcrest
ZCTA5 33857,12,2377,28546,438,-666666666,1862,996,1771,484,953,291,43,0,1554,991,563,991,632,359,2019-01-01,zipcode,Lorida
ZCTA5 33859,12,11025,43688,911,118600,9117,4705,7646,1219,2773,2560,723,371,5335,4332,1003,4332,3097,1235,2019-01-01,zipcode,Lake wales
ZCTA5 33860,12,26893,51904,988,132200,20414,8525,17702,2551,7347,5108,1859,837,9307,8141,1166,8141,6269,1872,2019-01-01,zipcode,Mulberry
ZCTA5 33865,12,958,57917,-666666666,-666666666,836,400,764,158,376,156,61,13,269,224,45,224,176,48,2019-01-01,zipcode,Ona
ZCTA5 33867,12,327,39038,-666666666,144200,327,231,327,38,111,77,88,13,256,166,90,166,166,0,2019-01-01,zipcode,River ranch
ZCTA5 33868,12,12081,51250,867,109000,9941,5916,9096,1972,3582,2395,718,429,4652,3637,1015,3637,2999,638,2019-01-01,zipcode,Polk city
ZCTA5 33870,12,22284,32364,744,84600,18737,10319,16497,3205,6171,4925,1328,868,11651,8696,2955,8696,5365,3331,2019-01-01,zipcode,Sebring
ZCTA5 33872,12,15923,46574,900,105100,14060,9256,13120,1138,4381,4560,1928,1113,9509,7211,2298,7211,5801,1410,2019-01-01,zipcode,Sebring
ZCTA5 33873,12,14162,37766,702,86100,10688,4779,8838,1917,4311,1649,615,346,5549,4489,1060,4489,2724,1765,2019-01-01,zipcode,Wauchula
ZCTA5 33875,12,11522,54054,992,150500,9990,4964,9108,880,3300,2402,1674,852,5701,4701,1000,4701,3948,753,2019-01-01,zipcode,Sebring
ZCTA5 33876,12,4888,51088,1036,104800,4172,2511,3952,456,1700,1262,395,139,2635,2033,602,2033,1717,316,2019-01-01,zipcode,Sebring
ZCTA5 33877,12,618,-666666666,-666666666,-666666666,457,289,201,60,106,35,0,0,139,106,33,106,36,70,2019-01-01,zipcode,Waverly
ZCTA5 33880,12,40519,44239,907,117100,31762,13476,27460,6290,9903,7902,1993,1372,16390,13686,2704,13686,8904,4782,2019-01-01,zipcode,Winter haven
ZCTA5 33881,12,34340,40897,897,93200,28001,14871,24570,3852,8953,7544,2662,1559,16100,13059,3041,13059,8958,4101,2019-01-01,zipcode,Winter haven
ZCTA5 33884,12,32019,60298,1150,180900,26534,11761,23162,1851,6748,8058,4072,2433,14412,11973,2439,11973,8554,3419,2019-01-01,zipcode,Winter haven
ZCTA5 33890,12,4773,36082,719,83800,3524,1710,2985,697,1612,455,140,81,1828,1483,345,1483,1167,316,2019-01-01,zipcode,Zolfo springs
ZCTA5 33896,12,11654,63958,1546,205400,9727,3058,8142,896,2070,3035,1459,682,5227,3610,1617,3610,2128,1482,2019-01-01,zipcode,Davenport
ZCTA5 33897,12,22752,60430,1559,168600,18334,6576,15909,1249,5760,5997,2099,804,12513,7009,5504,7009,4897,2112,2019-01-01,zipcode,Davenport
ZCTA5 33898,12,16931,45193,899,118800,14149,6988,12611,2432,4816,3555,1256,552,9252,6318,2934,6318,4937,1381,2019-01-01,zipcode,Lake wales
ZCTA5 33901,12,21364,38112,933,194900,17706,8011,15766,2955,4853,4011,2438,1509,10780,8701,2079,8701,3596,5105,2019-01-01,zipcode,Fort myers
ZCTA5 33903,12,22657,43870,923,101200,20172,12122,18703,2687,6576,6011,2126,1303,14757,10711,4046,10711,8457,2254,2019-01-01,zipcode,North fort myers
ZCTA5 33904,12,31086,51861,1161,236800,27867,13798,26101,2335,9061,8359,4486,1860,19632,13395,6237,13395,10295,3100,2019-01-01,zipcode,Cape coral
ZCTA5 33905,12,37492,51634,1059,164000,30826,13777,26615,5716,9039,7008,3048,1804,14793,11778,3015,11778,7890,3888,2019-01-01,zipcode,Fort myers
ZCTA5 33907,12,24429,42530,1137,155700,20212,7795,18009,2654,5382,4910,3414,1649,12878,9536,3342,9536,4119,5417,2019-01-01,zipcode,Fort myers
ZCTA5 33908,12,36513,59596,1414,270600,33582,20730,31539,1579,8471,8374,7760,5355,31436,17577,13859,17577,12628,4949,2019-01-01,zipcode,Fort myers
ZCTA5 33909,12,31750,60105,1245,187500,25156,9352,21547,2011,8663,6711,3034,1128,11563,10215,1348,10215,6602,3613,2019-01-01,zipcode,Cape coral
ZCTA5 33912,12,18646,77333,1413,278800,16538,8974,15280,606,3403,4524,3911,2836,11378,7979,3399,7979,6681,1298,2019-01-01,zipcode,Fort myers
ZCTA5 33913,12,25497,85268,1639,307000,21979,10820,18821,1283,3902,5170,5090,3376,12934,8959,3975,8959,7744,1215,2019-01-01,zipcode,Fort myers
ZCTA5 33914,12,38281,65381,1189,282900,33812,14961,30578,2211,10748,9499,4928,3192,20535,14916,5619,14916,11526,3390,2019-01-01,zipcode,Cape coral
ZCTA5 33916,12,24907,36349,988,111600,18329,7027,15872,3986,4865,3792,2052,1177,11274,8553,2721,8553,3038,5515,2019-01-01,zipcode,Fort myers
ZCTA5 33917,12,30049,49671,854,107700,26402,15211,24852,3070,9466,7402,3059,1855,17245,12570,4675,12570,10329,2241,2019-01-01,zipcode,North fort myers
ZCTA5 33919,12,30330,56932,1192,202600,26714,12993,24937,1424,6121,7992,5615,3785,18705,13933,4772,13933,10329,3604,2019-01-01,zipcode,Fort myers
ZCTA5 33920,12,6243,78377,926,265100,5370,2508,4867,629,1487,1775,579,397,2492,2098,394,2098,1893,205,2019-01-01,zipcode,Alva
ZCTA5 33921,12,813,101250,-666666666,1198700,794,530,755,46,93,316,141,159,1919,331,1588,331,276,55,2019-01-01,zipcode,Boca grande
ZCTA5 33922,12,4108,47143,972,196500,3573,2202,3447,344,1103,1153,449,398,2779,1704,1075,1704,1442,262,2019-01-01,zipcode,Bokeelia
ZCTA5 33924,12,195,-666666666,-666666666,-666666666,195,72,183,78,33,34,25,13,1893,45,1848,45,34,11,2019-01-01,zipcode,Captiva
ZCTA5 33928,12,25141,79078,1681,313500,21851,12688,20876,1117,4210,6165,5523,3861,17771,11090,6681,11090,9566,1524,2019-01-01,zipcode,Estero
ZCTA5 33930,12,930,52713,-666666666,136800,598,182,482,80,248,113,0,41,426,357,69,357,302,55,2019-01-01,zipcode,Felda
ZCTA5 33931,12,10566,64738,1128,362000,10338,7241,10170,599,2561,3094,2142,1774,15227,5467,9760,5467,4873,594,2019-01-01,zipcode,Fort myers beach
ZCTA5 33935,12,23513,39098,765,96100,17549,7162,14648,4944,4888,3482,765,569,8262,6911,1351,6911,4664,2247,2019-01-01,zipcode,Labelle
ZCTA5 33936,12,24517,38567,919,131300,20101,9203,17838,3254,7117,4762,1811,894,9938,8254,1684,8254,5088,3166,2019-01-01,zipcode,Lehigh acres
ZCTA5 33944,12,219,-666666666,-666666666,-666666666,97,70,97,0,97,0,0,0,105,70,35,70,70,0,2019-01-01,zipcode,Palmdale
ZCTA5 33945,12,0,-666666666,-666666666,-666666666,0,0,0,0,0,0,0,0,217,0,217,0,0,0,2019-01-01,zipcode,Pineland
ZCTA5 33946,12,2104,93547,1707,482700,2073,1397,2073,46,614,577,586,250,2794,1083,1711,1083,978,105,2019-01-01,zipcode,Placida
ZCTA5 33947,12,9096,53302,1161,248200,8524,5670,7981,500,2818,2663,1260,740,5684,4179,1505,4179,3541,638,2019-01-01,zipcode,Rotonda west
ZCTA5 33948,12,17122,47394,1047,178900,15087,8280,13780,1203,4689,4927,1674,1287,8969,7005,1964,7005,5663,1342,2019-01-01,zipcode,Port charlotte
ZCTA5 33950,12,23299,57852,995,283900,21539,14545,20308,1159,5310,6715,4493,2631,16049,11663,4386,11663,9556,2107,2019-01-01,zipcode,Punta gorda
ZCTA5 33952,12,33390,42484,972,148200,29006,14534,26228,3304,9792,8626,3112,1394,15937,13437,2500,13437,9380,4057,2019-01-01,zipcode,Port charlotte
ZCTA5 33953,12,6741,56451,1330,223800,6357,4205,6006,527,1931,2112,870,566,3973,2929,1044,2929,2672,257,2019-01-01,zipcode,Port charlotte
ZCTA5 33954,12,10573,60841,1259,209200,9171,4554,8280,833,2929,2697,1273,548,4346,3944,402,3944,3112,832,2019-01-01,zipcode,Port charlotte
ZCTA5 33955,12,11436,65558,1196,242700,10574,7066,9899,1600,2956,2759,1667,917,6661,4444,2217,4444,4045,399,2019-01-01,zipcode,Punta gorda
ZCTA5 33956,12,3489,51774,1176,230800,3439,2449,3236,311,1080,1009,309,527,3224,1680,1544,1680,1452,228,2019-01-01,zipcode,Saint james city
ZCTA5 33957,12,7319,108081,1545,721200,6758,4234,6617,152,945,1475,2021,2024,8945,3684,5261,3684,3151,533,2019-01-01,zipcode,Sanibel
ZCTA5 33960,12,672,39514,-666666666,109500,593,291,570,56,284,156,59,15,580,291,289,291,273,18,2019-01-01,zipcode,Venus
ZCTA5 33965,12,1735,-666666666,-666666666,-666666666,1735,847,28,0,0,28,0,0,0,0,0,0,0,0,2019-01-01,zipcode,Fort myers
ZCTA5 33966,12,10065,64686,1158,265800,8716,4168,7752,449,1725,2195,2029,1354,5921,4249,1672,4249,3107,1142,2019-01-01,zipcode,Fort myers
ZCTA5 33967,12,25129,67996,1335,224700,20504,6010,16556,2087,4185,5870,3205,1209,9991,8190,1801,8190,6143,2047,2019-01-01,zipcode,Fort myers
ZCTA5 33971,12,27941,53840,1184,168300,20987,7219,17135,3448,6311,5074,1504,798,8139,7396,743,7396,5322,2074,2019-01-01,zipcode,Lehigh acres
ZCTA5 33972,12,15515,62092,1158,179100,12306,4887,10479,1695,3676,3458,1153,497,5341,4506,835,4506,3355,1151,2019-01-01,zipcode,Lehigh acres
ZCTA5 33973,12,17161,42991,1051,217600,11288,4186,9332,2354,3366,2340,800,472,4419,4097,322,4097,962,3135,2019-01-01,zipcode,Lehigh acres
ZCTA5 33974,12,17757,49645,1241,162600,13343,4788,11375,1738,4464,3168,1457,548,5440,4692,748,4692,2986,1706,2019-01-01,zipcode,Lehigh acres
ZCTA5 33976,12,18245,50190,1212,150000,13171,4192,10892,2684,3719,2984,1232,273,4902,4555,347,4555,3172,1383,2019-01-01,zipcode,Lehigh acres
ZCTA5 33980,12,13342,46451,862,151300,11686,7791,10731,1074,3511,3653,1525,968,7944,5775,2169,5775,4326,1449,2019-01-01,zipcode,Punta gorda
ZCTA5 33981,12,11407,55568,1247,256300,10128,6077,9696,408,3736,3451,1395,706,6444,4656,1788,4656,3941,715,2019-01-01,zipcode,Port charlotte
ZCTA5 33982,12,10391,49750,960,124800,9103,5470,8409,1244,3054,2742,668,701,5141,4067,1074,4067,3323,744,2019-01-01,zipcode,Punta gorda
ZCTA5 33983,12,15100,58148,1061,221300,12726,6995,11689,902,4008,3675,1967,1137,7819,5897,1922,5897,4868,1029,2019-01-01,zipcode,Punta gorda
ZCTA5 33990,12,34657,59541,1167,215500,29558,12122,26587,2225,10152,8854,3606,1750,14040,11417,2623,11417,8208,3209,2019-01-01,zipcode,Cape coral
ZCTA5 33991,12,22516,69179,1501,240800,17903,6520,15818,826,5471,4640,3541,1340,9344,7722,1622,7722,5964,1758,2019-01-01,zipcode,Cape coral
ZCTA5 33993,12,27905,67680,1461,219100,22704,8980,19181,1949,7894,5426,2615,1297,10028,8588,1440,8588,6865,1723,2019-01-01,zipcode,Cape coral
ZCTA5 34101,12,0,-666666666,-666666666,-666666666,0,0,0,0,0,0,0,0,14,0,14,0,0,0,2019-01-01,zipcode,Naples
ZCTA5 34102,12,11548,85938,1262,1016900,10524,5889,9795,719,1430,2220,3212,2214,9745,5598,4147,5598,3993,1605,2019-01-01,zipcode,Naples
ZCTA5 34103,12,13129,95559,1433,768400,12067,7275,11330,520,2312,2748,3316,2434,11409,6115,5294,6115,4860,1255,2019-01-01,zipcode,Naples
ZCTA5 34104,12,24520,53303,1229,249700,21044,10010,19281,2459,5690,5530,3184,2418,15176,10494,4682,10494,7193,3301,2019-01-01,zipcode,Naples
ZCTA5 34105,12,18011,87617,1614,459700,15835,7914,14565,639,2870,4131,4349,2576,10863,7901,2962,7901,5210,2691,2019-01-01,zipcode,Naples
ZCTA5 34108,12,16450,100705,1459,735800,15232,9182,14450,546,2678,3042,4202,3982,14402,7928,6474,7928,6452,1476,2019-01-01,zipcode,Naples
ZCTA5 34109,12,24251,72095,1447,405100,21005,10407,19558,1231,4406,4216,6067,3638,14716,11064,3652,11064,6990,4074,2019-01-01,zipcode,Naples
ZCTA5 34110,12,23988,78410,1583,402100,21516,12687,20077,762,4139,5226,5262,4688,16694,11018,5676,11018,8314,2704,2019-01-01,zipcode,Naples
ZCTA5 34112,12,27064,57792,1118,227900,24155,13314,22300,2387,6789,6170,4149,2805,19295,11865,7430,11865,9100,2765,2019-01-01,zipcode,Naples
ZCTA5 34113,12,22175,57365,1333,321000,19315,9387,16603,2837,4605,3990,3251,1920,13822,8546,5276,8546,6048,2498,2019-01-01,zipcode,Naples
ZCTA5 34114,12,18223,60746,1274,255000,16370,9346,15028,1609,4776,4227,2688,1728,13362,7882,5480,7882,6505,1377,2019-01-01,zipcode,Naples
ZCTA5 34116,12,36111,52131,1242,249700,28081,7702,24024,6593,8545,5292,2405,1189,10464,9640,824,9640,5088,4552,2019-01-01,zipcode,Naples
ZCTA5 34117,12,17039,77035,1526,297900,14092,4695,11805,1886,3742,3310,1868,999,5230,4769,461,4769,4314,455,2019-01-01,zipcode,Naples
ZCTA5 34119,12,32911,92266,1621,456200,27281,14032,24391,887,5018,6653,6733,5100,16808,13103,3705,13103,10314,2789,2019-01-01,zipcode,Naples
ZCTA5 34120,12,35498,83398,1687,330200,27340,9321,24115,2539,7764,6347,4043,3422,13520,10702,2818,10702,9313,1389,2019-01-01,zipcode,Naples
ZCTA5 34134,12,14992,91019,1238,501000,14122,9815,13729,451,2541,3555,4095,3087,14340,7622,6718,7622,6529,1093,2019-01-01,zipcode,Bonita springs
ZCTA5 34135,12,47356,66616,1290,280100,41564,22398,38237,5390,8868,10666,8081,5232,29415,19166,10249,19166,15321,3845,2019-01-01,zipcode,Bonita springs
ZCTA5 34137,12,651,-666666666,-666666666,-666666666,278,115,278,0,187,91,0,0,159,159,0,159,84,75,2019-01-01,zipcode,
ZCTA5 34138,12,340,-666666666,-666666666,-666666666,294,156,294,0,144,91,59,0,351,155,196,155,108,47,2019-01-01,zipcode,Chokoloskee
ZCTA5 34139,12,204,61250,863,234600,185,55,177,5,58,51,41,22,409,115,294,115,94,21,2019-01-01,zipcode,Everglades city
ZCTA5 34140,12,337,30489,-666666666,-666666666,249,170,196,0,46,110,40,0,412,98,314,98,52,46,2019-01-01,zipcode,Goodland
ZCTA5 34141,12,67,-666666666,-666666666,-666666666,59,23,36,0,0,14,4,18,18,18,0,18,4,14,2019-01-01,zipcode,Ochopee
ZCTA5 34142,12,30534,35172,805,166000,22310,7577,17513,9570,4588,2048,952,355,8129,7088,1041,7088,3188,3900,2019-01-01,zipcode,Immokalee
ZCTA5 34145,12,17834,86215,1638,678900,16568,9838,15780,1152,3094,4458,4523,2553,18495,8379,10116,8379,7335,1044,2019-01-01,zipcode,Marco island
ZCTA5 34201,12,3997,95164,1888,453500,3584,2355,3395,129,523,688,1032,1023,2471,1846,625,1846,1715,131,2019-01-01,zipcode,Bradenton
ZCTA5 34202,12,24637,102703,1842,445600,20580,9880,18662,501,2909,4821,5640,4791,11707,9529,2178,9529,7429,2100,2019-01-01,zipcode,Bradenton
ZCTA5 34203,12,38971,54558,1045,202800,31911,13893,29241,3596,9954,8897,4375,2419,18234,14278,3956,14278,10646,3632,2019-01-01,zipcode,Bradenton
ZCTA5 34205,12,32294,42816,993,144900,26309,11316,23363,3958,7725,7106,2995,1579,15703,12313,3390,12313,7126,5187,2019-01-01,zipcode,Bradenton
ZCTA5 34207,12,36292,39812,978,79200,30136,13817,26250,4693,10262,7126,2524,1645,19218,14608,4610,14608,8342,6266,2019-01-01,zipcode,Bradenton
ZCTA5 34208,12,40998,48664,1065,172100,32141,13134,27386,5848,9467,6538,3688,1845,14963,12747,2216,12747,7347,5400,2019-01-01,zipcode,Bradenton
ZCTA5 34209,12,35172,60037,1232,227200,31229,15485,28164,1652,8903,9142,5042,3425,18490,14668,3822,14668,11202,3466,2019-01-01,zipcode,Bradenton
ZCTA5 34210,12,16462,49662,1139,201500,14760,7674,12986,865,3901,4192,2481,1547,10928,7084,3844,7084,4209,2875,2019-01-01,zipcode,Bradenton
ZCTA5 34211,12,8898,109194,1698,383100,7746,3855,7032,224,1453,2149,2020,1186,5150,3730,1420,3730,3336,394,2019-01-01,zipcode,Bradenton
ZCTA5 34212,12,21244,96307,1634,355000,16847,6650,14961,277,3110,4919,4035,2620,8965,7549,1416,7549,6051,1498,2019-01-01,zipcode,Bradenton
ZCTA5 34215,12,596,48015,-666666666,900000,579,381,522,0,118,177,100,127,556,271,285,271,228,43,2019-01-01,zipcode,Cortez
ZCTA5 34216,12,724,74000,-666666666,888000,686,443,672,30,138,188,168,148,1360,384,976,384,356,28,2019-01-01,zipcode,Anna maria
ZCTA5 34217,12,5079,68029,1304,590000,4772,2751,4626,111,774,1578,1176,987,6624,2743,3881,2743,2077,666,2019-01-01,zipcode,Bradenton beach
ZCTA5 34219,12,24750,83831,1758,277300,20263,8298,18249,823,4862,6431,4285,1848,10093,8617,1476,8617,7652,965,2019-01-01,zipcode,Parrish
ZCTA5 34221,12,46357,57983,1108,169600,38096,17945,33707,4263,11878,10197,4627,2742,20236,15269,4967,15269,11972,3297,2019-01-01,zipcode,Palmetto
ZCTA5 34222,12,11659,54718,989,101700,10223,5710,9381,639,3096,3810,1231,605,7415,5236,2179,5236,4205,1031,2019-01-01,zipcode,Ellenton
ZCTA5 34223,12,18336,54586,1041,235700,17123,11826,16545,726,6139,4788,2766,2126,13848,9209,4639,9209,7520,1689,2019-01-01,zipcode,Englewood
ZCTA5 34224,12,16422,45210,979,163100,15112,8759,13755,1235,5546,3970,1698,1306,10929,7441,3488,7441,5812,1629,2019-01-01,zipcode,Englewood
ZCTA5 34228,12,7283,114762,1625,740500,7183,5655,7065,230,804,1477,2284,2270,9338,3838,5500,3838,3607,231,2019-01-01,zipcode,Longboat key
ZCTA5 34229,12,7674,87039,1211,449500,6707,3920,6352,244,1116,1322,1760,1910,4364,3377,987,3377,2833,544,2019-01-01,zipcode,Osprey
ZCTA5 34231,12,30341,53332,1182,255300,26482,11683,24494,1778,6596,7485,5147,3488,18415,14505,3910,14505,9141,5364,2019-01-01,zipcode,Sarasota
ZCTA5 34232,12,35240,67146,1403,223100,29859,10496,26868,2171,9818,7401,5014,2464,15432,13767,1665,13767,9659,4108,2019-01-01,zipcode,Sarasota
ZCTA5 34233,12,17767,65738,1472,258300,15099,6705,13774,1006,4133,3665,3193,1777,9176,7891,1285,7891,5832,2059,2019-01-01,zipcode,Sarasota
ZCTA5 34234,12,21932,38243,1015,139300,18134,8452,15541,2506,5561,3914,2226,1334,10372,8784,1588,8784,4692,4092,2019-01-01,zipcode,Sarasota
ZCTA5 34235,12,15303,58740,1395,234500,13494,6705,12038,705,3233,3506,2579,2015,8320,6661,1659,6661,5008,1653,2019-01-01,zipcode,Sarasota
ZCTA5 34236,12,13217,69331,1176,685100,12414,7431,12025,870,1569,3028,3323,3235,11244,7251,3993,7251,4418,2833,2019-01-01,zipcode,Sarasota
ZCTA5 34237,12,18071,47756,1152,148600,15451,5625,13674,2096,4432,3844,2290,1012,8621,6916,1705,6916,3461,3455,2019-01-01,zipcode,Sarasota
ZCTA5 34238,12,20049,76465,1632,366600,18401,10903,17308,333,3423,4223,4467,4862,12922,10091,2831,10091,7895,2196,2019-01-01,zipcode,Sarasota
ZCTA5 34239,12,15716,60733,1355,279600,13621,5140,12326,978,2850,3655,3063,1780,8438,6869,1569,6869,4897,1972,2019-01-01,zipcode,Sarasota
ZCTA5 34240,12,11442,92000,1469,393500,9312,4320,8268,373,1886,2187,2066,1756,5657,3946,1711,3946,3740,206,2019-01-01,zipcode,Sarasota
ZCTA5 34241,12,15568,83316,1727,363900,13118,6098,11935,430,2929,3543,3067,1966,6701,5963,738,5963,5125,838,2019-01-01,zipcode,Sarasota
ZCTA5 34242,12,7465,111190,1713,719700,6946,4160,6560,197,748,1649,2134,1832,10950,3852,7098,3852,3288,564,2019-01-01,zipcode,Sarasota
ZCTA5 34243,12,31901,64847,1559,275000,28018,13599,25222,1471,5882,7337,6213,4319,15856,13292,2564,13292,10226,3066,2019-01-01,zipcode,Sarasota
ZCTA5 34251,12,7115,72500,895,352200,5509,1803,4716,531,2060,1313,543,269,2292,2028,264,2028,1890,138,2019-01-01,zipcode,Myakka city
ZCTA5 34266,12,32229,34078,688,83500,26273,13435,22474,6523,10063,3746,1520,622,12238,9972,2266,9972,6673,3299,2019-01-01,zipcode,Arcadia
ZCTA5 34268,12,157,-666666666,-666666666,-666666666,128,128,128,80,48,0,0,0,173,88,85,88,40,48,2019-01-01,zipcode,Nocatee
ZCTA5 34269,12,4517,43393,802,149900,4128,2716,3832,390,1475,1060,633,274,2778,2012,766,2012,1705,307,2019-01-01,zipcode,Arcadia
ZCTA5 34275,12,20472,65713,1153,304900,18185,10020,16396,763,5053,4647,3464,2469,11520,9339,2181,9339,7692,1647,2019-01-01,zipcode,Nokomis
ZCTA5 34285,12,18653,54890,1231,222400,18030,12409,17021,639,5128,4760,3779,2715,15483,9900,5583,9900,7650,2250,2019-01-01,zipcode,Venice
ZCTA5 34286,12,20178,63743,1538,184500,15742,7017,13523,1790,4748,4256,1922,807,7192,6494,698,6494,5593,901,2019-01-01,zipcode,North port
ZCTA5 34287,12,28614,51017,1118,148900,24537,13965,22474,1978,8900,7201,2799,1596,14788,11278,3510,11278,8377,2901,2019-01-01,zipcode,North port
ZCTA5 34288,12,11511,62469,1314,196900,9472,4246,8255,700,2892,2987,995,681,4835,4239,596,4239,3518,721,2019-01-01,zipcode,North port
ZCTA5 34289,12,3481,59471,1240,193500,2847,844,2265,38,310,1066,457,394,2042,1337,705,1337,515,822,2019-01-01,zipcode,North port
ZCTA5 34291,12,5626,63287,1423,199100,4647,1936,4196,341,1833,1369,460,193,1893,1893,0,1893,1580,313,2019-01-01,zipcode,North port
ZCTA5 34292,12,15398,65991,1723,315300,14209,9963,13558,612,3379,3860,3421,2286,9869,7789,2080,7789,6238,1551,2019-01-01,zipcode,Venice
ZCTA5 34293,12,39534,63063,1331,242100,35607,20058,33362,1575,9696,10254,7217,4620,23222,18096,5126,18096,15606,2490,2019-01-01,zipcode,Venice
ZCTA5 34420,12,17749,46435,841,109700,14584,5792,12843,1865,5181,4398,1023,376,8166,6755,1411,6755,4729,2026,2019-01-01,zipcode,Belleview
ZCTA5 34428,12,9043,42096,696,132600,7823,4007,6977,908,2546,2536,688,299,5059,3993,1066,3993,2975,1018,2019-01-01,zipcode,Crystal river
ZCTA5 34429,12,8338,44958,962,126500,7422,4328,6693,624,2275,2222,806,766,5010,3835,1175,3835,3225,610,2019-01-01,zipcode,Crystal river
ZCTA5 34431,12,8002,39812,790,119600,6752,3803,6204,700,2615,1921,613,355,4344,3561,783,3561,2907,654,2019-01-01,zipcode,Dunnellon
ZCTA5 34432,12,12673,44577,889,139900,11035,7019,10402,1337,3666,3245,1463,691,6642,5542,1100,5542,4790,752,2019-01-01,zipcode,Dunnellon
ZCTA5 34433,12,6574,53989,907,134400,5622,2956,5158,871,2053,1416,560,258,3424,2829,595,2829,2499,330,2019-01-01,zipcode,Dunnellon
ZCTA5 34434,12,8021,46250,1103,140800,6378,3061,5959,610,2412,2043,694,200,4012,3111,901,3111,2492,619,2019-01-01,zipcode,Dunnellon
ZCTA5 34436,12,8169,36875,706,104500,7134,4031,6293,1078,2497,1915,361,442,4543,3572,971,3572,2945,627,2019-01-01,zipcode,Floral city
ZCTA5 34442,12,14752,50009,821,163500,13395,8856,12385,987,4279,3687,1783,1649,8847,6831,2016,6831,5984,847,2019-01-01,zipcode,Hernando
ZCTA5 34445,12,0,-666666666,-666666666,-666666666,0,0,0,0,0,0,0,0,0,0,0,0,0,0,2019-01-01,zipcode,Holder
ZCTA5 34446,12,17454,48084,884,146000,15437,10588,14343,1358,4989,4913,2009,1074,9338,7975,1363,7975,7060,915,2019-01-01,zipcode,Homosassa
ZCTA5 34448,12,10394,44717,871,90500,8984,5307,8374,839,3392,3009,893,241,6448,4723,1725,4723,3778,945,2019-01-01,zipcode,Homosassa
ZCTA5 34449,12,3192,28333,491,81400,2906,1553,2720,440,1203,814,189,74,1858,1416,442,1416,1020,396,2019-01-01,zipcode,Inglis
ZCTA5 34450,12,10692,38406,761,119800,9298,5453,8447,947,2830,3001,981,688,6371,5059,1312,5059,3700,1359,2019-01-01,zipcode,Inverness
ZCTA5 34452,12,11903,44789,892,114000,10151,5540,9033,1004,3524,3236,880,389,5790,4852,938,4852,4018,834,2019-01-01,zipcode,Inverness
ZCTA5 34453,12,10621,39055,858,102100,8880,5115,8248,1696,3036,2378,816,322,5546,4337,1209,4337,3428,909,2019-01-01,zipcode,Inverness
ZCTA5 34461,12,11380,46939,797,182500,10445,7087,9366,1054,3872,2563,1197,680,5942,4469,1473,4469,3542,927,2019-01-01,zipcode,Lecanto
ZCTA5 34465,12,17455,40101,859,159000,14988,9255,13897,1411,5153,4915,1438,980,9072,7948,1124,7948,6392,1556,2019-01-01,zipcode,Beverly hills
ZCTA5 34470,12,19794,39101,867,108500,15827,7051,13747,1690,4976,4793,1637,651,9223,7721,1502,7721,4285,3436,2019-01-01,zipcode,Ocala
ZCTA5 34471,12,25734,50405,927,195500,20865,8329,17419,1327,5354,5178,3150,2410,11723,10038,1685,10038,6137,3901,2019-01-01,zipcode,Ocala
ZCTA5 34472,12,31344,44925,968,116200,24293,10455,20363,2817,7659,6530,2234,1123,12116,10503,1613,10503,7412,3091,2019-01-01,zipcode,Ocala
ZCTA5 34473,12,19998,56113,1068,157000,16404,7420,14513,1580,5781,4635,1953,564,7868,6729,1139,6729,5351,1378,2019-01-01,zipcode,Ocala
ZCTA5 34474,12,17143,44639,1057,133000,13936,6110,12528,1344,3804,3867,2232,1281,8191,7042,1149,7042,3263,3779,2019-01-01,zipcode,Ocala
ZCTA5 34475,12,13179,25893,728,90400,10408,6387,9032,2271,3499,2060,873,329,5128,4446,682,4446,2130,2316,2019-01-01,zipcode,Ocala
ZCTA5 34476,12,23279,52888,989,154200,19747,11610,18464,1461,5844,6409,2807,1943,11610,10047,1563,10047,8934,1113,2019-01-01,zipcode,Ocala
ZCTA5 34479,12,13603,46354,872,104900,10870,4757,9596,1131,3881,2853,1260,471,5747,5068,679,5068,3468,1600,2019-01-01,zipcode,Ocala
ZCTA5 34480,12,19188,55431,845,164100,15689,6299,13296,1365,4720,3906,1816,1489,8067,6826,1241,6826,4941,1885,2019-01-01,zipcode,Ocala
ZCTA5 34481,12,20963,44754,968,123900,19514,14570,18487,1456,6109,5977,3363,1582,12035,10473,1562,10473,9491,982,2019-01-01,zipcode,Ocala
ZCTA5 34482,12,24352,44282,781,151400,21036,13101,18939,3825,7300,4903,2143,768,9243,7332,1911,7332,5580,1752,2019-01-01,zipcode,Ocala
ZCTA5 34484,12,3637,47195,959,232500,2984,1377,2742,251,970,833,415,273,1852,1504,348,1504,1043,461,2019-01-01,zipcode,Oxford
ZCTA5 34488,12,10424,38429,825,58100,8349,4663,7449,1178,3146,2171,813,141,5612,4162,1450,4162,3153,1009,2019-01-01,zipcode,Silver springs
ZCTA5 34491,12,26614,45945,883,168400,23262,15199,22092,2151,8669,7139,2582,1551,15015,12236,2779,12236,10728,1508,2019-01-01,zipcode,Summerfield
ZCTA5 34498,12,585,41094,1018,164400,453,273,428,44,152,139,70,23,528,272,256,272,207,65,2019-01-01,zipcode,Yankeetown
ZCTA5 34601,12,22487,38389,779,94400,19024,10612,17158,2619,5802,5223,2361,1153,11982,10017,1965,10017,6940,3077,2019-01-01,zipcode,Brooksville
ZCTA5 34602,12,7697,55915,937,152100,6413,3248,5757,990,2127,1519,653,468,2910,2735,175,2735,2306,429,2019-01-01,zipcode,Brooksville
ZCTA5 34604,12,12608,60278,941,155100,10249,5036,9019,1098,3486,2865,1065,505,4552,4104,448,4104,3464,640,2019-01-01,zipcode,Brooksville
ZCTA5 34606,12,27209,42769,955,132100,22849,13088,20603,2179,7555,6764,2775,1330,13798,11749,2049,11749,8897,2852,2019-01-01,zipcode,Spring hill
ZCTA5 34607,12,8403,48779,1053,214800,7555,4489,6730,675,2022,2504,1054,475,5003,3810,1193,3810,3179,631,2019-01-01,zipcode,Spring hill
ZCTA5 34608,12,34802,49529,1051,136000,28675,14069,25211,3168,9064,9085,2616,1278,14800,13479,1321,13479,9790,3689,2019-01-01,zipcode,Spring hill
ZCTA5 34609,12,42227,57257,1147,167800,34238,16456,30300,2977,9888,11337,3997,2101,17459,15884,1575,15884,12483,3401,2019-01-01,zipcode,Spring hill
ZCTA5 34610,12,14698,54469,1004,158000,12193,5655,10483,1878,3742,3263,1142,458,5713,5017,696,5017,3963,1054,2019-01-01,zipcode,Spring hill
ZCTA5 34613,12,17924,44375,947,101200,16020,10292,15144,2003,5579,5128,1605,829,10381,8511,1870,8511,7302,1209,2019-01-01,zipcode,Brooksville
ZCTA5 34614,12,7195,57451,1158,160700,5970,2723,5176,718,1737,1917,436,368,2961,2628,333,2628,2495,133,2019-01-01,zipcode,Brooksville
ZCTA5 34637,12,8411,81981,-666666666,236300,7054,4743,6273,774,1597,1848,1215,839,2607,2174,433,2174,1916,258,2019-01-01,zipcode,Land o lakes
ZCTA5 34638,12,28609,91543,1506,259900,20442,6194,17817,1081,3948,5676,5023,2089,9720,9117,603,9117,7376,1741,2019-01-01,zipcode,Land o lakes
ZCTA5 34639,12,29395,88694,1348,250500,23357,7643,20307,1281,4771,6405,5345,2505,10528,10030,498,10030,8227,1803,2019-01-01,zipcode,Land o lakes
ZCTA5 34652,12,23688,39309,926,109800,20459,10433,18348,2206,6938,6306,1944,954,14554,10721,3833,10721,6334,4387,2019-01-01,zipcode,New port richey
ZCTA5 34653,12,34588,41145,1013,105400,28808,14183,25658,2887,9990,8673,2816,1292,17515,14829,2686,14829,9030,5799,2019-01-01,zipcode,New port richey
ZCTA5 34654,12,22935,48000,1032,162000,19406,10231,17499,2230,6383,5814,1966,1106,10453,8880,1573,8880,6860,2020,2019-01-01,zipcode,New port richey
ZCTA5 34655,12,41872,65239,1240,229400,34703,15862,31450,2053,9198,10561,6246,3392,19938,17114,2824,17114,13536,3578,2019-01-01,zipcode,New port richey
ZCTA5 34661,12,104,-666666666,-666666666,159900,104,52,104,0,81,9,14,0,80,52,28,52,52,0,2019-01-01,zipcode,Nobleton
ZCTA5 34667,12,33272,43958,934,138800,29397,17532,27337,2738,10451,8883,3335,1930,19698,15529,4169,15529,11260,4269,2019-01-01,zipcode,Hudson
ZCTA5 34668,12,48146,38087,983,94700,39831,18963,34749,4523,14123,11553,3086,1464,22892,19709,3183,19709,12170,7539,2019-01-01,zipcode,Port richey
ZCTA5 34669,12,13304,49196,1022,152000,11002,5253,9622,922,4056,3161,1040,443,5845,5186,659,5186,4145,1041,2019-01-01,zipcode,Hudson
ZCTA5 34677,12,22169,63385,1158,243500,18401,7142,15945,980,4131,4777,3968,2089,10062,8729,1333,8729,6279,2450,2019-01-01,zipcode,Oldsmar
ZCTA5 34679,12,43,-666666666,-666666666,-666666666,43,37,43,0,38,5,0,0,51,33,18,33,16,17,2019-01-01,zipcode,Aripeka
ZCTA5 34681,12,730,55198,-666666666,384800,629,367,562,32,49,97,323,61,452,334,118,334,334,0,2019-01-01,zipcode,Crystal beach
ZCTA5 34683,12,33514,66513,1234,275400,28323,11531,25220,1506,5813,8621,6100,3180,15663,13358,2305,13358,10122,3236,2019-01-01,zipcode,Palm harbor
ZCTA5 34684,12,29088,54340,1344,192600,25627,11846,22958,1207,6433,8176,4932,2210,14623,12958,1665,12958,8897,4061,2019-01-01,zipcode,Palm harbor
ZCTA5 34685,12,17998,82782,1337,354600,15141,6415,13472,536,2876,3908,3725,2427,7765,7025,740,7025,5316,1709,2019-01-01,zipcode,Palm harbor
ZCTA5 34688,12,7443,84338,1603,363400,6393,3162,5954,307,1200,1847,1617,983,3608,3096,512,3096,2666,430,2019-01-01,zipcode,Tarpon springs
ZCTA5 34689,12,27445,48890,858,206000,23487,11516,20955,2175,6505,6839,3304,2132,13511,10814,2697,10814,7801,3013,2019-01-01,zipcode,Tarpon springs
ZCTA5 34690,12,11408,37081,1034,76500,9954,4954,8844,1057,4094,2627,801,265,6786,5387,1399,5387,3411,1976,2019-01-01,zipcode,Holiday
ZCTA5 34691,12,20257,39619,1039,89800,16789,7952,15201,1391,6935,4581,1704,590,11959,8725,3234,8725,5699,3026,2019-01-01,zipcode,Holiday
ZCTA5 34695,12,18382,76988,1301,263800,15305,5800,13876,629,3666,3948,3821,1812,8301,7374,927,7374,6091,1283,2019-01-01,zipcode,Safety harbor
ZCTA5 34698,12,38720,49541,1081,199000,34437,16710,31918,2469,9327,9772,6744,3606,21624,18136,3488,18136,12420,5716,2019-01-01,zipcode,Dunedin
ZCTA5 34705,12,2860,59000,903,115900,2179,780,1868,339,756,623,130,20,1153,964,189,964,766,198,2019-01-01,zipcode,Astatula
ZCTA5 34711,12,61594,72159,1408,237300,50255,20649,44475,3576,11348,15742,9009,4800,24566,21883,2683,21883,17117,4766,2019-01-01,zipcode,Clermont
ZCTA5 34714,12,22380,53472,1241,193100,17825,5852,15003,840,4257,5337,3536,1033,10047,7830,2217,7830,3817,4013,2019-01-01,zipcode,Clermont
ZCTA5 34715,12,18241,68504,1485,253800,14571,5773,12431,1054,3591,4502,2355,929,6238,5648,590,5648,3965,1683,2019-01-01,zipcode,Clermont
ZCTA5 34731,12,14858,49824,944,177700,12802,6520,11885,1046,3977,4028,1664,1170,7508,6452,1056,6452,5214,1238,2019-01-01,zipcode,Fruitland park
ZCTA5 34734,12,4591,67356,1355,304000,3359,1370,2878,252,830,835,658,303,1414,1414,0,1414,1199,215,2019-01-01,zipcode,Gotha
ZCTA5 34736,12,19271,62258,1208,198500,15104,6252,13422,2151,3844,4414,2053,960,6835,6324,511,6324,5091,1233,2019-01-01,zipcode,Groveland
ZCTA5 34737,12,2942,75341,1338,244400,2428,1010,2190,198,681,633,406,272,1410,1133,277,1133,915,218,2019-01-01,zipcode,Howey in the hills
ZCTA5 34739,12,243,-666666666,-666666666,95400,195,97,195,61,43,52,39,0,487,150,337,150,125,25,2019-01-01,zipcode,Kenansville
ZCTA5 34741,12,47710,38071,1126,162300,36380,12456,31152,4865,9647,10948,4052,1640,20833,15729,5104,15729,4580,11149,2019-01-01,zipcode,Kissimmee
ZCTA5 34743,12,45109,47909,1294,179200,36932,13582,30463,4827,10473,10221,3531,1411,13517,12099,1418,12099,8116,3983,2019-01-01,zipcode,Kissimmee
ZCTA5 34744,12,57134,52191,1203,219500,44814,16570,37547,5040,11032,12457,6441,2577,19070,16163,2907,16163,10005,6158,2019-01-01,zipcode,Kissimmee
ZCTA5 34746,12,44307,56160,1412,201800,35586,12762,30369,4229,8656,9908,5200,2376,22631,13137,9494,13137,8681,4456,2019-01-01,zipcode,Kissimmee
ZCTA5 34747,12,21354,66747,1505,325500,17722,5351,14876,416,3067,4257,4395,2741,25150,8024,17126,8024,3708,4316,2019-01-01,zipcode,Kissimmee
ZCTA5 34748,12,39977,45059,911,156900,34452,21428,31578,3538,11682,10039,3856,2463,21359,17890,3469,17890,12883,5007,2019-01-01,zipcode,Leesburg
ZCTA5 34753,12,5932,42956,897,155900,4510,1822,3735,749,1648,1128,113,97,1797,1709,88,1709,1341,368,2019-01-01,zipcode,Mascotte
ZCTA5 34756,12,3505,75071,1125,287400,2826,1094,2363,184,516,999,436,228,1343,1208,135,1208,993,215,2019-01-01,zipcode,Montverde
ZCTA5 34758,12,43143,53510,1243,172400,33376,12446,27136,4012,10709,8375,2615,1425,13648,10680,2968,10680,7276,3404,2019-01-01,zipcode,Kissimmee
ZCTA5 34759,12,40713,50748,1291,184000,31133,15888,26630,4438,7454,8597,3846,2295,15369,11982,3387,11982,8878,3104,2019-01-01,zipcode,Kissimmee
ZCTA5 34760,12,863,64018,1563,215100,688,139,619,46,159,326,78,10,342,299,43,299,225,74,2019-01-01,zipcode,Oakland
ZCTA5 34761,12,45864,68152,1363,237100,34911,10313,30017,4429,6685,8852,6924,3127,15603,14645,958,14645,9898,4747,2019-01-01,zipcode,Ocoee
ZCTA5 34762,12,544,61083,-666666666,-666666666,528,310,507,136,221,107,27,16,294,249,45,249,249,0,2019-01-01,zipcode,Okahumpka
ZCTA5 34769,12,24995,46033,1015,156600,19380,7949,16762,2557,6259,5553,1743,650,10442,8092,2350,8092,5230,2862,2019-01-01,zipcode,Saint cloud
ZCTA5 34771,12,21052,76624,1144,297800,16883,7181,13990,1171,4125,4904,2652,1138,7537,6171,1366,6171,5555,616,2019-01-01,zipcode,Saint cloud
ZCTA5 34772,12,31436,68343,1372,223500,23631,8234,20632,1902,6104,8295,3094,1237,10762,8953,1809,8953,7679,1274,2019-01-01,zipcode,Saint cloud
ZCTA5 34773,12,3728,63515,1527,209600,2515,1189,2062,301,449,635,438,239,1559,1023,536,1023,760,263,2019-01-01,zipcode,Saint cloud
ZCTA5 34785,12,38097,61341,929,296800,36666,28924,35414,3235,10958,10167,6102,4952,18647,15270,3377,15270,13649,1621,2019-01-01,zipcode,Wildwood
ZCTA5 34786,12,45836,105075,1814,450700,33758,10463,29769,847,3073,7731,11758,6360,16475,14778,1697,14778,10595,4183,2019-01-01,zipcode,Windermere
ZCTA5 34787,12,69976,81711,1236,321200,53842,16597,46921,4533,10220,12711,11825,7632,26087,23543,2544,23543,17221,6322,2019-01-01,zipcode,Winter garden
ZCTA5 34788,12,18193,44404,1037,90800,16100,9339,15134,1674,5712,4987,1844,917,9943,8324,1619,8324,6927,1397,2019-01-01,zipcode,Leesburg
ZCTA5 34797,12,1041,77167,-666666666,197100,952,517,904,0,322,433,67,82,622,418,204,418,404,14,2019-01-01,zipcode,Yalaha
ZCTA5 34945,12,5187,50880,1006,178500,4450,2737,3830,875,1080,1159,490,226,1848,1432,416,1432,1217,215,2019-01-01,zipcode,Fort pierce
ZCTA5 34946,12,6079,39361,808,88300,5347,2501,4537,739,1580,1611,455,152,3041,2397,644,2397,1684,713,2019-01-01,zipcode,Fort pierce
ZCTA5 34947,12,14155,34055,998,110100,10250,3916,8440,1988,3603,1862,664,323,5041,4294,747,4294,1574,2720,2019-01-01,zipcode,Fort pierce
ZCTA5 34949,12,7663,64736,1162,280200,7444,5076,7266,302,1668,2140,1750,1406,7944,4254,3690,4254,3312,942,2019-01-01,zipcode,Fort pierce
ZCTA5 34950,12,16603,30150,827,100900,13122,5500,11078,3248,3723,2996,867,244,7195,5867,1328,5867,2187,3680,2019-01-01,zipcode,Fort pierce
ZCTA5 34951,12,17106,43850,972,114100,15122,7981,13343,2073,4789,4184,1569,728,8854,7073,1781,7073,5898,1175,2019-01-01,zipcode,Fort pierce
ZCTA5 34952,12,41567,47770,1242,146700,35792,16406,32427,3083,11972,11645,3936,1791,21258,17026,4232,17026,11517,5509,2019-01-01,zipcode,Port saint lucie
ZCTA5 34953,12,70705,62696,1449,211700,55059,18265,46344,6782,14892,14892,6638,3140,23888,21839,2049,21839,17866,3973,2019-01-01,zipcode,Port saint lucie
ZCTA5 34956,12,10258,39661,818,91900,8048,4365,6729,2406,2284,1517,356,166,2771,2298,473,2298,1496,802,2019-01-01,zipcode,Indiantown
ZCTA5 34957,12,23204,55206,1107,257900,20739,11367,19165,1303,5365,5975,4117,2405,17874,11013,6861,11013,8139,2874,2019-01-01,zipcode,Jensen beach
ZCTA5 34972,12,20877,39875,748,105700,16528,8634,14238,4178,5438,3109,1128,385,7329,5757,1572,5757,3748,2009,2019-01-01,zipcode,Okeechobee
ZCTA5 34974,12,23952,42500,786,105900,20249,10682,17886,2837,7195,5714,1544,596,13881,9784,4097,9784,7673,2111,2019-01-01,zipcode,Okeechobee
ZCTA5 34981,12,5393,51159,1018,232900,4576,1763,3990,419,1792,1007,422,350,2070,1754,316,1754,1067,687,2019-01-01,zipcode,Fort pierce
ZCTA5 34982,12,25135,40436,1055,115600,20548,9378,18109,3140,6677,5525,1871,896,11456,10000,1456,10000,7109,2891,2019-01-01,zipcode,Fort pierce
ZCTA5 34983,12,42818,54579,1434,176600,35176,14836,30389,3850,10922,10174,3326,2117,15299,13908,1391,13908,10486,3422,2019-01-01,zipcode,Port saint lucie
ZCTA5 34984,12,16035,69556,1429,198800,13110,4791,11529,1318,3422,4363,1766,660,6338,5563,775,5563,4673,890,2019-01-01,zipcode,Port saint lucie
ZCTA5 34986,12,28265,62719,1562,262100,23432,14565,22217,2464,5595,6161,4632,3365,13924,11838,2086,11838,9440,2398,2019-01-01,zipcode,Port saint lucie
ZCTA5 34987,12,9717,72007,1813,276400,7878,4439,7451,480,2004,2199,1809,959,4353,3725,628,3725,2757,968,2019-01-01,zipcode,Port saint lucie
ZCTA5 34990,12,29999,86444,1585,367300,25397,12106,22601,1158,3809,7616,6582,3436,13715,11806,1909,11806,10290,1516,2019-01-01,zipcode,Palm city
ZCTA5 34994,12,17800,48085,1125,186100,14759,7264,13190,1094,3532,4639,2344,1581,9489,7438,2051,7438,4568,2870,2019-01-01,zipcode,Stuart
ZCTA5 34996,12,10741,69227,1089,284900,9826,5995,9369,442,1903,3029,2123,1872,8671,5468,3203,5468,4580,888,2019-01-01,zipcode,Stuart
ZCTA5 34997,12,44632,58789,1121,253500,37992,17298,34442,3436,9745,11425,6379,3457,21168,17875,3293,17875,14071,3804,2019-01-01,zipcode,Stuart
ZCTA5 35004,01,12045,62902,886,158900,9226,2899,8212,435,2909,3322,1144,402,4716,4624,92,4624,3733,891,2019-01-01,zipcode,Moody
ZCTA5 35005,01,7344,50473,859,97200,5784,2757,5163,849,1939,1641,589,145,3254,2697,557,2697,2057,640,2019-01-01,zipcode,Adamsville
ZCTA5 35006,01,2883,55909,788,104300,2331,1170,2046,327,959,578,108,74,1519,1018,501,1018,919,99,2019-01-01,zipcode,Adger
ZCTA5 35007,01,26332,73587,1036,168200,20097,7044,17429,1929,4390,5780,3482,1848,9891,9292,599,9292,7639,1653,2019-01-01,zipcode,Alabaster
ZCTA5 35010,01,20613,41954,659,99900,16590,8101,14553,2940,4658,4473,1532,950,10202,7987,2215,7987,5669,2318,2019-01-01,zipcode,Alexander city
ZCTA5 35013,01,46,-666666666,-666666666,-666666666,46,46,46,46,0,0,0,0,23,17,6,17,9,8,2019-01-01,zipcode,Allgood
ZCTA5 35014,01,4963,47691,968,88500,4307,2498,3601,885,1283,1046,202,185,1870,1655,215,1655,1477,178,2019-01-01,zipcode,Alpine
ZCTA5 35016,01,17208,46157,591,138400,13573,6317,11768,1428,3475,4437,1604,824,7388,6496,892,6496,4761,1735,2019-01-01,zipcode,Arab
ZCTA5 35019,01,2492,38080,638,136100,2056,1053,1702,259,635,579,201,28,1048,907,141,907,750,157,2019-01-01,zipcode,Baileyton
ZCTA5 35020,01,25757,29133,732,68800,20827,9377,17711,3428,6797,5395,1598,493,13206,10088,3118,10088,5066,5022,2019-01-01,zipcode,Bessemer
ZCTA5 35022,01,21587,61516,869,181500,18212,6284,15570,1315,4514,4825,3073,1843,9378,8580,798,8580,6921,1659,2019-01-01,zipcode,Bessemer
ZCTA5 35023,01,23523,54614,879,117900,18789,8493,16164,1967,6191,5313,1739,954,9362,8357,1005,8357,6143,2214,2019-01-01,zipcode,Bessemer
ZCTA5 35031,01,7779,47674,590,133600,6467,3535,5384,1187,1692,1774,432,299,3612,2806,806,2806,1993,813,2019-01-01,zipcode,Blountsville
ZCTA5 35032,01,44,29750,-666666666,77500,35,19,32,3,18,7,0,4,23,15,8,15,13,2,2019-01-01,zipcode,Bon air
ZCTA5 35033,01,2946,50682,628,121300,2332,1181,2001,456,592,693,143,117,1508,1130,378,1130,969,161,2019-01-01,zipcode,Bremen
ZCTA5 35034,01,6416,39087,770,46800,5272,3345,4496,1451,1791,827,300,127,1592,1197,395,1197,830,367,2019-01-01,zipcode,Brent
ZCTA5 35035,01,821,42167,-666666666,89300,797,388,731,61,381,146,106,37,596,334,262,334,321,13,2019-01-01,zipcode,Brierfield
ZCTA5 35036,01,204,16591,293,83800,141,63,117,33,66,11,7,0,131,88,43,88,26,62,2019-01-01,zipcode,Brookside
ZCTA5 35040,01,17311,62508,1059,148700,12809,4017,10934,931,3019,3973,2139,872,6827,6185,642,6185,5057,1128,2019-01-01,zipcode,Calera
ZCTA5 35042,01,6078,52550,394,115700,5072,2259,4550,632,2056,1224,306,332,2869,2330,539,2330,1808,522,2019-01-01,zipcode,Centreville
ZCTA5 35043,01,12153,100864,1257,238600,8802,2583,7835,224,1418,3006,2129,1058,4233,4002,231,4002,3808,194,2019-01-01,zipcode,Chelsea
ZCTA5 35044,01,7409,38152,501,97600,5845,2298,5073,1020,2047,1613,277,116,3551,3091,460,3091,1834,1257,2019-01-01,zipcode,Childersburg
ZCTA5 35045,01,15143,45853,697,127700,12218,5498,10611,1848,4539,2677,965,582,6765,5915,850,5915,4126,1789,2019-01-01,zipcode,Clanton
ZCTA5 35046,01,5017,52031,768,127100,3893,1889,3416,546,1418,895,370,187,2865,2060,805,2060,1573,487,2019-01-01,zipcode,Clanton
ZCTA5 35049,01,3856,47212,623,117500,3034,1195,2593,535,956,826,172,104,1659,1376,283,1376,1089,287,2019-01-01,zipcode,Cleveland
ZCTA5 35051,01,9838,51782,635,156000,8017,3995,6966,1125,2574,1575,1211,481,3860,3452,408,3452,2693,759,2019-01-01,zipcode,Columbiana
ZCTA5 35052,01,283,-666666666,-666666666,-666666666,283,217,283,71,96,92,24,0,23,23,0,23,0,23,2019-01-01,zipcode,Cook springs
ZCTA5 35053,01,2398,54537,825,165600,2013,1079,1850,306,557,540,308,139,2791,892,1899,892,834,58,2019-01-01,zipcode,Crane hill
ZCTA5 35054,01,4318,46441,750,162600,3746,2047,3278,681,1210,824,373,190,2407,1931,476,1931,1762,169,2019-01-01,zipcode,Cropwell
ZCTA5 35055,01,21153,46953,681,130900,16629,6934,14054,2351,4263,4719,1800,921,8725,7838,887,7838,4887,2951,2019-01-01,zipcode,Cullman
ZCTA5 35057,01,14187,49786,751,146300,11096,4411,9726,1682,3444,3390,707,503,6414,4977,1437,4977,4079,898,2019-01-01,zipcode,Cullman
ZCTA5 35058,01,8630,43188,756,133900,7097,3337,6441,1186,2156,2154,639,306,4025,3446,579,3446,2615,831,2019-01-01,zipcode,Cullman
ZCTA5 35060,01,272,23889,-666666666,-666666666,208,137,172,34,88,23,0,27,243,132,111,132,108,24,2019-01-01,zipcode,Docena
ZCTA5 35061,01,1130,44375,980,89500,939,309,795,125,135,438,86,11,575,417,158,417,218,199,2019-01-01,zipcode,Dolomite
ZCTA5 35062,01,7904,52741,755,125000,6263,2765,5495,977,1825,1713,636,344,3415,3049,366,3049,2575,474,2019-01-01,zipcode,Dora
ZCTA5 35063,01,3629,56538,790,81100,2905,1445,2527,494,906,1052,63,12,1752,1264,488,1264,1123,141,2019-01-01,zipcode,Empire
ZCTA5 35064,01,11048,40570,756,98400,9091,4163,7500,745,2728,2633,915,479,5698,4581,1117,4581,2535,2046,2019-01-01,zipcode,Fairfield
ZCTA5 35068,01,7967,62823,1001,153200,6523,2263,5662,682,1579,2042,914,445,3449,3379,70,3379,2341,1038,2019-01-01,zipcode,Fultondale
ZCTA5 35070,01,296,37708,563,103700,206,81,173,50,62,61,0,0,109,103,6,103,81,22,2019-01-01,zipcode,Garden city
ZCTA5 35071,01,16052,70963,933,172700,12877,5047,11120,726,3316,3973,1959,1146,6848,6328,520,6328,4979,1349,2019-01-01,zipcode,Gardendale
ZCTA5 35072,01,4410,37622,456,71400,3488,1728,3226,729,1399,791,149,158,2560,1700,860,1700,1339,361,2019-01-01,zipcode,Goodwater
ZCTA5 35073,01,2074,39826,842,91200,1725,872,1534,248,543,537,166,40,992,826,166,826,705,121,2019-01-01,zipcode,Graysville
ZCTA5 35074,01,99,-666666666,-666666666,-666666666,99,0,99,46,0,53,0,0,53,53,0,53,0,53,2019-01-01,zipcode,Green pond
ZCTA5 35077,01,13821,39490,647,115000,11511,5859,9732,2118,3266,3178,754,416,6179,5262,917,5262,3890,1372,2019-01-01,zipcode,Hanceville
ZCTA5 35078,01,1927,62557,1000,159500,1578,707,1399,310,454,443,121,71,927,733,194,733,607,126,2019-01-01,zipcode,Harpersville
ZCTA5 35079,01,9055,61837,833,139800,7174,3437,6352,655,2505,2383,553,256,3589,3058,531,3058,2896,162,2019-01-01,zipcode,Hayden
ZCTA5 35080,01,18471,88952,1331,188500,13790,3962,12001,481,2052,3845,4040,1583,6601,6374,227,6374,5869,505,2019-01-01,zipcode,Helena
ZCTA5 35082,01,0,-666666666,-666666666,-666666666,0,0,0,0,0,0,0,0,0,0,0,0,0,0,2019-01-01,zipcode,Hollins
ZCTA5 35083,01,3191,35750,736,110100,2532,1379,2235,530,856,659,138,52,1430,1273,157,1273,967,306,2019-01-01,zipcode,Holly pond
ZCTA5 35085,01,8901,43542,741,92400,7169,3275,5788,1156,2683,1363,380,206,3624,3191,433,3191,2465,726,2019-01-01,zipcode,Jemison
ZCTA5 35087,01,2571,31789,738,115900,2112,1065,1840,437,564,736,52,51,1041,980,61,980,600,380,2019-01-01,zipcode,Joppa
ZCTA5 35089,01,1954,32402,625,95500,1758,933,1558,397,587,422,97,55,1000,803,197,803,653,150,2019-01-01,zipcode,Kellyton
ZCTA5 35091,01,3118,82500,896,193600,2237,698,1961,119,650,658,330,204,1174,1074,100,1074,984,90,2019-01-01,zipcode,Kimberly
ZCTA5 35094,01,15059,60422,824,165000,11571,4346,10180,1050,2804,3415,1883,1028,6374,5646,728,5646,4533,1113,2019-01-01,zipcode,Leeds
ZCTA5 35096,01,8221,55766,858,114000,6908,2882,6063,1076,1966,2096,696,229,4210,3111,1099,3111,2528,583,2019-01-01,zipcode,Lincoln
ZCTA5 35097,01,1884,45950,919,118400,1473,839,1323,239,556,389,89,50,651,631,20,631,571,60,2019-01-01,zipcode,Locust fork
ZCTA5 35098,01,1091,31429,-666666666,88600,847,363,714,164,188,264,27,71,602,428,174,428,407,21,2019-01-01,zipcode,Logan
ZCTA5 35111,01,16325,71662,799,199300,13121,4683,11123,778,3338,3884,2177,946,6476,5765,711,5765,5225,540,2019-01-01,zipcode,Mc calla
ZCTA5 35112,01,281,-666666666,-666666666,-666666666,234,90,234,17,125,92,0,0,124,124,0,124,109,15,2019-01-01,zipcode,Margaret
ZCTA5 35114,01,8310,85183,1086,193600,6525,1965,5451,422,827,1743,1523,936,3148,2982,166,2982,2576,406,2019-01-01,zipcode,Alabaster
ZCTA5 35115,01,14988,42034,801,127600,12384,5018,9035,1359,3329,2388,1308,651,5978,5459,519,5459,3555,1904,2019-01-01,zipcode,Montevallo
ZCTA5 35116,01,4332,66414,880,167700,3499,1354,3068,200,995,1170,489,214,1831,1689,142,1689,1415,274,2019-01-01,zipcode,Morris
ZCTA5 35117,01,5478,71956,729,159000,4425,1530,3841,303,1046,1536,729,227,2258,2157,101,2157,1929,228,2019-01-01,zipcode,Mount olive
ZCTA5 35118,01,3467,62368,780,134700,2733,1263,2449,368,1034,764,185,98,1416,1192,224,1192,976,216,2019-01-01,zipcode,Mulga
ZCTA5 35119,01,282,-666666666,-666666666,-666666666,209,68,209,108,40,61,0,0,89,89,0,89,61,28,2019-01-01,zipcode,New castle
ZCTA5 35120,01,14424,67703,698,147900,11160,3843,9293,1318,3378,3213,934,450,5453,4824,629,4824,4017,807,2019-01-01,zipcode,Odenville
ZCTA5 35121,01,16123,44308,682,123300,12810,6696,11026,2941,3123,3494,921,547,6793,6014,779,6014,4027,1987,2019-01-01,zipcode,Oneonta
ZCTA5 35124,01,24387,79847,1115,193500,19672,6145,17357,1165,2987,5843,4714,2648,10206,9582,624,9582,8219,1363,2019-01-01,zipcode,Pelham
ZCTA5 35125,01,9931,46094,818,138100,8337,3668,7455,1679,2775,2123,613,265,4830,4095,735,4095,2595,1500,2019-01-01,zipcode,Pell city
ZCTA5 35126,01,20749,67823,914,149400,16906,6530,14135,1239,4900,5086,2108,802,8063,7562,501,7562,6395,1167,2019-01-01,zipcode,Pinson
ZCTA5 35127,01,9651,70526,1134,157400,8062,2982,6922,463,2096,2678,1001,684,3954,3610,344,3610,3118,492,2019-01-01,zipcode,Pleasant grove
ZCTA5 35128,01,10573,61354,863,172400,8592,3378,7532,1016,2292,2623,1170,431,5010,4294,716,4294,3136,1158,2019-01-01,zipcode,Pell city
ZCTA5 35130,01,2925,37977,469,85200,2436,1227,2145,555,928,538,56,68,1786,1291,495,1291,1040,251,2019-01-01,zipcode,Quinton
ZCTA5 35131,01,4696,40033,606,124700,3585,1783,3017,688,1256,672,220,181,1889,1503,386,1503,1104,399,2019-01-01,zipcode,Ragland
ZCTA5 35133,01,3222,50121,860,122500,2457,1292,2311,301,879,833,213,85,1466,1221,245,1221,1128,93,2019-01-01,zipcode,Remlap
ZCTA5 35135,01,2514,56422,923,190500,1874,556,1649,169,571,620,202,87,1026,894,132,894,576,318,2019-01-01,zipcode,Riverside
ZCTA5 35136,01,2197,41339,417,131000,1837,949,1577,203,540,579,199,56,1247,784,463,784,644,140,2019-01-01,zipcode,Rockford
ZCTA5 35139,01,161,15469,-666666666,16100,161,84,127,80,39,8,0,0,108,108,0,108,65,43,2019-01-01,zipcode,Sayre
ZCTA5 35143,01,2880,68355,542,155100,2441,1014,2290,286,811,783,332,78,2147,1199,948,1199,1139,60,2019-01-01,zipcode,Shelby
ZCTA5 35146,01,11175,80351,767,197800,9209,4546,8267,1314,2827,2447,1037,642,3756,3340,416,3340,3048,292,2019-01-01,zipcode,Springville
ZCTA5 35147,01,6022,74593,1350,193300,4587,1505,4049,433,849,1174,1135,458,2509,2198,311,2198,1960,238,2019-01-01,zipcode,Sterrett
ZCTA5 35148,01,2183,41424,531,105100,1768,848,1506,230,614,591,66,5,1136,907,229,907,595,312,2019-01-01,zipcode,Sumiton
ZCTA5 35149,01,251,41144,-666666666,105300,251,66,169,14,155,0,0,0,172,132,40,132,93,39,2019-01-01,zipcode,Sycamore
ZCTA5 35150,01,16991,31819,623,106300,13292,6484,11516,2302,3805,3804,1174,431,8379,6953,1426,6953,4310,2643,2019-01-01,zipcode,Sylacauga
ZCTA5 35151,01,7649,48820,811,110100,6350,3146,5681,1115,1832,1692,620,422,3780,2956,824,2956,2570,386,2019-01-01,zipcode,Sylacauga
ZCTA5 35160,01,25999,34210,563,92300,21498,11755,18235,3964,6389,5162,1632,1088,12396,9948,2448,9948,6627,3321,2019-01-01,zipcode,Talladega
ZCTA5 35171,01,3254,56410,776,106800,2674,1315,2341,556,901,492,288,104,1385,1242,143,1242,1056,186,2019-01-01,zipcode,Thorsby
ZCTA5 35172,01,3000,34052,684,83600,2511,1294,2300,441,931,736,156,36,1407,1240,167,1240,843,397,2019-01-01,zipcode,Trafford
ZCTA5 35173,01,27514,89923,1193,241000,20651,7376,18333,947,3800,6273,4682,2631,10050,9320,730,9320,8357,963,2019-01-01,zipcode,Trussville
ZCTA5 35175,01,5289,52938,648,141800,4285,1867,3780,704,1209,994,595,278,2478,2003,475,2003,1666,337,2019-01-01,zipcode,Union grove
ZCTA5 35176,01,784,-666666666,688,77000,657,329,545,248,161,63,37,36,358,341,17,341,201,140,2019-01-01,zipcode,Vandiver
ZCTA5 35178,01,3202,34088,636,99000,2356,1220,2044,386,705,716,181,56,1540,1248,292,1248,1045,203,2019-01-01,zipcode,Vincent
ZCTA5 35179,01,8616,47437,709,132100,6891,2917,6166,1068,2503,1908,446,241,3803,3296,507,3296,2792,504,2019-01-01,zipcode,Vinemont
ZCTA5 35180,01,14967,58750,582,142000,11623,5203,10151,1409,3838,3502,948,454,5999,5668,331,5668,4806,862,2019-01-01,zipcode,Warrior
ZCTA5 35183,01,918,56579,-666666666,79600,777,264,698,92,385,186,28,7,398,304,94,304,254,50,2019-01-01,zipcode,Weogufka
ZCTA5 35184,01,4666,38313,787,81300,3808,2073,3308,848,1491,695,212,62,2410,1641,769,1641,1151,490,2019-01-01,zipcode,West blocton
ZCTA5 35186,01,5085,64796,929,184400,4292,2048,3649,388,1182,1215,545,319,2344,2008,336,2008,1667,341,2019-01-01,zipcode,Wilsonville
ZCTA5 35187,01,6,-666666666,-666666666,-666666666,6,6,6,0,0,6,0,0,3,3,0,3,3,0,2019-01-01,zipcode,Wilton
ZCTA5 35188,01,3014,57750,-666666666,128100,2434,1032,2142,239,1207,537,119,40,988,894,94,894,745,149,2019-01-01,zipcode,Woodstock
ZCTA5 35203,01,3125,17248,551,214500,3014,1749,2650,553,885,428,453,331,1922,1688,234,1688,317,1371,2019-01-01,zipcode,Birmingham
ZCTA5 35204,01,9262,23027,609,63900,7666,4136,6700,1589,2306,2047,491,267,5817,4321,1496,4321,1488,2833,2019-01-01,zipcode,Birmingham
ZCTA5 35205,01,20857,39236,802,179900,18794,6380,13990,950,2576,3557,3986,2921,12710,9797,2913,9797,2566,7231,2019-01-01,zipcode,Birmingham
ZCTA5 35206,01,17713,33852,856,76900,13921,6037,12227,2048,4306,4132,1252,489,8595,6860,1735,6860,3456,3404,2019-01-01,zipcode,Birmingham
ZCTA5 35207,01,8696,24533,546,63300,6638,3370,5746,1083,2082,1814,468,299,4519,3544,975,3544,1993,1551,2019-01-01,zipcode,Birmingham
ZCTA5 35208,01,13719,36014,852,73900,10780,4791,9153,1118,3323,3551,857,304,7204,5439,1765,5439,2943,2496,2019-01-01,zipcode,Birmingham
ZCTA5 35209,01,28252,59931,997,344000,22235,5968,17672,854,2684,4026,4908,5200,15207,11992,3215,11992,5853,6139,2019-01-01,zipcode,Birmingham
ZCTA5 35210,01,14022,55394,988,146900,11672,4232,10440,986,2691,2850,2796,1117,6884,6101,783,6101,4108,1993,2019-01-01,zipcode,Birmingham
ZCTA5 35211,01,24745,32051,836,77900,20116,8361,17349,2678,4718,5808,2737,1408,15037,11441,3596,11441,4996,6445,2019-01-01,zipcode,Birmingham
ZCTA5 35212,01,11295,30240,591,133200,8714,3385,7644,1188,2275,2275,1161,745,6019,4766,1253,4766,2123,2643,2019-01-01,zipcode,Birmingham
ZCTA5 35213,01,14062,122379,1479,541400,10819,3675,9585,70,425,1003,4764,3323,6097,5693,404,5693,4310,1383,2019-01-01,zipcode,Birmingham
ZCTA5 35214,01,17789,51871,789,107700,14753,6249,13149,1072,3974,4797,2332,974,8678,7308,1370,7308,5127,2181,2019-01-01,zipcode,Birmingham
ZCTA5 35215,01,48680,42519,850,103700,35301,12405,29807,3826,10121,10612,3580,1668,20800,18173,2627,18173,10006,8167,2019-01-01,zipcode,Birmingham
ZCTA5 35216,01,36856,63348,1045,275400,28013,7374,24344,1177,3757,6268,8019,5123,16346,14819,1527,14819,8079,6740,2019-01-01,zipcode,Birmingham
ZCTA5 35217,01,13256,35551,699,79900,10616,4775,9066,1670,3395,2827,853,321,6182,4932,1250,4932,2703,2229,2019-01-01,zipcode,Birmingham
ZCTA5 35218,01,7235,27012,793,64700,5493,2329,4833,618,1619,2139,365,92,3686,2842,844,2842,1187,1655,2019-01-01,zipcode,Birmingham
ZCTA5 35221,01,4484,36313,844,67300,3684,1851,3192,545,1139,1164,281,63,2523,1771,752,1771,1127,644,2019-01-01,zipcode,Birmingham
ZCTA5 35222,01,8989,62246,767,242900,7425,2249,6654,553,868,1464,2008,1761,4799,4147,652,4147,2370,1777,2019-01-01,zipcode,Birmingham
ZCTA5 35223,01,11111,141604,1669,506500,8890,3550,7787,51,259,1167,3191,3119,4552,4197,355,4197,3600,597,2019-01-01,zipcode,Birmingham
ZCTA5 35224,01,5328,37983,772,68400,4204,1861,3530,400,1401,1308,304,117,2778,2033,745,2033,1208,825,2019-01-01,zipcode,Birmingham
ZCTA5 35226,01,35331,106905,1264,279600,26961,7993,24077,543,2836,4876,8717,7105,13870,13117,753,13117,10351,2766,2019-01-01,zipcode,Birmingham
ZCTA5 35228,01,10059,33486,866,66100,8068,3446,6892,1136,2589,2212,813,142,4653,3781,872,3781,2272,1509,2019-01-01,zipcode,Birmingham
ZCTA5 35229,01,1255,-666666666,-666666666,-666666666,1255,836,0,0,0,0,0,0,0,0,0,0,0,0,2019-01-01,zipcode,Birmingham
ZCTA5 35233,01,1730,41994,1284,188400,1701,703,1025,62,83,102,422,356,1451,921,530,921,87,834,2019-01-01,zipcode,Birmingham
ZCTA5 35234,01,5063,24205,597,59500,4541,2543,4157,1033,1274,1472,313,65,2632,1905,727,1905,873,1032,2019-01-01,zipcode,Birmingham
ZCTA5 35235,01,21340,56301,994,119100,16777,5514,14713,1349,4035,5472,2487,1370,8994,8139,855,8139,5613,2526,2019-01-01,zipcode,Birmingham
ZCTA5 35242,01,56340,98780,1140,355700,45562,14834,39568,898,4393,9776,15406,9095,24081,22156,1925,22156,15804,6352,2019-01-01,zipcode,Birmingham
ZCTA5 35243,01,17059,89007,1272,358000,14129,4375,12630,128,859,2604,5089,3950,9167,7702,1465,7702,4544,3158,2019-01-01,zipcode,Birmingham
ZCTA5 35244,01,31941,91323,1130,295900,25559,7537,22250,907,2832,5807,7795,4909,13550,12261,1289,12261,8593,3668,2019-01-01,zipcode,Birmingham
ZCTA5 35254,01,1598,-666666666,675,-666666666,1577,1113,192,49,91,0,35,17,218,155,63,155,63,92,2019-01-01,zipcode,Birmingham
ZCTA5 35401,01,37705,26216,784,118700,32937,18743,17092,3114,6134,3737,2112,1995,18382,11371,7011,11371,4106,7265,2019-01-01,zipcode,Tuscaloosa
ZCTA5 35404,01,22345,40651,882,130000,18585,7545,13263,1830,4237,4164,2174,858,10878,7757,3121,7757,3983,3774,2019-01-01,zipcode,Tuscaloosa
ZCTA5 35405,01,45391,56711,861,172800,36800,12676,29713,2592,8278,8789,6314,3740,19768,16962,2806,16962,9528,7434,2019-01-01,zipcode,Tuscaloosa
ZCTA5 35406,01,17914,104172,998,353000,13813,4921,12303,385,971,2363,4580,4004,7783,6905,878,6905,5363,1542,2019-01-01,zipcode,Tuscaloosa
ZCTA5 35441,01,972,41071,595,55500,754,358,677,137,236,181,82,41,832,392,440,392,356,36,2019-01-01,zipcode,Akron
ZCTA5 35442,01,6730,31921,540,77800,5568,3330,4769,1083,1531,1455,523,177,2565,2007,558,2007,1416,591,2019-01-01,zipcode,Aliceville
ZCTA5 35443,01,1777,15000,574,34200,1303,827,974,192,513,230,27,12,1120,534,586,534,289,245,2019-01-01,zipcode,Boligee
ZCTA5 35444,01,3972,50644,870,117000,3249,1349,2761,455,1061,924,258,63,1565,1428,137,1428,1202,226,2019-01-01,zipcode,Brookwood
ZCTA5 35446,01,2147,42314,860,117200,1728,843,1499,320,601,389,128,61,753,721,32,721,609,112,2019-01-01,zipcode,Buhl
ZCTA5 35447,01,3032,40088,432,89700,2498,1264,2195,433,845,642,192,83,1669,1164,505,1164,873,291,2019-01-01,zipcode,Carrollton
ZCTA5 35452,01,3416,52762,864,167500,2791,1267,2478,453,878,760,248,139,1346,1189,157,1189,958,231,2019-01-01,zipcode,Coker
ZCTA5 35453,01,10721,58750,794,140800,8292,3207,7329,1278,3061,1981,616,393,4392,3672,720,3672,3135,537,2019-01-01,zipcode,Cottondale
ZCTA5 35456,01,4051,50634,854,138000,3060,1407,2746,589,1216,636,180,125,1529,1300,229,1300,1034,266,2019-01-01,zipcode,Duncanville
ZCTA5 35457,01,0,-666666666,-666666666,-666666666,0,0,0,0,0,0,0,0,0,0,0,0,0,0,2019-01-01,zipcode,Echola
ZCTA5 35458,01,445,43875,-666666666,161100,429,153,373,15,215,83,29,31,178,161,17,161,126,35,2019-01-01,zipcode,Elrod
ZCTA5 35459,01,1156,32750,636,48800,979,527,814,184,334,231,35,30,535,397,138,397,306,91,2019-01-01,zipcode,Emelle
ZCTA5 35460,01,956,22396,525,99200,889,559,673,47,166,291,111,58,484,401,83,401,334,67,2019-01-01,zipcode,Epes
ZCTA5 35461,01,2093,50361,625,155400,1765,813,1591,199,583,563,161,85,1158,895,263,895,832,63,2019-01-01,zipcode,Ethelsville
ZCTA5 35462,01,4447,23323,621,84000,3501,1983,3303,809,1012,1101,229,152,2739,1777,962,1777,1206,571,2019-01-01,zipcode,Eutaw
ZCTA5 35463,01,2074,55602,-666666666,132700,1637,497,1495,98,609,514,234,40,874,761,113,761,680,81,2019-01-01,zipcode,Fosters
ZCTA5 35464,01,854,11731,335,-666666666,567,437,435,45,175,146,67,2,415,306,109,306,150,156,2019-01-01,zipcode,Gainesville
ZCTA5 35466,01,5441,44402,507,103100,4279,1998,3743,547,1442,1114,406,234,2478,2122,356,2122,1687,435,2019-01-01,zipcode,Gordo
ZCTA5 35469,01,311,36012,-666666666,83700,278,255,278,27,111,90,46,4,199,88,111,88,61,27,2019-01-01,zipcode,Knoxville
ZCTA5 35470,01,4836,22884,554,108700,3853,1999,2401,250,796,673,287,395,2342,1850,492,1850,919,931,2019-01-01,zipcode,Livingston
ZCTA5 35473,01,16294,64949,859,182000,12700,4539,10613,874,2647,2891,2457,1744,6891,6220,671,6220,4305,1915,2019-01-01,zipcode,Northport
ZCTA5 35474,01,6617,55342,804,136700,5312,1966,4471,624,1691,1232,567,357,2797,2276,521,2276,1853,423,2019-01-01,zipcode,Moundville
ZCTA5 35475,01,15952,79222,741,192800,12513,4169,10932,915,3221,3441,1930,1425,6476,5557,919,5557,4975,582,2019-01-01,zipcode,Northport
ZCTA5 35476,01,7208,36821,778,140400,5520,2182,4665,673,1408,1483,661,440,3259,2732,527,2732,1278,1454,2019-01-01,zipcode,Northport
ZCTA5 35477,01,137,-666666666,-666666666,-666666666,137,83,118,5,44,57,6,6,160,62,98,62,62,0,2019-01-01,zipcode,Panola
ZCTA5 35480,01,1007,83438,-666666666,189300,840,400,831,80,360,253,92,46,410,329,81,329,293,36,2019-01-01,zipcode,Ralph
ZCTA5 35481,01,3174,31458,430,81500,2755,1490,2315,501,975,668,129,42,1764,1450,314,1450,941,509,2019-01-01,zipcode,Reform
ZCTA5 35490,01,3911,56150,936,120300,3033,1156,2527,495,990,682,231,129,1618,1272,346,1272,919,353,2019-01-01,zipcode,Vance
ZCTA5 35501,01,10208,37014,593,95800,7769,3688,6612,1301,2355,2256,440,260,4877,3780,1097,3780,2202,1578,2019-01-01,zipcode,Jasper
ZCTA5 35503,01,8798,53344,733,120900,7381,3132,6454,1065,2353,2293,506,237,4245,3499,746,3499,2780,719,2019-01-01,zipcode,Jasper
ZCTA5 35504,01,12832,58403,641,158400,10534,4801,9090,1022,3084,3058,1353,573,6105,4949,1156,4949,3971,978,2019-01-01,zipcode,Jasper
ZCTA5 35540,01,2786,42648,331,87400,2268,1181,1942,326,890,555,109,62,1325,1123,202,1123,880,243,2019-01-01,zipcode,Addison
ZCTA5 35541,01,3399,51646,438,154300,2958,1498,2695,487,931,740,247,290,2692,1514,1178,1514,1391,123,2019-01-01,zipcode,Arley
ZCTA5 35542,01,920,39583,-666666666,78400,808,447,693,156,266,202,69,0,545,417,128,417,405,12,2019-01-01,zipcode,Bankston
ZCTA5 35543,01,1033,27917,593,49300,791,406,692,235,249,157,23,28,458,411,47,411,288,123,2019-01-01,zipcode,Bear creek
ZCTA5 35544,01,513,55500,572,45200,440,183,426,71,105,175,51,24,322,252,70,252,177,75,2019-01-01,zipcode,Beaverton
ZCTA5 35545,01,99,28750,-666666666,-666666666,87,53,64,33,15,14,0,2,58,50,8,50,46,4,2019-01-01,zipcode,Belk
ZCTA5 35546,01,3996,56106,359,104900,3115,1319,2611,448,1064,712,230,157,1607,1465,142,1465,1280,185,2019-01-01,zipcode,Berry
ZCTA5 35548,01,1600,37069,407,83900,1359,682,1190,345,415,328,53,49,839,694,145,694,555,139,2019-01-01,zipcode,Brilliant
ZCTA5 35549,01,3712,37308,589,64300,2975,1599,2613,591,1091,757,89,85,1816,1516,300,1516,1105,411,2019-01-01,zipcode,Carbon hill
ZCTA5 35550,01,5504,39776,624,71800,4516,2299,3999,763,1614,1286,185,151,2688,2304,384,2304,1837,467,2019-01-01,zipcode,Cordova
ZCTA5 35552,01,997,43715,315,66500,725,346,601,90,215,145,151,0,433,355,78,355,328,27,2019-01-01,zipcode,Detroit
ZCTA5 35553,01,4111,30139,479,66000,3546,2014,3106,901,1181,691,163,170,2371,1724,647,1724,1355,369,2019-01-01,zipcode,Double springs
ZCTA5 35554,01,1034,37270,603,60200,851,379,768,104,388,236,34,6,574,455,119,455,395,60,2019-01-01,zipcode,Eldridge
ZCTA5 35555,01,9537,40012,533,99500,7886,3794,6897,943,2769,2137,782,266,5247,3947,1300,3947,2760,1187,2019-01-01,zipcode,Fayette
ZCTA5 35559,01,12,-666666666,-666666666,-666666666,12,0,12,12,0,0,0,0,6,6,0,6,6,0,2019-01-01,zipcode,Glen allen
ZCTA5 35563,01,4646,37778,556,106800,3796,1801,3234,417,1266,1191,182,178,2332,1896,436,1896,1353,543,2019-01-01,zipcode,Guin
ZCTA5 35564,01,2134,28370,542,104400,1745,932,1526,259,586,552,76,53,1040,894,146,894,712,182,2019-01-01,zipcode,Hackleburg
ZCTA5 35565,01,12645,32121,538,71900,10017,4568,9092,2030,3399,2727,519,417,6243,5114,1129,5114,3999,1115,2019-01-01,zipcode,Haleyville
ZCTA5 35570,01,11159,37695,517,100500,9311,4762,7981,1801,2762,2315,713,390,5445,4529,916,4529,3202,1327,2019-01-01,zipcode,Hamilton
ZCTA5 35571,01,776,46979,656,79300,666,357,596,134,206,187,40,29,494,324,170,324,282,42,2019-01-01,zipcode,Hodges
ZCTA5 35572,01,1267,31193,-666666666,180600,1064,457,870,187,269,279,66,69,976,508,468,508,466,42,2019-01-01,zipcode,Houston
ZCTA5 35574,01,1694,39261,279,108300,1347,682,1254,201,499,348,110,96,875,681,194,681,593,88,2019-01-01,zipcode,Kennedy
ZCTA5 35575,01,1082,39716,634,85500,832,415,722,167,271,193,60,31,496,431,65,431,308,123,2019-01-01,zipcode,Lynn
ZCTA5 35576,01,2869,46127,468,92500,2552,1168,2288,329,1064,640,178,77,1639,1334,305,1334,1073,261,2019-01-01,zipcode,Millport
ZCTA5 35577,01,48,-666666666,-666666666,-666666666,41,21,27,0,10,10,7,0,52,13,39,13,13,0,2019-01-01,zipcode,Natural bridge
ZCTA5 35578,01,6111,36485,818,91000,4968,2960,4394,997,1934,1041,292,130,2769,2293,476,2293,2039,254,2019-01-01,zipcode,Nauvoo
ZCTA5 35579,01,3614,47417,345,85700,2846,1367,2591,518,1066,855,129,23,1767,1367,400,1367,1101,266,2019-01-01,zipcode,Oakman
ZCTA5 35580,01,3564,41997,627,80800,2694,1080,2384,535,780,917,76,76,1688,1343,345,1343,1159,184,2019-01-01,zipcode,Parrish
ZCTA5 35581,01,6073,44871,692,92100,4457,2275,3791,818,1121,1319,333,200,2453,1979,474,1979,1436,543,2019-01-01,zipcode,Phil campbell
ZCTA5 35582,01,4561,38594,466,85300,3318,1384,2953,631,1352,628,224,118,2156,1770,386,1770,1269,501,2019-01-01,zipcode,Red bay
ZCTA5 35584,01,365,25313,-666666666,47800,279,181,254,65,78,102,5,4,179,137,42,137,113,24,2019-01-01,zipcode,Sipsey
ZCTA5 35585,01,1727,45750,-666666666,151000,1351,713,1128,160,260,340,252,116,706,558,148,558,459,99,2019-01-01,zipcode,Spruce pine
ZCTA5 35586,01,3947,32500,425,83400,3033,1501,2821,568,1018,1013,133,89,2255,1706,549,1706,1329,377,2019-01-01,zipcode,Sulligent
ZCTA5 35587,01,582,36750,-666666666,42500,553,345,464,111,228,109,3,13,423,281,142,281,250,31,2019-01-01,zipcode,Townley
ZCTA5 35592,01,4839,36116,404,78600,3773,1846,3183,579,1273,852,349,130,2353,1910,443,1910,1298,612,2019-01-01,zipcode,Vernon
ZCTA5 35593,01,1537,45455,476,86500,1209,530,1112,232,454,261,109,56,748,592,156,592,482,110,2019-01-01,zipcode,Vina
ZCTA5 35594,01,7285,40881,515,113500,5728,2749,4992,897,1593,1793,480,229,3467,2685,782,2685,2015,670,2019-01-01,zipcode,Winfield
ZCTA5 35601,01,32381,43267,662,99900,25232,11512,21822,5136,6289,5899,3212,1286,14322,12290,2032,12290,7661,4629,2019-01-01,zipcode,Decatur
ZCTA5 35603,01,31653,56795,660,168900,25830,10042,22259,2061,5937,7798,4401,2062,13962,13273,689,13273,9330,3943,2019-01-01,zipcode,Decatur
ZCTA5 35610,01,1823,43211,477,160900,1604,797,1491,199,744,384,110,54,896,803,93,803,652,151,2019-01-01,zipcode,Anderson
ZCTA5 35611,01,27058,40257,640,126300,21900,9921,18543,3662,6371,4820,2612,1078,11616,9839,1777,9839,6054,3785,2019-01-01,zipcode,Athens
ZCTA5 35613,01,26379,79484,847,183600,21649,9774,19190,2607,5479,5699,3698,1707,8444,7937,507,7937,7122,815,2019-01-01,zipcode,Athens
ZCTA5 35614,01,7050,45276,756,120000,5567,2615,5032,1186,1639,1497,489,221,2966,2611,355,2611,2027,584,2019-01-01,zipcode,Athens
ZCTA5 35615,01,60,-666666666,-666666666,-666666666,60,60,60,60,0,0,0,0,17,17,0,17,0,17,2019-01-01,zipcode,Belle mina
ZCTA5 35616,01,3772,41034,719,85600,3210,1533,2747,597,1036,779,150,185,2309,1635,674,1635,1242,393,2019-01-01,zipcode,Cherokee
ZCTA5 35618,01,1796,29850,456,78500,1538,873,1271,308,509,329,69,56,1057,852,205,852,582,270,2019-01-01,zipcode,Courtland
ZCTA5 35619,01,4860,53051,617,116600,4071,1843,3648,822,1360,1148,219,99,2174,1847,327,1847,1561,286,2019-01-01,zipcode,Danville
ZCTA5 35620,01,9694,58301,830,127200,7967,3164,6712,818,2615,2354,520,405,3703,3345,358,3345,2744,601,2019-01-01,zipcode,Elkmont
ZCTA5 35621,01,2647,51618,745,118400,2180,1030,1919,377,670,558,213,101,1219,1124,95,1124,989,135,2019-01-01,zipcode,Eva
ZCTA5 35622,01,7409,52217,765,90500,5577,2436,4995,730,2159,1602,272,232,3233,2535,698,2535,2008,527,2019-01-01,zipcode,Falkville
ZCTA5 35630,01,33324,36405,641,119800,28131,12908,21413,3385,6586,6420,3174,1848,17839,14946,2893,14946,6624,8322,2019-01-01,zipcode,Florence
ZCTA5 35633,01,20625,59359,710,143700,16483,6933,14443,1812,4984,3776,2518,1353,9391,8349,1042,8349,7042,1307,2019-01-01,zipcode,Florence
ZCTA5 35634,01,9997,74668,867,186300,8393,3857,7430,555,2750,1962,1205,958,4304,3934,370,3934,3288,646,2019-01-01,zipcode,Florence
ZCTA5 35640,01,25654,58572,668,146100,20501,8521,17527,1826,5793,6034,2397,1477,10820,9455,1365,9455,7581,1874,2019-01-01,zipcode,Hartselle
ZCTA5 35643,01,3802,44754,532,104200,3188,1389,2837,951,1126,478,202,80,1657,1505,152,1505,1351,154,2019-01-01,zipcode,Hillsboro
ZCTA5 35645,01,13654,62007,653,175800,10995,4750,9743,884,3987,2691,1389,792,5960,5223,737,5223,4451,772,2019-01-01,zipcode,Killen
ZCTA5 35646,01,4522,41894,482,105900,3938,2199,3431,572,1621,893,153,192,2420,1828,592,1828,1408,420,2019-01-01,zipcode,Leighton
ZCTA5 35647,01,1177,65938,372,111300,914,322,743,80,293,170,170,30,386,368,18,368,297,71,2019-01-01,zipcode,Lester
ZCTA5 35648,01,3448,56172,522,115800,2788,1117,2315,297,1039,682,183,114,1450,1298,152,1298,1058,240,2019-01-01,zipcode,Lexington
ZCTA5 35649,01,84,130000,-666666666,500000,70,28,68,3,9,11,27,18,30,30,0,30,30,0,2019-01-01,zipcode,Mooresville
ZCTA5 35650,01,13668,43521,541,128100,10958,5736,9660,1822,4144,2428,851,415,6039,5153,886,5153,3832,1321,2019-01-01,zipcode,Moulton
ZCTA5 35651,01,1364,35438,726,88300,1049,629,911,126,526,205,38,16,573,461,112,461,343,118,2019-01-01,zipcode,Mount hope
ZCTA5 35652,01,8704,54135,768,133000,7085,3053,6165,697,2427,1790,861,390,4351,3479,872,3479,2793,686,2019-01-01,zipcode,Rogersville
ZCTA5 35653,01,10615,43547,596,83500,8535,3479,7113,1918,2745,1596,502,352,4688,3611,1077,3611,2455,1156,2019-01-01,zipcode,Russellville
ZCTA5 35654,01,7771,42622,550,111800,6009,2778,5112,1107,1990,1357,409,249,3625,2778,847,2778,1849,929,2019-01-01,zipcode,Russellville
ZCTA5 35660,01,8986,34194,645,90000,7310,3685,6507,1237,2159,1821,839,451,5079,4046,1033,4046,2335,1711,2019-01-01,zipcode,Sheffield
ZCTA5 35661,01,17027,60311,836,148000,13664,5714,12032,1134,4035,3795,2111,957,7335,6624,711,6624,5290,1334,2019-01-01,zipcode,Muscle shoals
ZCTA5 35670,01,6594,55592,590,119000,5292,2177,4595,697,1425,1478,741,254,3159,2527,632,2527,2141,386,2019-01-01,zipcode,Somerville
ZCTA5 35671,01,1958,30539,634,74100,1735,683,1509,279,637,356,166,71,1096,872,224,872,574,298,2019-01-01,zipcode,Tanner
ZCTA5 35672,01,5714,51505,553,104100,4302,2170,3614,526,1390,1125,287,286,2836,2211,625,2211,1717,494,2019-01-01,zipcode,Town creek
ZCTA5 35673,01,7460,53822,594,129500,5923,2748,5330,1000,1945,1560,620,205,3141,2620,521,2620,2180,440,2019-01-01,zipcode,Trinity
ZCTA5 35674,01,19144,49358,681,115600,15346,6878,13364,2089,5441,3842,1218,774,8828,7305,1523,7305,5211,2094,2019-01-01,zipcode,Tuscumbia
ZCTA5 35677,01,1593,38125,850,88300,1258,643,1089,197,515,238,111,28,1051,667,384,667,517,150,2019-01-01,zipcode,Waterloo
ZCTA5 35739,01,5076,51575,789,133700,3919,1383,3530,666,1114,1049,507,194,2220,1975,245,1975,1420,555,2019-01-01,zipcode,Ardmore
ZCTA5 35740,01,3056,30531,416,86400,2567,1361,2267,342,964,716,188,57,1635,1419,216,1419,950,469,2019-01-01,zipcode,Bridgeport
ZCTA5 35741,01,2801,74569,1005,268700,2569,958,2243,158,295,434,940,416,1490,1350,140,1350,904,446,2019-01-01,zipcode,Brownsboro
ZCTA5 35744,01,1956,36760,413,117700,1616,867,1277,257,662,211,69,78,984,737,247,737,596,141,2019-01-01,zipcode,Dutton
ZCTA5 35745,01,164,30625,-666666666,155900,154,73,131,5,80,28,12,6,165,81,84,81,74,7,2019-01-01,zipcode,Estillfork
ZCTA5 35746,01,461,33980,-666666666,-666666666,400,230,377,135,117,112,13,0,300,213,87,213,181,32,2019-01-01,zipcode,Fackler
ZCTA5 35747,01,5302,56563,663,160300,4481,2094,3919,417,1721,1033,446,302,2764,2076,688,2076,1610,466,2019-01-01,zipcode,Grant
ZCTA5 35748,01,7300,75370,582,198800,5978,2364,5199,539,1761,1247,999,653,2937,2738,199,2738,2281,457,2019-01-01,zipcode,Gurley
ZCTA5 35749,01,22804,91496,1096,186500,17658,6069,15290,827,3293,4757,3782,2631,9112,8286,826,8286,7316,970,2019-01-01,zipcode,Harvest
ZCTA5 35750,01,13391,56250,847,134900,10818,3708,9350,1013,3290,2932,1472,643,5879,5266,613,5266,4116,1150,2019-01-01,zipcode,Hazel green
ZCTA5 35751,01,238,48000,-666666666,215200,225,89,169,0,60,62,29,18,124,86,38,86,86,0,2019-01-01,zipcode,Hollytree
ZCTA5 35752,01,2682,47002,775,68600,2222,1156,1905,307,916,548,102,32,1203,1019,184,1019,901,118,2019-01-01,zipcode,Hollywood
ZCTA5 35754,01,5300,50417,613,150600,4424,1901,3869,946,1008,896,847,172,2212,1980,232,1980,1473,507,2019-01-01,zipcode,Laceys spring
ZCTA5 35755,01,450,46364,-666666666,150000,436,206,360,20,105,109,64,62,427,218,209,218,174,44,2019-01-01,zipcode,Langston
ZCTA5 35756,01,13855,94737,1366,239500,10060,3327,8766,519,1387,2360,2823,1677,5129,4500,629,4500,3901,599,2019-01-01,zipcode,Madison
ZCTA5 35757,01,16909,91765,1147,201300,13349,4506,11365,609,1583,3277,3416,2480,6311,6021,290,6021,5139,882,2019-01-01,zipcode,Madison
ZCTA5 35758,01,46724,91900,968,240800,37250,11669,32080,942,3885,8395,10938,7920,19549,18566,983,18566,12489,6077,2019-01-01,zipcode,Madison
ZCTA5 35759,01,8113,90655,1297,192500,6528,2258,5541,209,1037,2031,1577,687,3130,3089,41,3089,2853,236,2019-01-01,zipcode,Meridianville
ZCTA5 35760,01,4876,53831,785,130100,3889,1528,3401,638,1396,844,416,107,2092,1831,261,1831,1446,385,2019-01-01,zipcode,New hope
ZCTA5 35761,01,12547,64521,844,153600,9952,3612,8779,1222,2616,2711,1485,745,5147,4834,313,4834,4175,659,2019-01-01,zipcode,New market
ZCTA5 35763,01,19855,121158,2000,280700,14597,5480,12911,448,1776,2699,4209,3779,7110,6867,243,6867,6291,576,2019-01-01,zipcode,Owens cross roads
ZCTA5 35764,01,540,28750,589,77600,463,255,414,108,210,78,12,6,262,248,14,248,182,66,2019-01-01,zipcode,Paint rock
ZCTA5 35765,01,3633,37429,448,93200,3099,1767,2754,578,871,878,257,170,1861,1406,455,1406,1195,211,2019-01-01,zipcode,Pisgah
ZCTA5 35766,01,155,-666666666,-666666666,-666666666,140,58,140,19,91,16,0,14,123,67,56,67,54,13,2019-01-01,zipcode,Princeton
ZCTA5 35768,01,11473,43219,588,96000,9297,4321,8049,1357,3394,2118,816,364,5385,4483,902,4483,3002,1481,2019-01-01,zipcode,Scottsboro
ZCTA5 35769,01,9745,45677,664,143500,7998,3547,7167,762,2407,2353,1140,505,5102,4041,1061,4041,3054,987,2019-01-01,zipcode,Scottsboro
ZCTA5 35771,01,3959,50064,677,106000,3004,1150,2785,521,993,976,209,86,1649,1422,227,1422,1048,374,2019-01-01,zipcode,Section
ZCTA5 35772,01,4762,39556,475,83700,3633,1957,3222,535,1582,828,168,109,2316,1878,438,1878,1399,479,2019-01-01,zipcode,Stevenson
ZCTA5 35773,01,12323,54933,842,123200,10020,3460,8722,1176,2730,2583,1515,718,5165,4706,459,4706,3723,983,2019-01-01,zipcode,Toney
ZCTA5 35774,01,198,52750,-666666666,73000,198,136,150,7,68,48,13,14,93,67,26,67,67,0,2019-01-01,zipcode,Trenton
ZCTA5 35775,01,1095,36591,-666666666,82500,884,373,839,173,317,220,112,17,422,380,42,380,290,90,2019-01-01,zipcode,Valhermoso springs
ZCTA5 35776,01,3785,38448,600,93700,3140,1585,2721,507,1193,671,231,119,1731,1450,281,1450,1205,245,2019-01-01,zipcode,Woodville
ZCTA5 35801,01,23947,71947,861,274300,19850,8940,17653,1614,2845,3949,5408,3837,10951,10020,931,10020,6659,3361,2019-01-01,zipcode,Huntsville
ZCTA5 35802,01,21853,64702,831,240800,18306,7184,16228,585,2399,4730,5002,3512,11522,10292,1230,10292,5790,4502,2019-01-01,zipcode,Huntsville
ZCTA5 35803,01,26242,78524,905,183800,21346,8355,19029,833,3119,5237,6128,3712,12054,11299,755,11299,9003,2296,2019-01-01,zipcode,Huntsville
ZCTA5 35805,01,20491,25511,642,74200,15529,5662,12317,2873,3659,4037,1367,381,10498,9146,1352,9146,2587,6559,2019-01-01,zipcode,Huntsville
ZCTA5 35806,01,23019,68490,965,233900,19766,5972,16447,823,2240,3972,6149,3263,11723,11056,667,11056,5134,5922,2019-01-01,zipcode,Huntsville
ZCTA5 35808,01,1348,90104,1377,-666666666,1044,230,678,11,113,199,216,139,369,351,18,351,5,346,2019-01-01,zipcode,Huntsville
ZCTA5 35810,01,29274,37488,868,86100,23791,9733,18794,3082,5479,6077,2607,1549,12906,11497,1409,11497,7345,4152,2019-01-01,zipcode,Huntsville
ZCTA5 35811,01,27245,65740,808,164300,22031,7914,19339,1864,5091,6084,4045,2255,11896,10947,949,10947,8749,2198,2019-01-01,zipcode,Huntsville
ZCTA5 35816,01,13971,25451,680,89000,11691,4148,8216,1249,2225,2609,1369,764,8001,6622,1379,6622,1648,4974,2019-01-01,zipcode,Huntsville
ZCTA5 35824,01,8298,83950,952,229200,6974,1501,5506,89,591,1682,1660,1484,3959,3828,131,3828,1966,1862,2019-01-01,zipcode,Huntsville
ZCTA5 35896,01,698,-666666666,-666666666,-666666666,698,361,0,0,0,0,0,0,0,0,0,0,0,0,2019-01-01,zipcode,Huntsville
ZCTA5 35901,01,19811,39688,619,117200,15986,7543,13904,2459,4100,4698,1578,1069,9362,7553,1809,7553,4789,2764,2019-01-01,zipcode,Gadsden
ZCTA5 35903,01,17699,37492,677,97500,14637,6459,12193,1959,4406,3993,1099,736,8423,6674,1749,6674,4197,2477,2019-01-01,zipcode,Gadsden
ZCTA5 35904,01,13704,35349,640,69900,11209,5472,9734,1816,3373,3143,908,494,6722,5333,1389,5333,4242,1091,2019-01-01,zipcode,Gadsden
ZCTA5 35905,01,6219,57989,605,135200,5103,2443,4542,522,1334,1694,427,565,2903,2349,554,2349,1907,442,2019-01-01,zipcode,Gadsden
ZCTA5 35906,01,9811,50929,797,167700,7751,3182,6874,542,2024,2260,1335,713,4591,3917,674,3917,2379,1538,2019-01-01,zipcode,Rainbow city
ZCTA5 35907,01,8589,73143,942,154200,7066,2725,6193,399,1385,2559,1320,530,3570,3245,325,3245,2877,368,2019-01-01,zipcode,Gadsden
ZCTA5 35950,01,20867,44670,693,111000,15020,6288,12908,2894,3928,3978,1522,586,7822,7303,519,7303,4557,2746,2019-01-01,zipcode,Albertville
ZCTA5 35951,01,12686,37000,634,108400,9771,4318,8167,2553,2677,2143,561,233,4996,4266,730,4266,2983,1283,2019-01-01,zipcode,Albertville
ZCTA5 35952,01,7879,40991,611,90900,6239,3100,5426,1325,2035,1544,336,186,3410,2876,534,2876,2211,665,2019-01-01,zipcode,Altoona
ZCTA5 35953,01,7519,46096,814,110700,6139,3103,5401,1059,2175,1825,181,161,3469,2743,726,2743,2220,523,2019-01-01,zipcode,Ashville
ZCTA5 35954,01,11834,39956,578,86600,9377,4513,7998,1451,3037,2760,384,366,5800,4477,1323,4477,3621,856,2019-01-01,zipcode,Attalla
ZCTA5 35956,01,8927,47016,676,114000,7230,3430,6313,1109,2208,2166,515,315,3692,3270,422,3270,2682,588,2019-01-01,zipcode,Boaz
ZCTA5 35957,01,15967,40235,682,97400,12072,5535,10341,2231,3276,3240,1030,564,6597,5655,942,5655,3334,2321,2019-01-01,zipcode,Boaz
ZCTA5 35958,01,3523,42885,544,137500,2954,1570,2489,492,930,608,296,163,1633,1450,183,1450,1088,362,2019-01-01,zipcode,Bryant
ZCTA5 35959,01,4523,39743,520,105700,3747,1987,3313,660,1446,826,227,154,3771,1928,1843,1928,1501,427,2019-01-01,zipcode,Cedar bluff
ZCTA5 35960,01,9714,44189,623,144600,8171,4283,7284,1205,2896,2101,478,604,6576,4276,2300,4276,3146,1130,2019-01-01,zipcode,Centre
ZCTA5 35961,01,7082,39467,579,84400,5612,2597,4861,1342,1805,1415,180,119,2919,2497,422,2497,1651,846,2019-01-01,zipcode,Collinsville
ZCTA5 35962,01,8730,42796,706,88300,6808,2987,5758,1729,1916,1434,367,312,3587,3083,504,3083,2252,831,2019-01-01,zipcode,Crossville
ZCTA5 35963,01,1201,33250,-666666666,116700,1052,500,982,158,359,325,98,42,669,514,155,514,358,156,2019-01-01,zipcode,Dawson
ZCTA5 35966,01,4182,41912,744,121400,3554,1741,3023,755,1186,758,153,171,1930,1642,288,1642,1288,354,2019-01-01,zipcode,Flat rock
ZCTA5 35967,01,16274,39575,650,115500,12411,5320,10739,2831,3313,2933,908,754,7254,6017,1237,6017,4245,1772,2019-01-01,zipcode,Fort payne
ZCTA5 35968,01,5206,44185,593,111200,4055,1934,3511,937,1038,1021,356,159,1913,1655,258,1655,1150,505,2019-01-01,zipcode,Fort payne
ZCTA5 35971,01,5666,43472,693,93500,4552,1981,3654,856,1370,1125,189,114,2209,1953,256,1953,1406,547,2019-01-01,zipcode,Fyffe
ZCTA5 35972,01,1222,60398,-666666666,105400,967,432,879,145,398,197,90,49,445,437,8,437,361,76,2019-01-01,zipcode,Gallant
ZCTA5 35973,01,2810,37244,814,97300,2276,1195,1995,565,712,550,125,43,1498,1127,371,1127,990,137,2019-01-01,zipcode,Gaylesville
ZCTA5 35974,01,1744,40882,641,122600,1306,562,1159,278,341,272,172,96,801,708,93,708,408,300,2019-01-01,zipcode,Geraldine
ZCTA5 35975,01,629,30938,-666666666,81000,511,319,460,98,222,96,40,4,224,224,0,224,174,50,2019-01-01,zipcode,Groveoak
ZCTA5 35976,01,17549,50580,633,172700,14354,6782,12488,1902,3354,3754,2441,1037,8036,6882,1154,6882,5180,1702,2019-01-01,zipcode,Guntersville
ZCTA5 35978,01,4901,41020,553,98100,3988,1903,3611,709,1528,993,254,127,2271,1887,384,1887,1546,341,2019-01-01,zipcode,Henagar
ZCTA5 35979,01,1352,35417,-666666666,127100,1065,429,924,161,491,236,16,20,668,590,78,590,445,145,2019-01-01,zipcode,Higdon
ZCTA5 35980,01,5440,46198,627,93300,4151,1988,3325,685,1240,870,250,280,2128,1800,328,1800,1470,330,2019-01-01,zipcode,Horton
ZCTA5 35981,01,1802,43641,277,117600,1554,672,1281,162,677,336,66,40,840,653,187,653,482,171,2019-01-01,zipcode,Ider
ZCTA5 35983,01,3683,55052,639,160700,3030,1395,2665,243,1054,915,240,213,2331,1426,905,1426,1083,343,2019-01-01,zipcode,Leesburg
ZCTA5 35984,01,1492,41071,807,185500,1389,803,1344,146,336,356,360,146,1489,756,733,756,607,149,2019-01-01,zipcode,Mentone
ZCTA5 35986,01,7968,36640,595,114100,6310,2806,5311,1074,1881,1833,351,172,3518,3055,463,3055,2133,922,2019-01-01,zipcode,Rainsville
ZCTA5 35987,01,2458,42391,808,92300,1995,962,1671,361,691,470,69,80,1066,912,154,912,745,167,2019-01-01,zipcode,Steele
ZCTA5 35988,01,2311,43679,623,90200,1701,628,1455,305,495,438,130,87,881,789,92,789,583,206,2019-01-01,zipcode,Sylvania
ZCTA5 35989,01,3831,39185,587,94600,2841,1343,2443,585,866,575,235,182,1736,1372,364,1372,1046,326,2019-01-01,zipcode,Valley head
ZCTA5 35990,01,82,-666666666,975,-666666666,57,35,31,8,21,2,0,0,34,23,11,23,6,17,2019-01-01,zipcode,Walnut grove
ZCTA5 36003,01,1963,37000,445,91800,1717,945,1519,384,608,375,77,75,1176,912,264,912,713,199,2019-01-01,zipcode,Autaugaville
ZCTA5 36005,01,1438,49722,530,97700,1161,589,956,164,344,244,110,94,748,498,250,498,432,66,2019-01-01,zipcode,Banks
ZCTA5 36006,01,1108,47154,471,179300,974,411,875,153,320,199,133,70,600,483,117,483,402,81,2019-01-01,zipcode,Billingsley
ZCTA5 36009,01,2463,38500,477,89200,2010,949,1716,244,754,363,277,78,1312,960,352,960,678,282,2019-01-01,zipcode,Brantley
ZCTA5 36010,01,4766,40345,557,80000,3996,2033,3246,763,1337,698,284,164,2348,1624,724,1624,1176,448,2019-01-01,zipcode,Brundidge
ZCTA5 36013,01,615,103696,-666666666,387800,523,197,449,34,75,210,75,55,210,210,0,210,210,0,2019-01-01,zipcode,Cecil
ZCTA5 36016,01,4951,33263,552,73700,4332,2860,3891,1280,1484,804,228,95,1924,1495,429,1495,962,533,2019-01-01,zipcode,Clayton
ZCTA5 36017,01,2897,24413,429,60700,2483,1892,2235,753,821,507,112,42,915,701,214,701,442,259,2019-01-01,zipcode,Clio
ZCTA5 36020,01,1039,41641,797,163600,836,409,723,112,254,221,89,47,450,413,37,413,306,107,2019-01-01,zipcode,Coosada
ZCTA5 36022,01,13003,70200,775,176600,10361,3930,8882,849,2870,2927,1693,543,5099,4707,392,4707,3971,736,2019-01-01,zipcode,Deatsville
ZCTA5 36024,01,5124,53506,811,172700,4373,2002,3807,532,1350,1067,599,259,3073,2175,898,2175,1707,468,2019-01-01,zipcode,Eclectic
ZCTA5 36025,01,6231,44952,980,141200,5640,3914,4960,1401,1883,1049,370,257,1400,1318,82,1318,842,476,2019-01-01,zipcode,Elmore
ZCTA5 36026,01,1091,44432,-666666666,287500,938,472,846,79,278,233,240,16,1079,477,602,477,347,130,2019-01-01,zipcode,Equality
ZCTA5 36027,01,14970,32767,587,104800,11676,5574,10089,2211,3415,3006,947,510,7724,6111,1613,6111,3489,2622,2019-01-01,zipcode,Eufaula
ZCTA5 36028,01,1438,37798,613,97500,1231,588,1090,263,368,264,142,53,895,587,308,587,495,92,2019-01-01,zipcode,Dozier
ZCTA5 36029,01,1164,47216,-666666666,-666666666,920,295,833,147,357,159,120,50,434,344,90,344,305,39,2019-01-01,zipcode,Fitzpatrick
ZCTA5 36030,01,605,33021,613,106800,528,331,435,17,295,85,24,14,294,177,117,177,136,41,2019-01-01,zipcode,Forest home
ZCTA5 36031,01,185,-666666666,-666666666,82000,165,131,139,71,55,6,7,0,102,92,10,92,89,3,2019-01-01,zipcode,Fort davis
ZCTA5 36032,01,2464,34464,389,64500,1916,786,1567,297,711,334,105,120,1260,979,281,979,634,345,2019-01-01,zipcode,Fort deposit
ZCTA5 36033,01,4262,39425,609,79500,3424,1806,3027,605,1235,798,207,182,2372,1367,1005,1367,1025,342,2019-01-01,zipcode,Georgiana
ZCTA5 36034,01,1132,42500,567,55100,861,400,682,67,276,202,97,40,492,358,134,358,327,31,2019-01-01,zipcode,Glenwood
ZCTA5 36035,01,1606,42292,670,91800,1258,473,1170,166,521,220,132,131,966,572,394,572,497,75,2019-01-01,zipcode,Goshen
ZCTA5 36036,01,1688,44940,655,102100,1526,647,1257,231,446,310,170,100,988,672,316,672,571,101,2019-01-01,zipcode,Grady
ZCTA5 36037,01,12944,41733,631,96900,10231,4382,8884,1282,3980,2051,963,608,6395,4265,2130,4265,2822,1443,2019-01-01,zipcode,Greenville
ZCTA5 36038,01,44,-666666666,-666666666,-666666666,44,30,44,5,15,24,0,0,13,13,0,13,13,0,2019-01-01,zipcode,Gantt
ZCTA5 36039,01,232,50677,-666666666,88300,232,117,197,58,54,54,31,0,87,87,0,87,68,19,2019-01-01,zipcode,Hardaway
ZCTA5 36040,01,3452,24852,592,66600,2745,1519,2473,555,1139,423,227,129,1632,1414,218,1414,956,458,2019-01-01,zipcode,Hayneville
ZCTA5 36041,01,1344,39931,-666666666,68400,1058,498,881,200,422,206,31,22,667,497,170,497,441,56,2019-01-01,zipcode,Highland home
ZCTA5 36042,01,1947,47273,643,103800,1582,742,1423,293,710,226,137,57,959,632,327,632,562,70,2019-01-01,zipcode,Honoraville
ZCTA5 36043,01,3626,50000,1041,186300,3092,1683,2648,723,814,529,345,237,1550,1318,232,1318,1037,281,2019-01-01,zipcode,Hope hull
ZCTA5 36046,01,1406,40956,727,105700,1181,506,1034,231,388,254,113,48,686,547,139,547,507,40,2019-01-01,zipcode,Lapine
ZCTA5 36047,01,1084,41895,-666666666,81300,807,371,725,139,346,163,68,9,577,447,130,447,369,78,2019-01-01,zipcode,Letohatchee
ZCTA5 36048,01,1513,31250,594,71100,1252,612,1070,403,448,162,47,10,755,565,190,565,405,160,2019-01-01,zipcode,Louisville
ZCTA5 36049,01,5883,46696,549,78400,4730,2154,4132,797,1554,819,718,244,2620,2045,575,2045,1441,604,2019-01-01,zipcode,Luverne
ZCTA5 36051,01,2057,70438,886,87200,1784,645,1603,263,733,373,106,128,977,853,124,853,666,187,2019-01-01,zipcode,Marbury
ZCTA5 36052,01,393,106406,-666666666,582400,343,163,343,17,66,99,107,54,240,191,49,191,172,19,2019-01-01,zipcode,Mathews
ZCTA5 36053,01,1732,28478,591,76600,1291,569,1183,259,431,387,46,60,1114,694,420,694,455,239,2019-01-01,zipcode,Midway
ZCTA5 36054,01,15899,58125,875,143600,12008,4022,9703,1055,3023,3123,1546,956,6241,5864,377,5864,4049,1815,2019-01-01,zipcode,Millbrook
ZCTA5 36064,01,10149,109082,1250,314400,7705,2185,6666,288,849,1447,2393,1689,3964,3613,351,3613,3369,244,2019-01-01,zipcode,Pike road
ZCTA5 36066,01,19732,62284,1124,173300,15700,5626,13125,1124,2989,3706,3202,2104,8887,8381,506,8381,4785,3596,2019-01-01,zipcode,Prattville
ZCTA5 36067,01,27601,53645,875,140400,21565,9440,18528,2445,6970,5293,2329,1491,10943,10015,928,10015,7628,2387,2019-01-01,zipcode,Prattville
ZCTA5 36069,01,2028,46020,786,122000,1796,743,1517,232,467,393,204,221,1051,864,187,864,770,94,2019-01-01,zipcode,Ramer
ZCTA5 36071,01,456,31635,518,80000,416,293,385,115,154,80,26,10,251,207,44,207,168,39,2019-01-01,zipcode,Rutledge
ZCTA5 36075,01,2240,37202,748,83400,1795,861,1611,303,511,533,201,63,1133,929,204,929,637,292,2019-01-01,zipcode,Shorter
ZCTA5 36078,01,12540,54842,707,136100,10169,4331,8799,1650,2990,2645,953,561,5778,4912,866,4912,3443,1469,2019-01-01,zipcode,Tallassee
ZCTA5 36079,01,9932,49792,815,132200,7823,2935,6566,776,2294,1986,919,591,4465,3359,1106,3359,2668,691,2019-01-01,zipcode,Troy
ZCTA5 36080,01,2412,81250,-666666666,183800,2100,1082,1899,130,715,573,291,190,1079,855,224,855,780,75,2019-01-01,zipcode,Titus
ZCTA5 36081,01,15754,27368,639,132300,13289,6227,8277,1258,2744,2020,1261,994,8313,6074,2239,6074,2812,3262,2019-01-01,zipcode,Troy
ZCTA5 36082,01,1141,-666666666,-666666666,-666666666,1141,893,21,0,0,7,14,0,0,0,0,0,0,0,2019-01-01,zipcode,Troy
ZCTA5 36083,01,7316,32394,565,77200,6117,2888,5318,929,1410,1568,801,610,4655,3315,1340,3315,2110,1205,2019-01-01,zipcode,Tuskegee
ZCTA5 36088,01,4646,31200,705,83800,4141,2081,1755,290,432,562,222,249,1983,1204,779,1204,549,655,2019-01-01,zipcode,Tuskegee institute
ZCTA5 36089,01,7698,34417,666,72100,6305,3125,5264,1420,2102,1174,368,200,3307,2662,645,2662,1850,812,2019-01-01,zipcode,Union springs
ZCTA5 36091,01,3590,39821,654,84800,2930,1527,2728,493,1220,747,148,120,1840,1538,302,1538,1191,347,2019-01-01,zipcode,Verbena
ZCTA5 36092,01,20170,54861,810,141600,16371,8248,14052,2036,5422,3662,2015,917,8821,7501,1320,7501,5458,2043,2019-01-01,zipcode,Wetumpka
ZCTA5 36093,01,11084,98438,1295,250400,8408,3105,7170,297,1292,2320,1937,1324,4107,3905,202,3905,3507,398,2019-01-01,zipcode,Wetumpka
ZCTA5 36104,01,8465,26401,687,67100,7032,3861,5206,1289,1506,1258,539,614,4087,2932,1155,2932,906,2026,2019-01-01,zipcode,Montgomery
ZCTA5 36105,01,9391,31287,826,67100,7593,3652,6719,1677,2296,1722,722,302,5297,3840,1457,3840,2455,1385,2019-01-01,zipcode,Montgomery
ZCTA5 36106,01,14951,59985,973,160000,12203,4321,10042,695,1851,2650,2472,2374,7148,6333,815,6333,3524,2809,2019-01-01,zipcode,Montgomery
ZCTA5 36107,01,7669,29592,756,67700,5787,2257,4750,1040,1511,1174,566,459,4163,3084,1079,3084,1278,1806,2019-01-01,zipcode,Montgomery
ZCTA5 36108,01,17680,24832,634,63100,14393,7205,12593,3665,4138,3026,1243,521,9220,7243,1977,7243,4070,3173,2019-01-01,zipcode,Montgomery
ZCTA5 36109,01,25377,54561,957,116600,20689,8162,17351,1521,4413,5637,3584,2196,10977,10150,827,10150,7344,2806,2019-01-01,zipcode,Montgomery
ZCTA5 36110,01,11693,32760,839,57700,9129,4772,7830,2222,2707,1955,571,375,5435,4237,1198,4237,2236,2001,2019-01-01,zipcode,Montgomery
ZCTA5 36111,01,12610,51679,825,144200,9750,3564,8243,1399,1993,2072,1751,1028,5623,4909,714,4909,2918,1991,2019-01-01,zipcode,Montgomery
ZCTA5 36112,01,309,-666666666,-666666666,-666666666,309,11,147,0,26,99,0,22,0,0,0,0,0,0,2019-01-01,zipcode,Montgomery
ZCTA5 36113,01,1764,88375,1515,-666666666,1429,956,1259,97,391,393,157,221,302,263,39,263,0,263,2019-01-01,zipcode,Montgomery
ZCTA5 36115,01,1058,69028,1388,-666666666,693,174,485,4,85,255,65,76,295,295,0,295,0,295,2019-01-01,zipcode,Montgomery
ZCTA5 36116,01,43882,45883,881,109500,33828,11876,27873,3199,6980,9208,5013,3473,20090,17049,3041,17049,8412,8637,2019-01-01,zipcode,Montgomery
ZCTA5 36117,01,54640,64011,1003,180300,42515,13568,35954,1940,7153,10448,9648,6765,24479,22552,1927,22552,13122,9430,2019-01-01,zipcode,Montgomery
ZCTA5 36201,01,17482,27533,593,64400,14266,7127,12676,3469,4882,3476,644,205,9458,7104,2354,7104,4181,2923,2019-01-01,zipcode,Anniston
ZCTA5 36203,01,18453,56237,862,152600,14352,4985,12380,1942,3357,4191,1691,1199,7685,6980,705,6980,4850,2130,2019-01-01,zipcode,Oxford
ZCTA5 36205,01,1027,85373,733,215900,871,427,697,85,182,213,84,133,416,331,85,331,170,161,2019-01-01,zipcode,Anniston
ZCTA5 36206,01,11648,45115,703,96600,9203,3996,7950,1255,2905,2483,659,648,5161,4433,728,4433,3362,1071,2019-01-01,zipcode,Anniston
ZCTA5 36207,01,19614,54023,817,150100,15750,6652,13641,1199,3925,4927,1795,1795,9809,8117,1692,8117,5564,2553,2019-01-01,zipcode,Anniston
ZCTA5 36250,01,4768,70813,927,128800,3835,1363,3505,259,1018,1391,536,301,2023,1834,189,1834,1557,277,2019-01-01,zipcode,Alexandria
ZCTA5 36251,01,4400,35671,390,83900,3841,1841,3227,780,1119,1032,182,114,2414,1818,596,1818,1307,511,2019-01-01,zipcode,Ashland
ZCTA5 36255,01,944,44375,-666666666,125000,753,319,647,141,307,160,0,39,412,382,30,382,338,44,2019-01-01,zipcode,Cragford
ZCTA5 36256,01,1621,41827,692,104700,1276,577,1126,214,399,385,97,31,864,665,199,665,566,99,2019-01-01,zipcode,Daviston
ZCTA5 36258,01,1385,55500,540,128800,1219,603,1111,137,535,257,122,60,825,594,231,594,516,78,2019-01-01,zipcode,Delta
ZCTA5 36260,01,4259,40714,625,121500,3452,1773,3002,611,1071,1023,190,107,1867,1604,263,1604,1322,282,2019-01-01,zipcode,Eastaboga
ZCTA5 36262,01,1326,40147,639,93300,1009,494,886,209,371,213,77,16,603,458,145,458,363,95,2019-01-01,zipcode,Fruithurst
ZCTA5 36263,01,420,26324,715,95000,394,277,358,86,165,30,10,67,268,182,86,182,102,80,2019-01-01,zipcode,Graham
ZCTA5 36264,01,8305,41123,575,123000,6683,3500,5858,1393,1961,1580,523,401,3959,3246,713,3246,2333,913,2019-01-01,zipcode,Heflin
ZCTA5 36265,01,20238,50020,667,143700,17060,7141,12614,1082,3581,4734,1806,1411,8707,7531,1176,7531,4667,2864,2019-01-01,zipcode,Jacksonville
ZCTA5 36266,01,6106,42574,578,118800,4632,2021,4019,925,1545,1098,257,194,2963,2154,809,2154,1500,654,2019-01-01,zipcode,Lineville
ZCTA5 36267,01,7,-666666666,-666666666,-666666666,7,0,7,7,0,0,0,0,7,7,0,7,7,0,2019-01-01,zipcode,Millerville
ZCTA5 36268,01,5514,54286,765,107700,4293,1580,3651,630,1403,1213,244,161,2615,2216,399,2216,1863,353,2019-01-01,zipcode,Munford
ZCTA5 36269,01,1685,55216,599,82400,1143,534,1031,210,438,219,131,33,588,513,75,513,393,120,2019-01-01,zipcode,Muscadine
ZCTA5 36271,01,5771,54073,746,117300,4782,1845,4247,979,1421,1280,298,269,2846,2200,646,2200,1878,322,2019-01-01,zipcode,Ohatchee
ZCTA5 36272,01,13097,41059,607,82900,10707,5491,9495,1877,3640,2676,818,484,6565,5336,1229,5336,4261,1075,2019-01-01,zipcode,Piedmont
ZCTA5 36273,01,3125,47625,658,123100,2611,1008,2284,415,973,532,271,93,1481,1280,201,1280,1076,204,2019-01-01,zipcode,Ranburne
ZCTA5 36274,01,11067,40136,594,85400,9079,4250,7802,1548,2781,2283,798,392,5441,4361,1080,4361,3279,1082,2019-01-01,zipcode,Roanoke
ZCTA5 36276,01,2573,35804,494,72000,2107,1034,1604,424,543,456,128,53,1130,860,270,860,677,183,2019-01-01,zipcode,Wadley
ZCTA5 36277,01,5771,57250,851,106000,4480,1798,3892,540,1036,1623,502,191,2254,2011,243,2011,1660,351,2019-01-01,zipcode,Weaver
ZCTA5 36278,01,4557,39235,651,154700,3551,2017,3179,547,887,1030,358,357,3008,1774,1234,1774,1422,352,2019-01-01,zipcode,Wedowee
ZCTA5 36279,01,2452,56851,1020,141700,2083,992,1889,335,682,540,140,192,1290,1028,262,1028,944,84,2019-01-01,zipcode,Wellington
ZCTA5 36280,01,4332,55803,784,100000,3406,1666,3090,585,1205,824,239,237,2092,1624,468,1624,1256,368,2019-01-01,zipcode,Woodland
ZCTA5 36301,01,37608,42140,736,119800,29615,12614,25501,3947,8761,8529,2687,1577,16966,14144,2822,14144,8605,5539,2019-01-01,zipcode,Dothan
ZCTA5 36303,01,30986,44639,702,144300,24373,10565,21088,2879,5873,6987,3388,1961,14524,11667,2857,11667,6965,4702,2019-01-01,zipcode,Dothan
ZCTA5 36305,01,15954,67601,965,186300,12505,4902,11023,699,2652,3828,2343,1501,6900,6076,824,6076,4265,1811,2019-01-01,zipcode,Dothan
ZCTA5 36310,01,6275,39983,554,92300,5370,3055,4621,1104,1639,1264,335,279,4234,2621,1613,2621,2051,570,2019-01-01,zipcode,Abbeville
ZCTA5 36311,01,2426,36426,505,76300,2075,1118,1682,382,720,394,62,124,1309,993,316,993,827,166,2019-01-01,zipcode,Ariton
ZCTA5 36312,01,6285,46111,676,113500,5076,2316,4308,654,1664,1409,386,195,2735,2276,459,2276,1684,592,2019-01-01,zipcode,Ashford
ZCTA5 36313,01,244,72286,-666666666,135800,167,39,167,32,0,123,12,0,149,98,51,98,63,35,2019-01-01,zipcode,Bellwood
ZCTA5 36314,01,398,36875,522,108700,358,209,350,87,151,72,11,29,251,197,54,197,167,30,2019-01-01,zipcode,Black
ZCTA5 36316,01,2118,64243,725,154100,1754,885,1627,199,443,694,230,61,944,811,133,811,705,106,2019-01-01,zipcode,Chancellor
ZCTA5 36317,01,486,28839,-666666666,67900,455,303,442,159,115,111,41,16,335,227,108,227,185,42,2019-01-01,zipcode,Clopton
ZCTA5 36318,01,1481,50625,575,69400,1150,599,932,176,343,345,52,16,713,517,196,517,450,67,2019-01-01,zipcode,Coffee springs
ZCTA5 36319,01,2200,41893,777,79700,1772,973,1630,258,518,627,135,92,1096,905,191,905,712,193,2019-01-01,zipcode,Columbia
ZCTA5 36320,01,3660,40417,613,89800,2977,1291,2666,476,1099,779,248,64,1701,1366,335,1366,1100,266,2019-01-01,zipcode,Cottonwood
ZCTA5 36321,01,1816,42500,750,102400,1370,575,1202,221,498,337,92,54,716,622,94,622,493,129,2019-01-01,zipcode,Cowarts
ZCTA5 36322,01,8921,41989,668,97100,7178,3132,6105,976,2146,2218,532,233,4371,3392,979,3392,1984,1408,2019-01-01,zipcode,Daleville
ZCTA5 36323,01,7862,44978,639,83800,6706,3221,5757,1315,2024,1800,426,192,3792,3007,785,3007,2135,872,2019-01-01,zipcode,Elba
ZCTA5 36330,01,37144,61447,856,167400,28668,10619,24903,2697,5846,9353,4677,2330,16240,14161,2079,14161,8797,5364,2019-01-01,zipcode,Enterprise
ZCTA5 36340,01,5718,40828,444,105700,4504,2242,3995,932,1492,1024,277,270,2751,2281,470,2281,1567,714,2019-01-01,zipcode,Geneva
ZCTA5 36343,01,1241,41518,555,70400,1088,596,939,304,323,253,43,16,734,501,233,501,436,65,2019-01-01,zipcode,Gordon
ZCTA5 36344,01,5719,43273,619,118600,4702,2218,4100,733,1491,1420,305,151,2755,2074,681,2074,1405,669,2019-01-01,zipcode,Hartford
ZCTA5 36345,01,8785,62117,648,141700,6887,2613,6129,985,1896,1917,836,495,3656,3157,499,3157,2655,502,2019-01-01,zipcode,Headland
ZCTA5 36346,01,1432,48424,598,94400,1108,506,956,213,332,256,98,57,657,545,112,545,465,80,2019-01-01,zipcode,Jack
ZCTA5 36350,01,6428,42634,679,137100,4975,1837,4268,647,1211,1658,494,258,3079,2646,433,2646,1578,1068,2019-01-01,zipcode,Midland city
ZCTA5 36351,01,3482,49074,739,111700,2873,1321,2562,409,954,810,250,139,1671,1466,205,1466,1052,414,2019-01-01,zipcode,New brockton
ZCTA5 36352,01,5433,65379,678,168200,4502,1776,3856,452,1052,1492,303,557,2068,1936,132,1936,1591,345,2019-01-01,zipcode,Newton
ZCTA5 36353,01,1683,41648,538,104000,1441,663,1134,166,334,472,114,48,903,701,202,701,621,80,2019-01-01,zipcode,Newville
ZCTA5 36360,01,19064,44112,636,115400,15548,7714,13734,2006,4530,4724,1649,825,9386,7792,1594,7792,5101,2691,2019-01-01,zipcode,Ozark
ZCTA5 36362,01,5311,70024,1165,-666666666,3635,868,2406,21,406,1105,638,236,1468,1296,172,1296,8,1288,2019-01-01,zipcode,Fort rucker
ZCTA5 36370,01,881,43125,725,89500,735,395,704,153,322,195,22,12,423,357,66,357,284,73,2019-01-01,zipcode,Pansey
ZCTA5 36371,01,767,40000,763,127300,619,348,550,81,182,191,77,19,387,320,67,320,226,94,2019-01-01,zipcode,Pinckard
ZCTA5 36373,01,435,27102,-666666666,101300,428,278,303,117,124,62,0,0,354,191,163,191,149,42,2019-01-01,zipcode,Shorterville
ZCTA5 36374,01,787,59875,1272,83800,689,254,628,148,159,217,56,48,530,341,189,341,285,56,2019-01-01,zipcode,Skipperville
ZCTA5 36375,01,6976,46932,764,84900,5764,2604,4871,1008,1838,1269,502,254,3307,2761,546,2761,1975,786,2019-01-01,zipcode,Slocomb
ZCTA5 36376,01,2179,42212,733,86200,1785,894,1585,332,675,407,110,61,1089,787,302,787,621,166,2019-01-01,zipcode,Webb
ZCTA5 36401,01,7730,37856,533,86500,6315,3130,5503,721,3002,1129,419,232,4466,2919,1547,2919,2105,814,2019-01-01,zipcode,Evergreen
ZCTA5 36420,01,10369,44753,635,119900,8484,3845,7492,1199,2703,2170,776,644,5295,4250,1045,4250,2964,1286,2019-01-01,zipcode,Andalusia
ZCTA5 36421,01,9966,42560,596,97700,7705,3382,6693,856,2176,2400,925,336,5147,3818,1329,3818,2977,841,2019-01-01,zipcode,Andalusia
ZCTA5 36425,01,1045,26635,546,39500,892,519,731,66,391,179,68,27,657,413,244,413,331,82,2019-01-01,zipcode,Beatrice
ZCTA5 36426,01,15262,40511,621,96900,12294,5804,10884,1956,4287,3182,1030,429,7426,5884,1542,5884,4008,1876,2019-01-01,zipcode,Brewton
ZCTA5 36432,01,2150,38125,-666666666,84000,1784,1048,1523,397,642,303,88,93,1142,648,494,648,528,120,2019-01-01,zipcode,Castleberry
ZCTA5 36435,01,370,35054,-666666666,69400,284,172,278,72,87,104,0,15,274,131,143,131,125,6,2019-01-01,zipcode,Coy
ZCTA5 36436,01,359,39231,-666666666,96100,334,192,245,55,109,81,0,0,212,122,90,122,115,7,2019-01-01,zipcode,Dickinson
ZCTA5 36439,01,502,38929,881,138800,345,165,319,33,114,102,36,34,243,192,51,192,110,82,2019-01-01,zipcode,Excel
ZCTA5 36441,01,3886,37656,651,89500,2849,1224,2652,318,1192,747,271,124,1846,1471,375,1471,1125,346,2019-01-01,zipcode,Flomaton
ZCTA5 36442,01,3356,35513,525,92900,2699,1386,2379,439,1016,752,108,64,1652,1252,400,1252,950,302,2019-01-01,zipcode,Florala
ZCTA5 36444,01,774,30982,-666666666,63800,632,460,577,159,285,94,19,20,586,301,285,301,201,100,2019-01-01,zipcode,Franklin
ZCTA5 36445,01,4524,45316,662,101000,3552,2201,3175,529,1392,803,331,120,2315,1868,447,1868,1412,456,2019-01-01,zipcode,Frisco city
ZCTA5 36446,01,441,-666666666,-666666666,85000,359,231,308,54,175,63,0,16,252,155,97,155,116,39,2019-01-01,zipcode,Fulton
ZCTA5 36451,01,4312,47551,548,116100,3435,1790,3107,532,1207,1103,154,111,2393,1720,673,1720,1322,398,2019-01-01,zipcode,Grove hill
ZCTA5 36453,01,2396,37607,613,78200,2072,1034,1769,303,671,594,131,70,1094,941,153,941,679,262,2019-01-01,zipcode,Kinston
ZCTA5 36454,01,8,-666666666,-666666666,-666666666,8,8,8,0,8,0,0,0,42,5,37,5,5,0,2019-01-01,zipcode,Lenox
ZCTA5 36455,01,252,37614,617,68300,215,109,205,42,94,60,7,2,174,117,57,117,84,33,2019-01-01,zipcode,Lockhart
ZCTA5 36456,01,1528,40481,525,50900,1144,618,992,120,478,313,44,37,782,545,237,545,428,117,2019-01-01,zipcode,Mc kenzie
ZCTA5 36460,01,10246,30511,536,124000,8275,3955,7003,893,3226,1847,715,322,4781,3776,1005,3776,2185,1591,2019-01-01,zipcode,Monroeville
ZCTA5 36467,01,9810,38795,602,91100,7963,3679,6957,1342,2608,2091,617,299,4871,3995,876,3995,2812,1183,2019-01-01,zipcode,Opp
ZCTA5 36470,01,51,-666666666,-666666666,-666666666,51,51,51,30,21,0,0,0,51,51,0,51,0,51,2019-01-01,zipcode,Perdue hill
ZCTA5 36471,01,904,18203,-666666666,55400,738,518,658,94,436,85,20,23,827,413,414,413,282,131,2019-01-01,zipcode,Peterman
ZCTA5 36473,01,102,60987,-666666666,116500,93,59,86,20,44,12,0,10,61,39,22,39,39,0,2019-01-01,zipcode,Range
ZCTA5 36474,01,2647,47328,549,74100,2220,1082,1989,384,922,530,100,53,1471,1114,357,1114,1009,105,2019-01-01,zipcode,Red level
ZCTA5 36475,01,2393,28158,651,81100,1830,1013,1596,143,909,268,212,64,1306,878,428,878,660,218,2019-01-01,zipcode,Repton
ZCTA5 36476,01,16,-666666666,-666666666,-666666666,16,5,7,0,5,2,0,0,20,7,13,7,7,0,2019-01-01,zipcode,River falls
ZCTA5 36477,01,3688,32305,519,76400,2941,1452,2663,528,895,974,139,127,2108,1587,521,1587,1153,434,2019-01-01,zipcode,Samson
ZCTA5 36480,01,1682,27461,678,87800,1441,888,1200,149,489,445,46,71,1066,601,465,601,371,230,2019-01-01,zipcode,Uriah
ZCTA5 36481,01,443,16161,-666666666,-666666666,358,257,253,75,123,42,0,13,293,135,158,135,56,79,2019-01-01,zipcode,Vredenburgh
ZCTA5 36482,01,1004,31711,-666666666,79900,881,493,783,224,255,227,64,13,568,386,182,386,341,45,2019-01-01,zipcode,Whatley
ZCTA5 36483,01,447,42188,-666666666,106400,399,256,373,46,191,86,39,11,219,176,43,176,166,10,2019-01-01,zipcode,Wing
ZCTA5 36502,01,18113,32845,614,105800,14826,8429,12477,2582,6016,2501,833,545,7280,5837,1443,5837,3857,1980,2019-01-01,zipcode,Atmore
ZCTA5 36505,01,1682,73090,1133,123000,1191,458,972,208,224,299,160,81,558,493,65,493,353,140,2019-01-01,zipcode,Axis
ZCTA5 36507,01,21360,44635,655,132200,17009,8164,14237,2328,5071,4513,1644,681,8397,7307,1090,7307,5231,2076,2019-01-01,zipcode,Bay minette
ZCTA5 36509,01,2054,43363,725,74900,1678,773,1427,572,413,340,83,19,804,683,121,683,438,245,2019-01-01,zipcode,Bayou la batre
ZCTA5 36511,01,221,20615,-666666666,111500,221,168,221,61,104,24,32,0,334,200,134,200,200,0,2019-01-01,zipcode,Bon secour
ZCTA5 36512,01,39,-666666666,-666666666,-666666666,39,39,39,13,26,0,0,0,20,20,0,20,20,0,2019-01-01,zipcode,Bucks
ZCTA5 36513,01,672,27051,-666666666,126900,396,315,326,187,71,39,0,29,168,149,19,149,85,64,2019-01-01,zipcode,Calvert
ZCTA5 36518,01,2744,40000,751,96800,2309,1245,1960,309,820,580,164,87,1470,1046,424,1046,764,282,2019-01-01,zipcode,Chatom
ZCTA5 36521,01,6073,55610,788,118300,4853,2240,4387,749,2124,1172,234,108,2311,2162,149,2162,1853,309,2019-01-01,zipcode,Chunchula
ZCTA5 36522,01,7339,41319,766,101600,5373,2507,4749,882,2149,1187,399,132,2979,2609,370,2609,1933,676,2019-01-01,zipcode,Citronelle
ZCTA5 36523,01,2809,46420,847,118900,2310,1238,2111,611,822,427,125,126,1141,957,184,957,707,250,2019-01-01,zipcode,Coden
ZCTA5 36524,01,1328,35093,580,84400,1054,632,848,169,386,183,54,56,967,488,479,488,422,66,2019-01-01,zipcode,Coffeeville
ZCTA5 36525,01,1914,43714,742,129600,1348,564,1187,169,497,339,136,46,699,628,71,628,463,165,2019-01-01,zipcode,Creola
ZCTA5 36526,01,34565,77739,1189,211600,26555,9295,22957,815,4821,8190,5676,3455,13673,12305,1368,12305,9336,2969,2019-01-01,zipcode,Daphne
ZCTA5 36527,01,15517,94088,1248,278500,11764,3963,9989,384,1556,3259,2845,1945,5909,5724,185,5724,3996,1728,2019-01-01,zipcode,Daphne
ZCTA5 36528,01,1324,87596,1111,257600,1224,592,1112,58,241,355,251,207,2060,585,1475,585,518,67,2019-01-01,zipcode,Dauphin island
ZCTA5 36529,01,209,-666666666,-666666666,-666666666,170,105,145,8,87,28,7,15,125,77,48,77,77,0,2019-01-01,zipcode,Deer park
ZCTA5 36530,01,6363,48906,853,167600,5415,2349,4589,674,1411,1559,669,276,3537,2627,910,2627,2144,483,2019-01-01,zipcode,Elberta
ZCTA5 36532,01,35066,69766,1173,268700,27405,11908,24620,1644,4606,6570,7700,4100,15596,12929,2667,12929,10393,2536,2019-01-01,zipcode,Fairhope
ZCTA5 36535,01,33065,46753,836,171200,27586,12029,24720,2727,7951,7976,4299,1767,15704,13221,2483,13221,9544,3677,2019-01-01,zipcode,Foley
ZCTA5 36538,01,377,29000,-666666666,23500,328,219,323,162,143,6,12,0,307,182,125,182,182,0,2019-01-01,zipcode,Frankville
ZCTA5 36539,01,688,32583,-666666666,-666666666,583,359,354,49,187,104,5,9,326,262,64,262,200,62,2019-01-01,zipcode,Fruitdale
ZCTA5 36540,01,628,32870,-666666666,156000,564,296,501,116,288,81,4,12,316,246,70,246,203,43,2019-01-01,zipcode,Gainestown
ZCTA5 36541,01,15524,58794,1074,116100,11453,4610,9929,1822,3701,3121,803,482,5977,5086,891,5086,4592,494,2019-01-01,zipcode,Grand bay
ZCTA5 36542,01,14045,53792,1078,246100,12573,5044,11112,580,2623,3986,2410,1513,16634,6711,9923,6711,3951,2760,2019-01-01,zipcode,Gulf shores
ZCTA5 36543,01,137,-666666666,-666666666,-666666666,69,8,69,0,0,41,12,16,82,41,41,41,41,0,2019-01-01,zipcode,Huxford
ZCTA5 36544,01,11682,44681,852,106300,9256,3963,7973,1993,3577,1725,549,129,4680,4071,609,4071,3114,957,2019-01-01,zipcode,Irvington
ZCTA5 36545,01,9743,35970,572,112000,7879,4344,6485,1311,2722,1527,508,417,4818,3413,1405,3413,2343,1070,2019-01-01,zipcode,Jackson
ZCTA5 36548,01,998,-666666666,-666666666,141100,808,367,720,37,258,271,63,91,626,434,192,434,376,58,2019-01-01,zipcode,Leroy
ZCTA5 36549,01,5687,50000,1109,141700,5096,3034,4629,269,1861,1483,757,259,2917,2268,649,2268,2055,213,2019-01-01,zipcode,Lillian
ZCTA5 36550,01,179,118674,-666666666,-666666666,179,69,179,60,42,11,37,29,198,109,89,109,72,37,2019-01-01,zipcode,Little river
ZCTA5 36551,01,9573,58849,980,152100,7841,3303,6903,949,2505,2002,992,455,3556,3135,421,3135,2672,463,2019-01-01,zipcode,Loxley
ZCTA5 36553,01,2721,45245,638,104800,2246,1333,1688,254,812,455,75,92,1260,826,434,826,787,39,2019-01-01,zipcode,Mc intosh
ZCTA5 36555,01,806,60781,832,261900,759,366,682,23,206,199,195,59,478,347,131,347,314,33,2019-01-01,zipcode,Magnolia springs
ZCTA5 36556,01,571,-666666666,-666666666,47500,462,303,351,42,151,138,20,0,383,229,154,229,136,93,2019-01-01,zipcode,Malcolm
ZCTA5 36558,01,3677,49315,499,83000,2956,1423,2564,509,1022,560,252,221,2015,1485,530,1485,1321,164,2019-01-01,zipcode,Millry
ZCTA5 36559,01,213,26614,-666666666,629500,213,177,176,0,0,89,18,69,219,107,112,107,89,18,2019-01-01,zipcode,Montrose
ZCTA5 36560,01,3243,36397,673,60100,2843,1502,2467,802,1019,500,106,40,1448,1263,185,1263,898,365,2019-01-01,zipcode,Mount vernon
ZCTA5 36561,01,6843,83064,1188,337300,6158,2834,5636,254,1120,1381,2038,843,13641,3221,10420,3221,2514,707,2019-01-01,zipcode,Orange beach
ZCTA5 36562,01,1362,43816,822,119200,1135,554,1012,193,513,205,94,7,607,464,143,464,425,39,2019-01-01,zipcode,Perdido
ZCTA5 36564,01,153,-666666666,-666666666,2000001,111,71,91,0,0,9,31,51,153,61,92,61,61,0,2019-01-01,zipcode,Point clear
ZCTA5 36567,01,13980,51479,833,145300,10908,4774,9524,1622,3592,2991,945,374,5718,4976,742,4976,3579,1397,2019-01-01,zipcode,Robertsdale
ZCTA5 36568,01,92,13750,-666666666,-666666666,92,62,76,25,21,13,0,17,68,68,0,68,55,13,2019-01-01,zipcode,Saint elmo
ZCTA5 36569,01,570,44137,-666666666,-666666666,501,281,496,80,194,195,25,2,368,225,143,225,181,44,2019-01-01,zipcode,Saint stephens
ZCTA5 36571,01,15474,58696,881,147200,12015,4993,10270,1439,3674,3215,1369,573,6294,5558,736,5558,4096,1462,2019-01-01,zipcode,Saraland
ZCTA5 36572,01,6159,64348,885,155800,4893,2292,4316,399,1781,1197,641,298,2316,2205,111,2205,1882,323,2019-01-01,zipcode,Satsuma
ZCTA5 36574,01,1123,-666666666,-666666666,201800,960,609,811,84,406,169,118,34,525,352,173,352,319,33,2019-01-01,zipcode,Seminole
ZCTA5 36575,01,21118,54921,779,148900,16028,6725,13869,1849,5524,4023,1677,796,8003,7372,631,7372,6028,1344,2019-01-01,zipcode,Semmes
ZCTA5 36576,01,4198,57338,871,171700,3525,1212,3231,373,1284,875,590,109,2027,1753,274,1753,1363,390,2019-01-01,zipcode,Silverhill
ZCTA5 36578,01,1436,80313,740,240900,1111,364,1006,44,245,468,142,107,697,533,164,533,489,44,2019-01-01,zipcode,Stapleton
ZCTA5 36579,01,1214,48182,588,127200,966,536,940,120,367,226,160,67,1155,522,633,522,444,78,2019-01-01,zipcode,Stockton
ZCTA5 36580,01,5507,47438,793,163300,4518,1908,3629,678,1351,1049,404,147,2377,1900,477,1900,1561,339,2019-01-01,zipcode,Summerdale
ZCTA5 36581,01,258,-666666666,-666666666,-666666666,221,101,221,0,213,8,0,0,176,106,70,106,89,17,2019-01-01,zipcode,Sunflower
ZCTA5 36582,01,24029,54544,735,125200,18044,7215,15782,2496,5454,4843,2225,764,9679,8548,1131,8548,6364,2184,2019-01-01,zipcode,Theodore
ZCTA5 36583,01,898,41181,-666666666,165000,646,402,582,60,231,203,66,22,328,297,31,297,244,53,2019-01-01,zipcode,Tibbie
ZCTA5 36584,01,856,69531,-666666666,83500,671,272,621,135,246,188,47,5,570,324,246,324,260,64,2019-01-01,zipcode,Vinegar bend
ZCTA5 36585,01,1242,31154,762,91500,844,405,792,86,274,279,32,121,422,338,84,338,275,63,2019-01-01,zipcode,Wagarville
ZCTA5 36587,01,10317,50529,811,105700,8488,4565,6948,1620,2986,1769,389,184,4249,3252,997,3252,2813,439,2019-01-01,zipcode,Wilmer
ZCTA5 36590,01,0,-666666666,-666666666,-666666666,0,0,0,0,0,0,0,0,0,0,0,0,0,0,2019-01-01,zipcode,Theodore
ZCTA5 36602,01,932,28750,446,203100,932,500,860,129,135,286,192,118,767,638,129,638,134,504,2019-01-01,zipcode,Mobile
ZCTA5 36603,01,9552,20801,640,82500,8025,5699,6826,1893,2388,1828,517,200,3825,2847,978,2847,1079,1768,2019-01-01,zipcode,Mobile
ZCTA5 36604,01,9423,47080,814,167000,7622,2571,6600,663,1331,1889,1545,1172,5165,4069,1096,4069,2193,1876,2019-01-01,zipcode,Mobile
ZCTA5 36605,01,27372,35632,843,79900,21365,9642,17956,2606,7565,5277,1769,739,12949,10375,2574,10375,5711,4664,2019-01-01,zipcode,Mobile
ZCTA5 36606,01,18787,40850,843,100100,14562,5393,12854,1446,4469,3266,2359,1314,9508,7937,1571,7937,4226,3711,2019-01-01,zipcode,Mobile
ZCTA5 36607,01,6398,37220,799,104100,5250,2252,4625,640,1417,1184,811,573,3381,2739,642,2739,1439,1300,2019-01-01,zipcode,Mobile
ZCTA5 36608,01,35336,51332,903,156800,29573,12029,23481,2008,5499,6788,5671,3515,17240,14959,2281,14959,7889,7070,2019-01-01,zipcode,Mobile
ZCTA5 36609,01,23492,40363,824,151200,19249,7239,16640,1445,4368,5509,3501,1817,13293,11311,1982,11311,4952,6359,2019-01-01,zipcode,Mobile
ZCTA5 36610,01,10728,25963,669,47800,8277,4754,7177,1527,3094,2002,397,157,5730,4001,1729,4001,2074,1927,2019-01-01,zipcode,Mobile
ZCTA5 36611,01,5817,28611,816,75500,4013,1778,3309,509,1291,1113,245,151,2589,2134,455,2134,1101,1033,2019-01-01,zipcode,Mobile
ZCTA5 36612,01,4626,22172,671,61500,3178,1793,2681,622,1130,779,69,81,1948,1618,330,1618,832,786,2019-01-01,zipcode,Mobile
ZCTA5 36613,01,13583,39113,862,107400,10508,5267,8605,1484,3526,2670,679,246,5051,4173,878,4173,3170,1003,2019-01-01,zipcode,Eight mile
ZCTA5 36615,01,0,-666666666,-666666666,-666666666,0,0,0,0,0,0,0,0,0,0,0,0,0,0,2019-01-01,zipcode,Mobile
ZCTA5 36616,01,8,-666666666,-666666666,-666666666,8,0,0,0,0,0,0,0,20,8,12,8,0,8,2019-01-01,zipcode,Mobile
ZCTA5 36617,01,13306,31192,917,74200,10762,5514,9300,1402,3567,2769,916,646,5962,4941,1021,4941,2739,2202,2019-01-01,zipcode,Mobile
ZCTA5 36618,01,17143,44531,858,107100,13859,6337,11571,1301,3853,3769,1656,992,7358,6653,705,6653,5188,1465,2019-01-01,zipcode,Mobile
ZCTA5 36619,01,15507,50739,869,133600,12475,5235,10977,1416,4074,3240,1730,517,6549,5831,718,5831,4428,1403,2019-01-01,zipcode,Mobile
ZCTA5 36688,01,237,-666666666,-666666666,-666666666,237,147,0,0,0,0,0,0,0,0,0,0,0,0,2019-01-01,zipcode,Mobile
ZCTA5 36693,01,19721,61155,924,149500,16241,6257,14005,811,3666,4381,3498,1649,8836,7682,1154,7682,5158,2524,2019-01-01,zipcode,Mobile
ZCTA5 36695,01,51804,69084,1040,186900,40640,14825,34242,2225,9369,10483,8337,3828,20442,18981,1461,18981,12583,6398,2019-01-01,zipcode,Mobile
ZCTA5 36701,01,20558,37110,681,89900,16041,7223,13735,2032,4602,4659,1343,1099,11177,8526,2651,8526,4983,3543,2019-01-01,zipcode,Selma
ZCTA5 36703,01,12927,29990,602,78300,10065,5051,8518,1771,3481,2382,547,337,5953,5067,886,5067,2747,2320,2019-01-01,zipcode,Selma
ZCTA5 36720,01,963,17941,533,56300,771,526,523,180,137,132,58,16,454,342,112,342,266,76,2019-01-01,zipcode,Alberta
ZCTA5 36722,01,441,29722,-666666666,90200,388,228,309,71,132,106,0,0,278,172,106,172,109,63,2019-01-01,zipcode,Arlington
ZCTA5 36723,01,371,16343,-666666666,-666666666,193,129,176,70,42,64,0,0,225,127,98,127,65,62,2019-01-01,zipcode,Boykin
ZCTA5 36726,01,4706,34205,451,84500,3615,1990,3220,703,1283,764,357,113,2453,1707,746,1707,1057,650,2019-01-01,zipcode,Camden
ZCTA5 36727,01,12,-666666666,-666666666,-666666666,12,5,12,0,5,7,0,0,60,12,48,12,12,0,2019-01-01,zipcode,Campbell
ZCTA5 36728,01,214,19276,-666666666,53500,202,107,178,59,51,40,7,21,192,104,88,104,73,31,2019-01-01,zipcode,Catherine
ZCTA5 36732,01,7706,28056,529,117500,6179,2872,5009,762,1612,1566,583,486,3911,3018,893,3018,1772,1246,2019-01-01,zipcode,Demopolis
ZCTA5 36736,01,1633,64792,943,75800,968,484,887,120,340,164,123,140,568,459,109,459,378,81,2019-01-01,zipcode,Dixons mills
ZCTA5 36738,01,718,32765,-666666666,107400,646,422,524,56,262,130,54,22,341,245,96,245,202,43,2019-01-01,zipcode,Faunsdale
ZCTA5 36740,01,1276,34521,590,91300,1080,619,919,186,371,251,51,60,914,472,442,472,334,138,2019-01-01,zipcode,Forkland
ZCTA5 36742,01,1921,47466,583,57000,1744,1005,1399,305,566,362,84,82,1108,743,365,743,606,137,2019-01-01,zipcode,Gallion
ZCTA5 36744,01,6294,29675,474,81000,5147,2655,4230,652,2011,954,439,174,3380,2537,843,2537,1684,853,2019-01-01,zipcode,Greensboro
ZCTA5 36748,01,2419,40208,658,84000,2138,1244,1818,204,773,607,83,151,1523,993,530,993,728,265,2019-01-01,zipcode,Linden
ZCTA5 36749,01,949,27266,-666666666,96700,851,509,687,189,289,162,27,20,462,399,63,399,250,149,2019-01-01,zipcode,Jones
ZCTA5 36750,01,2622,41944,398,110900,1942,1016,1744,349,795,478,46,76,1175,982,193,982,769,213,2019-01-01,zipcode,Maplesville
ZCTA5 36751,01,632,32143,659,32600,460,261,335,213,87,8,8,19,307,236,71,236,191,45,2019-01-01,zipcode,Lower peach tree
ZCTA5 36752,01,1146,-666666666,-666666666,106600,962,475,927,64,221,471,109,62,778,611,167,611,568,43,2019-01-01,zipcode,Lowndesboro
ZCTA5 36753,01,8,-666666666,-666666666,-666666666,8,8,8,8,0,0,0,0,23,8,15,8,0,8,2019-01-01,zipcode,Mc williams
ZCTA5 36754,01,473,-666666666,-666666666,194400,473,250,427,221,150,44,0,12,278,188,90,188,116,72,2019-01-01,zipcode,Magnolia
ZCTA5 36756,01,5867,25553,506,80800,4916,3044,3677,668,1303,824,449,433,2694,1866,828,1866,1302,564,2019-01-01,zipcode,Marion
ZCTA5 36758,01,1412,52212,-666666666,75000,1102,546,942,141,493,185,83,40,626,519,107,519,460,59,2019-01-01,zipcode,Plantersville
ZCTA5 36759,01,1831,37250,-666666666,70400,1404,720,1264,226,417,383,178,60,853,673,180,673,579,94,2019-01-01,zipcode,Marion junction
ZCTA5 36761,01,787,25750,832,45800,674,398,571,184,202,133,30,22,631,374,257,374,290,84,2019-01-01,zipcode,Minter
ZCTA5 36763,01,316,36250,806,-666666666,184,95,171,65,56,42,5,3,100,66,34,66,49,17,2019-01-01,zipcode,Myrtlewood
ZCTA5 36765,01,1685,22807,1005,59000,1276,797,1068,269,575,185,31,8,689,568,121,568,508,60,2019-01-01,zipcode,Newbern
ZCTA5 36766,01,22,-666666666,-666666666,135000,22,11,22,6,0,0,9,7,22,16,6,16,12,4,2019-01-01,zipcode,Oak hill
ZCTA5 36767,01,1476,22891,504,42400,1246,679,1017,361,285,251,96,24,1056,651,405,651,444,207,2019-01-01,zipcode,Orrville
ZCTA5 36768,01,900,28750,733,59200,817,403,666,64,220,283,67,32,669,344,325,344,290,54,2019-01-01,zipcode,Pine apple
ZCTA5 36769,01,2444,35197,526,75000,1957,1233,1650,319,808,347,128,48,1332,914,418,914,623,291,2019-01-01,zipcode,Pine hill
ZCTA5 36773,01,469,28507,664,109800,376,236,229,57,29,117,19,7,244,185,59,185,98,87,2019-01-01,zipcode,Safford
ZCTA5 36775,01,1025,35921,672,60800,761,354,708,100,243,316,44,5,569,402,167,402,313,89,2019-01-01,zipcode,Sardis
ZCTA5 36776,01,1856,28182,-666666666,76200,1503,740,1144,136,354,477,147,30,821,576,245,576,484,92,2019-01-01,zipcode,Sawyerville
ZCTA5 36782,01,2685,38214,339,75700,2002,1058,1810,250,687,703,146,24,1323,948,375,948,873,75,2019-01-01,zipcode,Sweet water
ZCTA5 36783,01,686,27143,461,73900,628,333,598,54,266,162,52,64,653,362,291,362,295,67,2019-01-01,zipcode,Thomaston
ZCTA5 36784,01,7181,37832,536,152400,5767,3173,5100,900,2254,1265,454,227,3680,2863,817,2863,1752,1111,2019-01-01,zipcode,Thomasville
ZCTA5 36785,01,1074,34079,756,93200,885,462,816,201,331,183,95,6,751,528,223,528,399,129,2019-01-01,zipcode,Tyler
ZCTA5 36786,01,2474,18281,492,59100,1830,1101,1608,223,635,342,287,121,1493,921,572,921,647,274,2019-01-01,zipcode,Uniontown
ZCTA5 36790,01,89,-666666666,-666666666,49300,89,56,56,0,7,49,0,0,59,59,0,59,59,0,2019-01-01,zipcode,Stanton
ZCTA5 36792,01,1396,69189,-666666666,113800,1009,479,943,93,379,417,17,37,745,492,253,492,410,82,2019-01-01,zipcode,Randolph
ZCTA5 36793,01,279,-666666666,-666666666,154100,250,118,190,15,95,61,0,19,192,90,102,90,72,18,2019-01-01,zipcode,Lawley
ZCTA5 36801,01,25071,46713,734,158300,19900,7027,17096,1669,5247,5125,2704,2351,10786,9854,932,9854,6132,3722,2019-01-01,zipcode,Opelika
ZCTA5 36804,01,18535,51159,805,101900,14569,5918,12789,1672,3771,4493,1923,930,7281,6927,354,6927,5431,1496,2019-01-01,zipcode,Opelika
ZCTA5 36830,01,39476,53972,887,268900,31790,11995,22794,1366,2778,5570,6969,6111,17534,15437,2097,15437,7933,7504,2019-01-01,zipcode,Auburn
ZCTA5 36832,01,24596,30603,862,119900,21212,8535,11186,927,2031,3232,2896,2100,13297,10234,3063,10234,4140,6094,2019-01-01,zipcode,Auburn
ZCTA5 36849,01,4185,-666666666,-666666666,-666666666,4185,3039,24,0,10,5,9,0,0,0,0,0,0,0,2019-01-01,zipcode,Auburn university
ZCTA5 36850,01,2612,33832,355,64900,2177,1134,1762,320,647,627,101,67,1391,1015,376,1015,810,205,2019-01-01,zipcode,Camp hill
ZCTA5 36852,01,2744,24718,784,89900,2139,973,1826,263,776,571,165,51,1193,956,237,956,685,271,2019-01-01,zipcode,Cusseta
ZCTA5 36853,01,7943,54248,705,166500,6695,3790,5928,861,1946,1508,1028,585,6025,3314,2711,3314,2726,588,2019-01-01,zipcode,Dadeville
ZCTA5 36854,01,15138,52093,795,117400,11971,4834,10108,1385,3483,3497,1221,522,7391,5811,1580,5811,3612,2199,2019-01-01,zipcode,Valley
ZCTA5 36855,01,1638,50016,730,139900,1328,528,1240,225,482,357,130,46,806,649,157,649,495,154,2019-01-01,zipcode,Five points
ZCTA5 36856,01,7811,72580,1433,198000,5660,2251,5041,487,1079,2035,1039,401,2746,2631,115,2631,2198,433,2019-01-01,zipcode,Fort mitchell
ZCTA5 36858,01,330,37917,632,96300,277,152,262,49,112,35,38,28,211,152,59,152,125,27,2019-01-01,zipcode,Hatchechubbee
ZCTA5 36859,01,16,-666666666,-666666666,-666666666,16,16,16,16,0,0,0,0,8,8,0,8,8,0,2019-01-01,zipcode,
ZCTA5 36860,01,1728,32209,671,67500,1492,805,1272,378,442,368,48,36,981,668,313,668,470,198,2019-01-01,zipcode,Hurtsboro
ZCTA5 36861,01,3013,49250,665,144200,2605,1191,2437,546,804,579,341,167,2050,1351,699,1351,1149,202,2019-01-01,zipcode,Jacksons gap
ZCTA5 36862,01,5868,34531,595,94800,4822,2450,4266,1006,1581,1295,261,123,2842,2326,516,2326,1610,716,2019-01-01,zipcode,Lafayette
ZCTA5 36863,01,11847,38538,722,98900,9753,4182,8492,1712,3070,2473,857,380,6239,4899,1340,4899,3461,1438,2019-01-01,zipcode,Lanett
ZCTA5 36865,01,30,43750,-666666666,112500,30,13,21,0,11,9,1,0,20,12,8,12,9,3,2019-01-01,zipcode,Loachapoka
ZCTA5 36866,01,3581,39409,605,79800,2956,1165,2701,431,1114,764,273,119,2007,1616,391,1616,1256,360,2019-01-01,zipcode,Notasulga
ZCTA5 36867,01,22239,45702,835,141500,17815,6283,14998,1826,4237,5318,2082,1535,10845,9428,1417,9428,4694,4734,2019-01-01,zipcode,Phenix city
ZCTA5 36869,01,20986,36333,802,105200,16103,7061,13468,2703,4447,4358,1279,681,9971,8162,1809,8162,4828,3334,2019-01-01,zipcode,Phenix city
ZCTA5 36870,01,19413,54067,798,137600,15275,5579,12933,1699,3510,5420,1166,1138,8192,7284,908,7284,5326,1958,2019-01-01,zipcode,Phenix city
ZCTA5 36871,01,1175,27197,393,84700,1003,565,947,92,477,198,148,32,692,496,196,496,429,67,2019-01-01,zipcode,Pittsview
ZCTA5 36874,01,9973,62722,1058,161500,7720,3268,6676,465,2420,2264,817,710,3941,3425,516,3425,2971,454,2019-01-01,zipcode,Salem
ZCTA5 36875,01,3782,54239,797,130900,3181,1448,2911,402,889,1196,262,162,1867,1638,229,1638,1226,412,2019-01-01,zipcode,Seale
ZCTA5 36877,01,12848,52076,893,154700,10321,3944,8961,986,2524,3488,1118,845,5412,4851,561,4851,3314,1537,2019-01-01,zipcode,Smiths station
ZCTA5 36879,01,2521,99489,930,250100,1940,617,1802,126,391,392,478,415,1081,903,178,903,819,84,2019-01-01,zipcode,Waverly
ZCTA5 36901,01,369,30580,-666666666,50000,369,256,332,69,215,48,0,0,181,181,0,181,110,71,2019-01-01,zipcode,Bellamy
ZCTA5 36904,01,3734,36194,493,84600,3046,1632,2601,339,977,836,314,135,2111,1512,599,1512,1093,419,2019-01-01,zipcode,Butler
ZCTA5 36907,01,1597,23590,684,76600,1343,832,1097,111,430,185,207,164,1013,736,277,736,641,95,2019-01-01,zipcode,Cuba
ZCTA5 36908,01,2176,55164,444,78100,1774,1008,1582,248,627,560,117,30,1128,839,289,839,755,84,2019-01-01,zipcode,Gilbertown
ZCTA5 36910,01,63,-666666666,-666666666,-666666666,63,63,63,0,31,32,0,0,66,31,35,31,0,31,2019-01-01,zipcode,Jachin
ZCTA5 36912,01,2069,32634,703,69500,1773,1106,1604,239,626,586,69,84,1155,829,326,829,659,170,2019-01-01,zipcode,Lisman
ZCTA5 36913,01,36,-666666666,-666666666,-666666666,36,36,36,28,0,8,0,0,17,17,0,17,17,0,2019-01-01,zipcode,Melvin
ZCTA5 36915,01,654,33125,-666666666,52700,503,265,418,40,133,172,72,1,387,241,146,241,165,76,2019-01-01,zipcode,Needham
ZCTA5 36916,01,797,30000,438,49400,676,468,641,155,268,176,9,33,510,334,176,334,265,69,2019-01-01,zipcode,Pennington
ZCTA5 36919,01,1652,29333,558,71200,1341,794,1177,297,451,329,59,41,993,722,271,722,590,132,2019-01-01,zipcode,Silas
ZCTA5 36921,01,771,25238,675,74600,726,433,648,176,256,159,50,7,544,416,128,416,400,16,2019-01-01,zipcode,Toxey
ZCTA5 36922,01,600,36136,-666666666,62100,482,266,374,186,113,67,0,8,323,230,93,230,199,31,2019-01-01,zipcode,Ward
ZCTA5 36925,01,3001,30904,498,45700,2451,1178,2182,349,704,761,208,160,1583,1246,337,1246,804,442,2019-01-01,zipcode,York
ZCTA5 75001,48,14992,72512,1351,321000,12978,2156,11371,520,1310,3241,4294,2006,9298,8129,1169,8129,1391,6738,2019-01-01,zipcode,Addison
ZCTA5 75002,48,71253,101429,1527,276000,53721,15326,45454,2485,7377,13968,14713,6911,23314,22414,900,22414,17640,4774,2019-01-01,zipcode,Allen
ZCTA5 75006,48,51642,64462,1179,204900,40225,10895,34127,7004,8521,8180,7246,3176,19178,18580,598,18580,9408,9172,2019-01-01,zipcode,Carrollton
ZCTA5 75007,48,55500,86648,1276,240000,45821,13339,39188,3793,8395,10718,11687,4595,20000,19465,535,19465,14069,5396,2019-01-01,zipcode,Carrollton
ZCTA5 75009,48,14089,111146,1578,302000,10038,3113,8924,875,1863,3098,2352,736,4568,4207,361,4207,3352,855,2019-01-01,zipcode,Celina
ZCTA5 75010,48,30406,85946,1316,319200,24824,5709,21358,1396,3229,6137,7436,3160,12791,11834,957,11834,5499,6335,2019-01-01,zipcode,Carrollton
ZCTA5 75013,48,42629,130509,1456,417600,31831,9057,27256,714,2796,5941,10075,7730,15202,14569,633,14569,10492,4077,2019-01-01,zipcode,Allen
ZCTA5 75019,48,42888,118740,1448,388700,32982,8625,29239,769,2251,5952,11648,8619,16745,16212,533,16212,11199,5013,2019-01-01,zipcode,Coppell
ZCTA5 75020,48,23232,50081,804,115500,18599,7835,16203,1620,5191,6294,1950,1148,10170,8895,1275,8895,5556,3339,2019-01-01,zipcode,Denison
ZCTA5 75021,48,8847,45941,854,130700,7018,2991,6306,884,2329,2157,586,350,3607,3312,295,3312,2570,742,2019-01-01,zipcode,Denison
ZCTA5 75022,48,27201,162351,1877,428600,20460,5698,17152,509,1838,3321,7071,4413,8557,8372,185,8372,7697,675,2019-01-01,zipcode,Flower mound
ZCTA5 75023,48,50431,90193,1503,259000,41279,12729,35974,1932,5231,10703,12237,5871,18911,18196,715,18196,11207,6989,2019-01-01,zipcode,Plano
ZCTA5 75024,48,43551,102524,1412,410100,34963,9267,30617,631,2800,5192,13023,8971,19233,17791,1442,17791,7462,10329,2019-01-01,zipcode,Plano
ZCTA5 75025,48,53764,118505,1483,351300,42179,13130,36249,1341,3673,7409,13488,10338,19322,18662,660,18662,12848,5814,2019-01-01,zipcode,Plano
ZCTA5 75028,48,47804,127931,1729,324200,36576,9758,31738,997,3936,8113,12432,6260,16668,16262,406,16262,13453,2809,2019-01-01,zipcode,Flower mound
ZCTA5 75032,48,33080,109080,1313,330400,25658,8304,21637,1908,3269,6704,5963,3793,11722,11355,367,11355,9346,2009,2019-01-01,zipcode,Rockwall
ZCTA5 75034,48,108525,117707,1403,409900,80687,23864,69175,2675,7141,16867,26292,16200,40900,38172,2728,38172,25583,12589,2019-01-01,zipcode,Frisco
ZCTA5 75035,48,75485,134636,1848,364700,54132,14073,47289,1566,4301,10737,18094,12591,25587,24220,1367,24220,19227,4993,2019-01-01,zipcode,Frisco
ZCTA5 75038,48,29990,61692,1097,266700,23325,5374,19889,1368,4680,4801,5631,3409,13601,12381,1220,12381,2090,10291,2019-01-01,zipcode,Irving
ZCTA5 75039,48,20108,92224,1497,455300,16848,2807,15602,210,1040,3139,6020,5193,11306,10160,1146,10160,1646,8514,2019-01-01,zipcode,Irving
ZCTA5 75040,48,62417,63924,1223,152900,47491,14443,39110,10731,9660,11425,5141,2153,19278,18295,983,18295,12796,5499,2019-01-01,zipcode,Garland
ZCTA5 75041,48,30880,50395,1047,131700,22146,7165,18165,5885,5119,4818,1703,640,9985,9199,786,9199,5568,3631,2019-01-01,zipcode,Garland
ZCTA5 75042,48,39183,50549,969,144600,29088,9460,23410,8477,5579,5979,2460,915,11946,11312,634,11312,5850,5462,2019-01-01,zipcode,Garland
ZCTA5 75043,48,62601,63331,1137,166300,47159,13914,40014,5858,9665,14289,6616,3586,22177,21088,1089,21088,12455,8633,2019-01-01,zipcode,Garland
ZCTA5 75044,48,43292,69254,1237,202100,35199,10652,30015,3572,6345,8774,7657,3667,15875,15333,542,15333,10348,4985,2019-01-01,zipcode,Garland
ZCTA5 75048,48,25598,102096,1486,243100,20001,5829,16824,2036,3470,5600,3880,1838,8422,8115,307,8115,7087,1028,2019-01-01,zipcode,Sachse
ZCTA5 75050,48,43174,58567,1069,130400,32694,9201,26248,6593,7546,7068,3307,1734,16239,14693,1546,14693,6474,8219,2019-01-01,zipcode,Grand prairie
ZCTA5 75051,48,40923,42922,934,100300,29691,10538,23837,8354,8436,4809,1540,698,13854,12754,1100,12754,6078,6676,2019-01-01,zipcode,Grand prairie
ZCTA5 75052,48,95495,78660,1319,172700,72751,20405,60549,7853,15574,20451,11626,5045,31389,29675,1714,29675,22060,7615,2019-01-01,zipcode,Grand prairie
ZCTA5 75054,48,11927,133802,1982,328700,8503,2054,7259,288,818,2082,2360,1711,3592,3486,106,3486,3043,443,2019-01-01,zipcode,Grand prairie
ZCTA5 75056,48,60554,89252,1354,276100,47525,10334,41593,2779,7400,12627,13237,5550,24122,22537,1585,22537,14204,8333,2019-01-01,zipcode,The colony
ZCTA5 75057,48,14960,57216,1227,128000,11499,2638,9462,2058,2185,2732,1930,557,5897,5181,716,5181,1939,3242,2019-01-01,zipcode,Lewisville
ZCTA5 75058,48,2666,98750,1164,328600,2010,758,1703,134,409,506,461,193,935,873,62,873,712,161,2019-01-01,zipcode,Gunter
ZCTA5 75060,48,47764,57907,980,135200,34941,10271,28588,10093,7757,6169,3349,1220,14581,13818,763,13818,8539,5279,2019-01-01,zipcode,Irving
ZCTA5 75061,48,54520,49400,962,145400,39845,10936,32319,11512,8334,7262,3628,1583,18655,17245,1410,17245,6656,10589,2019-01-01,zipcode,Irving
ZCTA5 75062,48,49306,55392,1065,153100,37560,10596,29923,6535,7277,8147,5360,2604,16954,16177,777,16177,6635,9542,2019-01-01,zipcode,Irving
ZCTA5 75063,48,40048,96053,1264,361900,30680,7538,27635,673,2325,4890,10628,9119,16910,16119,791,16119,6386,9733,2019-01-01,zipcode,Irving
ZCTA5 75065,48,12640,75266,1218,196400,10037,2984,9012,948,2346,3266,1771,681,4684,4561,123,4561,3434,1127,2019-01-01,zipcode,Lake dallas
ZCTA5 75067,48,68196,63939,1189,210800,53215,12229,45664,6024,10507,13260,11234,4639,26932,24812,2120,24812,9582,15230,2019-01-01,zipcode,Lewisville
ZCTA5 75068,48,65991,104692,1686,260600,47251,10719,41204,2783,7436,12698,11738,6549,21460,20590,870,20590,16711,3879,2019-01-01,zipcode,Little elm
ZCTA5 75069,48,37892,58106,1116,275700,30045,11100,25069,4893,5952,5993,5415,2816,14956,13816,1140,13816,7032,6784,2019-01-01,zipcode,Mckinney
ZCTA5 75070,48,104415,102650,1546,322600,77115,21723,67016,2245,8132,19840,25124,11675,38662,36849,1813,36849,25680,11169,2019-01-01,zipcode,Mckinney
ZCTA5 75071,48,55570,103982,1639,310000,41112,12918,35093,2239,5725,11061,10809,5259,18802,17814,988,17814,13332,4482,2019-01-01,zipcode,Mckinney
ZCTA5 75074,48,52259,70680,1325,228900,40851,10867,34085,5968,6506,9125,8427,4059,19078,17907,1171,17907,9454,8453,2019-01-01,zipcode,Plano
ZCTA5 75075,48,38283,80603,1340,271000,32168,10637,27148,1948,4536,7759,8469,4436,15370,14421,949,14421,8986,5435,2019-01-01,zipcode,Plano
ZCTA5 75076,48,8156,53267,986,145500,6668,2446,5914,420,1668,2369,1063,394,4495,3322,1173,3322,2550,772,2019-01-01,zipcode,Pottsboro
ZCTA5 75077,48,37102,108687,1465,301600,29569,8981,25407,966,4372,8141,8394,3534,13142,12667,475,12667,10231,2436,2019-01-01,zipcode,Lewisville
ZCTA5 75078,48,28803,151066,1520,453500,19977,6080,17190,419,2125,4564,6888,3194,8989,8486,503,8486,7498,988,2019-01-01,zipcode,Prosper
ZCTA5 75080,48,52531,77736,1398,287100,42450,14757,33072,3321,3943,7575,11291,6942,20085,18856,1229,18856,10408,8448,2019-01-01,zipcode,Richardson
ZCTA5 75081,48,40265,77174,1330,229200,32001,10063,27816,2304,4333,8890,8722,3567,15888,15029,859,15029,8578,6451,2019-01-01,zipcode,Richardson
ZCTA5 75082,48,23483,118929,1633,343800,18874,5916,16265,361,1629,3481,6451,4343,8953,8410,543,8410,6294,2116,2019-01-01,zipcode,Richardson
ZCTA5 75087,48,35157,103423,1352,276300,26805,9284,23237,1051,3677,7658,6810,4041,12879,12415,464,12415,10079,2336,2019-01-01,zipcode,Rockwall
ZCTA5 75088,48,26039,93703,1588,219600,20983,6197,18613,1283,4426,6684,4019,2201,9606,9177,429,9177,7865,1312,2019-01-01,zipcode,Rowlett
ZCTA5 75089,48,36324,107111,1643,236400,27830,7192,23997,1433,5178,8360,6282,2744,11696,11492,204,11492,9882,1610,2019-01-01,zipcode,Rowlett
ZCTA5 75090,48,25418,42130,867,89500,19409,7742,15988,2895,5386,5620,1311,776,9456,8393,1063,8393,5326,3067,2019-01-01,zipcode,Sherman
ZCTA5 75092,48,24905,56855,897,162800,19638,6776,16782,1478,3791,6782,3172,1559,11177,9968,1209,9968,5494,4474,2019-01-01,zipcode,Sherman
ZCTA5 75093,48,46788,112930,1479,457200,38377,12560,33973,885,2912,6364,13891,9921,20430,18802,1628,18802,11972,6830,2019-01-01,zipcode,Plano
ZCTA5 75094,48,23239,125990,2138,347400,16571,5270,14139,691,2022,3467,4864,3095,6194,6133,61,6133,5202,931,2019-01-01,zipcode,Plano
ZCTA5 75098,48,56376,94641,1506,233600,41540,10601,34959,2709,7801,11623,9065,3761,17998,17367,631,17367,13862,3505,2019-01-01,zipcode,Wylie
ZCTA5 75101,48,517,47143,888,68800,390,160,342,138,112,77,10,5,201,170,31,170,121,49,2019-01-01,zipcode,Bardwell
ZCTA5 75102,48,1358,53929,937,101600,1015,365,877,220,258,257,138,4,708,508,200,508,375,133,2019-01-01,zipcode,Barry
ZCTA5 75103,48,14530,61083,1012,157200,11929,5971,10561,1263,3450,3987,1407,454,6238,5464,774,5464,4526,938,2019-01-01,zipcode,Canton
ZCTA5 75104,48,49171,73171,1374,170600,36634,10847,30676,2818,7525,11199,5745,3389,16432,15621,811,15621,10982,4639,2019-01-01,zipcode,Cedar hill
ZCTA5 75105,48,161,42212,-666666666,156700,147,78,95,13,31,34,17,0,72,51,21,51,47,4,2019-01-01,zipcode,Chatfield
ZCTA5 75109,48,4384,58813,1319,138400,3481,1362,3065,270,833,1237,443,282,2081,1703,378,1703,1381,322,2019-01-01,zipcode,Corsicana
ZCTA5 75110,48,28558,44906,797,95500,21654,7997,18179,4571,4781,6085,1731,1011,11318,9935,1383,9935,6243,3692,2019-01-01,zipcode,Corsicana
ZCTA5 75114,48,6829,75673,1154,157600,5283,1568,4458,842,1599,1338,483,196,2211,2013,198,2013,1615,398,2019-01-01,zipcode,Crandall
ZCTA5 75115,48,52916,72084,1190,170000,40573,12773,35397,3728,7593,14125,6320,3631,20307,19183,1124,19183,12267,6916,2019-01-01,zipcode,Desoto
ZCTA5 75116,48,19867,45827,1057,137100,14741,5592,12146,2436,3347,4156,1367,840,7045,6574,471,6574,3697,2877,2019-01-01,zipcode,Duncanville
ZCTA5 75117,48,3984,54877,920,151200,2947,1293,2556,247,828,962,342,177,1710,1487,223,1487,1099,388,2019-01-01,zipcode,Edgewood
ZCTA5 75119,48,28598,60229,921,119800,21943,7645,17983,4310,5811,4942,2060,860,10451,9509,942,9509,6584,2925,2019-01-01,zipcode,Ennis
ZCTA5 75124,48,4255,54432,717,120000,3614,1888,3270,442,1323,1078,242,185,2328,1717,611,1717,1398,319,2019-01-01,zipcode,Eustace
ZCTA5 75125,48,6326,63927,1019,84600,4720,1893,3859,1331,1042,1044,222,220,2224,2063,161,2063,1620,443,2019-01-01,zipcode,Ferris
ZCTA5 75126,48,48987,99729,1564,219700,34942,8752,29647,2225,7758,10959,6034,2671,14883,14280,603,14280,12294,1986,2019-01-01,zipcode,Forney
ZCTA5 75127,48,1705,44722,732,113900,1353,688,1146,237,505,284,81,39,671,606,65,606,437,169,2019-01-01,zipcode,Fruitvale
ZCTA5 75132,48,1559,76765,-666666666,209800,1121,229,1083,10,345,313,260,155,699,602,97,602,544,58,2019-01-01,zipcode,Fate
ZCTA5 75134,48,21879,54140,1049,136900,15772,4510,13013,1820,3732,5066,1572,823,7710,7274,436,7274,3990,3284,2019-01-01,zipcode,Lancaster
ZCTA5 75135,48,7363,78580,1002,146500,5596,2017,4869,461,1782,2121,347,158,2494,2358,136,2358,1949,409,2019-01-01,zipcode,Caddo mills
ZCTA5 75137,48,19548,65291,1272,165500,15492,5692,12809,1485,3401,4413,2026,1484,7429,6932,497,6932,4930,2002,2019-01-01,zipcode,Duncanville
ZCTA5 75140,48,7595,48031,720,114200,5808,2957,4777,1084,1723,1473,345,152,2791,2337,454,2337,1784,553,2019-01-01,zipcode,Grand saline
ZCTA5 75141,48,5782,35707,1040,69500,4594,3064,3641,1112,1461,819,153,96,1229,1131,98,1131,698,433,2019-01-01,zipcode,Hutchins
ZCTA5 75142,48,19261,55700,968,116100,14550,5381,12361,2754,4352,3769,964,522,6223,5642,581,5642,4075,1567,2019-01-01,zipcode,Kaufman
ZCTA5 75143,48,14510,50390,850,103600,11681,5383,9944,2045,3722,2566,1169,442,7439,5339,2100,5339,4236,1103,2019-01-01,zipcode,Kemp
ZCTA5 75144,48,3668,44219,802,91200,3027,1330,2570,266,1030,822,259,193,1735,1361,374,1361,923,438,2019-01-01,zipcode,Kerens
ZCTA5 75146,48,19701,60701,1113,142800,14236,3976,12084,1193,3346,4704,1819,1022,7401,6873,528,6873,4335,2538,2019-01-01,zipcode,Lancaster
ZCTA5 75147,48,6636,43154,795,121900,5446,2214,4709,586,2104,1362,472,185,2874,2480,394,2480,1718,762,2019-01-01,zipcode,Mabank
ZCTA5 75148,48,5961,36648,777,95700,4707,2370,4089,700,1262,1551,401,175,3318,2227,1091,2227,1560,667,2019-01-01,zipcode,Malakoff
ZCTA5 75149,48,56473,50648,1048,119900,41185,13910,33535,8088,10210,10703,3254,1280,19154,18138,1016,18138,11294,6844,2019-01-01,zipcode,Mesquite
ZCTA5 75150,48,60671,54440,1113,138000,45379,14206,36985,6988,11402,11584,4739,2272,23261,21086,2175,21086,9771,11315,2019-01-01,zipcode,Mesquite
ZCTA5 75152,48,5195,67460,1201,117600,3609,1162,2996,521,1047,883,393,152,1856,1636,220,1636,1234,402,2019-01-01,zipcode,Palmer
ZCTA5 75153,48,441,54038,674,97100,359,167,336,110,78,111,37,0,165,128,37,128,110,18,2019-01-01,zipcode,Powell
ZCTA5 75154,48,40947,78699,1246,187500,30720,9680,25772,3331,7086,8797,4415,2143,13705,12899,806,12899,10249,2650,2019-01-01,zipcode,Red oak
ZCTA5 75155,48,3233,53698,861,93900,2250,901,1901,649,596,513,104,39,1031,947,84,947,780,167,2019-01-01,zipcode,Rice
ZCTA5 75156,48,16578,47857,726,115400,13729,6789,12077,2098,4596,3561,1232,590,9478,6730,2748,6730,5080,1650,2019-01-01,zipcode,Mabank
ZCTA5 75157,48,261,40500,817,65800,195,72,175,48,71,42,11,3,125,98,27,98,73,25,2019-01-01,zipcode,Rosser
ZCTA5 75158,48,4191,63750,974,164200,3296,1496,3010,315,1114,1048,329,204,1508,1373,135,1373,1186,187,2019-01-01,zipcode,Scurry
ZCTA5 75159,48,20098,55712,980,121600,15246,7183,12876,3654,4366,3320,1013,523,5699,5359,340,5359,3960,1399,2019-01-01,zipcode,Seagoville
ZCTA5 75160,48,25525,54596,990,138000,19785,7348,17058,3072,5487,5418,2097,984,9094,8313,781,8313,5211,3102,2019-01-01,zipcode,Terrell
ZCTA5 75161,48,6529,58125,1014,137500,5314,2066,4691,727,2228,1321,250,165,2261,2106,155,2106,1758,348,2019-01-01,zipcode,Terrell
ZCTA5 75163,48,2716,40806,1015,76000,2352,1345,2128,512,829,579,151,57,1688,1164,524,1164,860,304,2019-01-01,zipcode,Trinidad
ZCTA5 75164,48,633,48656,1069,152700,520,187,426,38,260,96,18,14,283,265,18,265,194,71,2019-01-01,zipcode,Josephine
ZCTA5 75165,48,45059,69827,1092,187300,34745,12082,29294,3741,7982,10840,4736,1995,16595,15459,1136,15459,9604,5855,2019-01-01,zipcode,Waxahachie
ZCTA5 75166,48,4395,93047,1680,252500,3192,807,2769,107,687,1114,584,277,1389,1389,0,1389,1226,163,2019-01-01,zipcode,Lavon
ZCTA5 75167,48,12170,104907,-666666666,260100,9275,2774,8058,1054,1796,2928,1737,543,3907,3656,251,3656,3460,196,2019-01-01,zipcode,Waxahachie
ZCTA5 75169,48,14142,47674,754,101800,11307,5322,9962,1970,3587,3298,842,265,6510,5379,1131,5379,4072,1307,2019-01-01,zipcode,Wills point
ZCTA5 75172,48,4619,44891,913,59500,3432,1289,2954,899,856,993,183,23,1477,1384,93,1384,775,609,2019-01-01,zipcode,Wilmer
ZCTA5 75173,48,4409,79150,1076,207400,3461,1094,3037,327,1224,926,369,191,1574,1421,153,1421,1284,137,2019-01-01,zipcode,Nevada
ZCTA5 75180,48,23941,50278,1059,102800,16672,4988,13305,5496,3457,3426,682,244,7186,6372,814,6372,3786,2586,2019-01-01,zipcode,Balch springs
ZCTA5 75181,48,28263,88149,1697,182500,20456,6031,17234,2398,4554,6304,2565,1413,8228,8040,188,8040,6984,1056,2019-01-01,zipcode,Mesquite
ZCTA5 75182,48,6325,136118,-666666666,380400,4810,1549,4130,326,756,1098,1210,740,1911,1860,51,1860,1797,63,2019-01-01,zipcode,Sunnyvale
ZCTA5 75189,48,29135,90694,1552,208800,21344,6256,18231,1769,5591,6124,3495,1252,9691,9258,433,9258,7836,1422,2019-01-01,zipcode,Royse city
ZCTA5 75201,48,17476,97104,1757,545700,16638,2395,14136,277,992,2215,6510,4142,11722,10335,1387,10335,1174,9161,2019-01-01,zipcode,Dallas
ZCTA5 75202,48,2312,79766,1487,243700,2177,298,1867,21,59,373,931,483,1994,1497,497,1497,337,1160,2019-01-01,zipcode,Dallas
ZCTA5 75203,48,17367,39285,851,84700,13432,4032,11177,3753,3281,2371,1212,560,7324,6425,899,6425,1816,4609,2019-01-01,zipcode,Dallas
ZCTA5 75204,48,30537,81529,1492,381600,27939,5006,23402,1708,1961,3927,8923,6883,20719,17628,3091,17628,3475,14153,2019-01-01,zipcode,Dallas
ZCTA5 75205,48,24877,156636,1552,1201800,20236,8061,15109,199,674,1683,6508,6045,10737,9316,1421,9316,6108,3208,2019-01-01,zipcode,Dallas
ZCTA5 75206,48,39010,71135,1283,400500,34298,6350,29709,2592,2376,4813,12719,7209,24196,20919,3277,20919,5807,15112,2019-01-01,zipcode,Dallas
ZCTA5 75207,48,7702,87480,1635,-666666666,7638,5396,6570,1536,1506,1636,1274,618,1873,1731,142,1731,10,1721,2019-01-01,zipcode,Dallas
ZCTA5 75208,48,29706,63277,1047,294500,23540,6679,20084,5848,3629,3804,4323,2480,12026,10716,1310,10716,5837,4879,2019-01-01,zipcode,Dallas
ZCTA5 75209,48,14308,95112,1372,618400,11986,3302,11150,866,1193,1952,4275,2864,7639,6648,991,6648,4063,2585,2019-01-01,zipcode,Dallas
ZCTA5 75210,48,8673,28269,755,63200,6046,2450,5050,1898,1537,1286,178,151,3430,2868,562,2868,708,2160,2019-01-01,zipcode,Dallas
ZCTA5 75211,48,77570,44893,942,108000,56299,19861,44115,19733,12810,7666,2846,1060,23396,21720,1676,21720,10928,10792,2019-01-01,zipcode,Dallas
ZCTA5 75212,48,26720,36212,744,103000,19460,8185,15301,6627,5184,2439,817,234,8656,7923,733,7923,3988,3935,2019-01-01,zipcode,Dallas
ZCTA5 75214,48,34824,89719,1221,490100,28011,7657,25564,1383,2229,4853,9958,7141,17924,16243,1681,16243,8704,7539,2019-01-01,zipcode,Dallas
ZCTA5 75215,48,17818,30865,820,71700,13972,5663,12057,3092,3990,3334,1171,470,8468,6809,1659,6809,2215,4594,2019-01-01,zipcode,Dallas
ZCTA5 75216,48,53327,27288,855,69800,39350,19434,33548,11072,12902,7119,1823,632,21115,18482,2633,18482,9053,9429,2019-01-01,zipcode,Dallas
ZCTA5 75217,48,89163,40475,933,86200,61945,26563,48772,21272,15388,9698,1768,646,26232,24375,1857,24375,14505,9870,2019-01-01,zipcode,Dallas
ZCTA5 75218,48,22529,83851,1209,329200,18471,5315,17243,1186,2446,3964,5618,4029,11204,10404,800,10404,6979,3425,2019-01-01,zipcode,Dallas
ZCTA5 75219,48,25120,72559,1405,301200,23189,4523,21224,1959,2101,3869,8070,5225,18100,15447,2653,15447,4753,10694,2019-01-01,zipcode,Dallas
ZCTA5 75220,48,42009,47111,883,294100,31378,8184,25711,11904,5262,3222,3183,2140,16014,14402,1612,14402,4551,9851,2019-01-01,zipcode,Dallas
ZCTA5 75223,48,14941,50286,921,119500,11153,3574,9252,3946,1755,1660,1260,631,5178,4555,623,4555,2371,2184,2019-01-01,zipcode,Dallas
ZCTA5 75224,48,37592,42663,888,115000,26740,9614,20618,7254,6245,4329,2022,768,12260,11274,986,11274,5232,6042,2019-01-01,zipcode,Dallas
ZCTA5 75225,48,21736,161296,1999,1083400,16813,7149,15388,151,550,1968,7262,5457,9940,8932,1008,8932,7013,1919,2019-01-01,zipcode,Dallas
ZCTA5 75226,48,4579,49115,1289,-666666666,4051,1391,3682,1143,521,978,709,331,2106,1933,173,1933,104,1829,2019-01-01,zipcode,Dallas
ZCTA5 75227,48,59924,43890,975,106700,42044,15879,33179,11163,10207,8480,2381,948,19413,17897,1516,17897,10047,7850,2019-01-01,zipcode,Dallas
ZCTA5 75228,48,73976,42243,887,148800,54463,18430,44769,12877,13072,10849,5664,2307,28167,25670,2497,25670,11739,13931,2019-01-01,zipcode,Dallas
ZCTA5 75229,48,32322,100144,1109,396700,25303,6868,22202,5359,2623,3861,6309,4050,11979,11085,894,11085,8010,3075,2019-01-01,zipcode,Dallas
ZCTA5 75230,48,27489,91596,1133,655600,23484,7886,21032,1021,1732,4443,7723,6113,14310,13207,1103,13207,8053,5154,2019-01-01,zipcode,Dallas
ZCTA5 75231,48,40371,41806,906,345700,30936,7696,26093,5729,5787,5978,5849,2750,20328,17126,3202,17126,3028,14098,2019-01-01,zipcode,Dallas
ZCTA5 75232,48,31453,40103,977,108200,24209,11802,20871,5219,6930,5950,1743,1029,11725,10867,858,10867,6240,4627,2019-01-01,zipcode,Dallas
ZCTA5 75233,48,17280,51062,1023,152800,13158,4465,10411,3005,3120,2364,1184,738,5521,5255,266,5255,2570,2685,2019-01-01,zipcode,Dallas
ZCTA5 75234,48,37160,71118,1331,184900,29924,8693,25038,5401,5835,6250,5231,2321,13653,12784,869,12784,7791,4993,2019-01-01,zipcode,Dallas
ZCTA5 75235,48,18429,48603,1223,169300,15351,4572,13066,3563,2860,2382,2606,1655,9002,7937,1065,7937,2041,5896,2019-01-01,zipcode,Dallas
ZCTA5 75236,48,18137,43279,959,140000,12844,3729,10278,2561,2895,2893,1349,580,6886,6146,740,6146,2250,3896,2019-01-01,zipcode,Dallas
ZCTA5 75237,48,21423,27970,881,126200,15363,5531,12234,2389,4093,4100,1160,492,10178,9159,1019,9159,1256,7903,2019-01-01,zipcode,Dallas
ZCTA5 75238,48,33049,70593,958,362900,24436,7205,21434,3204,3130,4800,6372,3928,13893,12755,1138,12755,6440,6315,2019-01-01,zipcode,Dallas
ZCTA5 75240,48,28534,51569,1051,261200,21042,4457,16850,4629,3353,3292,3801,1775,11354,10115,1239,10115,2450,7665,2019-01-01,zipcode,Dallas
ZCTA5 75241,48,31562,32313,931,87500,23752,11605,19146,4033,7405,5560,1354,794,11963,11021,942,11021,6186,4835,2019-01-01,zipcode,Dallas
ZCTA5 75243,48,68308,41786,936,238600,52273,13851,44655,6463,9556,14331,9416,4889,31982,28307,3675,28307,6811,21496,2019-01-01,zipcode,Dallas
ZCTA5 75244,48,13254,95711,1454,431500,11117,2614,9667,359,947,1894,4028,2439,6549,5864,685,5864,2921,2943,2019-01-01,zipcode,Dallas
ZCTA5 75246,48,2760,24803,773,223100,2146,802,1987,580,425,551,333,98,1644,1343,301,1343,142,1201,2019-01-01,zipcode,Dallas
ZCTA5 75247,48,792,18568,851,-666666666,792,481,780,175,268,224,49,64,239,209,30,209,0,209,2019-01-01,zipcode,Dallas
ZCTA5 75248,48,37373,86938,1195,401400,30909,8908,28140,1653,3563,6123,10091,6710,17933,16460,1473,16460,8670,7790,2019-01-01,zipcode,Dallas
ZCTA5 75249,48,17649,64246,1504,159600,13106,3345,10889,1602,2642,4201,1639,805,5482,5386,96,5386,4042,1344,2019-01-01,zipcode,Dallas
ZCTA5 75251,48,2861,69028,1346,-666666666,2594,658,1985,45,255,608,595,482,2251,1740,511,1740,0,1740,2019-01-01,zipcode,Dallas
ZCTA5 75252,48,26867,63053,1031,371700,22988,6499,19269,1065,2080,4135,6979,5010,14271,12410,1861,12410,5244,7166,2019-01-01,zipcode,Dallas
ZCTA5 75253,48,23900,48174,1057,43100,16152,5047,12760,5649,3320,3057,612,122,7053,6461,592,6461,4218,2243,2019-01-01,zipcode,Dallas
ZCTA5 75254,48,26929,54122,1139,323100,20585,3603,17507,2617,2999,4672,4601,2618,13561,11837,1724,11837,2086,9751,2019-01-01,zipcode,Dallas
ZCTA5 75270,48,0,-666666666,-666666666,-666666666,0,0,0,0,0,0,0,0,0,0,0,0,0,0,2019-01-01,zipcode,Dallas
ZCTA5 75287,48,55673,52150,1081,304700,45980,8117,40031,2001,6935,12330,13238,5527,31216,28087,3129,28087,5836,22251,2019-01-01,zipcode,Dallas
ZCTA5 75390,48,0,-666666666,-666666666,-666666666,0,0,0,0,0,0,0,0,0,0,0,0,0,0,2019-01-01,zipcode,Dallas
ZCTA5 75401,48,19146,36727,852,71000,14365,5701,12253,2825,4540,3125,1120,643,7509,6888,621,6888,3587,3301,2019-01-01,zipcode,Greenville
ZCTA5 75402,48,18087,65972,994,149500,14388,5291,12385,1280,3611,3793,2228,1473,7451,6744,707,6744,4572,2172,2019-01-01,zipcode,Greenville
ZCTA5 75407,48,17978,66110,1268,180500,13385,4036,11293,1397,4087,3619,1716,474,6158,5732,426,5732,4017,1715,2019-01-01,zipcode,Princeton
ZCTA5 75409,48,16349,90540,1685,213100,11029,3159,9746,1277,2937,2484,1760,1288,5247,4831,416,4831,3641,1190,2019-01-01,zipcode,Anna
ZCTA5 75410,48,4954,65662,768,141500,3994,1854,3785,617,1533,1100,307,228,2431,1945,486,1945,1599,346,2019-01-01,zipcode,Alba
ZCTA5 75411,48,889,77174,968,-666666666,756,337,746,99,294,238,67,48,477,342,135,342,270,72,2019-01-01,zipcode,Arthur city
ZCTA5 75412,48,457,44135,-666666666,76400,370,140,340,35,129,148,28,0,354,253,101,253,242,11,2019-01-01,zipcode,Bagwell
ZCTA5 75413,48,282,-666666666,1025,60400,220,82,198,59,86,41,7,5,148,114,34,114,85,29,2019-01-01,zipcode,Bailey
ZCTA5 75414,48,3416,64500,720,135800,2652,1098,2267,215,577,941,354,180,1320,1168,152,1168,981,187,2019-01-01,zipcode,Bells
ZCTA5 75415,48,240,100083,-666666666,-666666666,206,119,186,15,88,44,30,9,96,90,6,90,81,9,2019-01-01,zipcode,Ben franklin
ZCTA5 75416,48,3070,51771,775,114000,2371,1116,1975,256,697,546,387,89,1355,1113,242,1113,904,209,2019-01-01,zipcode,Blossom
ZCTA5 75417,48,2688,47045,558,88000,2140,959,1837,370,592,662,136,77,1260,994,266,994,852,142,2019-01-01,zipcode,Bogata
ZCTA5 75418,48,14571,48850,783,117700,12166,6824,10561,1780,3626,3296,1082,777,5589,4891,698,4891,3279,1612,2019-01-01,zipcode,Bonham
ZCTA5 75420,48,1052,58750,756,136100,859,274,723,82,228,301,102,10,438,385,53,385,313,72,2019-01-01,zipcode,Brashear
ZCTA5 75421,48,666,53929,728,110100,394,171,328,28,126,148,12,14,250,192,58,192,170,22,2019-01-01,zipcode,Brookston
ZCTA5 75422,48,3088,55332,808,114800,2417,1215,2210,396,628,662,317,207,1331,1163,168,1163,968,195,2019-01-01,zipcode,Campbell
ZCTA5 75423,48,3110,63107,924,160400,2508,1039,2267,184,805,839,356,83,1330,1129,201,1129,938,191,2019-01-01,zipcode,Celeste
ZCTA5 75424,48,3024,65893,1200,167300,2439,835,2123,391,772,710,172,78,1224,1126,98,1126,920,206,2019-01-01,zipcode,Blue ridge
ZCTA5 75426,48,4393,34790,637,50500,3891,1862,3462,431,1535,1105,317,74,2857,1925,932,1925,1284,641,2019-01-01,zipcode,Clarksville
ZCTA5 75428,48,11371,35407,836,80800,9516,4196,5939,626,2032,1733,787,761,4357,3635,722,3635,1745,1890,2019-01-01,zipcode,Commerce
ZCTA5 75431,48,2122,51875,819,58200,1689,721,1546,400,694,414,28,10,861,702,159,702,487,215,2019-01-01,zipcode,Como
ZCTA5 75432,48,3504,49107,610,84000,2691,1186,2250,301,658,596,415,280,1543,1260,283,1260,877,383,2019-01-01,zipcode,Cooper
ZCTA5 75433,48,2808,56042,880,106000,2225,1011,2020,334,662,623,282,119,1241,1051,190,1051,828,223,2019-01-01,zipcode,Cumby
ZCTA5 75435,48,944,37059,508,70600,762,331,691,147,258,184,82,20,505,412,93,412,293,119,2019-01-01,zipcode,Deport
ZCTA5 75436,48,2480,50909,527,114800,1889,932,1616,209,669,550,153,35,1139,878,261,878,653,225,2019-01-01,zipcode,Detroit
ZCTA5 75437,48,1377,63333,-666666666,125400,1009,412,934,87,303,351,132,61,561,480,81,480,433,47,2019-01-01,zipcode,Dike
ZCTA5 75438,48,992,68393,700,105400,770,294,672,72,275,176,98,51,457,373,84,373,303,70,2019-01-01,zipcode,Dodd city
ZCTA5 75439,48,1035,61000,826,131900,804,325,672,101,253,251,36,31,456,398,58,398,223,175,2019-01-01,zipcode,Ector
ZCTA5 75440,48,6258,49979,664,138700,5315,2712,4829,682,1921,1576,473,177,3232,2489,743,2489,2042,447,2019-01-01,zipcode,Emory
ZCTA5 75441,48,128,50964,-666666666,-666666666,104,47,100,0,41,0,41,18,89,71,18,71,71,0,2019-01-01,zipcode,Enloe
ZCTA5 75442,48,9308,73405,1138,161900,7248,2879,6326,983,2050,2183,808,302,3503,3045,458,3045,2206,839,2019-01-01,zipcode,Farmersville
ZCTA5 75446,48,3178,40057,812,87800,2452,1260,1950,273,671,560,292,154,1522,1181,341,1181,836,345,2019-01-01,zipcode,Honey grove
ZCTA5 75447,48,1256,79792,639,175700,962,331,822,111,313,344,23,31,501,440,61,440,385,55,2019-01-01,zipcode,Ivanhoe
ZCTA5 75448,48,643,37568,-666666666,-666666666,498,257,430,62,136,183,39,10,241,228,13,228,206,22,2019-01-01,zipcode,Klondike
ZCTA5 75449,48,1374,43125,807,96400,1124,499,903,106,253,336,130,78,747,543,204,543,377,166,2019-01-01,zipcode,Ladonia
ZCTA5 75450,48,150,31771,-666666666,88000,102,39,102,10,18,66,8,0,150,55,95,55,46,9,2019-01-01,zipcode,Lake creek
ZCTA5 75451,48,1163,39292,603,121200,1024,458,891,70,189,437,156,39,747,536,211,536,450,86,2019-01-01,zipcode,Leesburg
ZCTA5 75452,48,4650,57500,822,123900,3508,1392,2869,345,1082,859,440,143,1687,1548,139,1548,1085,463,2019-01-01,zipcode,Leonard
ZCTA5 75453,48,3046,59587,1048,120500,2509,1056,2144,340,782,660,314,48,1363,1126,237,1126,904,222,2019-01-01,zipcode,Lone oak
ZCTA5 75454,48,10467,108889,1888,300000,7400,2348,6195,342,1467,2417,1292,677,3052,3044,8,3044,2705,339,2019-01-01,zipcode,Melissa
ZCTA5 75455,48,28354,50170,717,109100,20932,7669,17040,3978,5547,4654,1990,871,10678,9405,1273,9405,6070,3335,2019-01-01,zipcode,Mount pleasant
ZCTA5 75457,48,6501,51395,826,131500,5195,1847,4418,362,1329,1475,985,267,3416,2315,1101,2315,1687,628,2019-01-01,zipcode,Mount vernon
ZCTA5 75459,48,5156,67554,787,131700,4090,1042,3470,288,1106,1414,512,150,2174,1903,271,1903,1366,537,2019-01-01,zipcode,Howe
ZCTA5 75460,48,23504,33704,709,74900,18665,8159,16024,3097,5592,5263,1541,531,11484,9917,1567,9917,4867,5050,2019-01-01,zipcode,Paris
ZCTA5 75462,48,11641,60422,798,155600,9047,3323,7969,849,2115,2686,1424,895,4876,4551,325,4551,3544,1007,2019-01-01,zipcode,Paris
ZCTA5 75468,48,939,54458,-666666666,70900,740,407,632,53,262,243,30,44,372,335,37,335,284,51,2019-01-01,zipcode,Pattonville
ZCTA5 75469,48,275,46500,-666666666,115600,248,136,226,41,85,65,13,22,161,108,53,108,95,13,2019-01-01,zipcode,Pecan gap
ZCTA5 75470,48,323,63319,-666666666,38400,240,96,240,84,115,19,10,12,145,119,26,119,119,0,2019-01-01,zipcode,Petty
ZCTA5 75471,48,1531,80278,562,134100,1008,412,813,201,270,250,77,15,448,396,52,396,286,110,2019-01-01,zipcode,Pickton
ZCTA5 75472,48,4087,48011,751,108000,3302,1638,2860,436,1098,901,309,116,1789,1454,335,1454,1070,384,2019-01-01,zipcode,Point
ZCTA5 75473,48,3688,61667,726,99600,2968,1157,2621,342,860,841,406,172,1532,1410,122,1410,1186,224,2019-01-01,zipcode,Powderly
ZCTA5 75474,48,15017,53468,854,105500,12403,6060,10585,2513,3691,3103,853,425,6546,5392,1154,5392,4152,1240,2019-01-01,zipcode,Quinlan
ZCTA5 75475,48,148,31250,-666666666,97000,139,86,95,7,53,12,23,0,66,60,6,60,55,5,2019-01-01,zipcode,Randolph
ZCTA5 75476,48,1056,63688,913,145700,966,558,930,217,280,359,35,39,528,435,93,435,390,45,2019-01-01,zipcode,Ravenna
ZCTA5 75477,48,1183,45556,558,68100,964,347,814,94,307,237,153,23,475,386,89,386,257,129,2019-01-01,zipcode,Roxton
ZCTA5 75478,48,1120,50313,679,117600,862,433,749,163,187,278,105,16,434,403,31,403,322,81,2019-01-01,zipcode,Saltillo
ZCTA5 75479,48,1786,53185,648,94100,1500,666,1351,185,538,411,139,78,787,709,78,709,569,140,2019-01-01,zipcode,Savoy
ZCTA5 75480,48,1587,50833,647,188800,1282,641,1151,88,328,464,160,111,1216,624,592,624,573,51,2019-01-01,zipcode,Scroggins
ZCTA5 75481,48,314,51029,-666666666,83800,248,123,196,26,83,53,17,17,170,114,56,114,104,10,2019-01-01,zipcode,Sulphur bluff
ZCTA5 75482,48,24984,51311,822,116900,19713,7599,16761,2264,6232,4639,2494,1132,10737,9481,1256,9481,6228,3253,2019-01-01,zipcode,Sulphur springs
ZCTA5 75486,48,2291,61269,-666666666,128600,1820,837,1538,230,491,523,236,58,1061,870,191,870,754,116,2019-01-01,zipcode,Sumner
ZCTA5 75487,48,2106,54355,588,103100,1622,612,1407,276,437,500,115,79,821,726,95,726,557,169,2019-01-01,zipcode,Talco
ZCTA5 75488,48,645,58359,673,161100,520,256,500,39,170,212,60,19,397,251,146,251,200,51,2019-01-01,zipcode,Telephone
ZCTA5 75489,48,1032,55147,956,105900,737,288,660,55,175,335,77,18,400,388,12,388,239,149,2019-01-01,zipcode,Tom bean
ZCTA5 75490,48,2493,80172,1071,168100,1939,560,1756,170,627,659,187,113,1067,955,112,955,814,141,2019-01-01,zipcode,Trenton
ZCTA5 75491,48,5064,78319,638,143900,4014,1400,3438,359,943,1264,655,217,2195,1799,396,1799,1468,331,2019-01-01,zipcode,Whitewright
ZCTA5 75492,48,456,57125,519,148600,373,169,345,33,142,125,24,21,221,195,26,195,173,22,2019-01-01,zipcode,Windom
ZCTA5 75493,48,626,42891,617,45800,397,101,306,168,76,52,10,0,209,171,38,171,123,48,2019-01-01,zipcode,Winfield
ZCTA5 75494,48,9940,52733,806,127800,7795,3737,6851,912,2043,2737,868,291,4731,3564,1167,3564,2791,773,2019-01-01,zipcode,Winnsboro
ZCTA5 75495,48,8729,81804,1066,201600,6937,2174,5596,409,1803,2112,1016,256,3131,2818,313,2818,2342,476,2019-01-01,zipcode,Van alstyne
ZCTA5 75496,48,3739,72944,785,127200,3012,1294,2535,324,908,845,307,151,1567,1258,309,1258,1040,218,2019-01-01,zipcode,Wolfe city
ZCTA5 75497,48,3907,57549,603,163700,3428,1933,3173,443,854,1112,646,118,2009,1665,344,1665,1394,271,2019-01-01,zipcode,Yantis
ZCTA5 75501,48,36094,37983,687,103100,28025,13468,23872,3140,8523,8684,2364,1161,15446,13291,2155,13291,7690,5601,2019-01-01,zipcode,Texarkana
ZCTA5 75503,48,25517,66706,886,169200,19926,8091,17201,1016,4097,5939,3865,2284,10962,9565,1397,9565,6117,3448,2019-01-01,zipcode,Texarkana
ZCTA5 75550,48,681,32381,546,59800,652,336,588,91,228,189,72,8,466,308,158,308,269,39,2019-01-01,zipcode,Annona
ZCTA5 75551,48,11251,52546,738,98000,8654,3928,7615,931,3070,1989,1126,499,5124,4170,954,4170,3392,778,2019-01-01,zipcode,Atlanta
ZCTA5 75554,48,2131,54750,585,93800,1810,804,1435,184,688,290,213,60,1118,827,291,827,708,119,2019-01-01,zipcode,Avery
ZCTA5 75555,48,1579,43433,647,76600,1363,787,1204,170,576,355,79,24,977,722,255,722,658,64,2019-01-01,zipcode,Bivins
ZCTA5 75556,48,1214,43000,775,81100,898,419,752,104,368,169,87,24,475,408,67,408,298,110,2019-01-01,zipcode,Bloomburg
ZCTA5 75558,48,1582,52292,-666666666,72100,1160,406,1033,215,521,240,57,0,595,501,94,501,449,52,2019-01-01,zipcode,Cookville
ZCTA5 75559,48,5122,47917,593,92200,4001,2177,3622,375,1582,986,395,284,2656,2067,589,2067,1600,467,2019-01-01,zipcode,De kalb
ZCTA5 75560,48,1002,35000,707,67500,911,336,739,178,293,114,94,60,547,452,95,452,394,58,2019-01-01,zipcode,Douglassville
ZCTA5 75561,48,4939,44415,712,85600,3879,1619,3470,443,1343,1194,339,151,2320,1966,354,1966,1406,560,2019-01-01,zipcode,Hooks
ZCTA5 75562,48,104,39271,-666666666,71300,104,31,89,0,47,36,6,0,63,63,0,63,63,0,2019-01-01,zipcode,Kildare
ZCTA5 75563,48,4528,41346,527,89700,3738,1921,3327,399,1475,1017,277,159,2234,1870,364,1870,1387,483,2019-01-01,zipcode,Linden
ZCTA5 75565,48,206,45486,-666666666,-666666666,171,98,155,36,82,27,10,0,111,85,26,85,56,29,2019-01-01,zipcode,Mc leod
ZCTA5 75566,48,756,36429,830,116100,629,380,589,119,211,197,51,11,450,310,140,310,296,14,2019-01-01,zipcode,Marietta
ZCTA5 75567,48,4824,56303,871,110700,3726,1679,3196,209,1597,942,356,92,1940,1625,315,1625,1232,393,2019-01-01,zipcode,Maud
ZCTA5 75568,48,2238,38825,570,85100,1648,689,1516,190,641,503,150,32,1229,1029,200,1029,706,323,2019-01-01,zipcode,Naples
ZCTA5 75569,48,3464,36382,836,118100,2399,841,1905,127,742,768,151,117,1408,1329,79,1329,662,667,2019-01-01,zipcode,Nash
ZCTA5 75570,48,11071,54194,603,106900,9826,5710,8469,1617,3496,2212,905,239,3924,3298,626,3298,2146,1152,2019-01-01,zipcode,New boston
ZCTA5 75571,48,3134,50375,613,103800,2429,1032,2075,137,958,635,235,110,1387,1088,299,1088,974,114,2019-01-01,zipcode,Omaha
ZCTA5 75572,48,3896,48750,579,57200,3214,1570,2820,435,1242,694,260,189,1881,1654,227,1654,1269,385,2019-01-01,zipcode,Queen city
ZCTA5 75573,48,115,88380,-666666666,84300,97,71,97,4,15,11,32,35,64,41,23,41,37,4,2019-01-01,zipcode,Redwater
ZCTA5 75574,48,1659,57297,613,77100,1331,631,1124,166,423,315,156,64,882,707,175,707,564,143,2019-01-01,zipcode,Simms
ZCTA5 75601,48,15719,44725,763,138900,12604,5662,10957,1728,3480,3592,1355,802,6646,5657,989,5657,3392,2265,2019-01-01,zipcode,Longview
ZCTA5 75602,48,21655,42530,768,82500,16199,6349,12663,3308,3875,3763,1315,402,8448,7094,1354,7094,4390,2704,2019-01-01,zipcode,Longview
ZCTA5 75603,48,6100,48565,748,107300,4742,1956,4173,501,1419,1571,457,225,2911,2295,616,2295,1908,387,2019-01-01,zipcode,Longview
ZCTA5 75604,48,31027,50729,862,145700,23148,8759,19549,3080,5492,6635,2794,1548,12598,11320,1278,11320,6199,5121,2019-01-01,zipcode,Longview
ZCTA5 75605,48,30501,62132,960,189200,24211,8865,21196,1263,4990,8427,4621,1895,13638,12396,1242,12396,7315,5081,2019-01-01,zipcode,Longview
ZCTA5 75630,48,2370,32429,720,95400,2048,1239,1956,195,779,664,265,53,1610,1204,406,1204,1038,166,2019-01-01,zipcode,Avinger
ZCTA5 75631,48,3248,60144,788,100600,2417,1000,2198,271,736,956,157,78,1390,1131,259,1131,834,297,2019-01-01,zipcode,Beckville
ZCTA5 75633,48,13161,54789,756,107900,10473,4508,8807,1284,2752,3041,1219,511,6434,5061,1373,5061,3773,1288,2019-01-01,zipcode,Carthage
ZCTA5 75638,48,5505,39960,700,85200,4474,2253,3868,477,1513,1251,413,214,2621,2303,318,2303,1671,632,2019-01-01,zipcode,Daingerfield
ZCTA5 75639,48,2926,29891,812,75400,2369,1307,1987,512,654,655,153,13,1513,1094,419,1094,892,202,2019-01-01,zipcode,De berry
ZCTA5 75640,48,4859,56923,907,138500,3611,1487,3014,371,1034,953,513,143,2055,1836,219,1836,1538,298,2019-01-01,zipcode,Diana
ZCTA5 75641,48,89,46607,-666666666,125000,81,35,78,10,18,50,0,0,65,43,22,43,32,11,2019-01-01,zipcode,Easton
ZCTA5 75642,48,48,-666666666,-666666666,-666666666,48,10,44,15,10,19,0,0,53,19,34,19,19,0,2019-01-01,zipcode,Elysian fields
ZCTA5 75643,48,2253,55563,718,93600,1738,817,1539,321,487,492,179,60,1120,787,333,787,633,154,2019-01-01,zipcode,Gary
ZCTA5 75644,48,13427,48548,695,126500,10098,4760,8747,1128,3094,3044,958,523,5214,4453,761,4453,3306,1147,2019-01-01,zipcode,Gilmer
ZCTA5 75645,48,10797,56924,979,159200,8852,3790,7669,869,2665,2449,1215,471,4525,3701,824,3701,3207,494,2019-01-01,zipcode,Gilmer
ZCTA5 75647,48,13712,47850,947,126000,10814,4307,9296,1354,3052,3431,1132,327,5517,4885,632,4885,3490,1395,2019-01-01,zipcode,Gladewater
ZCTA5 75650,48,9837,62582,922,171600,7390,2878,6484,583,1940,2558,921,482,3989,3530,459,3530,2249,1281,2019-01-01,zipcode,Hallsville
ZCTA5 75651,48,2100,49707,891,117500,1691,719,1491,247,581,451,126,86,1061,843,218,843,779,64,2019-01-01,zipcode,Harleton
ZCTA5 75652,48,16223,53253,744,150400,13507,8056,11293,2620,3665,3202,1208,598,5219,4381,838,4381,3187,1194,2019-01-01,zipcode,Henderson
ZCTA5 75654,48,12664,55050,692,128100,9467,3582,8030,1581,2249,2790,855,555,5420,4714,706,4714,3672,1042,2019-01-01,zipcode,Henderson
ZCTA5 75656,48,4331,40576,545,88800,3444,1599,2979,544,1355,699,221,160,2045,1687,358,1687,1232,455,2019-01-01,zipcode,Hughes springs
ZCTA5 75657,48,7261,38518,742,103500,6103,2849,5345,824,2202,1551,536,232,4528,3297,1231,3297,2408,889,2019-01-01,zipcode,Jefferson
ZCTA5 75661,48,3094,53596,641,86500,2773,1368,2173,467,685,486,432,103,2018,1004,1014,1004,822,182,2019-01-01,zipcode,Karnack
ZCTA5 75662,48,24976,58471,832,121900,19307,7109,16198,3075,4342,6005,1749,1027,10418,8884,1534,8884,6310,2574,2019-01-01,zipcode,Kilgore
ZCTA5 75667,48,1193,41208,814,95600,935,447,786,214,202,290,66,14,527,453,74,453,338,115,2019-01-01,zipcode,Laneville
ZCTA5 75668,48,2371,37500,686,110300,1821,898,1568,186,664,549,141,28,1235,996,239,996,643,353,2019-01-01,zipcode,Lone star
ZCTA5 75669,48,762,70035,-666666666,84300,632,339,556,154,186,173,31,12,390,279,111,279,259,20,2019-01-01,zipcode,Long branch
ZCTA5 75670,48,17539,36208,670,68700,13117,5960,10576,2362,4455,2567,847,345,7255,5781,1474,5781,3386,2395,2019-01-01,zipcode,Marshall
ZCTA5 75672,48,16351,58175,850,131400,13081,5954,11400,1457,3692,3840,1606,805,7293,5970,1323,5970,4553,1417,2019-01-01,zipcode,Marshall
ZCTA5 75681,48,2128,44964,773,113900,1845,891,1634,171,687,432,231,113,1191,965,226,965,839,126,2019-01-01,zipcode,Mount enterprise
ZCTA5 75682,48,578,77344,-666666666,156300,436,215,381,76,125,114,35,31,198,171,27,171,171,0,2019-01-01,zipcode,New london
ZCTA5 75683,48,3709,39602,769,85500,2972,1482,2518,536,864,921,187,10,1781,1444,337,1444,1184,260,2019-01-01,zipcode,Ore city
ZCTA5 75684,48,7894,52599,814,117200,6266,2806,5399,921,1997,1996,372,113,2989,2535,454,2535,1827,708,2019-01-01,zipcode,Overton
ZCTA5 75686,48,13184,49167,740,101400,10125,4336,8788,1115,3137,2807,1186,543,5898,4734,1164,4734,3483,1251,2019-01-01,zipcode,Pittsburg
ZCTA5 75691,48,4320,63160,760,119800,3140,1227,2908,618,939,977,303,71,2100,1556,544,1556,1144,412,2019-01-01,zipcode,Tatum
ZCTA5 75692,48,4414,58155,1048,105200,3558,1820,3075,445,1087,1084,299,160,1916,1463,453,1463,1223,240,2019-01-01,zipcode,Waskom
ZCTA5 75693,48,7076,64216,1080,165900,5516,1632,4698,659,1547,1487,835,170,2692,2430,262,2430,1847,583,2019-01-01,zipcode,White oak
ZCTA5 75701,48,35858,47543,900,138600,28883,11756,22836,2664,5276,8704,4407,1785,14299,12195,2104,12195,6739,5456,2019-01-01,zipcode,Tyler
ZCTA5 75702,48,27698,37345,759,77200,20791,8073,16613,5843,4225,5156,1051,338,9428,7936,1492,7936,4271,3665,2019-01-01,zipcode,Tyler
ZCTA5 75703,48,42777,62544,990,229600,33899,11476,28291,1534,4289,11107,7398,3963,18648,16627,2021,16627,9149,7478,2019-01-01,zipcode,Tyler
ZCTA5 75704,48,10199,39959,828,130400,7946,3746,6778,1708,1915,2122,663,370,3647,3034,613,3034,2336,698,2019-01-01,zipcode,Tyler
ZCTA5 75705,48,2762,40065,-666666666,87900,2190,850,1991,281,796,648,173,93,1103,807,296,807,761,46,2019-01-01,zipcode,Tyler
ZCTA5 75706,48,10449,49982,721,103200,7791,3197,6672,2084,1436,2438,578,136,3861,3136,725,3136,2166,970,2019-01-01,zipcode,Tyler
ZCTA5 75707,48,14232,74077,1197,191300,11250,4255,9665,554,2379,3410,2093,1229,6122,5373,749,5373,4124,1249,2019-01-01,zipcode,Tyler
ZCTA5 75708,48,7698,43056,739,80700,5460,2087,4346,1561,1354,1094,198,139,2749,2230,519,2230,1609,621,2019-01-01,zipcode,Tyler
ZCTA5 75709,48,4731,62682,1040,133500,3967,1542,3511,467,696,1151,750,447,2284,1756,528,1756,1022,734,2019-01-01,zipcode,Tyler
ZCTA5 75750,48,3766,64250,736,133900,3168,1279,2872,296,1245,800,450,81,1487,1355,132,1355,1093,262,2019-01-01,zipcode,Arp
ZCTA5 75751,48,17084,45423,867,101400,12889,6033,10668,1833,3826,2911,1319,779,6612,5475,1137,5475,3281,2194,2019-01-01,zipcode,Athens
ZCTA5 75752,48,6998,55328,770,131300,5943,2644,5230,526,1024,2120,1058,502,3784,2807,977,2807,2431,376,2019-01-01,zipcode,Athens
ZCTA5 75754,48,6627,57000,899,158600,5667,2257,4682,704,1295,1909,484,290,2882,2528,354,2528,1885,643,2019-01-01,zipcode,Ben wheeler
ZCTA5 75755,48,5178,43767,760,145500,4290,1834,3481,716,1214,977,462,112,2350,1844,506,1844,1172,672,2019-01-01,zipcode,Big sandy
ZCTA5 75756,48,4450,59375,818,88100,3360,1323,2742,535,720,868,414,205,1761,1530,231,1530,1336,194,2019-01-01,zipcode,Brownsboro
ZCTA5 75757,48,12802,69628,794,195600,9935,4072,8434,870,1637,2811,2024,1092,4952,4371,581,4371,3871,500,2019-01-01,zipcode,Bullard
ZCTA5 75758,48,8739,50807,783,112700,7363,3665,6479,848,2404,1982,858,387,4209,3444,765,3444,2639,805,2019-01-01,zipcode,Chandler
ZCTA5 75759,48,54,-666666666,975,-666666666,48,36,44,12,19,13,0,0,37,23,14,23,16,7,2019-01-01,zipcode,Cuney
ZCTA5 75760,48,2066,49306,624,99800,1641,896,1530,193,661,448,143,85,1228,932,296,932,697,235,2019-01-01,zipcode,Cushing
ZCTA5 75762,48,12412,71725,1111,173500,9437,3628,8314,362,1707,3086,2140,1019,5513,4480,1033,4480,3587,893,2019-01-01,zipcode,Flint
ZCTA5 75763,48,6247,58551,755,124200,5112,2595,4596,524,1632,1710,365,365,3184,2341,843,2341,2008,333,2019-01-01,zipcode,Frankston
ZCTA5 75764,48,187,61875,525,54300,150,41,127,31,33,55,8,0,83,80,3,80,64,16,2019-01-01,zipcode,Gallatin
ZCTA5 75765,48,7157,48306,876,130500,6339,3888,5283,537,1554,1844,927,421,4239,2970,1269,2970,2454,516,2019-01-01,zipcode,Hawkins
ZCTA5 75766,48,26925,46892,717,96700,20207,8684,17028,4118,5249,4976,1884,801,11322,9638,1684,9638,6573,3065,2019-01-01,zipcode,Jacksonville
ZCTA5 75770,48,2925,62988,746,120700,2436,1271,2132,266,589,885,220,172,1512,1124,388,1124,868,256,2019-01-01,zipcode,Larue
ZCTA5 75771,48,21310,69199,1028,170600,16865,7925,14788,1440,4274,5295,2509,1270,8715,7461,1254,7461,5772,1689,2019-01-01,zipcode,Lindale
ZCTA5 75773,48,14523,52254,778,137400,11693,5708,10194,1804,3669,3379,853,489,5947,4953,994,4953,3821,1132,2019-01-01,zipcode,Mineola
ZCTA5 75778,48,2947,39028,682,104200,2379,1433,2103,277,683,728,357,58,1648,1214,434,1214,889,325,2019-01-01,zipcode,Murchison
ZCTA5 75779,48,128,-666666666,-666666666,64500,73,26,73,13,40,10,10,0,61,35,26,35,35,0,2019-01-01,zipcode,Neches
ZCTA5 75780,48,216,46429,475,-666666666,180,62,97,51,24,14,0,8,91,54,37,54,43,11,2019-01-01,zipcode,New summerfield
ZCTA5 75783,48,7942,55039,779,118000,6482,3379,5737,980,1936,1966,596,259,3742,2967,775,2967,2359,608,2019-01-01,zipcode,Quitman
ZCTA5 75784,48,774,44188,782,104100,624,251,471,83,132,161,49,46,311,267,44,267,233,34,2019-01-01,zipcode,Reklaw
ZCTA5 75785,48,11357,47743,865,91800,9223,5267,7895,1734,2605,2523,775,258,4091,3436,655,3436,2596,840,2019-01-01,zipcode,Rusk
ZCTA5 75788,48,23,-666666666,-666666666,-666666666,23,23,23,0,0,23,0,0,48,23,25,23,0,23,2019-01-01,zipcode,Sacul
ZCTA5 75789,48,7806,56036,887,155900,5963,2423,5224,625,1653,1729,934,283,3120,2761,359,2761,2165,596,2019-01-01,zipcode,Troup
ZCTA5 75790,48,3864,59250,712,117500,2945,1075,2582,319,801,930,356,176,1622,1458,164,1458,1045,413,2019-01-01,zipcode,Van
ZCTA5 75791,48,13562,74886,1104,163000,10574,3539,8838,977,1585,3571,1696,1009,4993,4692,301,4692,3421,1271,2019-01-01,zipcode,Whitehouse
ZCTA5 75792,48,3002,47946,1049,93000,2419,1067,2156,233,731,935,171,86,1219,998,221,998,800,198,2019-01-01,zipcode,Winona
ZCTA5 75801,48,16244,38674,762,106300,12517,4956,10412,1464,4116,3216,1094,522,6856,5854,1002,5854,3377,2477,2019-01-01,zipcode,Palestine
ZCTA5 75803,48,21928,44183,811,99000,18567,11533,16262,3185,6476,5076,984,541,7332,6030,1302,6030,4447,1583,2019-01-01,zipcode,Palestine
ZCTA5 75831,48,5529,43292,758,96000,4261,2133,3715,747,1401,1108,328,131,2804,1973,831,1973,1476,497,2019-01-01,zipcode,Buffalo
ZCTA5 75832,48,107,-666666666,-666666666,-666666666,107,10,88,0,23,65,0,0,9,9,0,9,0,9,2019-01-01,zipcode,Cayuga
ZCTA5 75833,48,2944,48098,806,120000,2404,1244,2171,280,872,620,249,150,2049,1159,890,1159,827,332,2019-01-01,zipcode,Centerville
ZCTA5 75835,48,11086,33292,698,97800,8860,4341,7373,1468,2412,2301,921,271,5956,4402,1554,4402,2833,1569,2019-01-01,zipcode,Crockett
ZCTA5 75838,48,639,41583,-666666666,197900,526,271,427,106,144,118,46,13,410,249,161,249,223,26,2019-01-01,zipcode,Donie
ZCTA5 75839,48,5927,44856,896,95800,4451,1902,3695,504,1407,1398,236,150,2659,2256,403,2256,1905,351,2019-01-01,zipcode,Elkhart
ZCTA5 75840,48,6340,55000,757,128400,4955,2031,4255,613,1549,1279,629,185,3379,2382,997,2382,1723,659,2019-01-01,zipcode,Fairfield
ZCTA5 75844,48,5968,40890,712,98300,4892,2073,4337,436,1517,1497,652,235,3729,2543,1186,2543,1940,603,2019-01-01,zipcode,Grapeland
ZCTA5 75845,48,2926,48880,772,86600,2430,1221,2099,369,628,779,254,69,1822,1163,659,1163,917,246,2019-01-01,zipcode,Groveton
ZCTA5 75846,48,2957,36903,733,69000,2221,1067,2041,485,898,489,111,58,1951,1153,798,1153,904,249,2019-01-01,zipcode,Jewett
ZCTA5 75847,48,1843,38011,585,85400,1466,816,1399,208,540,344,238,69,1170,781,389,781,580,201,2019-01-01,zipcode,Kennard
ZCTA5 75848,48,137,48125,619,58100,100,47,54,12,10,28,4,0,63,55,8,55,37,18,2019-01-01,zipcode,Kirvin
ZCTA5 75849,48,67,28125,638,-666666666,64,35,42,8,27,7,0,0,34,27,7,27,15,12,2019-01-01,zipcode,Latexo
ZCTA5 75850,48,796,47321,646,189100,665,406,592,225,189,66,76,36,374,289,85,289,274,15,2019-01-01,zipcode,Leona
ZCTA5 75851,48,4954,51780,784,137900,4543,3717,4259,1076,1740,1084,206,153,1409,923,486,923,760,163,2019-01-01,zipcode,Lovelady
ZCTA5 75852,48,4017,51250,914,119400,3803,3309,3234,741,1380,904,142,67,702,461,241,461,380,81,2019-01-01,zipcode,Midway
ZCTA5 75853,48,466,36034,543,-666666666,451,261,451,39,233,146,13,20,426,280,146,280,216,64,2019-01-01,zipcode,Montalba
ZCTA5 75855,48,3078,40529,718,84000,2521,1474,2285,265,871,872,173,104,1733,1138,595,1138,935,203,2019-01-01,zipcode,Oakwood
ZCTA5 75856,48,215,180727,-666666666,-666666666,198,28,67,0,33,18,16,0,120,78,42,78,23,55,2019-01-01,zipcode,Pennington
ZCTA5 75858,48,0,-666666666,-666666666,-666666666,0,0,0,0,0,0,0,0,21,0,21,0,0,0,2019-01-01,zipcode,Ratcliff
ZCTA5 75859,48,2134,43885,1073,101200,1931,1274,1812,401,459,602,255,95,1352,944,408,944,863,81,2019-01-01,zipcode,Streetman
ZCTA5 75860,48,6516,57208,635,97800,5301,3296,4748,974,1562,1695,318,199,2563,1799,764,1799,1433,366,2019-01-01,zipcode,Teague
ZCTA5 75861,48,9126,60000,728,83200,8711,7870,8351,2362,3248,2404,249,88,1010,718,292,718,394,324,2019-01-01,zipcode,Tennessee colony
ZCTA5 75862,48,10176,39466,752,80900,8271,4700,7450,1341,2737,2466,661,245,6458,4254,2204,4254,3258,996,2019-01-01,zipcode,Trinity
ZCTA5 75901,48,30429,50813,844,110800,23264,8837,19465,3899,5978,6221,2259,1108,12040,10547,1493,10547,6812,3735,2019-01-01,zipcode,Lufkin
ZCTA5 75904,48,34406,54306,852,127500,26201,10192,22075,3368,6278,7850,2974,1605,14406,12530,1876,12530,7509,5021,2019-01-01,zipcode,Lufkin
ZCTA5 75925,48,4002,39461,685,92200,3026,1476,2522,397,834,966,232,93,1839,1490,349,1490,974,516,2019-01-01,zipcode,Alto
ZCTA5 75926,48,1151,39868,-666666666,82500,947,480,844,86,362,320,42,34,681,466,215,466,414,52,2019-01-01,zipcode,Apple springs
ZCTA5 75928,48,1198,-666666666,-666666666,67900,1066,481,846,102,420,312,12,0,584,370,214,370,309,61,2019-01-01,zipcode,Bon wier
ZCTA5 75929,48,1649,62885,-666666666,152000,1402,789,1232,102,340,647,84,59,1647,704,943,704,555,149,2019-01-01,zipcode,Broaddus
ZCTA5 75930,48,1779,29569,845,69200,1518,783,1305,306,536,289,76,98,1101,732,369,732,663,69,2019-01-01,zipcode,Bronson
ZCTA5 75931,48,2203,46393,781,99700,1829,864,1702,378,643,422,216,43,2193,950,1243,950,851,99,2019-01-01,zipcode,Brookeland
ZCTA5 75932,48,1743,48952,-666666666,96400,1432,887,1221,221,413,498,67,22,1351,652,699,652,611,41,2019-01-01,zipcode,Burkeville
ZCTA5 75933,48,1158,43565,-666666666,66400,964,472,914,177,409,296,32,0,576,469,107,469,437,32,2019-01-01,zipcode,Call
ZCTA5 75934,48,219,84886,-666666666,68600,175,41,147,0,61,63,16,7,149,65,84,65,42,23,2019-01-01,zipcode,Camden
ZCTA5 75935,48,13648,43479,574,75000,10040,4490,8225,2199,2671,2164,883,308,5720,4699,1021,4699,3351,1348,2019-01-01,zipcode,Center
ZCTA5 75936,48,1128,52500,-666666666,106000,880,415,737,109,261,289,61,17,553,358,195,358,299,59,2019-01-01,zipcode,Chester
ZCTA5 75937,48,891,37875,509,79500,740,405,618,62,275,190,69,22,418,339,79,339,295,44,2019-01-01,zipcode,Chireno
ZCTA5 75938,48,2585,42083,721,108400,2125,1272,2010,251,872,615,207,65,1774,997,777,997,807,190,2019-01-01,zipcode,Colmesneil
ZCTA5 75939,48,5260,45909,530,76400,4115,1617,3315,566,1319,1052,241,137,2319,1888,431,1888,1163,725,2019-01-01,zipcode,Corrigan
ZCTA5 75941,48,8465,47500,553,85500,6568,3430,5734,1370,1801,1797,546,220,3133,2616,517,2616,2015,601,2019-01-01,zipcode,Diboll
ZCTA5 75942,48,229,-666666666,-666666666,-666666666,120,39,120,39,51,30,0,0,145,51,94,51,51,0,2019-01-01,zipcode,Doucette
ZCTA5 75943,48,1442,45521,775,72400,1068,388,879,150,306,289,109,25,669,495,174,495,385,110,2019-01-01,zipcode,Douglass
ZCTA5 75944,48,1100,42407,830,69100,990,560,914,135,364,271,109,35,789,518,271,518,486,32,2019-01-01,zipcode,Etoile
ZCTA5 75946,48,3744,41250,660,110600,2926,1461,2509,410,814,842,391,52,1650,1375,275,1375,915,460,2019-01-01,zipcode,Garrison
ZCTA5 75948,48,6268,33670,573,153400,5325,3536,4934,590,1600,1807,536,401,5418,2643,2775,2643,2364,279,2019-01-01,zipcode,Hemphill
ZCTA5 75949,48,8225,34555,658,84600,6497,3253,5738,956,2304,2074,263,141,3860,3103,757,3103,2347,756,2019-01-01,zipcode,Huntington
ZCTA5 75951,48,15859,40069,789,97800,12265,5454,10649,1637,4488,2914,998,612,7726,5698,2028,5698,4074,1624,2019-01-01,zipcode,Jasper
ZCTA5 75954,48,2466,42813,650,73600,2131,1101,1858,418,794,355,195,96,1433,964,469,964,785,179,2019-01-01,zipcode,Joaquin
ZCTA5 75956,48,8937,42500,690,103800,7067,3395,5859,1037,2598,1552,261,411,3764,3194,570,3194,2480,714,2019-01-01,zipcode,Kirbyville
ZCTA5 75959,48,994,51165,-666666666,113800,801,375,709,166,223,151,81,88,798,383,415,383,344,39,2019-01-01,zipcode,Milam
ZCTA5 75960,48,653,-666666666,-666666666,34900,432,119,357,45,64,207,41,0,431,257,174,257,234,23,2019-01-01,zipcode,Moscow
ZCTA5 75961,48,16004,37092,797,114600,12476,4438,9222,1657,2719,2950,1221,675,7512,6145,1367,6145,3068,3077,2019-01-01,zipcode,Nacogdoches
ZCTA5 75962,48,3242,-666666666,-666666666,-666666666,3242,2254,42,0,0,27,15,0,0,0,0,0,0,0,2019-01-01,zipcode,
ZCTA5 75964,48,19811,44857,745,96400,14148,5407,12118,3285,3612,3342,1293,586,7889,6694,1195,6694,4110,2584,2019-01-01,zipcode,Nacogdoches
ZCTA5 75965,48,17907,48597,764,178700,15099,5746,10498,654,2286,3011,2677,1870,8765,7604,1161,7604,3803,3801,2019-01-01,zipcode,Nacogdoches
ZCTA5 75966,48,4920,39375,660,75100,3929,1948,3341,394,1539,939,359,110,2382,1883,499,1883,1429,454,2019-01-01,zipcode,Newton
ZCTA5 75968,48,1635,28138,603,55800,1335,766,1175,207,578,286,24,80,931,641,290,641,496,145,2019-01-01,zipcode,Pineland
ZCTA5 75969,48,3854,56250,746,106700,3305,1562,2950,588,1124,770,261,207,1721,1403,318,1403,1188,215,2019-01-01,zipcode,Pollok
ZCTA5 75972,48,6169,40171,547,85300,5038,2870,4470,905,1887,987,434,257,3625,2552,1073,2552,1935,617,2019-01-01,zipcode,San augustine
ZCTA5 75973,48,2828,46703,424,91100,2271,1040,1990,291,1031,468,141,59,1737,1083,654,1083,918,165,2019-01-01,zipcode,Shelbyville
ZCTA5 75974,48,3410,37809,556,80000,2684,1390,2331,656,619,684,279,93,1697,1350,347,1350,984,366,2019-01-01,zipcode,Tenaha
ZCTA5 75975,48,4031,44228,650,114100,3166,1400,2584,426,678,1130,247,103,2035,1489,546,1489,1081,408,2019-01-01,zipcode,Timpson
ZCTA5 75976,48,778,29958,390,114800,548,296,517,156,162,151,45,3,325,267,58,267,113,154,2019-01-01,zipcode,Wells
ZCTA5 75977,48,291,19643,675,76400,265,159,227,66,70,91,0,0,233,172,61,172,140,32,2019-01-01,zipcode,Wiergate
ZCTA5 75978,48,134,76310,-666666666,132100,98,24,89,0,45,24,0,20,55,48,7,48,42,6,2019-01-01,zipcode,Woden
ZCTA5 75979,48,12228,39063,682,81700,10374,6161,8445,1879,3707,1812,812,235,5390,3675,1715,3675,2955,720,2019-01-01,zipcode,Woodville
ZCTA5 75980,48,2254,38365,692,83500,1810,1037,1558,221,666,538,112,21,1968,978,990,978,785,193,2019-01-01,zipcode,Zavalla
ZCTA5 76001,48,33748,88135,1410,194400,25848,7862,20698,1564,4114,6933,5541,2546,10971,10489,482,10489,8546,1943,2019-01-01,zipcode,Arlington
ZCTA5 76002,48,36460,89512,1845,191800,26980,6914,21843,2591,5132,7016,4639,2465,9827,9669,158,9669,8193,1476,2019-01-01,zipcode,Arlington
ZCTA5 76006,48,24684,48116,1017,257700,19941,4253,16607,1179,3345,5341,4284,2458,13489,11553,1936,11553,2733,8820,2019-01-01,zipcode,Arlington
ZCTA5 76008,48,19338,133297,1860,326700,14128,4262,12013,388,1830,3451,4197,2147,6285,5955,330,5955,5300,655,2019-01-01,zipcode,Aledo
ZCTA5 76009,48,20417,59978,1027,112400,15092,5728,13191,2958,5197,3516,1121,399,7624,6709,915,6709,5072,1637,2019-01-01,zipcode,Alvarado
ZCTA5 76010,48,60097,39073,922,104700,42864,14762,31791,12884,9349,5955,2790,813,19963,17734,2229,17734,6096,11638,2019-01-01,zipcode,Arlington
ZCTA5 76011,48,22622,40102,943,127100,17803,4735,14914,2962,3638,4843,2548,923,11083,9702,1381,9702,1882,7820,2019-01-01,zipcode,Arlington
ZCTA5 76012,48,25719,65022,994,200100,21058,7626,18024,1412,3612,5862,4286,2852,11117,10295,822,10295,6339,3956,2019-01-01,zipcode,Arlington
ZCTA5 76013,48,34203,55166,960,195900,27570,9596,22347,1414,5022,7150,5837,2924,13771,12877,894,12877,6592,6285,2019-01-01,zipcode,Arlington
ZCTA5 76014,48,35096,52588,1172,119200,26551,9174,21720,5074,6780,6230,2879,757,12138,10977,1161,10977,5528,5449,2019-01-01,zipcode,Arlington
ZCTA5 76015,48,16961,57274,1160,148700,13600,4520,11257,1433,2538,3901,2262,1123,7196,6482,714,6482,2997,3485,2019-01-01,zipcode,Arlington
ZCTA5 76016,48,32026,82490,1530,199400,26382,9836,22514,1183,4588,7373,6273,3097,11721,11278,443,11278,8986,2292,2019-01-01,zipcode,Arlington
ZCTA5 76017,48,47499,75525,1156,179800,38138,11179,31876,2321,6824,11444,7705,3582,17830,17029,801,17029,11596,5433,2019-01-01,zipcode,Arlington
ZCTA5 76018,48,31200,67962,1514,146800,24278,6422,19258,3067,5103,6477,3345,1266,9553,9200,353,9200,6474,2726,2019-01-01,zipcode,Arlington
ZCTA5 76020,48,29131,67674,850,156500,23509,9417,20601,2268,7238,7184,2768,1143,11765,10335,1430,10335,7962,2373,2019-01-01,zipcode,Azle
ZCTA5 76021,48,35794,74148,1102,234500,29194,8951,25557,1282,4925,9154,7251,2945,15545,14929,616,14929,8147,6782,2019-01-01,zipcode,Bedford
ZCTA5 76022,48,13495,61129,1150,170100,10897,3406,9799,589,2284,4007,1810,1109,5793,5526,267,5526,2944,2582,2019-01-01,zipcode,Bedford
ZCTA5 76023,48,6909,67452,981,187700,5677,2319,4777,662,1511,1655,793,156,2447,2331,116,2331,1804,527,2019-01-01,zipcode,Boyd
ZCTA5 76028,48,70507,80435,1251,196800,53873,17792,46652,3519,14349,16615,7968,4201,25589,24275,1314,24275,18370,5905,2019-01-01,zipcode,Burleson
ZCTA5 76031,48,17668,57366,917,102600,13634,5441,11509,2169,4437,3038,1481,384,6580,6003,577,6003,4648,1355,2019-01-01,zipcode,Cleburne
ZCTA5 76033,48,26081,55938,957,136300,20608,8285,17219,2463,6313,5048,2372,1023,10572,9889,683,9889,6173,3716,2019-01-01,zipcode,Cleburne
ZCTA5 76034,48,26418,163315,2141,515700,21038,7652,18757,158,1654,4733,7491,4721,9465,9290,175,9290,8915,375,2019-01-01,zipcode,Colleyville
ZCTA5 76035,48,2211,108274,875,195000,1829,606,1594,182,503,483,194,232,816,721,95,721,658,63,2019-01-01,zipcode,Cresson
ZCTA5 76036,48,27056,76355,1197,184700,20604,6471,17303,1402,5187,6552,2913,1249,9700,8985,715,8985,6748,2237,2019-01-01,zipcode,Crowley
ZCTA5 76039,48,36087,70748,1227,210600,28900,6938,25747,2128,4875,8425,6618,3701,16279,15082,1197,15082,6407,8675,2019-01-01,zipcode,Euless
ZCTA5 76040,48,31519,56997,933,186500,24039,6695,20552,2627,4907,6960,4097,1961,12624,11308,1316,11308,4954,6354,2019-01-01,zipcode,Euless
ZCTA5 76041,48,395,133629,1277,110500,338,93,304,49,57,75,123,0,171,140,31,140,115,25,2019-01-01,zipcode,Forreston
ZCTA5 76043,48,7440,58144,869,224700,5846,2543,5175,592,2130,1277,872,304,3228,2630,598,2630,2015,615,2019-01-01,zipcode,Glen rose
ZCTA5 76044,48,4401,69067,835,196100,3681,1468,3061,267,1292,1076,336,90,1752,1650,102,1650,1297,353,2019-01-01,zipcode,Godley
ZCTA5 76048,48,24822,54429,923,159600,19994,9405,17484,2260,6064,5305,2485,1370,12001,9487,2514,9487,6444,3043,2019-01-01,zipcode,Granbury
ZCTA5 76049,48,29698,76113,1061,217800,24509,11226,21903,1893,5824,7619,4208,2359,12619,11237,1382,11237,9534,1703,2019-01-01,zipcode,Granbury
ZCTA5 76050,48,6212,70234,987,170000,4931,1979,4331,516,1423,1707,521,164,2352,2149,203,2149,1733,416,2019-01-01,zipcode,Grandview
ZCTA5 76051,48,53291,91131,1380,320300,42685,9970,36172,2543,5666,10720,11795,5448,21697,20644,1053,20644,10895,9749,2019-01-01,zipcode,Grapevine
ZCTA5 76052,48,22290,115397,1480,274700,16539,4649,13912,730,3180,4544,4105,1353,7453,7057,396,7057,6341,716,2019-01-01,zipcode,Haslet
ZCTA5 76053,48,30765,55711,1085,162900,23252,7266,19908,2734,5242,6744,3634,1554,11948,10861,1087,10861,5997,4864,2019-01-01,zipcode,Hurst
ZCTA5 76054,48,12280,100988,1404,254800,9679,3303,8813,326,1444,2773,3011,1259,4482,4381,101,4381,3740,641,2019-01-01,zipcode,Hurst
ZCTA5 76055,48,2811,55208,836,85900,2235,994,1980,397,677,659,166,81,1138,1021,117,1021,749,272,2019-01-01,zipcode,Itasca
ZCTA5 76058,48,19904,55973,980,124200,14698,5673,12159,2351,4776,3588,901,543,7191,6515,676,6515,5024,1491,2019-01-01,zipcode,Joshua
ZCTA5 76059,48,5601,44179,828,120100,4484,1884,3226,474,899,1029,620,204,1964,1740,224,1740,677,1063,2019-01-01,zipcode,Keene
ZCTA5 76060,48,8468,78500,953,223500,6603,2208,5696,826,1624,1522,1036,688,2999,2820,179,2820,2138,682,2019-01-01,zipcode,Kennedale
ZCTA5 76061,48,37,-666666666,-666666666,-666666666,37,0,37,0,0,37,0,0,19,19,0,19,19,0,2019-01-01,zipcode,Lillian
ZCTA5 76063,48,73216,97533,1404,254500,54980,16567,45934,2971,8307,15868,12567,6221,24894,23679,1215,23679,18080,5599,2019-01-01,zipcode,Mansfield
ZCTA5 76064,48,1818,62969,1063,175900,1230,451,1112,105,399,412,83,113,633,545,88,545,419,126,2019-01-01,zipcode,Maypearl
ZCTA5 76065,48,37090,96483,1181,241100,28036,8574,23844,1438,5965,8475,5447,2519,12663,12168,495,12168,10087,2081,2019-01-01,zipcode,Midlothian
ZCTA5 76066,48,2621,46862,513,173400,2344,1053,2107,346,612,817,225,107,1452,1090,362,1090,852,238,2019-01-01,zipcode,Millsap
ZCTA5 76067,48,20309,46238,805,101200,15857,6741,13320,2251,4757,4575,1232,505,8567,6903,1664,6903,4659,2244,2019-01-01,zipcode,Mineral wells
ZCTA5 76070,48,895,100972,-666666666,214800,706,327,659,46,182,124,278,29,326,305,21,305,305,0,2019-01-01,zipcode,Nemo
ZCTA5 76071,48,4589,62865,872,162900,3479,1369,2807,571,924,863,407,42,1523,1365,158,1365,1068,297,2019-01-01,zipcode,Newark
ZCTA5 76073,48,5656,71286,1018,163500,4386,1847,3869,464,1449,1283,584,89,2099,1900,199,1900,1587,313,2019-01-01,zipcode,Paradise
ZCTA5 76077,48,355,25833,-666666666,-666666666,355,259,293,9,106,101,19,58,165,98,67,98,98,0,2019-01-01,zipcode,Rainbow
ZCTA5 76078,48,10247,70323,1138,163800,7600,2668,6637,748,2440,2295,884,270,3334,3108,226,3108,2670,438,2019-01-01,zipcode,Rhome
ZCTA5 76082,48,20194,65080,1032,148100,15793,6116,13652,2331,4989,4421,1478,433,7280,6242,1038,6242,5128,1114,2019-01-01,zipcode,Springtown
ZCTA5 76084,48,9109,66205,963,118200,7090,3114,5812,974,2333,1777,460,268,2782,2469,313,2469,2032,437,2019-01-01,zipcode,Venus
ZCTA5 76085,48,11014,74819,945,228500,8877,3479,7529,967,2445,2662,998,457,3720,3353,367,3353,2929,424,2019-01-01,zipcode,Weatherford
ZCTA5 76086,48,23699,59098,1036,126900,18498,7110,15302,2152,5238,5457,1448,1007,9172,8348,824,8348,4381,3967,2019-01-01,zipcode,Weatherford
ZCTA5 76087,48,27760,90780,1247,250200,21657,8101,19445,1482,3926,6748,5044,2245,11539,9688,1851,9688,8656,1032,2019-01-01,zipcode,Weatherford
ZCTA5 76088,48,11907,76432,1074,260400,9549,3587,8116,967,2830,2729,1180,410,4391,4051,340,4051,3154,897,2019-01-01,zipcode,Weatherford
ZCTA5 76092,48,31424,240507,1367,678800,23038,8691,19972,176,1956,3883,7968,5989,9780,9453,327,9453,8874,579,2019-01-01,zipcode,Southlake
ZCTA5 76093,48,1792,51316,839,102500,1434,713,1270,303,564,276,89,38,777,686,91,686,442,244,2019-01-01,zipcode,Rio vista
ZCTA5 76102,48,9282,72560,1366,260800,8275,4298,7086,1081,1557,1463,1656,1329,4287,3671,616,3671,1177,2494,2019-01-01,zipcode,Fort worth
ZCTA5 76103,48,15486,41972,836,99600,12067,4862,10058,3116,2513,2456,1445,528,5856,5192,664,5192,3177,2015,2019-01-01,zipcode,Fort worth
ZCTA5 76104,48,18344,31450,935,73900,13322,6111,11027,3542,3404,2323,1104,654,7795,6270,1525,6270,2485,3785,2019-01-01,zipcode,Fort worth
ZCTA5 76105,48,22179,32296,819,67800,15678,6842,12218,5621,3895,2189,320,193,7444,6548,896,6548,3561,2987,2019-01-01,zipcode,Fort worth
ZCTA5 76106,48,39900,40148,930,84700,28286,10865,22646,10655,7826,3169,909,87,11145,10462,683,10462,5078,5384,2019-01-01,zipcode,Fort worth
ZCTA5 76107,48,30168,66259,1118,301400,25784,8454,22239,2409,3920,4750,6982,4178,16483,14327,2156,14327,7077,7250,2019-01-01,zipcode,Fort worth
ZCTA5 76108,48,43169,68860,1098,152000,33188,10630,28486,2785,9588,8792,5013,2308,16326,15381,945,15381,10394,4987,2019-01-01,zipcode,Fort worth
ZCTA5 76109,48,23220,82640,1198,476200,19320,7464,14389,470,1267,2252,5695,4705,11250,9688,1562,9688,5225,4463,2019-01-01,zipcode,Fort worth
ZCTA5 76110,48,31926,51665,946,129600,24388,8499,19260,6807,3927,3545,2847,2134,11457,10349,1108,10349,5963,4386,2019-01-01,zipcode,Fort worth
ZCTA5 76111,48,22531,48989,970,97800,16727,5527,13154,5138,3935,2502,1204,375,7359,6672,687,6672,4070,2602,2019-01-01,zipcode,Fort worth
ZCTA5 76112,48,42572,45308,891,121800,32633,11568,28000,5081,7982,9160,4052,1725,19307,16698,2609,16698,8110,8588,2019-01-01,zipcode,Fort worth
ZCTA5 76114,48,26563,53689,964,97200,20558,7348,17120,4162,6241,4479,1703,535,9942,9107,835,9107,5214,3893,2019-01-01,zipcode,Fort worth
ZCTA5 76115,48,21319,38929,884,79200,14877,5354,11680,5670,2988,1706,785,531,6658,5991,667,5991,2994,2997,2019-01-01,zipcode,Fort worth
ZCTA5 76116,48,50506,51068,940,198900,40148,13882,33790,4887,8180,9609,7496,3618,24781,21343,3438,21343,7826,13517,2019-01-01,zipcode,Fort worth
ZCTA5 76117,48,31068,49353,900,106300,23519,7910,19624,5166,7567,5004,1200,687,10701,9878,823,9878,5516,4362,2019-01-01,zipcode,Haltom city
ZCTA5 76118,48,16378,69848,953,176500,12478,3591,10646,1255,2869,3372,2409,741,6004,5586,418,5586,4271,1315,2019-01-01,zipcode,Fort worth
ZCTA5 76119,48,52070,37130,910,74700,37150,16080,30499,10357,10561,7373,1453,755,16636,14632,2004,14632,7442,7190,2019-01-01,zipcode,Fort worth
ZCTA5 76120,48,18125,54012,999,160600,13886,3551,12114,1397,3014,4642,2108,953,8155,6943,1212,6943,2921,4022,2019-01-01,zipcode,Fort worth
ZCTA5 76123,48,36245,85710,1635,169700,26879,7329,22268,1621,6061,7104,4653,2829,11607,11208,399,11208,8642,2566,2019-01-01,zipcode,Fort worth
ZCTA5 76126,48,23450,92827,1184,212800,17740,5713,16202,753,3206,5358,4437,2448,9523,8543,980,8543,6980,1563,2019-01-01,zipcode,Fort worth
ZCTA5 76127,48,1946,87833,1733,-666666666,1904,1459,1500,272,600,535,37,56,48,48,0,48,10,38,2019-01-01,zipcode,Naval air station jrb
ZCTA5 76129,48,2519,-666666666,-666666666,-666666666,2519,1833,52,0,0,36,16,0,0,0,0,0,0,0,2019-01-01,zipcode,Fort worth
ZCTA5 76131,48,43542,85312,1532,201400,30777,8990,26435,2853,6292,8850,6161,2279,13886,13361,525,13361,9892,3469,2019-01-01,zipcode,Fort worth
ZCTA5 76132,48,27243,56655,1034,312700,21939,7106,18924,745,3777,5010,5545,3847,13782,12798,984,12798,4064,8734,2019-01-01,zipcode,Fort worth
ZCTA5 76133,48,51505,57710,1075,139800,39940,13736,33922,4965,10400,9747,5724,3086,20200,18648,1552,18648,11652,6996,2019-01-01,zipcode,Fort worth
ZCTA5 76134,48,26151,49493,1018,123300,19593,7453,16012,3384,5889,4582,1409,748,9185,8370,815,8370,5180,3190,2019-01-01,zipcode,Fort worth
ZCTA5 76135,48,21973,63672,934,160300,16942,5418,14492,1826,4012,5046,2346,1262,8517,7929,588,7929,5513,2416,2019-01-01,zipcode,Fort worth
ZCTA5 76137,48,60385,76877,1316,172700,46196,12460,37420,4008,8639,12900,8691,3182,21199,19826,1373,19826,12250,7576,2019-01-01,zipcode,Fort worth
ZCTA5 76140,48,30723,52119,1140,120000,22851,8165,18830,3850,6845,5544,1829,762,10811,9602,1209,9602,6646,2956,2019-01-01,zipcode,Fort worth
ZCTA5 76148,48,23993,72572,1395,132100,18931,5615,16099,1876,4967,6019,2468,769,8149,7885,264,7885,6351,1534,2019-01-01,zipcode,Fort worth
ZCTA5 76155,48,5813,57912,1178,-666666666,4917,686,4351,250,650,1186,1558,707,3358,3023,335,3023,0,3023,2019-01-01,zipcode,Fort worth
ZCTA5 76164,48,15488,35984,892,74200,11806,4445,9414,5224,2625,1132,322,111,4922,4428,494,4428,2390,2038,2019-01-01,zipcode,Fort worth
ZCTA5 76177,48,11695,94352,1399,240800,8607,1869,7610,30,1411,2504,2703,962,4752,4273,479,4273,2513,1760,2019-01-01,zipcode,Fort worth
ZCTA5 76179,48,65496,92742,1539,209000,47358,13515,41253,3566,10402,14129,9560,3596,22091,20867,1224,20867,15819,5048,2019-01-01,zipcode,Fort worth
ZCTA5 76180,48,37524,59140,1163,180800,29503,8927,25295,2464,5966,9194,5483,2188,15833,14829,1004,14829,7026,7803,2019-01-01,zipcode,North richland hills
ZCTA5 76182,48,31046,91998,1221,234700,24746,7833,21850,1138,4772,7428,6165,2347,11489,11099,390,11099,9174,1925,2019-01-01,zipcode,North richland hills
ZCTA5 76201,48,28601,33035,919,168300,27079,10164,12207,1070,1835,4115,3273,1914,11344,9745,1599,9745,1941,7804,2019-01-01,zipcode,Denton
ZCTA5 76205,48,21326,53949,1087,224800,18290,6272,13055,1427,2661,3920,3060,1987,8209,7330,879,7330,2822,4508,2019-01-01,zipcode,Denton
ZCTA5 76207,48,14588,68255,1215,238000,11890,5265,10444,1047,2049,3250,2925,1173,5876,5515,361,5515,3629,1886,2019-01-01,zipcode,Denton
ZCTA5 76208,48,24621,83358,1205,262000,18922,5320,16256,1881,3011,4675,4479,2210,8418,7891,527,7891,5261,2630,2019-01-01,zipcode,Denton
ZCTA5 76209,48,25689,54438,1062,176500,20219,5242,15548,1974,3210,5117,3392,1855,10261,9218,1043,9218,4297,4921,2019-01-01,zipcode,Denton
ZCTA5 76210,48,45474,95499,1388,239200,36516,10610,30388,2443,5501,10854,7361,4229,15562,14954,608,14954,11215,3739,2019-01-01,zipcode,Denton
ZCTA5 76225,48,2857,64545,796,181700,2288,799,1848,117,672,735,240,84,1197,1044,153,1044,800,244,2019-01-01,zipcode,Alvord
ZCTA5 76226,48,26761,138467,1593,393900,20084,6215,18024,554,2167,4509,7266,3528,9196,8935,261,8935,8212,723,2019-01-01,zipcode,Argyle
ZCTA5 76227,48,34036,94235,1673,231300,24556,5800,21785,1161,4366,8020,5914,2324,11877,11412,465,11412,9027,2385,2019-01-01,zipcode,Aubrey
ZCTA5 76228,48,994,58542,806,93000,794,381,698,87,230,221,110,50,502,367,135,367,317,50,2019-01-01,zipcode,Bellevue
ZCTA5 76230,48,9896,53490,928,131800,7920,3470,6879,782,2615,2252,848,382,5074,4089,985,4089,2942,1147,2019-01-01,zipcode,Bowie
ZCTA5 76233,48,3294,69107,1090,149400,2487,799,2166,234,777,681,382,92,1320,1180,140,1180,860,320,2019-01-01,zipcode,Collinsville
ZCTA5 76234,48,16630,66409,1030,189300,12809,4276,10741,1363,2974,3901,1733,770,6502,5946,556,5946,4605,1341,2019-01-01,zipcode,Decatur
ZCTA5 76238,48,324,63333,675,89700,291,116,250,20,83,105,31,11,147,142,5,142,109,33,2019-01-01,zipcode,Era
ZCTA5 76239,48,1087,70739,950,184600,930,428,830,69,287,326,95,53,585,479,106,479,393,86,2019-01-01,zipcode,Forestburg
ZCTA5 76240,48,28010,53045,889,154900,21924,8050,18729,2803,5929,6527,2191,1279,11888,10829,1059,10829,6819,4010,2019-01-01,zipcode,Gainesville
ZCTA5 76244,48,77496,105182,1692,254100,55369,12169,47089,1766,7614,14425,16813,6471,25681,24758,923,24758,19590,5168,2019-01-01,zipcode,Keller
ZCTA5 76245,48,1569,41406,667,96100,1408,730,1300,155,319,558,204,64,1446,791,655,791,681,110,2019-01-01,zipcode,Gordonville
ZCTA5 76247,48,13601,90971,1360,196100,10238,3100,8990,743,2170,3324,2070,683,4418,4211,207,4211,3542,669,2019-01-01,zipcode,Justin
ZCTA5 76248,48,39665,138519,1404,374900,30247,9581,26034,1204,3496,6780,9672,4882,13416,13207,209,13207,10527,2680,2019-01-01,zipcode,Keller
ZCTA5 76249,48,8317,75139,1302,187900,6634,2026,5841,671,1496,1763,1405,506,3157,2890,267,2890,2292,598,2019-01-01,zipcode,Krum
ZCTA5 76250,48,1157,102917,1171,192200,870,311,769,22,154,287,194,112,438,419,19,419,357,62,2019-01-01,zipcode,Lindsay
ZCTA5 76251,48,779,54091,1078,159600,607,274,552,79,226,172,57,18,335,258,77,258,190,68,2019-01-01,zipcode,Montague
ZCTA5 76252,48,2624,79737,836,192800,2146,627,1796,149,497,570,390,190,1182,1006,176,1006,831,175,2019-01-01,zipcode,Muenster
ZCTA5 76253,48,291,55313,-666666666,-666666666,205,67,200,38,84,61,16,1,106,95,11,95,80,15,2019-01-01,zipcode,Myra
ZCTA5 76255,48,5311,42543,616,106000,4151,1887,3748,645,1365,1127,419,192,3036,2172,864,2172,1527,645,2019-01-01,zipcode,Nocona
ZCTA5 76258,48,7010,65492,1072,243000,5769,2213,4688,609,1233,1323,1049,474,2893,2736,157,2736,1836,900,2019-01-01,zipcode,Pilot point
ZCTA5 76259,48,6045,82875,1278,210900,4464,1285,3950,541,950,1404,739,316,1988,1927,61,1927,1504,423,2019-01-01,zipcode,Ponder
ZCTA5 76261,48,285,56250,-666666666,71800,261,163,238,27,120,29,45,17,163,116,47,116,92,24,2019-01-01,zipcode,Ringgold
ZCTA5 76262,48,39425,121352,1263,379500,28976,7891,25408,975,3626,7120,8994,4693,13564,12919,645,12919,10050,2869,2019-01-01,zipcode,Roanoke
ZCTA5 76263,48,46,-666666666,-666666666,-666666666,46,17,46,0,13,33,0,0,41,24,17,24,24,0,2019-01-01,zipcode,Rosston
ZCTA5 76264,48,1513,68616,813,156500,1325,461,1135,57,352,552,159,15,790,653,137,653,491,162,2019-01-01,zipcode,Sadler
ZCTA5 76265,48,1472,45417,670,108800,1138,453,974,99,371,334,121,49,904,578,326,578,459,119,2019-01-01,zipcode,Saint jo
ZCTA5 76266,48,16112,73554,1181,199000,12662,3824,10735,1350,3386,3446,1766,787,5795,5373,422,5373,4154,1219,2019-01-01,zipcode,Sanger
ZCTA5 76268,48,232,42917,-666666666,41200,165,96,165,29,68,49,13,6,85,85,0,85,69,16,2019-01-01,zipcode,Southmayd
ZCTA5 76270,48,1958,69554,440,146100,1601,798,1402,360,531,313,129,69,902,651,251,651,478,173,2019-01-01,zipcode,Sunset
ZCTA5 76271,48,1792,75714,1030,223400,1332,443,1105,123,333,337,253,59,680,580,100,580,487,93,2019-01-01,zipcode,Tioga
ZCTA5 76272,48,4116,67270,859,138400,3439,1344,3048,406,999,1032,501,110,1834,1629,205,1629,1370,259,2019-01-01,zipcode,Valley view
ZCTA5 76273,48,9806,65721,957,169700,7738,3045,6616,904,2219,2386,720,387,3907,3544,363,3544,2619,925,2019-01-01,zipcode,Whitesboro
ZCTA5 76301,48,14757,29024,663,56700,11492,4575,9945,2267,3976,2475,850,377,8262,6480,1782,6480,2972,3508,2019-01-01,zipcode,Wichita falls
ZCTA5 76302,48,13482,45596,820,112700,10270,4409,8432,1165,2433,3000,1435,399,5527,5065,462,5065,2951,2114,2019-01-01,zipcode,Wichita falls
ZCTA5 76305,48,4261,64257,680,117900,3504,1560,3140,291,1186,974,501,188,2129,1730,399,1730,1502,228,2019-01-01,zipcode,Wichita falls
ZCTA5 76306,48,14980,45885,807,80100,11828,4513,10129,1535,3720,3343,1061,470,7065,5954,1111,5954,3369,2585,2019-01-01,zipcode,Wichita falls
ZCTA5 76308,48,19493,53734,812,140700,16029,5246,12137,597,2599,4282,2816,1843,9278,8290,988,8290,4839,3451,2019-01-01,zipcode,Wichita falls
ZCTA5 76309,48,12991,48246,806,102200,9903,3524,8363,990,2564,2647,1390,772,6175,5126,1049,5126,3243,1883,2019-01-01,zipcode,Wichita falls
ZCTA5 76310,48,19187,67068,825,142500,14732,4874,13353,1158,3334,4617,2617,1627,7969,7349,620,7349,5231,2118,2019-01-01,zipcode,Wichita falls
ZCTA5 76311,48,8987,65272,1313,-666666666,8214,858,2003,46,368,850,459,280,650,639,11,639,10,629,2019-01-01,zipcode,Sheppard afb
ZCTA5 76351,48,2068,47333,561,83200,1640,612,1404,114,572,357,261,100,1034,888,146,888,659,229,2019-01-01,zipcode,Archer city
ZCTA5 76354,48,12114,50630,830,105800,9492,3777,8117,718,2910,2767,1180,542,5653,4945,708,4945,3101,1844,2019-01-01,zipcode,Burkburnett
ZCTA5 76357,48,569,51172,696,75600,399,125,336,10,131,112,56,27,263,197,66,197,154,43,2019-01-01,zipcode,Byers
ZCTA5 76360,48,3545,36364,471,45700,3075,1497,2769,430,1174,786,290,89,2169,1600,569,1600,1123,477,2019-01-01,zipcode,Electra
ZCTA5 76363,48,534,61563,419,23500,394,177,311,78,125,81,25,2,225,169,56,169,143,26,2019-01-01,zipcode,Goree
ZCTA5 76364,48,174,50417,722,68600,122,39,112,1,61,26,14,10,118,69,49,69,46,23,2019-01-01,zipcode,Harrold
ZCTA5 76365,48,4688,49698,809,98800,3914,1871,3425,380,1232,1022,547,244,2616,1941,675,1941,1551,390,2019-01-01,zipcode,Henrietta
ZCTA5 76366,48,1903,51932,833,118000,1548,624,1296,165,440,436,158,97,1039,785,254,785,627,158,2019-01-01,zipcode,Holliday
ZCTA5 76367,48,14247,63026,949,93700,11952,7266,10777,2411,4072,2831,1007,456,3953,3584,369,3584,3027,557,2019-01-01,zipcode,Iowa park
ZCTA5 76370,48,232,58750,-666666666,25800,215,84,197,43,116,9,24,5,182,118,64,118,82,36,2019-01-01,zipcode,Megargel
ZCTA5 76371,48,1367,49922,504,52800,1070,462,907,148,330,227,124,78,807,555,252,555,475,80,2019-01-01,zipcode,Munday
ZCTA5 76372,48,1166,46806,440,81000,866,417,697,93,321,177,67,39,564,433,131,433,324,109,2019-01-01,zipcode,Newcastle
ZCTA5 76373,48,153,34861,-666666666,-666666666,145,82,133,44,48,30,11,0,70,63,7,63,63,0,2019-01-01,zipcode,Oklaunion
ZCTA5 76374,48,3858,48214,644,55800,3057,1253,2823,584,804,819,456,160,2024,1656,368,1656,1142,514,2019-01-01,zipcode,Olney
ZCTA5 76377,48,555,36029,425,58500,456,250,413,65,198,132,18,0,356,254,102,254,224,30,2019-01-01,zipcode,Petrolia
ZCTA5 76379,48,590,61250,653,105900,453,150,322,42,126,98,41,15,200,178,22,178,130,48,2019-01-01,zipcode,Scotland
ZCTA5 76380,48,3630,41127,523,61900,2958,1343,2587,386,893,718,454,136,2727,1552,1175,1552,1129,423,2019-01-01,zipcode,Seymour
ZCTA5 76384,48,12179,44800,608,68800,9807,3575,8412,1939,2796,2386,978,313,5926,4947,979,4947,3006,1941,2019-01-01,zipcode,Vernon
ZCTA5 76388,48,235,48047,744,43300,215,71,180,28,86,44,13,9,134,107,27,107,82,25,2019-01-01,zipcode,Weinert
ZCTA5 76389,48,1257,74432,615,125300,1038,365,843,127,403,171,128,14,518,463,55,463,395,68,2019-01-01,zipcode,Windthorst
ZCTA5 76401,48,30003,52058,913,162300,24346,8971,16518,1450,4043,5208,4141,1676,13278,10049,3229,10049,5706,4343,2019-01-01,zipcode,Stephenville
ZCTA5 76402,48,953,-666666666,-666666666,-666666666,953,625,15,0,0,0,15,0,0,0,0,0,0,0,2019-01-01,zipcode,Stephenville
ZCTA5 76424,48,8721,44976,726,70400,6791,3278,5694,1276,1629,1830,641,318,4320,2943,1377,2943,2416,527,2019-01-01,zipcode,Breckenridge
ZCTA5 76426,48,12351,51845,896,147500,10250,4547,8766,1792,2982,2491,1060,441,4812,4231,581,4231,2868,1363,2019-01-01,zipcode,Bridgeport
ZCTA5 76427,48,859,50341,580,83200,664,355,540,82,268,131,46,13,438,350,88,350,228,122,2019-01-01,zipcode,Bryson
ZCTA5 76429,48,133,-666666666,-666666666,143100,133,35,133,0,53,68,8,4,259,87,172,87,39,48,2019-01-01,zipcode,Caddo
ZCTA5 76430,48,2288,45268,592,90200,1794,745,1479,216,362,475,302,124,1207,923,284,923,750,173,2019-01-01,zipcode,Albany
ZCTA5 76431,48,3630,51707,977,134700,2534,1326,2356,531,968,555,198,104,1530,1281,249,1281,1022,259,2019-01-01,zipcode,Chico
ZCTA5 76432,48,1314,43781,908,134200,1061,502,918,132,306,333,115,32,724,541,183,541,487,54,2019-01-01,zipcode,Blanket
ZCTA5 76433,48,1796,72946,1106,293300,1525,655,1254,35,375,425,223,196,782,582,200,582,514,68,2019-01-01,zipcode,Bluff dale
ZCTA5 76435,48,512,38125,-666666666,52500,436,223,423,36,182,141,48,16,403,206,197,206,195,11,2019-01-01,zipcode,Carbon
ZCTA5 76436,48,227,76250,-666666666,291200,155,74,144,23,42,22,36,21,155,84,71,84,74,10,2019-01-01,zipcode,Carlton
ZCTA5 76437,48,5818,45536,490,80000,4775,2116,3763,487,793,1865,402,216,2925,2027,898,2027,1677,350,2019-01-01,zipcode,Cisco
ZCTA5 76442,48,7909,55531,483,110900,6307,2668,5660,1052,1918,1632,649,409,4098,3160,938,3160,2600,560,2019-01-01,zipcode,Comanche
ZCTA5 76443,48,1914,35743,486,84300,1477,899,1356,177,420,493,239,27,1156,858,298,858,669,189,2019-01-01,zipcode,Cross plains
ZCTA5 76444,48,3339,45054,614,88000,2688,1261,2418,263,903,682,443,127,1758,1435,323,1435,1110,325,2019-01-01,zipcode,De leon
ZCTA5 76445,48,292,28320,-666666666,73900,251,130,216,32,75,79,0,30,210,131,79,131,131,0,2019-01-01,zipcode,Desdemona
ZCTA5 76446,48,7709,51563,710,120500,6036,2193,5217,1102,1549,1407,804,355,3637,2524,1113,2524,2049,475,2019-01-01,zipcode,Dublin
ZCTA5 76448,48,5196,36250,589,88900,4321,2253,3883,528,1313,1186,464,392,3183,1900,1283,1900,1450,450,2019-01-01,zipcode,Eastland
ZCTA5 76449,48,2430,59796,745,121900,2038,903,1906,216,545,753,275,117,2962,988,1974,988,805,183,2019-01-01,zipcode,Graford
ZCTA5 76450,48,13112,54873,719,113300,10358,4240,9127,1481,3141,2747,1184,574,6629,5294,1335,5294,4143,1151,2019-01-01,zipcode,Graham
ZCTA5 76452,48,99,75000,-666666666,-666666666,64,7,31,12,0,19,0,0,43,32,11,32,16,16,2019-01-01,zipcode,Energy
ZCTA5 76453,48,1295,61583,917,192000,1110,571,1050,79,356,292,214,109,815,570,245,570,498,72,2019-01-01,zipcode,Gordon
ZCTA5 76454,48,1870,35583,470,65000,1429,802,1109,210,462,316,106,15,1056,670,386,670,398,272,2019-01-01,zipcode,Gorman
ZCTA5 76455,48,1009,53917,585,87000,778,326,638,99,230,174,126,9,571,361,210,361,317,44,2019-01-01,zipcode,Gustine
ZCTA5 76457,48,4013,39854,754,126600,3235,1490,2804,407,1189,765,297,146,2288,1439,849,1439,1085,354,2019-01-01,zipcode,Hico
ZCTA5 76458,48,6111,49276,745,88500,5018,2869,4174,801,1640,1082,422,229,2600,2011,589,2011,1653,358,2019-01-01,zipcode,Jacksboro
ZCTA5 76459,48,270,91250,-666666666,59200,189,62,162,41,60,54,0,7,148,110,38,110,106,4,2019-01-01,zipcode,Jermyn
ZCTA5 76460,48,233,75221,-666666666,181800,226,80,198,12,17,127,14,28,195,114,81,114,114,0,2019-01-01,zipcode,Loving
ZCTA5 76462,48,3762,81047,1042,225600,3128,1295,2698,338,926,838,391,205,1528,1224,304,1224,1105,119,2019-01-01,zipcode,Lipan
ZCTA5 76463,48,412,37500,1083,68700,388,187,319,27,152,110,21,9,296,176,120,176,158,18,2019-01-01,zipcode,Mingus
ZCTA5 76464,48,505,51667,583,-666666666,438,220,415,60,114,96,91,54,430,256,174,256,216,40,2019-01-01,zipcode,Moran
ZCTA5 76466,48,149,-666666666,-666666666,-666666666,149,42,149,0,64,85,0,0,268,106,162,106,106,0,2019-01-01,zipcode,Olden
ZCTA5 76469,48,93,34583,-666666666,54500,89,71,85,13,27,39,4,2,67,49,18,49,49,0,2019-01-01,zipcode,Putnam
ZCTA5 76470,48,3580,32500,542,57800,2880,1498,2401,541,785,836,146,93,1732,1182,550,1182,845,337,2019-01-01,zipcode,Ranger
ZCTA5 76471,48,1785,37833,611,53000,1547,761,1343,145,413,509,193,83,1205,694,511,694,565,129,2019-01-01,zipcode,Rising star
ZCTA5 76472,48,1761,58591,-666666666,110700,1404,519,1222,240,371,209,305,97,783,643,140,643,489,154,2019-01-01,zipcode,Santo
ZCTA5 76474,48,171,63125,-666666666,119100,156,109,149,14,45,54,22,14,117,89,28,89,85,4,2019-01-01,zipcode,Sidney
ZCTA5 76475,48,956,41667,721,90600,766,397,684,153,220,194,93,24,774,348,426,348,276,72,2019-01-01,zipcode,Strawn
ZCTA5 76476,48,2628,68333,797,180700,2095,762,1868,256,548,654,315,95,1118,978,140,978,818,160,2019-01-01,zipcode,Tolar
ZCTA5 76481,48,189,26141,-666666666,-666666666,96,60,74,15,46,0,13,0,92,51,41,51,28,23,2019-01-01,zipcode,South bend
ZCTA5 76483,48,932,38698,346,57200,814,346,723,117,278,174,135,19,682,449,233,449,304,145,2019-01-01,zipcode,Throckmorton
ZCTA5 76484,48,916,58571,716,186300,769,550,681,59,219,231,122,50,644,356,288,356,307,49,2019-01-01,zipcode,Palo pinto
ZCTA5 76486,48,1125,53654,537,86100,953,401,847,89,311,334,89,24,657,456,201,456,399,57,2019-01-01,zipcode,Perrin
ZCTA5 76487,48,3058,67574,1174,176900,2288,1004,1957,301,823,535,170,128,1179,991,188,991,872,119,2019-01-01,zipcode,Poolville
ZCTA5 76490,48,90,31563,-666666666,-666666666,90,17,65,0,17,35,7,6,74,47,27,47,42,5,2019-01-01,zipcode,Whitt
ZCTA5 76491,48,347,-666666666,646,51200,280,119,245,26,75,115,23,6,244,156,88,156,139,17,2019-01-01,zipcode,Woodson
ZCTA5 76501,48,16710,46280,707,121000,13084,5489,11240,1846,3565,4006,1281,542,7012,6293,719,6293,3888,2405,2019-01-01,zipcode,Temple
ZCTA5 76502,48,42103,71393,1129,163600,31523,11422,27590,1383,6363,9855,6179,3810,16650,15369,1281,15369,10396,4973,2019-01-01,zipcode,Temple
ZCTA5 76504,48,23756,42340,854,96100,18516,7393,15476,2243,5170,5127,1832,1104,10470,9107,1363,9107,3574,5533,2019-01-01,zipcode,Temple
ZCTA5 76508,48,7,-666666666,-666666666,-666666666,7,7,0,0,0,0,0,0,0,0,0,0,0,0,2019-01-01,zipcode,Temple
ZCTA5 76511,48,2505,41445,709,91500,2052,1240,1765,499,682,465,82,37,786,641,145,641,494,147,2019-01-01,zipcode,Bartlett
ZCTA5 76513,48,39411,67124,936,173000,29923,10789,23768,2383,6178,7969,4162,3076,14847,13669,1178,13669,9180,4489,2019-01-01,zipcode,Belton
ZCTA5 76518,48,1880,48491,850,98300,1412,633,1113,153,492,293,145,30,658,561,97,561,466,95,2019-01-01,zipcode,Buckholts
ZCTA5 76519,48,487,48508,-666666666,202000,221,80,197,23,86,37,16,35,271,145,126,145,134,11,2019-01-01,zipcode,Burlington
ZCTA5 76520,48,7722,40771,658,94700,6054,3321,5154,1220,1894,1358,506,176,3859,2833,1026,2833,1879,954,2019-01-01,zipcode,Cameron
ZCTA5 76522,48,36560,53547,868,118300,27961,10518,23556,1554,6333,11221,3103,1345,15359,13651,1708,13651,7859,5792,2019-01-01,zipcode,Copperas cove
ZCTA5 76523,48,0,-666666666,-666666666,-666666666,0,0,0,0,0,0,0,0,0,0,0,0,0,0,2019-01-01,zipcode,Davilla
ZCTA5 76524,48,3042,63770,919,124000,2503,941,2124,239,896,667,205,117,1224,1113,111,1113,995,118,2019-01-01,zipcode,Eddy
ZCTA5 76525,48,1098,55625,825,104900,883,412,798,129,241,228,130,70,657,438,219,438,335,103,2019-01-01,zipcode,Evant
ZCTA5 76527,48,2969,54940,778,171200,2202,898,1975,286,690,732,214,53,1161,1007,154,1007,669,338,2019-01-01,zipcode,Florence
ZCTA5 76528,48,17284,51744,726,113600,13523,6135,12248,1828,3533,4943,1210,734,7228,6256,972,6256,4409,1847,2019-01-01,zipcode,Gatesville
ZCTA5 76530,48,1874,55938,788,150400,1583,673,1417,177,664,389,131,56,786,675,111,675,530,145,2019-01-01,zipcode,Granger
ZCTA5 76531,48,4728,54740,642,136200,3882,2021,3435,594,1123,934,575,209,2521,1743,778,1743,1456,287,2019-01-01,zipcode,Hamilton
ZCTA5 76534,48,3046,60200,827,157300,2171,882,1948,236,669,678,230,135,1182,1014,168,1014,751,263,2019-01-01,zipcode,Holland
ZCTA5 76537,48,5782,79773,1327,180000,4324,1186,3538,386,1013,1284,583,272,2001,1814,187,1814,1439,375,2019-01-01,zipcode,Jarrell
ZCTA5 76538,48,1025,82500,1275,158800,782,329,685,33,228,261,105,58,435,360,75,360,242,118,2019-01-01,zipcode,Jonesboro
ZCTA5 76539,48,8608,66736,780,190400,7030,3180,6175,379,1441,3051,796,508,3695,3182,513,3182,2850,332,2019-01-01,zipcode,Kempner
ZCTA5 76541,48,17691,31167,696,69900,13703,4839,10728,1996,3338,4381,796,217,9928,7564,2364,7564,2085,5479,2019-01-01,zipcode,Killeen
ZCTA5 76542,48,51405,62751,1050,153900,37793,11953,30503,2081,6615,13892,5593,2322,19714,18194,1520,18194,10066,8128,2019-01-01,zipcode,Killeen
ZCTA5 76543,48,30268,41081,847,91500,22556,6970,18608,1885,5785,8213,1884,841,13629,11847,1782,11847,4314,7533,2019-01-01,zipcode,Killeen
ZCTA5 76544,48,23834,45179,1251,92000,19275,2821,7597,320,1686,3985,1234,372,6666,3319,3347,3319,70,3249,2019-01-01,zipcode,Fort hood
ZCTA5 76548,48,30510,74436,934,202100,23086,8989,19408,1813,4046,6715,4507,2327,11815,10234,1581,10234,6268,3966,2019-01-01,zipcode,Harker heights
ZCTA5 76549,48,52012,52933,1073,138900,36762,11821,29399,1576,6665,14562,4540,2056,20112,17895,2217,17895,8737,9158,2019-01-01,zipcode,Killeen
ZCTA5 76550,48,13412,54423,740,145900,10612,4325,9304,1040,3104,3407,1165,588,5738,4956,782,4956,3583,1373,2019-01-01,zipcode,Lampasas
ZCTA5 76554,48,2380,57679,912,112300,1703,538,1446,202,477,540,193,34,858,749,109,749,534,215,2019-01-01,zipcode,Little river academy
ZCTA5 76556,48,1494,52917,757,118200,1214,573,1037,128,459,254,104,92,723,591,132,591,515,76,2019-01-01,zipcode,Milano
ZCTA5 76557,48,5331,64261,636,150400,4371,1879,3640,378,1513,1220,244,285,2099,1874,225,1874,1564,310,2019-01-01,zipcode,Moody
ZCTA5 76559,48,6211,55000,877,132600,4361,1379,3723,269,1213,1446,452,343,2444,2128,316,2128,1226,902,2019-01-01,zipcode,Nolanville
ZCTA5 76561,48,1030,68571,700,88800,786,286,699,123,235,215,93,33,405,372,33,372,283,89,2019-01-01,zipcode,Oglesby
ZCTA5 76565,48,138,38173,-666666666,275000,138,108,103,9,25,10,35,24,51,51,0,51,51,0,2019-01-01,zipcode,Pottsville
ZCTA5 76566,48,242,61875,-666666666,179900,191,53,171,9,48,55,59,0,131,98,33,98,91,7,2019-01-01,zipcode,Purmela
ZCTA5 76567,48,9161,51484,774,109800,7272,3157,6356,1092,2445,2095,406,318,4121,3556,565,3556,2365,1191,2019-01-01,zipcode,Rockdale
ZCTA5 76569,48,2681,66111,1034,85500,1987,739,1678,146,617,711,148,56,918,812,106,812,584,228,2019-01-01,zipcode,Rogers
ZCTA5 76570,48,2700,46250,642,65000,2105,1138,1953,362,817,373,337,64,1366,868,498,868,671,197,2019-01-01,zipcode,Rosebud
ZCTA5 76571,48,8630,85194,716,292700,6566,2350,5739,258,1193,1726,1535,1027,3296,2933,363,2933,2428,505,2019-01-01,zipcode,Salado
ZCTA5 76573,48,29,-666666666,-666666666,-666666666,23,18,14,10,4,0,0,0,9,9,0,9,9,0,2019-01-01,zipcode,Schwertner
ZCTA5 76574,48,19161,54060,923,163400,15562,6019,13851,2738,5094,3864,1461,694,6954,6356,598,6356,4322,2034,2019-01-01,zipcode,Taylor
ZCTA5 76577,48,3187,60944,838,149300,2677,1080,2258,338,801,664,389,66,1363,1214,149,1214,938,276,2019-01-01,zipcode,Thorndale
ZCTA5 76578,48,1482,70406,1096,160400,1136,311,976,114,417,322,98,25,540,433,107,433,358,75,2019-01-01,zipcode,Thrall
ZCTA5 76579,48,5223,63140,994,140600,3740,1364,3204,246,1095,1185,552,126,1779,1586,193,1586,1202,384,2019-01-01,zipcode,Troy
ZCTA5 76596,48,1250,-666666666,-666666666,-666666666,1250,1250,1172,299,282,520,60,11,0,0,0,0,0,0,2019-01-01,zipcode,Gatesville
ZCTA5 76597,48,2657,-666666666,-666666666,-666666666,2657,2657,2626,770,959,797,72,28,0,0,0,0,0,0,2019-01-01,zipcode,Gatesville
ZCTA5 76598,48,479,-666666666,-666666666,-666666666,479,479,418,128,136,144,7,3,0,0,0,0,0,0,2019-01-01,zipcode,Gatesville
ZCTA5 76599,48,2339,-666666666,-666666666,-666666666,2339,2339,2136,622,628,826,57,3,0,0,0,0,0,0,2019-01-01,zipcode,Gatesville
ZCTA5 76621,48,867,77125,808,173900,681,197,613,34,162,218,133,66,428,355,73,355,315,40,2019-01-01,zipcode,Abbott
ZCTA5 76622,48,1160,58988,947,104400,953,356,852,94,312,275,110,61,620,444,176,444,354,90,2019-01-01,zipcode,Aquilla
ZCTA5 76623,48,259,66750,-666666666,92900,194,56,178,64,34,75,2,3,81,81,0,81,76,5,2019-01-01,zipcode,Avalon
ZCTA5 76624,48,2015,73405,699,109500,1550,625,1373,207,398,539,174,55,893,727,166,727,582,145,2019-01-01,zipcode,Axtell
ZCTA5 76626,48,1386,56985,905,93800,989,423,819,81,294,313,116,15,579,457,122,457,314,143,2019-01-01,zipcode,Blooming grove
ZCTA5 76627,48,1511,62344,881,89000,1175,394,980,149,436,274,46,75,612,531,81,531,479,52,2019-01-01,zipcode,Blum
ZCTA5 76628,48,54,28125,-666666666,-666666666,47,13,41,14,9,18,0,0,45,27,18,27,23,4,2019-01-01,zipcode,Brandon
ZCTA5 76629,48,1668,42847,683,84300,1448,762,1231,203,481,393,107,47,1172,721,451,721,481,240,2019-01-01,zipcode,Bremond
ZCTA5 76630,48,1359,77564,1016,148800,1027,501,1002,107,373,412,88,22,588,472,116,472,426,46,2019-01-01,zipcode,Bruceville
ZCTA5 76631,48,692,70781,993,107100,547,210,415,69,106,143,78,19,247,193,54,193,154,39,2019-01-01,zipcode,Bynum
ZCTA5 76632,48,1613,44643,1099,83900,1256,521,1019,275,332,304,108,0,852,588,264,588,466,122,2019-01-01,zipcode,Chilton
ZCTA5 76633,48,5290,94620,940,213500,4142,1647,3617,197,1048,1361,773,238,1899,1793,106,1793,1614,179,2019-01-01,zipcode,China spring
ZCTA5 76634,48,7431,55923,840,141700,6187,2790,5700,662,1702,2008,982,346,3978,2930,1048,2930,2248,682,2019-01-01,zipcode,Clifton
ZCTA5 76635,48,1290,38947,608,65900,956,391,861,177,228,301,107,48,596,450,146,450,342,108,2019-01-01,zipcode,Coolidge
ZCTA5 76636,48,1525,58889,718,126000,1263,469,1093,147,415,362,125,44,676,574,102,574,487,87,2019-01-01,zipcode,Covington
ZCTA5 76637,48,540,50221,497,126800,453,251,381,88,111,107,47,28,329,251,78,251,189,62,2019-01-01,zipcode,Cranfills gap
ZCTA5 76638,48,2910,80833,950,240700,2133,843,1934,94,449,694,397,300,1139,1036,103,1036,913,123,2019-01-01,zipcode,Crawford
ZCTA5 76639,48,1318,43125,525,84500,1065,452,940,124,300,310,137,69,796,559,237,559,368,191,2019-01-01,zipcode,Dawson
ZCTA5 76640,48,3567,41479,817,88200,2638,1244,2353,420,790,825,228,90,1455,1222,233,1222,836,386,2019-01-01,zipcode,Elm mott
ZCTA5 76641,48,1575,40357,756,86800,1288,667,1126,246,383,330,87,80,735,578,157,578,483,95,2019-01-01,zipcode,Frost
ZCTA5 76642,48,6949,45761,691,117100,5634,2888,4841,783,1496,1702,661,199,3081,2528,553,2528,1845,683,2019-01-01,zipcode,Groesbeck
ZCTA5 76643,48,14523,72077,1155,167500,11693,4066,10235,732,2284,3878,2156,1185,5713,5425,288,5425,3962,1463,2019-01-01,zipcode,Hewitt
ZCTA5 76645,48,10568,48095,789,93600,8252,3307,6720,1279,2180,2004,822,435,4437,3746,691,3746,2238,1508,2019-01-01,zipcode,Hillsboro
ZCTA5 76648,48,2887,53575,740,90000,2319,1128,2016,268,701,749,223,75,1310,1055,255,1055,774,281,2019-01-01,zipcode,Hubbard
ZCTA5 76649,48,596,46442,700,128100,473,238,430,52,187,94,72,25,351,245,106,245,222,23,2019-01-01,zipcode,Iredell
ZCTA5 76650,48,186,54643,-666666666,69500,135,55,132,33,53,38,8,0,107,64,43,64,57,7,2019-01-01,zipcode,Irene
ZCTA5 76651,48,3250,56607,849,105600,2597,913,2235,311,745,903,202,74,1519,1247,272,1247,827,420,2019-01-01,zipcode,Italy
ZCTA5 76652,48,1349,45216,730,87100,1095,580,939,85,444,291,86,33,649,519,130,519,445,74,2019-01-01,zipcode,Kopperl
ZCTA5 76653,48,1279,52917,663,132500,1076,512,946,140,415,337,32,22,628,468,160,468,382,86,2019-01-01,zipcode,Kosse
ZCTA5 76654,48,139,27917,875,97500,113,64,106,14,58,19,11,4,61,57,4,57,39,18,2019-01-01,zipcode,Leroy
ZCTA5 76655,48,8312,97760,1003,201100,6551,1905,5524,233,1367,2219,1272,433,3145,2921,224,2921,2446,475,2019-01-01,zipcode,Lorena
ZCTA5 76656,48,2446,57292,538,108800,1918,686,1607,220,594,535,219,39,991,712,279,712,570,142,2019-01-01,zipcode,Lott
ZCTA5 76657,48,10108,80525,1104,194200,7896,2546,6818,812,1771,2229,1181,825,3723,3379,344,3379,2438,941,2019-01-01,zipcode,Mc gregor
ZCTA5 76660,48,561,50568,838,82600,416,149,337,62,129,101,31,14,245,169,76,169,131,38,2019-01-01,zipcode,Malone
ZCTA5 76661,48,7755,24970,453,58400,6428,4243,5599,1740,2157,1359,247,96,3303,2081,1222,2081,1183,898,2019-01-01,zipcode,Marlin
ZCTA5 76664,48,3688,46406,803,109200,2747,1196,2235,274,812,754,321,74,1463,1214,249,1214,876,338,2019-01-01,zipcode,Mart
ZCTA5 76665,48,2417,49375,703,112800,1939,944,1694,234,570,556,178,156,1285,954,331,954,673,281,2019-01-01,zipcode,Meridian
ZCTA5 76666,48,268,51528,-666666666,110000,196,68,170,8,59,85,15,3,137,91,46,91,72,19,2019-01-01,zipcode,Mertens
ZCTA5 76667,48,11098,44241,721,84700,8706,3713,7454,1742,2372,2382,654,304,4662,3814,848,3814,2697,1117,2019-01-01,zipcode,Mexia
ZCTA5 76670,48,1517,47059,988,101500,1205,433,1055,279,386,339,44,7,590,476,114,476,345,131,2019-01-01,zipcode,Milford
ZCTA5 76671,48,1621,48427,776,116700,1357,712,1205,195,487,367,94,62,1140,711,429,711,574,137,2019-01-01,zipcode,Morgan
ZCTA5 76673,48,1706,47717,596,124100,1051,418,907,217,299,291,77,23,583,460,123,460,341,119,2019-01-01,zipcode,Mount calm
ZCTA5 76676,48,281,52778,-666666666,90000,213,83,191,43,65,63,16,4,131,98,33,98,88,10,2019-01-01,zipcode,Penelope
ZCTA5 76678,48,260,40326,836,147700,183,102,162,10,43,73,20,16,129,84,45,84,44,40,2019-01-01,zipcode,Prairie hill
ZCTA5 76679,48,1435,56354,-666666666,101500,1082,445,960,112,380,280,159,29,720,530,190,530,428,102,2019-01-01,zipcode,Purdon
ZCTA5 76680,48,279,-666666666,-666666666,-666666666,246,146,226,50,85,56,28,7,156,108,48,108,108,0,2019-01-01,zipcode,Reagan
ZCTA5 76681,48,801,40556,981,112700,643,288,525,104,192,169,49,11,468,294,174,294,213,81,2019-01-01,zipcode,Richland
ZCTA5 76682,48,2846,59609,873,95200,2246,956,1945,248,753,568,279,97,1172,1015,157,1015,772,243,2019-01-01,zipcode,Riesel
ZCTA5 76685,48,40,53824,-666666666,-666666666,40,15,40,8,15,0,17,0,81,32,49,32,15,17,2019-01-01,zipcode,Satin
ZCTA5 76686,48,195,37500,725,79600,149,70,144,16,46,46,29,7,103,84,19,84,65,19,2019-01-01,zipcode,Tehuacana
ZCTA5 76687,48,1879,46220,876,137800,1588,981,1486,105,700,462,169,50,1187,769,418,769,666,103,2019-01-01,zipcode,Thornton
ZCTA5 76689,48,3565,56741,951,127600,2698,1019,2318,308,742,741,357,170,1729,1330,399,1330,1078,252,2019-01-01,zipcode,Valley mills
ZCTA5 76690,48,1101,38036,806,93200,811,348,650,166,255,117,77,35,529,379,150,379,249,130,2019-01-01,zipcode,Walnut springs
ZCTA5 76691,48,6333,63881,851,113600,5141,1830,4439,536,1356,1703,594,250,2807,2360,447,2360,1823,537,2019-01-01,zipcode,West
ZCTA5 76692,48,10252,51409,687,105900,8599,4035,7634,1085,2826,2256,1009,458,5604,4081,1523,4081,3101,980,2019-01-01,zipcode,Whitney
ZCTA5 76693,48,1492,37500,726,112900,1098,571,904,164,230,356,112,42,756,514,242,514,320,194,2019-01-01,zipcode,Wortham
ZCTA5 76701,48,1895,34500,1043,-666666666,1638,751,1225,239,276,365,184,161,895,706,189,706,156,550,2019-01-01,zipcode,Waco
ZCTA5 76704,48,7956,21398,646,85500,5700,2876,4370,693,1884,1483,182,128,3673,3140,533,3140,1131,2009,2019-01-01,zipcode,Waco
ZCTA5 76705,48,31734,44338,743,97800,24947,11104,19373,4163,5803,6889,1696,822,12289,10632,1657,10632,6291,4341,2019-01-01,zipcode,Waco
ZCTA5 76706,48,39221,34070,873,123400,31504,13393,16286,2899,4841,5025,2106,1415,15252,13310,1942,13310,5269,8041,2019-01-01,zipcode,Waco
ZCTA5 76707,48,15688,29235,829,77800,11236,4685,8665,2771,2500,2155,781,458,6175,5225,950,5225,2377,2848,2019-01-01,zipcode,Waco
ZCTA5 76708,48,27964,51432,886,140500,20555,7008,17199,3213,4437,5824,2360,1365,10647,9740,907,9740,6088,3652,2019-01-01,zipcode,Waco
ZCTA5 76710,48,24837,44983,807,137300,20148,6983,17178,1759,4603,5654,3324,1838,11801,10814,987,10814,5249,5565,2019-01-01,zipcode,Waco
ZCTA5 76711,48,9988,46926,1047,68500,7776,2532,6295,1971,1589,1940,506,289,3974,3470,504,3470,1790,1680,2019-01-01,zipcode,Waco
ZCTA5 76712,48,25525,71929,982,209000,20009,7007,17800,1100,2801,5931,4881,3087,10747,10007,740,10007,7137,2870,2019-01-01,zipcode,Woodway
ZCTA5 76798,48,1591,-666666666,-666666666,-666666666,1591,1315,7,0,0,7,0,0,0,0,0,0,0,0,2019-01-01,zipcode,Waco
ZCTA5 76801,48,25011,46388,787,98100,20192,8955,16933,2438,6402,5078,2162,853,12027,9324,2703,9324,6302,3022,2019-01-01,zipcode,Brownwood
ZCTA5 76802,48,5251,60250,751,119200,4217,1543,3544,344,1155,1246,587,212,2263,1985,278,1985,1511,474,2019-01-01,zipcode,Early
ZCTA5 76820,48,88,155714,-666666666,395200,88,33,88,0,26,36,16,10,145,50,95,50,40,10,2019-01-01,zipcode,Art
ZCTA5 76821,48,4561,44643,767,80300,3773,1797,3366,645,1213,915,475,118,2381,1792,589,1792,1315,477,2019-01-01,zipcode,Ballinger
ZCTA5 76823,48,3024,48807,527,89400,2470,1121,2217,240,800,779,308,90,1483,1165,318,1165,978,187,2019-01-01,zipcode,Bangs
ZCTA5 76824,48,9,-666666666,-666666666,-666666666,9,9,9,0,0,9,0,0,9,9,0,9,0,9,2019-01-01,zipcode,Bend
ZCTA5 76825,48,6908,48017,742,91600,5502,2179,4739,1188,1269,1494,582,206,3389,2599,790,2599,1809,790,2019-01-01,zipcode,Brady
ZCTA5 76827,48,418,55313,-666666666,103800,329,146,319,53,136,75,39,16,266,171,95,171,154,17,2019-01-01,zipcode,Brookesmith
ZCTA5 76828,48,240,75313,-666666666,123500,189,80,189,22,47,90,30,0,205,95,110,95,88,7,2019-01-01,zipcode,Burkett
ZCTA5 76831,48,0,-666666666,-666666666,-666666666,0,0,0,0,0,0,0,0,94,0,94,0,0,0,2019-01-01,zipcode,Castell
ZCTA5 76832,48,728,37000,629,137500,555,241,498,119,157,151,68,3,358,224,134,224,137,87,2019-01-01,zipcode,Cherokee
ZCTA5 76834,48,5310,45706,726,69100,4261,1833,3851,574,1525,1240,349,163,3383,2223,1160,2223,1575,648,2019-01-01,zipcode,Coleman
ZCTA5 76836,48,0,-666666666,-666666666,-666666666,0,0,0,0,0,0,0,0,15,0,15,0,0,0,2019-01-01,zipcode,Doole
ZCTA5 76837,48,2440,34844,735,78200,2096,1555,1940,802,603,333,140,62,861,562,299,562,371,191,2019-01-01,zipcode,Eden
ZCTA5 76841,48,19,-666666666,-666666666,-666666666,19,0,19,10,9,0,0,0,88,10,78,10,10,0,2019-01-01,zipcode,Fort mc kavett
ZCTA5 76842,48,242,41579,-666666666,46600,230,173,216,54,37,91,34,0,202,94,108,94,79,15,2019-01-01,zipcode,Fredonia
ZCTA5 76844,48,3534,51000,623,136600,2941,1400,2544,472,752,835,381,104,2017,1306,711,1306,1078,228,2019-01-01,zipcode,Goldthwaite
ZCTA5 76845,48,288,66563,-666666666,158900,226,106,214,22,65,62,48,17,208,109,99,109,91,18,2019-01-01,zipcode,Gouldbusk
ZCTA5 76848,48,48,35125,-666666666,-666666666,48,35,48,0,23,25,0,0,75,31,44,31,31,0,2019-01-01,zipcode,Hext
ZCTA5 76849,48,3785,43231,732,123500,3060,1185,2714,414,954,795,311,240,2643,1467,1176,1467,1086,381,2019-01-01,zipcode,Junction
ZCTA5 76852,48,268,56607,567,132800,222,91,200,12,67,77,19,25,233,121,112,121,101,20,2019-01-01,zipcode,Lohn
ZCTA5 76853,48,1456,57963,812,127700,1153,566,1022,100,356,324,183,59,912,530,382,530,398,132,2019-01-01,zipcode,Lometa
ZCTA5 76854,48,220,27019,-666666666,-666666666,220,114,197,65,23,71,30,8,357,163,194,163,111,52,2019-01-01,zipcode,London
ZCTA5 76856,48,3735,40170,790,168800,2960,1000,2500,336,701,812,476,175,2230,1501,729,1501,1029,472,2019-01-01,zipcode,Mason
ZCTA5 76857,48,1761,43261,-666666666,87300,1456,842,1331,80,399,521,209,122,1715,800,915,800,631,169,2019-01-01,zipcode,May
ZCTA5 76858,48,292,34306,-666666666,55500,226,140,215,78,23,53,35,26,222,127,95,127,99,28,2019-01-01,zipcode,Melvin
ZCTA5 76859,48,2015,36059,602,58500,1771,736,1659,379,581,388,199,112,1642,950,692,950,646,304,2019-01-01,zipcode,Menard
ZCTA5 76861,48,1945,65313,738,119500,1449,554,1204,171,423,346,184,80,812,617,195,617,483,134,2019-01-01,zipcode,Miles
ZCTA5 76862,48,207,63833,-666666666,179900,175,73,165,13,75,47,22,8,282,92,190,92,71,21,2019-01-01,zipcode,Millersview
ZCTA5 76864,48,821,37543,-666666666,164500,659,449,614,68,264,175,65,42,518,301,217,301,275,26,2019-01-01,zipcode,Mullin
ZCTA5 76865,48,151,-666666666,-666666666,134700,151,89,139,29,58,45,0,7,136,68,68,68,63,5,2019-01-01,zipcode,Norton
ZCTA5 76866,48,537,73750,-666666666,161000,461,225,439,26,111,214,77,11,439,206,233,206,192,14,2019-01-01,zipcode,Paint rock
ZCTA5 76869,48,64,30875,-666666666,-666666666,64,36,49,0,13,10,6,20,144,43,101,43,43,0,2019-01-01,zipcode,Pontotoc
ZCTA5 76870,48,270,56875,-666666666,90800,206,77,169,23,69,47,27,3,156,95,61,95,79,16,2019-01-01,zipcode,Priddy
ZCTA5 76871,48,657,55417,608,150000,548,217,516,83,172,150,74,37,583,277,306,277,200,77,2019-01-01,zipcode,Richland springs
ZCTA5 76872,48,770,56875,665,134400,654,312,587,43,200,205,89,50,564,336,228,336,288,48,2019-01-01,zipcode,Rochelle
ZCTA5 76873,48,60,58098,-666666666,850800,60,54,60,4,16,3,8,29,92,41,51,41,37,4,2019-01-01,zipcode,Rockwood
ZCTA5 76874,48,0,-666666666,-666666666,-666666666,0,0,0,0,0,0,0,0,124,0,124,0,0,0,2019-01-01,zipcode,Roosevelt
ZCTA5 76875,48,525,45375,917,99300,447,150,413,22,185,139,47,20,302,239,63,239,180,59,2019-01-01,zipcode,Rowena
ZCTA5 76877,48,4371,44268,766,107900,3599,1728,3002,813,1064,739,307,79,2093,1484,609,1484,1020,464,2019-01-01,zipcode,San saba
ZCTA5 76878,48,1688,51802,648,91700,1394,655,1223,141,428,469,156,29,910,622,288,622,475,147,2019-01-01,zipcode,Santa anna
ZCTA5 76882,48,214,34875,-666666666,112500,193,124,190,12,36,69,62,11,183,103,80,103,82,21,2019-01-01,zipcode,Talpa
ZCTA5 76884,48,115,46719,-666666666,33100,103,55,85,1,39,32,6,7,64,41,23,41,33,8,2019-01-01,zipcode,Valera
ZCTA5 76885,48,216,-666666666,-666666666,-666666666,103,76,94,0,9,57,10,18,194,71,123,71,48,23,2019-01-01,zipcode,Valley spring
ZCTA5 76887,48,82,-666666666,-666666666,-666666666,82,30,82,0,52,11,19,0,88,51,37,51,43,8,2019-01-01,zipcode,Voca
ZCTA5 76888,48,151,-666666666,-666666666,170300,132,91,129,13,22,69,19,6,199,86,113,86,69,17,2019-01-01,zipcode,Voss
ZCTA5 76890,48,982,63542,-666666666,122900,814,398,719,58,244,290,88,39,451,336,115,336,308,28,2019-01-01,zipcode,Zephyr
ZCTA5 76901,48,31667,57406,933,119700,24802,8844,21178,2771,7234,6386,2854,1933,12743,11617,1126,11617,7912,3705,2019-01-01,zipcode,San angelo
ZCTA5 76903,48,31248,37455,782,84500,24762,9827,21222,5031,7520,6015,1850,806,13853,11682,2171,11682,7228,4454,2019-01-01,zipcode,San angelo
ZCTA5 76904,48,36178,66454,888,202300,28731,9607,22549,1290,4680,7973,5663,2943,15510,14343,1167,14343,8247,6096,2019-01-01,zipcode,San angelo
ZCTA5 76905,48,12206,59042,964,143100,8705,3001,7412,1078,2486,2270,1136,442,4810,4332,478,4332,2934,1398,2019-01-01,zipcode,San angelo
ZCTA5 76908,48,2554,-666666666,-666666666,-666666666,2554,57,375,0,53,213,109,0,8,0,8,0,0,0,2019-01-01,zipcode,Goodfellow afb
ZCTA5 76930,48,107,61250,-666666666,81800,91,23,91,23,51,17,0,0,67,41,26,41,34,7,2019-01-01,zipcode,Barnhart
ZCTA5 76932,48,3819,74342,842,99300,2622,831,2161,387,911,649,161,53,1288,1092,196,1092,726,366,2019-01-01,zipcode,Big lake
ZCTA5 76933,48,1209,48548,679,81700,963,395,895,172,349,264,59,51,701,556,145,556,386,170,2019-01-01,zipcode,Bronte
ZCTA5 76934,48,1084,52813,775,-666666666,893,518,726,103,249,229,69,76,433,359,74,359,310,49,2019-01-01,zipcode,Carlsbad
ZCTA5 76935,48,1791,77829,-666666666,221400,1319,655,1248,41,336,508,276,87,652,565,87,565,544,21,2019-01-01,zipcode,Christoval
ZCTA5 76936,48,2983,53229,439,77800,2277,784,1968,402,488,752,271,55,1502,1075,427,1075,848,227,2019-01-01,zipcode,Eldorado
ZCTA5 76937,48,15,-666666666,-666666666,-666666666,15,7,15,0,0,0,15,0,8,8,0,8,8,0,2019-01-01,zipcode,Eola
ZCTA5 76939,48,0,-666666666,-666666666,-666666666,0,0,0,0,0,0,0,0,8,0,8,0,0,0,2019-01-01,zipcode,Knickerbocker
ZCTA5 76940,48,113,-666666666,-666666666,-666666666,111,34,106,0,5,74,27,0,73,47,26,47,47,0,2019-01-01,zipcode,Mereta
ZCTA5 76941,48,1455,43594,975,120600,1067,460,911,45,336,387,119,24,783,602,181,602,477,125,2019-01-01,zipcode,Mertzon
ZCTA5 76943,48,3420,45568,554,105500,2800,1125,2411,544,869,677,231,90,1857,1352,505,1352,1012,340,2019-01-01,zipcode,Ozona
ZCTA5 76945,48,1798,42895,566,61300,1453,654,1353,212,428,404,185,124,1412,876,536,876,667,209,2019-01-01,zipcode,Robert lee
ZCTA5 76949,48,12,-666666666,-666666666,-666666666,11,10,10,2,2,6,0,0,15,5,10,5,5,0,2019-01-01,zipcode,Silver
ZCTA5 76950,48,3867,54271,637,92100,2938,1002,2603,667,845,644,291,156,2095,1421,674,1421,981,440,2019-01-01,zipcode,Sonora
ZCTA5 76951,48,1231,59868,850,59000,907,264,775,82,403,216,41,33,592,458,134,458,392,66,2019-01-01,zipcode,Sterling city
ZCTA5 76953,48,101,-666666666,-666666666,-666666666,101,40,84,1,44,39,0,0,98,67,31,67,25,42,2019-01-01,zipcode,Tennyson
ZCTA5 76955,48,192,94107,-666666666,205000,139,34,114,16,9,20,59,10,80,53,27,53,32,21,2019-01-01,zipcode,Vancourt
ZCTA5 76957,48,134,-666666666,-666666666,-666666666,62,31,62,0,31,31,0,0,31,31,0,31,0,31,2019-01-01,zipcode,Wall
ZCTA5 76958,48,183,-666666666,-666666666,195200,172,118,150,0,83,46,21,0,130,80,50,80,77,3,2019-01-01,zipcode,Water valley
ZCTA5 77002,48,15613,71369,1490,236700,15495,9943,12828,2244,3729,2689,2588,1578,5691,4678,1013,4678,797,3881,2019-01-01,zipcode,Houston
ZCTA5 77003,48,9707,72295,1183,302800,8320,1777,7023,1319,1113,1302,1645,1644,5435,4698,737,4698,2123,2575,2019-01-01,zipcode,Houston
ZCTA5 77004,48,37294,51309,1052,292800,33128,13682,21506,1754,4056,4548,5491,5657,16641,13418,3223,13418,4504,8914,2019-01-01,zipcode,Houston
ZCTA5 77005,48,28572,192380,1772,1060400,22093,8786,17779,251,688,1820,6122,8898,10793,10107,686,10107,7320,2787,2019-01-01,zipcode,Houston
ZCTA5 77006,48,22580,85956,1484,464900,20735,4230,18210,596,825,3310,6782,6697,14938,12972,1966,12972,4543,8429,2019-01-01,zipcode,Houston
ZCTA5 77007,48,40080,125653,1690,422200,35856,4907,32224,814,1777,4721,14390,10522,22929,20394,2535,20394,10517,9877,2019-01-01,zipcode,Houston
ZCTA5 77008,48,34895,108644,1274,445800,29593,5631,27373,1808,3141,4542,10467,7415,17813,16337,1476,16337,9687,6650,2019-01-01,zipcode,Houston
ZCTA5 77009,48,36147,56316,885,281200,28942,8660,25618,6551,5237,5012,5308,3510,16227,14123,2104,14123,8309,5814,2019-01-01,zipcode,Houston
ZCTA5 77010,48,890,250001,3026,864300,879,222,865,0,20,96,428,321,858,600,258,600,58,542,2019-01-01,zipcode,Houston
ZCTA5 77011,48,17447,31314,685,89400,13525,5640,11280,5306,2957,1939,810,268,6895,5922,973,5922,2557,3365,2019-01-01,zipcode,Houston
ZCTA5 77012,48,19597,39489,775,82300,14515,5351,12561,6109,3739,1796,803,114,7025,5981,1044,5981,2516,3465,2019-01-01,zipcode,Houston
ZCTA5 77013,48,19198,38665,925,90500,14709,6380,11670,4533,3464,2760,720,193,6527,5823,704,5823,2294,3529,2019-01-01,zipcode,Houston
ZCTA5 77014,48,37488,50938,977,146400,27554,8147,22447,4583,5997,7785,2879,1203,13061,11801,1260,11801,5144,6657,2019-01-01,zipcode,Houston
ZCTA5 77015,48,56477,47371,933,109500,40494,14709,32349,10451,10095,8208,2447,1148,19329,17384,1945,17384,8889,8495,2019-01-01,zipcode,Houston
ZCTA5 77016,48,30741,36335,897,71300,23566,10428,19324,6067,7067,4560,1089,541,11038,9679,1359,9679,5758,3921,2019-01-01,zipcode,Houston
ZCTA5 77017,48,32985,49994,869,101300,25190,9012,20457,7746,6092,4733,1339,547,11151,10087,1064,10087,5260,4827,2019-01-01,zipcode,Houston
ZCTA5 77018,48,28229,90422,934,405000,21465,7179,19600,2383,3511,3601,5993,4112,12214,10934,1280,10934,7703,3231,2019-01-01,zipcode,Houston
ZCTA5 77019,48,22057,116207,1687,596500,19421,5049,17188,459,1120,2730,7007,5872,12404,11233,1171,11233,5731,5502,2019-01-01,zipcode,Houston
ZCTA5 77020,48,26357,32207,747,78900,19693,8543,16322,5904,4983,3790,1241,404,9933,8670,1263,8670,3876,4794,2019-01-01,zipcode,Houston
ZCTA5 77021,48,26214,37913,949,107900,21219,8583,17289,2528,5005,4649,3127,1980,12493,10720,1773,10720,4155,6565,2019-01-01,zipcode,Houston
ZCTA5 77022,48,27924,31183,767,106700,21010,8730,17319,7656,4838,3451,1044,330,10538,9255,1283,9255,4057,5198,2019-01-01,zipcode,Houston
ZCTA5 77023,48,29138,41583,829,142900,22507,8319,18836,6419,5173,3823,2284,1137,11107,9837,1270,9837,4506,5331,2019-01-01,zipcode,Houston
ZCTA5 77024,48,38190,123274,1617,996100,29705,12114,26188,422,1727,3929,11196,8914,17210,15218,1992,15218,9901,5317,2019-01-01,zipcode,Houston
ZCTA5 77025,48,28540,76772,1250,439300,23284,7260,20491,1494,2134,3061,5841,7961,14452,12590,1862,12590,5212,7378,2019-01-01,zipcode,Houston
ZCTA5 77026,48,21300,28678,719,65500,17137,8007,14666,5220,5634,2745,796,271,9596,7960,1636,7960,3205,4755,2019-01-01,zipcode,Houston
ZCTA5 77027,48,18323,98463,1588,765400,16161,4188,14428,338,552,2587,5961,4990,11613,9733,1880,9733,3095,6638,2019-01-01,zipcode,Houston
ZCTA5 77028,48,17425,29014,870,69600,13399,5928,11393,3393,4265,2730,753,252,6807,5847,960,5847,3269,2578,2019-01-01,zipcode,Houston
ZCTA5 77029,48,17781,38183,820,76400,13389,5730,11035,4665,2905,2585,569,311,6496,5647,849,5647,3500,2147,2019-01-01,zipcode,Houston
ZCTA5 77030,48,11229,90075,1525,591800,9013,2898,7749,119,202,697,2685,4046,5913,5058,855,5058,2065,2993,2019-01-01,zipcode,Houston
ZCTA5 77031,48,18058,48029,914,153700,13902,4208,11241,3055,2645,2770,1910,861,6755,6296,459,6296,2673,3623,2019-01-01,zipcode,Houston
ZCTA5 77032,48,14535,32473,975,87200,9473,3825,7257,2474,2027,2062,426,268,4611,4315,296,4315,1513,2802,2019-01-01,zipcode,Houston
ZCTA5 77033,48,30558,38162,940,67000,22588,10176,18639,5067,6882,5103,1222,365,10373,9165,1208,9165,5356,3809,2019-01-01,zipcode,Houston
ZCTA5 77034,48,40635,51608,1017,125700,29541,8691,22989,6688,6764,6398,2198,941,13791,12248,1543,12248,5243,7005,2019-01-01,zipcode,Houston
ZCTA5 77035,48,36931,44382,889,223900,28302,9004,24275,5526,5528,6099,4170,2952,15813,13764,2049,13764,5779,7985,2019-01-01,zipcode,Houston
ZCTA5 77036,48,74472,30952,824,151100,55003,16690,45848,15626,13200,9144,5484,2394,31124,26500,4624,26500,4918,21582,2019-01-01,zipcode,Houston
ZCTA5 77037,48,18966,43180,922,105500,13764,5075,11318,6476,3031,1442,330,39,5547,5136,411,5136,3646,1490,2019-01-01,zipcode,Houston
ZCTA5 77038,48,31912,41052,1003,119100,22161,7870,18161,7378,5029,4330,895,529,9459,9075,384,9075,5076,3999,2019-01-01,zipcode,Houston
ZCTA5 77039,48,28877,36769,937,102700,20202,8481,15683,7835,4514,2702,526,106,8332,7607,725,7607,4543,3064,2019-01-01,zipcode,Houston
ZCTA5 77040,48,47823,59453,1065,170500,37834,11626,32053,6265,7394,9253,6413,2728,18658,17785,873,17785,9657,8128,2019-01-01,zipcode,Houston
ZCTA5 77041,48,33941,87489,1455,193200,27406,8814,23202,3760,5162,5820,5627,2833,12278,11350,928,11350,8483,2867,2019-01-01,zipcode,Houston
ZCTA5 77042,48,41734,49726,1080,244900,33358,8627,28159,2814,4391,7975,8698,4281,21829,19251,2578,19251,5009,14242,2019-01-01,zipcode,Houston
ZCTA5 77043,48,24803,64810,1152,256900,19545,6140,17113,2999,3772,3834,4366,2142,10456,9274,1182,9274,5313,3961,2019-01-01,zipcode,Houston
ZCTA5 77044,48,48783,80503,1355,204400,34418,9525,28970,4204,7464,8870,5976,2456,15544,14294,1250,14294,10748,3546,2019-01-01,zipcode,Houston
ZCTA5 77045,48,36532,57843,979,85100,27303,10366,21570,5734,6840,5901,2037,1058,10846,10391,455,10391,6695,3696,2019-01-01,zipcode,Houston
ZCTA5 77046,48,1207,87891,1943,344600,1194,293,1136,0,28,386,300,422,831,809,22,809,267,542,2019-01-01,zipcode,Houston
ZCTA5 77047,48,32616,67725,1292,149900,24579,6808,20815,2481,5329,7537,3192,2276,11049,10533,516,10533,7217,3316,2019-01-01,zipcode,Houston
ZCTA5 77048,48,18383,41300,869,81000,13367,4633,11428,1749,3660,4056,1174,789,6894,6041,853,6041,3680,2361,2019-01-01,zipcode,Houston
ZCTA5 77049,48,36434,62994,1136,154900,25964,7341,20360,4971,5404,7159,1885,941,11934,10809,1125,10809,7353,3456,2019-01-01,zipcode,Houston
ZCTA5 77050,48,4741,48500,744,84900,3567,1508,3036,1140,849,859,142,46,1546,1454,92,1454,1128,326,2019-01-01,zipcode,Houston
ZCTA5 77051,48,17221,30646,897,78000,12914,5699,10518,2240,3657,3369,1053,199,7598,6379,1219,6379,2441,3938,2019-01-01,zipcode,Houston
ZCTA5 77053,48,31650,50368,1237,92200,23433,8415,18859,5804,6155,4649,1573,678,9139,8840,299,8840,5821,3019,2019-01-01,zipcode,Houston
ZCTA5 77054,48,23267,50827,1172,143200,21043,6354,17061,211,1446,4603,4833,5968,15995,13097,2898,13097,1937,11160,2019-01-01,zipcode,Houston
ZCTA5 77055,48,44671,55591,985,461900,34140,10236,29297,7295,6630,4914,6268,4190,16813,15458,1355,15458,6692,8766,2019-01-01,zipcode,Houston
ZCTA5 77056,48,22056,108359,1624,644800,19350,5704,17771,420,1146,3122,7794,5289,14281,11370,2911,11370,4465,6905,2019-01-01,zipcode,Houston
ZCTA5 77057,48,41690,62644,1145,352700,34203,8678,30461,3345,3534,6084,10564,6934,23118,20169,2949,20169,6699,13470,2019-01-01,zipcode,Houston
ZCTA5 77058,48,16120,55035,1134,184500,13660,3844,11381,822,1500,3893,3173,1993,8959,7689,1270,7689,2230,5459,2019-01-01,zipcode,Houston
ZCTA5 77059,48,17254,139163,1588,314000,13473,4681,11858,580,903,2139,4510,3726,6140,5899,241,5899,5509,390,2019-01-01,zipcode,Houston
ZCTA5 77060,48,45642,31006,814,104600,30631,10402,24810,11099,7090,5036,1256,329,16496,14165,2331,14165,3140,11025,2019-01-01,zipcode,Houston
ZCTA5 77061,48,26253,41980,822,131200,19288,6076,15904,5224,5019,3460,1349,852,9827,8700,1127,8700,3195,5505,2019-01-01,zipcode,Houston
ZCTA5 77062,48,26477,95564,1039,205100,20301,6800,17891,1232,2763,5206,5275,3415,10036,9545,491,9545,7577,1968,2019-01-01,zipcode,Houston
ZCTA5 77063,48,39249,46324,1109,220400,32021,9328,27545,3011,4493,7287,8538,4216,21030,18753,2277,18753,4214,14539,2019-01-01,zipcode,Houston
ZCTA5 77064,48,48637,71754,1257,162300,38128,11551,32194,5096,7590,9918,6674,2916,17250,16139,1111,16139,9333,6806,2019-01-01,zipcode,Houston
ZCTA5 77065,48,37793,57370,1146,173600,29558,8604,25935,3426,6582,8301,5040,2586,15854,14847,1007,14847,6889,7958,2019-01-01,zipcode,Houston
ZCTA5 77066,48,35676,61930,1205,143800,27706,9313,23208,5024,6781,6200,3819,1384,11231,10804,427,10804,7497,3307,2019-01-01,zipcode,Houston
ZCTA5 77067,48,35227,43282,922,119600,25050,8243,19865,5790,6313,5573,1539,650,11393,10217,1176,10217,3999,6218,2019-01-01,zipcode,Houston
ZCTA5 77068,48,11011,83803,1147,219000,9383,2947,7851,957,1541,2651,1800,902,4352,3986,366,3986,2743,1243,2019-01-01,zipcode,Houston
ZCTA5 77069,48,19345,67470,1193,268700,15395,5183,13677,693,2129,4698,4136,2021,8854,8275,579,8275,4643,3632,2019-01-01,zipcode,Houston
ZCTA5 77070,48,53057,66569,1266,194100,41411,12364,34949,2480,7535,11169,9239,4526,22137,20264,1873,20264,10122,10142,2019-01-01,zipcode,Houston
ZCTA5 77071,48,28888,48532,951,146800,21945,7206,18596,2986,4718,4906,3493,2493,11333,10110,1223,10110,5709,4401,2019-01-01,zipcode,Houston
ZCTA5 77072,48,61122,41228,1028,111200,46211,15572,37747,12942,11180,8330,3812,1483,19780,17954,1826,17954,8468,9486,2019-01-01,zipcode,Houston
ZCTA5 77073,48,39939,50931,1066,142700,29366,8635,23968,4243,7012,8907,2807,999,14821,13745,1076,13745,7629,6116,2019-01-01,zipcode,Houston
ZCTA5 77074,48,40978,42776,892,146700,29475,9286,24629,7834,6759,4998,3816,1222,14934,12840,2094,12840,4198,8642,2019-01-01,zipcode,Houston
ZCTA5 77075,48,44517,54819,968,144000,32885,9980,26154,7412,8286,7246,2543,667,13581,12953,628,12953,6973,5980,2019-01-01,zipcode,Houston
ZCTA5 77076,48,36009,38346,935,106600,25423,9605,20373,9859,6916,2589,808,201,11077,10382,695,10382,4938,5444,2019-01-01,zipcode,Houston
ZCTA5 77077,48,59588,65193,1241,302600,48126,13985,41981,1886,5679,11236,13904,9276,30734,27097,3637,27097,9452,17645,2019-01-01,zipcode,Houston
ZCTA5 77078,48,15663,40298,939,79700,11385,4749,9535,2805,3656,2098,719,257,5197,4640,557,4640,2818,1822,2019-01-01,zipcode,Houston
ZCTA5 77079,48,34122,91375,1363,518900,24654,8294,21694,1631,2228,4203,8251,5381,14916,12275,2641,12275,7265,5010,2019-01-01,zipcode,Houston
ZCTA5 77080,48,45586,48547,985,214000,34080,10286,28757,9079,7447,5709,4366,2156,16776,15225,1551,15225,6636,8589,2019-01-01,zipcode,Houston
ZCTA5 77081,48,53031,33502,843,298900,37961,9616,31530,11621,8225,4977,4560,2147,20893,18846,2047,18846,984,17862,2019-01-01,zipcode,Houston
ZCTA5 77082,48,55056,51943,1142,161000,44068,12803,38689,5108,9084,10776,9315,4406,24909,22308,2601,22308,7821,14487,2019-01-01,zipcode,Houston
ZCTA5 77083,48,78298,54425,1084,149800,60770,20687,49251,9815,13504,14528,7908,3496,23144,22338,806,22338,14271,8067,2019-01-01,zipcode,Houston
ZCTA5 77084,48,107673,64133,1279,162000,80907,23673,66865,11247,14792,21005,14271,5550,37968,35082,2886,35082,21304,13778,2019-01-01,zipcode,Houston
ZCTA5 77085,48,17991,57167,1146,119300,14057,4452,11032,3599,3272,2435,1059,667,5391,5274,117,5274,3615,1659,2019-01-01,zipcode,Houston
ZCTA5 77086,48,28636,48211,1008,116300,20930,7421,16554,5909,5681,3525,1104,335,8456,7922,534,7922,4718,3204,2019-01-01,zipcode,Houston
ZCTA5 77087,48,37886,39800,787,92400,27711,10440,22490,9250,6844,4365,1567,464,12210,11109,1101,11109,5907,5202,2019-01-01,zipcode,Houston
ZCTA5 77088,48,55734,42489,898,112900,41928,15977,34216,10210,11126,8736,2974,1170,19117,17379,1738,17379,10759,6620,2019-01-01,zipcode,Houston
ZCTA5 77089,48,54751,69617,1126,159100,43186,13325,34664,6044,9331,11554,5230,2505,18512,17362,1150,17362,11869,5493,2019-01-01,zipcode,Houston
ZCTA5 77090,48,40761,39808,1005,153500,29634,8491,23445,3259,6303,9016,3412,1455,18274,15927,2347,15927,3442,12485,2019-01-01,zipcode,Houston
ZCTA5 77091,48,27750,36098,841,127000,20476,7598,17703,4972,5557,4423,1841,910,11320,9911,1409,9911,4036,5875,2019-01-01,zipcode,Houston
ZCTA5 77092,48,38458,39536,894,185400,29252,8761,24408,6550,7778,5366,3513,1201,15185,13954,1231,13954,4973,8981,2019-01-01,zipcode,Houston
ZCTA5 77093,48,47135,31301,881,82700,33546,15092,27001,14324,7885,3973,654,165,14220,12831,1389,12831,7300,5531,2019-01-01,zipcode,Houston
ZCTA5 77094,48,10271,178354,1772,416700,7666,2700,6821,169,545,989,2843,2275,3778,3370,408,3370,2732,638,2019-01-01,zipcode,Houston
ZCTA5 77095,48,70692,92225,1283,216800,55306,16417,46660,3211,8632,14556,14311,5950,25857,24114,1743,24114,18068,6046,2019-01-01,zipcode,Houston
ZCTA5 77096,48,32682,65608,1001,359900,25251,7966,22320,2122,3510,5137,5987,5564,15385,12995,2390,12995,6465,6530,2019-01-01,zipcode,Houston
ZCTA5 77098,48,13818,91138,1631,527900,12486,2745,11244,200,360,1580,4568,4536,9522,8246,1276,8246,2316,5930,2019-01-01,zipcode,Houston
ZCTA5 77099,48,52294,40802,949,120200,39323,13079,32518,8864,9404,9312,3818,1120,18200,17017,1183,17017,5779,11238,2019-01-01,zipcode,Houston
ZCTA5 77201,48,0,-666666666,-666666666,-666666666,0,0,0,0,0,0,0,0,0,0,0,0,0,0,2019-01-01,zipcode,Houston
ZCTA5 77301,48,34169,46875,924,134300,25715,9185,21150,7368,6259,5092,1595,836,11681,10503,1178,10503,5275,5228,2019-01-01,zipcode,Conroe
ZCTA5 77302,48,18658,77215,1134,190800,14082,5600,12061,1610,4090,4091,1624,646,6873,6283,590,6283,5104,1179,2019-01-01,zipcode,Conroe
ZCTA5 77303,48,20655,55311,1073,141200,15520,5213,12967,3462,4455,3686,1010,354,7202,6689,513,6689,5019,1670,2019-01-01,zipcode,Conroe
ZCTA5 77304,48,33364,64516,1114,228100,26103,7933,21849,2023,4979,6600,5270,2977,14116,13149,967,13149,7462,5687,2019-01-01,zipcode,Conroe
ZCTA5 77306,48,13569,50045,928,103800,10111,3911,7840,2859,2522,2115,170,174,4828,4252,576,4252,3215,1037,2019-01-01,zipcode,Conroe
ZCTA5 77316,48,26119,103875,1203,330900,19575,6544,17079,1259,4749,5278,4076,1717,9096,8428,668,8428,7491,937,2019-01-01,zipcode,Montgomery
ZCTA5 77318,48,16303,61392,1129,195400,13569,5711,11804,1733,3755,3880,1714,722,7050,6276,774,6276,4871,1405,2019-01-01,zipcode,Willis
ZCTA5 77320,48,36122,51990,916,139500,31443,20023,27286,4468,11983,6183,3403,1249,11298,9077,2221,9077,5792,3285,2019-01-01,zipcode,Huntsville
ZCTA5 77326,48,37,-666666666,-666666666,-666666666,37,37,37,0,37,0,0,0,83,37,46,37,37,0,2019-01-01,zipcode,Ace
ZCTA5 77327,48,23274,42304,700,99200,16470,7675,14105,3662,5155,3829,1085,374,9351,7802,1549,7802,5510,2292,2019-01-01,zipcode,Cleveland
ZCTA5 77328,48,14438,53054,904,118400,10595,4899,9044,2096,3833,2297,658,160,5309,4559,750,4559,3659,900,2019-01-01,zipcode,Cleveland
ZCTA5 77331,48,7971,43642,798,139500,6703,3525,5991,774,2858,1412,673,274,4619,3148,1471,3148,2649,499,2019-01-01,zipcode,Coldspring
ZCTA5 77334,48,358,42950,-666666666,-666666666,301,151,301,57,65,179,0,0,123,123,0,123,48,75,2019-01-01,zipcode,Dodge
ZCTA5 77335,48,2972,55516,814,106300,2457,959,2135,344,975,714,84,18,1650,1202,448,1202,1036,166,2019-01-01,zipcode,Goodrich
ZCTA5 77336,48,13156,68596,1090,168400,9879,3848,8239,1310,2300,3087,1222,320,4981,4569,412,4569,3426,1143,2019-01-01,zipcode,Huffman
ZCTA5 77338,48,43558,56638,1061,150600,31979,8999,26820,4416,7497,10399,3601,907,15830,15062,768,15062,8428,6634,2019-01-01,zipcode,Humble
ZCTA5 77339,48,40133,75080,1346,198000,31098,11235,27004,1217,4841,9607,7259,4080,17475,15735,1740,15735,10200,5535,2019-01-01,zipcode,Kingwood
ZCTA5 77340,48,31352,36604,908,166400,27631,13752,16446,1578,5467,4741,3043,1617,12776,11268,1508,11268,4311,6957,2019-01-01,zipcode,Huntsville
ZCTA5 77342,48,0,-666666666,-666666666,-666666666,0,0,0,0,0,0,0,0,0,0,0,0,0,0,2019-01-01,zipcode,Huntsville
ZCTA5 77345,48,27993,137519,1533,286700,21485,8749,18243,492,1776,4510,7493,3972,9902,9347,555,9347,8285,1062,2019-01-01,zipcode,Kingwood
ZCTA5 77346,48,66805,104829,1474,205900,48582,14779,41923,2322,7918,14662,11864,5157,22158,21444,714,21444,17776,3668,2019-01-01,zipcode,Humble
ZCTA5 77350,48,135,-666666666,-666666666,-666666666,100,51,83,27,4,27,21,4,52,52,0,52,50,2,2019-01-01,zipcode,Leggett
ZCTA5 77351,48,34366,50318,781,123100,28509,14737,25114,5023,9553,6991,2500,1047,17049,12140,4909,12140,9256,2884,2019-01-01,zipcode,Livingston
ZCTA5 77354,48,37058,89489,1206,260000,27970,9702,24454,2431,6522,7542,5671,2288,12941,12327,614,12327,9883,2444,2019-01-01,zipcode,Magnolia
ZCTA5 77355,48,29281,88042,1123,256900,23193,8366,19683,2601,5283,6128,4296,1375,10044,9634,410,9634,8173,1461,2019-01-01,zipcode,Magnolia
ZCTA5 77356,48,26987,92378,1317,265000,22912,9471,20242,713,3950,7598,5642,2339,14420,11675,2745,11675,9630,2045,2019-01-01,zipcode,Montgomery
ZCTA5 77357,48,27721,62321,890,141200,20356,7762,15667,4207,4463,4892,1449,656,9100,8062,1038,8062,6157,1905,2019-01-01,zipcode,New caney
ZCTA5 77358,48,5565,56250,926,165300,4181,1829,3414,381,1404,1307,197,125,2581,1943,638,1943,1499,444,2019-01-01,zipcode,New waverly
ZCTA5 77359,48,425,48472,-666666666,-666666666,425,272,425,45,369,11,0,0,125,125,0,125,80,45,2019-01-01,zipcode,Oakhurst
ZCTA5 77360,48,5115,48186,858,92100,4236,2167,3878,442,1808,1133,386,109,3812,2328,1484,2328,1836,492,2019-01-01,zipcode,Onalaska
ZCTA5 77362,48,6435,74681,1678,177500,4921,2253,4089,304,1546,1108,948,183,2105,1873,232,1873,1590,283,2019-01-01,zipcode,Pinehurst
ZCTA5 77363,48,2853,43316,975,166900,2418,1120,2271,326,730,678,362,175,1551,1282,269,1282,1104,178,2019-01-01,zipcode,Plantersville
ZCTA5 77364,48,1828,32240,811,117100,1665,943,1626,301,596,506,144,79,1577,969,608,969,787,182,2019-01-01,zipcode,Pointblank
ZCTA5 77365,48,36755,79320,1150,206600,28234,9849,23045,4453,5717,7436,3697,1742,12534,11455,1079,11455,9137,2318,2019-01-01,zipcode,Porter
ZCTA5 77367,48,80,-666666666,-666666666,-666666666,77,56,61,40,21,0,0,0,98,46,52,46,33,13,2019-01-01,zipcode,Riverside
ZCTA5 77368,48,223,-666666666,-666666666,123900,206,152,206,55,85,36,14,16,165,103,62,103,103,0,2019-01-01,zipcode,Romayor
ZCTA5 77369,48,555,46064,-666666666,78300,495,301,463,148,118,132,54,11,406,232,174,232,184,48,2019-01-01,zipcode,Rye
ZCTA5 77371,48,8036,42348,591,83100,6277,3119,5486,985,2637,1464,316,84,3251,2532,719,2532,1906,626,2019-01-01,zipcode,Shepherd
ZCTA5 77372,48,14116,62245,992,111400,10293,3734,8596,2159,3201,2570,541,125,5037,4420,617,4420,3317,1103,2019-01-01,zipcode,Splendora
ZCTA5 77373,48,61501,71424,1396,155900,47250,14660,40342,4055,11333,15162,7180,2612,21788,20588,1200,20588,14280,6308,2019-01-01,zipcode,Spring
ZCTA5 77374,48,536,-666666666,-666666666,45400,436,211,335,31,151,108,45,0,281,233,48,233,192,41,2019-01-01,zipcode,Thicket
ZCTA5 77375,48,55759,78164,1186,196100,41705,12239,34817,3127,8206,11318,8622,3544,19245,18153,1092,18153,13058,5095,2019-01-01,zipcode,Tomball
ZCTA5 77376,48,569,39952,-666666666,11500,550,459,467,83,323,61,0,0,324,255,69,255,255,0,2019-01-01,zipcode,Votaw
ZCTA5 77377,48,38469,96994,1405,264000,28705,9789,24618,1703,4671,7302,7692,3250,13129,12502,627,12502,10260,2242,2019-01-01,zipcode,Tomball
ZCTA5 77378,48,17616,55508,958,132600,12712,5171,10919,2386,3802,3324,1059,348,6361,5677,684,5677,4032,1645,2019-01-01,zipcode,Willis
ZCTA5 77379,48,81368,103359,1275,257300,62321,21149,54322,2825,9867,16008,16745,8877,29165,27653,1512,27653,21795,5858,2019-01-01,zipcode,Spring
ZCTA5 77380,48,25761,73457,1343,273300,21861,6546,18967,967,2500,5750,6338,3412,13466,11986,1480,11986,4583,7403,2019-01-01,zipcode,Spring
ZCTA5 77381,48,36160,117661,1438,359500,28657,11759,25590,654,2769,6170,9817,6180,14528,13738,790,13738,10137,3601,2019-01-01,zipcode,Spring
ZCTA5 77382,48,41581,138281,1718,422200,30602,11018,25141,421,2533,5583,9687,6917,13987,13380,607,13380,9586,3794,2019-01-01,zipcode,Spring
ZCTA5 77384,48,19467,87311,1261,320400,15696,5223,14111,819,2243,4090,4062,2897,9202,7879,1323,7879,4565,3314,2019-01-01,zipcode,Conroe
ZCTA5 77385,48,25160,95126,1300,226600,19117,5631,16452,1173,3701,5112,4425,2041,9040,8580,460,8580,6796,1784,2019-01-01,zipcode,Conroe
ZCTA5 77386,48,57421,114665,1514,235400,40525,10294,35469,1737,5133,12229,11856,4514,18647,18181,466,18181,13977,4204,2019-01-01,zipcode,Spring
ZCTA5 77388,48,50701,93290,1587,197200,39085,11426,32615,2619,6589,11201,8063,4143,17530,16886,644,16886,12605,4281,2019-01-01,zipcode,Spring
ZCTA5 77389,48,38222,126473,1628,320000,26675,7967,23988,913,3883,6043,8614,4535,13318,12034,1284,12034,9556,2478,2019-01-01,zipcode,Spring
ZCTA5 77396,48,58396,69208,1197,159700,43996,14429,37599,6110,10056,11191,6212,4030,19723,18675,1048,18675,10990,7685,2019-01-01,zipcode,Humble
ZCTA5 77401,48,19372,193950,1807,840000,15031,5131,13693,414,765,1635,4521,6358,7678,7069,609,7069,6070,999,2019-01-01,zipcode,Bellaire
ZCTA5 77406,48,49261,124705,1388,305500,37605,13139,33144,1722,6465,9649,9750,5558,16651,15422,1229,15422,13415,2007,2019-01-01,zipcode,Richmond
ZCTA5 77407,48,60000,101612,1490,245200,43019,12014,36576,2177,5788,10890,11079,6642,17493,17015,478,17015,13884,3131,2019-01-01,zipcode,Richmond
ZCTA5 77412,48,44,-666666666,-666666666,-666666666,39,0,39,0,15,7,17,0,12,7,5,7,7,0,2019-01-01,zipcode,Altair
ZCTA5 77414,48,23982,51559,868,121300,18595,7923,15797,3365,4552,4977,2060,843,12301,8854,3447,8854,5866,2988,2019-01-01,zipcode,Bay city
ZCTA5 77415,48,88,-666666666,-666666666,-666666666,47,18,29,0,0,0,29,0,13,13,0,13,13,0,2019-01-01,zipcode,Cedar lane
ZCTA5 77417,48,2550,44474,944,111600,2058,904,1767,456,609,470,194,38,1138,900,238,900,542,358,2019-01-01,zipcode,Beasley
ZCTA5 77418,48,10537,60568,812,253800,8654,3781,7384,1026,1652,2359,1595,752,4762,4190,572,4190,3159,1031,2019-01-01,zipcode,Bellville
ZCTA5 77419,48,1253,51852,571,135400,850,209,741,178,182,201,180,0,597,460,137,460,384,76,2019-01-01,zipcode,Blessing
ZCTA5 77420,48,2695,55385,844,120600,2122,827,1727,274,349,832,233,39,1092,908,184,908,696,212,2019-01-01,zipcode,Boling
ZCTA5 77422,48,13194,56064,983,126200,10826,5936,9259,1225,3557,3383,823,271,5738,4582,1156,4582,3733,849,2019-01-01,zipcode,Brazoria
ZCTA5 77423,48,12377,61178,945,217300,9451,3220,7659,1778,2317,2001,1062,501,3946,3608,338,3608,2937,671,2019-01-01,zipcode,Brookshire
ZCTA5 77426,48,2524,72656,1315,236000,2106,896,1754,225,343,783,286,117,1264,917,347,917,659,258,2019-01-01,zipcode,Chappell hill
ZCTA5 77428,48,0,-666666666,-666666666,-666666666,0,0,0,0,0,0,0,0,0,0,0,0,0,0,2019-01-01,zipcode,Collegeport
ZCTA5 77429,48,88628,107033,1416,247300,64598,19687,56260,2594,8879,16876,19538,8373,30175,28691,1484,28691,24117,4574,2019-01-01,zipcode,Cypress
ZCTA5 77430,48,2078,80889,-666666666,184600,1501,638,1335,140,393,308,297,197,929,752,177,752,681,71,2019-01-01,zipcode,Damon
ZCTA5 77432,48,47,-666666666,-666666666,-666666666,47,19,47,28,0,19,0,0,41,19,22,19,0,19,2019-01-01,zipcode,Danevang
ZCTA5 77433,48,90657,112468,1618,272900,62882,17570,54546,3577,9569,15386,17493,8521,28981,27222,1759,27222,22879,4343,2019-01-01,zipcode,Cypress
ZCTA5 77434,48,4740,38482,730,62000,3690,1691,2978,696,1147,688,291,156,1974,1602,372,1602,1224,378,2019-01-01,zipcode,Eagle lake
ZCTA5 77435,48,4031,60250,866,165800,3162,1132,2690,333,825,720,559,253,1826,1573,253,1573,1325,248,2019-01-01,zipcode,East bernard
ZCTA5 77436,48,54,-666666666,-666666666,-666666666,34,20,34,0,0,0,20,14,14,14,0,14,14,0,2019-01-01,zipcode,Egypt
ZCTA5 77437,48,16913,49090,732,155400,12582,4804,10640,2630,2608,3366,1411,625,6816,6167,649,6167,3996,2171,2019-01-01,zipcode,El campo
ZCTA5 77440,48,27,-666666666,-666666666,-666666666,27,0,27,27,0,0,0,0,27,27,0,27,0,27,2019-01-01,zipcode,Elmaton
ZCTA5 77441,48,12559,165603,-666666666,428500,9375,3627,8070,308,808,1791,3456,1707,4295,3942,353,3942,3822,120,2019-01-01,zipcode,Fulshear
ZCTA5 77442,48,996,49250,525,131300,731,198,663,135,243,192,59,34,504,323,181,323,255,68,2019-01-01,zipcode,Garwood
ZCTA5 77443,48,300,-666666666,-666666666,-666666666,171,36,171,0,103,36,0,32,81,81,0,81,49,32,2019-01-01,zipcode,Glen flora
ZCTA5 77444,48,534,-666666666,731,154400,406,162,355,101,139,71,22,22,342,207,135,207,144,63,2019-01-01,zipcode,Guy
ZCTA5 77445,48,14200,44190,858,150400,10312,3760,8208,1568,2992,2049,1156,443,5482,4848,634,4848,2657,2191,2019-01-01,zipcode,Hempstead
ZCTA5 77446,48,6520,24118,1042,171400,6223,3734,851,79,226,348,69,129,1043,810,233,810,182,628,2019-01-01,zipcode,Prairie view
ZCTA5 77447,48,16246,76343,1238,180900,11752,3981,9878,1505,3196,3254,1329,594,5363,5044,319,5044,4059,985,2019-01-01,zipcode,Hockley
ZCTA5 77448,48,131,-666666666,-666666666,-666666666,100,15,100,47,7,16,30,0,63,63,0,63,16,47,2019-01-01,zipcode,Hungerford
ZCTA5 77449,48,128294,78112,1568,162400,92235,23500,77045,10771,19771,25279,15392,5832,38672,37128,1544,37128,26133,10995,2019-01-01,zipcode,Katy
ZCTA5 77450,48,73692,96526,1413,271100,56215,18145,47938,2420,6631,13321,16169,9397,26411,24938,1473,24938,17697,7241,2019-01-01,zipcode,Katy
ZCTA5 77451,48,53,28333,-666666666,61300,45,18,29,2,20,7,0,0,34,20,14,20,18,2,2019-01-01,zipcode,Kendleton
ZCTA5 77453,48,393,26151,671,-666666666,171,58,168,34,61,73,0,0,126,99,27,99,29,70,2019-01-01,zipcode,Lane city
ZCTA5 77454,48,0,-666666666,-666666666,-666666666,0,0,0,0,0,0,0,0,0,0,0,0,0,0,2019-01-01,zipcode,Lissie
ZCTA5 77455,48,2194,56696,634,131600,1731,719,1479,360,478,428,170,43,921,728,193,728,663,65,2019-01-01,zipcode,Louise
ZCTA5 77456,48,1384,39926,753,91000,1067,453,925,143,380,274,128,0,639,529,110,529,469,60,2019-01-01,zipcode,Markham
ZCTA5 77457,48,488,31563,633,115500,387,191,367,63,90,178,36,0,1103,235,868,235,206,29,2019-01-01,zipcode,Matagorda
ZCTA5 77458,48,210,-666666666,-666666666,92600,210,67,155,39,45,60,11,0,159,130,29,130,106,24,2019-01-01,zipcode,Midfield
ZCTA5 77459,48,72788,112368,1789,277100,55823,17472,47517,2568,6485,11938,16385,10141,23640,22624,1016,22624,19222,3402,2019-01-01,zipcode,Missouri city
ZCTA5 77460,48,39,-666666666,-666666666,-666666666,16,9,16,16,0,0,0,0,17,7,10,7,7,0,2019-01-01,zipcode,Nada
ZCTA5 77461,48,11447,73952,1059,174600,8921,3332,7646,1492,2479,2062,1266,347,4265,3889,376,3889,3110,779,2019-01-01,zipcode,Needville
ZCTA5 77464,48,99,59844,763,225000,94,48,87,32,18,23,9,5,60,53,7,53,24,29,2019-01-01,zipcode,Orchard
ZCTA5 77465,48,7151,44946,811,116000,5409,2222,4464,676,1802,1234,471,281,3865,2632,1233,2632,2011,621,2019-01-01,zipcode,Palacios
ZCTA5 77466,48,511,61193,994,195800,461,134,360,64,106,139,45,6,259,229,30,229,153,76,2019-01-01,zipcode,Pattison
ZCTA5 77467,48,17,-666666666,-666666666,-666666666,17,0,17,0,0,17,0,0,31,17,14,17,0,17,2019-01-01,zipcode,Pierce
ZCTA5 77468,48,39,-666666666,-666666666,-666666666,39,20,39,0,0,19,0,20,49,20,29,20,20,0,2019-01-01,zipcode,Pledger
ZCTA5 77469,48,53992,81374,1133,232600,42104,15013,35682,4634,8675,10217,7925,4231,18062,17216,846,17216,12651,4565,2019-01-01,zipcode,Richmond
ZCTA5 77470,48,374,49886,-666666666,84300,331,103,243,90,109,31,5,8,235,153,82,153,118,35,2019-01-01,zipcode,Rock island
ZCTA5 77471,48,41212,52764,1054,153200,30001,10278,24563,5811,7157,7530,2565,1500,14670,13099,1571,13099,7068,6031,2019-01-01,zipcode,Rosenberg
ZCTA5 77473,48,77,-666666666,-666666666,-666666666,55,36,48,0,8,40,0,0,52,45,7,45,3,42,2019-01-01,zipcode,San felipe
ZCTA5 77474,48,12487,69956,933,172300,9476,3115,8198,1526,2576,2517,1237,342,5012,4548,464,4548,3437,1111,2019-01-01,zipcode,Sealy
ZCTA5 77475,48,790,68324,-666666666,85600,690,270,617,58,219,222,74,44,589,287,302,287,287,0,2019-01-01,zipcode,Sheridan
ZCTA5 77476,48,204,-666666666,-666666666,302400,136,43,126,33,36,34,13,10,86,62,24,62,45,17,2019-01-01,zipcode,Simonton
ZCTA5 77477,48,35830,59910,1234,170400,29053,8394,23720,3102,5103,6891,6396,2228,13727,12934,793,12934,6057,6877,2019-01-01,zipcode,Stafford
ZCTA5 77478,48,25721,92327,1542,302200,22294,8483,19407,1155,2786,4595,6599,4272,10073,9603,470,9603,7237,2366,2019-01-01,zipcode,Sugar land
ZCTA5 77479,48,93848,140394,1801,372000,71655,24347,62182,3334,6130,11261,22422,19035,30831,29475,1356,29475,24281,5194,2019-01-01,zipcode,Sugar land
ZCTA5 77480,48,8055,60423,926,110200,6200,2802,5383,620,2098,1961,650,54,3660,2975,685,2975,2386,589,2019-01-01,zipcode,Sweeny
ZCTA5 77481,48,35,-666666666,-666666666,-666666666,35,28,35,0,23,12,0,0,34,30,4,30,2,28,2019-01-01,zipcode,Thompsons
ZCTA5 77482,48,1779,43060,863,93200,1615,800,1421,176,343,687,161,54,1002,835,167,835,626,209,2019-01-01,zipcode,Van vleck
ZCTA5 77483,48,309,-666666666,-666666666,-666666666,203,0,152,13,90,49,0,0,275,107,168,107,70,37,2019-01-01,zipcode,Wadsworth
ZCTA5 77484,48,10875,64846,960,202500,8435,2826,6667,994,2193,2340,832,308,4156,3581,575,3581,2463,1118,2019-01-01,zipcode,Waller
ZCTA5 77485,48,4627,52328,794,149600,3528,1749,3122,579,1165,897,334,147,1847,1560,287,1560,1022,538,2019-01-01,zipcode,Wallis
ZCTA5 77486,48,7491,79231,1075,144300,5759,2333,4821,583,1347,2003,532,356,3019,2636,383,2636,2029,607,2019-01-01,zipcode,West columbia
ZCTA5 77488,48,14525,44400,780,110200,11597,5135,9669,2199,2924,3217,691,638,6425,5365,1060,5365,3295,2070,2019-01-01,zipcode,Wharton
ZCTA5 77489,48,38242,68646,1431,132500,29947,9088,25356,3112,7466,8186,4573,2019,12795,12388,407,12388,9193,3195,2019-01-01,zipcode,Missouri city
ZCTA5 77493,48,36334,90861,1463,209200,27314,8013,23376,2553,5831,7347,4879,2766,11939,11074,865,11074,9103,1971,2019-01-01,zipcode,Katy
ZCTA5 77494,48,118291,135943,1667,351400,82985,26936,71792,2275,6763,18477,25066,19211,38449,36575,1874,36575,27679,8896,2019-01-01,zipcode,Katy
ZCTA5 77498,48,51293,80748,1620,212800,40119,13166,32769,3788,6750,9529,8285,4417,16347,15286,1061,15286,11254,4032,2019-01-01,zipcode,Sugar land
ZCTA5 77502,48,38199,52081,965,105700,27486,10011,21816,8272,6957,4950,1249,388,11652,10809,843,10809,6727,4082,2019-01-01,zipcode,Pasadena
ZCTA5 77503,48,24808,51312,950,105100,17616,5859,14538,3453,5134,4389,1157,405,8509,7752,757,7752,4187,3565,2019-01-01,zipcode,Pasadena
ZCTA5 77504,48,24954,48455,950,152600,18584,5961,15270,3095,5586,4131,1778,680,10029,8878,1151,8878,3812,5066,2019-01-01,zipcode,Pasadena
ZCTA5 77505,48,24223,82628,1160,188100,18665,6191,15282,1788,4588,5585,2184,1137,8801,8177,624,8177,5449,2728,2019-01-01,zipcode,Pasadena
ZCTA5 77506,48,38765,41804,873,81000,27021,9713,21770,9501,7299,3890,866,214,12130,10698,1432,10698,3989,6709,2019-01-01,zipcode,Pasadena
ZCTA5 77507,48,312,-666666666,1579,-666666666,298,60,215,0,80,76,21,38,318,182,136,182,0,182,2019-01-01,zipcode,Pasadena
ZCTA5 77510,48,14485,78828,930,179000,11703,4247,9821,1121,3099,4286,1147,168,6117,5237,880,5237,4085,1152,2019-01-01,zipcode,Santa fe
ZCTA5 77511,48,47556,64932,1020,153500,36659,13767,30375,4906,9228,11626,3235,1380,18271,16203,2068,16203,11328,4875,2019-01-01,zipcode,Alvin
ZCTA5 77514,48,5127,45714,775,106600,4077,2058,3530,1130,1115,951,121,213,2393,1908,485,1908,1535,373,2019-01-01,zipcode,Anahuac
ZCTA5 77515,48,32469,64778,923,131500,26321,11728,22688,4032,8293,6813,2801,749,12202,10831,1371,10831,7456,3375,2019-01-01,zipcode,Angleton
ZCTA5 77517,48,5677,64680,1186,192100,4752,2084,3977,470,1571,1429,422,85,2181,1907,274,1907,1817,90,2019-01-01,zipcode,Santa fe
ZCTA5 77518,48,10856,46063,925,128100,8019,2731,6850,1534,2607,1816,664,229,3975,3546,429,3546,2215,1331,2019-01-01,zipcode,Bacliff
ZCTA5 77519,48,1066,53971,-666666666,85500,954,490,898,183,430,194,79,12,450,404,46,404,382,22,2019-01-01,zipcode,Batson
ZCTA5 77520,48,35350,50461,896,89600,26393,10076,22199,6664,6256,6870,1595,814,13781,12169,1612,12169,7039,5130,2019-01-01,zipcode,Baytown
ZCTA5 77521,48,60164,72665,979,153400,44760,14763,35889,5615,10072,13644,4681,1877,21860,20015,1845,20015,12460,7555,2019-01-01,zipcode,Baytown
ZCTA5 77523,48,23501,113000,1004,232000,16666,4658,14269,980,3265,6416,2457,1151,7997,7594,403,7594,6380,1214,2019-01-01,zipcode,Baytown
ZCTA5 77530,48,33437,61149,891,105200,24039,8830,19210,6027,6620,5100,1098,365,9958,9415,543,9415,6404,3011,2019-01-01,zipcode,Channelview
ZCTA5 77531,48,16228,62892,990,134200,12318,3907,10381,2121,3368,3150,1349,393,7255,6108,1147,6108,3508,2600,2019-01-01,zipcode,Clute
ZCTA5 77532,48,29963,67824,908,158400,23860,9288,20147,2836,6388,7566,2456,901,11021,10646,375,10646,8435,2211,2019-01-01,zipcode,Crosby
ZCTA5 77533,48,938,44563,636,71200,762,344,602,77,324,157,32,12,440,347,93,347,206,141,2019-01-01,zipcode,Daisetta
ZCTA5 77534,48,2256,95890,945,164400,1805,580,1456,73,347,700,257,79,961,816,145,816,731,85,2019-01-01,zipcode,Danbury
ZCTA5 77535,48,34537,54638,904,132700,27840,14512,23825,5231,9207,7521,1364,502,11025,9877,1148,9877,7994,1883,2019-01-01,zipcode,Dayton
ZCTA5 77536,48,32146,81960,1231,173400,25530,8192,20943,2296,6149,8373,3060,1065,11381,10663,718,10663,8406,2257,2019-01-01,zipcode,Deer park
ZCTA5 77538,48,1042,57778,1375,123400,855,386,709,179,200,236,67,27,395,346,49,346,315,31,2019-01-01,zipcode,Devers
ZCTA5 77539,48,46032,75664,1041,171200,36137,12276,31385,4922,8057,11078,5151,2177,19138,16676,2462,16676,12359,4317,2019-01-01,zipcode,Dickinson
ZCTA5 77541,48,18609,46039,890,100200,13596,5204,10737,2546,3683,3436,870,202,8808,6452,2356,6452,3693,2759,2019-01-01,zipcode,Freeport
ZCTA5 77545,48,25226,80873,1551,174900,18408,5287,15180,2374,3706,4541,2924,1635,7464,7113,351,7113,5918,1195,2019-01-01,zipcode,Fresno
ZCTA5 77546,48,53623,106287,1413,242300,40513,12905,34573,1566,6261,10533,10558,5655,18554,17660,894,17660,14059,3601,2019-01-01,zipcode,Friendswood
ZCTA5 77547,48,9925,46176,956,79600,6924,2393,5334,2105,1493,1253,429,54,2723,2580,143,2580,1592,988,2019-01-01,zipcode,Galena park
ZCTA5 77550,48,21863,42710,943,167200,18682,7476,15663,2474,3418,4838,3074,1859,14036,9744,4292,9744,4165,5579,2019-01-01,zipcode,Galveston
ZCTA5 77551,48,21929,49789,998,176400,18115,7763,15089,2673,4553,4322,2270,1271,9840,8356,1484,8356,3384,4972,2019-01-01,zipcode,Galveston
ZCTA5 77554,48,8556,75283,1175,293000,7796,3319,6324,353,1056,2202,1577,1136,10052,3744,6308,3744,2475,1269,2019-01-01,zipcode,Galveston
ZCTA5 77560,48,337,97554,-666666666,159200,323,89,277,26,95,106,37,13,346,171,175,171,171,0,2019-01-01,zipcode,Hankamer
ZCTA5 77561,48,103,-666666666,-666666666,108300,76,27,76,16,43,4,13,0,43,43,0,43,36,7,2019-01-01,zipcode,Hardin
ZCTA5 77562,48,10680,59792,891,117000,8355,3591,6850,1403,1991,2673,472,311,3932,3763,169,3763,2807,956,2019-01-01,zipcode,Highlands
ZCTA5 77563,48,11027,68028,921,158800,8510,3148,7496,901,2151,3021,988,435,5211,4284,927,4284,3112,1172,2019-01-01,zipcode,Hitchcock
ZCTA5 77564,48,1888,71121,-666666666,121900,1364,759,1225,325,444,266,161,29,904,714,190,714,627,87,2019-01-01,zipcode,Hull
ZCTA5 77565,48,8650,66282,1271,263100,7040,2650,6158,285,1026,2353,1669,825,4368,3796,572,3796,2089,1707,2019-01-01,zipcode,Kemah
ZCTA5 77566,48,29436,83782,1224,190500,22681,7340,19474,1107,4557,7000,4823,1987,12044,11238,806,11238,7516,3722,2019-01-01,zipcode,Lake jackson
ZCTA5 77568,48,15680,52441,895,111600,12456,4908,10767,1628,3823,3607,1201,508,6877,5671,1206,5671,4062,1609,2019-01-01,zipcode,La marque
ZCTA5 77571,48,37427,76864,1084,150500,30152,10034,25880,3082,8536,9883,3023,1356,14035,13217,818,13217,10007,3210,2019-01-01,zipcode,La porte
ZCTA5 77573,48,88131,111609,1424,250900,66222,19699,56929,1976,9465,17904,17326,10258,31342,30260,1082,30260,23365,6895,2019-01-01,zipcode,League city
ZCTA5 77575,48,16884,56172,867,108700,13099,5890,10767,1663,4239,3457,827,581,7183,6173,1010,6173,4585,1588,2019-01-01,zipcode,Liberty
ZCTA5 77577,48,1481,73889,-666666666,155900,1093,567,1011,264,245,373,117,12,719,538,181,538,521,17,2019-01-01,zipcode,Liverpool
ZCTA5 77578,48,22527,92487,1293,273100,16375,4823,14052,762,2742,5280,3305,1963,8038,7140,898,7140,6039,1101,2019-01-01,zipcode,Manvel
ZCTA5 77580,48,1099,139414,-666666666,332100,614,263,593,0,88,224,221,60,331,331,0,331,306,25,2019-01-01,zipcode,Mont belvieu
ZCTA5 77581,48,48438,92687,1225,235900,36914,12019,31499,1725,6385,10616,8487,4286,18057,17071,986,17071,13269,3802,2019-01-01,zipcode,Pearland
ZCTA5 77583,48,40514,78808,780,204100,31318,14892,26065,5785,8206,6244,3707,2123,11098,9920,1178,9920,7772,2148,2019-01-01,zipcode,Rosharon
ZCTA5 77584,48,90372,107995,1462,252400,67609,17243,59864,3524,8645,17088,18444,12163,32487,30802,1685,30802,22650,8152,2019-01-01,zipcode,Pearland
ZCTA5 77585,48,986,41944,-666666666,17700,788,387,653,107,261,231,54,0,386,338,48,338,338,0,2019-01-01,zipcode,Saratoga
ZCTA5 77586,48,22548,97181,1180,245100,18071,5653,15441,542,2640,5360,4842,2057,9522,8752,770,8752,5648,3104,2019-01-01,zipcode,Seabrook
ZCTA5 77587,48,16928,45241,866,95200,12076,4322,9556,4023,3351,1569,487,126,5265,4737,528,4737,2660,2077,2019-01-01,zipcode,South houston
ZCTA5 77590,48,31604,46992,944,114700,24236,9366,20600,3940,7057,6858,2035,710,12894,11366,1528,11366,6372,4994,2019-01-01,zipcode,Texas city
ZCTA5 77591,48,14936,51659,1016,137200,11599,4291,10083,1376,3294,3553,1453,407,6453,5572,881,5572,2946,2626,2019-01-01,zipcode,Texas city
ZCTA5 77597,48,986,-666666666,-666666666,-666666666,632,277,546,98,171,187,67,23,406,268,138,268,229,39,2019-01-01,zipcode,Wallisville
ZCTA5 77598,48,26460,56809,1094,153600,21361,4955,17023,2335,3181,5891,3981,1635,12297,11244,1053,11244,2244,9000,2019-01-01,zipcode,Webster
ZCTA5 77611,48,8578,78449,936,143800,6570,2196,5517,322,1737,2253,983,222,3629,3055,574,3055,2376,679,2019-01-01,zipcode,Bridge city
ZCTA5 77612,48,9408,54876,763,106100,7575,3933,6436,765,3191,1806,582,92,4105,3367,738,3367,2984,383,2019-01-01,zipcode,Buna
ZCTA5 77613,48,1097,47375,734,115900,902,495,859,129,384,295,27,24,530,489,41,489,367,122,2019-01-01,zipcode,China
ZCTA5 77614,48,265,16979,-666666666,-666666666,241,157,230,35,115,80,0,0,225,140,85,140,108,32,2019-01-01,zipcode,Deweyville
ZCTA5 77615,48,1084,78929,633,85300,806,275,693,128,300,195,61,9,364,316,48,316,268,48,2019-01-01,zipcode,Evadale
ZCTA5 77616,48,511,38175,-666666666,-666666666,477,185,420,30,244,127,19,0,573,257,316,257,240,17,2019-01-01,zipcode,Fred
ZCTA5 77617,48,66,-666666666,-666666666,-666666666,66,58,66,17,17,11,21,0,177,49,128,49,40,9,2019-01-01,zipcode,
ZCTA5 77619,48,15662,55652,970,112900,12319,4803,10618,1142,3979,3906,1251,340,6481,5701,780,5701,4030,1671,2019-01-01,zipcode,Groves
ZCTA5 77622,48,1439,88875,1144,155800,1099,475,936,80,390,298,128,40,581,471,110,471,404,67,2019-01-01,zipcode,Hamshire
ZCTA5 77623,48,648,57833,-666666666,84500,548,228,492,35,199,187,31,40,328,224,104,224,191,33,2019-01-01,zipcode,High island
ZCTA5 77624,48,609,-666666666,-666666666,66500,545,297,520,44,237,186,38,15,408,282,126,282,238,44,2019-01-01,zipcode,Hillister
ZCTA5 77625,48,9761,62925,768,87900,7970,3648,6273,1058,2504,1993,443,275,4387,3413,974,3413,2879,534,2019-01-01,zipcode,Kountze
ZCTA5 77627,48,21698,78367,879,141700,17106,6088,14491,910,4267,5696,2529,1089,9614,8709,905,8709,6113,2596,2019-01-01,zipcode,Nederland
ZCTA5 77629,48,786,45938,588,103300,663,253,590,65,205,214,80,26,380,344,36,344,304,40,2019-01-01,zipcode,Nome
ZCTA5 77630,48,28925,51017,819,106800,22501,8808,19516,2598,6962,7101,2198,657,13352,11333,2019,11333,7483,3850,2019-01-01,zipcode,Orange
ZCTA5 77632,48,22903,70518,854,123700,18039,7001,15500,1401,5862,5301,2425,511,10216,8591,1625,8591,7052,1539,2019-01-01,zipcode,Orange
ZCTA5 77640,48,15706,38324,871,64900,12458,6421,10561,2029,4055,3178,864,435,8382,6180,2202,6180,3853,2327,2019-01-01,zipcode,Port arthur
ZCTA5 77642,48,39202,35746,799,65800,28937,12927,23919,7165,7811,6198,2039,706,16517,13726,2791,13726,7612,6114,2019-01-01,zipcode,Port arthur
ZCTA5 77650,48,1835,-666666666,562,188400,1549,719,1311,175,589,379,57,111,2649,754,1895,754,524,230,2019-01-01,zipcode,Port bolivar
ZCTA5 77651,48,12782,71740,996,165900,10207,4070,8721,660,2244,3539,1424,854,5314,4936,378,4936,3692,1244,2019-01-01,zipcode,Port neches
ZCTA5 77655,48,213,55625,-666666666,104700,213,101,201,32,96,65,8,0,155,114,41,114,99,15,2019-01-01,zipcode,Sabine pass
ZCTA5 77656,48,16524,52702,736,102700,12999,5867,11599,1411,4813,3839,1164,372,7704,6205,1499,6205,4948,1257,2019-01-01,zipcode,Silsbee
ZCTA5 77657,48,21345,71319,855,158900,16339,6162,14225,1304,4913,4915,2169,924,8662,7731,931,7731,6096,1635,2019-01-01,zipcode,Lumberton
ZCTA5 77659,48,5326,68750,805,166200,3798,1679,3325,351,1058,1024,653,239,2059,1735,324,1735,1446,289,2019-01-01,zipcode,Sour lake
ZCTA5 77660,48,1057,50568,-666666666,76500,813,466,705,178,229,198,74,26,571,322,249,322,294,28,2019-01-01,zipcode,Spurger
ZCTA5 77661,48,671,-666666666,-666666666,120500,479,344,346,84,67,119,13,63,305,258,47,258,133,125,2019-01-01,zipcode,Stowell
ZCTA5 77662,48,26277,56345,741,97100,20808,9084,17510,2766,7202,5626,1566,350,11606,9832,1774,9832,7876,1956,2019-01-01,zipcode,Vidor
ZCTA5 77663,48,1014,-666666666,-666666666,173400,797,598,775,80,205,406,55,29,684,488,196,488,409,79,2019-01-01,zipcode,Village mills
ZCTA5 77664,48,2939,58354,436,112300,2397,1359,1999,191,932,496,218,162,1343,1020,323,1020,932,88,2019-01-01,zipcode,Warren
ZCTA5 77665,48,6152,51989,782,150500,4920,1760,4213,606,1554,1227,607,219,2610,2140,470,2140,1630,510,2019-01-01,zipcode,Winnie
ZCTA5 77701,48,13480,36857,760,51000,10079,4626,8658,2637,3383,1934,516,188,6051,4717,1334,4717,2557,2160,2019-01-01,zipcode,Beaumont
ZCTA5 77702,48,3225,47917,938,102100,2366,736,1967,211,771,575,279,131,1494,1295,199,1295,674,621,2019-01-01,zipcode,Beaumont
ZCTA5 77703,48,13823,28906,729,67600,9699,4418,8325,1980,3676,2187,393,89,5927,4841,1086,4841,2377,2464,2019-01-01,zipcode,Beaumont
ZCTA5 77705,48,39236,41844,740,83000,34003,21142,28263,5542,10061,9453,2205,1002,12460,10451,2009,10451,6312,4139,2019-01-01,zipcode,Beaumont
ZCTA5 77706,48,29474,68750,922,174600,23302,8454,20136,892,3793,6983,5033,3435,13833,12602,1231,12602,6877,5725,2019-01-01,zipcode,Beaumont
ZCTA5 77707,48,18335,56655,989,120200,14184,5261,11719,1259,3224,4172,2000,1064,7383,6778,605,6778,4697,2081,2019-01-01,zipcode,Beaumont
ZCTA5 77708,48,12536,48846,826,118400,9395,3281,7756,852,2570,2572,1255,507,5548,4952,596,4952,2395,2557,2019-01-01,zipcode,Beaumont
ZCTA5 77713,48,14238,69723,1120,156700,11755,4114,10346,904,2812,3516,2468,646,7280,6173,1107,6173,3942,2231,2019-01-01,zipcode,Beaumont
ZCTA5 77801,48,15068,31665,860,113900,11975,4157,7237,1552,1776,1903,1137,869,7146,6027,1119,6027,917,5110,2019-01-01,zipcode,Bryan
ZCTA5 77802,48,25621,57114,976,177900,21068,7540,17459,1145,3354,5121,4442,3397,11729,10888,841,10888,5682,5206,2019-01-01,zipcode,Bryan
ZCTA5 77803,48,32946,40903,863,85900,23951,9403,19534,6745,6210,5170,1073,336,10719,9690,1029,9690,5660,4030,2019-01-01,zipcode,Bryan
ZCTA5 77807,48,11564,66959,979,174300,8878,3665,7356,1288,2119,2227,1051,671,4248,3518,730,3518,2240,1278,2019-01-01,zipcode,Bryan
ZCTA5 77808,48,12013,69147,948,235700,9637,3599,8556,973,2051,2533,1832,1167,4914,4579,335,4579,4126,453,2019-01-01,zipcode,Bryan
ZCTA5 77830,48,3101,77821,631,264500,2329,972,2109,188,659,713,336,213,1475,1186,289,1186,1043,143,2019-01-01,zipcode,Anderson
ZCTA5 77831,48,3179,50090,809,127400,2531,1224,2220,265,718,833,228,176,1774,1166,608,1166,974,192,2019-01-01,zipcode,Bedias
ZCTA5 77833,48,29345,54748,860,182200,23930,10178,19102,2672,5895,5443,3697,1395,12284,10163,2121,10163,7530,2633,2019-01-01,zipcode,Brenham
ZCTA5 77835,48,2330,50781,967,120800,1965,833,1875,180,660,452,343,240,1893,1143,750,1143,916,227,2019-01-01,zipcode,Burton
ZCTA5 77836,48,12077,59847,720,149100,9715,4028,8404,1537,3281,2124,1088,374,5644,4526,1118,4526,3524,1002,2019-01-01,zipcode,Caldwell
ZCTA5 77837,48,1922,37348,716,94100,1567,689,1306,236,492,416,117,45,995,744,251,744,487,257,2019-01-01,zipcode,Calvert
ZCTA5 77840,48,59371,26075,920,196400,54586,25875,19246,1525,2663,5122,4705,5231,25021,20409,4612,20409,2453,17956,2019-01-01,zipcode,College station
ZCTA5 77845,48,66649,82929,1154,256200,52184,16779,39363,2026,4459,9326,12252,11300,26126,24343,1783,24343,16415,7928,2019-01-01,zipcode,College station
ZCTA5 77853,48,1059,48843,678,94600,978,453,809,208,269,195,102,35,662,439,223,439,368,71,2019-01-01,zipcode,Dime box
ZCTA5 77855,48,224,-666666666,-666666666,-666666666,86,25,86,11,39,36,0,0,217,50,167,50,14,36,2019-01-01,zipcode,Flynn
ZCTA5 77856,48,5246,50450,835,172400,4147,1922,3593,326,1197,1265,647,158,3046,1977,1069,1977,1559,418,2019-01-01,zipcode,Franklin
ZCTA5 77857,48,792,58068,831,209500,633,292,582,91,215,196,59,21,436,331,105,331,258,73,2019-01-01,zipcode,Gause
ZCTA5 77859,48,6750,57624,606,94600,5145,1747,4512,822,1788,1398,340,164,2942,2471,471,2471,1915,556,2019-01-01,zipcode,Hearne
ZCTA5 77861,48,2203,62941,754,201200,1859,832,1614,190,660,458,236,70,1111,848,263,848,729,119,2019-01-01,zipcode,Iola
ZCTA5 77864,48,7562,52240,723,95900,5653,2230,4632,1000,1506,1267,631,228,3332,2769,563,2769,1961,808,2019-01-01,zipcode,Madisonville
ZCTA5 77865,48,2440,63125,1103,115400,2094,1160,1579,143,624,526,220,66,985,865,120,865,733,132,2019-01-01,zipcode,Marquez
ZCTA5 77867,48,106,55250,-666666666,83100,88,35,81,38,27,11,5,0,59,47,12,47,39,8,2019-01-01,zipcode,Mumford
ZCTA5 77868,48,17142,54352,749,137600,13464,7099,11387,2836,4041,3026,839,645,5506,4659,847,4659,3228,1431,2019-01-01,zipcode,Navasota
ZCTA5 77871,48,2738,46250,770,148200,2430,1142,2119,280,861,544,349,85,1644,1127,517,1127,849,278,2019-01-01,zipcode,Normangee
ZCTA5 77872,48,1879,58529,859,161900,1495,721,1307,108,553,399,180,67,1022,756,266,756,649,107,2019-01-01,zipcode,North zulch
ZCTA5 77873,48,1200,44857,518,153700,991,337,796,84,265,236,120,91,718,568,150,568,476,92,2019-01-01,zipcode,Richards
ZCTA5 77876,48,123,111250,-666666666,-666666666,111,45,94,0,19,65,10,0,72,33,39,33,16,17,2019-01-01,zipcode,Shiro
ZCTA5 77878,48,317,31654,830,567300,280,180,247,55,44,110,35,3,203,170,33,170,95,75,2019-01-01,zipcode,Snook
ZCTA5 77879,48,5621,55891,738,89200,4566,2179,3941,606,1504,1144,466,221,3299,2084,1215,2084,1692,392,2019-01-01,zipcode,Somerville
ZCTA5 77880,48,1438,68365,-666666666,268900,883,404,883,94,249,219,119,202,927,501,426,501,382,119,2019-01-01,zipcode,Washington
ZCTA5 77901,48,43052,43957,884,99600,32983,11661,26378,6048,8981,7915,2389,1045,16764,14280,2484,14280,7891,6389,2019-01-01,zipcode,Victoria
ZCTA5 77904,48,28202,76537,983,187800,21941,8326,19399,1450,4978,6966,3779,2226,11822,10604,1218,10604,7338,3266,2019-01-01,zipcode,Victoria
ZCTA5 77905,48,14834,72896,951,152800,11720,4669,10518,1471,3314,3854,1411,468,6212,5484,728,5484,4654,830,2019-01-01,zipcode,Victoria
ZCTA5 77950,48,170,50682,-666666666,77700,152,77,138,15,54,53,11,5,157,82,75,82,65,17,2019-01-01,zipcode,Austwell
ZCTA5 77951,48,1809,32820,697,42300,1520,638,1332,417,565,298,52,0,832,583,249,583,377,206,2019-01-01,zipcode,Bloomington
ZCTA5 77954,48,11478,59056,903,128000,9320,4721,8281,1572,3359,2382,707,261,4387,3616,771,3616,2485,1131,2019-01-01,zipcode,Cuero
ZCTA5 77957,48,8735,54721,850,109900,6773,2835,5749,802,1946,1981,736,284,3878,2947,931,2947,2011,936,2019-01-01,zipcode,Edna
ZCTA5 77960,48,65,-666666666,-666666666,-666666666,65,28,65,28,0,37,0,0,108,65,43,65,37,28,2019-01-01,zipcode,Fannin
ZCTA5 77961,48,178,100727,-666666666,-666666666,178,64,178,0,39,96,43,0,153,103,50,103,64,39,2019-01-01,zipcode,Francitas
ZCTA5 77962,48,3654,66587,875,130300,2757,920,2438,607,751,744,257,79,1450,1179,271,1179,866,313,2019-01-01,zipcode,Ganado
ZCTA5 77963,48,5855,52428,620,128000,4557,2253,3829,643,988,1484,484,230,2764,2009,755,2009,1594,415,2019-01-01,zipcode,Goliad
ZCTA5 77964,48,8395,53835,731,181700,6522,2632,5749,848,2256,1699,705,241,4582,3300,1282,3300,2276,1024,2019-01-01,zipcode,Hallettsville
ZCTA5 77968,48,3214,83348,593,289100,2396,896,2167,139,564,814,501,149,1233,1049,184,1049,939,110,2019-01-01,zipcode,Inez
ZCTA5 77969,48,246,112361,-666666666,264100,230,86,215,54,27,108,26,0,94,73,21,73,73,0,2019-01-01,zipcode,La salle
ZCTA5 77970,48,429,65417,738,-666666666,365,135,261,105,65,62,28,1,202,156,46,156,100,56,2019-01-01,zipcode,La ward
ZCTA5 77971,48,792,87625,679,-666666666,544,190,544,121,147,171,105,0,440,231,209,231,126,105,2019-01-01,zipcode,Lolita
ZCTA5 77973,48,27,-666666666,-666666666,-666666666,27,8,16,8,8,0,0,0,8,8,0,8,0,8,2019-01-01,zipcode,Mcfaddin
ZCTA5 77974,48,314,90625,883,186100,271,97,239,22,68,88,47,14,159,125,34,125,102,23,2019-01-01,zipcode,Meyersville
ZCTA5 77975,48,1609,62569,777,129400,1305,561,1169,188,488,299,129,65,1000,643,357,643,502,141,2019-01-01,zipcode,Moulton
ZCTA5 77976,48,96,-666666666,-666666666,197500,96,23,89,0,28,34,11,16,57,44,13,44,37,7,2019-01-01,zipcode,Nursery
ZCTA5 77977,48,544,29539,603,64900,467,196,380,140,127,77,19,17,259,229,30,229,162,67,2019-01-01,zipcode,Placedo
ZCTA5 77978,48,696,70455,887,87900,544,183,481,29,209,184,24,35,365,268,97,268,149,119,2019-01-01,zipcode,Point comfort
ZCTA5 77979,48,17916,58877,726,115600,14001,5344,11849,2484,3896,3781,1079,609,8281,6220,2061,6220,4526,1694,2019-01-01,zipcode,Port lavaca
ZCTA5 77982,48,884,62955,835,222300,756,383,572,73,159,288,22,30,1682,306,1376,306,191,115,2019-01-01,zipcode,Port o connor
ZCTA5 77983,48,2045,54479,703,146900,1540,754,1371,388,432,324,168,59,1329,715,614,715,590,125,2019-01-01,zipcode,Seadrift
ZCTA5 77984,48,3972,67250,829,183900,3146,1442,2873,287,1087,830,501,168,2145,1551,594,1551,1257,294,2019-01-01,zipcode,Shiner
ZCTA5 77987,48,206,51786,-666666666,-666666666,164,67,145,12,81,26,25,1,108,88,20,88,79,9,2019-01-01,zipcode,Sweet home
ZCTA5 77988,48,559,52794,-666666666,118100,368,149,303,73,71,98,24,37,223,156,67,156,140,16,2019-01-01,zipcode,Telferner
ZCTA5 77990,48,811,46350,-666666666,87700,667,323,625,84,231,186,99,25,492,311,181,311,225,86,2019-01-01,zipcode,Tivoli
ZCTA5 77991,48,397,74095,1219,-666666666,197,33,125,10,48,67,0,0,94,71,23,71,39,32,2019-01-01,zipcode,Vanderbilt
ZCTA5 77993,48,95,2499,-666666666,-666666666,95,42,78,0,25,38,8,7,77,35,42,35,14,21,2019-01-01,zipcode,Weesatche
ZCTA5 77994,48,354,-666666666,1075,98100,299,107,265,34,118,78,24,11,282,149,133,149,93,56,2019-01-01,zipcode,Westhoff
ZCTA5 77995,48,10724,51264,719,117300,8164,3205,6835,1366,2889,1769,710,101,4854,3902,952,3902,2937,965,2019-01-01,zipcode,Yoakum
ZCTA5 78001,48,0,-666666666,-666666666,-666666666,0,0,0,0,0,0,0,0,0,0,0,0,0,0,2019-01-01,zipcode,Artesia wells
ZCTA5 78002,48,6833,52598,850,102700,5145,2421,4103,1193,1323,1312,223,52,1904,1765,139,1765,1282,483,2019-01-01,zipcode,Atascosa
ZCTA5 78003,48,9743,60116,915,164400,8418,4109,7501,841,2659,2438,1073,490,5082,3750,1332,3750,3088,662,2019-01-01,zipcode,Bandera
ZCTA5 78004,48,1118,113510,-666666666,361000,963,386,910,41,234,240,169,226,431,431,0,431,404,27,2019-01-01,zipcode,Bergheim
ZCTA5 78005,48,870,83849,-666666666,-666666666,781,421,781,360,157,149,33,82,380,367,13,367,367,0,2019-01-01,zipcode,Bigfoot
ZCTA5 78006,48,36056,85813,1219,346000,28458,11140,25013,1172,5030,7882,6938,3991,13234,12165,1069,12165,8857,3308,2019-01-01,zipcode,Boerne
ZCTA5 78007,48,169,82500,806,128100,117,53,102,17,57,26,2,0,116,60,56,60,45,15,2019-01-01,zipcode,Calliham
ZCTA5 78008,48,461,82973,-666666666,64500,429,297,429,208,100,37,42,42,349,252,97,252,209,43,2019-01-01,zipcode,Campbellton
ZCTA5 78009,48,8466,58726,1081,164700,6615,2679,5582,864,1237,2167,772,542,3154,2842,312,2842,2340,502,2019-01-01,zipcode,Castroville
ZCTA5 78010,48,3493,60755,865,153500,2811,1161,2314,308,739,822,305,140,1623,1301,322,1301,989,312,2019-01-01,zipcode,Center point
ZCTA5 78011,48,1688,39375,533,40000,1286,526,1113,421,509,162,21,0,755,578,177,578,512,66,2019-01-01,zipcode,Charlotte
ZCTA5 78012,48,267,64118,-666666666,79400,207,96,202,68,67,36,10,21,211,96,115,96,85,11,2019-01-01,zipcode,Christine
ZCTA5 78013,48,7312,65757,833,209400,6143,1894,5057,1127,1434,1415,723,358,2665,2157,508,2157,1780,377,2019-01-01,zipcode,Comfort
ZCTA5 78014,48,5999,46667,634,84900,4977,2526,4246,1428,1665,829,264,60,2543,1984,559,1984,1316,668,2019-01-01,zipcode,Cotulla
ZCTA5 78015,48,15811,123182,1611,432500,12160,4695,10483,200,1214,2467,4261,2341,5545,5274,271,5274,4768,506,2019-01-01,zipcode,Boerne
ZCTA5 78016,48,11632,51991,629,100300,9118,3620,7698,1700,2612,2367,781,238,4245,3606,639,3606,2706,900,2019-01-01,zipcode,Devine
ZCTA5 78017,48,6074,48038,775,60400,4663,2874,3288,1106,1120,766,119,177,1500,1020,480,1020,575,445,2019-01-01,zipcode,Dilley
ZCTA5 78019,48,1253,53636,680,56600,1073,693,873,440,259,87,82,5,498,276,222,276,202,74,2019-01-01,zipcode,Encinal
ZCTA5 78021,48,273,-666666666,-666666666,-666666666,202,184,202,57,127,5,13,0,188,75,113,75,70,5,2019-01-01,zipcode,Fowlerton
ZCTA5 78022,48,4033,54468,722,102500,3252,1724,2912,845,765,919,233,150,2217,1390,827,1390,1127,263,2019-01-01,zipcode,George west
ZCTA5 78023,48,31357,122967,1616,300600,24103,8042,19768,834,3065,5867,5970,4032,9169,8900,269,8900,8099,801,2019-01-01,zipcode,Helotes
ZCTA5 78024,48,1370,54125,820,388800,1241,638,1205,44,266,401,275,219,1162,579,583,579,429,150,2019-01-01,zipcode,Hunt
ZCTA5 78025,48,4918,52692,863,134900,4083,1682,3360,435,1216,822,712,175,2310,1928,382,1928,1441,487,2019-01-01,zipcode,Ingram
ZCTA5 78026,48,6452,48858,934,91900,4802,2161,4055,874,1941,831,309,100,2579,2041,538,2041,1447,594,2019-01-01,zipcode,Jourdanton
ZCTA5 78027,48,381,228030,-666666666,360800,320,200,303,0,76,47,118,62,199,88,111,88,88,0,2019-01-01,zipcode,Kendalia
ZCTA5 78028,48,39944,54785,879,181900,33202,15641,29221,3163,7649,10248,5100,3061,18374,16856,1518,16856,11597,5259,2019-01-01,zipcode,Kerrville
ZCTA5 78029,48,0,-666666666,-666666666,-666666666,0,0,0,0,0,0,0,0,0,0,0,0,0,0,2019-01-01,zipcode,Kerrville
ZCTA5 78039,48,1924,66944,586,108100,1693,580,1365,207,477,316,338,27,742,646,96,646,561,85,2019-01-01,zipcode,La coste
ZCTA5 78040,48,40939,25108,693,77500,28452,13818,22396,11023,5251,4393,1357,372,13543,11512,2031,11512,4964,6548,2019-01-01,zipcode,Laredo
ZCTA5 78041,48,47753,50603,828,157500,35963,14452,28673,8057,7110,6401,4827,2278,16034,14536,1498,14536,7707,6829,2019-01-01,zipcode,Laredo
ZCTA5 78043,48,45532,39716,845,104100,32499,13477,25210,9161,6565,5953,2600,931,13890,12689,1201,12689,6763,5926,2019-01-01,zipcode,Laredo
ZCTA5 78044,48,519,44489,620,-666666666,410,237,369,202,98,35,22,12,337,133,204,133,72,61,2019-01-01,zipcode,Laredo
ZCTA5 78045,48,66685,75073,1159,175500,47760,14442,38515,5660,8125,11188,9816,3726,20305,19138,1167,19138,14608,4530,2019-01-01,zipcode,Laredo
ZCTA5 78046,48,70989,37952,850,96600,46538,20542,35472,14867,10870,7135,1959,641,18085,16371,1714,16371,12114,4257,2019-01-01,zipcode,Laredo
ZCTA5 78050,48,584,43819,-666666666,-666666666,403,208,375,253,92,30,0,0,234,203,31,203,140,63,2019-01-01,zipcode,Leming
ZCTA5 78052,48,6769,60880,802,100800,5393,2162,4528,623,1787,1300,444,374,2328,2062,266,2062,1676,386,2019-01-01,zipcode,Lytle
ZCTA5 78055,48,1867,44622,647,291100,1486,888,1316,201,522,298,196,99,1075,621,454,621,477,144,2019-01-01,zipcode,Medina
ZCTA5 78056,48,2138,113962,-666666666,420900,1707,729,1579,0,334,514,346,385,1011,794,217,794,685,109,2019-01-01,zipcode,Mico
ZCTA5 78057,48,378,-666666666,-666666666,541700,378,164,342,33,5,205,54,45,286,146,140,146,146,0,2019-01-01,zipcode,Moore
ZCTA5 78058,48,976,95761,575,311200,857,387,735,143,93,259,126,114,748,400,348,400,353,47,2019-01-01,zipcode,Mountain home
ZCTA5 78059,48,5545,63186,846,145700,4620,2072,3891,833,1332,978,540,208,2220,1813,407,1813,1635,178,2019-01-01,zipcode,Natalia
ZCTA5 78060,48,0,-666666666,-666666666,-666666666,0,0,0,0,0,0,0,0,27,0,27,0,0,0,2019-01-01,zipcode,Oakville
ZCTA5 78061,48,12858,46184,859,77700,10177,5291,8270,2841,3044,1984,279,122,3894,3076,818,3076,2115,961,2019-01-01,zipcode,Pearsall
ZCTA5 78063,48,9484,59758,1052,169700,7999,3601,7200,755,1845,2814,1204,582,4800,3641,1159,3641,3235,406,2019-01-01,zipcode,Pipe creek
ZCTA5 78064,48,16186,66067,1075,150600,11906,4996,10100,1579,3854,2667,1392,608,6040,5189,851,5189,3619,1570,2019-01-01,zipcode,Pleasanton
ZCTA5 78065,48,11130,50533,696,82300,8487,3327,7130,1765,2851,1682,642,190,3950,3456,494,3456,2582,874,2019-01-01,zipcode,Poteet
ZCTA5 78066,48,521,64102,-666666666,171200,312,208,312,0,140,69,88,15,196,173,23,173,141,32,2019-01-01,zipcode,Rio medina
ZCTA5 78067,48,772,120648,-666666666,121500,603,189,565,206,202,116,41,0,473,274,199,274,248,26,2019-01-01,zipcode,San ygnacio
ZCTA5 78069,48,6115,51316,663,95000,4601,1784,3520,960,1101,1089,269,101,1876,1556,320,1556,1339,217,2019-01-01,zipcode,Somerset
ZCTA5 78070,48,15457,89083,1147,307800,13320,5468,11650,774,2886,4201,2468,1321,6070,5498,572,5498,5233,265,2019-01-01,zipcode,Spring branch
ZCTA5 78071,48,4372,42549,627,113000,3586,2145,3119,709,1253,846,239,72,1688,1102,586,1102,826,276,2019-01-01,zipcode,Three rivers
ZCTA5 78072,48,582,62250,838,85700,426,166,371,19,87,124,75,66,305,189,116,189,144,45,2019-01-01,zipcode,Tilden
ZCTA5 78073,48,8580,50929,775,85400,6513,2619,5199,1701,1828,1218,257,195,2478,2160,318,2160,1617,543,2019-01-01,zipcode,Von ormy
ZCTA5 78075,48,248,62763,-666666666,99100,203,52,116,0,85,24,7,0,86,86,0,86,55,31,2019-01-01,zipcode,Whitsett
ZCTA5 78076,48,13029,33015,515,76300,9191,3955,7244,2676,2233,1443,793,99,5738,4112,1626,4112,3032,1080,2019-01-01,zipcode,Zapata
ZCTA5 78101,48,6465,73030,681,223000,5409,2086,4827,495,1865,1130,818,519,2478,2206,272,2206,2000,206,2019-01-01,zipcode,Adkins
ZCTA5 78102,48,28323,43078,859,95000,23016,13962,19191,4893,6535,6137,927,699,8765,6868,1897,6868,4070,2798,2019-01-01,zipcode,Beeville
ZCTA5 78104,48,136,69375,-666666666,-666666666,125,46,100,0,46,48,3,3,83,59,24,59,45,14,2019-01-01,zipcode,Beeville
ZCTA5 78107,48,269,38672,-666666666,-666666666,269,118,231,69,95,67,0,0,182,155,27,155,74,81,2019-01-01,zipcode,Berclair
ZCTA5 78108,48,39999,100271,1725,222800,29822,9974,24869,1075,5438,8829,5702,3825,12850,12246,604,12246,9938,2308,2019-01-01,zipcode,Cibolo
ZCTA5 78109,48,39769,70242,1273,158100,28858,9796,23656,2410,5734,9437,3625,2450,12477,11599,878,11599,8295,3304,2019-01-01,zipcode,Converse
ZCTA5 78112,48,8617,52761,1012,85400,6440,2451,5446,1348,2083,1662,301,52,2420,2279,141,2279,1946,333,2019-01-01,zipcode,Elmendorf
ZCTA5 78113,48,3558,71469,1039,170100,2645,853,2231,287,987,437,454,66,1399,1241,158,1241,924,317,2019-01-01,zipcode,Falls city
ZCTA5 78114,48,24009,70840,908,165700,18922,7936,16017,2236,6159,4717,1846,1059,8437,7641,796,7641,6085,1556,2019-01-01,zipcode,Floresville
ZCTA5 78116,48,313,-666666666,-666666666,232100,269,169,248,36,128,49,22,13,159,97,62,97,97,0,2019-01-01,zipcode,Gillett
ZCTA5 78117,48,401,42390,784,147500,394,211,340,28,141,109,53,9,308,207,101,207,155,52,2019-01-01,zipcode,Hobson
ZCTA5 78118,48,4264,55278,841,96900,3419,2061,2898,829,1026,522,394,127,1567,1078,489,1078,800,278,2019-01-01,zipcode,Karnes city
ZCTA5 78119,48,7160,52413,700,90100,6029,3685,5088,1400,1813,1323,366,186,2621,1755,866,1755,1353,402,2019-01-01,zipcode,Kenedy
ZCTA5 78121,48,13276,95843,1003,271700,10308,3719,8856,643,2679,2888,1904,742,4673,4266,407,4266,3900,366,2019-01-01,zipcode,La vernia
ZCTA5 78122,48,274,46389,-666666666,65000,239,99,216,57,97,12,16,34,158,130,28,130,93,37,2019-01-01,zipcode,Leesville
ZCTA5 78123,48,2177,47917,922,143500,1800,662,1561,245,640,362,264,50,1429,987,442,987,748,239,2019-01-01,zipcode,Mc queeney
ZCTA5 78124,48,6913,75211,988,173000,5742,2162,5135,621,1853,1802,620,239,2519,2433,86,2433,2034,399,2019-01-01,zipcode,Marion
ZCTA5 78125,48,45,41875,-666666666,61300,42,24,42,4,3,23,4,8,62,28,34,28,28,0,2019-01-01,zipcode,Mineral
ZCTA5 78130,48,77400,65627,1169,204400,60132,20202,51813,5477,15002,15396,10958,4980,31615,28154,3461,28154,17568,10586,2019-01-01,zipcode,New braunfels
ZCTA5 78132,48,30987,106523,1068,372900,24268,9816,20871,823,4094,6113,6577,3264,11232,10462,770,10462,9025,1437,2019-01-01,zipcode,New braunfels
ZCTA5 78133,48,18483,67366,1060,224100,15546,6993,13831,996,4038,4736,2538,1523,9623,7217,2406,7217,5940,1277,2019-01-01,zipcode,Canyon lake
ZCTA5 78140,48,3486,56071,816,77700,2548,970,2045,663,949,299,98,36,1374,1124,250,1124,676,448,2019-01-01,zipcode,Nixon
ZCTA5 78141,48,524,55208,717,82300,452,238,402,79,134,132,47,10,392,223,169,223,189,34,2019-01-01,zipcode,Nordheim
ZCTA5 78142,48,166,-666666666,-666666666,87500,139,63,112,19,41,19,11,22,72,53,19,53,36,17,2019-01-01,zipcode,Normanna
ZCTA5 78143,48,226,70150,-666666666,153500,184,108,169,15,47,13,94,0,47,47,0,47,47,0,2019-01-01,zipcode,Pandora
ZCTA5 78144,48,29,-666666666,-666666666,-666666666,29,14,29,0,14,0,0,15,29,29,0,29,0,29,2019-01-01,zipcode,Panna maria
ZCTA5 78145,48,116,40536,-666666666,-666666666,86,47,76,11,48,17,0,0,43,37,6,37,30,7,2019-01-01,zipcode,Pawnee
ZCTA5 78146,48,637,60833,832,89000,509,230,394,40,114,206,34,0,299,204,95,204,111,93,2019-01-01,zipcode,Pettus
ZCTA5 78147,48,2035,65313,850,131500,1543,484,1147,184,450,320,131,62,705,591,114,591,404,187,2019-01-01,zipcode,Poth
ZCTA5 78148,48,22364,62759,991,168300,16992,6074,14493,1015,3658,5386,2666,1768,8077,7716,361,7716,4263,3453,2019-01-01,zipcode,Universal city
ZCTA5 78150,48,37,-666666666,-666666666,-666666666,37,0,10,0,0,10,0,0,0,0,0,0,0,0,2019-01-01,zipcode,Jbsa randolph
ZCTA5 78151,48,1662,46310,634,95400,1268,623,1096,249,360,314,137,36,742,554,188,554,405,149,2019-01-01,zipcode,Runge
ZCTA5 78152,48,2171,79333,1281,249700,1706,633,1429,90,481,478,237,143,681,638,43,638,591,47,2019-01-01,zipcode,Saint hedwig
ZCTA5 78154,48,41272,80707,1323,204400,31669,9981,27492,1687,6445,9054,6484,3822,15036,14457,579,14457,10246,4211,2019-01-01,zipcode,Schertz
ZCTA5 78155,48,48909,58004,900,156900,38498,15238,32544,5396,12492,8250,4402,2004,19396,17359,2037,17359,12531,4828,2019-01-01,zipcode,Seguin
ZCTA5 78159,48,1196,62905,817,-666666666,887,430,690,137,265,209,68,11,518,390,128,390,336,54,2019-01-01,zipcode,Smiley
ZCTA5 78160,48,4918,63719,861,158100,3788,1690,3295,504,1142,1124,333,192,1924,1567,357,1567,1323,244,2019-01-01,zipcode,Stockdale
ZCTA5 78161,48,651,46500,-666666666,159400,579,344,508,46,197,181,53,31,312,280,32,280,270,10,2019-01-01,zipcode,Sutherland springs
ZCTA5 78162,48,301,33516,-666666666,-666666666,236,115,193,52,36,80,25,0,185,109,76,109,86,23,2019-01-01,zipcode,Tuleta
ZCTA5 78163,48,12874,122868,1044,359100,10047,4256,8879,511,2135,2657,2369,1207,4465,4279,186,4279,4048,231,2019-01-01,zipcode,Bulverde
ZCTA5 78164,48,3706,53500,772,165900,3067,1547,2895,535,1062,861,286,151,2114,1486,628,1486,1224,262,2019-01-01,zipcode,Yorktown
ZCTA5 78201,48,48334,37183,792,111300,39204,16075,32579,9233,10242,7844,3247,2013,18380,16307,2073,16307,7815,8492,2019-01-01,zipcode,San antonio
ZCTA5 78202,48,11453,28130,826,82200,8825,4104,7580,2420,2316,1800,589,455,4581,3812,769,3812,1805,2007,2019-01-01,zipcode,San antonio
ZCTA5 78203,48,6180,32216,822,74300,4577,1887,3912,1314,1158,902,290,248,2304,1984,320,1984,1006,978,2019-01-01,zipcode,San antonio
ZCTA5 78204,48,12231,40031,897,87400,10167,3779,8725,1927,2904,2249,988,657,4821,4195,626,4195,2355,1840,2019-01-01,zipcode,San antonio
ZCTA5 78205,48,1441,36094,741,365300,1349,534,1164,148,185,272,274,285,1635,1069,566,1069,166,903,2019-01-01,zipcode,San antonio
ZCTA5 78207,48,55484,27205,677,60300,41330,19690,34540,15406,10474,6594,1572,494,17467,15443,2024,15443,7448,7995,2019-01-01,zipcode,San antonio
ZCTA5 78208,48,4913,24455,785,78300,3514,1807,3072,1086,937,839,125,85,1970,1636,334,1636,523,1113,2019-01-01,zipcode,San antonio
ZCTA5 78209,48,42653,73448,1164,381000,34172,12014,28916,1452,3015,6559,10266,7624,20080,17623,2457,17623,9632,7991,2019-01-01,zipcode,San antonio
ZCTA5 78210,48,37683,38248,817,94100,29209,11816,25120,7236,7968,6859,1922,1135,14169,12428,1741,12428,6787,5641,2019-01-01,zipcode,San antonio
ZCTA5 78211,48,32769,39348,875,73700,25442,9827,20995,7785,7211,4482,1106,411,9929,8956,973,8956,5904,3052,2019-01-01,zipcode,San antonio
ZCTA5 78212,48,28865,47623,845,172800,25094,9699,20544,3750,4969,4959,3921,2945,12522,10784,1738,10784,4956,5828,2019-01-01,zipcode,San antonio
ZCTA5 78213,48,44813,45682,906,132900,35735,12311,29385,5952,7193,9612,4376,2252,17611,16276,1335,16276,7906,8370,2019-01-01,zipcode,San antonio
ZCTA5 78214,48,27558,35978,809,79500,20447,8953,16294,5090,6040,4068,816,280,8215,7831,384,7831,4541,3290,2019-01-01,zipcode,San antonio
ZCTA5 78215,48,2915,74408,1475,407700,2782,430,2352,69,132,611,833,707,2181,1849,332,1849,82,1767,2019-01-01,zipcode,San antonio
ZCTA5 78216,48,43554,50358,963,198500,35123,10370,29559,3490,6436,9133,6663,3837,19888,17410,2478,17410,6506,10904,2019-01-01,zipcode,San antonio
ZCTA5 78217,48,34159,46152,962,140500,27056,9372,22908,2672,7050,7881,3354,1951,15225,13649,1576,13649,5502,8147,2019-01-01,zipcode,San antonio
ZCTA5 78218,48,37281,42343,905,113700,29007,10706,24126,4178,6652,8416,3227,1653,13849,12483,1366,12483,6051,6432,2019-01-01,zipcode,San antonio
ZCTA5 78219,48,17239,37374,933,89400,12790,5305,10673,1671,3357,4336,890,419,5938,5571,367,5571,2675,2896,2019-01-01,zipcode,San antonio
ZCTA5 78220,48,16700,30772,951,76200,12564,6411,10305,2673,3580,2953,789,310,5978,5426,552,5426,3150,2276,2019-01-01,zipcode,San antonio
ZCTA5 78221,48,41185,43437,847,87700,31244,12025,26055,7640,9758,6488,1610,559,12566,11572,994,11572,7222,4350,2019-01-01,zipcode,San antonio
ZCTA5 78222,48,25227,50766,914,117500,18437,7428,16016,2929,5461,5411,1600,615,8169,7391,778,7391,5259,2132,2019-01-01,zipcode,San antonio
ZCTA5 78223,48,56055,42762,833,95700,42350,15988,35511,7631,12666,11015,3174,1025,19857,18074,1783,18074,10234,7840,2019-01-01,zipcode,San antonio
ZCTA5 78224,48,22851,46797,943,93800,16734,6529,14039,3498,5079,3952,1242,268,6319,5948,371,5948,3375,2573,2019-01-01,zipcode,San antonio
ZCTA5 78225,48,14472,35431,844,71100,10659,4531,8914,2883,3231,2018,576,206,4674,4212,462,4212,2837,1375,2019-01-01,zipcode,San antonio
ZCTA5 78226,48,7906,30401,774,74900,6032,2901,4994,1876,1576,1262,164,116,2933,2409,524,2409,966,1443,2019-01-01,zipcode,San antonio
ZCTA5 78227,48,51394,39864,864,91500,38095,14835,31064,8182,10233,10049,2014,586,15841,14764,1077,14764,8025,6739,2019-01-01,zipcode,San antonio
ZCTA5 78228,48,62359,42418,850,96100,49497,21104,40523,11970,14060,10094,3196,1203,20215,18411,1804,18411,10858,7553,2019-01-01,zipcode,San antonio
ZCTA5 78229,48,34125,40742,970,153700,27944,9100,23194,2939,5518,7726,4131,2880,16433,14196,2237,14196,2210,11986,2019-01-01,zipcode,San antonio
ZCTA5 78230,48,45021,62332,1034,232900,36596,12538,31265,2006,5639,8438,9252,5930,19873,18223,1650,18223,9102,9121,2019-01-01,zipcode,San antonio
ZCTA5 78231,48,9001,92174,1188,292700,7247,2612,6541,291,639,1901,2039,1671,3641,3430,211,3430,2415,1015,2019-01-01,zipcode,San antonio
ZCTA5 78232,48,39072,73787,1162,246600,32277,10718,27870,1110,4328,8960,8122,5350,16305,15778,527,15778,8918,6860,2019-01-01,zipcode,San antonio
ZCTA5 78233,48,50103,54865,1112,136400,38292,13530,32483,3215,10751,11840,4556,2121,18081,17290,791,17290,9986,7304,2019-01-01,zipcode,San antonio
ZCTA5 78234,48,4965,79167,1780,56500,3319,697,2011,85,210,867,518,331,967,948,19,948,44,904,2019-01-01,zipcode,Jbsa ft sam houston
ZCTA5 78235,48,1476,44583,1212,-666666666,1178,284,970,95,265,401,120,89,685,640,45,640,0,640,2019-01-01,zipcode,San antonio
ZCTA5 78236,48,6896,80262,1846,-666666666,6011,490,1437,28,110,827,362,110,485,413,72,413,0,413,2019-01-01,zipcode,Jbsa lackland
ZCTA5 78237,48,39105,31399,803,64900,29646,13759,24979,10623,8352,4965,846,193,11708,10961,747,10961,6975,3986,2019-01-01,zipcode,San antonio
ZCTA5 78238,48,25660,50402,962,142000,19588,6968,16486,2235,4917,5939,2598,797,10108,9127,981,9127,4360,4767,2019-01-01,zipcode,San antonio
ZCTA5 78239,48,27431,61234,1179,144000,21557,8859,18035,2511,5002,5984,2839,1699,9618,8588,1030,8588,6307,2281,2019-01-01,zipcode,San antonio
ZCTA5 78240,48,60927,56154,1064,172900,48191,15299,40523,3239,7728,13673,10217,5666,26115,23493,2622,23493,8774,14719,2019-01-01,zipcode,San antonio
ZCTA5 78242,48,34893,42857,893,82800,24891,8998,19078,6375,6463,4800,1145,295,9861,9078,783,9078,4977,4101,2019-01-01,zipcode,San antonio
ZCTA5 78243,48,408,-666666666,-666666666,-666666666,408,0,114,0,0,89,25,0,0,0,0,0,0,0,2019-01-01,zipcode,San antonio
ZCTA5 78244,48,30981,62080,1259,131700,23282,7754,19508,2733,5091,7427,3038,1219,9737,9113,624,9113,6417,2696,2019-01-01,zipcode,San antonio
ZCTA5 78245,48,76518,69609,1211,158900,55469,16224,45252,6062,12305,16195,7357,3333,23296,21705,1591,21705,15409,6296,2019-01-01,zipcode,San antonio
ZCTA5 78247,48,53892,79466,1278,179200,42086,12082,36301,2248,9200,12904,8056,3893,18578,17423,1155,17423,13207,4216,2019-01-01,zipcode,San antonio
ZCTA5 78248,48,14345,119886,1332,338000,11439,3900,10075,153,875,2858,3377,2812,5705,5488,217,5488,4227,1261,2019-01-01,zipcode,San antonio
ZCTA5 78249,48,61639,66539,1216,201400,51753,14535,35322,1788,5340,12602,10443,5149,22245,20657,1588,20657,11054,9603,2019-01-01,zipcode,San antonio
ZCTA5 78250,48,61669,71476,1204,153900,47751,13577,39751,2794,9835,14979,8318,3825,19380,18903,477,18903,14222,4681,2019-01-01,zipcode,San antonio
ZCTA5 78251,48,62186,65691,1116,171700,47817,13120,39524,3222,9252,15469,7258,4323,21685,20610,1075,20610,11039,9571,2019-01-01,zipcode,San antonio
ZCTA5 78252,48,12009,60787,1214,122700,8704,4012,7433,1625,2008,2772,783,245,2760,2656,104,2656,2010,646,2019-01-01,zipcode,San antonio
ZCTA5 78253,48,43770,101138,1392,244600,31165,9147,26049,1559,4705,9015,6262,4508,13226,12352,874,12352,9932,2420,2019-01-01,zipcode,San antonio
ZCTA5 78254,48,59107,89055,1327,203500,42669,11735,35900,2329,6989,12295,9522,4765,17694,16905,789,16905,13427,3478,2019-01-01,zipcode,San antonio
ZCTA5 78255,48,14825,124397,1433,330700,10675,3399,9266,330,1071,2833,2773,2259,4829,4516,313,4516,3970,546,2019-01-01,zipcode,San antonio
ZCTA5 78256,48,11238,91866,1338,405100,9370,2216,6467,157,398,1747,2198,1967,5065,4271,794,4271,1435,2836,2019-01-01,zipcode,San antonio
ZCTA5 78257,48,7538,77269,1285,532800,6311,1990,5503,223,817,1284,1772,1407,4154,3616,538,3616,1669,1947,2019-01-01,zipcode,San antonio
ZCTA5 78258,48,44747,105598,1409,337000,34405,12251,29414,1035,3014,7735,10498,7132,17231,16083,1148,16083,10784,5299,2019-01-01,zipcode,San antonio
ZCTA5 78259,48,26338,90840,1237,270300,20445,6443,17673,463,2882,5266,5276,3786,10049,9449,600,9449,6349,3100,2019-01-01,zipcode,San antonio
ZCTA5 78260,48,26301,115500,1729,335400,19326,6337,16629,599,2279,4847,5513,3391,8702,8340,362,8340,7488,852,2019-01-01,zipcode,San antonio
ZCTA5 78261,48,16749,93853,1417,311000,12417,3616,10627,253,1786,3409,3202,1977,6090,5803,287,5803,4576,1227,2019-01-01,zipcode,San antonio
ZCTA5 78263,48,4440,78897,1116,182400,3901,1266,3262,303,1204,1027,496,232,1496,1412,84,1412,1290,122,2019-01-01,zipcode,San antonio
ZCTA5 78264,48,10623,50729,885,88000,7895,3302,6141,1821,1848,1768,509,195,3242,2824,418,2824,2342,482,2019-01-01,zipcode,San antonio
ZCTA5 78266,48,6913,122957,2131,391800,5500,2379,4875,175,651,1033,1642,1374,2538,2462,76,2462,2293,169,2019-01-01,zipcode,San antonio
ZCTA5 78330,48,934,45313,1078,82000,676,334,591,104,255,124,78,30,333,309,24,309,258,51,2019-01-01,zipcode,Agua dulce
ZCTA5 78332,48,28941,39979,703,77100,21999,9648,18261,4543,6599,4851,1736,532,11183,9355,1828,9355,6269,3086,2019-01-01,zipcode,Alice
ZCTA5 78335,48,0,-666666666,-666666666,-666666666,0,0,0,0,0,0,0,0,0,0,0,0,0,0,2019-01-01,zipcode,Aransas pass
ZCTA5 78336,48,11214,42691,900,119000,8647,4089,7422,1737,2769,2096,650,170,6118,4051,2067,4051,2610,1441,2019-01-01,zipcode,Aransas pass
ZCTA5 78338,48,18,-666666666,-666666666,-666666666,18,0,18,6,12,0,0,0,16,13,3,13,0,13,2019-01-01,zipcode,Armstrong
ZCTA5 78339,48,317,-666666666,-666666666,65400,293,108,260,44,92,57,39,28,229,157,72,157,141,16,2019-01-01,zipcode,Banquete
ZCTA5 78340,48,356,46875,808,90900,304,140,284,21,95,107,36,25,314,149,165,149,132,17,2019-01-01,zipcode,Bayside
ZCTA5 78341,48,1844,42955,537,49500,1397,651,1061,237,310,324,90,100,1208,650,558,650,494,156,2019-01-01,zipcode,Benavides
ZCTA5 78342,48,330,43565,825,30600,241,101,204,68,44,79,13,0,114,101,13,101,59,42,2019-01-01,zipcode,Ben bolt
ZCTA5 78343,48,4526,51400,855,89100,3553,1521,2959,572,1006,878,378,125,1957,1594,363,1594,1216,378,2019-01-01,zipcode,Bishop
ZCTA5 78344,48,436,62500,-666666666,77900,347,177,292,16,148,76,48,4,216,146,70,146,116,30,2019-01-01,zipcode,Bruni
ZCTA5 78349,48,617,52396,-666666666,97300,525,344,384,130,101,118,35,0,321,165,156,165,159,6,2019-01-01,zipcode,Concepcion
ZCTA5 78351,48,421,35938,875,30400,314,173,243,80,97,38,28,0,178,123,55,123,72,51,2019-01-01,zipcode,Driscoll
ZCTA5 78352,48,485,32292,-666666666,31300,275,133,247,70,128,49,0,0,148,106,42,106,106,0,2019-01-01,zipcode,Edroy
ZCTA5 78353,48,241,36250,-666666666,63300,218,156,218,85,58,54,21,0,300,132,168,132,118,14,2019-01-01,zipcode,Encino
ZCTA5 78355,48,7168,28009,611,70800,5426,2475,4002,1213,995,1167,427,200,2920,2074,846,2074,1256,818,2019-01-01,zipcode,Falfurrias
ZCTA5 78357,48,2886,50114,614,60400,2150,689,1721,401,591,621,85,23,1312,954,358,954,622,332,2019-01-01,zipcode,Freer
ZCTA5 78358,48,653,38590,1044,64100,616,420,593,108,208,178,66,33,399,298,101,298,199,99,2019-01-01,zipcode,Fulton
ZCTA5 78359,48,1977,46196,563,61700,1575,690,1242,332,498,337,53,22,766,630,136,630,417,213,2019-01-01,zipcode,Gregory
ZCTA5 78361,48,5320,33946,584,66400,3833,1639,3126,774,1142,778,322,110,2573,1649,924,1649,1188,461,2019-01-01,zipcode,Hebbronville
ZCTA5 78362,48,10218,64874,1159,144200,7760,2912,6276,947,2409,2013,604,303,4066,3463,603,3463,2484,979,2019-01-01,zipcode,Ingleside
ZCTA5 78363,48,29544,43261,857,92700,23187,9185,16174,3461,4305,4421,2889,1098,12470,10414,2056,10414,5326,5088,2019-01-01,zipcode,Kingsville
ZCTA5 78368,48,9460,40380,693,65000,7453,3469,6269,2044,1986,1668,444,127,4454,3308,1146,3308,2472,836,2019-01-01,zipcode,Mathis
ZCTA5 78369,48,416,25000,-666666666,-666666666,265,149,214,82,74,45,13,0,219,128,91,128,81,47,2019-01-01,zipcode,Mirando city
ZCTA5 78370,48,4952,53644,847,100200,3787,1685,3268,1024,806,907,419,112,1844,1528,316,1528,1080,448,2019-01-01,zipcode,Odem
ZCTA5 78371,48,153,64375,-666666666,85000,144,59,100,0,19,69,12,0,243,75,168,75,59,16,2019-01-01,zipcode,Oilton
ZCTA5 78372,48,5971,41392,761,100500,3716,2004,3098,827,1417,621,224,9,2183,1549,634,1549,1180,369,2019-01-01,zipcode,Orange grove
ZCTA5 78373,48,4393,59746,1022,352500,3947,1427,3559,122,952,1035,917,533,5184,2175,3009,2175,1392,783,2019-01-01,zipcode,Port aransas
ZCTA5 78374,48,18369,78641,1303,168900,13990,4888,12070,820,3519,4512,2249,970,7448,6389,1059,6389,4350,2039,2019-01-01,zipcode,Portland
ZCTA5 78375,48,2951,49811,815,53400,2573,1072,2176,558,814,472,295,37,1223,933,290,933,779,154,2019-01-01,zipcode,Premont
ZCTA5 78376,48,544,50724,599,-666666666,428,216,395,140,157,77,19,2,374,196,178,196,128,68,2019-01-01,zipcode,Realitos
ZCTA5 78377,48,3745,52625,587,88800,2880,1416,2305,412,998,673,151,71,1769,1221,548,1221,830,391,2019-01-01,zipcode,Refugio
ZCTA5 78379,48,1413,55536,1118,71300,1231,577,999,242,279,242,128,108,801,534,267,534,453,81,2019-01-01,zipcode,Riviera
ZCTA5 78380,48,24300,49424,828,86600,18125,7797,15288,4136,4818,4173,1509,652,9043,7890,1153,7890,5444,2446,2019-01-01,zipcode,Robstown
ZCTA5 78382,48,21123,47098,982,167600,17859,8355,15541,2286,4660,4868,2285,1442,13863,8328,5535,8328,6831,1497,2019-01-01,zipcode,Rockport
ZCTA5 78383,48,4296,62969,767,110700,3539,1626,3153,572,934,1101,349,197,2698,1604,1094,1604,1441,163,2019-01-01,zipcode,Sandia
ZCTA5 78384,48,5739,31192,674,35900,4316,2102,3733,1382,1080,973,188,110,2703,1721,982,1721,992,729,2019-01-01,zipcode,San diego
ZCTA5 78385,48,525,39063,-666666666,24400,364,182,364,275,65,20,1,3,210,173,37,173,46,127,2019-01-01,zipcode,Sarita
ZCTA5 78387,48,9660,46382,656,68100,7052,2871,5761,1390,1957,1810,363,241,3774,3080,694,3080,2121,959,2019-01-01,zipcode,Sinton
ZCTA5 78389,48,1874,54886,895,62000,1584,747,1207,238,528,349,70,22,791,601,190,601,512,89,2019-01-01,zipcode,Skidmore
ZCTA5 78390,48,5059,40298,816,80500,3953,1856,3281,939,1046,1048,213,35,2420,1810,610,1810,1151,659,2019-01-01,zipcode,Taft
ZCTA5 78391,48,283,52938,-666666666,63300,228,105,168,58,22,61,27,0,103,79,24,79,59,20,2019-01-01,zipcode,Tynan
ZCTA5 78393,48,2161,50613,817,83200,1753,799,1557,419,517,481,103,37,1096,831,265,831,648,183,2019-01-01,zipcode,Woodsboro
ZCTA5 78401,48,5265,28464,767,79700,4747,3279,4099,1223,1326,1137,281,132,2302,1816,486,1816,361,1455,2019-01-01,zipcode,Corpus christi
ZCTA5 78402,48,236,54375,1171,173400,236,120,222,14,71,77,45,15,413,156,257,156,71,85,2019-01-01,zipcode,Corpus christi
ZCTA5 78404,48,17761,42260,912,101200,14677,5841,12741,3131,3545,3036,1828,1201,8149,6853,1296,6853,3446,3407,2019-01-01,zipcode,Corpus christi
ZCTA5 78405,48,15059,30284,733,58500,11807,5060,10175,4254,3633,1925,260,103,6021,5243,778,5243,2728,2515,2019-01-01,zipcode,Corpus christi
ZCTA5 78406,48,2027,42938,1131,45800,1669,1183,1307,489,504,251,47,16,438,383,55,383,270,113,2019-01-01,zipcode,Corpus christi
ZCTA5 78407,48,2704,43155,954,75000,2101,929,1736,460,789,381,56,50,1157,821,336,821,394,427,2019-01-01,zipcode,Corpus christi
ZCTA5 78408,48,11583,34718,675,76900,8527,3607,7017,2791,2218,1646,149,213,4841,4103,738,4103,2026,2077,2019-01-01,zipcode,Corpus christi
ZCTA5 78409,48,2725,60469,756,78500,2078,719,1843,534,581,599,123,6,1137,993,144,993,529,464,2019-01-01,zipcode,Corpus christi
ZCTA5 78410,48,28396,73481,1089,157100,21029,7538,17717,2381,5017,6777,2507,1035,10522,9632,890,9632,6336,3296,2019-01-01,zipcode,Corpus christi
ZCTA5 78411,48,25987,59148,1045,123700,21384,7636,18259,2642,4703,6507,2737,1670,11294,9949,1345,9949,6199,3750,2019-01-01,zipcode,Corpus christi
ZCTA5 78412,48,41977,50222,1044,127200,33475,12454,24175,2378,6881,8042,4706,2168,16290,15172,1118,15172,6929,8243,2019-01-01,zipcode,Corpus christi
ZCTA5 78413,48,40644,71271,1162,182000,31791,9641,26409,1838,6745,9399,5536,2891,16169,15002,1167,15002,8267,6735,2019-01-01,zipcode,Corpus christi
ZCTA5 78414,48,40657,86650,1226,205600,30858,9688,26570,1327,6017,9744,5449,4033,16021,14959,1062,14959,9710,5249,2019-01-01,zipcode,Corpus christi
ZCTA5 78415,48,40377,49011,950,101600,30782,11082,25850,5446,9972,7800,1964,668,14739,13284,1455,13284,7770,5514,2019-01-01,zipcode,Corpus christi
ZCTA5 78416,48,15973,37710,917,74200,12141,5490,10093,3576,3377,2578,453,109,5756,5193,563,5193,3069,2124,2019-01-01,zipcode,Corpus christi
ZCTA5 78417,48,4095,55693,739,104300,3232,1026,2759,891,872,753,192,51,1454,1275,179,1275,906,369,2019-01-01,zipcode,Corpus christi
ZCTA5 78418,48,30312,68109,1107,207700,24276,8929,21271,2047,5443,7599,4013,2169,15345,12122,3223,12122,7403,4719,2019-01-01,zipcode,Corpus christi
ZCTA5 78419,48,778,69688,1816,-666666666,577,108,354,4,58,138,138,16,184,172,12,172,0,172,2019-01-01,zipcode,Corpus christi
ZCTA5 78501,48,63066,38421,689,106200,49102,19424,40538,11070,8409,10365,7701,2993,24117,21189,2928,21189,11388,9801,2019-01-01,zipcode,Mcallen
ZCTA5 78503,48,21644,32353,892,91700,15627,6926,12785,5049,2660,1907,2299,870,8039,6505,1534,6505,4188,2317,2019-01-01,zipcode,Mcallen
ZCTA5 78504,48,57410,64697,900,150800,42142,13829,34411,4644,6475,10680,8014,4598,19881,18141,1740,18141,12384,5757,2019-01-01,zipcode,Mcallen
ZCTA5 78516,48,34990,35328,608,62500,23634,11383,18714,7904,5202,3730,1556,322,11720,9452,2268,9452,7175,2277,2019-01-01,zipcode,Alamo
ZCTA5 78520,48,62490,34499,689,89000,46299,21141,36034,13112,8625,7982,4494,1821,20340,18073,2267,18073,10933,7140,2019-01-01,zipcode,Brownsville
ZCTA5 78521,48,90687,32169,720,73400,65162,29561,50384,21265,11966,10379,5032,1742,28412,25324,3088,25324,14748,10576,2019-01-01,zipcode,Brownsville
ZCTA5 78526,48,48995,56152,872,112600,35346,13242,28004,7916,6046,6942,5420,1680,14461,13397,1064,13397,9571,3826,2019-01-01,zipcode,Brownsville
ZCTA5 78535,48,601,49911,675,57900,507,224,415,135,200,65,0,15,230,195,35,195,136,59,2019-01-01,zipcode,Combes
ZCTA5 78536,48,363,67917,-666666666,76400,325,108,287,77,57,109,27,17,186,129,57,129,113,16,2019-01-01,zipcode,Delmita
ZCTA5 78537,48,48072,29959,561,62000,32589,15163,25306,11316,6059,5708,1766,457,15221,12520,2701,12520,9587,2933,2019-01-01,zipcode,Donna
ZCTA5 78538,48,11137,35077,479,61000,8080,3774,6534,2875,1568,1380,540,171,3723,3155,568,3155,2307,848,2019-01-01,zipcode,Edcouch
ZCTA5 78539,48,37380,54158,797,143000,27708,9061,22152,3406,4250,6249,4525,3722,13331,12203,1128,12203,6813,5390,2019-01-01,zipcode,Edinburg
ZCTA5 78541,48,44860,37639,794,94800,31973,11732,24238,7419,5940,6068,3392,1419,14485,12997,1488,12997,6805,6192,2019-01-01,zipcode,Edinburg
ZCTA5 78542,48,77336,42332,652,83800,52817,22982,40660,16414,9723,8979,4321,1223,19483,17350,2133,17350,13270,4080,2019-01-01,zipcode,Edinburg
ZCTA5 78543,48,8689,37728,567,54700,6422,2771,5384,1698,1716,1288,504,178,2679,2399,280,2399,1784,615,2019-01-01,zipcode,Elsa
ZCTA5 78545,48,402,-666666666,-666666666,37900,249,103,219,196,23,0,0,0,190,109,81,109,109,0,2019-01-01,zipcode,Falcon heights
ZCTA5 78548,48,627,-666666666,-666666666,34200,454,225,370,220,77,59,14,0,223,166,57,166,149,17,2019-01-01,zipcode,Grulla
ZCTA5 78549,48,1010,23103,-666666666,45600,590,373,506,299,132,50,15,10,387,288,99,288,258,30,2019-01-01,zipcode,Hargill
ZCTA5 78550,48,52644,38239,718,83600,37349,15429,30650,8301,9083,8176,3500,1590,19312,16813,2499,16813,8613,8200,2019-01-01,zipcode,Harlingen
ZCTA5 78552,48,37948,49217,793,98000,28083,12242,23761,5483,6315,7012,3300,1651,15214,12527,2687,12527,9421,3106,2019-01-01,zipcode,Harlingen
ZCTA5 78557,48,13970,33775,675,100600,10100,3958,7756,3031,1508,1577,1393,247,3914,3758,156,3758,2663,1095,2019-01-01,zipcode,Hidalgo
ZCTA5 78558,48,1021,48935,-666666666,59900,741,218,610,294,159,124,33,0,270,219,51,219,171,48,2019-01-01,zipcode,La blanca
ZCTA5 78559,48,13255,37849,678,64300,9579,4210,7857,2327,2350,2110,844,226,4583,3948,635,3948,2909,1039,2019-01-01,zipcode,La feria
ZCTA5 78560,48,4847,41647,677,79600,3373,1585,2769,1047,779,683,144,116,1454,1344,110,1344,875,469,2019-01-01,zipcode,La joya
ZCTA5 78561,48,669,27014,602,54400,554,270,406,211,120,65,10,0,207,179,28,179,132,47,2019-01-01,zipcode,Lasara
ZCTA5 78562,48,4341,41010,413,63400,3338,2082,2711,1249,762,470,230,0,894,777,117,777,574,203,2019-01-01,zipcode,La villa
ZCTA5 78563,48,269,-666666666,-666666666,153400,269,150,269,31,138,48,38,14,134,101,33,101,84,17,2019-01-01,zipcode,Linn
ZCTA5 78564,48,202,41131,-666666666,-666666666,78,10,78,49,19,10,0,0,86,39,47,39,8,31,2019-01-01,zipcode,Lopeno
ZCTA5 78565,48,84,-666666666,-666666666,-666666666,84,61,84,39,0,45,0,0,95,61,34,61,39,22,2019-01-01,zipcode,Los ebanos
ZCTA5 78566,48,17398,48952,787,113600,12322,5435,9837,2459,2608,2950,1335,485,5461,4776,685,4776,3490,1286,2019-01-01,zipcode,Los fresnos
ZCTA5 78567,48,443,29250,-666666666,47100,352,160,313,128,99,60,11,15,196,142,54,142,128,14,2019-01-01,zipcode,Los indios
ZCTA5 78569,48,4101,45185,629,68600,3269,1698,2694,764,984,582,242,122,1426,1190,236,1190,993,197,2019-01-01,zipcode,Lyford
ZCTA5 78570,48,33949,34195,581,64200,23377,10508,18521,7323,4598,4637,1286,677,10783,8886,1897,8886,6386,2500,2019-01-01,zipcode,Mercedes
ZCTA5 78572,48,80601,44206,764,93200,58594,26947,47782,15058,11801,10354,7323,3246,30351,24530,5821,24530,17278,7252,2019-01-01,zipcode,Mission
ZCTA5 78573,48,38826,36638,715,89200,26600,9675,20380,8034,4960,4539,2066,781,10962,9865,1097,9865,6683,3182,2019-01-01,zipcode,Mission
ZCTA5 78574,48,62616,35429,712,81200,42720,16912,32231,14495,6853,6350,3424,1109,17673,15548,2125,15548,12106,3442,2019-01-01,zipcode,Mission
ZCTA5 78575,48,12215,68873,956,126100,8753,3478,7420,1342,1534,2229,1424,891,4013,3455,558,3455,2562,893,2019-01-01,zipcode,Olmito
ZCTA5 78576,48,10600,21230,539,65700,6285,3148,4270,2302,1311,434,190,33,2802,2508,294,2508,1968,540,2019-01-01,zipcode,Penitas
ZCTA5 78577,48,78103,39849,752,81000,53666,23622,43483,15455,11163,10392,4958,1515,25190,22111,3079,22111,13329,8782,2019-01-01,zipcode,Pharr
ZCTA5 78578,48,11772,36147,703,130700,9290,4922,8473,2249,2966,1854,819,585,6882,4384,2498,4384,2975,1409,2019-01-01,zipcode,Port isabel
ZCTA5 78579,48,5836,53347,617,58000,4565,1660,3450,1584,701,665,360,140,1618,1416,202,1416,1274,142,2019-01-01,zipcode,Progreso
ZCTA5 78580,48,14839,35089,681,50200,11514,5263,8940,3215,3208,1849,510,158,4536,3756,780,3756,2358,1398,2019-01-01,zipcode,Raymondville
ZCTA5 78582,48,43074,32104,605,72100,29860,12024,23252,10674,6209,4158,1571,640,12754,10636,2118,10636,8088,2548,2019-01-01,zipcode,Rio grande city
ZCTA5 78583,48,7137,37070,543,76500,5570,2990,4964,1332,1722,1166,512,232,3945,2482,1463,2482,2073,409,2019-01-01,zipcode,Rio hondo
ZCTA5 78584,48,19175,24504,579,72300,13967,6683,11168,5490,2901,1591,886,300,6151,4988,1163,4988,3566,1422,2019-01-01,zipcode,Roma
ZCTA5 78585,48,356,14300,-666666666,71400,253,151,202,83,46,61,0,12,201,114,87,114,112,2,2019-01-01,zipcode,Salineno
ZCTA5 78586,48,56692,31809,689,59600,40726,19403,32290,11724,9677,7201,2306,1382,18459,15680,2779,15680,12156,3524,2019-01-01,zipcode,San benito
ZCTA5 78588,48,133,36705,-666666666,-666666666,103,39,90,11,24,42,8,5,71,45,26,45,43,2,2019-01-01,zipcode,San isidro
ZCTA5 78589,48,41291,38689,758,87400,29512,12283,22808,8805,5932,5115,2190,766,11580,10593,987,10593,8134,2459,2019-01-01,zipcode,San juan
ZCTA5 78590,48,354,41375,-666666666,35600,263,72,216,68,82,39,27,0,103,81,22,81,81,0,2019-01-01,zipcode,San perlita
ZCTA5 78591,48,249,-666666666,-666666666,238600,177,114,164,0,65,64,31,4,133,79,54,79,58,21,2019-01-01,zipcode,Santa elena
ZCTA5 78592,48,676,30347,580,34100,580,289,422,219,111,68,24,0,233,209,24,209,165,44,2019-01-01,zipcode,Santa maria
ZCTA5 78593,48,5895,32318,636,56200,4482,2068,3594,1211,1480,602,261,40,1749,1555,194,1555,1130,425,2019-01-01,zipcode,Santa rosa
ZCTA5 78594,48,1555,28910,319,49900,1185,655,945,290,300,267,72,16,652,526,126,526,457,69,2019-01-01,zipcode,Sebastian
ZCTA5 78595,48,5959,30203,535,54400,4067,1818,3027,1825,669,393,112,28,1868,1639,229,1639,1348,291,2019-01-01,zipcode,Sullivan city
ZCTA5 78596,48,67269,41978,699,79700,46584,19652,37881,11618,9082,10544,4884,1753,23635,18790,4845,18790,13292,5498,2019-01-01,zipcode,Weslaco
ZCTA5 78597,48,2818,45221,1081,306800,2602,1028,2553,81,338,984,577,573,7606,1645,5961,1645,1087,558,2019-01-01,zipcode,South padre island
ZCTA5 78598,48,87,30313,-666666666,152100,87,48,87,0,47,19,5,16,412,53,359,53,49,4,2019-01-01,zipcode,Port mansfield
ZCTA5 78602,48,29795,63592,983,195400,23608,11237,20608,2419,6551,6396,3348,1894,10830,9315,1515,9315,7282,2033,2019-01-01,zipcode,Bastrop
ZCTA5 78605,48,6275,64769,922,163800,4996,1995,4050,569,1606,1275,482,118,2267,1966,301,1966,1693,273,2019-01-01,zipcode,Bertram
ZCTA5 78606,48,5547,52594,808,264500,4482,1912,4044,470,1088,1322,837,327,2853,2031,822,2031,1575,456,2019-01-01,zipcode,Blanco
ZCTA5 78607,48,170,-666666666,-666666666,350000,170,151,170,0,110,43,17,0,197,57,140,57,47,10,2019-01-01,zipcode,Bluffton
ZCTA5 78608,48,470,112611,-666666666,168500,442,174,420,62,157,136,65,0,327,202,125,202,157,45,2019-01-01,zipcode,Briggs
ZCTA5 78609,48,1991,55221,833,160000,1754,871,1578,115,579,594,156,134,1663,825,838,825,633,192,2019-01-01,zipcode,Buchanan dam
ZCTA5 78610,48,38525,80256,1316,255000,28680,8366,24234,1944,6179,6781,6289,3041,13034,12584,450,12584,9485,3099,2019-01-01,zipcode,Buda
ZCTA5 78611,48,12921,58199,734,179500,10416,4386,9257,944,2892,3370,1380,671,6491,4468,2023,4468,3432,1036,2019-01-01,zipcode,Burnet
ZCTA5 78612,48,13802,69213,1311,163200,9643,3853,7949,1364,2108,2866,1212,399,4212,3893,319,3893,3210,683,2019-01-01,zipcode,Cedar creek
ZCTA5 78613,48,81943,104308,1414,295000,61701,16807,53156,1962,8137,16359,18123,8575,28334,26937,1397,26937,18709,8228,2019-01-01,zipcode,Cedar park
ZCTA5 78614,48,599,58947,924,191200,489,160,459,53,140,151,93,22,294,248,46,248,188,60,2019-01-01,zipcode,Cost
ZCTA5 78615,48,971,54861,982,178400,700,284,641,83,224,210,60,64,390,331,59,331,257,74,2019-01-01,zipcode,Coupland
ZCTA5 78616,48,8918,54870,1032,132000,6376,2377,5196,1594,1767,1304,386,145,3041,2633,408,2633,1999,634,2019-01-01,zipcode,Dale
ZCTA5 78617,48,28930,62179,1280,148300,21511,7188,16865,5501,5867,3832,1415,250,7436,6790,646,6790,5280,1510,2019-01-01,zipcode,Del valle
ZCTA5 78618,48,338,66250,920,326400,297,142,284,4,132,71,48,29,279,130,149,130,111,19,2019-01-01,zipcode,Doss
ZCTA5 78619,48,4505,132568,997,486600,3476,930,3150,204,700,692,988,566,1571,1532,39,1532,1343,189,2019-01-01,zipcode,Driftwood
ZCTA5 78620,48,17590,108570,1204,413300,13861,4631,11839,682,2018,3167,4178,1794,6437,6107,330,6107,5249,858,2019-01-01,zipcode,Dripping springs
ZCTA5 78621,48,23936,72500,981,166300,18275,6026,16017,3729,4751,4899,1958,680,7913,6966,947,6966,5299,1667,2019-01-01,zipcode,Elgin
ZCTA5 78622,48,237,58864,1125,-666666666,199,60,190,45,78,16,51,0,141,106,35,106,77,29,2019-01-01,zipcode,Fentress
ZCTA5 78623,48,1113,84875,-666666666,248000,981,476,922,5,186,442,151,138,502,435,67,435,423,12,2019-01-01,zipcode,Fischer
ZCTA5 78624,48,22444,60761,958,294000,18530,7556,16420,1697,4918,4364,3880,1561,11129,9036,2093,9036,6419,2617,2019-01-01,zipcode,Fredericksburg
ZCTA5 78626,48,36556,71638,1221,221900,28733,9267,23081,2696,6491,6841,4658,2395,11949,11129,820,11129,7422,3707,2019-01-01,zipcode,Georgetown
ZCTA5 78628,48,35601,95238,1186,309800,28433,11236,25080,1336,4925,8121,6915,3783,12805,12333,472,12333,8830,3503,2019-01-01,zipcode,Georgetown
ZCTA5 78629,48,12393,53783,732,139000,9233,3842,7924,1606,3480,1603,891,344,5230,4402,828,4402,2801,1601,2019-01-01,zipcode,Gonzales
ZCTA5 78631,48,2964,59531,976,227200,2205,934,2038,190,639,754,291,164,1400,1061,339,1061,930,131,2019-01-01,zipcode,Harper
ZCTA5 78632,48,1003,87604,-666666666,213300,858,316,805,98,408,215,51,33,517,394,123,394,349,45,2019-01-01,zipcode,Harwood
ZCTA5 78633,48,25853,80117,1698,319500,23335,16091,22247,501,3599,6586,6802,4759,12358,11966,392,11966,10893,1073,2019-01-01,zipcode,Georgetown
ZCTA5 78634,48,34447,84237,1420,203900,25370,5924,22503,1755,6660,7534,4740,1814,11281,10403,878,10403,8580,1823,2019-01-01,zipcode,Hutto
ZCTA5 78635,48,564,86389,-666666666,343000,444,170,299,26,50,223,0,0,166,150,16,150,119,31,2019-01-01,zipcode,Hye
ZCTA5 78636,48,3555,63836,864,262300,3080,1334,2819,300,849,803,580,287,1956,1530,426,1530,1143,387,2019-01-01,zipcode,Johnson city
ZCTA5 78638,48,2133,57924,1196,123000,1719,761,1499,185,573,442,183,116,1035,886,149,886,760,126,2019-01-01,zipcode,Kingsbury
ZCTA5 78639,48,8792,48787,878,154700,7585,3821,6726,1220,1778,2397,786,545,4969,3389,1580,3389,2453,936,2019-01-01,zipcode,Kingsland
ZCTA5 78640,48,58790,75689,1406,189100,43161,12653,36781,5421,9919,11736,6518,3187,19309,18428,881,18428,12991,5437,2019-01-01,zipcode,Kyle
ZCTA5 78641,48,72078,100562,1529,253600,52943,14994,45787,3532,8580,15777,12372,5526,23075,21929,1146,21929,17744,4185,2019-01-01,zipcode,Leander
ZCTA5 78642,48,12363,89213,833,280100,9555,2721,7895,760,2219,2446,1741,729,4097,3812,285,3812,3061,751,2019-01-01,zipcode,Liberty hill
ZCTA5 78643,48,6298,53590,776,171300,5327,2638,4871,804,1390,1588,843,246,3728,2301,1427,2301,1806,495,2019-01-01,zipcode,Llano
ZCTA5 78644,48,18390,57637,961,141000,14982,6765,13025,2467,5158,3370,1435,595,6545,5980,565,5980,4055,1925,2019-01-01,zipcode,Lockhart
ZCTA5 78645,48,11579,80179,1343,252800,9401,3658,8825,521,2108,3101,2325,770,5791,4550,1241,4550,3796,754,2019-01-01,zipcode,Leander
ZCTA5 78648,48,8148,47854,816,157900,6604,2906,5688,1090,2204,1574,612,208,3492,3177,315,3177,2005,1172,2019-01-01,zipcode,Luling
ZCTA5 78650,48,1632,60515,850,155700,1288,366,1099,161,528,268,87,55,681,535,146,535,414,121,2019-01-01,zipcode,Mc dade
ZCTA5 78652,48,5374,86404,1462,306200,4672,1525,4330,304,1100,1138,1187,601,2442,2138,304,2138,1422,716,2019-01-01,zipcode,Manchaca
ZCTA5 78653,48,24313,73496,1447,187700,16961,4577,14967,2696,4238,4327,2622,1084,8014,7270,744,7270,5997,1273,2019-01-01,zipcode,Manor
ZCTA5 78654,48,18250,54034,820,207900,14784,6421,12669,1652,3428,3824,2554,1211,9754,7082,2672,7082,5044,2038,2019-01-01,zipcode,Marble falls
ZCTA5 78655,48,2845,62386,788,178300,2245,809,1954,570,703,361,179,141,1145,987,158,987,763,224,2019-01-01,zipcode,Martindale
ZCTA5 78656,48,2416,61913,923,152600,1893,509,1485,308,587,453,105,32,724,711,13,711,409,302,2019-01-01,zipcode,Maxwell
ZCTA5 78657,48,6277,71483,1127,314700,5669,3050,5116,364,1104,1501,1684,463,5092,2720,2372,2720,2290,430,2019-01-01,zipcode,Horseshoe bay
ZCTA5 78659,48,2616,65345,729,181000,2166,886,1896,121,838,668,205,64,1188,942,246,942,806,136,2019-01-01,zipcode,Paige
ZCTA5 78660,48,91300,88204,1383,232700,69860,17644,60542,5612,13711,18432,16433,6354,31981,30885,1096,30885,22871,8014,2019-01-01,zipcode,Pflugerville
ZCTA5 78661,48,329,39531,967,76300,251,124,218,38,120,16,44,0,142,125,17,125,90,35,2019-01-01,zipcode,Prairie lea
ZCTA5 78662,48,2201,79792,1068,191900,1876,560,1583,47,514,769,152,101,911,772,139,772,601,171,2019-01-01,zipcode,Red rock
ZCTA5 78663,48,873,91413,788,-666666666,765,182,683,21,185,280,84,113,463,354,109,354,302,52,2019-01-01,zipcode,Round mountain
ZCTA5 78664,48,64686,75766,1309,215800,50494,12142,41936,3911,9658,14606,9437,4324,22459,20606,1853,20606,11385,9221,2019-01-01,zipcode,Round rock
ZCTA5 78665,48,49074,95932,1496,266400,36038,8888,30178,1343,5759,10230,8677,4169,16094,14791,1303,14791,10429,4362,2019-01-01,zipcode,Round rock
ZCTA5 78666,48,82923,44159,1056,172100,71617,24507,42165,5897,11753,11758,8365,4392,31605,29054,2551,29054,11368,17686,2019-01-01,zipcode,San marcos
ZCTA5 78669,48,12901,121118,934,449800,10129,3809,9565,290,1539,2563,3383,1790,6179,4667,1512,4667,4178,489,2019-01-01,zipcode,Spicewood
ZCTA5 78670,48,112,70938,-666666666,158800,102,41,93,7,20,48,18,0,51,47,4,47,29,18,2019-01-01,zipcode,Staples
ZCTA5 78671,48,706,-666666666,730,156000,625,217,476,164,93,113,95,11,407,323,84,323,188,135,2019-01-01,zipcode,Stonewall
ZCTA5 78672,48,1283,41903,-666666666,123600,1128,690,1078,217,283,442,126,10,1139,611,528,611,573,38,2019-01-01,zipcode,Tow
ZCTA5 78675,48,314,31750,-666666666,-666666666,293,122,262,66,103,21,58,14,215,150,65,150,127,23,2019-01-01,zipcode,Willow city
ZCTA5 78676,48,13124,77028,1212,296800,11159,4935,9545,570,1321,3213,2595,1846,6402,5312,1090,5312,4441,871,2019-01-01,zipcode,Wimberley
ZCTA5 78677,48,39,-666666666,-666666666,-666666666,33,33,33,0,33,0,0,0,14,14,0,14,14,0,2019-01-01,zipcode,Wrightsboro
ZCTA5 78681,48,58155,107912,1436,299700,43351,11818,36594,1835,5087,10531,12709,6432,18461,17448,1013,17448,13305,4143,2019-01-01,zipcode,Round rock
ZCTA5 78701,48,10848,122182,2262,448100,10685,2421,9614,425,612,1080,4721,2776,8090,6395,1695,6395,2127,4268,2019-01-01,zipcode,Austin
ZCTA5 78702,48,23671,65689,1223,399400,20147,5493,18112,2973,3002,3633,5594,2910,11078,9713,1365,9713,4104,5609,2019-01-01,zipcode,Austin
ZCTA5 78703,48,20407,108548,1507,849600,16738,4111,15584,219,412,1653,6650,6650,10832,9545,1287,9545,5213,4332,2019-01-01,zipcode,Austin
ZCTA5 78704,48,48746,75233,1428,553300,43006,8772,37992,2273,3237,6966,16697,8819,27977,25071,2906,25071,8938,16133,2019-01-01,zipcode,Austin
ZCTA5 78705,48,34549,20326,1313,431300,33904,18493,7295,252,558,1329,3156,2000,10818,8873,1945,8873,875,7998,2019-01-01,zipcode,Austin
ZCTA5 78712,48,880,-666666666,-666666666,-666666666,880,557,18,0,0,0,18,0,0,0,0,0,0,0,2019-01-01,zipcode,Austin
ZCTA5 78717,48,30657,112590,1382,369200,22294,5664,19541,447,1909,5089,7280,4816,11163,10552,611,10552,6061,4491,2019-01-01,zipcode,Austin
ZCTA5 78719,48,1709,64167,1008,144000,1443,501,1304,685,325,201,56,37,487,428,59,428,351,77,2019-01-01,zipcode,Austin
ZCTA5 78721,48,12110,46591,1179,284400,10163,3296,8752,2195,1849,1762,2037,909,4696,4208,488,4208,2222,1986,2019-01-01,zipcode,Austin
ZCTA5 78722,48,7180,72428,1414,423100,6229,1192,5723,300,633,806,2436,1548,3628,3260,368,3260,1432,1828,2019-01-01,zipcode,Austin
ZCTA5 78723,48,35725,59197,1115,338100,28232,7173,25389,4051,4737,5526,6932,4143,15079,13527,1552,13527,6242,7285,2019-01-01,zipcode,Austin
ZCTA5 78724,48,25723,50625,1261,147400,17732,5744,14384,5004,4320,2865,1426,769,7141,6776,365,6776,4407,2369,2019-01-01,zipcode,Austin
ZCTA5 78725,48,8469,59949,1546,167700,6308,1823,5754,1404,1655,1578,618,499,2907,2775,132,2775,2309,466,2019-01-01,zipcode,Austin
ZCTA5 78726,48,14040,77384,1257,473500,11336,2371,9517,84,696,2295,4365,2077,6538,5877,661,5877,2427,3450,2019-01-01,zipcode,Austin
ZCTA5 78727,48,30561,80758,1364,295200,25651,6347,23402,817,2701,5777,8624,5483,14721,13557,1164,13557,6391,7166,2019-01-01,zipcode,Austin
ZCTA5 78728,48,21125,57590,1171,257500,17007,3987,15317,709,3602,3981,5089,1936,10889,10008,881,10008,2651,7357,2019-01-01,zipcode,Austin
ZCTA5 78729,48,28644,80742,1301,285500,23933,5288,21196,904,3338,5948,7130,3876,12923,11898,1025,11898,5090,6808,2019-01-01,zipcode,Austin
ZCTA5 78730,48,9803,124063,1365,730800,7848,2179,7212,117,520,1088,3025,2462,4339,4059,280,4059,2451,1608,2019-01-01,zipcode,Austin
ZCTA5 78731,48,27298,94851,1297,636800,22348,7032,20293,345,1023,2912,7933,8080,13665,12537,1128,12537,7270,5267,2019-01-01,zipcode,Austin
ZCTA5 78732,48,17780,167604,1837,536800,12861,4082,11173,236,594,2064,5244,3035,6063,5867,196,5867,4602,1265,2019-01-01,zipcode,Austin
ZCTA5 78733,48,8927,184500,2512,623900,6524,2187,5819,62,228,1013,2224,2292,3062,2932,130,2932,2612,320,2019-01-01,zipcode,Austin
ZCTA5 78734,48,19452,117604,1820,421300,15590,5648,14329,666,1574,3515,5591,2983,8817,7751,1066,7751,6334,1417,2019-01-01,zipcode,Austin
ZCTA5 78735,48,18122,98906,1560,496200,14137,4127,12775,440,1215,2499,5094,3527,8727,7609,1118,7609,4001,3608,2019-01-01,zipcode,Austin
ZCTA5 78736,48,10163,103287,1577,344200,8207,2627,7514,189,1396,2243,2626,1060,3799,3678,121,3678,2759,919,2019-01-01,zipcode,Austin
ZCTA5 78737,48,17173,142411,1875,454600,12322,3788,11224,262,1251,2542,4556,2613,5724,5621,103,5621,5188,433,2019-01-01,zipcode,Austin
ZCTA5 78738,48,15986,129907,1601,562800,12247,4242,11126,152,916,2134,5150,2774,6858,6216,642,6216,4477,1739,2019-01-01,zipcode,Austin
ZCTA5 78739,48,21040,162274,2424,467000,14914,4611,13742,173,879,2295,6055,4340,6903,6695,208,6695,6366,329,2019-01-01,zipcode,Austin
ZCTA5 78741,48,52114,45835,1150,208300,44118,8889,32886,6891,6407,8016,8233,3339,24027,21664,2363,21664,3388,18276,2019-01-01,zipcode,Austin
ZCTA5 78742,48,887,52917,1095,-666666666,680,239,507,193,97,145,36,36,289,271,18,271,168,103,2019-01-01,zipcode,Austin
ZCTA5 78744,48,50123,52345,1180,164300,37231,9939,30549,9176,8226,6893,4838,1416,16481,15493,988,15493,6727,8766,2019-01-01,zipcode,Austin
ZCTA5 78745,48,61907,64626,1337,279500,52644,12683,47741,4599,8602,14013,14198,6329,28390,26756,1634,26756,12379,14377,2019-01-01,zipcode,Austin
ZCTA5 78746,48,28608,151801,1638,903900,22433,7697,20137,292,721,2409,9208,7507,11927,10894,1033,10894,7562,3332,2019-01-01,zipcode,Austin
ZCTA5 78747,48,21021,82811,1459,235600,16776,4709,14323,2043,3339,4019,3556,1366,7287,6971,316,6971,5312,1659,2019-01-01,zipcode,Austin
ZCTA5 78748,48,51653,76909,1396,272100,41535,10037,36972,2454,6696,10415,12081,5326,21415,20239,1176,20239,12294,7945,2019-01-01,zipcode,Austin
ZCTA5 78749,48,38041,105734,1423,344700,30637,7493,27713,604,3051,5468,11494,7096,16004,15428,576,15428,9837,5591,2019-01-01,zipcode,Austin
ZCTA5 78750,48,31734,102130,1425,418900,25188,7352,22679,899,2743,5234,8044,5759,12534,11858,676,11858,7461,4397,2019-01-01,zipcode,Austin
ZCTA5 78751,48,16197,64340,1375,483300,14781,2941,12018,268,1051,1940,5297,3462,8925,7911,1014,7911,2381,5530,2019-01-01,zipcode,Austin
ZCTA5 78752,48,20881,48454,1114,275500,17008,3701,15043,2976,3086,3141,3925,1915,9275,8484,791,8484,2179,6305,2019-01-01,zipcode,Austin
ZCTA5 78753,48,60426,51053,1105,199600,46798,12231,39816,10373,10909,9572,6085,2877,22078,20552,1526,20552,7306,13246,2019-01-01,zipcode,Austin
ZCTA5 78754,48,26433,72752,1247,223700,19520,4389,17036,2184,3527,4197,4426,2702,9132,8816,316,8816,4859,3957,2019-01-01,zipcode,Austin
ZCTA5 78756,48,8694,82535,1261,537700,7593,1626,6821,149,484,1009,3059,2120,4792,4339,453,4339,1883,2456,2019-01-01,zipcode,Austin
ZCTA5 78757,48,25706,76716,1213,416300,20597,4952,18939,1622,2399,3919,6536,4463,11826,10937,889,10937,6012,4925,2019-01-01,zipcode,Austin
ZCTA5 78758,48,48993,55074,1196,222400,39372,8818,34956,5849,8055,7722,9120,4210,22664,20844,1820,20844,5823,15021,2019-01-01,zipcode,Austin
ZCTA5 78759,48,43298,85555,1287,444100,36361,9507,33095,691,2848,7250,12783,9523,22083,20671,1412,20671,9572,11099,2019-01-01,zipcode,Austin
ZCTA5 78801,48,22518,42360,658,91100,17289,7111,13795,3285,3939,4104,2019,448,8615,7223,1392,7223,5201,2022,2019-01-01,zipcode,Uvalde
ZCTA5 78802,48,21,-666666666,-666666666,-666666666,21,0,21,0,21,0,0,0,40,21,19,21,21,0,2019-01-01,zipcode,Uvalde
ZCTA5 78827,48,1173,29545,537,59200,914,435,768,186,246,227,55,54,543,390,153,390,294,96,2019-01-01,zipcode,Asherton
ZCTA5 78828,48,117,72925,-666666666,-666666666,117,96,117,0,10,71,17,19,283,83,200,83,83,0,2019-01-01,zipcode,Barksdale
ZCTA5 78829,48,1448,34231,722,29000,1016,547,884,407,187,233,57,0,564,382,182,382,310,72,2019-01-01,zipcode,Batesville
ZCTA5 78830,48,966,24280,800,60300,803,488,642,197,252,173,9,11,390,269,121,269,229,40,2019-01-01,zipcode,Big wells
ZCTA5 78832,48,3659,26738,515,68800,3198,1944,2957,635,1087,876,195,164,1995,1337,658,1337,1024,313,2019-01-01,zipcode,Brackettville
ZCTA5 78833,48,1463,33684,643,73100,1288,773,1156,210,490,332,98,26,1014,532,482,532,371,161,2019-01-01,zipcode,Camp wood
ZCTA5 78834,48,8059,29115,732,78100,5852,2858,4863,1666,1801,656,507,233,3353,2409,944,2409,1482,927,2019-01-01,zipcode,Carrizo springs
ZCTA5 78836,48,228,18077,-666666666,36900,219,163,183,112,44,19,8,0,120,68,52,68,68,0,2019-01-01,zipcode,Catarina
ZCTA5 78837,48,230,-666666666,-666666666,70000,195,87,173,68,45,37,14,9,210,93,117,93,84,9,2019-01-01,zipcode,Comstock
ZCTA5 78838,48,202,-666666666,-666666666,265300,202,152,202,59,65,32,23,23,309,110,199,110,107,3,2019-01-01,zipcode,Concan
ZCTA5 78839,48,8995,34567,613,53800,6855,3165,5231,1515,1948,1132,445,191,3167,2718,449,2718,1901,817,2019-01-01,zipcode,Crystal city
ZCTA5 78840,48,47937,46345,730,103700,35629,14488,29134,9306,7066,7431,3715,1616,18653,15578,3075,15578,9883,5695,2019-01-01,zipcode,Del rio
ZCTA5 78843,48,689,-666666666,-666666666,-666666666,689,0,82,0,0,18,64,0,54,54,0,54,0,54,2019-01-01,zipcode,Laughlin afb
ZCTA5 78850,48,1109,60893,700,163900,883,428,743,159,179,233,106,66,552,378,174,378,329,49,2019-01-01,zipcode,D hanis
ZCTA5 78851,48,37,88264,-666666666,-666666666,37,12,37,8,3,8,18,0,40,25,15,25,21,4,2019-01-01,zipcode,Dryden
ZCTA5 78852,48,57159,39548,658,97800,41328,17686,32188,13021,7291,7863,3158,855,18025,15986,2039,15986,10454,5532,2019-01-01,zipcode,Eagle pass
ZCTA5 78860,48,21,-666666666,-666666666,-666666666,21,21,21,21,0,0,0,0,21,21,0,21,21,0,2019-01-01,zipcode,El indio
ZCTA5 78861,48,13663,59111,811,132900,10850,5567,9088,1471,3145,3126,809,537,4833,3982,851,3982,3070,912,2019-01-01,zipcode,Hondo
ZCTA5 78870,48,1099,41397,562,111300,846,343,626,183,193,104,85,61,447,349,98,349,226,123,2019-01-01,zipcode,Knippa
ZCTA5 78871,48,13,-666666666,-666666666,-666666666,13,7,13,0,10,0,3,0,66,7,59,7,7,0,2019-01-01,zipcode,Langtry
ZCTA5 78872,48,1608,29018,589,43600,1145,611,990,441,182,290,38,39,666,483,183,483,371,112,2019-01-01,zipcode,La pryor
ZCTA5 78873,48,2053,37045,912,164100,1440,817,1220,251,240,473,172,84,1408,652,756,652,531,121,2019-01-01,zipcode,Leakey
ZCTA5 78877,48,724,39750,-666666666,151200,533,316,533,258,142,27,46,60,273,229,44,229,177,52,2019-01-01,zipcode,Quemado
ZCTA5 78879,48,89,66136,-666666666,141700,89,32,75,0,0,39,36,0,318,40,278,40,40,0,2019-01-01,zipcode,Rio frio
ZCTA5 78880,48,1626,33229,391,66300,1368,617,1173,398,280,317,152,26,1409,635,774,635,526,109,2019-01-01,zipcode,Rocksprings
ZCTA5 78881,48,2184,30156,624,65100,1591,941,1441,384,560,285,153,59,1125,815,310,815,646,169,2019-01-01,zipcode,Sabinal
ZCTA5 78883,48,395,58125,-666666666,-666666666,356,262,321,0,129,77,70,45,393,171,222,171,159,12,2019-01-01,zipcode,Tarpley
ZCTA5 78884,48,1134,57262,-666666666,188000,894,323,815,54,202,322,136,101,825,420,405,420,369,51,2019-01-01,zipcode,Utopia
ZCTA5 78885,48,115,58750,-666666666,370000,115,64,88,0,31,40,10,7,171,47,124,47,40,7,2019-01-01,zipcode,Vanderpool
ZCTA5 78886,48,469,43688,-666666666,152100,415,199,365,39,145,127,48,6,279,189,90,189,162,27,2019-01-01,zipcode,Yancey
ZCTA5 78931,48,368,101528,-666666666,342600,274,109,256,31,81,63,53,28,218,151,67,151,138,13,2019-01-01,zipcode,Bleiblerville
ZCTA5 78932,48,565,76375,723,-666666666,526,269,436,38,90,122,164,22,389,195,194,195,161,34,2019-01-01,zipcode,Carmine
ZCTA5 78933,48,1308,61930,-666666666,121900,1006,438,995,150,234,315,247,49,866,570,296,570,439,131,2019-01-01,zipcode,Cat spring
ZCTA5 78934,48,6816,53532,685,142700,5217,2211,4579,665,1465,1292,873,284,3372,2380,992,2380,1841,539,2019-01-01,zipcode,Columbus
ZCTA5 78935,48,1234,105234,-666666666,281300,1094,495,978,65,289,333,178,113,514,398,116,398,390,8,2019-01-01,zipcode,Alleyton
ZCTA5 78938,48,303,49808,629,155100,246,92,194,6,87,67,19,15,187,130,57,130,97,33,2019-01-01,zipcode,Ellinger
ZCTA5 78940,48,2521,57500,781,176800,2150,886,1884,156,832,528,292,76,1489,884,605,884,795,89,2019-01-01,zipcode,Fayetteville
ZCTA5 78941,48,2709,60625,785,161900,2352,1252,2093,358,959,419,276,81,1565,935,630,935,804,131,2019-01-01,zipcode,Flatonia
ZCTA5 78942,48,9033,52637,881,125300,7079,2654,5793,1092,2152,1719,625,205,3771,2965,806,2965,2098,867,2019-01-01,zipcode,Giddings
ZCTA5 78943,48,311,-666666666,-666666666,114900,274,100,274,69,55,102,27,21,163,109,54,109,109,0,2019-01-01,zipcode,Glidden
ZCTA5 78944,48,524,67153,-666666666,244800,490,244,439,24,163,175,46,31,304,241,63,241,227,14,2019-01-01,zipcode,Industry
ZCTA5 78945,48,10767,62083,860,199800,8598,3544,7610,1142,2881,2194,1019,374,5636,4080,1556,4080,3204,876,2019-01-01,zipcode,La grange
ZCTA5 78946,48,1270,53684,925,117600,1188,374,1086,128,421,432,77,28,729,458,271,458,360,98,2019-01-01,zipcode,Ledbetter
ZCTA5 78947,48,4634,64917,985,192300,3681,1479,3207,189,1079,1394,342,203,2220,1732,488,1732,1550,182,2019-01-01,zipcode,Lexington
ZCTA5 78948,48,636,38654,-666666666,259100,604,316,512,108,217,141,36,10,407,268,139,268,248,20,2019-01-01,zipcode,Lincoln
ZCTA5 78949,48,590,90750,-666666666,158400,417,205,410,46,141,149,53,21,422,214,208,214,193,21,2019-01-01,zipcode,Muldoon
ZCTA5 78950,48,1810,54292,757,220000,1568,712,1343,131,566,359,193,94,1334,800,534,800,745,55,2019-01-01,zipcode,New ulm
ZCTA5 78951,48,0,-666666666,-666666666,-666666666,0,0,0,0,0,0,0,0,0,0,0,0,0,0,2019-01-01,zipcode,Oakland
ZCTA5 78953,48,701,70069,1401,161800,645,174,645,110,158,292,61,24,535,377,158,377,304,73,2019-01-01,zipcode,Rosanky
ZCTA5 78954,48,1110,69464,789,487500,1019,493,960,51,319,298,224,68,994,513,481,513,461,52,2019-01-01,zipcode,Round top
ZCTA5 78956,48,5685,53194,878,167500,4626,1990,4043,688,1560,1058,546,191,2847,1928,919,1928,1484,444,2019-01-01,zipcode,Schulenburg
ZCTA5 78957,48,9699,58446,1051,173100,7758,3439,6727,869,2096,1991,1240,531,4437,3465,972,3465,2722,743,2019-01-01,zipcode,Smithville
ZCTA5 78959,48,2097,41875,507,104700,1750,865,1546,590,539,298,80,39,1113,850,263,850,652,198,2019-01-01,zipcode,Waelder
ZCTA5 78962,48,5138,62703,747,163800,4149,1515,3467,470,1197,1016,562,222,2767,1895,872,1895,1609,286,2019-01-01,zipcode,Weimar
ZCTA5 78963,48,1202,63657,-666666666,148400,882,289,788,118,339,239,80,12,444,356,88,356,350,6,2019-01-01,zipcode,West point
ZCTA5 79001,48,178,68750,-666666666,94000,151,66,146,6,56,31,37,16,113,69,44,69,58,11,2019-01-01,zipcode,Adrian
ZCTA5 79003,48,185,75833,1125,92500,151,83,139,28,29,58,19,5,109,74,35,74,51,23,2019-01-01,zipcode,Allison
ZCTA5 79005,48,1714,60625,720,114000,1346,401,1145,257,396,304,113,75,677,597,80,597,448,149,2019-01-01,zipcode,Booker
ZCTA5 79007,48,14290,50680,778,80700,10930,4347,9023,1369,2971,3287,1112,284,6816,4529,2287,4529,3451,1078,2019-01-01,zipcode,Borger
ZCTA5 79009,48,1754,37096,657,91300,1354,525,1056,372,384,190,80,30,710,583,127,583,370,213,2019-01-01,zipcode,Bovina
ZCTA5 79010,48,910,-666666666,-666666666,-666666666,438,294,309,0,146,34,98,31,214,170,44,170,103,67,2019-01-01,zipcode,Boys ranch
ZCTA5 79011,48,206,71528,811,157800,185,47,173,11,62,57,32,11,129,105,24,105,77,28,2019-01-01,zipcode,Briscoe
ZCTA5 79012,48,1427,115481,-666666666,260500,988,140,877,0,192,410,241,34,593,519,74,519,480,39,2019-01-01,zipcode,Bushland
ZCTA5 79013,48,3618,47805,670,55800,2587,981,1895,1392,364,104,35,0,1224,953,271,953,543,410,2019-01-01,zipcode,Cactus
ZCTA5 79014,48,3964,71010,825,151000,2881,975,2410,429,763,701,399,118,1707,1285,422,1285,912,373,2019-01-01,zipcode,Canadian
ZCTA5 79015,48,21925,69182,843,189200,17595,5215,12638,641,1886,4839,3651,1621,8427,7474,953,7474,4946,2528,2019-01-01,zipcode,Canyon
ZCTA5 79016,48,147,-666666666,-666666666,-666666666,147,92,8,0,0,4,4,0,0,0,0,0,0,0,2019-01-01,zipcode,Canyon
ZCTA5 79018,48,307,59464,610,81400,240,86,229,13,66,92,26,32,208,135,73,135,74,61,2019-01-01,zipcode,Channing
ZCTA5 79019,48,1871,72981,938,141500,1483,645,1322,179,309,551,197,86,833,646,187,646,568,78,2019-01-01,zipcode,Claude
ZCTA5 79021,48,183,52188,-666666666,73600,127,35,99,41,19,26,7,6,86,56,30,56,21,35,2019-01-01,zipcode,Cotton center
ZCTA5 79022,48,11400,59599,802,120100,8660,3547,7804,1827,2637,2104,902,334,4049,3398,651,3398,2201,1197,2019-01-01,zipcode,Dalhart
ZCTA5 79024,48,380,56250,681,84500,314,117,271,23,110,81,38,19,184,146,38,146,107,39,2019-01-01,zipcode,Darrouzett
ZCTA5 79025,48,20,-666666666,-666666666,-666666666,20,4,20,14,6,0,0,0,25,14,11,14,14,0,2019-01-01,zipcode,Dawn
ZCTA5 79027,48,4794,48622,640,82300,3548,1354,2837,754,886,778,286,133,1958,1557,401,1557,947,610,2019-01-01,zipcode,Dimmitt
ZCTA5 79029,48,15584,58824,859,133900,11107,3379,9225,2325,2491,2891,933,585,5821,5006,815,5006,3325,1681,2019-01-01,zipcode,Dumas
ZCTA5 79031,48,1377,59500,720,70700,1023,405,906,247,242,225,151,41,648,482,166,482,360,122,2019-01-01,zipcode,Earth
ZCTA5 79032,48,98,31932,-666666666,-666666666,67,23,50,13,18,17,2,0,61,33,28,33,18,15,2019-01-01,zipcode,Edmonson
ZCTA5 79033,48,47,-666666666,-666666666,-666666666,47,38,47,18,0,9,20,0,45,29,16,29,20,9,2019-01-01,zipcode,Farnsworth
ZCTA5 79034,48,535,55313,721,92600,405,159,354,37,88,148,70,11,271,195,76,195,157,38,2019-01-01,zipcode,Follett
ZCTA5 79035,48,5307,57013,768,91300,3850,1470,3263,911,971,670,555,156,1937,1729,208,1729,1126,603,2019-01-01,zipcode,Friona
ZCTA5 79036,48,5184,56064,782,75100,4151,2000,3705,414,1467,1401,344,79,2519,1727,792,1727,1591,136,2019-01-01,zipcode,Fritch
ZCTA5 79039,48,965,59792,827,121800,695,279,664,77,212,238,92,45,452,378,74,378,309,69,2019-01-01,zipcode,Groom
ZCTA5 79040,48,1962,49609,868,156000,1443,466,1072,428,202,216,175,51,791,567,224,567,406,161,2019-01-01,zipcode,Gruver
ZCTA5 79041,48,2754,41935,639,76000,2170,1042,1822,412,638,495,214,63,1298,1049,249,1049,744,305,2019-01-01,zipcode,Hale center
ZCTA5 79042,48,1200,46875,783,84800,924,288,756,35,225,238,174,84,617,449,168,449,339,110,2019-01-01,zipcode,Happy
ZCTA5 79043,48,1514,40223,592,54700,1090,438,883,300,304,191,65,23,653,517,136,517,326,191,2019-01-01,zipcode,Hart
ZCTA5 79044,48,646,46169,1063,81700,464,216,353,163,64,53,53,20,341,269,72,269,111,158,2019-01-01,zipcode,Hartley
ZCTA5 79045,48,18847,50035,790,90800,13560,4621,11119,2961,4014,2799,1021,324,7159,6175,984,6175,3949,2226,2019-01-01,zipcode,Hereford
ZCTA5 79046,48,712,54750,850,78900,492,190,428,80,129,133,66,20,315,243,72,243,167,76,2019-01-01,zipcode,Higgins
ZCTA5 79051,48,0,-666666666,-666666666,-666666666,0,0,0,0,0,0,0,0,0,0,0,0,0,0,2019-01-01,zipcode,Kerrick
ZCTA5 79052,48,1318,50729,675,68300,1046,366,782,174,280,217,87,24,589,436,153,436,357,79,2019-01-01,zipcode,Kress
ZCTA5 79053,48,97,-666666666,-666666666,95000,75,21,61,4,13,37,7,0,55,27,28,27,18,9,2019-01-01,zipcode,Lazbuddie
ZCTA5 79054,48,676,36923,738,30300,488,190,438,54,203,164,9,8,324,250,74,250,200,50,2019-01-01,zipcode,Lefors
ZCTA5 79056,48,56,76250,-666666666,109400,46,27,43,2,7,15,10,9,38,20,18,20,16,4,2019-01-01,zipcode,Lipscomb
ZCTA5 79057,48,1254,40104,665,45800,981,440,881,162,280,294,111,34,697,493,204,493,328,165,2019-01-01,zipcode,Mclean
ZCTA5 79058,48,0,-666666666,-666666666,-666666666,0,0,0,0,0,0,0,0,22,0,22,0,0,0,2019-01-01,zipcode,Masterson
ZCTA5 79059,48,671,64107,820,115800,527,227,456,35,142,157,84,38,371,263,108,263,219,44,2019-01-01,zipcode,Miami
ZCTA5 79061,48,375,68333,546,70800,283,102,241,28,49,112,51,1,184,146,38,146,106,40,2019-01-01,zipcode,Mobeetie
ZCTA5 79062,48,180,70000,-666666666,-666666666,151,53,118,30,22,30,29,7,96,58,38,58,46,12,2019-01-01,zipcode,Morse
ZCTA5 79063,48,768,71000,521,161500,587,237,516,13,227,149,100,27,306,278,28,278,226,52,2019-01-01,zipcode,Nazareth
ZCTA5 79064,48,2495,46369,645,60500,1939,853,1673,475,575,417,157,49,1116,903,213,903,587,316,2019-01-01,zipcode,Olton
ZCTA5 79065,48,20606,50126,748,81800,15931,7140,13645,2737,4396,4546,1338,628,9102,7202,1900,7202,5292,1910,2019-01-01,zipcode,Pampa
ZCTA5 79068,48,3489,86116,802,131300,2740,826,2285,91,717,733,492,252,1483,1291,192,1291,979,312,2019-01-01,zipcode,Panhandle
ZCTA5 79070,48,9851,50143,833,103700,7177,2351,5825,1520,1914,1499,686,206,3927,3328,599,3328,2410,918,2019-01-01,zipcode,Perryton
ZCTA5 79072,48,26629,48553,647,84700,20208,8309,16368,3969,5772,3828,1781,1018,10283,8368,1915,8368,4968,3400,2019-01-01,zipcode,Plainview
ZCTA5 79078,48,217,-666666666,417,70000,184,64,175,20,73,56,5,21,180,86,94,86,80,6,2019-01-01,zipcode,Sanford
ZCTA5 79079,48,2617,43277,712,75900,2064,746,1752,344,551,619,180,58,1449,1131,318,1131,698,433,2019-01-01,zipcode,Shamrock
ZCTA5 79080,48,461,50089,820,49500,395,226,359,19,120,175,37,8,364,197,167,197,175,22,2019-01-01,zipcode,Skellytown
ZCTA5 79081,48,3918,30579,734,88900,2889,1246,2473,752,745,674,238,64,1660,1333,327,1333,907,426,2019-01-01,zipcode,Spearman
ZCTA5 79082,48,218,53625,-666666666,76000,165,54,151,26,37,70,10,8,139,97,42,97,90,7,2019-01-01,zipcode,Springlake
ZCTA5 79083,48,1923,43750,685,73000,1577,940,1304,196,405,546,118,39,1258,710,548,710,565,145,2019-01-01,zipcode,Stinnett
ZCTA5 79084,48,2123,49750,753,107500,1680,563,1415,250,393,527,196,49,1012,742,270,742,556,186,2019-01-01,zipcode,Stratford
ZCTA5 79085,48,18,-666666666,-666666666,-666666666,16,2,14,6,1,7,0,0,7,7,0,7,7,0,2019-01-01,zipcode,Summerfield
ZCTA5 79086,48,2228,50000,781,87100,1640,527,1377,352,432,356,187,50,936,780,156,780,571,209,2019-01-01,zipcode,Sunray
ZCTA5 79087,48,629,63333,750,105300,469,189,403,79,101,113,86,24,301,242,59,242,189,53,2019-01-01,zipcode,Texline
ZCTA5 79088,48,5394,36530,703,84100,4216,2346,3774,1156,1107,1029,346,136,2268,1811,457,1811,1235,576,2019-01-01,zipcode,Tulia
ZCTA5 79091,48,77,-666666666,-666666666,-666666666,45,8,45,21,10,14,0,0,41,21,20,21,21,0,2019-01-01,zipcode,Umbarger
ZCTA5 79092,48,1148,63636,780,99200,967,309,898,96,378,298,86,40,452,404,48,404,357,47,2019-01-01,zipcode,Vega
ZCTA5 79093,48,102,-666666666,-666666666,-666666666,90,43,90,14,52,24,0,0,83,68,15,68,68,0,2019-01-01,zipcode,Waka
ZCTA5 79094,48,14,-666666666,-666666666,81300,14,2,14,0,0,8,6,0,31,11,20,11,11,0,2019-01-01,zipcode,Wayside
ZCTA5 79095,48,2657,39583,611,53000,2029,731,1727,440,442,515,279,51,1213,917,296,917,698,219,2019-01-01,zipcode,Wellington
ZCTA5 79096,48,2071,52500,758,104800,1504,542,1387,304,415,376,217,75,944,782,162,782,563,219,2019-01-01,zipcode,Wheeler
ZCTA5 79097,48,863,85139,887,107300,642,222,578,51,181,203,87,56,381,311,70,311,285,26,2019-01-01,zipcode,White deer
ZCTA5 79098,48,484,44643,1058,100000,364,162,291,37,63,137,39,15,186,154,32,154,124,30,2019-01-01,zipcode,Wildorado
ZCTA5 79101,48,1851,21064,765,71600,1710,1163,1629,257,397,623,243,109,1456,1090,366,1090,113,977,2019-01-01,zipcode,Amarillo
ZCTA5 79102,48,9878,44180,783,107200,7502,2392,6004,1139,1750,1973,821,321,4521,4216,305,4216,2094,2122,2019-01-01,zipcode,Amarillo
ZCTA5 79103,48,10869,46694,921,91200,8155,2593,6716,1649,2149,2263,490,165,4112,3927,185,3927,2687,1240,2019-01-01,zipcode,Amarillo
ZCTA5 79104,48,7019,43229,829,62900,5269,2030,4607,1551,1718,1054,227,57,2771,2452,319,2452,1561,891,2019-01-01,zipcode,Amarillo
ZCTA5 79105,48,0,-666666666,-666666666,-666666666,0,0,0,0,0,0,0,0,29,0,29,0,0,0,2019-01-01,zipcode,Amarillo
ZCTA5 79106,48,27268,40632,789,117400,20859,7391,17509,2700,4951,5923,2411,1524,13255,11656,1599,11656,5633,6023,2019-01-01,zipcode,Amarillo
ZCTA5 79107,48,34935,36294,788,67200,24004,9192,19032,7087,6680,4168,923,174,13019,11561,1458,11561,6748,4813,2019-01-01,zipcode,Amarillo
ZCTA5 79108,48,16112,52186,943,115900,13813,8738,12711,2668,5142,3733,988,180,5085,4390,695,4390,3255,1135,2019-01-01,zipcode,Amarillo
ZCTA5 79109,48,44600,57817,783,164100,35202,10764,30337,2106,7044,11595,6751,2841,20453,18235,2218,18235,11171,7064,2019-01-01,zipcode,Amarillo
ZCTA5 79110,48,19158,59249,1066,112200,14250,4036,11945,1260,3371,5087,1608,619,7312,6692,620,6692,4620,2072,2019-01-01,zipcode,Amarillo
ZCTA5 79111,48,2108,65230,1081,-666666666,1601,786,1237,182,452,449,85,69,555,509,46,509,15,494,2019-01-01,zipcode,Amarillo
ZCTA5 79118,48,23381,75021,946,167800,17979,5342,15544,1687,4666,5646,2690,855,8822,7993,829,7993,6430,1563,2019-01-01,zipcode,Amarillo
ZCTA5 79119,48,17524,85490,1052,259000,13664,4032,12181,690,1996,3894,3640,1961,7334,6810,524,6810,4871,1939,2019-01-01,zipcode,Amarillo
ZCTA5 79121,48,6002,84899,933,208700,5188,1850,4665,267,760,1541,1328,769,3017,2538,479,2538,1801,737,2019-01-01,zipcode,Amarillo
ZCTA5 79124,48,8800,97071,1006,262900,6780,2620,6040,282,1061,2239,1579,879,3574,3444,130,3444,2823,621,2019-01-01,zipcode,Amarillo
ZCTA5 79201,48,7288,43507,745,85600,6128,2987,5201,933,1811,1524,729,204,2983,2430,553,2430,1464,966,2019-01-01,zipcode,Childress
ZCTA5 79220,48,208,38958,-666666666,56900,157,79,122,17,31,17,42,15,151,75,76,75,43,32,2019-01-01,zipcode,Afton
ZCTA5 79225,48,1069,52885,696,38900,854,316,708,238,181,179,90,20,608,376,232,376,277,99,2019-01-01,zipcode,Chillicothe
ZCTA5 79226,48,2861,45026,666,76500,2306,1002,1815,196,639,662,217,101,1825,1121,704,1121,793,328,2019-01-01,zipcode,Clarendon
ZCTA5 79227,48,1302,43633,491,46100,1128,481,964,178,306,327,112,41,936,549,387,549,459,90,2019-01-01,zipcode,Crowell
ZCTA5 79229,48,411,52500,450,45000,350,196,317,47,96,140,23,11,266,160,106,160,142,18,2019-01-01,zipcode,Dickens
ZCTA5 79230,48,179,41750,-666666666,-666666666,137,62,135,66,23,5,30,11,78,43,35,43,38,5,2019-01-01,zipcode,Dodson
ZCTA5 79231,48,117,-666666666,-666666666,-666666666,60,32,60,0,32,28,0,0,28,28,0,28,0,28,2019-01-01,zipcode,Dougherty
ZCTA5 79233,48,145,31146,729,24500,109,23,90,12,29,30,19,0,93,67,26,67,40,27,2019-01-01,zipcode,Estelline
ZCTA5 79234,48,26,-666666666,-666666666,-666666666,21,8,21,0,7,13,1,0,62,14,48,14,7,7,2019-01-01,zipcode,Flomot
ZCTA5 79235,48,3298,47198,726,47500,2427,964,2127,596,618,612,233,68,1757,1321,436,1321,1026,295,2019-01-01,zipcode,Floydada
ZCTA5 79236,48,218,58333,592,36700,156,39,149,26,53,38,25,7,112,74,38,74,26,48,2019-01-01,zipcode,Guthrie
ZCTA5 79237,48,417,29417,608,-666666666,363,148,314,49,88,128,33,16,311,203,108,203,136,67,2019-01-01,zipcode,Hedley
ZCTA5 79239,48,181,24250,-666666666,81100,161,84,155,17,59,44,24,11,194,95,99,95,66,29,2019-01-01,zipcode,Lakeview
ZCTA5 79240,48,81,95625,-666666666,-666666666,65,23,58,0,22,27,9,0,30,22,8,22,14,8,2019-01-01,zipcode,Lelia lake
ZCTA5 79241,48,2270,53657,723,81200,1825,736,1512,378,363,489,214,68,1108,880,228,880,632,248,2019-01-01,zipcode,Lockney
ZCTA5 79243,48,53,-666666666,-666666666,-666666666,53,51,53,0,34,15,4,0,37,18,19,18,14,4,2019-01-01,zipcode,Mcadoo
ZCTA5 79244,48,870,51094,624,59100,614,205,559,56,149,266,84,4,464,303,161,303,210,93,2019-01-01,zipcode,Matador
ZCTA5 79245,48,2346,34604,517,53700,1856,837,1595,344,475,552,139,85,1305,943,362,943,611,332,2019-01-01,zipcode,Memphis
ZCTA5 79247,48,64,73000,-666666666,28500,42,12,42,4,20,18,0,0,28,28,0,28,26,2,2019-01-01,zipcode,Odell
ZCTA5 79248,48,1621,31680,342,44100,1182,464,1036,257,283,316,121,59,1066,687,379,687,377,310,2019-01-01,zipcode,Paducah
ZCTA5 79250,48,1401,45000,650,62800,1110,489,959,218,296,249,131,65,734,536,198,536,419,117,2019-01-01,zipcode,Petersburg
ZCTA5 79251,48,13,-666666666,-666666666,66000,13,7,13,8,0,3,0,2,16,8,8,8,8,0,2019-01-01,zipcode,Quail
ZCTA5 79252,48,2954,39438,482,45800,2419,1087,2106,349,740,744,185,88,1766,1240,526,1240,817,423,2019-01-01,zipcode,Quanah
ZCTA5 79255,48,664,45000,625,96100,529,232,419,56,145,114,87,17,447,260,187,260,179,81,2019-01-01,zipcode,Quitaque
ZCTA5 79256,48,290,42738,623,51400,259,96,246,44,101,49,47,5,197,146,51,146,91,55,2019-01-01,zipcode,Roaring springs
ZCTA5 79257,48,822,39688,-666666666,49600,714,384,638,100,238,197,59,44,565,343,222,343,253,90,2019-01-01,zipcode,Silverton
ZCTA5 79258,48,49,65455,-666666666,58200,49,33,33,0,26,7,0,0,26,18,8,18,18,0,2019-01-01,zipcode,South plains
ZCTA5 79259,48,35,-666666666,-666666666,-666666666,35,4,35,0,0,7,28,0,70,15,55,15,15,0,2019-01-01,zipcode,Tell
ZCTA5 79261,48,370,41458,563,54100,319,143,234,51,72,82,19,10,332,163,169,163,111,52,2019-01-01,zipcode,Turkey
ZCTA5 79311,48,3415,49861,667,87700,2528,1031,2102,360,670,622,374,76,1453,1236,217,1236,908,328,2019-01-01,zipcode,Abernathy
ZCTA5 79312,48,978,50625,478,61900,833,374,704,193,210,209,72,20,467,354,113,354,286,68,2019-01-01,zipcode,Amherst
ZCTA5 79313,48,1528,42000,609,61100,1129,460,1007,275,310,304,87,31,744,534,210,534,363,171,2019-01-01,zipcode,Anton
ZCTA5 79314,48,40,-666666666,-666666666,-666666666,24,17,24,3,15,5,0,1,41,18,23,18,11,7,2019-01-01,zipcode,Bledsoe
ZCTA5 79316,48,11310,43369,702,76100,8592,3808,7234,2380,2241,1806,582,225,4361,3672,689,3672,2505,1167,2019-01-01,zipcode,Brownfield
ZCTA5 79322,48,2022,38710,600,63200,1549,644,1291,305,465,307,167,47,964,748,216,748,583,165,2019-01-01,zipcode,Crosbyton
ZCTA5 79323,48,7252,70941,834,145100,4944,1782,4035,1465,1130,992,343,105,2398,2152,246,2152,1712,440,2019-01-01,zipcode,Denver city
ZCTA5 79324,48,42,-666666666,-666666666,256300,29,12,18,0,6,12,0,0,26,14,12,14,14,0,2019-01-01,zipcode,Enochs
ZCTA5 79325,48,2184,62625,671,110500,1645,610,1384,371,450,355,148,60,950,755,195,755,550,205,2019-01-01,zipcode,Farwell
ZCTA5 79326,48,59,-666666666,-666666666,107000,41,19,33,0,6,23,0,4,31,23,8,23,23,0,2019-01-01,zipcode,Fieldton
ZCTA5 79329,48,3112,67404,689,148000,2501,856,2078,458,638,501,378,103,1323,1117,206,1117,872,245,2019-01-01,zipcode,Idalou
ZCTA5 79330,48,139,94375,-666666666,167700,105,66,93,0,65,10,8,10,327,33,294,33,27,6,2019-01-01,zipcode,Justiceburg
ZCTA5 79331,48,12426,42426,644,74100,9653,5056,7813,2359,2531,1822,904,197,4980,4191,789,4191,2895,1296,2019-01-01,zipcode,Lamesa
ZCTA5 79336,48,17270,47688,697,98900,13248,4941,10715,2604,2800,3691,1113,507,7008,6050,958,6050,4165,1885,2019-01-01,zipcode,Levelland
ZCTA5 79339,48,6617,42757,787,66100,4750,1898,3996,987,1349,1145,376,139,2917,2298,619,2298,1551,747,2019-01-01,zipcode,Littlefield
ZCTA5 79342,48,516,92813,428,78100,307,116,291,78,79,77,18,39,183,147,36,147,89,58,2019-01-01,zipcode,Loop
ZCTA5 79343,48,1700,42206,583,76300,1289,469,1041,262,386,241,116,36,670,554,116,554,384,170,2019-01-01,zipcode,Lorenzo
ZCTA5 79344,48,161,-666666666,-666666666,64200,75,34,52,0,16,11,25,0,67,32,35,32,25,7,2019-01-01,zipcode,Maple
ZCTA5 79345,48,990,56538,642,93200,719,270,596,134,211,158,82,11,376,310,66,310,254,56,2019-01-01,zipcode,Meadow
ZCTA5 79346,48,2225,38478,547,33600,1686,639,1456,519,415,431,73,18,1091,810,281,810,625,185,2019-01-01,zipcode,Morton
ZCTA5 79347,48,7202,52545,597,74400,5454,2031,4369,979,1530,1078,594,188,2580,2125,455,2125,1585,540,2019-01-01,zipcode,Muleshoe
ZCTA5 79350,48,401,58750,746,74500,291,91,231,47,94,86,2,2,164,134,30,134,101,33,2019-01-01,zipcode,New deal
ZCTA5 79351,48,1414,57500,779,69300,1103,449,952,232,269,303,110,38,702,542,160,542,370,172,2019-01-01,zipcode,Odonnell
ZCTA5 79353,48,10,-666666666,-666666666,-666666666,10,6,10,2,2,4,2,0,6,6,0,6,4,2,2019-01-01,zipcode,Pep
ZCTA5 79355,48,1877,60556,727,69800,1355,489,1111,401,215,331,133,31,738,620,118,620,468,152,2019-01-01,zipcode,Plains
ZCTA5 79356,48,5893,48975,773,79600,5153,3230,4396,1736,1225,849,435,151,1691,1498,193,1498,1057,441,2019-01-01,zipcode,Post
ZCTA5 79357,48,2123,44097,615,56700,1608,644,1386,328,471,436,105,46,1029,755,274,755,574,181,2019-01-01,zipcode,Ralls
ZCTA5 79358,48,1109,54167,793,120700,852,343,749,203,151,220,126,49,465,410,55,410,317,93,2019-01-01,zipcode,Ropesville
ZCTA5 79359,48,3025,47043,632,52800,1997,824,1637,577,615,353,62,30,1018,807,211,807,575,232,2019-01-01,zipcode,Seagraves
ZCTA5 79360,48,16666,62894,735,159600,11324,4209,9120,3578,2618,1787,841,296,5178,4689,489,4689,3674,1015,2019-01-01,zipcode,Seminole
ZCTA5 79363,48,5678,62857,840,169700,4191,1437,3650,508,1103,1058,577,404,2178,1988,190,1988,1502,486,2019-01-01,zipcode,Shallowater
ZCTA5 79364,48,7630,47413,684,83100,5822,2259,5081,755,1674,1782,635,235,3443,3005,438,3005,2042,963,2019-01-01,zipcode,Slaton
ZCTA5 79366,48,1056,105000,1222,252700,891,319,809,26,143,210,257,173,478,432,46,432,408,24,2019-01-01,zipcode,Ransom canyon
ZCTA5 79367,48,777,43750,931,73600,590,174,441,75,136,146,63,21,270,252,18,252,168,84,2019-01-01,zipcode,Smyer
ZCTA5 79369,48,93,-666666666,-666666666,36800,83,43,83,0,45,22,0,16,40,40,0,40,40,0,2019-01-01,zipcode,Spade
ZCTA5 79370,48,1594,39907,514,51900,1339,681,1198,195,438,351,128,86,1154,626,528,626,483,143,2019-01-01,zipcode,Spur
ZCTA5 79371,48,1399,51667,642,61300,1108,326,941,250,277,256,118,40,697,548,149,548,426,122,2019-01-01,zipcode,Sudan
ZCTA5 79372,48,1229,50714,569,86100,941,346,802,201,219,255,77,50,526,440,86,440,319,121,2019-01-01,zipcode,Sundown
ZCTA5 79373,48,2924,35385,608,76600,2143,966,1858,462,581,487,251,77,1380,1096,284,1096,709,387,2019-01-01,zipcode,Tahoka
ZCTA5 79376,48,14,-666666666,-666666666,-666666666,14,14,14,0,0,0,14,0,27,14,13,14,14,0,2019-01-01,zipcode,Tokio
ZCTA5 79377,48,269,58438,-666666666,84000,183,83,161,64,39,37,20,1,134,85,49,85,58,27,2019-01-01,zipcode,Welch
ZCTA5 79378,48,196,67500,-666666666,40700,146,55,140,23,65,42,9,1,100,68,32,68,61,7,2019-01-01,zipcode,Wellman
ZCTA5 79379,48,622,52500,500,69500,491,230,401,86,148,108,35,24,212,170,42,170,146,24,2019-01-01,zipcode,Whiteface
ZCTA5 79380,48,80,38750,-666666666,75000,67,28,61,15,17,15,11,3,53,34,19,34,26,8,2019-01-01,zipcode,Whitharral
ZCTA5 79381,48,1548,51477,717,128300,1178,451,993,226,268,308,153,38,603,519,84,519,393,126,2019-01-01,zipcode,Wilson
ZCTA5 79382,48,8149,74413,952,177000,5682,1517,4860,460,1073,1882,938,507,3010,2778,232,2778,2123,655,2019-01-01,zipcode,Wolfforth
ZCTA5 79401,48,7912,19900,989,78600,7343,3122,2487,466,563,869,237,352,4398,3302,1096,3302,375,2927,2019-01-01,zipcode,Lubbock
ZCTA5 79403,48,17926,40911,816,58800,13138,5825,10851,2716,4595,2742,584,214,6590,5713,877,5713,3264,2449,2019-01-01,zipcode,Lubbock
ZCTA5 79404,48,10094,35106,717,56400,7931,3729,6757,1918,2725,1557,371,186,4087,3284,803,3284,1899,1385,2019-01-01,zipcode,Lubbock
ZCTA5 79406,48,7017,-666666666,-666666666,-666666666,7017,4733,38,0,0,8,30,0,0,0,0,0,0,0,2019-01-01,zipcode,Lubbock
ZCTA5 79407,48,22807,45542,873,114200,18140,5405,13390,1488,3906,4072,2331,1593,10517,9475,1042,9475,4237,5238,2019-01-01,zipcode,Lubbock
ZCTA5 79410,48,10166,40465,1156,151100,8730,3540,5239,737,982,1537,937,1046,4432,3929,503,3929,1429,2500,2019-01-01,zipcode,Lubbock
ZCTA5 79411,48,7012,38466,901,69500,5986,2079,4084,1032,970,1102,732,248,3676,3015,661,3015,1109,1906,2019-01-01,zipcode,Lubbock
ZCTA5 79412,48,16554,34948,815,81800,11932,4309,9252,2732,2939,2487,775,319,6360,5640,720,5640,2795,2845,2019-01-01,zipcode,Lubbock
ZCTA5 79413,48,21821,53079,1069,143100,16975,5452,13594,1440,3034,4264,3201,1655,9481,8461,1020,8461,5135,3326,2019-01-01,zipcode,Lubbock
ZCTA5 79414,48,18731,47585,892,106700,14809,4337,11292,1643,2721,3777,1695,1456,8335,7702,633,7702,3026,4676,2019-01-01,zipcode,Lubbock
ZCTA5 79415,48,17939,31680,859,63500,14317,5536,10069,2531,3185,2580,996,777,7295,6579,716,6579,2606,3973,2019-01-01,zipcode,Lubbock
ZCTA5 79416,48,34124,56028,1134,137000,27412,9149,19756,1828,4742,6576,3963,2647,14849,12939,1910,12939,6380,6559,2019-01-01,zipcode,Lubbock
ZCTA5 79423,48,40303,69818,1043,160500,30199,9143,25712,2384,5858,7998,6339,3133,16140,15129,1011,15129,10386,4743,2019-01-01,zipcode,Lubbock
ZCTA5 79424,48,46933,84450,981,207100,36381,10736,31026,1660,5261,9898,8993,5214,20305,18856,1449,18856,13047,5809,2019-01-01,zipcode,Lubbock
ZCTA5 79501,48,2659,48412,729,77900,2094,947,1765,297,549,624,229,66,1548,1081,467,1081,768,313,2019-01-01,zipcode,Anson
ZCTA5 79502,48,1305,47955,531,55800,990,429,872,180,304,269,69,50,826,520,306,520,384,136,2019-01-01,zipcode,Aspermont
ZCTA5 79503,48,85,68056,-666666666,87500,85,48,85,10,18,27,10,20,100,58,42,58,37,21,2019-01-01,zipcode,Avoca
ZCTA5 79504,48,3366,60408,584,79300,2862,1179,2436,313,733,796,451,143,1452,1207,245,1207,973,234,2019-01-01,zipcode,Baird
ZCTA5 79505,48,244,39375,-666666666,42800,185,97,159,23,61,41,31,3,151,81,70,81,58,23,2019-01-01,zipcode,Benjamin
ZCTA5 79506,48,626,41429,505,66700,542,297,526,68,152,181,103,22,762,358,404,358,306,52,2019-01-01,zipcode,Blackwell
ZCTA5 79508,48,1470,66556,792,163800,1073,381,973,65,491,223,162,32,577,511,66,511,390,121,2019-01-01,zipcode,Buffalo gap
ZCTA5 79510,48,7573,50409,853,103600,6043,2617,5286,578,2050,1587,800,271,3787,2896,891,2896,2365,531,2019-01-01,zipcode,Clyde
ZCTA5 79511,48,1183,55278,754,101600,913,343,816,131,248,293,101,43,618,486,132,486,419,67,2019-01-01,zipcode,Coahoma
ZCTA5 79512,48,7456,49583,670,70200,6331,3893,4885,1005,1996,1331,418,135,3549,2011,1538,2011,1547,464,2019-01-01,zipcode,Colorado city
ZCTA5 79517,48,164,71875,-666666666,122100,140,51,140,5,23,78,34,0,77,77,0,77,62,15,2019-01-01,zipcode,Fluvanna
ZCTA5 79518,48,48,128750,-666666666,-666666666,33,13,33,1,14,5,0,13,66,19,47,19,19,0,2019-01-01,zipcode,Girard
ZCTA5 79519,48,41,57750,-666666666,167500,41,18,41,0,16,11,10,4,58,29,29,29,29,0,2019-01-01,zipcode,Goldsboro
ZCTA5 79520,48,2121,50602,707,51300,1544,808,1232,255,454,388,103,32,1224,915,309,915,717,198,2019-01-01,zipcode,Hamlin
ZCTA5 79521,48,3611,44006,488,62900,3066,1499,2489,769,864,603,192,61,2164,1267,897,1267,942,325,2019-01-01,zipcode,Haskell
ZCTA5 79525,48,2498,53375,854,119900,1953,871,1717,206,462,666,335,48,1225,1143,82,1143,913,230,2019-01-01,zipcode,Hawley
ZCTA5 79526,48,837,51023,829,81000,689,356,628,83,270,157,84,34,490,372,118,372,309,63,2019-01-01,zipcode,Hermleigh
ZCTA5 79527,48,263,65625,498,59200,185,73,164,26,57,43,35,3,217,97,120,97,76,21,2019-01-01,zipcode,Ira
ZCTA5 79528,48,587,35500,475,30900,458,221,427,66,151,110,51,49,357,246,111,246,166,80,2019-01-01,zipcode,Jayton
ZCTA5 79529,48,1480,45000,600,40300,1113,534,941,158,294,282,109,98,700,532,168,532,426,106,2019-01-01,zipcode,Knox city
ZCTA5 79530,48,538,59783,-666666666,53600,454,124,424,70,192,78,75,9,270,214,56,214,179,35,2019-01-01,zipcode,Lawn
ZCTA5 79532,48,826,64167,821,57300,601,199,531,161,170,135,42,23,419,292,127,292,252,40,2019-01-01,zipcode,Loraine
ZCTA5 79533,48,385,51500,379,31100,337,144,297,56,74,97,62,8,247,172,75,172,127,45,2019-01-01,zipcode,Lueders
ZCTA5 79534,48,125,-666666666,-666666666,110200,120,56,116,11,10,38,27,30,109,71,38,71,66,5,2019-01-01,zipcode,Mc caulley
ZCTA5 79535,48,179,65000,-666666666,55800,165,115,148,10,51,74,11,2,110,88,22,88,83,5,2019-01-01,zipcode,Maryneal
ZCTA5 79536,48,5258,53388,738,78100,3987,1695,3636,342,1539,1225,438,92,2289,1970,319,1970,1639,331,2019-01-01,zipcode,Merkel
ZCTA5 79537,48,35,-666666666,-666666666,31700,35,30,35,0,30,0,5,0,50,22,28,22,22,0,2019-01-01,zipcode,Nolan
ZCTA5 79538,48,325,64500,-666666666,110500,265,122,224,31,65,61,55,12,169,108,61,108,105,3,2019-01-01,zipcode,Novice
ZCTA5 79539,48,223,68542,631,-666666666,202,95,148,35,28,32,41,12,131,95,36,95,77,18,2019-01-01,zipcode,O brien
ZCTA5 79540,48,121,92917,-666666666,-666666666,90,13,83,5,25,48,5,0,59,42,17,42,42,0,2019-01-01,zipcode,Old glory
ZCTA5 79541,48,973,-666666666,-666666666,-666666666,742,271,563,0,159,127,21,256,383,314,69,314,253,61,2019-01-01,zipcode,Ovalo
ZCTA5 79543,48,1298,49861,622,71100,960,432,809,102,289,288,110,20,605,457,148,457,377,80,2019-01-01,zipcode,Roby
ZCTA5 79544,48,676,32393,669,26100,552,276,470,170,146,121,27,6,353,247,106,247,176,71,2019-01-01,zipcode,Rochester
ZCTA5 79545,48,1774,57813,737,78600,1395,540,1144,172,345,346,200,81,859,656,203,656,545,111,2019-01-01,zipcode,Roscoe
ZCTA5 79546,48,1794,39773,532,62500,1419,559,1216,203,436,348,176,53,1143,796,347,796,510,286,2019-01-01,zipcode,Rotan
ZCTA5 79547,48,642,25417,658,32600,527,257,505,157,203,80,53,12,467,303,164,303,237,66,2019-01-01,zipcode,Rule
ZCTA5 79548,48,203,61250,-666666666,87000,165,70,157,30,62,29,32,4,147,84,63,84,71,13,2019-01-01,zipcode,Rule
ZCTA5 79549,48,15943,54272,760,86100,12313,5612,10318,2265,3484,2915,1086,568,6586,5458,1128,5458,4077,1381,2019-01-01,zipcode,Snyder
ZCTA5 79553,48,3270,43629,635,60300,2440,1303,2166,359,830,555,307,115,1797,1430,367,1430,969,461,2019-01-01,zipcode,Stamford
ZCTA5 79556,48,12833,44840,694,77300,9848,4011,8118,1514,2871,2607,824,302,5948,4571,1377,4571,2947,1624,2019-01-01,zipcode,Sweetwater
ZCTA5 79560,48,172,50735,921,90600,155,62,152,19,70,44,11,8,118,74,44,74,47,27,2019-01-01,zipcode,Sylvester
ZCTA5 79561,48,615,50750,636,61700,505,218,420,45,136,188,30,21,303,241,62,241,173,68,2019-01-01,zipcode,Trent
ZCTA5 79562,48,3371,84868,1043,170000,2648,917,2401,54,460,1054,585,248,1359,1256,103,1256,1130,126,2019-01-01,zipcode,Tuscola
ZCTA5 79563,48,1074,45446,847,68600,814,346,662,122,332,157,38,13,435,374,61,374,266,108,2019-01-01,zipcode,Tye
ZCTA5 79565,48,292,63977,-666666666,72500,216,99,182,23,82,55,22,0,137,91,46,91,87,4,2019-01-01,zipcode,Westbrook
ZCTA5 79566,48,247,38333,-666666666,218800,206,127,199,28,52,39,55,25,179,106,73,106,80,26,2019-01-01,zipcode,Wingate
ZCTA5 79567,48,3432,38806,616,56300,2594,1042,2137,608,714,487,238,90,1699,1291,408,1291,826,465,2019-01-01,zipcode,Winters
ZCTA5 79601,48,27507,39344,797,104300,24036,13753,17145,3225,6062,4829,1914,1115,9460,7519,1941,7519,3425,4094,2019-01-01,zipcode,Abilene
ZCTA5 79602,48,24876,68100,939,162600,18580,6549,15871,1612,4486,4946,2944,1883,9427,8349,1078,8349,6196,2153,2019-01-01,zipcode,Abilene
ZCTA5 79603,48,23454,41220,900,79300,17873,6500,14296,2731,5275,4240,1580,470,9728,8489,1239,8489,5019,3470,2019-01-01,zipcode,Abilene
ZCTA5 79605,48,29732,48091,907,109300,23378,7316,18554,1917,6499,6139,2612,1387,13172,11175,1997,11175,5987,5188,2019-01-01,zipcode,Abilene
ZCTA5 79606,48,25053,64465,987,188300,19475,6305,16094,834,3739,5971,3570,1980,11111,10223,888,10223,5598,4625,2019-01-01,zipcode,Abilene
ZCTA5 79607,48,3308,49948,1201,-666666666,2413,279,1043,13,166,669,142,53,773,687,86,687,0,687,2019-01-01,zipcode,Dyess afb
ZCTA5 79699,48,115,-666666666,-666666666,-666666666,115,61,0,0,0,0,0,0,55,0,55,0,0,0,2019-01-01,zipcode,Abilene
ZCTA5 79701,48,32219,57064,1037,126200,23190,7729,19273,5888,5426,4913,2426,620,11113,10006,1107,10006,6635,3371,2019-01-01,zipcode,Midland
ZCTA5 79703,48,23834,71382,1451,163100,17994,4775,14407,2583,4450,5294,1580,500,8375,7887,488,7887,5404,2483,2019-01-01,zipcode,Midland
ZCTA5 79705,48,41933,85259,1306,248900,31963,8902,27288,3432,5969,8365,6842,2680,16004,14807,1197,14807,10086,4721,2019-01-01,zipcode,Midland
ZCTA5 79706,48,25657,85772,1293,189900,17336,5348,15012,2562,4500,5011,2237,702,8233,7594,639,7594,5929,1665,2019-01-01,zipcode,Midland
ZCTA5 79707,48,39921,98015,1264,297600,30357,8353,25950,1652,5881,8321,6716,3380,15205,14497,708,14497,8900,5597,2019-01-01,zipcode,Midland
ZCTA5 79713,48,493,60577,525,151600,373,162,302,51,94,76,47,34,208,184,24,184,142,42,2019-01-01,zipcode,Ackerly
ZCTA5 79714,48,18036,76158,1028,143900,13071,4587,10700,2969,3739,2686,814,492,6296,5573,723,5573,4130,1443,2019-01-01,zipcode,Andrews
ZCTA5 79718,48,1169,43977,733,52300,996,251,696,131,186,198,162,19,481,340,141,340,248,92,2019-01-01,zipcode,Balmorhea
ZCTA5 79719,48,589,42708,820,44100,422,193,330,120,110,86,9,5,249,189,60,189,145,44,2019-01-01,zipcode,Barstow
ZCTA5 79720,48,35025,54479,873,99800,28181,13376,23776,4740,8055,7995,2027,959,12577,10537,2040,10537,6782,3755,2019-01-01,zipcode,Big spring
ZCTA5 79730,48,157,61131,-666666666,24200,138,52,126,66,49,8,1,2,126,71,55,71,59,12,2019-01-01,zipcode,Coyanosa
ZCTA5 79731,48,4772,66156,835,101700,3478,1304,2889,595,926,929,330,109,1655,1415,240,1415,1199,216,2019-01-01,zipcode,Crane
ZCTA5 79733,48,169,70000,408,72500,120,29,114,16,21,36,29,12,68,68,0,68,46,22,2019-01-01,zipcode,Forsan
ZCTA5 79734,48,2145,53401,704,112600,1803,1057,1623,338,333,453,170,329,1763,1005,758,1005,843,162,2019-01-01,zipcode,Fort davis
ZCTA5 79735,48,13915,48313,850,90200,10729,5525,9279,3038,3362,2073,464,342,4813,3965,848,3965,2847,1118,2019-01-01,zipcode,Fort stockton
ZCTA5 79738,48,234,56364,-666666666,162500,175,91,146,6,35,50,34,21,124,78,46,78,55,23,2019-01-01,zipcode,Gail
ZCTA5 79739,48,1322,76711,-666666666,251600,1070,441,800,267,147,189,108,89,428,338,90,338,227,111,2019-01-01,zipcode,Garden city
ZCTA5 79741,48,222,39464,1172,70000,171,102,169,20,59,61,24,5,132,113,19,113,98,15,2019-01-01,zipcode,Goldsmith
ZCTA5 79742,48,526,49063,559,-666666666,380,138,332,102,120,57,34,19,230,179,51,179,144,35,2019-01-01,zipcode,Grandfalls
ZCTA5 79743,48,328,73500,438,-666666666,270,98,223,22,75,70,36,20,174,106,68,106,56,50,2019-01-01,zipcode,Imperial
ZCTA5 79744,48,1255,69167,771,105300,1021,294,795,124,232,285,126,28,549,454,95,454,346,108,2019-01-01,zipcode,Iraan
ZCTA5 79745,48,6984,60063,858,62600,5206,2102,4102,1362,1231,1224,205,80,2713,2339,374,2339,1861,478,2019-01-01,zipcode,Kermit
ZCTA5 79748,48,298,48438,-666666666,-666666666,206,91,153,72,49,11,18,3,109,81,28,81,67,14,2019-01-01,zipcode,Knott
ZCTA5 79749,48,366,76250,500,197900,242,97,193,36,34,55,44,24,119,100,19,100,67,33,2019-01-01,zipcode,Lenorah
ZCTA5 79752,48,2467,47500,838,65000,1875,917,1555,399,654,376,61,65,1124,870,254,870,647,223,2019-01-01,zipcode,Mc camey
ZCTA5 79754,48,98,83750,-666666666,-666666666,73,40,71,14,14,43,0,0,66,30,36,30,19,11,2019-01-01,zipcode,Mentone
ZCTA5 79755,48,124,48125,750,263200,111,46,111,33,17,46,15,0,71,61,10,61,25,36,2019-01-01,zipcode,Midkiff
ZCTA5 79756,48,9565,66667,956,91500,7286,2907,6085,1254,2109,1941,565,216,3914,3276,638,3276,2315,961,2019-01-01,zipcode,Monahans
ZCTA5 79758,48,2403,97222,1132,276300,1611,434,1409,97,492,721,99,0,906,838,68,838,639,199,2019-01-01,zipcode,Gardendale
ZCTA5 79759,48,0,-666666666,-666666666,-666666666,0,0,0,0,0,0,0,0,0,0,0,0,0,0,2019-01-01,zipcode,Notrees
ZCTA5 79761,48,33602,55296,990,122100,24881,7874,20010,5295,6045,5778,2117,775,13091,11428,1663,11428,6900,4528,2019-01-01,zipcode,Odessa
ZCTA5 79762,48,43812,66584,1119,167900,33204,9071,26977,3563,8192,9495,3836,1891,17553,15737,1816,15737,8925,6812,2019-01-01,zipcode,Odessa
ZCTA5 79763,48,38833,54224,983,105500,27294,9916,22461,7540,6758,6143,1617,403,13025,11632,1393,11632,7484,4148,2019-01-01,zipcode,Odessa
ZCTA5 79764,48,22172,58257,1028,102300,16151,5216,12942,3854,4371,3524,811,382,7617,7014,603,7014,5180,1834,2019-01-01,zipcode,Odessa
ZCTA5 79765,48,16486,99428,1569,238100,12264,3426,10557,939,2499,3546,2364,1209,6359,5959,400,5959,4526,1433,2019-01-01,zipcode,Odessa
ZCTA5 79766,48,7694,53300,1001,98200,5158,2342,4128,1806,1301,765,256,0,2119,2034,85,2034,1544,490,2019-01-01,zipcode,Odessa
ZCTA5 79770,48,0,-666666666,-666666666,-666666666,0,0,0,0,0,0,0,0,39,0,39,0,0,0,2019-01-01,zipcode,Orla
ZCTA5 79772,48,14029,55507,877,66800,11238,5651,9579,2960,3193,2336,733,357,3892,3058,834,3058,2218,840,2019-01-01,zipcode,Pecos
ZCTA5 79777,48,293,54360,-666666666,-666666666,170,74,147,14,62,21,50,0,158,94,64,94,34,60,2019-01-01,zipcode,Pyote
ZCTA5 79778,48,1056,71979,561,77500,844,373,752,162,330,179,63,18,475,389,86,389,301,88,2019-01-01,zipcode,Rankin
ZCTA5 79780,48,173,-666666666,-666666666,-666666666,129,46,114,59,40,15,0,0,143,85,58,85,48,37,2019-01-01,zipcode,Saragosa
ZCTA5 79781,48,263,53750,-666666666,-666666666,198,55,169,7,70,55,4,33,142,92,50,92,76,16,2019-01-01,zipcode,Sheffield
ZCTA5 79782,48,4497,62454,844,142900,3270,1171,2676,642,867,693,245,229,1585,1347,238,1347,989,358,2019-01-01,zipcode,Stanton
ZCTA5 79783,48,321,137596,-666666666,212500,239,80,219,23,97,69,21,9,101,87,14,87,78,9,2019-01-01,zipcode,Tarzan
ZCTA5 79785,48,121,-666666666,-666666666,-666666666,121,40,111,27,14,50,20,0,86,35,51,35,35,0,2019-01-01,zipcode,Toyah
ZCTA5 79788,48,685,61023,733,63800,503,189,475,85,270,100,17,3,279,240,39,240,208,32,2019-01-01,zipcode,Wickett
ZCTA5 79789,48,824,70833,731,56400,550,204,451,59,165,169,41,17,305,254,51,254,198,56,2019-01-01,zipcode,Wink
ZCTA5 79821,48,7136,37083,833,102000,5466,2765,4571,1011,1332,1644,409,175,2055,1855,200,1855,1401,454,2019-01-01,zipcode,Anthony
ZCTA5 79830,48,7860,47471,723,167900,6414,2332,5654,815,1171,1344,1544,780,4439,3398,1041,3398,1906,1492,2019-01-01,zipcode,Alpine
ZCTA5 79831,48,4,-666666666,-666666666,-666666666,4,0,4,0,0,0,4,0,9,4,5,4,4,0,2019-01-01,zipcode,
ZCTA5 79834,48,233,51250,599,-666666666,196,36,189,19,18,57,73,22,140,106,34,106,4,102,2019-01-01,zipcode,Big bend national park
ZCTA5 79835,48,11184,32388,800,80400,8128,3674,6525,2378,1905,1336,593,313,3773,3315,458,3315,2190,1125,2019-01-01,zipcode,Canutillo
ZCTA5 79836,48,5891,39440,716,85200,4233,1729,3382,964,907,927,398,186,1870,1723,147,1723,1320,403,2019-01-01,zipcode,Clint
ZCTA5 79837,48,322,23529,-666666666,28500,267,126,267,102,45,66,48,6,334,182,152,182,94,88,2019-01-01,zipcode,Dell city
ZCTA5 79838,48,6171,29779,538,61500,4636,2310,3825,1905,1058,735,109,18,2168,1905,263,1905,1320,585,2019-01-01,zipcode,Fabens
ZCTA5 79839,48,2141,30704,653,48500,1519,857,1157,657,383,85,32,0,678,442,236,442,353,89,2019-01-01,zipcode,Fort hancock
ZCTA5 79842,48,425,45769,-666666666,100300,378,193,345,55,66,76,104,44,401,210,191,210,151,59,2019-01-01,zipcode,Marathon
ZCTA5 79843,48,2456,41163,639,172900,1933,513,1600,408,246,417,256,273,1521,954,567,954,657,297,2019-01-01,zipcode,Marfa
ZCTA5 79845,48,4384,20244,406,58100,3319,2012,2773,1623,441,304,385,20,2439,1556,883,1556,814,742,2019-01-01,zipcode,Presidio
ZCTA5 79846,48,121,-666666666,-666666666,-666666666,45,31,24,24,0,0,0,0,84,19,65,19,0,19,2019-01-01,zipcode,Redford
ZCTA5 79847,48,153,53393,2172,16600,82,27,82,0,38,28,16,0,106,61,45,61,23,38,2019-01-01,zipcode,Salt flat
ZCTA5 79848,48,823,42689,-666666666,74700,721,405,698,94,199,303,65,37,743,382,361,382,368,14,2019-01-01,zipcode,Sanderson
ZCTA5 79849,48,12157,35607,728,79900,8799,3814,6947,2891,1897,1382,751,26,3896,3363,533,3363,2316,1047,2019-01-01,zipcode,San elizario
ZCTA5 79851,48,1576,39890,591,57200,1347,1094,1187,536,355,178,116,2,338,217,121,217,116,101,2019-01-01,zipcode,Sierra blanca
ZCTA5 79852,48,709,34500,381,78600,649,386,618,88,198,181,96,55,532,370,162,370,298,72,2019-01-01,zipcode,Terlingua
ZCTA5 79853,48,2621,39635,531,73700,1858,864,1423,705,367,239,94,18,815,717,98,717,608,109,2019-01-01,zipcode,Tornillo
ZCTA5 79854,48,90,-666666666,-666666666,-666666666,79,34,79,21,23,26,4,5,131,48,83,48,12,36,2019-01-01,zipcode,Valentine
ZCTA5 79855,48,2108,35813,444,61900,1630,549,1380,480,470,292,112,26,964,557,407,557,383,174,2019-01-01,zipcode,Van horn
ZCTA5 79901,48,9590,13574,432,56800,7840,4749,6647,3817,1420,1139,230,41,4672,3669,1003,3669,367,3302,2019-01-01,zipcode,El paso
ZCTA5 79902,48,20496,34791,650,174200,17346,7197,14331,2866,2560,4027,2659,2219,9275,8067,1208,8067,3216,4851,2019-01-01,zipcode,El paso
ZCTA5 79903,48,15995,33778,647,94000,13405,5713,11363,3093,2725,3499,1582,464,6858,5884,974,5884,3583,2301,2019-01-01,zipcode,El paso
ZCTA5 79904,48,33428,35951,818,100300,23376,9816,18859,4404,5061,6380,2081,933,12403,10958,1445,10958,4523,6435,2019-01-01,zipcode,El paso
ZCTA5 79905,48,21599,23394,495,81800,16982,8166,14513,6369,3837,3369,676,262,8589,7565,1024,7565,3757,3808,2019-01-01,zipcode,El paso
ZCTA5 79906,48,5295,53645,1379,-666666666,3299,905,2142,11,336,994,547,254,1555,1293,262,1293,0,1293,2019-01-01,zipcode,El paso
ZCTA5 79907,48,53174,31784,737,90100,41288,18314,32732,10985,10138,8190,2735,684,17817,16518,1299,16518,9446,7072,2019-01-01,zipcode,El paso
ZCTA5 79908,48,6422,62982,1534,-666666666,4271,729,2528,54,543,1155,553,223,1032,988,44,988,0,988,2019-01-01,zipcode,El paso
ZCTA5 79911,48,5794,104797,1678,234900,4170,1008,3678,85,223,904,1224,1242,2106,2004,102,2004,1565,439,2019-01-01,zipcode,El paso
ZCTA5 79912,48,78267,60503,920,188800,60804,20781,50463,4886,8066,12850,14638,10023,32370,28490,3880,28490,15284,13206,2019-01-01,zipcode,El paso
ZCTA5 79915,48,36412,31688,632,90000,28826,13371,24291,8246,7170,6311,2056,508,13548,12465,1083,12465,7214,5251,2019-01-01,zipcode,El paso
ZCTA5 79916,48,2979,-666666666,-666666666,-666666666,2979,134,990,0,174,452,218,146,0,0,0,0,0,0,2019-01-01,zipcode,Fort bliss
ZCTA5 79920,48,8,-666666666,-666666666,-666666666,8,0,0,0,0,0,0,0,0,0,0,0,0,0,2019-01-01,zipcode,
ZCTA5 79922,48,7932,78424,801,262800,6366,2231,5312,572,918,1303,1609,910,2914,2520,394,2520,2125,395,2019-01-01,zipcode,El paso
ZCTA5 79924,48,59648,43397,849,99900,45391,18983,36857,7407,10195,13518,4143,1594,21887,20077,1810,20077,12540,7537,2019-01-01,zipcode,El paso
ZCTA5 79925,48,39616,47596,838,140800,30961,11309,25318,3563,5635,9615,4071,2434,16181,14668,1513,14668,7363,7305,2019-01-01,zipcode,El paso
ZCTA5 79927,48,40747,36895,774,89400,30683,12718,24561,9182,7217,6286,1491,385,11864,11256,608,11256,8516,2740,2019-01-01,zipcode,El paso
ZCTA5 79928,48,57219,55367,948,120200,40199,13353,31671,6599,8524,10254,4722,1572,16730,15529,1201,15529,12853,2676,2019-01-01,zipcode,El paso
ZCTA5 79930,48,28277,37122,799,96900,22349,8613,17908,5305,3895,5326,2380,1002,12056,10214,1842,10214,5038,5176,2019-01-01,zipcode,El paso
ZCTA5 79932,48,28243,67753,863,170000,21232,7369,17363,2308,3309,5554,3831,2361,9772,8899,873,8899,6390,2509,2019-01-01,zipcode,El paso
ZCTA5 79934,48,26445,71225,1148,141900,19473,5651,15620,1105,3304,5533,3513,2165,10385,9206,1179,9206,5895,3311,2019-01-01,zipcode,El paso
ZCTA5 79935,48,17850,55054,828,152900,14553,5597,12092,1914,2705,4055,2606,812,6706,6216,490,6216,3573,2643,2019-01-01,zipcode,El paso
ZCTA5 79936,48,111620,54870,991,130000,86398,29567,68570,9702,16696,25769,11828,4575,37267,35437,1830,35437,23534,11903,2019-01-01,zipcode,El paso
ZCTA5 79938,48,84237,58902,1086,147700,57601,18404,46538,7652,9101,17913,8840,3032,25710,23642,2068,23642,18197,5445,2019-01-01,zipcode,El paso
ZCTA5 79942,48,30,-666666666,-666666666,-666666666,30,0,30,0,15,0,15,0,15,15,0,15,15,0,2019-01-01,zipcode,El paso
ZCTA5 77538,48,808,57375,-666666666,157400,635,293,567,111,220,161,51,24,354,282,72,282,257,25,2020-01-01,zipcode,Devers
ZCTA5 77546,48,53148,105406,1429,265000,40528,12159,34308,1771,5900,11006,9844,5787,19071,17987,1084,17987,13584,4403,2020-01-01,zipcode,Friendswood
ZCTA5 77563,48,11129,69699,954,164900,8924,3434,7878,945,2173,3237,1096,427,5143,4430,713,4430,3232,1198,2020-01-01,zipcode,Hitchcock
ZCTA5 77581,48,50737,95273,1224,244800,38303,11721,32257,1812,7070,10709,7877,4789,18125,16912,1213,16912,13439,3473,2020-01-01,zipcode,Pearland
ZCTA5 77583,48,41305,89406,1228,207400,32047,14379,27306,5131,8473,7000,3863,2839,11742,10563,1179,10563,9217,1346,2020-01-01,zipcode,Rosharon
ZCTA5 77587,48,17162,45354,1013,109100,12369,4037,9614,3865,3286,1831,551,81,5565,5048,517,5048,2602,2446,2020-01-01,zipcode,South houston
ZCTA5 77616,48,157,46620,-666666666,200000,145,65,102,0,37,47,18,0,269,93,176,93,74,19,2020-01-01,zipcode,Fred
ZCTA5 77624,48,793,66500,-666666666,-666666666,713,343,686,23,354,218,77,14,407,312,95,312,279,33,2020-01-01,zipcode,Hillister
ZCTA5 77640,48,16549,41317,938,65700,12846,6457,11060,2042,4152,3639,743,484,8898,6692,2206,6692,4264,2428,2020-01-01,zipcode,Port arthur
ZCTA5 77662,48,27587,60654,748,95800,21763,9110,18306,2775,7191,6298,1510,532,12339,10343,1996,10343,8092,2251,2020-01-01,zipcode,Vidor
ZCTA5 77665,48,5857,59875,591,145800,4588,1592,3859,526,1311,1329,502,191,2388,1931,457,1931,1525,406,2020-01-01,zipcode,Winnie
ZCTA5 77702,48,3334,66719,965,105100,2528,678,2137,207,647,736,266,281,1544,1360,184,1360,821,539,2020-01-01,zipcode,Beaumont
ZCTA5 77705,48,40224,42466,704,90500,34701,21896,28540,5498,10589,9796,1760,897,12639,10827,1812,10827,6222,4605,2020-01-01,zipcode,Beaumont
ZCTA5 77706,48,29707,62500,914,183800,24005,9411,20647,967,4058,6554,5690,3378,14430,13286,1144,13286,7677,5609,2020-01-01,zipcode,Beaumont
ZCTA5 77802,48,25257,56655,1005,181500,21028,7525,17856,1171,3888,4890,4668,3239,11972,11116,856,11116,5955,5161,2020-01-01,zipcode,Bryan
ZCTA5 77836,48,12516,62357,699,155600,9859,4288,8582,1514,3309,2059,1208,492,5890,4710,1180,4710,3660,1050,2020-01-01,zipcode,Caldwell
ZCTA5 77856,48,5492,61429,768,182900,4243,1863,3605,293,1384,1209,535,184,3060,1976,1084,1976,1523,453,2020-01-01,zipcode,Franklin
ZCTA5 77879,48,5357,60000,860,96000,4472,2147,3794,450,1328,1107,680,229,3156,2042,1114,2042,1629,413,2020-01-01,zipcode,Somerville
ZCTA5 77961,48,138,-666666666,-666666666,-666666666,138,62,138,39,35,64,0,0,103,103,0,103,62,41,2020-01-01,zipcode,Francitas
ZCTA5 77962,48,3309,60000,841,121400,2534,976,2222,535,751,667,204,65,1367,1094,273,1094,738,356,2020-01-01,zipcode,Ganado
ZCTA5 34773,12,3883,59205,1792,214500,2673,1346,2377,334,541,740,494,268,1518,1161,357,1161,961,200,2020-01-01,zipcode,Saint cloud
ZCTA5 34785,12,37555,60267,916,306800,35455,27514,34492,3232,10678,9421,6200,4961,18184,15192,2992,15192,13057,2135,2020-01-01,zipcode,Wildwood
ZCTA5 34987,12,10816,71547,1728,285300,8911,4685,8333,375,2135,2286,2156,1381,4995,4311,684,4311,3275,1036,2020-01-01,zipcode,Port saint lucie
ZCTA5 34996,12,11287,69248,1168,328300,10321,5903,9917,456,2134,3136,2098,2093,8969,5783,3186,5783,4815,968,2020-01-01,zipcode,Stuart
ZCTA5 34491,12,29998,48187,947,181200,24961,15573,23407,2323,9579,7195,2569,1741,14772,12738,2034,12738,11039,1699,2020-01-01,zipcode,Summerfield
ZCTA5 34695,12,18442,83020,1281,285300,15284,5875,13602,350,3608,3734,3985,1925,8096,7229,867,7229,6042,1187,2020-01-01,zipcode,Safety harbor
ZCTA5 34737,12,3016,75833,1398,286800,2592,1158,2324,168,670,756,428,302,1402,1200,202,1200,959,241,2020-01-01,zipcode,Howey in the hills
ZCTA5 34242,12,7643,111653,2011,729500,7119,4348,6747,233,588,1562,2418,1946,10696,3939,6757,3939,3429,510,2020-01-01,zipcode,Sarasota
ZCTA5 34266,12,31733,34770,741,90100,25994,12975,22349,6312,9915,3861,1442,819,12207,10112,2095,10112,6567,3545,2020-01-01,zipcode,Arcadia
ZCTA5 34287,12,27620,52793,1124,160100,23776,13817,21898,1752,7910,7782,2791,1663,15470,11295,4175,11295,8700,2595,2020-01-01,zipcode,North port
ZCTA5 34431,12,8116,40582,769,128700,6997,4257,6464,1101,2482,1970,551,360,4537,3713,824,3713,3126,587,2020-01-01,zipcode,Dunnellon
ZCTA5 34433,12,6998,56232,930,157200,5927,2842,5175,748,2139,1512,488,288,3594,2913,681,2913,2613,300,2020-01-01,zipcode,Dunnellon
ZCTA5 34434,12,8233,49769,1137,139900,6524,3318,6249,551,2763,2061,696,178,3924,3121,803,3121,2647,474,2020-01-01,zipcode,Dunnellon
ZCTA5 34446,12,17878,48271,892,143900,15754,11167,14702,1414,5431,5136,1744,977,9100,7861,1239,7861,7054,807,2020-01-01,zipcode,Homosassa
ZCTA5 34465,12,16652,47099,881,148400,14470,8956,13155,1257,4874,4657,1310,1057,8529,7555,974,7555,6158,1397,2020-01-01,zipcode,Beverly hills
ZCTA5 34481,12,21462,44052,978,132100,20272,15287,19246,1494,6472,5799,3361,2120,12455,11414,1041,11414,10099,1315,2020-01-01,zipcode,Ocala
ZCTA5 34484,12,3361,39050,3248,221500,2925,1715,2713,509,894,730,256,324,1978,1614,364,1614,886,728,2020-01-01,zipcode,Oxford
ZCTA5 34652,12,24549,42595,948,134400,21380,10635,19341,2436,7642,6044,2257,962,14808,10982,3826,10982,6687,4295,2020-01-01,zipcode,New port richey
ZCTA5 34669,12,14022,47226,1100,157300,11653,5877,10224,1107,4510,3219,992,396,6159,5439,720,5439,4448,991,2020-01-01,zipcode,Hudson
ZCTA5 34681,12,589,48472,-666666666,474000,442,235,440,28,49,100,237,26,407,298,109,298,298,0,2020-01-01,zipcode,Crystal beach
ZCTA5 34684,12,28058,56682,1439,196300,24780,11721,22531,1277,6193,7612,5032,2417,14579,13173,1406,13173,9332,3841,2020-01-01,zipcode,Palm harbor
ZCTA5 34691,12,20473,40537,1020,107200,16949,7738,15436,1326,7496,4361,1719,534,11949,8946,3003,8946,5642,3304,2020-01-01,zipcode,Holiday
ZCTA5 34114,12,17856,62694,1318,303200,15784,9324,14776,1518,4159,4072,3146,1881,13190,7829,5361,7829,6530,1299,2020-01-01,zipcode,Naples
ZCTA5 34141,12,110,-666666666,-666666666,-666666666,91,68,78,0,55,8,3,12,12,12,0,12,4,8,2020-01-01,zipcode,Ochopee
ZCTA5 34698,12,39317,51432,1108,218300,35258,16769,32772,2364,8943,10985,6348,4132,22099,18732,3367,18732,13120,5612,2020-01-01,zipcode,Dunedin
ZCTA5 34734,12,4529,79773,1422,322700,3080,1061,2657,138,611,789,804,315,1304,1304,0,1304,1061,243,2020-01-01,zipcode,Gotha
ZCTA5 34235,12,14269,58879,1439,241600,13147,6300,11631,529,2966,3939,2251,1946,8052,6502,1550,6502,4986,1516,2020-01-01,zipcode,Sarasota
ZCTA5 34448,12,10140,45119,823,101600,8857,5091,8431,1097,3484,2689,927,234,6221,4625,1596,4625,3684,941,2020-01-01,zipcode,Homosassa
ZCTA5 34202,12,23759,103226,1788,454200,19546,9371,17404,515,2842,4513,4922,4612,10904,8812,2092,8812,6827,1985,2020-01-01,zipcode,Bradenton
ZCTA5 34432,12,12793,43798,858,147000,11066,6822,10427,1132,3840,3273,1483,699,6498,5672,826,5672,4996,676,2020-01-01,zipcode,Dunnellon
ZCTA5 34450,12,11074,38600,793,136000,9881,6113,8753,793,2949,3161,1109,741,6583,5218,1365,5218,4004,1214,2020-01-01,zipcode,Inverness
ZCTA5 34461,12,12154,45598,874,197600,10915,7076,9741,1112,4053,2308,1279,989,5839,4542,1297,4542,3829,713,2020-01-01,zipcode,Lecanto
ZCTA5 34472,12,31271,49590,983,124700,24473,10301,20741,3127,7307,6686,2315,1306,12597,11106,1491,11106,8395,2711,2020-01-01,zipcode,Ocala
ZCTA5 34476,12,22857,52827,945,162300,19863,11873,18526,1232,6534,6138,2792,1830,11920,10605,1315,10605,9585,1020,2020-01-01,zipcode,Ocala
ZCTA5 34609,12,43374,57924,1173,182400,35259,16502,31206,3205,9207,12362,4226,2206,17613,16170,1443,16170,13100,3070,2020-01-01,zipcode,Spring hill
ZCTA5 34667,12,32360,43363,966,147500,28739,17143,26984,2970,10798,8267,3062,1887,20091,15736,4355,15736,11462,4274,2020-01-01,zipcode,Hudson
ZCTA5 34679,12,33,-666666666,-666666666,-666666666,33,33,33,0,33,0,0,0,41,22,19,22,10,12,2020-01-01,zipcode,Aripeka
ZCTA5 34689,12,27428,51753,918,225800,23611,11544,21400,1915,6339,6576,4004,2566,14012,11823,2189,11823,9037,2786,2020-01-01,zipcode,Tarpon springs
ZCTA5 34705,12,3010,54135,868,151900,2303,904,1915,379,724,554,209,49,1148,1000,148,1000,806,194,2020-01-01,zipcode,Astatula
ZCTA5 34739,12,551,82361,-666666666,96000,447,75,306,189,23,58,36,0,450,263,187,263,112,151,2020-01-01,zipcode,Kenansville
ZCTA5 34104,12,24106,54957,1367,262600,19545,9469,18116,2226,4710,5592,3318,2270,14984,10404,4580,10404,7143,3261,2020-01-01,zipcode,Naples
ZCTA5 34112,12,28702,60313,1145,234400,26023,14934,23886,2257,7389,6876,4296,3068,20179,12986,7193,12986,10343,2643,2020-01-01,zipcode,Naples
ZCTA5 34116,12,37138,55488,1310,266900,29066,8554,24708,6261,8348,6246,2527,1326,10447,9666,781,9666,5199,4467,2020-01-01,zipcode,Naples
ZCTA5 34142,12,33029,38082,790,203800,24399,9131,19067,9073,5252,2786,1301,655,8744,7532,1212,7532,3451,4081,2020-01-01,zipcode,Immokalee
ZCTA5 34210,12,16799,50621,1169,219600,14922,7620,12943,843,3983,3900,2774,1443,11179,7293,3886,7293,4449,2844,2020-01-01,zipcode,Bradenton
ZCTA5 34215,12,633,27444,-666666666,817300,619,481,574,0,80,217,164,113,525,299,226,299,287,12,2020-01-01,zipcode,Cortez
ZCTA5 34216,12,1092,80865,-666666666,911300,1032,701,1015,43,150,274,360,188,1679,607,1072,607,572,35,2020-01-01,zipcode,Anna maria
ZCTA5 34223,12,18500,55797,1074,254100,17343,12216,16856,596,5620,4951,3460,2229,14012,9666,4346,9666,8096,1570,2020-01-01,zipcode,Englewood
ZCTA5 34239,12,15178,59010,1388,300400,13210,5321,12236,1018,2621,3629,3115,1853,8318,6978,1340,6978,5086,1892,2020-01-01,zipcode,Sarasota
ZCTA5 75503,48,26843,74391,928,179700,20942,8487,17903,866,3940,6459,4123,2515,11151,9979,1172,9979,6570,3409,2020-01-01,zipcode,Texarkana
ZCTA5 75555,48,1477,43163,641,76200,1277,726,1165,160,597,319,62,27,929,696,233,696,617,79,2020-01-01,zipcode,Bivins
ZCTA5 75568,48,2350,40871,785,93300,1724,779,1581,217,764,423,142,35,1266,1019,247,1019,701,318,2020-01-01,zipcode,Naples
ZCTA5 75975,48,4052,50188,663,129400,3170,1289,2627,326,811,1217,202,71,2013,1454,559,1454,1055,399,2020-01-01,zipcode,Timpson
ZCTA5 78728,48,21857,62223,1215,280500,17730,3802,15846,549,3368,4111,5818,2000,11241,10429,812,10429,3062,7367,2020-01-01,zipcode,Austin
ZCTA5 78736,48,10010,97184,1481,368000,8312,2870,7287,182,1172,2223,2628,1082,3798,3677,121,3677,2665,1012,2020-01-01,zipcode,Austin
ZCTA5 78750,48,33860,100489,1546,409800,26624,7067,24170,1300,2447,5967,8776,5680,12948,12383,565,12383,7193,5190,2020-01-01,zipcode,Austin
ZCTA5 78753,48,60035,53797,1140,218100,46272,12483,40097,9119,10316,9785,7662,3215,22991,21602,1389,21602,7644,13958,2020-01-01,zipcode,Austin
ZCTA5 78827,48,1030,25612,521,74800,814,379,738,198,230,204,53,53,571,407,164,407,299,108,2020-01-01,zipcode,Asherton
ZCTA5 78832,48,3674,39972,672,82000,3212,1876,2883,548,803,991,372,169,2010,1475,535,1475,1110,365,2020-01-01,zipcode,Brackettville
ZCTA5 78839,48,8790,41275,578,63200,7048,2998,5608,1176,2034,1616,453,329,3353,2951,402,2951,2233,718,2020-01-01,zipcode,Crystal city
ZCTA5 78861,48,14318,55155,809,130800,11818,6286,9951,1481,3300,3608,855,707,5042,4402,640,4402,3341,1061,2020-01-01,zipcode,Hondo
ZCTA5 78938,48,314,55750,757,163900,233,82,172,9,72,50,21,20,206,111,95,111,87,24,2020-01-01,zipcode,Ellinger
ZCTA5 78943,48,269,-666666666,-666666666,-666666666,231,70,231,53,53,105,20,0,181,88,93,88,88,0,2020-01-01,zipcode,Glidden
ZCTA5 78945,48,10388,55964,705,202700,8581,4047,7849,937,3036,2143,1255,478,5783,4133,1650,4133,3411,722,2020-01-01,zipcode,La grange
ZCTA5 78963,48,868,65365,-666666666,163000,608,229,569,44,330,125,53,17,326,241,85,241,236,5,2020-01-01,zipcode,West point
ZCTA5 78837,48,212,-666666666,-666666666,-666666666,192,94,185,76,25,22,21,41,207,95,112,95,87,8,2020-01-01,zipcode,Comstock
ZCTA5 78941,48,3046,62852,921,165100,2611,1178,2282,281,1133,546,253,69,1636,1050,586,1050,878,172,2020-01-01,zipcode,Flatonia
ZCTA5 78944,48,614,98750,-666666666,288700,581,273,559,32,122,196,186,23,316,262,54,262,255,7,2020-01-01,zipcode,Industry
ZCTA5 78950,48,1863,54792,-666666666,237100,1578,606,1398,107,625,336,245,85,1222,783,439,783,704,79,2020-01-01,zipcode,New ulm
ZCTA5 78248,48,13822,124311,1213,358600,11340,3710,9935,125,866,2937,3336,2671,5676,5427,249,5427,4092,1335,2020-01-01,zipcode,San antonio
ZCTA5 78207,48,57700,26915,699,65600,42964,21335,35794,15482,11309,6960,1447,596,17654,15573,2081,15573,7326,8247,2020-01-01,zipcode,San antonio
ZCTA5 78233,48,48060,60155,1156,149100,36724,12765,31361,3076,9975,11847,4398,2065,17457,16709,748,16709,10212,6497,2020-01-01,zipcode,San antonio
ZCTA5 78242,48,35159,41598,897,85800,25127,9526,19260,6485,6237,5100,1123,315,9964,9262,702,9262,5160,4102,2020-01-01,zipcode,San antonio
ZCTA5 78251,48,65885,66667,1153,184900,50448,13361,41054,3044,10344,15400,7979,4287,21666,20593,1073,20593,10810,9783,2020-01-01,zipcode,San antonio
ZCTA5 33573,12,25132,49368,1783,186700,23453,17565,22874,1085,7111,7460,4495,2723,15427,13440,1987,13440,10706,2734,2020-01-01,zipcode,Sun city center
ZCTA5 33602,12,15860,71894,1656,368100,13970,4403,12813,1106,2045,2710,3603,3349,10051,8599,1452,8599,3097,5502,2020-01-01,zipcode,Tampa
ZCTA5 33624,12,39750,71668,1321,255600,32506,9610,28744,1627,6994,8026,7913,4184,15730,15043,687,15043,9636,5407,2020-01-01,zipcode,Tampa
ZCTA5 33710,12,35695,61970,1231,208900,29977,10593,26952,1875,7841,8184,6429,2623,16478,14369,2109,14369,11316,3053,2020-01-01,zipcode,Saint petersburg
ZCTA5 33759,12,18303,53611,1428,188600,14814,6022,13325,1358,3621,4142,2688,1516,8844,7820,1024,7820,4218,3602,2020-01-01,zipcode,Clearwater
ZCTA5 33762,12,8542,67134,1408,245400,7901,4384,7180,876,2141,1983,1390,790,3100,2633,467,2633,2014,619,2020-01-01,zipcode,Clearwater
ZCTA5 33771,12,29868,47114,1112,83400,25707,11381,23402,2186,7712,8220,3993,1291,17118,13316,3802,13316,7768,5548,2020-01-01,zipcode,Largo
ZCTA5 33773,12,17290,59305,1079,192300,15044,5411,13457,1216,3743,4622,2980,896,8116,6831,1285,6831,5160,1671,2020-01-01,zipcode,Largo
ZCTA5 33774,12,19270,63370,1104,243700,15609,6581,14406,1237,3744,5703,2402,1320,10291,7988,2303,7988,6124,1864,2020-01-01,zipcode,Largo
ZCTA5 33810,12,51595,58100,1116,168600,41856,18332,36429,4982,12848,12338,3898,2363,20623,17958,2665,17958,13762,4196,2020-01-01,zipcode,Lakeland
ZCTA5 33813,12,38080,85383,1270,245600,29547,11083,25827,1384,6347,8255,6252,3589,13993,12939,1054,12939,10241,2698,2020-01-01,zipcode,Lakeland
ZCTA5 33830,12,30242,46112,820,154100,23631,9015,20235,2489,8170,5491,2880,1205,11366,9829,1537,9829,6326,3503,2020-01-01,zipcode,Bartow
ZCTA5 33834,12,7451,48287,766,81000,5944,3507,5065,1230,2483,887,337,128,2153,1728,425,1728,1163,565,2020-01-01,zipcode,Bowling green
ZCTA5 33837,12,32185,60531,1405,209200,25562,10791,22920,2597,6221,8103,4216,1783,14436,10313,4123,10313,8183,2130,2020-01-01,zipcode,Davenport
ZCTA5 33838,12,4552,38889,855,150400,3302,1660,2862,760,1205,728,121,48,1671,1356,315,1356,843,513,2020-01-01,zipcode,Dundee
ZCTA5 33908,12,35798,58556,1431,271500,33206,20332,31323,1486,8567,8384,7421,5465,31582,18163,13419,18163,12864,5299,2020-01-01,zipcode,Fort myers
ZCTA5 33922,12,4057,50603,988,229400,3510,2121,3389,372,949,1121,451,496,2714,1674,1040,1674,1452,222,2020-01-01,zipcode,Bokeelia
ZCTA5 33931,12,10984,64742,1192,373800,10820,7292,10484,555,3043,3044,2011,1831,15338,5537,9801,5537,5023,514,2020-01-01,zipcode,Fort myers beach
ZCTA5 33935,12,23872,37155,815,113100,18201,7273,15184,4782,4926,3931,995,550,8337,7109,1228,7109,5146,1963,2020-01-01,zipcode,Labelle
ZCTA5 33945,12,6,-666666666,-666666666,-666666666,6,6,6,0,0,0,6,0,202,6,196,6,6,0,2020-01-01,zipcode,Pineland
ZCTA5 33952,12,35285,44456,983,159700,30623,15848,27894,3383,10024,9352,3549,1586,16848,14495,2353,14495,10498,3997,2020-01-01,zipcode,Port charlotte
ZCTA5 33980,12,13461,50018,897,161700,11912,8051,11017,823,3974,3775,1475,970,8210,6101,2109,6101,4697,1404,2020-01-01,zipcode,Punta gorda
ZCTA5 33027,12,66467,58063,1455,316800,55764,23292,49930,3212,14901,14116,10209,7492,26072,24319,1753,24319,18806,5513,2020-01-01,zipcode,Hollywood
ZCTA5 33013,12,30524,41177,1171,278800,26754,10779,23435,7023,8418,4340,2743,911,9615,9293,322,9293,5403,3890,2020-01-01,zipcode,Hialeah
ZCTA5 33033,12,58869,55174,1417,248500,42483,14316,34659,7645,9083,9741,5722,2468,16780,15906,874,15906,8631,7275,2020-01-01,zipcode,Homestead
ZCTA5 33050,12,9530,58120,1352,559100,8078,2859,7290,712,1919,2151,1684,824,7252,4183,3069,4183,2229,1954,2020-01-01,zipcode,Marathon
ZCTA5 33063,12,54916,47800,1413,208500,47963,17227,44129,5008,15358,12838,8094,2831,27673,24451,3222,24451,17341,7110,2020-01-01,zipcode,Pompano beach
ZCTA5 33067,12,26294,106890,1783,457200,20516,6067,17638,659,3028,5209,4877,3865,8697,8269,428,8269,5946,2323,2020-01-01,zipcode,Pompano beach
ZCTA5 33069,12,29321,50975,1354,178400,23899,10568,21235,2855,6065,6302,3967,2046,14561,10500,4061,10500,4818,5682,2020-01-01,zipcode,Pompano beach
ZCTA5 33125,12,60347,31371,1076,265500,51918,22974,45521,15529,14799,6930,5742,2521,23037,21716,1321,21716,5793,15923,2020-01-01,zipcode,Miami
ZCTA5 33127,12,30795,32688,1055,247900,24232,10634,21090,6245,7385,4457,1990,1013,11158,9800,1358,9800,2827,6973,2020-01-01,zipcode,Miami
ZCTA5 35211,01,24876,31785,876,81300,20336,8597,17537,2486,5291,5951,2609,1200,14923,11493,3430,11493,5183,6310,2020-01-01,zipcode,Birmingham
ZCTA5 35214,01,17021,54800,785,118700,14317,6319,12638,996,3542,4287,2594,1219,8522,7259,1263,7259,5204,2055,2020-01-01,zipcode,Birmingham
ZCTA5 35242,01,56713,98055,1142,364400,46446,15440,40129,1185,4351,9432,16026,9135,24719,22832,1887,22832,16191,6641,2020-01-01,zipcode,Birmingham
ZCTA5 35470,01,5123,23467,705,130900,4154,1915,2306,240,759,791,200,316,2437,1952,485,1952,911,1041,2020-01-01,zipcode,Livingston
ZCTA5 35481,01,3208,40352,394,90000,2745,1450,2304,429,1041,628,122,84,1778,1451,327,1451,957,494,2020-01-01,zipcode,Reform
ZCTA5 35504,01,12420,60714,659,162300,10091,4559,8858,1243,2644,3027,1383,561,5737,4904,833,4904,4037,867,2020-01-01,zipcode,Jasper
ZCTA5 35555,01,10050,41599,543,102900,8370,3967,7184,834,3041,2246,816,247,5404,4131,1273,4131,2834,1297,2020-01-01,zipcode,Fayette
ZCTA5 35581,01,6206,41500,673,87100,4451,2189,3786,759,1335,1200,316,176,2535,2012,523,2012,1483,529,2020-01-01,zipcode,Phil campbell
ZCTA5 35582,01,4871,34602,439,84300,3781,1554,3369,593,1368,682,583,143,2397,2002,395,2002,1428,574,2020-01-01,zipcode,Red bay
ZCTA5 35611,01,27293,45195,641,135700,22414,9837,19432,3585,6141,5850,2683,1173,11851,10290,1561,10290,6185,4105,2020-01-01,zipcode,Athens
ZCTA5 35620,01,10668,68667,878,141900,8607,3105,6995,590,2624,2719,514,548,3902,3536,366,3536,3050,486,2020-01-01,zipcode,Elkmont
ZCTA5 35621,01,3113,55000,944,109000,2355,1057,2052,472,630,548,339,63,1234,1186,48,1186,1054,132,2020-01-01,zipcode,Eva
ZCTA5 35755,01,435,41875,-666666666,385700,419,220,335,19,93,110,75,38,420,203,217,203,148,55,2020-01-01,zipcode,Langston
ZCTA5 35773,01,13688,54119,914,130600,11171,3939,10175,1042,2975,3268,1869,1021,5537,5115,422,5115,4128,987,2020-01-01,zipcode,Toney
ZCTA5 35802,01,22301,62231,871,243200,18760,7115,16535,621,2333,5415,4840,3326,11871,10707,1164,10707,5842,4865,2020-01-01,zipcode,Huntsville
ZCTA5 35805,01,19761,26598,667,77300,15317,5612,12374,3144,3161,4105,1420,544,10031,8954,1077,8954,2515,6439,2020-01-01,zipcode,Huntsville
ZCTA5 35904,01,14130,38173,665,77200,11320,5344,9942,1663,3727,3255,865,432,6717,5338,1379,5338,4066,1272,2020-01-01,zipcode,Gadsden
ZCTA5 35980,01,5925,49549,631,112700,4634,2064,3632,788,1251,992,277,324,2186,1952,234,1952,1583,369,2020-01-01,zipcode,Horton
ZCTA5 35031,01,7460,42121,594,123900,6146,3051,5200,977,1707,1819,404,293,3373,2630,743,2630,1735,895,2020-01-01,zipcode,Blountsville
ZCTA5 35956,01,8608,52324,667,132800,6882,3248,5914,964,2069,2009,492,380,3667,3091,576,3091,2490,601,2020-01-01,zipcode,Boaz
ZCTA5 35966,01,3951,49479,685,122700,3319,1560,2858,819,961,744,214,120,1944,1485,459,1485,1261,224,2020-01-01,zipcode,Flat rock
ZCTA5 35981,01,2040,43250,579,95500,1736,644,1453,281,532,423,189,28,891,667,224,667,482,185,2020-01-01,zipcode,Ider
ZCTA5 35010,01,20208,44690,612,105900,16277,7407,14263,2723,5000,4234,1266,1040,10407,8055,2352,8055,5566,2489,2020-01-01,zipcode,Alexander city
ZCTA5 35064,01,10858,41540,809,95100,8835,3671,7107,472,2734,2397,1048,456,5463,4425,1038,4425,2417,2008,2020-01-01,zipcode,Fairfield
ZCTA5 35046,01,5002,56223,740,130300,3781,1610,3282,452,1607,765,308,150,2801,1953,848,1953,1594,359,2020-01-01,zipcode,Clanton
ZCTA5 35053,01,2457,72000,807,222700,1918,902,1803,265,503,551,341,143,2371,854,1517,854,808,46,2020-01-01,zipcode,Crane hill
ZCTA5 35063,01,3130,57829,779,79900,2648,1165,2338,545,858,848,67,20,1724,1258,466,1258,1149,109,2020-01-01,zipcode,Empire
ZCTA5 35072,01,4835,39118,540,80200,3795,2039,3441,585,1687,782,259,128,2645,1808,837,1808,1441,367,2020-01-01,zipcode,Goodwater
ZCTA5 35078,01,2057,62321,792,167000,1636,659,1467,214,459,535,152,107,1092,787,305,787,685,102,2020-01-01,zipcode,Harpersville
ZCTA5 35087,01,2684,31270,898,106900,2206,993,1971,469,516,784,145,57,1125,1069,56,1069,866,203,2020-01-01,zipcode,Joppa
ZCTA5 35097,01,1900,41563,1101,134100,1554,878,1417,237,578,421,121,60,715,695,20,695,642,53,2020-01-01,zipcode,Locust fork
ZCTA5 35114,01,8170,83458,1034,195100,6053,1864,5089,255,1002,1635,1295,902,3058,2859,199,2859,2532,327,2020-01-01,zipcode,Alabaster
ZCTA5 35117,01,5203,73750,706,160300,4180,1544,3493,291,991,1347,638,226,2157,1979,178,1979,1768,211,2020-01-01,zipcode,Mount olive
ZCTA5 35119,01,138,-666666666,-666666666,-666666666,138,65,138,103,35,0,0,0,30,30,0,30,0,30,2020-01-01,zipcode,New castle
ZCTA5 35127,01,9625,64087,1099,157400,8114,2864,6760,358,1902,3029,827,644,3975,3668,307,3668,3013,655,2020-01-01,zipcode,Pleasant grove
ZCTA5 35136,01,2047,36612,-666666666,143600,1767,1059,1493,159,519,576,212,27,1273,785,488,785,651,134,2020-01-01,zipcode,Rockford
ZCTA5 35149,01,249,40964,-666666666,103900,249,74,179,15,164,0,0,0,162,125,37,125,81,44,2020-01-01,zipcode,Sycamore
ZCTA5 35180,01,14305,61037,643,148400,11031,5029,9447,1224,3492,3510,815,406,5457,5003,454,5003,4235,768,2020-01-01,zipcode,Warrior
ZCTA5 35188,01,2351,55568,641,128600,1832,748,1509,291,697,413,80,28,888,715,173,715,547,168,2020-01-01,zipcode,Woodstock
ZCTA5 35228,01,10558,39330,877,68500,8368,3455,7126,1203,2538,2066,1047,272,4730,3937,793,3937,2430,1507,2020-01-01,zipcode,Birmingham
ZCTA5 35401,01,37909,25358,780,114600,33489,18214,17518,2721,5766,4309,2613,2109,18610,12191,6419,12191,4014,8177,2020-01-01,zipcode,Tuscaloosa
ZCTA5 35447,01,3328,33750,435,112600,2761,1508,2447,429,1035,758,143,82,1794,1314,480,1314,951,363,2020-01-01,zipcode,Carrollton
ZCTA5 35453,01,11738,64021,809,138400,8870,2899,7632,1234,2912,2251,761,474,4580,3937,643,3937,3391,546,2020-01-01,zipcode,Cottondale
ZCTA5 35457,01,28,-666666666,-666666666,-666666666,28,0,28,0,28,0,0,0,28,28,0,28,28,0,2020-01-01,zipcode,Echola
ZCTA5 35462,01,4355,27565,527,95300,3346,1886,3178,741,988,1076,237,136,2481,1742,739,1742,1127,615,2020-01-01,zipcode,Eutaw
ZCTA5 35466,01,4999,46466,616,105000,3959,1916,3313,425,1147,1089,412,240,2421,2036,385,2036,1708,328,2020-01-01,zipcode,Gordo
ZCTA5 35476,01,6833,46728,810,143700,5485,2057,4874,610,1410,1735,683,436,3197,2675,522,2675,1080,1595,2020-01-01,zipcode,Northport
ZCTA5 35543,01,1308,27188,592,61300,935,524,812,339,236,157,58,22,618,499,119,499,329,170,2020-01-01,zipcode,Bear creek
ZCTA5 35550,01,5322,43267,532,74700,4375,2332,3906,767,1426,1268,303,142,2597,2195,402,2195,1861,334,2020-01-01,zipcode,Cordova
ZCTA5 35585,01,1139,42950,-666666666,168800,936,500,794,112,167,250,201,64,524,414,110,414,329,85,2020-01-01,zipcode,Spruce pine
ZCTA5 35587,01,538,35682,-666666666,87300,517,319,510,141,248,108,2,11,437,304,133,304,270,34,2020-01-01,zipcode,Townley
ZCTA5 35622,01,7138,48409,770,104300,5230,2337,4619,669,1954,1430,375,191,3014,2506,508,2506,1857,649,2020-01-01,zipcode,Falkville
ZCTA5 35633,01,20593,58832,786,141000,16734,7368,14586,1749,4794,4152,2586,1305,9356,8236,1120,8236,7065,1171,2020-01-01,zipcode,Florence
ZCTA5 35643,01,3501,45395,562,102400,3110,1424,2817,950,1081,479,214,93,1652,1450,202,1450,1281,169,2020-01-01,zipcode,Hillsboro
ZCTA5 35648,01,3226,59135,561,117100,2580,988,2180,226,945,672,147,190,1325,1164,161,1164,953,211,2020-01-01,zipcode,Lexington
ZCTA5 35651,01,1614,52348,728,-666666666,1320,675,1115,148,463,225,273,6,640,537,103,537,420,117,2020-01-01,zipcode,Mount hope
ZCTA5 32812,12,35174,58665,1166,257500,29216,9254,25541,2306,6018,8499,6223,2495,15195,13889,1306,13889,7899,5990,2020-01-01,zipcode,Orlando
ZCTA5 32821,12,19220,51993,1419,226500,16569,4180,14102,594,2762,4757,4728,1261,14128,8111,6017,8111,2632,5479,2020-01-01,zipcode,Orlando
ZCTA5 32043,12,28501,61295,1002,198000,22165,8739,19412,1833,6367,6402,3635,1175,11514,10382,1132,10382,8140,2242,2020-01-01,zipcode,Green cove springs
ZCTA5 32130,12,5393,51250,1071,185900,4399,2228,3961,523,1672,1088,435,243,2161,1793,368,1793,1462,331,2020-01-01,zipcode,De leon springs
ZCTA5 32009,12,3841,65250,861,141100,3146,976,2487,205,1190,831,209,52,1490,1384,106,1384,1211,173,2020-01-01,zipcode,Bryceville
ZCTA5 32011,12,13910,63203,818,169700,11438,5058,10071,1651,4150,2949,882,439,5868,5318,550,5318,4566,752,2020-01-01,zipcode,Callahan
ZCTA5 32024,12,18957,56216,902,144300,15726,6782,13868,1869,5179,4336,1852,632,7695,7016,679,7016,5917,1099,2020-01-01,zipcode,Lake city
ZCTA5 32063,12,13495,63728,798,179100,10715,5039,9033,967,3363,2773,1251,679,5018,4417,601,4417,3115,1302,2020-01-01,zipcode,Macclenny
ZCTA5 32082,12,28503,111746,1447,546100,24041,10259,21387,466,2350,4511,8846,5214,14708,11719,2989,11719,9467,2252,2020-01-01,zipcode,Ponte vedra beach
ZCTA5 32083,12,4188,58750,841,115700,3756,3269,3533,1055,1301,1003,118,56,663,574,89,574,388,186,2020-01-01,zipcode,Raiford
ZCTA5 32087,12,6541,65211,688,110100,5242,3108,4472,1124,2063,1093,140,52,1605,1386,219,1386,965,421,2020-01-01,zipcode,Sanderson
ZCTA5 32091,12,15026,41633,756,107600,12026,5499,10777,1650,4727,3242,768,390,7018,5900,1118,5900,3571,2329,2020-01-01,zipcode,Starke
ZCTA5 32092,12,39858,90668,1775,298600,31927,12104,28382,2234,6365,7556,7995,4232,15616,13656,1960,13656,12015,1641,2020-01-01,zipcode,Saint augustine
ZCTA5 32134,12,7712,36716,659,87000,6654,4064,6120,1021,2744,1767,408,180,5867,3277,2590,3277,2902,375,2020-01-01,zipcode,Fort mc coy
ZCTA5 32206,12,16118,31526,758,90300,12508,5030,10879,2259,3677,3416,925,602,8749,6587,2162,6587,2889,3698,2020-01-01,zipcode,Jacksonville
ZCTA5 32218,12,65878,57327,1118,182100,49722,17987,42469,4051,12866,15736,6594,3222,25091,22441,2650,22441,14266,8175,2020-01-01,zipcode,Jacksonville
ZCTA5 79547,48,932,27500,1017,58300,722,393,695,175,245,159,81,35,605,442,163,442,329,113,2020-01-01,zipcode,Rule
ZCTA5 79102,48,10245,44677,811,114900,7813,2905,6322,1299,1785,1983,970,285,4881,4426,455,4426,2224,2202,2020-01-01,zipcode,Amarillo
ZCTA5 79830,48,7956,46875,736,182300,6520,2330,5726,886,1058,1410,1581,791,4504,3569,935,3569,2095,1474,2020-01-01,zipcode,Alpine
ZCTA5 79837,48,249,33333,-666666666,42700,190,53,190,61,18,33,77,1,254,116,138,116,44,72,2020-01-01,zipcode,Dell city
ZCTA5 79839,48,2182,30110,650,48100,1611,811,1143,688,399,50,6,0,703,501,202,501,356,145,2020-01-01,zipcode,Fort hancock
ZCTA5 79845,48,4317,17284,387,50400,3209,1687,2675,1737,262,392,276,8,2471,1570,901,1570,673,897,2020-01-01,zipcode,Presidio
ZCTA5 79854,48,175,-666666666,-666666666,74300,175,118,175,82,16,49,28,0,132,67,65,67,43,24,2020-01-01,zipcode,Valentine
ZCTA5 79934,48,26360,70975,1189,150000,19459,5483,15635,941,2764,5739,3900,2291,10521,9414,1107,9414,6302,3112,2020-01-01,zipcode,El paso
ZCTA5 79938,48,83326,58237,1106,155700,57193,18329,46676,7315,9354,17682,8362,3963,25571,24132,1439,24132,18996,5136,2020-01-01,zipcode,El paso
ZCTA5 79411,48,6661,36883,857,65500,6023,2102,3894,1047,986,889,580,392,3598,3080,518,3080,1093,1987,2020-01-01,zipcode,Lubbock
ZCTA5 79506,48,555,51212,525,71000,493,248,487,64,134,164,93,32,716,326,390,326,276,50,2020-01-01,zipcode,Blackwell
ZCTA5 79838,48,4872,30737,551,62500,3781,1864,3145,1548,847,673,54,23,1859,1623,236,1623,1069,554,2020-01-01,zipcode,Fabens
ZCTA5 79852,48,676,31625,457,92300,607,345,597,93,147,218,82,57,463,345,118,345,275,70,2020-01-01,zipcode,Terlingua
ZCTA5 79905,48,22767,21847,575,85400,17500,8742,14444,6461,3159,3718,830,276,8795,7817,978,7817,3797,4020,2020-01-01,zipcode,El paso
ZCTA5 79906,48,3452,55833,1314,-666666666,2446,526,1318,8,199,455,426,230,1011,832,179,832,0,832,2020-01-01,zipcode,El paso
ZCTA5 79935,48,18546,57617,854,161700,14835,5553,12387,2075,2789,4098,2545,880,6756,6434,322,6434,3606,2828,2020-01-01,zipcode,El paso
ZCTA5 76569,48,2614,61300,838,77900,1999,811,1651,92,619,684,194,62,942,824,118,824,652,172,2020-01-01,zipcode,Rogers
ZCTA5 76578,48,1233,60833,964,163500,929,304,801,100,280,269,107,45,471,378,93,378,295,83,2020-01-01,zipcode,Thrall
ZCTA5 76624,48,2485,77679,700,102700,2073,872,1554,257,473,593,171,60,1038,833,205,833,691,142,2020-01-01,zipcode,Axtell
ZCTA5 76627,48,1334,61250,967,87400,1080,321,858,120,369,258,49,62,614,493,121,493,431,62,2020-01-01,zipcode,Blum
ZCTA5 76634,48,7610,62450,666,152100,6233,2880,5707,596,1601,2234,919,357,3919,2988,931,2988,2297,691,2020-01-01,zipcode,Clifton
ZCTA5 76639,48,1437,37917,515,101500,1199,520,1088,101,407,370,141,69,864,649,215,649,387,262,2020-01-01,zipcode,Dawson
ZCTA5 76652,48,1089,55885,756,150600,889,454,807,68,422,229,69,19,611,464,147,464,405,59,2020-01-01,zipcode,Kopperl
ZCTA5 76679,48,1206,67632,-666666666,114200,912,375,814,74,317,192,215,16,590,434,156,434,397,37,2020-01-01,zipcode,Purdon
ZCTA5 76802,48,5271,68656,785,131100,4067,1424,3464,291,1041,1181,763,188,2251,1955,296,1955,1541,414,2020-01-01,zipcode,Early
ZCTA5 76828,48,199,62875,-666666666,-666666666,174,125,174,9,35,87,43,0,232,106,126,106,102,4,2020-01-01,zipcode,Burkett
ZCTA5 76849,48,3760,47305,674,123200,3161,1268,2805,486,893,776,416,234,2739,1649,1090,1649,1248,401,2020-01-01,zipcode,Junction
ZCTA5 76852,48,291,53889,664,187500,218,101,209,14,84,70,8,33,228,132,96,132,108,24,2020-01-01,zipcode,Lohn
ZCTA5 76866,48,662,79375,818,165900,512,230,480,34,116,205,110,15,489,250,239,250,221,29,2020-01-01,zipcode,Paint rock
ZCTA5 76002,48,36302,91413,1887,204500,27080,6758,21835,2744,5385,7154,4101,2451,9649,9491,158,9491,8026,1465,2020-01-01,zipcode,Arlington
ZCTA5 76016,48,31705,94168,1604,215100,25783,9115,21947,1096,4657,7323,5859,3012,11534,11103,431,11103,9064,2039,2020-01-01,zipcode,Arlington
ZCTA5 76023,48,7090,66803,989,175800,5898,2082,5103,686,1866,1706,730,115,2479,2325,154,2325,1942,383,2020-01-01,zipcode,Boyd
ZCTA5 76035,48,2373,116250,1271,293400,1744,550,1493,139,383,501,249,221,819,738,81,738,635,103,2020-01-01,zipcode,Cresson
ZCTA5 76049,48,30062,86396,1125,232600,24818,11364,22486,1669,5723,7615,4858,2621,12796,11604,1192,11604,10068,1536,2020-01-01,zipcode,Granbury
ZCTA5 76051,48,54130,94212,1445,338600,43891,10155,38093,2954,5786,10076,13274,6003,22929,21843,1086,21843,11740,10103,2020-01-01,zipcode,Grapevine
ZCTA5 76055,48,3181,59444,761,109000,2522,1041,2132,355,662,781,171,163,1330,1146,184,1146,858,288,2020-01-01,zipcode,Itasca
ZCTA5 76063,48,76609,99144,1413,280600,57449,17834,47822,3047,9375,16898,11914,6588,25773,24595,1178,24595,18443,6152,2020-01-01,zipcode,Mansfield
ZCTA5 76066,48,4106,61801,510,234200,2917,1393,2538,360,692,812,231,443,1557,1281,276,1281,1034,247,2020-01-01,zipcode,Millsap
ZCTA5 76086,48,23161,57762,1075,154300,18094,6990,15429,2383,5021,5751,1545,729,9080,8314,766,8314,4362,3952,2020-01-01,zipcode,Weatherford
ZCTA5 76087,48,29119,92029,1217,264600,22969,8568,20345,1549,3817,7334,5234,2411,11752,10259,1493,10259,9271,988,2020-01-01,zipcode,Weatherford
ZCTA5 76115,48,21907,39225,910,83600,15233,5957,12030,5365,2930,1794,938,1003,6671,6142,529,6142,2908,3234,2020-01-01,zipcode,Fort worth
ZCTA5 76123,48,37075,84147,1738,184500,27704,7582,23143,2242,6145,6594,4947,3215,11872,11462,410,11462,8936,2526,2020-01-01,zipcode,Fort worth
ZCTA5 76135,48,20233,66283,1018,180100,16226,5432,13623,1545,3642,4930,2435,1071,8198,7748,450,7748,5256,2492,2020-01-01,zipcode,Fort worth
ZCTA5 76201,48,29447,32704,954,190400,27430,9953,12456,767,1979,4357,3082,2271,11645,10013,1632,10013,2274,7739,2020-01-01,zipcode,Denton
ZCTA5 08836,34,4015,174441,1818,641500,2974,956,2623,7,375,369,1066,806,1369,1357,12,1357,1295,62,2020-01-01,zipcode,Martinsville
ZCTA5 08840,34,16792,129066,1723,427100,12949,3557,11784,465,1769,2564,3777,3209,6223,5957,266,5957,4749,1208,2020-01-01,zipcode,Metuchen
ZCTA5 08848,34,8857,113813,1395,330900,7072,2372,6227,276,1766,1449,1850,886,3438,3215,223,3215,2957,258,2020-01-01,zipcode,Milford
ZCTA5 08857,34,39601,92255,1237,363900,32993,9878,29511,1903,8295,7543,8287,3483,15861,15326,535,15326,10285,5041,2020-01-01,zipcode,Old bridge
ZCTA5 08863,34,12509,101206,1630,316400,10076,3170,9031,997,2196,2640,2120,1078,4495,4245,250,4245,3073,1172,2020-01-01,zipcode,Fords
ZCTA5 08865,34,29142,69154,1050,202400,24341,8337,21367,1890,7352,5955,3971,2199,13428,12227,1201,12227,8180,4047,2020-01-01,zipcode,Phillipsburg
ZCTA5 08867,34,5542,151940,1344,462200,4647,1175,3725,122,679,795,1161,968,1981,1876,105,1876,1641,235,2020-01-01,zipcode,Pittstown
ZCTA5 08876,34,21976,103678,1444,391100,17906,5342,15539,1355,2960,2970,5012,3242,9036,8479,557,8479,5594,2885,2020-01-01,zipcode,Somerville
ZCTA5 08880,34,4541,86667,1535,273100,3563,851,3042,265,994,863,612,308,1806,1646,160,1646,959,687,2020-01-01,zipcode,South bound brook
ZCTA5 08887,34,1231,99464,1480,210400,1028,329,936,145,154,211,268,158,585,546,39,546,409,137,2020-01-01,zipcode,Three bridges
ZCTA5 08889,34,10475,110194,1835,445900,9001,3798,7800,322,1690,1396,2662,1730,4524,4428,96,4428,3974,454,2020-01-01,zipcode,Whitehouse station
ZCTA5 08105,34,26807,34722,1027,89700,19159,6935,15680,5538,4904,3660,1181,397,9287,8366,921,8366,4070,4296,2020-01-01,zipcode,Camden
ZCTA5 78880,48,1736,38750,627,71300,1332,498,1093,275,334,281,174,29,1371,690,681,690,484,206,2020-01-01,zipcode,Rocksprings
ZCTA5 78883,48,314,65893,-666666666,364100,294,201,249,0,56,68,80,45,332,144,188,144,131,13,2020-01-01,zipcode,Tarpley
ZCTA5 78949,48,822,81288,-666666666,173800,661,448,473,37,106,140,167,23,434,210,224,210,201,9,2020-01-01,zipcode,Muldoon
ZCTA5 78959,48,1742,51607,519,104400,1511,667,1339,413,542,287,56,41,949,709,240,709,558,151,2020-01-01,zipcode,Waelder
ZCTA5 78744,48,48551,62905,1255,196700,36665,8026,30728,8239,8157,7490,5220,1622,16831,16053,778,16053,7677,8376,2020-01-01,zipcode,Austin
ZCTA5 78748,48,52076,88688,1497,297600,42033,9625,37753,2089,5571,11236,13457,5400,22201,21027,1174,21027,12485,8542,2020-01-01,zipcode,Austin
ZCTA5 78829,48,1764,-666666666,1028,38800,978,376,698,196,283,197,22,0,523,323,200,323,190,133,2020-01-01,zipcode,Batesville
ZCTA5 78830,48,877,24659,665,49500,732,489,634,195,193,187,35,24,441,291,150,291,225,66,2020-01-01,zipcode,Big wells
ZCTA5 78838,48,141,92083,-666666666,310000,141,99,141,39,50,12,34,6,304,83,221,83,83,0,2020-01-01,zipcode,Concan
ZCTA5 78756,48,9450,84779,1316,562300,8463,2000,7456,134,626,1183,3315,2198,4797,4414,383,4414,1997,2417,2020-01-01,zipcode,Austin
ZCTA5 78140,48,3457,55125,791,74500,2382,853,1942,600,901,312,103,26,1287,1094,193,1094,731,363,2020-01-01,zipcode,Nixon
ZCTA5 78221,48,42535,45950,889,92700,32607,12087,26876,8200,9662,6438,1730,846,12803,11828,975,11828,7822,4006,2020-01-01,zipcode,San antonio
ZCTA5 78357,48,2695,58429,698,68200,2032,713,1678,295,611,546,92,134,1176,857,319,857,593,264,2020-01-01,zipcode,Freer
ZCTA5 78570,48,32841,35382,545,64400,23447,10635,18693,7522,4744,4294,1222,911,10490,8732,1758,8732,6349,2383,2020-01-01,zipcode,Mercedes
ZCTA5 78654,48,18524,57087,1016,226200,15176,6663,13269,1722,3365,4121,2577,1484,9741,7174,2567,7174,5216,1958,2020-01-01,zipcode,Marble falls
ZCTA5 78028,48,40058,55776,950,198100,33533,15627,29244,2749,8180,9901,5264,3150,18184,16597,1587,16597,10979,5618,2020-01-01,zipcode,Kerrville
ZCTA5 78101,48,7434,93125,726,236200,5980,2311,5102,613,1695,1380,921,493,2629,2356,273,2356,2152,204,2020-01-01,zipcode,Adkins
ZCTA5 78102,48,28253,46089,864,95600,23060,13736,19328,4179,6632,6628,1039,850,8690,7012,1678,7012,4414,2598,2020-01-01,zipcode,Beeville
ZCTA5 78119,48,6960,46734,759,95200,5697,3684,5021,1341,1730,1336,404,210,2593,1869,724,1869,1266,603,2020-01-01,zipcode,Kenedy
ZCTA5 78152,48,2569,95306,1223,239100,2067,790,1657,111,496,491,327,232,844,803,41,803,764,39,2020-01-01,zipcode,Saint hedwig
ZCTA5 78154,48,41171,83042,1376,215700,32727,9173,28597,1464,6687,9835,6488,4123,15326,14681,645,14681,10255,4426,2020-01-01,zipcode,Schertz
ZCTA5 78160,48,5776,69934,833,167400,4622,1837,3690,622,1161,1404,322,181,2047,1747,300,1747,1547,200,2020-01-01,zipcode,Stockdale
ZCTA5 78164,48,3990,57875,722,175700,3289,1654,3050,480,1190,1034,209,137,2113,1570,543,1570,1314,256,2020-01-01,zipcode,Yorktown
ZCTA5 78204,48,12850,40195,985,88100,10213,3716,8802,2056,2654,2674,618,800,5122,4310,812,4310,2322,1988,2020-01-01,zipcode,San antonio
ZCTA5 78212,48,27940,49305,875,190400,24273,8827,19526,3170,4510,4921,3886,3039,12706,10939,1767,10939,4956,5983,2020-01-01,zipcode,San antonio
ZCTA5 78215,48,2925,72935,1494,425000,2796,414,2386,57,129,538,766,896,2230,1914,316,1914,103,1811,2020-01-01,zipcode,San antonio
ZCTA5 78217,48,35257,45417,987,146400,27733,9411,23999,3032,6481,8844,3451,2191,15249,13919,1330,13919,5815,8104,2020-01-01,zipcode,San antonio
ZCTA5 78226,48,8012,26728,770,82200,6198,2906,5050,2019,1398,1362,173,98,2884,2334,550,2334,928,1406,2020-01-01,zipcode,San antonio
ZCTA5 78228,48,61441,42445,825,103700,48834,20607,39600,11435,13682,10034,3220,1229,20578,18773,1805,18773,11095,7678,2020-01-01,zipcode,San antonio
ZCTA5 78231,48,10132,95918,1124,308100,8004,2705,7149,330,978,1911,2012,1918,3840,3679,161,3679,2503,1176,2020-01-01,zipcode,San antonio
ZCTA5 78236,48,6760,79420,1808,-666666666,6070,399,1619,64,192,905,343,115,437,355,82,355,0,355,2020-01-01,zipcode,Jbsa lackland
ZCTA5 78237,48,41247,33477,796,70400,30857,13666,25982,9849,9260,5501,1102,270,12362,11662,700,11662,7430,4232,2020-01-01,zipcode,San antonio
ZCTA5 78240,48,61937,54646,1121,182800,48071,15371,40246,3705,7532,13252,9739,6018,26228,23502,2726,23502,8515,14987,2020-01-01,zipcode,San antonio
ZCTA5 78249,48,61712,72629,1212,213000,52002,13850,36351,1770,5442,12034,10843,6262,22484,20991,1493,20991,11358,9633,2020-01-01,zipcode,San antonio
ZCTA5 78363,48,29400,46783,895,99300,23042,9295,16095,3411,4473,4328,2793,1090,12537,10632,1905,10632,5379,5253,2020-01-01,zipcode,Kingsville
ZCTA5 08346,34,781,82746,-666666666,155600,603,125,515,26,182,242,65,0,292,252,40,252,252,0,2020-01-01,zipcode,Newtonville
ZCTA5 08318,34,12387,74052,1075,216600,10484,3898,8740,697,3507,2282,1525,729,5100,4724,376,4724,3946,778,2020-01-01,zipcode,Elmer
ZCTA5 08321,34,112,28036,919,191100,110,83,110,15,72,17,0,6,290,71,219,71,47,24,2020-01-01,zipcode,Fortescue
ZCTA5 08326,34,1325,61415,1467,154500,1068,276,921,76,414,216,168,47,528,482,46,482,356,126,2020-01-01,zipcode,Landisville
ZCTA5 08403,34,903,110972,1773,856300,856,475,815,15,163,197,251,189,1548,475,1073,475,399,76,2020-01-01,zipcode,Longport
ZCTA5 08515,34,5972,149967,1802,454100,4487,1484,3690,214,761,689,1281,745,1762,1675,87,1675,1560,115,2020-01-01,zipcode,Chesterfield
ZCTA5 08518,34,5471,83819,1062,241400,4379,1263,3870,551,1015,1319,649,336,2399,2206,193,2206,1492,714,2020-01-01,zipcode,Florence
ZCTA5 08534,34,13208,133818,1738,463600,10250,3977,8847,294,1085,1069,2910,3489,5155,4781,374,4781,4049,732,2020-01-01,zipcode,Pennington
ZCTA5 08535,34,4567,185750,1836,595600,3746,895,3206,75,424,739,1184,784,1663,1564,99,1564,1439,125,2020-01-01,zipcode,Millstone township
ZCTA5 08536,34,19264,113609,1645,552400,15301,4216,13833,190,1262,1534,5143,5704,8657,7742,915,7742,3582,4160,2020-01-01,zipcode,Plainsboro
ZCTA5 08629,34,12910,72258,1194,108200,10698,3553,9032,1534,4051,2348,827,272,4386,4087,299,4087,2865,1222,2020-01-01,zipcode,Trenton
ZCTA5 08691,34,16413,137347,1780,409100,13119,4050,11578,287,2289,2055,3598,3349,6646,6336,310,6336,5473,863,2020-01-01,zipcode,Trenton
ZCTA5 08724,34,41504,77882,1646,290900,34502,12083,30171,1660,9389,8924,7096,3102,17913,16716,1197,16716,13923,2793,2020-01-01,zipcode,Brick
ZCTA5 08740,34,1488,53947,1529,256500,1226,490,1054,106,380,198,285,85,1210,680,530,680,496,184,2020-01-01,zipcode,Ocean gate
ZCTA5 08816,34,47323,123003,1535,406400,37986,11981,33332,1970,6066,5939,11159,8198,16867,16129,738,16129,13197,2932,2020-01-01,zipcode,East brunswick
ZCTA5 08826,34,5027,110730,1322,355000,4315,1338,3646,149,815,942,1043,697,2267,2042,225,2042,1701,341,2020-01-01,zipcode,Glen gardner
ZCTA5 08828,34,2232,94116,1712,243900,1875,434,1675,104,610,405,406,150,938,915,23,915,694,221,2020-01-01,zipcode,Helmetta
ZCTA5 08852,34,17643,104227,1690,416900,13838,3988,12334,345,1527,1581,5410,3471,6919,6639,280,6639,4542,2097,2020-01-01,zipcode,Monmouth junction
ZCTA5 77480,48,8344,59598,930,112700,6605,3205,5845,716,1956,2336,748,89,4018,3251,767,3251,2702,549,2020-01-01,zipcode,Sweeny
ZCTA5 77505,48,22967,88917,1224,200000,17802,5829,14590,1436,4155,5376,2136,1487,8376,7837,539,7837,5378,2459,2020-01-01,zipcode,Pasadena
ZCTA5 77515,48,33634,76923,900,154500,27696,12557,24144,3323,8715,8098,2732,1276,13012,11728,1284,11728,8179,3549,2020-01-01,zipcode,Angleton
ZCTA5 77519,48,781,48529,-666666666,60600,776,430,731,187,333,120,73,18,401,350,51,350,331,19,2020-01-01,zipcode,Batson
ZCTA5 77531,48,16352,63169,1095,143200,12563,3949,10372,1957,3330,3149,1482,454,7211,6191,1020,6191,3445,2746,2020-01-01,zipcode,Clute
ZCTA5 77534,48,2905,100000,1004,183300,2063,652,1680,105,405,778,308,84,1043,908,135,908,833,75,2020-01-01,zipcode,Danbury
ZCTA5 77536,48,32745,77163,1186,182000,25508,9001,20954,2296,6191,8073,3195,1199,12162,11305,857,11305,8475,2830,2020-01-01,zipcode,Deer park
ZCTA5 08879,34,23183,76007,1378,307400,18798,5534,17150,1732,5182,4706,3807,1723,9615,9086,529,9086,4846,4240,2020-01-01,zipcode,South amboy
ZCTA5 08886,34,7143,125288,1443,315400,5763,1665,4800,192,996,1168,1705,739,2579,2504,75,2504,2111,393,2020-01-01,zipcode,Stewartsville
ZCTA5 08009,34,12903,87704,1354,227000,10629,3384,9158,587,2600,3096,1937,938,4980,4882,98,4882,4270,612,2020-01-01,zipcode,Berlin
ZCTA5 08011,34,0,-666666666,-666666666,-666666666,0,0,0,0,0,0,0,0,0,0,0,0,0,0,2020-01-01,zipcode,Birmingham
ZCTA5 08016,34,33471,77442,1079,239600,26649,7848,23233,2145,6721,6916,5002,2449,13607,12742,865,12742,9533,3209,2020-01-01,zipcode,Burlington
ZCTA5 08019,34,1142,127917,2156,318900,901,255,830,64,382,189,173,22,479,451,28,451,404,47,2020-01-01,zipcode,Chatsworth
ZCTA5 08026,34,2231,83073,2281,216300,1814,762,1514,82,581,429,293,129,807,757,50,757,718,39,2020-01-01,zipcode,Gibbsboro
ZCTA5 08035,34,7654,96250,1110,282400,6293,1907,5642,231,1181,1386,1972,872,3410,3199,211,3199,2481,718,2020-01-01,zipcode,Haddon heights
ZCTA5 08527,34,56848,98606,1551,373700,45151,14882,38759,2212,11202,11245,9524,4576,21290,20187,1103,20187,17292,2895,2020-01-01,zipcode,Jackson
ZCTA5 08751,34,4351,57238,1282,451800,3604,1760,3145,315,1017,801,658,354,5526,2047,3479,2047,1093,954,2020-01-01,zipcode,Seaside heights
ZCTA5 08824,34,12418,154069,1498,458400,9969,2725,8826,253,1273,1407,3729,2164,4317,4152,165,4152,3551,601,2020-01-01,zipcode,Kendall park
ZCTA5 08820,34,37295,131216,1611,494700,29114,10747,26382,2188,3116,2685,8995,9398,12745,12535,210,12535,9475,3060,2020-01-01,zipcode,Edison
ZCTA5 08802,34,4299,119052,1590,377700,3510,1094,2998,27,791,851,927,402,1521,1482,39,1482,1400,82,2020-01-01,zipcode,Asbury
ZCTA5 08805,34,12100,75058,1490,293600,9525,2683,8167,1081,2786,1979,1458,863,4690,4176,514,4176,2294,1882,2020-01-01,zipcode,Bound brook
ZCTA5 08821,34,481,71923,-666666666,394700,431,143,304,0,158,75,62,9,169,142,27,142,142,0,2020-01-01,zipcode,Flagtown
ZCTA5 08827,34,3914,108657,511,363300,3317,1179,3054,68,614,848,1043,481,1780,1624,156,1624,1426,198,2020-01-01,zipcode,Hampton
ZCTA5 08829,34,3492,96654,1383,263000,2985,1077,2448,142,689,493,660,464,1463,1401,62,1401,1073,328,2020-01-01,zipcode,High bridge
ZCTA5 08831,34,51245,95707,1407,371400,42932,19571,39517,2236,10402,8924,10677,7278,23434,21941,1493,21941,19553,2388,2020-01-01,zipcode,Monroe township
ZCTA5 08850,34,8420,109531,1590,345700,6955,1876,6070,220,1462,1687,2006,695,3130,2983,147,2983,2430,553,2020-01-01,zipcode,Milltown
ZCTA5 08853,34,5297,185208,1421,578700,4337,1098,3572,113,570,647,1082,1160,1951,1885,66,1885,1587,298,2020-01-01,zipcode,Neshanic station
ZCTA5 08854,34,56948,106498,1650,346500,48268,19060,34785,2616,7242,7274,10484,7169,16774,15899,875,15899,10620,5279,2020-01-01,zipcode,Piscataway
ZCTA5 08872,34,19627,75499,1277,301600,15750,4974,14193,1183,4591,3791,3245,1383,7758,7541,217,7541,4402,3139,2020-01-01,zipcode,Sayreville
ZCTA5 08402,34,5921,101354,1370,490400,5203,2165,4620,206,816,1153,1115,1330,6879,2877,4002,2877,2421,456,2020-01-01,zipcode,Margate city
ZCTA5 08406,34,9995,55681,1266,260800,9060,3976,7954,675,2811,2070,1392,1006,7882,4655,3227,4655,3000,1655,2020-01-01,zipcode,Ventnor city
ZCTA5 08525,34,4881,127885,1537,444900,3988,891,3458,187,525,676,1186,884,2051,1872,179,1872,1518,354,2020-01-01,zipcode,Hopewell
ZCTA5 08533,34,6709,93341,1175,354900,5459,1339,4463,407,1356,1098,1125,477,2597,2597,0,2597,2082,515,2020-01-01,zipcode,New egypt
ZCTA5 08640,34,8350,85296,2098,-666666666,6931,4868,5995,962,2204,1721,799,309,1118,1065,53,1065,1,1064,2020-01-01,zipcode,Joint base mdl
ZCTA5 08730,34,4701,148788,2273,655500,3619,1173,3102,37,477,505,1298,785,1987,1690,297,1690,1554,136,2020-01-01,zipcode,Brielle
ZCTA5 08822,34,28836,113352,1453,425900,23191,6953,20420,1218,3885,4106,6737,4474,11379,10847,532,10847,8717,2130,2020-01-01,zipcode,Flemington
ZCTA5 08823,34,8324,91528,1870,258700,6769,1612,6077,275,963,1351,1756,1732,3629,3454,175,3454,2391,1063,2020-01-01,zipcode,Franklin park
ZCTA5 77968,48,3142,92625,596,282600,2260,872,2002,138,499,749,487,129,1155,1004,151,1004,863,141,2020-01-01,zipcode,Inez
ZCTA5 77971,48,1227,63299,694,169100,955,396,880,184,391,258,47,0,464,327,137,327,207,120,2020-01-01,zipcode,Lolita
ZCTA5 77982,48,1139,52868,-666666666,202500,995,547,859,60,276,483,27,13,1769,433,1336,433,366,67,2020-01-01,zipcode,Port o connor
ZCTA5 77086,48,30347,47495,977,130400,22175,7575,17598,6091,6234,3652,1237,384,9039,8345,694,8345,4787,3558,2020-01-01,zipcode,Houston
ZCTA5 77464,48,70,-666666666,-666666666,162500,63,37,63,20,14,23,2,4,54,43,11,43,18,25,2020-01-01,zipcode,Orchard
ZCTA5 77493,48,40547,91670,1377,226600,29861,9121,25590,2034,6153,8530,5822,3051,13121,12301,820,12301,9808,2493,2020-01-01,zipcode,Katy
ZCTA5 77494,48,126310,142037,1745,360100,88708,29340,76892,3014,7252,18333,26693,21600,40144,38439,1705,38439,28880,9559,2020-01-01,zipcode,Katy
ZCTA5 77872,48,2178,61480,861,122300,1635,841,1346,114,676,363,145,48,969,710,259,710,609,101,2020-01-01,zipcode,North zulch
ZCTA5 77964,48,7874,52830,775,188900,6186,2473,5343,757,2104,1581,663,238,4316,3097,1219,3097,2180,917,2020-01-01,zipcode,Hallettsville
ZCTA5 77970,48,337,63214,743,57400,263,99,190,80,45,50,13,2,187,96,91,96,49,47,2020-01-01,zipcode,La ward
ZCTA5 77974,48,448,53828,1102,185400,323,104,288,19,64,165,30,10,190,159,31,159,101,58,2020-01-01,zipcode,Meyersville
ZCTA5 77977,48,513,26293,668,48200,495,208,453,160,212,64,17,0,315,258,57,258,222,36,2020-01-01,zipcode,Placedo
ZCTA5 77984,48,4129,71134,780,178400,3314,1453,3015,198,1109,858,659,191,2217,1675,542,1675,1425,250,2020-01-01,zipcode,Shiner
ZCTA5 77991,48,631,104671,-666666666,-666666666,257,43,218,0,64,89,65,0,120,100,20,100,87,13,2020-01-01,zipcode,Vanderbilt
ZCTA5 77994,48,424,72438,-666666666,-666666666,303,133,268,11,85,138,24,10,275,136,139,136,108,28,2020-01-01,zipcode,Westhoff
ZCTA5 77015,48,57553,50118,972,116900,42178,14529,33924,10052,10292,9575,2821,1184,19707,17789,1918,17789,9290,8499,2020-01-01,zipcode,Houston
ZCTA5 77022,48,27200,36441,826,122700,20686,7818,17308,7044,4762,3783,1228,491,10683,9380,1303,9380,4596,4784,2020-01-01,zipcode,Houston
ZCTA5 77026,48,21269,29401,734,65700,16930,8039,14177,4840,5315,2734,1060,228,9138,7537,1601,7537,3139,4398,2020-01-01,zipcode,Houston
ZCTA5 77027,48,19171,99773,1538,808100,17292,4426,15551,202,556,2629,6531,5633,12838,10699,2139,10699,3041,7658,2020-01-01,zipcode,Houston
ZCTA5 77047,48,32747,65105,1308,157400,24595,6667,21110,3116,4245,7256,3901,2592,11994,11370,624,11370,8575,2795,2020-01-01,zipcode,Houston
ZCTA5 77005,48,29022,202526,1811,1135300,22470,8910,17888,196,432,1652,6437,9171,10949,10271,678,10271,7380,2891,2020-01-01,zipcode,Houston
ZCTA5 77007,48,40112,129703,1722,430300,35548,4633,32399,635,1644,4134,14925,11061,23358,20930,2428,20930,11005,9925,2020-01-01,zipcode,Houston
ZCTA5 77017,48,34010,50855,910,105800,25083,9247,20308,8021,5694,4558,1381,654,11379,10232,1147,10232,5246,4986,2020-01-01,zipcode,Houston
ZCTA5 77019,48,22164,116032,1645,634700,19664,5213,17661,498,1400,2645,6681,6437,12719,11510,1209,11510,5437,6073,2020-01-01,zipcode,Houston
ZCTA5 77378,48,16134,59358,954,148200,12280,4706,10908,2315,3645,3234,1493,221,5931,5293,638,5293,4233,1060,2020-01-01,zipcode,Willis
ZCTA5 77356,48,28144,96802,1376,292000,23171,8949,20469,801,3975,7311,5783,2599,13797,11799,1998,11799,9458,2341,2020-01-01,zipcode,Montgomery
ZCTA5 77357,48,29890,63566,1019,144900,22272,7688,16994,3952,5427,5548,1489,578,9985,8798,1187,8798,6430,2368,2020-01-01,zipcode,New caney
ZCTA5 77359,48,292,50486,-666666666,-666666666,292,153,292,36,244,12,0,0,150,108,42,108,51,57,2020-01-01,zipcode,Oakhurst
ZCTA5 77382,48,40026,144318,1710,426000,29285,10033,24457,415,2630,5274,9884,6254,12893,12531,362,12531,9490,3041,2020-01-01,zipcode,Spring
ZCTA5 77396,48,62309,70111,1237,167400,47701,15437,39551,6213,11659,11340,5889,4450,20782,19848,934,19848,12840,7008,2020-01-01,zipcode,Humble
ZCTA5 77419,48,1148,54516,571,125200,760,205,648,176,155,154,163,0,516,374,142,374,311,63,2020-01-01,zipcode,Blessing
ZCTA5 77428,48,0,-666666666,-666666666,-666666666,0,0,0,0,0,0,0,0,0,0,0,0,0,0,2020-01-01,zipcode,Collegeport
ZCTA5 77432,48,39,-666666666,-666666666,-666666666,39,14,39,25,0,14,0,0,14,14,0,14,0,14,2020-01-01,zipcode,Danevang
ZCTA5 77435,48,3857,59079,921,181400,3063,1193,2645,412,890,676,448,219,1830,1544,286,1544,1305,239,2020-01-01,zipcode,East bernard
ZCTA5 77441,48,11248,159618,-666666666,462600,8948,3703,7704,383,712,1560,3063,1986,4334,3795,539,3795,3728,67,2020-01-01,zipcode,Fulshear
ZCTA5 77447,48,16309,82560,1307,223700,11728,3311,10068,1262,3193,3427,1574,612,5754,5367,387,5367,4468,899,2020-01-01,zipcode,Hockley
ZCTA5 77025,48,29298,72207,1325,451700,23708,7583,21233,1226,1842,2841,6091,9233,15343,13741,1602,13741,5549,8192,2020-01-01,zipcode,Houston
ZCTA5 77038,48,30428,42291,1030,128100,21730,7971,17647,6629,5089,4375,1011,543,9145,8705,440,8705,4947,3758,2020-01-01,zipcode,Houston
ZCTA5 34234,12,22330,41933,1045,154000,18393,8477,15894,2661,5734,3940,2245,1314,10255,8646,1609,8646,4890,3756,2020-01-01,zipcode,Sarasota
ZCTA5 33967,12,26277,73084,1374,241000,21135,6277,17285,1747,4614,5564,3911,1449,10123,8494,1629,8494,6379,2115,2020-01-01,zipcode,Fort myers
ZCTA5 33973,12,16595,44116,1103,221200,10846,3749,8761,1661,3557,2343,756,444,4311,4025,286,4025,888,3137,2020-01-01,zipcode,Lehigh acres
ZCTA5 33974,12,19304,51669,1309,172900,14748,5283,12536,2031,4625,3818,1382,680,5504,4909,595,4909,2962,1947,2020-01-01,zipcode,Lehigh acres
ZCTA5 33976,12,16933,52778,1316,166700,12172,3439,9981,2439,3242,3006,1015,279,4857,4541,316,4541,3031,1510,2020-01-01,zipcode,Lehigh acres
ZCTA5 33076,12,41884,138816,2565,543300,30141,10753,25499,816,4466,4886,7996,7335,13290,12372,918,12372,10298,2074,2020-01-01,zipcode,Pompano beach
ZCTA5 32210,12,62457,48756,1000,144900,48581,15835,42246,4954,14684,13598,6023,2987,27506,24886,2620,24886,13127,11759,2020-01-01,zipcode,Jacksonville
ZCTA5 32250,12,27612,94219,1494,378300,23504,7147,21087,1078,3459,4939,7315,4296,14457,12469,1988,12469,8716,3753,2020-01-01,zipcode,Jacksonville beach
ZCTA5 32277,12,32446,48818,1041,183200,25686,8605,21168,1982,7192,7137,3654,1203,13331,12259,1072,12259,5783,6476,2020-01-01,zipcode,Jacksonville
ZCTA5 32320,12,4035,52665,729,187100,3408,1580,3105,716,983,792,376,238,2319,1832,487,1832,1237,595,2020-01-01,zipcode,Apalachicola
ZCTA5 32346,12,1709,44097,1636,188100,1315,650,1275,261,394,445,146,29,1674,776,898,776,627,149,2020-01-01,zipcode,Panacea
ZCTA5 32351,12,18095,36950,600,86300,14119,7955,11839,2665,4121,3191,1178,684,7345,5934,1411,5934,3939,1995,2020-01-01,zipcode,Quincy
ZCTA5 32025,12,24317,42848,851,126900,19589,10305,16057,2716,5566,5373,1559,843,9281,7959,1322,7959,4755,3204,2020-01-01,zipcode,Lake city
ZCTA5 32046,12,10615,59302,861,171200,8579,3842,7623,981,3884,2163,405,190,4001,3550,451,3550,2715,835,2020-01-01,zipcode,Hilliard
ZCTA5 32054,12,11802,54931,625,112100,9730,6040,8572,1843,3307,2371,693,358,3937,3497,440,3497,2548,949,2020-01-01,zipcode,Lake butler
ZCTA5 32068,12,56217,67247,1189,168600,44047,15743,37625,3417,13853,13149,5330,1876,20934,19078,1856,19078,14720,4358,2020-01-01,zipcode,Middleburg
ZCTA5 32179,12,7843,31463,824,104700,6803,3747,6111,1005,2305,1895,495,411,4704,3571,1133,3571,2886,685,2020-01-01,zipcode,Ocklawaha
ZCTA5 32181,12,2696,41000,750,86300,2159,1115,1679,242,680,506,167,84,1473,1088,385,1088,729,359,2020-01-01,zipcode,Pomona park
ZCTA5 32207,12,35659,51030,935,175900,28867,9424,25111,4146,6176,6316,5363,3110,17670,15566,2104,15566,7550,8016,2020-01-01,zipcode,Jacksonville
ZCTA5 32220,12,12703,68526,970,155100,9906,3233,8590,1117,3446,2680,884,463,4859,4554,305,4554,3919,635,2020-01-01,zipcode,Jacksonville
ZCTA5 32233,12,25318,65873,1194,313200,21326,6422,18312,1052,4558,5643,4656,2403,11271,10003,1268,10003,5795,4208,2020-01-01,zipcode,Atlantic beach
ZCTA5 32246,12,55325,61730,1222,206300,43542,12246,37460,3175,9726,11280,9314,3965,23804,21387,2417,21387,11478,9909,2020-01-01,zipcode,Jacksonville
ZCTA5 32301,12,32552,45890,992,162000,27318,9073,18848,1839,3501,5461,4808,3239,15550,13163,2387,13163,3813,9350,2020-01-01,zipcode,Tallahassee
ZCTA5 32321,12,6534,36461,717,74100,5594,3686,4741,1109,2124,910,374,224,2475,1721,754,1721,1371,350,2020-01-01,zipcode,Bristol
ZCTA5 32324,12,4858,32500,705,62800,4326,2846,3893,771,1971,848,171,132,2299,1918,381,1918,1232,686,2020-01-01,zipcode,Chattahoochee
ZCTA5 32328,12,3682,48478,866,219300,3009,1324,2660,386,886,646,420,322,3173,1553,1620,1553,1275,278,2020-01-01,zipcode,Eastpoint
ZCTA5 32330,12,743,41429,816,83800,499,247,444,169,169,96,10,0,345,272,73,272,156,116,2020-01-01,zipcode,Greensboro
ZCTA5 32332,12,1103,26220,-666666666,72600,939,525,772,223,339,122,72,16,572,505,67,505,294,211,2020-01-01,zipcode,Gretna
ZCTA5 32334,12,1799,45758,736,110300,1475,606,1268,119,581,350,131,87,1019,792,227,792,606,186,2020-01-01,zipcode,Hosford
ZCTA5 32428,12,17807,40084,698,124500,14618,7991,13002,2185,5417,3605,1236,559,7292,6066,1226,6066,4796,1270,2020-01-01,zipcode,Chipley
ZCTA5 32430,12,935,33548,-666666666,152700,836,364,735,147,366,201,21,0,526,364,162,364,264,100,2020-01-01,zipcode,Clarksville
ZCTA5 32432,12,0,-666666666,-666666666,-666666666,0,0,0,0,0,0,0,0,0,0,0,0,0,0,2020-01-01,zipcode,Cypress
ZCTA5 32439,12,10545,68076,1056,207100,8423,2889,7311,445,2216,2540,1490,620,5028,4024,1004,4024,3163,861,2020-01-01,zipcode,Freeport
ZCTA5 32442,12,3291,40717,673,121000,2639,1101,2302,439,944,664,144,111,1785,1513,272,1513,1032,481,2020-01-01,zipcode,Grand ridge
ZCTA5 32443,12,3405,34318,675,92900,2589,1477,2180,345,871,688,148,128,1562,1236,326,1236,939,297,2020-01-01,zipcode,Greenwood
ZCTA5 32447,12,169,-666666666,-666666666,-666666666,114,114,0,0,0,0,0,0,0,0,0,0,0,0,2020-01-01,zipcode,Marianna
ZCTA5 32465,12,7429,41571,765,96000,6812,4604,6151,1340,2367,1722,532,190,3563,2516,1047,2516,1962,554,2020-01-01,zipcode,Wewahitchka
ZCTA5 32536,12,24601,72985,1100,203000,19011,6953,15556,1614,3924,5598,2484,1936,9041,8134,907,8134,5450,2684,2020-01-01,zipcode,Crestview
ZCTA5 32548,12,22818,55062,1006,206300,18961,6742,16839,1193,4980,6288,2716,1662,13462,9826,3636,9826,5769,4057,2020-01-01,zipcode,Fort walton beach
ZCTA5 35661,01,17576,60714,780,154500,14412,5815,12893,1354,4057,4620,1847,1015,7946,6932,1014,6932,5595,1337,2020-01-01,zipcode,Muscle shoals
ZCTA5 76937,48,13,-666666666,-666666666,-666666666,13,6,13,0,0,0,13,0,7,7,0,7,7,0,2020-01-01,zipcode,Eola
ZCTA5 76940,48,107,-666666666,-666666666,-666666666,81,34,76,2,6,20,37,11,54,30,24,30,30,0,2020-01-01,zipcode,Mereta
ZCTA5 76958,48,134,52614,-666666666,252300,125,97,114,0,69,31,14,0,93,59,34,59,55,4,2020-01-01,zipcode,Water valley
ZCTA5 76953,48,83,24417,-666666666,-666666666,83,39,83,0,48,35,0,0,84,54,30,54,24,30,2020-01-01,zipcode,Tennyson
ZCTA5 76116,48,50371,49174,996,218900,39726,13390,33999,4504,8772,10123,6980,3620,25519,22025,3494,22025,7505,14520,2020-01-01,zipcode,Fort worth
ZCTA5 76132,48,26265,55330,1091,309900,21591,6958,18681,790,4249,4973,5018,3651,13662,12523,1139,12523,3826,8697,2020-01-01,zipcode,Fort worth
ZCTA5 76225,48,2688,62212,797,172400,2191,786,1855,96,717,763,210,69,1093,979,114,979,798,181,2020-01-01,zipcode,Alvord
ZCTA5 76233,48,3317,77235,1025,174900,2420,786,2073,212,712,744,270,135,1306,1161,145,1161,813,348,2020-01-01,zipcode,Collinsville
ZCTA5 76249,48,8196,82551,1274,197200,6490,1688,5769,515,1553,1861,1349,491,2912,2835,77,2835,2320,515,2020-01-01,zipcode,Krum
ZCTA5 76253,48,383,54750,-666666666,-666666666,299,139,211,29,117,54,11,0,104,94,10,94,80,14,2020-01-01,zipcode,Myra
ZCTA5 76255,48,5477,44725,645,104600,4254,1927,3830,668,1230,1355,389,188,2883,2171,712,2171,1521,650,2020-01-01,zipcode,Nocona
ZCTA5 76266,48,16571,76741,1198,225900,13354,4182,11690,1461,3629,3636,2028,936,5876,5458,418,5458,4267,1191,2020-01-01,zipcode,Sanger
ZCTA5 76270,48,1932,67917,436,-666666666,1528,636,1428,290,512,435,155,36,989,758,231,758,651,107,2020-01-01,zipcode,Sunset
ZCTA5 76271,48,1984,85000,1107,252700,1404,470,1221,118,355,335,300,113,724,634,90,634,539,95,2020-01-01,zipcode,Tioga
ZCTA5 76351,48,1805,49279,538,88500,1474,544,1283,122,556,294,220,91,965,803,162,803,596,207,2020-01-01,zipcode,Archer city
ZCTA5 76354,48,12323,51574,783,106700,10299,4197,8965,758,3318,2948,1286,655,5778,5107,671,5107,3364,1743,2020-01-01,zipcode,Burkburnett
ZCTA5 76371,48,1540,58229,416,47900,1146,431,1012,191,372,242,115,92,828,589,239,589,538,51,2020-01-01,zipcode,Munday
ZCTA5 76377,48,415,36250,575,58400,345,198,318,46,147,105,16,4,292,192,100,192,164,28,2020-01-01,zipcode,Petrolia
ZCTA5 76384,48,12112,44719,680,74200,9727,3467,8384,1768,2786,2596,992,242,5933,4755,1178,4755,2822,1933,2020-01-01,zipcode,Vernon
ZCTA5 76389,48,1542,90208,612,159100,1281,427,1038,134,483,229,161,31,637,574,63,574,497,77,2020-01-01,zipcode,Windthorst
ZCTA5 79936,48,108668,57402,984,130900,85075,29968,68651,10053,16388,25069,12160,4981,36250,34755,1495,34755,23594,11161,2020-01-01,zipcode,El paso
ZCTA5 32361,12,358,-666666666,-666666666,-666666666,242,56,242,3,87,144,8,0,169,169,0,169,149,20,2020-01-01,zipcode,Wacissa
ZCTA5 32399,12,0,-666666666,-666666666,-666666666,0,0,0,0,0,0,0,0,0,0,0,0,0,0,2020-01-01,zipcode,Tallahassee
ZCTA5 32409,12,9913,56789,921,153700,7834,3265,6994,857,2486,2653,724,274,4393,3791,602,3791,3369,422,2020-01-01,zipcode,Panama city
ZCTA5 32459,12,18160,85652,1609,408300,14946,5513,13829,816,2601,4196,4218,1998,15388,7730,7658,7730,6110,1620,2020-01-01,zipcode,Santa rosa beach
ZCTA5 32460,12,6124,39712,764,96300,5213,3718,4723,969,2003,1380,213,158,2018,1747,271,1747,1235,512,2020-01-01,zipcode,Sneads
ZCTA5 32463,12,212,46875,648,83000,180,71,143,20,50,73,0,0,91,82,9,82,36,46,2020-01-01,zipcode,Wausau
ZCTA5 32531,12,5128,52378,954,195100,4431,1959,4172,422,1464,1457,402,427,2852,2404,448,2404,2192,212,2020-01-01,zipcode,Baker
ZCTA5 32547,12,34071,53236,1083,203100,27606,9263,23898,2416,6108,8914,4474,1986,15435,14232,1203,14232,7246,6986,2020-01-01,zipcode,Fort walton beach
ZCTA5 32561,12,10296,95906,1419,416800,8412,3711,7670,236,805,2247,2464,1918,6909,4543,2366,4543,3586,957,2020-01-01,zipcode,Gulf breeze
ZCTA5 32565,12,4793,57436,986,117800,3940,1706,3550,372,1324,1171,549,134,2345,2010,335,2010,1623,387,2020-01-01,zipcode,Jay
ZCTA5 32570,12,32341,60933,1018,165200,26524,11081,23155,2030,7282,8889,3544,1410,14255,12776,1479,12776,8628,4148,2020-01-01,zipcode,Milton
ZCTA5 32606,12,23748,61177,1212,237900,19199,6794,16787,454,2561,4258,4274,5240,11616,10012,1604,10012,4768,5244,2020-01-01,zipcode,Gainesville
ZCTA5 32615,12,13669,63580,1034,205400,10795,3871,9682,440,2664,2906,2364,1308,6100,5430,670,5430,4166,1264,2020-01-01,zipcode,Alachua
ZCTA5 32617,12,4768,42377,647,124000,4169,2265,3711,255,1971,845,495,145,1874,1662,212,1662,1289,373,2020-01-01,zipcode,Anthony
ZCTA5 32639,12,270,34353,-666666666,-666666666,213,147,213,23,131,0,29,30,153,129,24,129,116,13,2020-01-01,zipcode,Gulf hammock
ZCTA5 32653,12,14363,63333,948,202100,11516,4816,10437,431,2140,2855,2690,2321,6410,6106,304,6106,4775,1331,2020-01-01,zipcode,Gainesville
ZCTA5 32680,12,10428,41935,625,85900,8899,5221,7967,1599,3746,1773,471,378,6060,4361,1699,4361,3634,727,2020-01-01,zipcode,Old town
ZCTA5 32693,12,11997,40060,713,115700,9723,4889,8018,1223,3118,2657,752,268,4948,4305,643,4305,3372,933,2020-01-01,zipcode,Trenton
ZCTA5 32127,12,29082,52438,1124,211300,24986,11826,22615,1865,6897,7936,3404,2513,15955,12582,3373,12582,9372,3210,2020-01-01,zipcode,Port orange
ZCTA5 32136,12,8372,52708,1206,281100,7590,4492,7304,281,1946,2632,1522,923,5424,3981,1443,3981,3218,763,2020-01-01,zipcode,Flagler beach
ZCTA5 32193,12,969,29054,834,204900,793,560,684,112,377,133,31,31,767,514,253,514,400,114,2020-01-01,zipcode,Welaka
ZCTA5 32195,12,3291,39007,1580,122100,3101,1566,2766,579,817,928,321,121,1635,1433,202,1433,1269,164,2020-01-01,zipcode,Weirsdale
ZCTA5 32040,12,8450,60155,851,118200,6441,2731,5658,790,2590,1669,453,156,3300,2920,380,2920,2580,340,2020-01-01,zipcode,Glen saint mary
ZCTA5 32044,12,2263,39000,1051,68200,1651,943,1440,379,473,497,65,26,941,822,119,822,475,347,2020-01-01,zipcode,Hampton
ZCTA5 32112,12,7342,33038,627,107100,5820,2982,4986,1674,1744,1019,391,158,3750,2809,941,2809,1936,873,2020-01-01,zipcode,Crescent city
ZCTA5 32140,12,1575,48036,-666666666,74800,1442,632,1239,202,467,509,55,6,750,599,151,599,506,93,2020-01-01,zipcode,Florahome
ZCTA5 32147,12,597,103564,-666666666,-666666666,442,71,321,42,118,46,115,0,239,150,89,150,103,47,2020-01-01,zipcode,Hollister
ZCTA5 32508,12,5144,50625,1385,-666666666,4794,435,1136,10,154,486,413,73,661,543,118,543,0,543,2020-01-01,zipcode,Pensacola
ZCTA5 32535,12,5683,36855,675,72500,5083,3298,4512,989,2068,1168,188,99,2007,1700,307,1700,1137,563,2020-01-01,zipcode,Century
ZCTA5 32542,12,3725,47250,1674,-666666666,2805,255,1328,60,200,557,399,112,1064,842,222,842,0,842,2020-01-01,zipcode,Eglin afb
ZCTA5 08830,34,17343,101793,1821,317200,14073,4731,12911,1151,3394,1870,3909,2587,6625,6304,321,6304,4513,1791,2020-01-01,zipcode,Iselin
ZCTA5 08832,34,2825,68049,1435,307100,2262,648,1619,263,645,245,335,131,995,966,29,966,184,782,2020-01-01,zipcode,Keasbey
ZCTA5 08001,34,847,73398,960,232800,711,284,501,7,169,246,52,27,281,281,0,281,213,68,2020-01-01,zipcode,Alloway
ZCTA5 08006,34,404,75972,-666666666,669400,358,213,338,8,43,58,154,75,1161,189,972,189,174,15,2020-01-01,zipcode,Barnegat light
ZCTA5 08010,34,11115,64071,1310,185000,9134,3028,7980,924,3064,2264,1184,544,4665,4244,421,4244,2826,1418,2020-01-01,zipcode,Beverly
ZCTA5 08023,34,274,32197,1309,150700,258,127,226,25,75,126,0,0,174,128,46,128,43,85,2020-01-01,zipcode,Deepwater
ZCTA5 08027,34,4816,76648,1113,180200,4051,1622,3696,234,1513,1005,785,159,2046,1895,151,1895,1589,306,2020-01-01,zipcode,Gibbstown
ZCTA5 08048,34,12179,106581,1354,331100,9912,2781,8734,397,2042,2605,2284,1406,5075,4735,340,4735,3584,1151,2020-01-01,zipcode,Lumberton
ZCTA5 08069,34,12442,51964,1048,140900,9917,3900,8334,1265,3519,2310,920,320,5401,4763,638,4763,2316,2447,2020-01-01,zipcode,Penns grove
ZCTA5 08106,34,9811,82500,993,221300,7848,2104,6796,162,2272,1844,1854,664,4058,3878,180,3878,2380,1498,2020-01-01,zipcode,Audubon
ZCTA5 08107,34,13533,60842,1121,189800,11100,3425,9453,884,3005,2698,1813,1053,5909,5476,433,5476,3000,2476,2020-01-01,zipcode,Oaklyn
ZCTA5 08201,34,10029,62269,1464,190100,7970,2853,6889,644,2236,1744,1626,639,4220,3752,468,3752,2527,1225,2020-01-01,zipcode,Absecon
ZCTA5 08004,34,11366,86607,1229,199400,9547,2895,8589,833,2905,2658,1681,512,4399,4072,327,4072,3392,680,2020-01-01,zipcode,Atco
ZCTA5 08034,34,18659,95248,1496,254000,15118,4957,13807,760,2525,3437,4202,2883,7598,7233,365,7233,5616,1617,2020-01-01,zipcode,Cherry hill
ZCTA5 08045,34,2811,69333,914,176900,2460,984,2239,187,786,589,213,464,1239,1162,77,1162,800,362,2020-01-01,zipcode,Lawnside
ZCTA5 08055,34,27307,132732,1409,359500,22537,7618,19788,429,3307,4365,7465,4222,10269,9895,374,9895,8752,1143,2020-01-01,zipcode,Medford
ZCTA5 08063,34,3007,65720,1306,146300,2428,833,2024,181,931,637,217,58,1133,1055,78,1055,918,137,2020-01-01,zipcode,National park
ZCTA5 08065,34,7162,73212,1456,175400,5781,1695,4914,212,1620,1728,1018,336,3133,2761,372,2761,1895,866,2020-01-01,zipcode,Palmyra
ZCTA5 08070,34,12291,67906,1018,157100,10020,3812,9100,902,3607,2987,993,611,5841,5129,712,5129,3764,1365,2020-01-01,zipcode,Pennsville
ZCTA5 08072,34,221,73882,-666666666,131600,204,65,193,4,77,52,45,15,107,107,0,107,107,0,2020-01-01,zipcode,Quinton
ZCTA5 08078,34,8307,71495,1014,163000,6501,1992,5744,398,2102,1706,1085,453,3408,3123,285,3123,2184,939,2020-01-01,zipcode,Runnemede
ZCTA5 08083,34,10137,74798,1112,199800,8355,2420,7253,512,2258,2317,1397,769,4151,3935,216,3935,2889,1046,2020-01-01,zipcode,Somerdale
ZCTA5 08089,34,4611,81850,1125,196500,3889,1317,3343,283,1289,1186,409,176,1581,1486,95,1486,1363,123,2020-01-01,zipcode,Waterford works
ZCTA5 08223,34,4277,83750,1394,273800,3574,1287,3230,46,784,981,920,499,2504,1875,629,1875,1672,203,2020-01-01,zipcode,Marmora
ZCTA5 08215,34,14068,71497,1030,225900,11487,4651,10096,1025,3876,3034,1303,858,5642,5163,479,5163,3651,1512,2020-01-01,zipcode,Egg harbor city
ZCTA5 08221,34,6719,116058,1640,283200,5581,1948,4968,248,901,1104,1516,1199,2745,2523,222,2523,2185,338,2020-01-01,zipcode,Linwood
ZCTA5 08224,34,443,84500,1125,248800,346,118,308,33,104,87,68,16,169,142,27,142,121,21,2020-01-01,zipcode,New gretna
ZCTA5 08330,34,27385,70571,1382,190000,22349,7929,19163,1240,6223,5434,4459,1807,11797,10681,1116,10681,7830,2851,2020-01-01,zipcode,Mays landing
ZCTA5 35020,01,24821,28129,746,73700,19958,9588,17161,2952,6869,5222,1658,460,13117,10438,2679,10438,5745,4693,2020-01-01,zipcode,Bessemer
ZCTA5 35034,01,6907,33571,705,69800,5586,3884,4679,1280,2244,820,212,123,2012,1702,310,1702,1067,635,2020-01-01,zipcode,Brent
ZCTA5 76520,48,8033,47991,675,99800,5921,2770,5257,1070,2015,1430,535,207,3726,2881,845,2881,1929,952,2020-01-01,zipcode,Cameron
ZCTA5 76522,48,37382,56002,855,121100,28482,10704,24160,1459,6577,11305,3336,1483,15848,14201,1647,14201,8635,5566,2020-01-01,zipcode,Copperas cove
ZCTA5 76531,48,4595,49550,607,137600,3806,1874,3253,576,984,1039,515,139,2379,1537,842,1537,1314,223,2020-01-01,zipcode,Hamilton
ZCTA5 76534,48,3119,63145,853,159100,2405,941,2216,335,659,761,284,177,1257,1116,141,1116,892,224,2020-01-01,zipcode,Holland
ZCTA5 76543,48,32031,44131,888,96900,24144,7676,19672,1978,5735,8959,2096,904,14408,12618,1790,12618,4786,7832,2020-01-01,zipcode,Killeen
ZCTA5 76548,48,31247,72513,907,200900,23921,8427,19896,1771,4324,6772,4796,2233,12118,10945,1173,10945,6104,4841,2020-01-01,zipcode,Harker heights
ZCTA5 76621,48,1061,78889,775,199600,788,243,725,26,183,277,177,62,515,416,99,416,379,37,2020-01-01,zipcode,Abbott
ZCTA5 76628,48,101,27917,-666666666,-666666666,89,24,70,27,18,25,0,0,54,43,11,43,38,5,2020-01-01,zipcode,Brandon
ZCTA5 76643,48,14705,71096,1224,174900,11335,4146,9816,514,2133,3910,2161,1098,5329,5167,162,5167,3565,1602,2020-01-01,zipcode,Hewitt
ZCTA5 76648,48,2697,48229,729,84000,2221,1029,1922,268,656,710,215,73,1323,1014,309,1014,727,287,2020-01-01,zipcode,Hubbard
ZCTA5 76657,48,11151,80769,1010,253000,8877,2736,7549,587,2043,2654,1487,778,4156,3784,372,3784,2837,947,2020-01-01,zipcode,Mc gregor
ZCTA5 76012,48,26730,70569,984,217900,21740,7427,18549,1178,3869,6034,4729,2739,11577,10465,1112,10465,6600,3865,2020-01-01,zipcode,Arlington
ZCTA5 76013,48,34763,58887,1028,213400,28337,9596,22713,1896,5209,6587,5911,3110,14051,13041,1010,13041,6516,6525,2020-01-01,zipcode,Arlington
ZCTA5 76017,48,46312,77109,1154,196000,37647,11446,30802,2414,6261,10906,7818,3403,17157,16288,869,16288,11184,5104,2020-01-01,zipcode,Arlington
ZCTA5 76020,48,30487,77359,919,179900,24316,9319,21420,2426,7140,7835,2920,1099,12162,10767,1395,10767,8396,2371,2020-01-01,zipcode,Azle
ZCTA5 76054,48,12178,100271,1406,268100,9920,3229,8761,323,1535,2998,2749,1156,4647,4489,158,4489,3651,838,2020-01-01,zipcode,Hurst
ZCTA5 76059,48,5716,42148,854,112900,4411,1857,3186,686,1025,807,499,169,2053,1740,313,1740,643,1097,2020-01-01,zipcode,Keene
ZCTA5 33170,12,13254,51778,1285,283900,10638,4405,9202,1989,3042,2201,1462,508,4040,3680,360,3680,2219,1461,2020-01-01,zipcode,Miami
ZCTA5 33316,12,10447,80694,1346,635100,9320,3530,8643,449,1175,2247,2730,2042,7897,5042,2855,5042,3138,1904,2020-01-01,zipcode,Fort lauderdale
ZCTA5 33470,12,28587,92217,2057,363700,23900,8216,20528,2755,5397,7438,3417,1521,9567,8669,898,8669,7755,914,2020-01-01,zipcode,Loxahatchee
ZCTA5 33034,12,23356,36250,1119,139900,15984,8316,13384,5093,3823,3336,882,250,5819,5056,763,5056,1639,3417,2020-01-01,zipcode,Homestead
ZCTA5 33334,12,30333,58346,1247,321000,25841,7252,22897,2791,5993,6321,4485,3307,13712,12353,1359,12353,7190,5163,2020-01-01,zipcode,Fort lauderdale
ZCTA5 33446,12,26415,60607,1305,302500,24031,15705,23331,1167,4792,6311,5914,5147,17521,13280,4241,13280,11552,1728,2020-01-01,zipcode,Delray beach
ZCTA5 33570,12,29576,54977,929,178000,23012,9084,19883,3149,6540,6514,2354,1326,11932,9788,2144,9788,6937,2851,2020-01-01,zipcode,Ruskin
ZCTA5 33634,12,23071,60237,1343,187600,18867,6038,16178,2183,4620,4470,3491,1414,8003,7544,459,7544,4314,3230,2020-01-01,zipcode,Tampa
ZCTA5 33890,12,5274,38700,765,91900,3904,1782,3308,795,1675,535,249,54,2039,1636,403,1636,1224,412,2020-01-01,zipcode,Zolfo springs
ZCTA5 33843,12,11976,46776,794,68500,10563,6694,9234,2427,3446,2100,665,596,5665,3945,1720,3945,3278,667,2020-01-01,zipcode,Frostproof
ZCTA5 32569,12,12789,58832,1058,213500,10595,3194,9316,488,2352,3255,2253,968,5464,5001,463,5001,3553,1448,2020-01-01,zipcode,Mary esther
ZCTA5 32312,12,32380,102480,1298,312300,25865,8674,21988,369,1929,5385,7767,6538,13287,12466,821,12466,10624,1842,2020-01-01,zipcode,Tallahassee
ZCTA5 32577,12,4978,71600,876,139300,4078,1742,3445,259,965,1350,618,253,2076,1942,134,1942,1744,198,2020-01-01,zipcode,Molino
ZCTA5 32578,12,33846,90964,1389,296200,26653,9571,23139,689,4593,7892,5155,4810,13923,12684,1239,12684,9670,3014,2020-01-01,zipcode,Niceville
ZCTA5 32603,12,7096,18116,982,252500,6895,4136,1262,54,104,157,339,608,2294,1753,541,1753,224,1529,2020-01-01,zipcode,Gainesville
ZCTA5 32619,12,5540,47233,597,113200,4564,1894,3679,497,1622,1155,270,135,2359,2032,327,2032,1755,277,2020-01-01,zipcode,Bell
ZCTA5 32648,12,399,54545,-666666666,169300,279,132,222,47,90,74,11,0,530,114,416,114,111,3,2020-01-01,zipcode,Horseshoe beach
ZCTA5 32681,12,30,-666666666,-666666666,-666666666,30,30,30,0,30,0,0,0,15,15,0,15,15,0,2020-01-01,zipcode,Orange lake
ZCTA5 32708,12,46542,76542,1383,264700,39327,13424,34308,1382,5343,11452,11134,4997,19566,18514,1052,18514,14118,4396,2020-01-01,zipcode,Winter springs
ZCTA5 32724,12,37856,54234,1053,191200,31328,14991,26540,1980,7443,9200,5096,2821,16301,14929,1372,14929,10854,4075,2020-01-01,zipcode,Deland
ZCTA5 32735,12,4133,55861,1350,140600,3546,2142,3248,283,1248,1133,433,151,2063,1779,284,1779,1393,386,2020-01-01,zipcode,Grand island
ZCTA5 32764,12,3043,75882,-666666666,287400,2756,1173,2390,215,884,797,410,84,1442,1150,292,1150,1070,80,2020-01-01,zipcode,Osteen
ZCTA5 32778,12,22486,46451,988,159800,19052,10505,17419,1822,5244,5897,3160,1296,11814,9974,1840,9974,7457,2517,2020-01-01,zipcode,Tavares
ZCTA5 32963,12,15383,126643,1342,660300,14579,9582,13862,165,1471,2863,4888,4475,12511,7574,4937,7574,7073,501,2020-01-01,zipcode,Vero beach
ZCTA5 32970,12,246,-666666666,-666666666,-666666666,246,183,246,14,209,23,0,0,119,69,50,69,46,23,2020-01-01,zipcode,Wabasso
ZCTA5 32350,12,1414,39125,802,70900,1261,739,1189,163,413,382,212,19,795,693,102,693,590,103,2020-01-01,zipcode,Pinetta
ZCTA5 32404,12,40300,55363,1004,166300,32376,13267,28220,3501,9059,10898,2827,1935,17880,15098,2782,15098,11112,3986,2020-01-01,zipcode,Panama city
ZCTA5 32420,12,2263,40909,676,93600,2006,971,1831,365,724,566,137,39,1550,1162,388,1162,1068,94,2020-01-01,zipcode,Alford
ZCTA5 32424,12,7643,39102,521,101900,6274,4077,5777,1283,2564,1343,391,196,2987,2216,771,2216,1642,574,2020-01-01,zipcode,Blountstown
ZCTA5 32455,12,4138,41637,692,89600,3597,1676,3124,649,1566,627,231,51,2060,1663,397,1663,1324,339,2020-01-01,zipcode,Ponce de leon
ZCTA5 32534,12,14759,50690,1074,120500,12210,4500,10613,605,3014,4606,1757,631,6899,6321,578,6321,4114,2207,2020-01-01,zipcode,Pensacola
ZCTA5 32462,12,3835,31421,704,119700,3335,1811,2889,542,1397,754,97,99,1818,1462,356,1462,1190,272,2020-01-01,zipcode,Vernon
ZCTA5 32466,12,4927,56219,1316,118500,3925,1896,3331,412,1279,1370,144,126,2272,1808,464,1808,1546,262,2020-01-01,zipcode,Youngstown
ZCTA5 32514,12,43323,53275,1066,155700,35024,13034,27924,2489,6633,9853,5835,3114,19006,17294,1712,17294,8438,8856,2020-01-01,zipcode,Pensacola
ZCTA5 32567,12,3325,53125,574,120400,2564,1228,2384,320,930,932,165,37,1709,1398,311,1398,1082,316,2020-01-01,zipcode,Laurel hill
ZCTA5 32605,12,26305,70517,1244,210100,22072,7815,19155,965,2535,4894,5677,5084,11716,10815,901,10815,7920,2895,2020-01-01,zipcode,Gainesville
ZCTA5 78612,48,16234,71205,1214,191000,11166,4847,9229,2103,2357,2896,1126,747,4437,4119,318,4119,3446,673,2020-01-01,zipcode,Cedar creek
ZCTA5 78616,48,8472,55337,895,148900,6096,2138,4851,1433,1351,1475,458,134,2831,2491,340,2491,1852,639,2020-01-01,zipcode,Dale
ZCTA5 78879,48,145,61389,-666666666,-666666666,145,63,109,0,0,64,45,0,295,50,245,50,50,0,2020-01-01,zipcode,Rio frio
ZCTA5 78886,48,490,-666666666,-666666666,-666666666,416,211,304,33,103,112,49,7,238,150,88,150,150,0,2020-01-01,zipcode,Yancey
ZCTA5 78940,48,2370,70278,731,174500,2048,885,1847,94,810,546,311,86,1401,846,555,846,773,73,2020-01-01,zipcode,Fayetteville
ZCTA5 78669,48,14038,133673,941,447700,11092,4180,10266,375,1318,2505,3493,2575,6771,5185,1586,5185,4763,422,2020-01-01,zipcode,Spicewood
ZCTA5 78701,48,11903,127782,2220,498400,11660,2434,10572,426,647,1338,4826,3335,8663,7287,1376,7287,2748,4539,2020-01-01,zipcode,Austin
ZCTA5 78735,48,18211,100000,1659,555300,14426,4085,13014,597,1221,2620,5084,3492,8979,7862,1117,7862,3871,3991,2020-01-01,zipcode,Austin
ZCTA5 78752,48,20779,49214,1232,292500,17285,3761,14561,2461,2624,3394,3958,2124,9834,9133,701,9133,2129,7004,2020-01-01,zipcode,Austin
ZCTA5 78758,48,50575,60769,1278,261300,40475,9204,35263,5398,6700,8045,9835,5285,23877,21851,2026,21851,6301,15550,2020-01-01,zipcode,Austin
ZCTA5 78801,48,22707,44923,834,103400,17389,7159,13993,3477,3998,3803,2081,634,8768,7386,1382,7386,4996,2390,2020-01-01,zipcode,Uvalde
ZCTA5 78850,48,1056,72782,694,172900,806,451,630,51,159,284,66,70,462,303,159,303,268,35,2020-01-01,zipcode,D hanis
ZCTA5 78873,48,1839,41083,916,216100,1424,696,1268,193,363,453,156,103,1450,679,771,679,559,120,2020-01-01,zipcode,Leakey
ZCTA5 78942,48,9565,55035,901,150400,7562,2657,6449,1299,2382,1901,662,205,3871,3194,677,3194,2285,909,2020-01-01,zipcode,Giddings
ZCTA5 78956,48,5977,61652,886,171300,4706,1870,4084,546,1463,1224,619,232,2925,1932,993,1932,1496,436,2020-01-01,zipcode,Schulenburg
ZCTA5 78005,48,1176,56357,-666666666,219300,1078,373,1046,565,287,82,35,77,543,465,78,465,313,152,2020-01-01,zipcode,Bigfoot
ZCTA5 78013,48,6210,75060,896,258400,5220,1707,4338,655,1123,1512,706,342,2587,2030,557,2030,1671,359,2020-01-01,zipcode,Comfort
ZCTA5 78201,48,50336,37518,840,126100,40605,16756,33774,9304,10052,8660,3064,2694,18469,16631,1838,16631,7899,8732,2020-01-01,zipcode,San antonio
ZCTA5 78202,48,11675,31802,854,89200,9264,4037,7938,2197,2574,1754,793,620,4709,4056,653,4056,2010,2046,2020-01-01,zipcode,San antonio
ZCTA5 78211,48,34539,41695,896,76900,27193,11206,22969,9290,7601,4699,1025,354,10080,9074,1006,9074,5802,3272,2020-01-01,zipcode,San antonio
ZCTA5 78230,48,45661,61948,1059,254900,37626,12417,32031,2186,5959,8753,8974,6159,19866,18527,1339,18527,9284,9243,2020-01-01,zipcode,San antonio
ZCTA5 78520,48,59388,37803,690,92400,45321,20981,34682,12330,8308,7322,4726,1996,20510,18128,2382,18128,10623,7505,2020-01-01,zipcode,Brownsville
ZCTA5 78401,48,4823,28750,849,83400,4528,3209,4037,1007,1293,1212,371,154,2146,1653,493,1653,313,1340,2020-01-01,zipcode,Corpus christi
ZCTA5 78407,48,2292,41250,964,76500,1860,736,1421,390,710,221,46,54,1136,642,494,642,327,315,2020-01-01,zipcode,Corpus christi
ZCTA5 78516,48,36248,36747,643,62900,25377,11803,20121,9265,4939,3847,1739,331,12562,10443,2119,10443,8074,2369,2020-01-01,zipcode,Alamo
ZCTA5 78549,48,1095,16705,-666666666,48900,699,541,564,378,131,46,0,9,372,286,86,286,245,41,2020-01-01,zipcode,Hargill
ZCTA5 78552,48,38982,51270,816,100400,28838,11784,24851,5238,6813,7561,3424,1815,15664,12884,2780,12884,9941,2943,2020-01-01,zipcode,Harlingen
ZCTA5 75672,48,16480,56497,863,138800,12956,5848,11152,1157,3416,3989,1816,774,7204,5937,1267,5937,4768,1169,2020-01-01,zipcode,Marshall
ZCTA5 75702,48,27678,41064,746,81200,20722,7879,16565,5150,4727,5395,976,317,9611,8027,1584,8027,4135,3892,2020-01-01,zipcode,Tyler
ZCTA5 75754,48,8021,81427,954,192800,6618,2738,5551,594,1437,2661,595,264,3074,2769,305,2769,2170,599,2020-01-01,zipcode,Ben wheeler
ZCTA5 75763,48,6359,59987,789,107800,5144,2453,4586,408,1653,1757,377,391,3204,2437,767,2437,2150,287,2020-01-01,zipcode,Frankston
ZCTA5 75006,48,52231,69501,1223,230400,41243,11002,35590,7123,8665,8437,7902,3463,20193,19537,656,19537,10077,9460,2020-01-01,zipcode,Carrollton
ZCTA5 75019,48,43137,122033,1492,414000,32968,8491,28927,686,2486,5621,11537,8597,16801,16190,611,16190,10972,5218,2020-01-01,zipcode,Coppell
ZCTA5 75021,48,9454,53967,911,136200,7426,2919,6743,902,2595,2236,721,289,3884,3445,439,3445,2721,724,2020-01-01,zipcode,Denison
ZCTA5 75025,48,54653,118725,1496,363100,42961,13441,37295,1443,4028,7556,14098,10170,19307,18800,507,18800,12708,6092,2020-01-01,zipcode,Plano
ZCTA5 75160,48,24494,57740,1040,142800,19069,6857,16142,2956,5446,4770,2063,907,8554,7941,613,7941,5091,2850,2020-01-01,zipcode,Terrell
ZCTA5 75201,48,18032,94872,1797,630100,17233,2273,14557,328,1270,2534,6407,4018,12839,11332,1507,11332,1197,10135,2020-01-01,zipcode,Dallas
ZCTA5 75210,48,9504,26801,814,69200,6437,2441,5180,1940,1658,1244,188,150,3553,3108,445,3108,965,2143,2020-01-01,zipcode,Dallas
ZCTA5 75212,48,28017,40024,770,112500,19932,8349,15686,6455,5026,2566,1316,323,8789,8183,606,8183,4203,3980,2020-01-01,zipcode,Dallas
ZCTA5 75240,48,26841,50767,1067,236500,20330,4740,16352,4481,3289,3203,3633,1746,11371,10283,1088,10283,2739,7544,2020-01-01,zipcode,Dallas
ZCTA5 75243,48,68253,44542,975,264800,52679,14658,45281,6503,9830,14506,8740,5702,31809,28350,3459,28350,6884,21466,2020-01-01,zipcode,Dallas
ZCTA5 75246,48,2553,43153,877,338500,2168,613,2070,440,429,644,387,170,1599,1319,280,1319,206,1113,2020-01-01,zipcode,Dallas
ZCTA5 75249,48,18374,63214,1620,161900,13100,3718,10753,1221,3011,3657,2163,701,5612,5574,38,5574,4141,1433,2020-01-01,zipcode,Dallas
ZCTA5 75413,48,287,57500,990,62300,234,98,208,70,75,53,5,5,144,108,36,108,83,25,2020-01-01,zipcode,Bailey
ZCTA5 75417,48,2563,40221,558,103000,1996,964,1678,281,584,540,174,99,1226,957,269,957,826,131,2020-01-01,zipcode,Bogata
ZCTA5 75423,48,3423,65700,874,108300,2727,1239,2418,171,1083,777,305,82,1322,1124,198,1124,940,184,2020-01-01,zipcode,Celeste
ZCTA5 75426,48,4177,33444,583,52700,3684,1807,3487,310,1535,1220,314,108,2870,2072,798,2072,1428,644,2020-01-01,zipcode,Clarksville
ZCTA5 75436,48,2122,44514,477,119700,1674,839,1422,169,533,511,171,38,1034,805,229,805,630,175,2020-01-01,zipcode,Detroit
ZCTA5 75439,48,1186,60139,847,98100,898,307,739,118,310,241,39,31,486,431,55,431,247,184,2020-01-01,zipcode,Ector
ZCTA5 75457,48,6243,59298,844,140200,4865,1489,4164,410,1158,1262,996,338,3211,2154,1057,2154,1621,533,2020-01-01,zipcode,Mount vernon
ZCTA5 75002,48,73916,104501,1577,291600,55973,17247,46992,2549,7184,13353,16679,7227,23526,22483,1043,22483,17953,4530,2020-01-01,zipcode,Allen
ZCTA5 76207,48,14794,74518,1222,264400,12328,5393,10637,842,1902,3601,2714,1578,6119,5733,386,5733,3807,1926,2020-01-01,zipcode,Denton
ZCTA5 76252,48,2441,90903,886,210700,2026,640,1741,136,487,449,414,255,1109,942,167,942,747,195,2020-01-01,zipcode,Muenster
ZCTA5 76264,48,1368,57308,810,164800,1209,413,1085,57,303,553,157,15,689,600,89,600,436,164,2020-01-01,zipcode,Sadler
ZCTA5 76309,48,13546,50272,850,105000,10582,3527,9129,792,2953,3097,1487,800,6434,5414,1020,5414,3336,2078,2020-01-01,zipcode,Wichita falls
ZCTA5 76310,48,18908,69634,873,147600,14393,4480,12977,1061,3533,4412,2600,1371,7927,7230,697,7230,5167,2063,2020-01-01,zipcode,Wichita falls
ZCTA5 76363,48,399,62813,-666666666,23700,303,122,245,52,93,72,27,1,175,125,50,125,111,14,2020-01-01,zipcode,Goree
ZCTA5 76453,48,1438,70179,847,218400,1171,680,1136,134,356,278,184,184,818,595,223,595,516,79,2020-01-01,zipcode,Gordon
ZCTA5 76469,48,90,-666666666,-666666666,55600,81,54,76,21,23,28,2,2,72,41,31,41,41,0,2020-01-01,zipcode,Putnam
ZCTA5 76470,48,3518,32298,650,61000,2737,1382,2273,525,676,862,111,99,1819,1304,515,1304,897,407,2020-01-01,zipcode,Ranger
ZCTA5 76481,48,191,27212,-666666666,-666666666,109,65,92,43,37,0,12,0,87,49,38,49,36,13,2020-01-01,zipcode,South bend
ZCTA5 76523,48,0,-666666666,-666666666,-666666666,0,0,0,0,0,0,0,0,0,0,0,0,0,0,2020-01-01,zipcode,Davilla
ZCTA5 76525,48,1188,56914,644,97900,975,446,881,117,229,300,134,101,733,525,208,525,412,113,2020-01-01,zipcode,Evant
ZCTA5 76528,48,19224,54052,675,130600,15559,9211,14386,2342,4342,5499,1278,925,6676,5708,968,5708,4313,1395,2020-01-01,zipcode,Gatesville
ZCTA5 76301,48,15113,28082,679,56000,12007,5575,10226,2331,3930,2667,804,494,7892,6201,1691,6201,3008,3193,2020-01-01,zipcode,Wichita falls
ZCTA5 76882,48,250,50469,-666666666,213000,191,98,187,9,34,96,38,10,178,108,70,108,85,23,2020-01-01,zipcode,Talpa
ZCTA5 76631,48,681,70125,790,113900,540,196,427,62,119,148,73,25,231,183,48,183,148,35,2020-01-01,zipcode,Bynum
ZCTA5 76635,48,1330,38533,663,66800,949,404,833,177,241,266,90,59,577,449,128,449,316,133,2020-01-01,zipcode,Coolidge
ZCTA5 76638,48,3355,89000,1085,243000,2437,981,2193,59,649,728,482,275,1233,1134,99,1134,1043,91,2020-01-01,zipcode,Crawford
ZCTA5 76457,48,4045,39984,717,109000,3144,1430,2808,161,1324,909,314,100,2222,1473,749,1473,1110,363,2020-01-01,zipcode,Hico
ZCTA5 76436,48,148,91806,-666666666,355600,130,49,119,0,52,21,24,22,118,55,63,55,44,11,2020-01-01,zipcode,Carlton
ZCTA5 76448,48,4983,42680,818,123800,4156,2010,3791,449,1255,1062,511,514,3148,2004,1144,2004,1559,445,2020-01-01,zipcode,Eastland
ZCTA5 76452,48,80,-666666666,-666666666,-666666666,49,18,35,0,0,35,0,0,52,27,25,27,27,0,2020-01-01,zipcode,Energy
ZCTA5 76471,48,1772,35500,593,57400,1494,772,1259,149,403,481,156,70,1194,734,460,734,580,154,2020-01-01,zipcode,Rising star
ZCTA5 76487,48,2230,83274,1260,164800,1697,700,1488,180,565,474,154,115,1038,779,259,779,719,60,2020-01-01,zipcode,Poolville
ZCTA5 76524,48,4072,67788,951,158300,3308,1204,2707,418,879,867,232,311,1396,1342,54,1342,1082,260,2020-01-01,zipcode,Eddy
ZCTA5 76541,48,18396,31515,711,71600,14449,5443,11378,2020,3530,4634,1021,173,10029,7766,2263,7766,1967,5799,2020-01-01,zipcode,Killeen
ZCTA5 76554,48,2461,57301,930,133200,1771,537,1533,187,524,587,198,37,929,835,94,835,607,228,2020-01-01,zipcode,Little river academy
ZCTA5 76556,48,1707,60342,650,103800,1391,475,1118,145,427,335,116,95,861,636,225,636,577,59,2020-01-01,zipcode,Milano
ZCTA5 76887,48,89,78295,-666666666,232100,89,54,89,0,35,12,14,28,114,71,43,71,60,11,2020-01-01,zipcode,Voca
ZCTA5 76934,48,974,51331,784,58000,788,424,636,83,257,224,43,29,378,297,81,297,261,36,2020-01-01,zipcode,Carlsbad
ZCTA5 76950,48,3824,61310,648,101800,2813,942,2499,609,804,624,298,164,2004,1286,718,1286,877,409,2020-01-01,zipcode,Sonora
ZCTA5 76071,48,4173,64583,878,181600,3181,1155,2545,452,1021,750,274,48,1278,1138,140,1138,892,246,2020-01-01,zipcode,Newark
ZCTA5 76105,48,22922,38436,879,80800,16862,7249,12794,5861,4105,2253,350,225,7572,6637,935,6637,3729,2908,2020-01-01,zipcode,Fort worth
ZCTA5 76110,48,33720,56389,1025,144100,25722,9354,20841,6626,4336,4118,3521,2240,12384,11134,1250,11134,6840,4294,2020-01-01,zipcode,Fort worth
ZCTA5 76707,48,15595,27259,836,81200,11129,4522,8686,2522,2585,2216,941,422,6385,5437,948,5437,2767,2670,2020-01-01,zipcode,Waco
ZCTA5 76827,48,592,-666666666,-666666666,160000,496,330,491,119,118,215,32,7,399,289,110,289,266,23,2020-01-01,zipcode,Brookesmith
ZCTA5 76831,48,0,-666666666,-666666666,-666666666,0,0,0,0,0,0,0,0,94,0,94,0,0,0,2020-01-01,zipcode,Castell
ZCTA5 76834,48,5370,45795,713,74600,4333,1806,3858,586,1545,1183,350,194,3319,2267,1052,2267,1681,586,2020-01-01,zipcode,Coleman
ZCTA5 76837,48,2070,37981,625,81200,1794,1385,1673,696,523,316,102,36,807,480,327,480,357,123,2020-01-01,zipcode,Eden
ZCTA5 76845,48,256,68125,-666666666,165000,207,79,195,14,62,50,52,17,179,100,79,100,88,12,2020-01-01,zipcode,Gouldbusk
ZCTA5 76856,48,3746,61011,728,214500,2930,1095,2463,376,475,772,607,233,2125,1445,680,1445,1061,384,2020-01-01,zipcode,Mason
ZCTA5 76858,48,300,39821,-666666666,50500,259,144,231,97,30,56,23,25,214,131,83,131,101,30,2020-01-01,zipcode,Melvin
ZCTA5 76009,48,19618,59103,907,127700,14821,6183,13039,3112,5251,3244,1140,292,7399,6363,1036,6363,4651,1712,2020-01-01,zipcode,Alvarado
ZCTA5 76031,48,18432,57237,941,146600,14270,5966,12166,2287,4871,2894,1625,489,6495,6115,380,6115,4509,1606,2020-01-01,zipcode,Cleburne
ZCTA5 76036,48,27835,78485,1329,199700,20734,6891,17447,1322,5390,6471,2925,1339,9535,8872,663,8872,6582,2290,2020-01-01,zipcode,Crowley
ZCTA5 76302,48,12867,46442,848,114400,9753,3551,8439,1009,2372,3025,1555,478,5595,5264,331,5264,3251,2013,2020-01-01,zipcode,Wichita falls
ZCTA5 76308,48,19937,57223,874,156300,16373,5398,11854,463,2565,4510,2645,1671,9523,8337,1186,8337,4674,3663,2020-01-01,zipcode,Wichita falls
ZCTA5 76370,48,325,61667,-666666666,19800,306,128,277,64,160,17,33,3,224,146,78,146,119,27,2020-01-01,zipcode,Megargel
ZCTA5 76380,48,3601,41186,481,68300,2890,1363,2568,331,960,737,442,98,2658,1636,1022,1636,1211,425,2020-01-01,zipcode,Seymour
ZCTA5 76424,48,8898,45258,710,79100,6885,3293,5892,1249,1837,1856,725,225,4427,3149,1278,3149,2369,780,2020-01-01,zipcode,Breckenridge
ZCTA5 76442,48,7812,57384,480,115000,6291,2719,5623,947,1771,1876,701,328,4026,3038,988,3038,2536,502,2020-01-01,zipcode,Comanche
ZCTA5 76444,48,3515,47679,601,82100,2792,1136,2494,350,896,658,469,121,1783,1427,356,1427,1104,323,2020-01-01,zipcode,De leon
ZCTA5 33147,12,46765,37619,1095,169200,36356,15298,31019,7905,11463,7560,2881,1210,15290,13966,1324,13966,6372,7594,2020-01-01,zipcode,Miami
ZCTA5 33149,12,12955,162175,2584,1412800,9433,3771,8129,245,678,1258,3074,2874,6950,4079,2871,4079,2834,1245,2020-01-01,zipcode,Key biscayne
ZCTA5 33161,12,56446,42846,1185,269900,43961,15387,37666,8080,12589,9848,4707,2442,18509,16822,1687,16822,6898,9924,2020-01-01,zipcode,Miami
ZCTA5 33172,12,42232,52003,1635,180000,35458,11636,31635,6880,7765,7472,5953,3565,15314,13754,1560,13754,6228,7526,2020-01-01,zipcode,Miami
ZCTA5 33175,12,52885,60630,1709,330200,46195,17651,40704,7463,11901,9577,8045,3718,17091,16670,421,16670,12561,4109,2020-01-01,zipcode,Miami
ZCTA5 33190,12,17252,63938,1403,277200,13184,4056,11267,1548,2194,4335,2577,613,5180,5053,127,5053,2280,2773,2020-01-01,zipcode,Miami
ZCTA5 33315,12,13490,78367,1409,335400,11673,3344,10645,696,3533,2660,2406,1350,6569,5778,791,5778,3277,2501,2020-01-01,zipcode,Fort lauderdale
ZCTA5 33405,12,20838,60199,1198,294100,17249,5890,15284,2984,3570,4036,2557,2137,8592,7645,947,7645,4385,3260,2020-01-01,zipcode,West palm beach
ZCTA5 33409,12,32607,54391,1336,186200,25992,7713,20830,3621,5412,6044,3935,1818,12568,10781,1787,10781,4576,6205,2020-01-01,zipcode,West palm beach
ZCTA5 33413,12,16904,66977,1645,275000,12822,3747,10632,1446,2876,3604,1662,1044,5482,4993,489,4993,3247,1746,2020-01-01,zipcode,West palm beach
ZCTA5 33426,12,23797,63061,1662,222400,20852,7075,18500,1339,5694,6324,3435,1708,11093,9760,1333,9760,5972,3788,2020-01-01,zipcode,Boynton beach
ZCTA5 33469,12,14848,83985,1538,393600,12912,6862,12115,419,2409,3567,3565,2155,8706,6689,2017,6689,5938,751,2020-01-01,zipcode,Jupiter
ZCTA5 33471,12,7061,39243,664,69200,6183,4264,5445,1777,1942,1028,468,230,3456,2428,1028,2428,1891,537,2020-01-01,zipcode,Moore haven
ZCTA5 33484,12,27210,44362,1384,156600,25364,15981,23977,1728,6408,7067,4902,3872,18624,14456,4168,14456,11446,3010,2020-01-01,zipcode,Delray beach
ZCTA5 33004,12,16234,42780,1230,225100,13517,4401,12555,1210,3468,4233,2509,1135,8371,6716,1655,6716,2990,3726,2020-01-01,zipcode,Dania
ZCTA5 33010,12,45454,32642,1072,269000,39717,16796,35404,12537,11309,6186,3864,1508,16505,15885,620,15885,4798,11087,2020-01-01,zipcode,Hialeah
ZCTA5 33021,12,49859,57849,1394,302300,40601,14594,35666,3911,8986,10975,6922,4872,21319,18677,2642,18677,11883,6794,2020-01-01,zipcode,Hollywood
ZCTA5 33023,12,74913,54759,1308,242800,59000,18425,50392,7951,17407,17050,5378,2606,22011,20634,1377,20634,13816,6818,2020-01-01,zipcode,Hollywood
ZCTA5 33025,12,73180,58595,1468,249200,59605,19201,52483,3071,20239,16602,7834,4737,28638,26049,2589,26049,11964,14085,2020-01-01,zipcode,Hollywood
ZCTA5 33857,12,1710,31827,480,73400,1593,945,1515,318,772,291,114,20,1375,901,474,901,681,220,2020-01-01,zipcode,Lorida
ZCTA5 33947,12,9455,55610,1165,253500,8906,5714,8279,624,2961,2820,1168,706,5987,4401,1586,4401,3651,750,2020-01-01,zipcode,Rotonda west
ZCTA5 33066,12,17382,52493,1325,144500,15498,7225,14352,1087,3798,4637,2807,2023,10752,8697,2055,8697,7216,1481,2020-01-01,zipcode,Pompano beach
ZCTA5 33168,12,23996,49381,1283,235100,20189,7642,17314,4304,6245,4252,1798,715,6770,6353,417,6353,4745,1608,2020-01-01,zipcode,Miami
ZCTA5 33313,12,62945,40781,1225,150700,47980,16943,39680,6770,14789,11902,4236,1983,23614,20084,3530,20084,8614,11470,2020-01-01,zipcode,Fort lauderdale
ZCTA5 33437,12,37420,65117,1526,303500,34544,20753,32765,1414,7286,9536,7998,6531,21450,18026,3424,18026,15567,2459,2020-01-01,zipcode,Boynton beach
ZCTA5 33185,12,30165,86366,2311,381700,24241,8902,20875,2278,4726,5756,5440,2675,8843,8627,216,8627,7073,1554,2020-01-01,zipcode,Miami
ZCTA5 33415,12,51932,43561,1262,155400,41005,14100,34473,7790,12086,8899,4201,1497,19564,17195,2369,17195,9937,7258,2020-01-01,zipcode,West palm beach
ZCTA5 33540,12,9126,35601,763,89800,8135,4762,7456,1013,3110,2334,741,258,5293,4175,1118,4175,3338,837,2020-01-01,zipcode,Zephyrhills
ZCTA5 33619,12,40257,47677,1210,138300,31629,12493,26311,4898,9704,6765,3201,1743,14463,13347,1116,13347,6776,6571,2020-01-01,zipcode,Tampa
ZCTA5 33755,12,26937,42389,1019,206100,21366,8038,18688,2551,6131,6177,2628,1201,11205,9977,1228,9977,5451,4526,2020-01-01,zipcode,Clearwater
ZCTA5 33182,12,16484,94386,1820,354000,14228,7138,12286,2459,3312,2628,2902,985,4071,3985,86,3985,3292,693,2020-01-01,zipcode,Miami
ZCTA5 33039,12,378,66571,-666666666,324200,358,199,338,100,63,112,0,63,138,138,0,138,138,0,2020-01-01,zipcode,Homestead
ZCTA5 33051,12,523,91899,1234,578900,523,321,523,11,119,134,186,73,1367,321,1046,321,261,60,2020-01-01,zipcode,Key colony beach
ZCTA5 33101,12,0,-666666666,-666666666,-666666666,0,0,0,0,0,0,0,0,0,0,0,0,0,0,2020-01-01,zipcode,Miami
ZCTA5 33449,12,11783,128712,2244,477500,9030,3771,7686,447,1022,1845,2043,2329,4058,3765,293,3765,3466,299,2020-01-01,zipcode,Lake worth
ZCTA5 33472,12,19874,76749,2122,307900,17326,9466,16060,922,3464,5165,3632,2877,8871,7908,963,7908,7391,517,2020-01-01,zipcode,Boynton beach
ZCTA5 33473,12,11868,122069,3215,593100,9074,4654,8471,32,806,2667,2323,2643,4867,4249,618,4249,3931,318,2020-01-01,zipcode,Boynton beach
ZCTA5 33503,12,222,-666666666,-666666666,361100,222,58,105,24,28,53,0,0,58,58,0,58,45,13,2020-01-01,zipcode,Balm
ZCTA5 33542,12,22744,36239,858,84100,19760,12201,17750,2388,7070,5995,1515,782,13395,10301,3094,10301,7287,3014,2020-01-01,zipcode,Zephyrhills
ZCTA5 33545,12,22515,83757,1669,239000,17425,5102,14597,726,3657,5312,3126,1776,7021,6634,387,6634,4949,1685,2020-01-01,zipcode,Wesley chapel
ZCTA5 33548,12,7335,125521,1589,384800,5800,2025,5035,75,858,1288,1661,1153,2846,2718,128,2718,2438,280,2020-01-01,zipcode,Lutz
ZCTA5 33558,12,25429,85281,1116,355300,19765,6919,17229,608,3191,4366,5180,3884,9673,9168,505,9168,6674,2494,2020-01-01,zipcode,Lutz
ZCTA5 33559,12,18744,71724,1173,212000,15560,4463,12467,834,3546,3654,2771,1662,7409,6871,538,6871,3954,2917,2020-01-01,zipcode,Lutz
ZCTA5 33563,12,27807,44969,976,142100,21600,7673,18424,4020,6034,5343,2277,750,11049,9967,1082,9967,5481,4486,2020-01-01,zipcode,Plant city
ZCTA5 33578,12,54143,65142,1352,213100,42178,11251,36484,2438,9424,12211,8220,4191,22366,20742,1624,20742,11180,9562,2020-01-01,zipcode,Riverview
ZCTA5 33579,12,37920,86439,1693,240100,28621,7770,25405,2868,5901,8720,5129,2787,12757,12030,727,12030,9040,2990,2020-01-01,zipcode,Riverview
ZCTA5 33596,12,31000,102627,1826,288000,25127,8254,21798,1053,4578,6207,6905,3055,10573,10047,526,10047,8394,1653,2020-01-01,zipcode,Valrico
ZCTA5 33744,12,101,-666666666,-666666666,-666666666,101,89,89,11,78,0,0,0,0,0,0,0,0,0,2020-01-01,zipcode,Bay pines
ZCTA5 33812,12,13478,79076,1234,203500,10347,3661,8960,582,2906,3040,1398,1034,5182,4216,966,4216,3343,873,2020-01-01,zipcode,Lakeland
ZCTA5 33854,12,366,48929,616,48200,338,220,319,66,88,104,51,10,626,188,438,188,101,87,2020-01-01,zipcode,Lakeshore
ZCTA5 33855,12,0,-666666666,-666666666,-666666666,0,0,0,0,0,0,0,0,0,0,0,0,0,0,2020-01-01,zipcode,Indian lake estates
ZCTA5 33856,12,299,24443,533,-666666666,299,183,299,0,75,196,28,0,466,251,215,251,8,243,2020-01-01,zipcode,Nalcrest
ZCTA5 33859,12,10987,48345,886,149900,8999,4662,7835,925,2683,2903,847,477,5611,4325,1286,4325,3268,1057,2020-01-01,zipcode,Lake wales
ZCTA5 33867,12,148,36250,-666666666,85400,148,135,148,14,53,68,13,0,209,95,114,95,95,0,2020-01-01,zipcode,River ranch
ZCTA5 33875,12,10787,57410,793,154900,9453,5230,8963,719,3466,2462,1588,728,5970,4883,1087,4883,3985,898,2020-01-01,zipcode,Sebring
ZCTA5 33876,12,5808,51193,834,119200,5237,3383,4982,607,1758,1777,640,200,2797,2282,515,2282,1873,409,2020-01-01,zipcode,Sebring
ZCTA5 33896,12,13735,60056,1632,217700,11180,3220,9132,806,2299,3758,1499,770,6010,4245,1765,4245,2157,2088,2020-01-01,zipcode,Davenport
ZCTA5 33897,12,22769,56419,1674,200500,18524,7026,16324,1333,5913,5554,2544,980,12122,7246,4876,7246,5219,2027,2020-01-01,zipcode,Davenport
ZCTA5 33898,12,16829,45471,941,119200,13671,7104,12508,2025,4543,4020,1337,583,9399,6479,2920,6479,5300,1179,2020-01-01,zipcode,Lake wales
ZCTA5 33965,12,1359,-666666666,-666666666,-666666666,1359,689,30,0,0,30,0,0,0,0,0,0,0,0,2020-01-01,zipcode,Fort myers
ZCTA5 33966,12,9576,67757,1248,284000,8151,3688,7280,193,1400,2188,2173,1326,5764,4263,1501,4263,2894,1369,2020-01-01,zipcode,Fort myers
ZCTA5 36854,01,14863,52469,823,114600,11914,4724,9838,1304,3380,3364,1280,510,7365,5865,1500,5865,3712,2153,2020-01-01,zipcode,Valley
ZCTA5 36861,01,2726,55072,679,122100,2392,1094,2223,464,711,539,338,171,1923,1201,722,1201,1093,108,2020-01-01,zipcode,Jacksons gap
ZCTA5 36915,01,645,32813,-666666666,52600,533,283,430,44,168,147,70,1,374,220,154,220,168,52,2020-01-01,zipcode,Needham
ZCTA5 36604,01,9670,50079,784,172100,7939,2809,6860,552,1562,1780,1761,1205,5111,3999,1112,3999,2235,1764,2020-01-01,zipcode,Mobile
ZCTA5 36322,01,8951,38794,663,105700,7437,3311,6393,1024,2317,2223,606,223,4678,3922,756,3922,2180,1742,2020-01-01,zipcode,Daleville
ZCTA5 36340,01,5745,39478,598,103500,4512,2476,3992,1043,1453,1016,186,294,2751,2333,418,2333,1760,573,2020-01-01,zipcode,Geneva
ZCTA5 36343,01,1174,47569,830,86300,1050,611,948,217,336,293,93,9,719,503,216,503,428,75,2020-01-01,zipcode,Gordon
ZCTA5 36360,01,18922,44880,677,126600,15269,7629,13399,2024,4171,4878,1432,894,9227,7789,1438,7789,4954,2835,2020-01-01,zipcode,Ozark
ZCTA5 36376,01,2167,40451,732,80800,1779,869,1618,328,634,493,99,64,1164,839,325,839,690,149,2020-01-01,zipcode,Webb
ZCTA5 36425,01,1086,32500,-666666666,-666666666,881,520,654,101,325,158,61,9,556,332,224,332,268,64,2020-01-01,zipcode,Beatrice
ZCTA5 36426,01,15404,41668,619,97300,12321,5469,10915,1963,4067,3247,1205,433,7167,5527,1640,5527,3781,1746,2020-01-01,zipcode,Brewton
ZCTA5 36436,01,356,38333,-666666666,88200,326,196,260,54,105,101,0,0,216,118,98,118,117,1,2020-01-01,zipcode,Dickinson
ZCTA5 36535,01,34542,53606,823,192400,29147,12584,26267,2899,8506,8539,4316,2007,16236,13926,2310,13926,10743,3183,2020-01-01,zipcode,Foley
ZCTA5 36545,01,9222,37137,582,114000,7668,4153,6285,1104,2555,1482,716,428,4816,3480,1336,3480,2505,975,2020-01-01,zipcode,Jackson
ZCTA5 36556,01,396,-666666666,-666666666,47800,396,222,277,15,122,121,19,0,431,196,235,196,134,62,2020-01-01,zipcode,Malcolm
ZCTA5 36578,01,2682,109735,719,304600,1413,298,1325,29,426,438,179,253,800,663,137,663,626,37,2020-01-01,zipcode,Stapleton
ZCTA5 36581,01,336,42250,-666666666,-666666666,287,151,287,20,253,14,0,0,173,138,35,138,138,0,2020-01-01,zipcode,Sunflower
ZCTA5 36607,01,6417,40074,813,97000,5418,2524,4846,818,1547,1134,865,482,3276,2727,549,2727,1335,1392,2020-01-01,zipcode,Mobile
ZCTA5 36608,01,36317,51544,911,163700,29961,12372,23518,2059,4886,6972,5758,3843,17232,15009,2223,15009,8041,6968,2020-01-01,zipcode,Mobile
ZCTA5 36613,01,13746,40631,1037,116500,10214,5027,8311,1225,3516,2552,680,338,5286,4218,1068,4218,2976,1242,2020-01-01,zipcode,Eight mile
ZCTA5 36619,01,15262,50533,882,139400,12139,5274,10718,1261,3607,3452,1663,735,6482,5670,812,5670,4217,1453,2020-01-01,zipcode,Mobile
ZCTA5 36722,01,344,47917,-666666666,93000,292,161,261,91,74,96,0,0,253,141,112,141,75,66,2020-01-01,zipcode,Arlington
ZCTA5 36759,01,1724,32321,-666666666,56000,1296,556,1119,151,431,353,173,11,785,607,178,607,499,108,2020-01-01,zipcode,Marion junction
ZCTA5 36784,01,6802,39028,587,143300,5233,2472,4542,671,2104,1282,232,253,3440,2627,813,2627,1610,1017,2020-01-01,zipcode,Thomasville
ZCTA5 36855,01,1592,50768,802,127900,1281,484,1208,173,505,366,138,26,757,704,53,704,576,128,2020-01-01,zipcode,Five points
ZCTA5 36856,01,7944,59542,1631,193800,5728,2770,5121,598,871,2629,636,387,2863,2659,204,2659,2326,333,2020-01-01,zipcode,Fort mitchell
ZCTA5 36867,01,22239,41627,808,139300,17705,6318,14916,1931,4098,5355,2138,1394,11238,9608,1630,9608,4247,5361,2020-01-01,zipcode,Phenix city
ZCTA5 36871,01,1081,35625,760,128600,903,536,828,115,366,152,142,53,716,455,261,455,364,91,2020-01-01,zipcode,Pittsview
ZCTA5 36910,01,45,-666666666,-666666666,-666666666,45,45,45,0,21,24,0,0,33,21,12,21,0,21,2020-01-01,zipcode,Jachin
ZCTA5 36916,01,1030,33333,326,68500,820,495,750,173,231,296,13,37,605,452,153,452,319,133,2020-01-01,zipcode,Pennington
ZCTA5 36441,01,3828,35088,550,100700,2727,1308,2485,260,1130,699,274,122,1940,1424,516,1424,1014,410,2020-01-01,zipcode,Flomaton
ZCTA5 33844,12,40078,47050,941,135100,32178,14715,28142,5451,9804,8645,2751,1491,18521,13179,5342,13179,9111,4068,2020-01-01,zipcode,Haines city
ZCTA5 33847,12,154,73125,-666666666,-666666666,124,46,94,17,27,30,12,8,50,50,0,50,41,9,2020-01-01,zipcode,Homeland
ZCTA5 33860,12,28372,57110,971,147900,21455,8201,18664,2847,7400,6030,1595,792,9383,8217,1166,8217,6114,2103,2020-01-01,zipcode,Mulberry
ZCTA5 33873,12,13394,38375,744,104000,9999,4400,8245,1910,3967,1656,468,244,5355,4417,938,4417,2791,1626,2020-01-01,zipcode,Wauchula
ZCTA5 33884,12,33008,60359,1152,198900,28079,12383,24298,2097,6747,8495,4416,2543,14673,12348,2325,12348,9206,3142,2020-01-01,zipcode,Winter haven
ZCTA5 33921,12,947,100804,-666666666,1155200,928,694,894,55,114,304,242,179,1895,416,1479,416,378,38,2020-01-01,zipcode,Boca grande
ZCTA5 33924,12,181,-666666666,-666666666,-666666666,181,80,156,75,14,19,33,15,1914,31,1883,31,31,0,2020-01-01,zipcode,Captiva
ZCTA5 33629,12,27059,126363,1373,590600,20375,6383,18237,501,1674,3209,6836,6017,11535,10441,1094,10441,8230,2211,2020-01-01,zipcode,Tampa
ZCTA5 33703,12,26980,87032,1331,270200,22492,7840,20069,1006,3523,5958,5498,4084,12250,11120,1130,11120,8942,2178,2020-01-01,zipcode,Saint petersburg
ZCTA5 33712,12,24802,51569,1110,201700,20658,7707,17501,1560,4815,5780,3692,1654,12446,9178,3268,9178,5122,4056,2020-01-01,zipcode,Saint petersburg
ZCTA5 33513,12,13982,42304,882,140300,11664,7385,10062,1822,4130,3086,619,405,5403,4094,1309,4094,3184,910,2020-01-01,zipcode,Bushnell
ZCTA5 33538,12,5371,38231,819,109800,4586,2283,4235,700,1783,1153,375,224,2985,2203,782,2203,1733,470,2020-01-01,zipcode,Lake panasoffkee
ZCTA5 33547,12,25676,104513,1820,327000,18025,6053,15563,665,3521,3864,4578,2935,8346,7704,642,7704,6691,1013,2020-01-01,zipcode,Lithia
ZCTA5 33606,12,21789,95799,1576,581700,19111,6507,13833,344,1237,2058,5976,4218,10201,8894,1307,8894,3861,5033,2020-01-01,zipcode,Tampa
ZCTA5 33616,12,15373,64274,1311,224100,12526,3493,11043,668,3300,2966,2488,1621,7006,6265,741,6265,2961,3304,2020-01-01,zipcode,Tampa
ZCTA5 33068,12,52691,47536,1493,199600,41583,11956,34424,5592,12864,9836,4143,1989,18498,17013,1485,17013,9876,7137,2020-01-01,zipcode,Pompano beach
ZCTA5 33109,12,390,228304,-666666666,2000001,373,249,373,0,26,13,149,185,795,213,582,213,200,13,2020-01-01,zipcode,Miami beach
ZCTA5 33142,12,59773,28105,966,207900,46547,19043,39988,13470,13746,7709,3760,1303,21928,20142,1786,20142,5471,14671,2020-01-01,zipcode,Miami
ZCTA5 33144,12,30343,51341,1392,318800,26687,10320,23983,4918,6963,6308,4334,1460,10129,9720,409,9720,5463,4257,2020-01-01,zipcode,Miami
ZCTA5 33189,12,24802,56845,1314,280300,19566,6411,17131,2807,5449,4662,2917,1296,8423,7813,610,7813,4508,3305,2020-01-01,zipcode,Miami
ZCTA5 33323,12,21612,93586,1976,351900,18100,5184,15504,1210,2663,5142,4337,2152,8536,7576,960,7576,5388,2188,2020-01-01,zipcode,Fort lauderdale
ZCTA5 33332,12,12111,139317,2585,643000,9892,3383,7914,442,779,1636,2412,2645,3612,3395,217,3395,3137,258,2020-01-01,zipcode,Fort lauderdale
ZCTA5 33411,12,74554,76804,1547,295900,59914,20976,52278,5052,13425,15493,11326,6982,28690,25446,3244,25446,18570,6876,2020-01-01,zipcode,West palm beach
ZCTA5 33431,12,23329,88430,1860,418100,19115,8545,14805,626,2124,3370,5449,3236,9870,8253,1617,8253,5356,2897,2020-01-01,zipcode,Boca raton
ZCTA5 33441,12,27963,47746,1272,267500,23239,7805,20691,3075,6309,6457,3265,1585,13789,11166,2623,11166,5839,5327,2020-01-01,zipcode,Deerfield beach
ZCTA5 33594,12,36685,68026,1372,201800,30357,10100,26541,2324,7966,8557,5156,2538,14015,13214,801,13214,10259,2955,2020-01-01,zipcode,Valrico
ZCTA5 33549,12,18132,71490,1239,239900,15089,5727,13267,765,3206,4361,2664,2271,7212,6883,329,6883,5549,1334,2020-01-01,zipcode,Lutz
ZCTA5 33569,12,28342,76560,1423,233100,22140,7698,19413,1458,4723,6458,4295,2479,11120,10181,939,10181,7921,2260,2020-01-01,zipcode,Riverview
ZCTA5 36009,01,2257,46250,431,96800,1865,973,1613,228,646,269,337,133,1206,893,313,893,677,216,2020-01-01,zipcode,Brantley
ZCTA5 36025,01,6722,41193,972,149700,6000,4296,5327,1682,2037,983,412,213,1400,1314,86,1314,894,420,2020-01-01,zipcode,Elmore
ZCTA5 36047,01,1117,46429,-666666666,70000,969,357,899,129,323,357,77,13,541,466,75,466,422,44,2020-01-01,zipcode,Letohatchee
ZCTA5 36078,01,13433,54802,717,142800,11309,5194,9222,1683,3020,2769,1158,592,5923,5213,710,5213,3780,1433,2020-01-01,zipcode,Tallassee
ZCTA5 36079,01,9789,51250,794,140500,7940,3474,6739,694,2118,2010,894,1023,4535,3462,1073,3462,2825,637,2020-01-01,zipcode,Troy
ZCTA5 36080,01,1997,78365,-666666666,191000,1611,771,1484,246,484,355,247,152,925,737,188,737,601,136,2020-01-01,zipcode,Titus
ZCTA5 36113,01,1781,93594,1569,-666666666,1526,1008,1347,195,308,474,190,180,333,287,46,287,0,287,2020-01-01,zipcode,Montgomery
ZCTA5 36201,01,17431,32315,621,66300,14499,6936,12695,3329,5005,3634,552,175,9781,7313,2468,7313,4463,2850,2020-01-01,zipcode,Anniston
ZCTA5 36206,01,10539,48842,805,97200,8313,3576,7121,1108,2721,2116,523,653,4940,4055,885,4055,2835,1220,2020-01-01,zipcode,Anniston
ZCTA5 36251,01,4755,40734,378,112400,4106,1789,3272,668,1143,1040,322,99,2336,1847,489,1847,1320,527,2020-01-01,zipcode,Ashland
ZCTA5 36274,01,10617,40124,619,91800,8803,4212,7753,1422,2866,2444,713,308,5436,4220,1216,4220,3259,961,2020-01-01,zipcode,Roanoke
ZCTA5 36314,01,576,50516,516,59000,462,171,458,54,224,138,11,31,291,237,54,237,208,29,2020-01-01,zipcode,Black
ZCTA5 36346,01,1379,44318,688,97000,1133,497,975,203,340,253,89,90,812,576,236,576,525,51,2020-01-01,zipcode,Jack
ZCTA5 36351,01,3199,56067,743,124900,2620,1174,2328,376,754,748,216,234,1520,1337,183,1337,1057,280,2020-01-01,zipcode,New brockton
ZCTA5 36523,01,3054,51250,896,166100,2489,1339,2189,678,760,368,226,157,1238,1046,192,1046,749,297,2020-01-01,zipcode,Coden
ZCTA5 36532,01,35728,77260,1160,305100,28399,12070,25500,1613,4452,6946,7742,4747,15925,13497,2428,13497,11364,2133,2020-01-01,zipcode,Fairhope
ZCTA5 36540,01,738,23140,-666666666,-666666666,619,303,562,222,258,70,12,0,435,328,107,328,267,61,2020-01-01,zipcode,Gainestown
ZCTA5 36542,01,14937,52214,1093,258600,13558,5778,11977,1016,3041,3898,2616,1406,17818,7276,10542,7276,4468,2808,2020-01-01,zipcode,Gulf shores
ZCTA5 36559,01,182,-666666666,-666666666,630200,182,151,151,0,0,76,15,60,200,92,108,92,76,16,2020-01-01,zipcode,Montrose
ZCTA5 36564,01,278,-666666666,-666666666,-666666666,178,78,127,0,0,0,52,75,134,75,59,75,75,0,2020-01-01,zipcode,Point clear
ZCTA5 36567,01,13590,52773,885,139300,11251,5036,9829,1587,3646,2854,1283,459,5654,5055,599,5055,3893,1162,2020-01-01,zipcode,Robertsdale
ZCTA5 36571,01,15500,58446,809,157900,11973,4644,10672,1215,4123,3074,1615,645,6656,5937,719,5937,4637,1300,2020-01-01,zipcode,Saraland
ZCTA5 36862,01,5691,32500,511,110300,4694,2441,4212,913,1616,1194,373,116,2963,2374,589,2374,1595,779,2020-01-01,zipcode,Lafayette
ZCTA5 36904,01,3983,36708,585,100900,3247,1634,2729,286,1092,873,321,157,2164,1614,550,1614,1220,394,2020-01-01,zipcode,Butler
ZCTA5 36925,01,2935,36275,658,42200,2320,1101,2146,367,679,807,164,129,1609,1293,316,1293,830,463,2020-01-01,zipcode,York
ZCTA5 36016,01,5360,38750,587,58100,4553,2880,4168,1162,1726,994,216,70,2046,1630,416,1630,1081,549,2020-01-01,zipcode,Clayton
ZCTA5 36024,01,4234,51196,605,179500,3688,1774,3286,347,1221,989,490,239,3012,1874,1138,1874,1533,341,2020-01-01,zipcode,Eclectic
ZCTA5 36031,01,129,65417,-666666666,121400,109,78,80,29,39,5,7,0,64,54,10,54,50,4,2020-01-01,zipcode,Fort davis
ZCTA5 36043,01,3788,70425,1048,152100,3270,1564,2681,606,860,598,357,260,1618,1353,265,1353,1068,285,2020-01-01,zipcode,Hope hull
ZCTA5 76673,48,1804,45547,710,150000,1142,491,941,289,266,307,63,16,629,482,147,482,352,130,2020-01-01,zipcode,Mount calm
ZCTA5 76685,48,37,-666666666,-666666666,-666666666,37,27,37,13,24,0,0,0,68,23,45,23,23,0,2020-01-01,zipcode,Satin
ZCTA5 76701,48,1872,37171,1029,153000,1644,711,1320,235,394,309,162,220,883,696,187,696,151,545,2020-01-01,zipcode,Waco
ZCTA5 76712,48,26104,80368,1023,218600,19718,6874,17994,949,2767,5624,5285,3369,10737,9926,811,9926,6895,3031,2020-01-01,zipcode,Woodway
ZCTA5 76823,48,3139,51441,604,89000,2593,1236,2335,271,910,730,352,72,1484,1168,316,1168,980,188,2020-01-01,zipcode,Bangs
ZCTA5 76859,48,1787,43068,693,76000,1560,609,1485,230,471,383,235,166,1603,951,652,951,596,355,2020-01-01,zipcode,Menard
ZCTA5 76861,48,1984,61667,720,118000,1449,558,1220,157,460,341,196,66,766,628,138,628,481,147,2020-01-01,zipcode,Miles
ZCTA5 76864,48,857,39107,636,173400,695,368,614,63,268,164,74,45,508,292,216,292,272,20,2020-01-01,zipcode,Mullin
ZCTA5 76884,48,98,62656,-666666666,-666666666,91,37,84,3,51,11,10,9,81,45,36,45,38,7,2020-01-01,zipcode,Valera
ZCTA5 76888,48,137,-666666666,-666666666,-666666666,118,68,116,5,9,73,22,7,236,80,156,80,54,26,2020-01-01,zipcode,Voss
ZCTA5 76936,48,2898,45250,400,80900,2227,944,1922,399,542,672,251,58,1505,1036,469,1036,808,228,2020-01-01,zipcode,Eldorado
ZCTA5 76065,48,38800,96778,1242,267200,28986,8685,24828,1615,6262,8820,5471,2660,13388,12749,639,12749,10476,2273,2020-01-01,zipcode,Midlothian
ZCTA5 76067,48,20437,55125,844,111000,15688,6230,13256,1650,4997,4797,1331,481,8410,6799,1611,6799,4789,2010,2020-01-01,zipcode,Mineral wells
ZCTA5 76660,48,624,42045,805,87100,392,211,311,63,110,87,41,10,275,186,89,186,135,51,2020-01-01,zipcode,Malone
ZCTA5 76667,48,10991,42522,690,91200,8705,4119,7483,1490,2722,2213,623,435,4723,3775,948,3775,2710,1065,2020-01-01,zipcode,Mexia
ZCTA5 76708,48,27095,51679,875,139700,20387,7052,16961,3162,4440,5829,2237,1293,10463,9641,822,9641,5938,3703,2020-01-01,zipcode,Waco
ZCTA5 76848,48,79,-666666666,-666666666,-666666666,79,54,79,0,9,70,0,0,90,40,50,40,40,0,2020-01-01,zipcode,Hext
ZCTA5 76854,48,306,27941,-666666666,-666666666,252,130,235,99,39,58,29,10,335,160,175,160,56,104,2020-01-01,zipcode,London
ZCTA5 76869,48,37,-666666666,-666666666,1073500,37,23,26,0,3,6,0,17,119,24,95,24,24,0,2020-01-01,zipcode,Pontotoc
ZCTA5 76870,48,238,58750,-666666666,-666666666,193,58,164,23,49,48,21,23,136,68,68,68,58,10,2020-01-01,zipcode,Priddy
ZCTA5 76872,48,876,61042,668,141300,728,365,651,48,312,190,47,54,592,359,233,359,314,45,2020-01-01,zipcode,Rochelle
ZCTA5 76933,48,1340,53105,714,94700,1045,423,944,171,364,277,78,54,751,593,158,593,363,230,2020-01-01,zipcode,Bronte
ZCTA5 76949,48,13,-666666666,-666666666,-666666666,12,11,11,4,0,7,0,0,17,6,11,6,6,0,2020-01-01,zipcode,Silver
ZCTA5 76040,48,33419,61768,969,221300,24904,6902,21788,2565,5091,7374,4361,2397,12890,11799,1091,11799,5707,6092,2020-01-01,zipcode,Euless
ZCTA5 76048,48,24586,54724,945,163100,20086,9249,17565,1860,6044,5370,3011,1280,11909,9933,1976,9933,7031,2902,2020-01-01,zipcode,Granbury
ZCTA5 76077,48,333,-666666666,-666666666,190300,333,233,333,9,151,105,27,41,219,163,56,163,163,0,2020-01-01,zipcode,Rainbow
ZCTA5 76093,48,2930,47123,874,86200,2233,749,2057,499,632,737,83,106,1221,1153,68,1153,835,318,2020-01-01,zipcode,Rio vista
ZCTA5 76104,48,17653,35193,1045,83800,13337,6049,11113,3240,3428,2451,1240,754,8250,6693,1557,6693,2779,3914,2020-01-01,zipcode,Fort worth
ZCTA5 76109,48,23725,83203,1244,498300,19850,7930,13913,447,1150,2312,5593,4411,10792,9288,1504,9288,4994,4294,2020-01-01,zipcode,Fort worth
ZCTA5 76117,48,32191,47473,976,121200,23898,8190,20133,5472,7808,4825,1399,629,11213,10601,612,10601,5510,5091,2020-01-01,zipcode,Haltom city
ZCTA5 76134,48,28852,54835,1113,134400,21636,7707,17660,3684,6159,5107,1708,1002,10056,9347,709,9347,5287,4060,2020-01-01,zipcode,Fort worth
ZCTA5 76137,48,59983,77961,1360,196800,46737,11621,38284,3907,9062,13455,8694,3166,22060,20835,1225,20835,12713,8122,2020-01-01,zipcode,Fort worth
ZCTA5 76179,48,69066,92773,1563,226000,50947,13677,44177,3155,12512,15322,9184,4004,24352,23296,1056,23296,17916,5380,2020-01-01,zipcode,Fort worth
ZCTA5 76180,48,37117,62595,1192,206600,29970,9272,25667,2281,6338,8780,5679,2589,16085,15102,983,15102,7735,7367,2020-01-01,zipcode,North richland hills
ZCTA5 76240,48,28546,55975,941,153100,22166,7853,18930,2639,5637,6815,2492,1347,11978,11017,961,11017,7066,3951,2020-01-01,zipcode,Gainesville
ZCTA5 76272,48,4404,81112,887,209400,3751,1541,3502,361,1212,1247,572,110,1897,1711,186,1711,1533,178,2020-01-01,zipcode,Valley view
ZCTA5 76443,48,1903,37552,664,91700,1436,838,1303,176,441,423,245,18,1044,801,243,801,614,187,2020-01-01,zipcode,Cross plains
ZCTA5 76446,48,8120,54260,808,137400,6539,2230,5418,1258,1644,1361,866,289,3863,2755,1108,2755,2396,359,2020-01-01,zipcode,Dublin
ZCTA5 76454,48,1903,32031,385,69500,1489,795,1193,283,387,458,47,18,1015,703,312,703,417,286,2020-01-01,zipcode,Gorman
ZCTA5 76459,48,200,71250,-666666666,71500,154,59,137,29,63,37,0,8,108,74,34,74,68,6,2020-01-01,zipcode,Jermyn
ZCTA5 76463,48,450,39375,1050,64300,408,207,342,61,146,95,35,5,290,187,103,187,161,26,2020-01-01,zipcode,Mingus
ZCTA5 35019,01,2007,43563,596,112800,1620,790,1344,204,544,429,128,39,999,829,170,829,666,163,2020-01-01,zipcode,Baileyton
ZCTA5 35023,01,23633,55979,934,121000,18895,8130,16532,1895,5665,5649,2446,877,9696,8410,1286,8410,6281,2129,2020-01-01,zipcode,Bessemer
ZCTA5 35040,01,17611,68620,1175,155900,13123,3581,11320,738,2863,4262,2497,960,6880,6379,501,6379,5192,1187,2020-01-01,zipcode,Calera
ZCTA5 35054,01,4459,59688,1014,209800,3509,1721,3019,377,1038,960,346,298,2110,1744,366,1744,1556,188,2020-01-01,zipcode,Cropwell
ZCTA5 35057,01,14535,54335,746,153100,11247,4256,9775,1782,3029,3575,855,534,6229,5053,1176,5053,4176,877,2020-01-01,zipcode,Cullman
ZCTA5 35070,01,298,41429,-666666666,108900,220,116,190,36,69,69,16,0,113,106,7,106,98,8,2020-01-01,zipcode,Garden city
ZCTA5 35079,01,9398,69038,809,158500,7226,3083,6158,543,2459,2211,649,296,3568,3124,444,3124,2961,163,2020-01-01,zipcode,Hayden
ZCTA5 35098,01,928,64712,-666666666,154300,787,353,696,135,173,309,66,13,555,415,140,415,363,52,2020-01-01,zipcode,Logan
ZCTA5 35143,01,3078,76380,534,159700,2532,1005,2220,190,750,803,409,68,2144,1201,943,1201,1054,147,2020-01-01,zipcode,Shelby
ZCTA5 35146,01,11551,83002,-666666666,194300,9544,4812,8600,1438,2685,2392,1427,658,4111,3695,416,3695,3361,334,2020-01-01,zipcode,Springville
ZCTA5 35204,01,9907,26618,605,63200,8217,4360,7191,1426,2823,1988,621,333,5976,4615,1361,4615,1885,2730,2020-01-01,zipcode,Birmingham
ZCTA5 35207,01,7901,26070,627,64900,6192,3318,5356,1089,1855,1688,451,273,4327,3506,821,3506,1913,1593,2020-01-01,zipcode,Birmingham
ZCTA5 35217,01,13133,36092,787,87900,10669,4708,9137,1736,3345,3003,708,345,6380,5124,1256,5124,2923,2201,2020-01-01,zipcode,Birmingham
ZCTA5 35404,01,22578,40776,920,136000,18414,6975,13244,1645,4802,3969,1796,1032,10438,7449,2989,7449,3864,3585,2020-01-01,zipcode,Tuscaloosa
ZCTA5 35405,01,44449,56446,886,176100,36760,12202,30476,2418,8051,9611,6466,3930,20053,17462,2591,17462,9721,7741,2020-01-01,zipcode,Tuscaloosa
ZCTA5 35406,01,18391,106653,1066,376200,14126,5109,12457,388,1091,2380,4556,4042,7843,6964,879,6964,5475,1489,2020-01-01,zipcode,Tuscaloosa
ZCTA5 35443,01,1702,18206,570,53000,1392,909,1134,153,633,260,29,59,1327,754,573,754,548,206,2020-01-01,zipcode,Boligee
ZCTA5 35464,01,916,11775,418,-666666666,578,430,403,70,161,105,67,0,407,283,124,283,103,180,2020-01-01,zipcode,Gainesville
ZCTA5 35474,01,7056,56250,769,139500,5598,1991,4452,647,1422,1273,520,590,2764,2251,513,2251,1901,350,2020-01-01,zipcode,Moundville
ZCTA5 35545,01,90,25000,-666666666,-666666666,79,52,64,33,18,12,0,1,44,40,4,40,38,2,2020-01-01,zipcode,Belk
ZCTA5 35546,01,3765,58389,361,105100,2934,1261,2503,341,1120,682,187,173,1674,1431,243,1431,1275,156,2020-01-01,zipcode,Berry
ZCTA5 35572,01,1700,55781,-666666666,253800,1520,679,1336,356,557,278,81,64,1253,783,470,783,731,52,2020-01-01,zipcode,Houston
ZCTA5 35575,01,1097,41429,663,82000,874,444,804,192,285,233,51,43,530,468,62,468,355,113,2020-01-01,zipcode,Lynn
ZCTA5 35580,01,3682,45167,628,86300,2840,1119,2532,533,755,945,171,128,1750,1462,288,1462,1287,175,2020-01-01,zipcode,Parrish
ZCTA5 35586,01,3746,33520,429,82300,2837,1422,2575,460,863,1013,136,103,2077,1541,536,1541,1174,367,2020-01-01,zipcode,Sulligent
ZCTA5 35592,01,4590,38299,442,108000,3810,2121,3364,709,1435,803,262,155,2558,1949,609,1949,1195,754,2020-01-01,zipcode,Vernon
ZCTA5 35593,01,1443,54500,529,89600,1173,470,1044,173,453,213,113,92,714,518,196,518,428,90,2020-01-01,zipcode,Vina
ZCTA5 35603,01,31509,60078,695,176600,25813,10709,22283,1966,6464,7842,3904,2107,14273,13476,797,13476,9667,3809,2020-01-01,zipcode,Decatur
ZCTA5 35616,01,3643,34526,680,97000,2919,1432,2529,483,929,775,130,212,2172,1459,713,1459,972,487,2020-01-01,zipcode,Cherokee
ZCTA5 35630,01,33685,34898,651,122000,27967,12401,21460,3090,7064,6255,3272,1779,17790,15057,2733,15057,6514,8543,2020-01-01,zipcode,Florence
ZCTA5 35674,01,19187,47738,695,121300,15371,6753,13164,1959,5426,3598,1454,727,8504,7006,1498,7006,4890,2116,2020-01-01,zipcode,Tuscumbia
ZCTA5 35748,01,6612,79185,622,246900,5509,2309,4919,373,1649,1199,1156,542,2756,2523,233,2523,2221,302,2020-01-01,zipcode,Gurley
ZCTA5 35757,01,17972,92152,1299,230100,13779,4291,11985,724,1415,3438,3886,2522,6581,6261,320,6261,5328,933,2020-01-01,zipcode,Madison
ZCTA5 35824,01,8352,86599,898,237900,7299,1587,6073,96,674,1869,1443,1991,4348,4173,175,4173,2286,1887,2020-01-01,zipcode,Huntsville
ZCTA5 35975,01,999,24101,-666666666,151100,819,453,735,85,478,131,40,1,381,381,0,381,333,48,2020-01-01,zipcode,Groveoak
ZCTA5 36258,01,1258,43125,531,96500,1111,609,1015,165,394,310,122,24,760,592,168,592,518,74,2020-01-01,zipcode,Delta
ZCTA5 36345,01,8449,61677,831,145100,6602,2706,5953,869,1799,1892,1005,388,3593,3128,465,3128,2695,433,2020-01-01,zipcode,Headland
ZCTA5 36271,01,6237,43801,738,87800,4698,1907,4248,686,1617,1342,328,275,2879,2280,599,2280,1988,292,2020-01-01,zipcode,Ohatchee
ZCTA5 36276,01,2684,36202,567,69800,2231,1178,1764,340,693,464,215,52,1151,917,234,917,732,185,2020-01-01,zipcode,Wadley
ZCTA5 36316,01,2260,65000,675,155400,1843,777,1655,156,377,748,277,97,938,816,122,816,701,115,2020-01-01,zipcode,Chancellor
ZCTA5 36352,01,4757,68889,674,177300,4011,1535,3476,342,1150,1272,338,374,1867,1766,101,1766,1488,278,2020-01-01,zipcode,Newton
ZCTA5 36370,01,922,50000,829,85400,777,356,727,155,363,181,19,9,420,346,74,346,290,56,2020-01-01,zipcode,Pansey
ZCTA5 36444,01,747,45294,-666666666,47100,618,443,577,183,303,50,14,27,558,268,290,268,227,41,2020-01-01,zipcode,Franklin
ZCTA5 36446,01,512,19600,-666666666,83800,410,275,343,54,204,71,0,14,270,184,86,184,132,52,2020-01-01,zipcode,Fulton
ZCTA5 36477,01,3615,36707,533,83200,2912,1351,2711,642,873,956,157,83,2095,1587,508,1587,1212,375,2020-01-01,zipcode,Samson
ZCTA5 36505,01,1062,73056,1066,136300,822,348,708,141,197,278,49,43,399,390,9,390,316,74,2020-01-01,zipcode,Axis
ZCTA5 36509,01,1634,43634,735,80000,1384,671,1181,437,360,291,75,18,692,565,127,565,348,217,2020-01-01,zipcode,Bayou la batre
ZCTA5 36544,01,11523,46585,766,119600,9101,3996,7860,1935,3464,1734,590,137,4484,3885,599,3885,2977,908,2020-01-01,zipcode,Irvington
ZCTA5 36574,01,1271,-666666666,-666666666,201700,1068,671,926,66,508,181,122,49,564,430,134,430,392,38,2020-01-01,zipcode,Seminole
ZCTA5 36576,01,3899,44313,844,177400,3355,1111,2969,260,995,988,568,158,2121,1791,330,1791,1405,386,2020-01-01,zipcode,Silverhill
ZCTA5 36612,01,4460,22500,681,65100,3180,1842,2715,756,1173,558,96,132,1875,1620,255,1620,936,684,2020-01-01,zipcode,Mobile
ZCTA5 36693,01,19806,64370,960,158200,16019,6188,13937,818,3521,4226,3727,1645,8924,7763,1161,7763,5319,2444,2020-01-01,zipcode,Mobile
ZCTA5 36728,01,212,19740,-666666666,-666666666,176,100,167,55,62,25,9,16,186,97,89,97,69,28,2020-01-01,zipcode,Catherine
ZCTA5 36738,01,719,27041,-666666666,66800,655,480,618,50,311,161,50,46,381,278,103,278,231,47,2020-01-01,zipcode,Faunsdale
ZCTA5 36752,01,1066,46176,-666666666,108800,919,398,787,35,195,404,92,61,741,526,215,526,488,38,2020-01-01,zipcode,Lowndesboro
ZCTA5 36763,01,111,77596,-666666666,57200,101,41,91,14,43,28,3,3,70,41,29,41,39,2,2020-01-01,zipcode,Myrtlewood
ZCTA5 36767,01,1513,25085,319,68000,970,537,786,163,315,187,97,24,989,487,502,487,347,140,2020-01-01,zipcode,Orrville
ZCTA5 36768,01,923,32634,840,75000,802,340,655,77,204,272,70,32,634,345,289,345,252,93,2020-01-01,zipcode,Pine apple
ZCTA5 33786,12,1568,94688,2288,709400,1405,766,1347,48,197,317,459,326,1164,731,433,731,648,83,2020-01-01,zipcode,Belleair beach
ZCTA5 33954,12,9876,61683,1340,220700,8492,3848,7658,760,2313,2648,1248,689,4084,3777,307,3777,2970,807,2020-01-01,zipcode,Port charlotte
ZCTA5 07901,34,23552,142909,1928,816200,17995,5864,15816,601,2092,1832,5622,5669,8950,8409,541,8409,5878,2531,2020-01-01,zipcode,Summit
ZCTA5 07922,34,12270,178563,2242,633500,9768,3559,8689,353,861,1210,3237,3028,4329,4101,228,4101,3945,156,2020-01-01,zipcode,Berkeley heights
ZCTA5 07976,34,560,89784,1317,2000001,536,322,490,6,98,98,223,65,253,253,0,253,146,107,2020-01-01,zipcode,New vernon
ZCTA5 07866,34,22651,115263,1489,357000,18251,5802,15777,522,3034,4196,5244,2781,8547,8324,223,8324,6887,1437,2020-01-01,zipcode,Rockaway
ZCTA5 07920,34,27150,151954,2016,665900,21614,8239,18438,664,1835,2617,6101,7221,10200,9811,389,9811,8167,1644,2020-01-01,zipcode,Basking ridge
ZCTA5 07924,34,7574,161989,1721,656000,5788,1825,5127,331,640,692,1970,1494,2625,2505,120,2505,2179,326,2020-01-01,zipcode,Bernardsville
ZCTA5 07970,34,79,-666666666,-666666666,-666666666,79,0,79,0,0,0,79,0,40,40,0,40,40,0,2020-01-01,zipcode,Mount freedom
ZCTA5 07057,34,11553,72389,1293,386600,10024,3661,8745,708,2821,2214,2112,890,5138,4781,357,4781,1911,2870,2020-01-01,zipcode,Wallington
ZCTA5 07936,34,11009,127977,2599,598100,9208,3020,7826,568,2151,1309,2471,1327,3856,3765,91,3765,3587,178,2020-01-01,zipcode,East hanover
ZCTA5 07882,34,13892,81566,1159,252500,11414,3402,9944,547,3352,2977,2214,854,6097,5769,328,5769,4064,1705,2020-01-01,zipcode,Washington
ZCTA5 07885,34,10221,82301,1798,293100,8465,2729,7408,697,2252,1879,1816,764,4592,3947,645,3947,2653,1294,2020-01-01,zipcode,Wharton
ZCTA5 32169,12,10732,81164,1370,363100,10147,5802,9759,276,1909,3551,2298,1725,11982,5840,6142,5840,4796,1044,2020-01-01,zipcode,New smyrna beach
ZCTA5 32180,12,5184,54612,933,136000,3713,1811,3112,613,1060,1124,238,77,1519,1364,155,1364,1103,261,2020-01-01,zipcode,Pierson
ZCTA5 32187,12,1454,36318,-666666666,117100,1294,710,1190,186,514,377,98,15,701,659,42,659,580,79,2020-01-01,zipcode,San mateo
ZCTA5 32190,12,1310,52462,625,-666666666,1214,638,946,213,493,115,69,56,546,443,103,443,357,86,2020-01-01,zipcode,Seville
ZCTA5 32217,12,19785,50442,928,224100,16444,5310,14317,1143,3583,4049,3567,1975,9308,8595,713,8595,4436,4159,2020-01-01,zipcode,Jacksonville
ZCTA5 32219,12,12760,53469,918,123200,10378,4514,9072,1193,3517,2667,1174,521,4849,4367,482,4367,3754,613,2020-01-01,zipcode,Jacksonville
ZCTA5 32257,12,39154,65440,1155,219600,31555,10637,28016,2481,6952,8593,6553,3437,17388,16015,1373,16015,10321,5694,2020-01-01,zipcode,Jacksonville
ZCTA5 36442,01,3783,37027,545,89200,3053,1498,2678,477,1083,962,91,65,1731,1336,395,1336,1002,334,2020-01-01,zipcode,Florala
ZCTA5 36445,01,5647,33218,670,100500,4715,2710,4342,877,2164,871,295,135,2777,2181,596,2181,1656,525,2020-01-01,zipcode,Frisco city
ZCTA5 36456,01,1621,41250,438,28300,1254,730,1047,152,519,272,67,37,844,598,246,598,482,116,2020-01-01,zipcode,Mc kenzie
ZCTA5 36474,01,2770,45750,657,81800,2300,1028,1944,302,851,585,121,85,1547,1197,350,1197,1046,151,2020-01-01,zipcode,Red level
ZCTA5 36475,01,2063,36420,519,117800,1612,843,1470,181,713,273,231,72,1174,731,443,731,595,136,2020-01-01,zipcode,Repton
ZCTA5 36483,01,471,49219,-666666666,113700,417,221,393,41,225,63,48,16,240,183,57,183,155,28,2020-01-01,zipcode,Wing
ZCTA5 36502,01,17775,30853,602,108100,14621,8725,12499,2783,5998,2449,873,396,7585,6073,1512,6073,3876,2197,2020-01-01,zipcode,Atmore
ZCTA5 36522,01,6759,43482,751,102800,5046,2548,4465,779,1968,1242,333,143,2810,2386,424,2386,1681,705,2020-01-01,zipcode,Citronelle
ZCTA5 36530,01,5848,48993,812,171300,5183,2254,4512,609,1380,1635,626,262,3642,2732,910,2732,2248,484,2020-01-01,zipcode,Elberta
ZCTA5 36539,01,605,35909,-666666666,-666666666,501,307,355,43,192,94,12,14,324,234,90,234,209,25,2020-01-01,zipcode,Fruitdale
ZCTA5 36558,01,3755,45357,498,95400,3002,1504,2622,539,987,516,212,368,2193,1540,653,1540,1404,136,2020-01-01,zipcode,Millry
ZCTA5 36562,01,1230,43836,-666666666,103800,1027,500,904,184,521,112,69,18,567,439,128,439,401,38,2020-01-01,zipcode,Perdido
ZCTA5 36579,01,1425,53239,588,155900,1231,711,1145,155,489,234,258,9,1037,557,480,557,505,52,2020-01-01,zipcode,Stockton
ZCTA5 36587,01,11049,51709,735,119800,8765,4595,7161,1525,2964,2046,420,206,4430,3594,836,3594,2888,706,2020-01-01,zipcode,Wilmer
ZCTA5 36602,01,919,23063,398,215900,919,506,844,95,142,332,177,98,780,641,139,641,115,526,2020-01-01,zipcode,Mobile
ZCTA5 36606,01,18507,43058,857,126300,14143,4893,12345,1366,4480,2774,2348,1377,9147,7839,1308,7839,3764,4075,2020-01-01,zipcode,Mobile
ZCTA5 36609,01,23043,38894,832,160300,19053,7351,16205,1250,4349,5353,3484,1769,13278,11255,2023,11255,4731,6524,2020-01-01,zipcode,Mobile
ZCTA5 36610,01,10273,25126,657,45500,8054,4664,7167,1482,3290,1789,423,183,5705,3978,1727,3978,1857,2121,2020-01-01,zipcode,Mobile
ZCTA5 36611,01,5757,32332,834,73900,4083,1689,3341,469,1240,1149,346,137,2662,2139,523,2139,1038,1101,2020-01-01,zipcode,Mobile
ZCTA5 36695,01,52524,70786,1059,185600,40951,14789,34699,2248,9181,11013,8612,3645,20920,19345,1575,19345,12964,6381,2020-01-01,zipcode,Mobile
ZCTA5 36701,01,20513,35204,714,92600,16193,7166,13605,1757,4565,4384,1697,1202,11046,8221,2825,8221,4602,3619,2020-01-01,zipcode,Selma
ZCTA5 36726,01,4828,36483,722,82100,3737,2014,3341,619,1267,983,332,140,2579,1802,777,1802,1183,619,2020-01-01,zipcode,Camden
ZCTA5 36756,01,4949,24834,433,87800,4152,3065,3103,785,1020,643,374,281,2451,1699,752,1699,1306,393,2020-01-01,zipcode,Marion
ZCTA5 36793,01,313,-666666666,-666666666,-666666666,295,89,221,16,113,92,0,0,207,105,102,105,65,40,2020-01-01,zipcode,Lawley
ZCTA5 36853,01,8241,55107,744,171700,7057,3577,6435,937,1764,2012,1146,576,6138,3454,2684,3454,2764,690,2020-01-01,zipcode,Dadeville
ZCTA5 36863,01,11718,36680,595,100000,9766,4462,8588,1797,3057,2661,790,283,6147,4822,1325,4822,3329,1493,2020-01-01,zipcode,Lanett
ZCTA5 36869,01,21191,40574,836,112500,16420,7212,14102,2371,4452,4972,1579,728,10038,8545,1493,8545,5266,3279,2020-01-01,zipcode,Phenix city
ZCTA5 36908,01,1820,48929,-666666666,79900,1492,863,1307,163,449,524,130,41,1079,732,347,732,648,84,2020-01-01,zipcode,Gilbertown
ZCTA5 32113,12,5341,39967,-666666666,89000,4399,1884,3677,587,1542,1209,177,162,2619,2036,583,2036,1524,512,2020-01-01,zipcode,Citra
ZCTA5 32034,12,38189,85854,1059,353600,32701,15212,30344,1390,6345,8338,8738,5533,21212,16291,4921,16291,13404,2887,2020-01-01,zipcode,Fernandina beach
ZCTA5 32055,12,16313,40838,780,108100,12794,6044,11026,1819,4210,3424,1011,562,7005,5914,1091,5914,3965,1949,2020-01-01,zipcode,Lake city
ZCTA5 32061,12,442,87273,-666666666,190100,400,153,229,10,141,45,33,0,116,116,0,116,103,13,2020-01-01,zipcode,Lulu
ZCTA5 32066,12,7455,51886,622,98800,6272,3569,5264,1522,2130,1092,239,281,2499,1963,536,1963,1525,438,2020-01-01,zipcode,Mayo
ZCTA5 32071,12,3559,47540,631,106400,2822,1421,2124,337,728,734,234,91,1562,1167,395,1167,1016,151,2020-01-01,zipcode,O brien
ZCTA5 32079,12,426,55313,1551,-666666666,426,394,426,55,66,68,124,113,242,196,46,196,22,174,2020-01-01,zipcode,Penney farms
ZCTA5 32110,12,8537,37599,843,123500,6946,3640,6190,1069,2873,1409,560,279,3719,3123,596,3123,2029,1094,2020-01-01,zipcode,Bunnell
ZCTA5 32119,12,22431,43038,1108,149600,19452,9381,16794,1700,5500,5715,2356,1523,11728,10033,1695,10033,5980,4053,2020-01-01,zipcode,Daytona beach
ZCTA5 32124,12,6589,71042,1627,242400,5793,3530,5198,1146,1572,1216,734,530,2068,1934,134,1934,1536,398,2020-01-01,zipcode,Daytona beach
ZCTA5 36117,01,53594,66349,1040,181900,41647,13921,34840,1988,6548,9975,9510,6819,23969,21914,2055,21914,12752,9162,2020-01-01,zipcode,Montgomery
ZCTA5 36255,01,974,45714,-666666666,118300,820,377,716,143,324,203,7,39,497,410,87,410,380,30,2020-01-01,zipcode,Cragford
ZCTA5 36264,01,8270,46221,648,135600,6692,3488,5908,1084,2052,1757,687,328,3782,3179,603,3179,2325,854,2020-01-01,zipcode,Heflin
ZCTA5 36280,01,4532,62468,785,149200,3536,1703,3118,478,1106,719,339,476,2025,1621,404,1621,1343,278,2020-01-01,zipcode,Woodland
ZCTA5 36301,01,37951,42045,745,122900,30109,12936,25964,3986,8846,8657,2892,1583,17403,14687,2716,14687,8940,5747,2020-01-01,zipcode,Dothan
ZCTA5 36455,01,179,31625,575,70500,161,80,150,34,78,36,0,2,165,95,70,95,63,32,2020-01-01,zipcode,Lockhart
ZCTA5 36460,01,9029,30083,533,111600,7275,3433,6081,905,2611,1623,619,323,4587,3571,1016,3571,2164,1407,2020-01-01,zipcode,Monroeville
ZCTA5 36511,01,173,-666666666,-666666666,115000,173,76,173,109,16,22,26,0,344,157,187,157,157,0,2020-01-01,zipcode,Bon secour
ZCTA5 36524,01,1314,45152,568,88300,1118,635,980,188,401,252,63,76,947,532,415,532,477,55,2020-01-01,zipcode,Coffeeville
ZCTA5 36041,01,1336,42531,-666666666,76200,1103,560,919,181,378,245,86,29,725,539,186,539,494,45,2020-01-01,zipcode,Highland home
ZCTA5 36053,01,1896,31518,568,72500,1599,782,1284,214,519,460,45,46,1162,729,433,729,548,181,2020-01-01,zipcode,Midway
ZCTA5 36066,01,20283,66243,1128,186500,16101,5694,13622,1036,2906,3609,3524,2547,8789,8522,267,8522,5133,3389,2020-01-01,zipcode,Prattville
ZCTA5 36071,01,479,31518,569,83100,450,295,446,158,160,64,44,20,326,229,97,229,166,63,2020-01-01,zipcode,Rutledge
ZCTA5 36035,01,1691,51429,745,103900,1268,492,1134,133,512,191,188,110,1036,632,404,632,565,67,2020-01-01,zipcode,Goshen
ZCTA5 36048,01,1373,30592,567,70800,1157,555,998,334,371,227,55,11,891,629,262,629,478,151,2020-01-01,zipcode,Louisville
ZCTA5 36049,01,5965,44307,576,82300,4777,2128,4201,824,1757,746,627,247,2522,1960,562,1960,1474,486,2020-01-01,zipcode,Luverne
ZCTA5 36067,01,27682,52343,906,134400,22046,9827,18769,2656,6574,5470,2383,1686,11043,10025,1018,10025,7645,2380,2020-01-01,zipcode,Prattville
ZCTA5 36069,01,1714,48125,775,120600,1539,776,1359,179,398,407,179,196,1056,785,271,785,703,82,2020-01-01,zipcode,Ramer
ZCTA5 36075,01,2206,39659,838,85700,1808,946,1700,350,571,454,232,93,1157,924,233,924,722,202,2020-01-01,zipcode,Shorter
ZCTA5 36081,01,15701,31046,712,148100,13274,5860,7978,948,2362,1839,1533,1296,8240,6025,2215,6025,2785,3240,2020-01-01,zipcode,Troy
ZCTA5 36088,01,4511,31801,675,91800,4033,2059,1757,223,441,519,319,255,2043,1287,756,1287,692,595,2020-01-01,zipcode,Tuskegee institute
ZCTA5 36091,01,3177,45313,716,71000,2701,1277,2573,491,1220,605,96,161,1755,1375,380,1375,1080,295,2020-01-01,zipcode,Verbena
ZCTA5 36109,01,24802,53884,959,117600,20163,7906,17012,1464,4488,5788,3315,1957,10968,10144,824,10144,7115,3029,2020-01-01,zipcode,Montgomery
ZCTA5 36266,01,6064,46875,570,126400,4610,2104,4119,757,1773,1125,268,196,3125,2208,917,2208,1631,577,2020-01-01,zipcode,Lineville
ZCTA5 36017,01,3042,24850,425,68700,2617,1955,2389,802,953,480,105,49,1047,779,268,779,459,320,2020-01-01,zipcode,Clio
ZCTA5 36036,01,2045,44569,667,116500,1885,928,1460,289,484,323,243,121,1103,764,339,764,665,99,2020-01-01,zipcode,Grady
ZCTA5 36040,01,3516,27056,674,65500,2850,1567,2560,472,1138,573,217,160,1760,1562,198,1562,1017,545,2020-01-01,zipcode,Hayneville
ZCTA5 36051,01,2363,56691,893,84700,2013,681,1773,197,785,594,96,101,1015,907,108,907,756,151,2020-01-01,zipcode,Marbury
ZCTA5 36064,01,10574,104327,1456,310300,7709,2332,6782,268,1088,1677,2115,1634,3969,3635,334,3635,3378,257,2020-01-01,zipcode,Pike road
ZCTA5 36083,01,7187,35324,582,72100,6038,2815,5149,838,1412,1642,584,673,4710,3468,1242,3468,2063,1405,2020-01-01,zipcode,Tuskegee
ZCTA5 36107,01,7782,28825,783,64700,5909,2455,4947,1024,1435,1368,591,529,4321,3271,1050,3271,1228,2043,2020-01-01,zipcode,Montgomery
ZCTA5 36110,01,11864,38981,856,62700,9210,4486,7948,1859,2982,2203,590,314,5293,4062,1231,4062,2301,1761,2020-01-01,zipcode,Montgomery
ZCTA5 36205,01,718,-666666666,708,214000,566,344,541,112,124,211,29,65,439,339,100,339,207,132,2020-01-01,zipcode,Anniston
ZCTA5 36272,01,13012,42804,612,90200,10712,5379,9298,1763,3764,2474,641,656,6470,5210,1260,5210,3983,1227,2020-01-01,zipcode,Piedmont
ZCTA5 36278,01,4271,35741,635,170400,3424,1966,3149,485,877,1150,299,338,3114,1794,1320,1794,1441,353,2020-01-01,zipcode,Wedowee
ZCTA5 36310,01,6258,41818,542,94600,5410,3154,4688,1104,1651,1264,382,287,4236,2542,1694,2542,1905,637,2020-01-01,zipcode,Abbeville
ZCTA5 36312,01,6352,46383,708,128000,5078,2404,4452,598,1584,1598,446,226,2874,2331,543,2331,1727,604,2020-01-01,zipcode,Ashford
ZCTA5 36313,01,201,59569,-666666666,158800,144,8,144,27,0,117,0,0,163,114,49,114,95,19,2020-01-01,zipcode,Bellwood
ZCTA5 36344,01,5564,42801,680,146500,4511,2119,3999,630,1389,1477,347,156,2761,2180,581,2180,1516,664,2020-01-01,zipcode,Hartford
ZCTA5 36373,01,476,21364,-666666666,62000,468,323,325,145,131,49,0,0,427,200,227,200,176,24,2020-01-01,zipcode,Shorterville
ZCTA5 36375,01,6884,42928,730,93500,5656,2583,4921,801,2043,1409,422,246,3211,2674,537,2674,1976,698,2020-01-01,zipcode,Slocomb
ZCTA5 34429,12,8439,46808,887,150600,7602,4614,6985,573,2568,1929,1183,732,5241,3928,1313,3928,3402,526,2020-01-01,zipcode,Crystal river
ZCTA5 34607,12,8666,45041,1120,226500,7665,4490,6864,620,2071,2729,903,541,4997,3841,1156,3841,3171,670,2020-01-01,zipcode,Spring hill
ZCTA5 34209,12,35148,63629,1309,245300,31120,15174,28631,1606,9403,8676,5519,3427,18536,14763,3773,14763,11492,3271,2020-01-01,zipcode,Bradenton
ZCTA5 34241,12,15222,83882,1722,351800,12781,5772,11251,389,2680,3333,2879,1970,6561,5870,691,5870,5121,749,2020-01-01,zipcode,Sarasota
ZCTA5 34661,12,186,-666666666,-666666666,158300,186,114,186,0,114,58,14,0,110,110,0,110,86,24,2020-01-01,zipcode,Nobleton
ZCTA5 34945,12,5265,53611,641,204800,4453,2905,3930,713,1177,1136,658,246,1867,1466,401,1466,1312,154,2020-01-01,zipcode,Fort pierce
ZCTA5 32258,12,39963,84146,1457,241200,30437,8831,26636,792,5061,9364,7374,4045,14699,13967,732,13967,9875,4092,2020-01-01,zipcode,Jacksonville
ZCTA5 32259,12,57223,121868,1954,358800,42036,14317,36514,492,6914,10092,12149,6867,18388,17407,981,17407,15206,2201,2020-01-01,zipcode,Saint johns
ZCTA5 32310,12,15265,37804,842,94000,12486,5292,8714,1312,3264,2068,1429,641,7844,5797,2047,5797,2763,3034,2020-01-01,zipcode,Tallahassee
ZCTA5 32311,12,20897,74273,1236,221500,17124,5344,14961,544,2906,3871,3962,3678,9332,8232,1100,8232,5337,2895,2020-01-01,zipcode,Tallahassee
ZCTA5 32331,12,4687,39542,813,59200,3841,2383,3390,590,1617,768,266,149,2197,1757,440,1757,1454,303,2020-01-01,zipcode,Greenville
ZCTA5 32336,12,1144,32005,850,94700,861,456,831,98,342,238,95,58,773,463,310,463,351,112,2020-01-01,zipcode,Lamont
ZCTA5 32355,12,340,60404,925,306800,315,230,303,14,80,180,18,11,243,167,76,167,139,28,2020-01-01,zipcode,Saint marks
ZCTA5 32403,12,2072,66116,1707,-666666666,1411,308,811,9,72,315,265,150,587,441,146,441,0,441,2020-01-01,zipcode,Panama city
ZCTA5 79415,48,17894,32980,900,64600,13932,5373,9412,2283,3011,2449,959,710,7036,6354,682,6354,2562,3792,2020-01-01,zipcode,Lubbock
ZCTA5 79508,48,1060,54375,782,156000,848,322,772,73,362,218,89,30,511,428,83,428,345,83,2020-01-01,zipcode,Buffalo gap
ZCTA5 79512,48,7451,44678,653,68500,6304,3666,4746,711,2166,1305,428,136,3653,2141,1512,2141,1730,411,2020-01-01,zipcode,Colorado city
ZCTA5 79527,48,225,88750,-666666666,55600,152,67,144,21,65,35,21,2,166,70,96,70,66,4,2020-01-01,zipcode,Ira
ZCTA5 79532,48,671,62917,556,64800,472,120,398,76,127,120,57,18,358,227,131,227,180,47,2020-01-01,zipcode,Loraine
ZCTA5 79540,48,51,93036,-666666666,-666666666,48,12,45,0,19,16,10,0,32,26,6,26,26,0,2020-01-01,zipcode,Old glory
ZCTA5 36553,01,3361,47461,420,128500,2816,1511,1801,157,1035,383,62,164,1341,859,482,859,833,26,2020-01-01,zipcode,Mc intosh
ZCTA5 36582,01,24115,55794,737,132800,18796,8396,16651,2744,5643,5046,2212,1006,10006,8949,1057,8949,6864,2085,2020-01-01,zipcode,Theodore
ZCTA5 36584,01,650,-666666666,-666666666,72500,542,279,526,93,239,135,52,7,501,299,202,299,292,7,2020-01-01,zipcode,Vinegar bend
ZCTA5 36585,01,1412,46080,776,82600,902,453,826,27,389,269,23,118,512,359,153,359,272,87,2020-01-01,zipcode,Wagarville
ZCTA5 36603,01,9239,25516,664,86500,7585,5196,6545,1526,2571,1665,475,308,3978,2934,1044,2934,1102,1832,2020-01-01,zipcode,Mobile
ZCTA5 36605,01,27035,36815,869,84400,21009,9167,17446,2540,6884,5225,1878,919,12487,10090,2397,10090,5373,4717,2020-01-01,zipcode,Mobile
ZCTA5 36744,01,5972,28946,605,106800,4844,2467,3990,847,1623,919,432,169,3269,2347,922,2347,1514,833,2020-01-01,zipcode,Greensboro
ZCTA5 36761,01,715,24609,548,32300,601,384,536,196,185,116,8,31,611,356,255,356,246,110,2020-01-01,zipcode,Minter
ZCTA5 36765,01,2207,24135,1014,63400,1926,1087,1449,357,538,485,54,15,745,597,148,597,570,27,2020-01-01,zipcode,Newbern
ZCTA5 36783,01,633,30913,557,56900,565,298,536,37,251,175,51,22,588,295,293,295,233,62,2020-01-01,zipcode,Thomaston
ZCTA5 36785,01,1037,44118,755,85600,853,355,782,121,349,232,74,6,720,504,216,504,398,106,2020-01-01,zipcode,Tyler
ZCTA5 36792,01,1109,-666666666,-666666666,105100,781,460,781,132,284,338,0,27,723,465,258,465,331,134,2020-01-01,zipcode,Randolph
ZCTA5 32159,12,30459,46163,1078,207600,28079,19535,26738,1815,8528,9747,3550,3098,18921,15819,3102,15819,12892,2927,2020-01-01,zipcode,Lady lake
ZCTA5 32208,12,30648,35296,938,90600,24083,11509,21129,3620,7792,7055,1735,927,14709,12550,2159,12550,6749,5801,2020-01-01,zipcode,Jacksonville
ZCTA5 32209,12,35919,26568,783,63800,27524,13304,23621,4921,10468,6174,1421,637,17125,13824,3301,13824,6415,7409,2020-01-01,zipcode,Jacksonville
ZCTA5 32176,12,14821,50196,1229,251500,13467,6858,12427,763,3214,4290,2440,1720,10684,7165,3519,7165,5447,1718,2020-01-01,zipcode,Ormond beach
ZCTA5 32177,12,28343,40800,778,112700,22050,10729,19447,2767,9075,5334,1428,843,12522,11092,1430,11092,7263,3829,2020-01-01,zipcode,Palatka
ZCTA5 34715,12,21032,71117,1629,265600,16787,6611,14976,1739,4422,4995,2328,1492,7243,6747,496,6747,5041,1706,2020-01-01,zipcode,Clermont
ZCTA5 34638,12,30182,97056,1669,275200,21536,6526,18895,1127,4341,6120,5152,2155,9934,9524,410,9524,7787,1737,2020-01-01,zipcode,Land o lakes
ZCTA5 34688,12,7779,84017,1346,369400,6693,3295,6219,286,1175,1888,1700,1170,3507,3197,310,3197,2847,350,2020-01-01,zipcode,Tarpon springs
ZCTA5 34714,12,24227,55406,1420,199200,19172,6099,16270,866,4776,6143,3380,1105,9799,7638,2161,7638,3861,3777,2020-01-01,zipcode,Clermont
ZCTA5 34772,12,31830,73358,1370,248200,24093,9138,20717,1358,5730,8807,3762,1060,10799,9105,1694,9105,7584,1521,2020-01-01,zipcode,Saint cloud
ZCTA5 34653,12,36166,40264,1030,117200,30105,14786,27032,2780,11174,8656,3139,1283,17567,15210,2357,15210,9535,5675,2020-01-01,zipcode,New port richey
ZCTA5 34982,12,26034,42971,1030,144300,21173,9677,18876,3033,7021,5688,2201,933,11478,10262,1216,10262,7724,2538,2020-01-01,zipcode,Fort pierce
ZCTA5 34233,12,18560,66469,1477,250300,15579,6474,14429,848,4468,3716,3309,2088,9235,8160,1075,8160,5745,2415,2020-01-01,zipcode,Sarasota
ZCTA5 36860,01,1890,40190,544,71700,1690,843,1406,293,433,553,100,27,1082,795,287,795,589,206,2020-01-01,zipcode,Hurtsboro
ZCTA5 36801,01,25127,51697,739,163900,19736,7362,17341,1902,4624,5104,3230,2481,11091,9973,1118,9973,6397,3576,2020-01-01,zipcode,Opelika
ZCTA5 36804,01,20356,52629,723,118700,15922,6805,14052,1933,4020,4837,2030,1232,7931,7343,588,7343,5808,1535,2020-01-01,zipcode,Opelika
ZCTA5 36830,01,40141,56595,894,268900,32628,12339,23598,1490,2690,5960,7256,6202,18117,15986,2131,15986,8582,7404,2020-01-01,zipcode,Auburn
ZCTA5 36852,01,3314,42927,917,130700,2329,959,1947,181,893,774,57,42,1231,972,259,972,734,238,2020-01-01,zipcode,Cusseta
ZCTA5 36870,01,18435,63797,856,141400,15119,5297,12838,1616,3126,5333,1433,1330,7653,7051,602,7051,5529,1522,2020-01-01,zipcode,Phenix city
ZCTA5 32580,12,4924,69702,1140,268500,3790,1171,3283,196,779,1414,617,277,2203,1808,395,1808,1171,637,2020-01-01,zipcode,Valparaiso
ZCTA5 32668,12,5144,48530,1050,230200,4424,2322,4005,687,1835,1064,270,149,2519,2017,502,2017,1751,266,2020-01-01,zipcode,Morriston
ZCTA5 32703,12,55239,53762,1172,216900,43944,15886,38217,5649,10833,11642,7386,2707,21379,19623,1756,19623,12844,6779,2020-01-01,zipcode,Apopka
ZCTA5 32060,12,23437,46662,706,116200,18941,9616,16778,2854,6427,4373,1797,1327,10498,8456,2042,8456,6631,1825,2020-01-01,zipcode,Live oak
ZCTA5 32094,12,3909,73825,828,103200,3377,2222,3157,830,1582,559,87,99,992,693,299,693,570,123,2020-01-01,zipcode,Wellborn
ZCTA5 32139,12,1028,39760,-666666666,74700,935,724,891,198,493,94,85,21,626,367,259,367,324,43,2020-01-01,zipcode,Georgetown
ZCTA5 32145,12,5788,47180,919,121300,4469,1970,3832,636,1330,1299,485,82,2360,2016,344,2016,1678,338,2020-01-01,zipcode,Hastings
ZCTA5 32148,12,10766,36224,634,65700,8462,4717,7447,1286,3831,1429,696,205,5379,4343,1036,4343,3188,1155,2020-01-01,zipcode,Interlachen
ZCTA5 79541,48,1172,-666666666,-666666666,219200,858,287,753,0,341,169,47,196,456,392,64,392,359,33,2020-01-01,zipcode,Ovalo
ZCTA5 79701,48,32692,54915,1075,141900,23564,7743,19492,5995,5259,5047,2303,888,10925,9881,1044,9881,6277,3604,2020-01-01,zipcode,Midland
ZCTA5 79748,48,277,65655,-666666666,-666666666,191,67,125,32,62,9,22,0,103,71,32,71,54,17,2020-01-01,zipcode,Knott
ZCTA5 79754,48,117,44076,-666666666,-666666666,91,20,88,3,13,72,0,0,87,62,25,62,11,51,2020-01-01,zipcode,Mentone
ZCTA5 79783,48,279,124375,-666666666,275000,203,81,184,21,95,55,5,8,91,80,11,80,65,15,2020-01-01,zipcode,Tarzan
ZCTA5 79842,48,397,40250,-666666666,100800,357,136,338,41,40,131,69,57,385,226,159,226,135,91,2020-01-01,zipcode,Marathon
ZCTA5 79907,48,51208,35539,767,90600,39642,17170,31885,9683,9886,8618,2881,817,17189,16023,1166,16023,9463,6560,2020-01-01,zipcode,El paso
ZCTA5 79567,48,3149,45625,645,59700,2379,888,1976,512,631,527,268,38,1612,1134,478,1134,788,346,2020-01-01,zipcode,Winters
ZCTA5 79719,48,465,33333,773,45600,360,161,298,99,105,85,8,1,231,172,59,172,142,30,2020-01-01,zipcode,Barstow
ZCTA5 79730,48,229,62891,-666666666,24100,142,57,128,52,62,12,1,1,136,76,60,76,76,0,2020-01-01,zipcode,Coyanosa
ZCTA5 79756,48,9576,70476,875,110300,7221,2701,6023,1209,2090,2025,565,134,3880,3345,535,3345,2425,920,2020-01-01,zipcode,Monahans
ZCTA5 79759,48,0,-666666666,-666666666,-666666666,0,0,0,0,0,0,0,0,0,0,0,0,0,0,2020-01-01,zipcode,Notrees
ZCTA5 79765,48,17017,91250,1322,237800,12205,3163,10674,761,3036,3380,2407,1090,6514,6097,417,6097,4195,1902,2020-01-01,zipcode,Odessa
ZCTA5 79109,48,43652,60176,820,166900,34718,11137,30091,1951,7515,11284,6550,2791,19787,17943,1844,17943,10779,7164,2020-01-01,zipcode,Amarillo
ZCTA5 79225,48,1002,53472,684,39900,767,226,650,204,167,168,92,19,591,379,212,379,290,89,2020-01-01,zipcode,Chillicothe
ZCTA5 79226,48,2767,50571,690,66800,2216,1000,1759,191,549,690,237,92,1758,1090,668,1090,792,298,2020-01-01,zipcode,Clarendon
ZCTA5 79227,48,1260,38056,489,47700,1094,452,924,172,265,372,86,29,879,540,339,540,437,103,2020-01-01,zipcode,Crowell
ZCTA5 79234,48,42,36500,-666666666,-666666666,37,13,37,0,11,24,2,0,45,16,29,16,8,8,2020-01-01,zipcode,Flomot
ZCTA5 79248,48,1595,36818,378,41100,1205,455,1031,207,289,333,127,75,1023,680,343,680,412,268,2020-01-01,zipcode,Paducah
ZCTA5 79251,48,29,-666666666,-666666666,108300,29,3,29,16,0,8,2,3,15,8,7,8,8,0,2020-01-01,zipcode,Quail
ZCTA5 79256,48,359,34688,620,45000,334,177,322,51,151,65,44,11,191,151,40,151,102,49,2020-01-01,zipcode,Roaring springs
ZCTA5 79257,48,903,36316,642,66300,761,320,719,124,249,258,55,33,620,388,232,388,296,92,2020-01-01,zipcode,Silverton
ZCTA5 79261,48,370,42232,532,55300,319,130,243,57,76,55,42,13,396,157,239,157,106,51,2020-01-01,zipcode,Turkey
ZCTA5 79336,48,16827,45956,679,98700,12955,5046,10480,2633,2817,3444,1104,482,6979,6015,964,6015,4266,1749,2020-01-01,zipcode,Levelland
ZCTA5 79339,48,6591,42622,773,66500,4906,2044,4116,960,1440,1192,414,110,3096,2420,676,2420,1661,759,2020-01-01,zipcode,Littlefield
ZCTA5 79344,48,238,98664,-666666666,64100,114,9,114,0,21,4,89,0,114,74,40,74,68,6,2020-01-01,zipcode,Maple
ZCTA5 79781,48,267,36974,-666666666,151300,217,113,192,9,56,50,62,15,147,124,23,124,118,6,2020-01-01,zipcode,Sheffield
ZCTA5 79785,48,125,54000,-666666666,47100,125,40,106,29,9,65,3,0,51,16,35,16,16,0,2020-01-01,zipcode,Toyah
ZCTA5 79831,48,0,-666666666,-666666666,-666666666,0,0,0,0,0,0,0,0,6,0,6,0,0,0,2020-01-01,zipcode,
ZCTA5 79843,48,2457,41969,644,168400,2149,559,1716,518,208,412,372,206,1473,985,488,985,719,266,2020-01-01,zipcode,Marfa
ZCTA5 79124,48,8159,88828,986,257400,6427,2508,5825,232,1197,2234,1334,828,3517,3395,122,3395,2842,553,2020-01-01,zipcode,Amarillo
ZCTA5 79062,48,267,54643,642,65600,204,61,140,13,63,33,25,6,103,78,25,78,65,13,2020-01-01,zipcode,Morse
ZCTA5 79091,48,69,-666666666,-666666666,-666666666,31,0,31,16,0,15,0,0,35,16,19,16,16,0,2020-01-01,zipcode,Umbarger
ZCTA5 79237,48,454,66750,633,-666666666,414,122,375,34,86,213,20,22,360,231,129,231,168,63,2020-01-01,zipcode,Hedley
ZCTA5 79244,48,894,52396,635,74300,661,235,588,51,185,250,92,10,499,302,197,302,215,87,2020-01-01,zipcode,Matador
ZCTA5 79346,48,2198,42549,715,32900,1708,620,1472,465,507,405,74,21,1069,816,253,816,580,236,2020-01-01,zipcode,Morton
ZCTA5 79351,48,1478,59394,781,80000,1080,424,989,217,302,324,113,33,733,574,159,574,404,170,2020-01-01,zipcode,Odonnell
ZCTA5 79749,48,492,117708,760,180600,361,154,245,13,72,86,59,15,141,123,18,123,86,37,2020-01-01,zipcode,Lenorah
ZCTA5 79755,48,103,117656,-666666666,309100,91,26,91,17,19,30,25,0,61,47,14,47,20,27,2020-01-01,zipcode,Midkiff
ZCTA5 79764,48,22519,68419,884,115100,16835,4675,13683,3631,4348,3345,1414,945,7688,7104,584,7104,5066,2038,2020-01-01,zipcode,Odessa
ZCTA5 79788,48,913,60088,630,69200,609,243,547,81,328,121,15,2,341,305,36,305,276,29,2020-01-01,zipcode,Wickett
ZCTA5 79789,48,1023,100978,808,103900,684,214,571,39,204,216,99,13,379,324,55,324,272,52,2020-01-01,zipcode,Wink
ZCTA5 79849,48,11605,38937,733,80400,8261,3392,6366,2913,1845,1173,399,36,3693,3199,494,3199,2070,1129,2020-01-01,zipcode,San elizario
ZCTA5 34951,12,16896,47965,961,144700,15132,8244,13513,1910,4325,4830,1763,685,8654,7051,1603,7051,6051,1000,2020-01-01,zipcode,Fort pierce
ZCTA5 34956,12,10195,43527,719,85600,8355,4354,6567,2172,2207,1650,416,122,2848,2393,455,2393,1645,748,2020-01-01,zipcode,Indiantown
ZCTA5 34972,12,20132,43851,851,136100,16375,8659,14027,3335,5688,3014,1415,575,7327,5994,1333,5994,4075,1919,2020-01-01,zipcode,Okeechobee
ZCTA5 34974,12,24871,46610,823,105500,20753,10927,18526,3072,6876,5976,1929,673,13748,10109,3639,10109,8150,1959,2020-01-01,zipcode,Okeechobee
ZCTA5 34744,12,60555,53598,1170,226700,48467,17182,40682,6642,11241,12994,6735,3070,20670,17975,2695,17975,12019,5956,2020-01-01,zipcode,Kissimmee
ZCTA5 34753,12,6014,55933,965,165400,4706,1671,3803,1139,1393,1020,147,104,1752,1675,77,1675,1238,437,2020-01-01,zipcode,Mascotte
ZCTA5 34787,12,74842,94038,1405,337000,56549,17208,49459,4266,10407,13348,13732,7706,26915,24677,2238,24677,17911,6766,2020-01-01,zipcode,Winter garden
ZCTA5 34236,12,13384,80761,1325,697200,12707,7859,12392,857,1693,2630,3417,3795,11453,7652,3801,7652,4713,2939,2020-01-01,zipcode,Sarasota
ZCTA5 34292,12,15090,68765,1455,321800,14031,9671,13500,691,3085,3991,3454,2279,9810,7747,2063,7747,6265,1482,2020-01-01,zipcode,Venice
ZCTA5 34420,12,18592,46383,836,122100,14903,6356,13230,1834,5130,4891,942,433,8031,7122,909,7122,4771,2351,2020-01-01,zipcode,Belleview
ZCTA5 34452,12,12538,46216,897,127200,10503,5397,9542,864,3612,3657,1060,349,5896,5197,699,5197,4197,1000,2020-01-01,zipcode,Inverness
ZCTA5 34470,12,20000,41166,910,122500,16175,7210,13990,1805,4809,4753,1766,857,9085,7989,1096,7989,4509,3480,2020-01-01,zipcode,Ocala
ZCTA5 34474,12,17358,51325,1134,147800,14254,5528,12787,1198,3616,3640,3141,1192,8099,7270,829,7270,3377,3893,2020-01-01,zipcode,Ocala
ZCTA5 34482,12,23576,52506,822,166100,20755,13395,18959,3695,7054,4991,2310,909,9022,7091,1931,7091,5632,1459,2020-01-01,zipcode,Ocala
ZCTA5 34602,12,8320,61549,944,164100,7118,3407,6427,964,2326,1871,707,559,3188,2904,284,2904,2572,332,2020-01-01,zipcode,Brooksville
ZCTA5 34606,12,27014,45125,959,146700,22788,12574,20733,2126,7301,7030,2875,1401,13677,11854,1823,11854,9089,2765,2020-01-01,zipcode,Spring hill
ZCTA5 34102,12,11930,95654,1300,1007100,10649,6120,10002,687,1575,2348,3190,2202,9836,5743,4093,5743,3988,1755,2020-01-01,zipcode,Naples
ZCTA5 34113,12,22573,61682,1444,307700,19863,9499,17138,2258,5178,4050,3648,2004,14069,8811,5258,8811,6221,2590,2020-01-01,zipcode,Naples
ZCTA5 34119,12,31355,94957,1560,481000,25845,12803,23772,686,5131,6916,6152,4887,16768,13192,3576,13192,10567,2625,2020-01-01,zipcode,Naples
ZCTA5 34208,12,43397,50050,1126,204300,33431,13990,28746,6154,10139,6664,3669,2120,15814,13429,2385,13429,7790,5639,2020-01-01,zipcode,Bradenton
ZCTA5 75068,48,69656,103863,1724,276700,50230,12727,43809,3256,8163,13631,12091,6668,22386,21753,633,21753,17070,4683,2020-01-01,zipcode,Little elm
ZCTA5 75070,48,109085,108939,1578,341000,80281,22145,69863,2152,8482,19609,27372,12248,39685,37715,1970,37715,26299,11416,2020-01-01,zipcode,Mckinney
ZCTA5 75087,48,36718,105238,1338,294100,28126,9005,24036,1157,3111,8037,7409,4322,13326,12963,363,12963,10467,2496,2020-01-01,zipcode,Rockwall
ZCTA5 75092,48,26297,56611,968,170600,21275,7700,18042,1457,3812,7711,3451,1611,12034,10849,1185,10849,6169,4680,2020-01-01,zipcode,Sherman
ZCTA5 75115,48,53118,71292,1212,195900,41639,12890,35834,3504,8293,14519,6119,3399,20088,18989,1099,18989,12303,6686,2020-01-01,zipcode,Desoto
ZCTA5 75127,48,1906,50502,716,156800,1539,902,1361,396,531,273,101,60,840,757,83,757,616,141,2020-01-01,zipcode,Fruitvale
ZCTA5 75142,48,21746,61629,1037,124100,16295,5610,13972,3020,5431,3958,1035,528,6689,6246,443,6246,4687,1559,2020-01-01,zipcode,Kaufman
ZCTA5 75155,48,2971,52277,845,103000,2125,844,1763,615,554,458,108,28,1027,945,82,945,776,169,2020-01-01,zipcode,Rice
ZCTA5 75164,48,788,48895,1092,156800,607,229,516,57,300,98,49,12,334,310,24,310,233,77,2020-01-01,zipcode,Josephine
ZCTA5 75454,48,11848,108487,1814,315000,8408,2519,6761,498,1490,2010,1983,780,3489,3401,88,3401,2972,429,2020-01-01,zipcode,Melissa
ZCTA5 75455,48,27700,53246,739,106900,20425,7507,16597,3586,5740,4381,2047,843,10528,9384,1144,9384,6049,3335,2020-01-01,zipcode,Mount pleasant
ZCTA5 75478,48,947,45185,783,106500,767,419,712,167,186,265,78,16,387,354,33,354,276,78,2020-01-01,zipcode,Saltillo
ZCTA5 75481,48,412,54583,-666666666,132600,295,146,251,23,117,62,36,13,204,141,63,141,132,9,2020-01-01,zipcode,Sulphur bluff
ZCTA5 75488,48,747,57617,-666666666,172500,526,232,508,21,203,217,53,14,402,263,139,263,223,40,2020-01-01,zipcode,Telephone
ZCTA5 75494,48,10741,55646,801,135600,8365,4109,7443,1142,2222,2679,1032,368,4773,3632,1141,3632,2958,674,2020-01-01,zipcode,Winnsboro
ZCTA5 75497,48,3963,58505,705,210200,3481,1998,3273,349,925,1327,574,98,2018,1694,324,1694,1420,274,2020-01-01,zipcode,Yantis
ZCTA5 75554,48,2356,52163,538,112500,1970,871,1572,136,786,340,221,89,1164,887,277,887,772,115,2020-01-01,zipcode,Avery
ZCTA5 75556,48,1292,62639,840,81700,957,381,838,133,426,169,92,18,550,459,91,459,362,97,2020-01-01,zipcode,Bloomburg
ZCTA5 75566,48,686,48276,-666666666,94100,582,392,509,111,169,153,66,10,462,286,176,286,281,5,2020-01-01,zipcode,Marietta
ZCTA5 75567,48,4655,54583,834,107500,3601,1617,3184,163,1554,896,355,216,2097,1728,369,1728,1315,413,2020-01-01,zipcode,Maud
ZCTA5 75641,48,138,45375,825,102500,131,79,120,24,55,41,0,0,83,63,20,63,38,25,2020-01-01,zipcode,Easton
ZCTA5 36912,01,1813,43232,907,63600,1580,924,1464,136,486,581,104,157,1024,752,272,752,622,130,2020-01-01,zipcode,Lisman
ZCTA5 36921,01,814,28100,-666666666,109900,805,501,725,256,250,162,47,10,691,504,187,504,489,15,2020-01-01,zipcode,Toxey
ZCTA5 36922,01,651,40741,-666666666,66900,574,256,472,157,157,152,0,6,341,220,121,220,200,20,2020-01-01,zipcode,Ward
ZCTA5 36481,01,258,15652,-666666666,-666666666,219,155,170,41,99,12,0,18,223,98,125,98,54,44,2020-01-01,zipcode,Vredenburgh
ZCTA5 36569,01,445,47262,-666666666,68200,442,277,442,38,165,219,19,1,370,212,158,212,212,0,2020-01-01,zipcode,Saint stephens
ZCTA5 36732,01,7628,33136,543,142100,6119,2790,5216,564,1986,1594,606,466,3977,3217,760,3217,1878,1339,2020-01-01,zipcode,Demopolis
ZCTA5 36849,01,4228,-666666666,-666666666,-666666666,4228,3003,15,0,0,5,10,0,0,0,0,0,0,0,2020-01-01,zipcode,Auburn university
ZCTA5 36919,01,1707,30648,433,59200,1388,775,1261,316,499,358,53,35,982,716,266,716,585,131,2020-01-01,zipcode,Silas
ZCTA5 36006,01,1571,19792,784,174200,1417,731,1278,132,487,475,125,59,851,691,160,691,622,69,2020-01-01,zipcode,Billingsley
ZCTA5 36374,01,643,63813,-666666666,65200,591,241,578,127,161,209,49,32,521,283,238,283,254,29,2020-01-01,zipcode,Skipperville
ZCTA5 36507,01,21598,44206,730,130400,17268,7685,14383,2615,4870,4757,1291,850,8307,7414,893,7414,5482,1932,2020-01-01,zipcode,Bay minette
ZCTA5 36052,01,620,123342,-666666666,710000,554,174,472,19,88,92,197,76,342,290,52,290,276,14,2020-01-01,zipcode,Mathews
ZCTA5 36092,01,20805,59034,869,155300,16629,7689,14933,1839,5662,4268,2278,886,9387,8068,1319,8068,5951,2117,2020-01-01,zipcode,Wetumpka
ZCTA5 36273,01,3132,51205,665,106600,2560,1057,2118,426,859,501,182,150,1524,1303,221,1303,1110,193,2020-01-01,zipcode,Ranburne
ZCTA5 36038,01,19,-666666666,-666666666,-666666666,19,19,19,0,19,0,0,0,10,10,0,10,10,0,2020-01-01,zipcode,Gantt
ZCTA5 36082,01,1004,-666666666,-666666666,-666666666,1004,790,14,0,8,6,0,0,0,0,0,0,0,0,2020-01-01,zipcode,Troy
ZCTA5 36112,01,262,-666666666,-666666666,-666666666,262,10,174,0,48,126,0,0,0,0,0,0,0,0,2020-01-01,zipcode,Montgomery
ZCTA5 36321,01,1898,49659,758,150700,1456,677,1292,232,482,403,99,76,765,691,74,691,563,128,2020-01-01,zipcode,Cowarts
ZCTA5 36421,01,10870,47153,617,108700,8296,3902,7248,886,2441,2587,873,461,5335,4027,1308,4027,2990,1037,2020-01-01,zipcode,Andalusia
ZCTA5 36439,01,508,56875,837,157200,322,132,280,17,111,75,40,37,214,163,51,163,113,50,2020-01-01,zipcode,Excel
ZCTA5 36454,01,7,-666666666,-666666666,-666666666,7,7,7,0,7,0,0,0,41,4,37,4,4,0,2020-01-01,zipcode,Lenox
ZCTA5 36512,01,12,-666666666,-666666666,-666666666,12,12,12,12,0,0,0,0,6,6,0,6,6,0,2020-01-01,zipcode,Bucks
ZCTA5 36543,01,55,-666666666,-666666666,-666666666,21,0,21,0,0,7,0,14,11,11,0,11,11,0,2020-01-01,zipcode,Huxford
ZCTA5 36555,01,870,81375,853,291100,782,364,676,6,138,198,189,145,442,337,105,337,296,41,2020-01-01,zipcode,Magnolia springs
ZCTA5 36568,01,108,-666666666,-666666666,-666666666,108,55,95,23,19,10,0,43,74,74,0,74,64,10,2020-01-01,zipcode,Saint elmo
ZCTA5 36590,01,0,-666666666,-666666666,-666666666,0,0,0,0,0,0,0,0,0,0,0,0,0,0,2020-01-01,zipcode,Theodore
ZCTA5 36615,01,0,-666666666,-666666666,-666666666,0,0,0,0,0,0,0,0,0,0,0,0,0,0,2020-01-01,zipcode,Mobile
ZCTA5 36616,01,8,-666666666,-666666666,-666666666,8,0,0,0,0,0,0,0,21,8,13,8,0,8,2020-01-01,zipcode,Mobile
ZCTA5 36688,01,232,-666666666,-666666666,-666666666,232,163,0,0,0,0,0,0,0,0,0,0,0,0,2020-01-01,zipcode,Mobile
ZCTA5 36753,01,26,-666666666,-666666666,-666666666,26,26,26,8,0,0,0,18,33,26,7,26,18,8,2020-01-01,zipcode,Mc williams
ZCTA5 36766,01,23,-666666666,-666666666,141700,23,13,23,5,0,0,12,6,28,14,14,14,10,4,2020-01-01,zipcode,Oak hill
ZCTA5 36859,01,14,-666666666,-666666666,-666666666,14,4,14,0,0,4,10,0,4,4,0,4,4,0,2020-01-01,zipcode,
ZCTA5 36865,01,59,55750,-666666666,116700,59,13,37,0,13,17,7,0,28,22,6,22,12,10,2020-01-01,zipcode,Loachapoka
ZCTA5 36913,01,50,-666666666,-666666666,-666666666,50,50,50,37,0,13,0,0,21,21,0,21,21,0,2020-01-01,zipcode,Melvin
ZCTA5 36108,01,16247,23431,638,64100,13199,7121,11541,3115,3869,2858,1154,545,8827,6609,2218,6609,3843,2766,2020-01-01,zipcode,Montgomery
ZCTA5 36256,01,1325,49620,588,100500,1074,505,978,132,328,360,77,81,774,601,173,601,522,79,2020-01-01,zipcode,Daviston
ZCTA5 36115,01,994,72708,1367,-666666666,649,166,466,0,55,253,87,71,266,266,0,266,0,266,2020-01-01,zipcode,Montgomery
ZCTA5 36323,01,7863,41292,627,83900,6806,3584,5994,1450,2065,1754,507,218,3788,2990,798,2990,2234,756,2020-01-01,zipcode,Elba
ZCTA5 36528,01,1610,65481,1096,309100,1521,802,1401,58,196,616,347,184,2143,679,1464,679,630,49,2020-01-01,zipcode,Dauphin island
ZCTA5 79347,48,6954,55410,546,81700,5269,2206,4122,949,1669,841,427,236,2669,2048,621,2048,1563,485,2020-01-01,zipcode,Muleshoe
ZCTA5 79379,48,551,45455,608,67200,432,197,355,79,124,94,44,14,219,174,45,174,143,31,2020-01-01,zipcode,Whiteface
ZCTA5 79360,48,16760,69964,764,154500,11341,4232,9016,3531,2907,1569,715,294,4964,4537,427,4537,3446,1091,2020-01-01,zipcode,Seminole
ZCTA5 79366,48,903,106111,993,252300,791,279,700,23,124,179,211,163,468,400,68,400,372,28,2020-01-01,zipcode,Ransom canyon
ZCTA5 79377,48,246,58182,-666666666,95000,183,90,153,59,48,27,18,1,144,84,60,84,58,26,2020-01-01,zipcode,Welch
ZCTA5 79381,48,1590,56250,825,138300,1193,453,986,163,244,299,217,63,611,544,67,544,418,126,2020-01-01,zipcode,Wilson
ZCTA5 79382,48,8515,72959,1017,193400,5737,1420,4932,378,1141,2150,865,398,3055,2921,134,2921,2230,691,2020-01-01,zipcode,Wolfforth
ZCTA5 32669,12,13457,71880,965,230000,10229,3635,9043,378,1920,3479,2050,1216,5347,4854,493,4854,4046,808,2020-01-01,zipcode,Newberry
ZCTA5 32692,12,126,-666666666,-666666666,-666666666,79,42,79,37,27,0,15,0,646,42,604,42,42,0,2020-01-01,zipcode,Suwannee
ZCTA5 32701,12,24060,57778,1251,192500,20404,6428,18213,934,3323,7549,4694,1713,12038,10808,1230,10808,5345,5463,2020-01-01,zipcode,Altamonte springs
ZCTA5 32709,12,1601,57150,-666666666,190600,1441,410,1325,136,551,385,212,41,707,661,46,661,584,77,2020-01-01,zipcode,Christmas
ZCTA5 32052,12,8727,42523,666,94900,7451,5086,6588,1830,3212,1214,255,77,2902,2147,755,2147,1476,671,2020-01-01,zipcode,Jasper
ZCTA5 32058,12,4728,42382,841,118600,3963,2095,3324,859,1502,809,97,57,1501,1292,209,1292,1009,283,2020-01-01,zipcode,Lawtey
ZCTA5 32038,12,10639,37896,778,115000,8786,4520,7834,915,2979,3021,641,278,4871,3973,898,3973,3318,655,2020-01-01,zipcode,Fort white
ZCTA5 32059,12,2507,41831,750,77800,2145,1098,1930,407,715,671,77,60,1257,1028,229,1028,834,194,2020-01-01,zipcode,Lee
ZCTA5 32102,12,2081,45395,1151,162500,1782,1124,1662,318,612,419,215,98,1591,980,611,980,827,153,2020-01-01,zipcode,Astor
ZCTA5 32114,12,33731,33474,928,122500,28599,13501,22389,3339,7277,7496,3036,1241,15758,13290,2468,13290,4405,8885,2020-01-01,zipcode,Daytona beach
ZCTA5 32117,12,28266,40659,1084,120000,23178,10115,20510,2011,7698,7116,2572,1113,13098,11249,1849,11249,5565,5684,2020-01-01,zipcode,Daytona beach
ZCTA5 32118,12,17492,43385,1066,250700,15640,7660,14433,1091,4209,4668,2793,1672,15292,9111,6181,9111,5456,3655,2020-01-01,zipcode,Daytona beach
ZCTA5 32132,12,7954,41724,858,174300,7226,3408,6765,441,2617,2793,521,393,4156,3887,269,3887,3194,693,2020-01-01,zipcode,Edgewater
ZCTA5 32137,12,44396,65573,1386,258600,38662,20413,34715,2374,11072,10838,6389,4042,22642,17568,5074,17568,14741,2827,2020-01-01,zipcode,Palm coast
ZCTA5 32174,12,52115,56383,1091,222000,44726,22704,40711,2920,11832,13630,7963,4366,25696,23090,2606,23090,18340,4750,2020-01-01,zipcode,Ormond beach
ZCTA5 32204,12,7507,47513,965,220000,6700,2034,5813,698,1028,1447,1688,952,4847,4123,724,4123,993,3130,2020-01-01,zipcode,Jacksonville
ZCTA5 32205,12,30349,48292,942,178900,25013,7910,22764,2703,6171,6598,4508,2784,15584,13859,1725,13859,6979,6880,2020-01-01,zipcode,Jacksonville
ZCTA5 32211,12,35160,44186,920,138800,26730,8457,22840,2614,8324,7664,3097,1141,15142,13606,1536,13606,6552,7054,2020-01-01,zipcode,Jacksonville
ZCTA5 32216,12,37867,52915,1068,178900,30514,10785,26602,2611,7655,7858,5801,2677,17922,16152,1770,16152,7448,8704,2020-01-01,zipcode,Jacksonville
ZCTA5 32224,12,41017,76428,1303,323900,33714,11501,25585,1284,4569,7444,8013,4275,16302,14907,1395,14907,8693,6214,2020-01-01,zipcode,Jacksonville
ZCTA5 32226,12,16407,85000,1689,243100,12738,4762,11492,827,3362,3999,2361,943,6712,5730,982,5730,5130,600,2020-01-01,zipcode,Jacksonville
ZCTA5 32323,12,113,-666666666,-666666666,-666666666,113,113,113,0,51,19,20,23,368,71,297,71,42,29,2020-01-01,zipcode,
ZCTA5 32347,12,7240,53344,664,117200,5453,2691,4868,526,1945,1610,560,227,3491,2583,908,2583,2134,449,2020-01-01,zipcode,Perry
ZCTA5 32408,12,19463,57202,1100,257300,16038,5757,14648,613,3485,5689,3458,1403,18149,8702,9447,8702,5833,2869,2020-01-01,zipcode,Panama city
ZCTA5 32713,12,21212,70421,1123,230400,18029,7805,16270,783,5502,5748,3130,1107,9195,8366,829,8366,6974,1392,2020-01-01,zipcode,Debary
ZCTA5 32714,12,37983,54611,1263,202900,31092,9669,27305,1848,6256,9160,7195,2846,16914,15224,1690,15224,7351,7873,2020-01-01,zipcode,Altamonte springs
ZCTA5 32784,12,10869,56250,911,153000,8839,3885,7828,1171,2545,2999,635,478,4932,3962,970,3962,2989,973,2020-01-01,zipcode,Umatilla
ZCTA5 32789,12,25767,79907,1353,500300,22083,9285,18707,701,2748,3849,6142,5267,12520,11187,1333,11187,7317,3870,2020-01-01,zipcode,Winter park
ZCTA5 32796,12,20738,52135,961,161700,17692,8666,15815,1368,5681,5090,2220,1456,9776,8208,1568,8208,6625,1583,2020-01-01,zipcode,Titusville
ZCTA5 32806,12,26964,72533,1203,304500,22050,6216,19919,1129,4076,4992,5802,3920,12179,10922,1257,10922,6768,4154,2020-01-01,zipcode,Orlando
ZCTA5 32825,12,60254,64400,1329,235900,49406,15672,40753,4466,9803,14492,7810,4182,21827,19123,2704,19123,12544,6579,2020-01-01,zipcode,Orlando
ZCTA5 32826,12,37297,57023,1194,180000,35007,20622,15029,1693,3580,4326,3324,2106,9708,8672,1036,8672,4309,4363,2020-01-01,zipcode,Orlando
ZCTA5 32421,12,4793,37377,596,86500,3851,2033,3341,755,1197,1060,289,40,1961,1592,369,1592,1329,263,2020-01-01,zipcode,Altha
ZCTA5 32433,12,19459,47311,813,97400,15262,6900,13660,2764,5401,4026,930,539,8238,6875,1363,6875,5088,1787,2020-01-01,zipcode,Defuniak springs
ZCTA5 32437,12,763,31618,619,107600,543,231,501,71,261,148,20,1,349,310,39,310,204,106,2020-01-01,zipcode,Ebro
ZCTA5 32438,12,3842,38878,481,75000,3477,1697,2927,612,1141,898,250,26,1854,1613,241,1613,1515,98,2020-01-01,zipcode,Fountain
ZCTA5 32444,12,21922,73258,1312,225900,16788,5461,14140,667,3740,5214,2914,1605,8961,7936,1025,7936,5610,2326,2020-01-01,zipcode,Lynn haven
ZCTA5 32446,12,10745,47554,731,127400,9023,4409,7742,906,2443,2832,742,819,4631,4063,568,4063,2741,1322,2020-01-01,zipcode,Marianna
ZCTA5 32449,12,751,-666666666,-666666666,65600,501,182,469,126,215,128,0,0,306,218,88,218,195,23,2020-01-01,zipcode,Wewahitchka
ZCTA5 32062,12,1666,52917,-666666666,138800,1361,732,1194,250,521,246,57,120,1030,582,448,582,569,13,2020-01-01,zipcode,Mc alpin
ZCTA5 32072,12,114,94728,-666666666,-666666666,114,41,114,0,32,34,39,9,136,59,77,59,59,0,2020-01-01,zipcode,
ZCTA5 32073,12,42153,62688,1124,183700,34319,12113,30081,2640,8270,11621,5084,2466,16027,15094,933,15094,9890,5204,2020-01-01,zipcode,Orange park
ZCTA5 32084,12,36415,54519,1062,214800,31161,13099,26545,2327,9258,7436,4590,2934,16571,13011,3560,13011,8998,4013,2020-01-01,zipcode,Saint augustine
ZCTA5 32086,12,30392,58714,1176,246300,26053,11353,23269,1867,5908,9095,4176,2223,13930,11575,2355,11575,8814,2761,2020-01-01,zipcode,Saint augustine
ZCTA5 32095,12,13155,76846,1076,372000,9992,3296,8669,374,2014,2168,2165,1948,4761,4483,278,4483,3699,784,2020-01-01,zipcode,Saint augustine
ZCTA5 32096,12,2870,41629,594,94400,2328,1315,2140,529,868,471,200,72,1449,1189,260,1189,897,292,2020-01-01,zipcode,White springs
ZCTA5 32097,12,19139,69980,1315,208600,14810,5082,12937,1379,4667,3977,1926,988,7510,6890,620,6890,5523,1367,2020-01-01,zipcode,Yulee
ZCTA5 36028,01,1474,38821,524,104800,1203,601,1008,187,308,339,129,45,989,621,368,621,402,219,2020-01-01,zipcode,Dozier
ZCTA5 36030,01,540,48345,608,151500,519,221,466,21,303,88,45,9,294,173,121,173,139,34,2020-01-01,zipcode,Forest home
ZCTA5 36034,01,1141,41912,542,57200,869,358,659,72,242,213,77,55,440,324,116,324,287,37,2020-01-01,zipcode,Glenwood
ZCTA5 36042,01,1645,56433,-666666666,105700,1301,619,1153,180,565,256,113,39,951,577,374,577,534,43,2020-01-01,zipcode,Honoraville
ZCTA5 36046,01,1345,40885,-666666666,88000,1092,446,952,254,288,260,97,53,599,485,114,485,458,27,2020-01-01,zipcode,Lapine
ZCTA5 36054,01,15559,56593,861,143600,11674,4038,9717,1133,2947,3010,1635,992,6164,5735,429,5735,4071,1664,2020-01-01,zipcode,Millbrook
ZCTA5 36089,01,7683,31596,569,80100,5948,3036,5051,1356,2036,1141,325,193,3417,2610,807,2610,1849,761,2020-01-01,zipcode,Union springs
ZCTA5 36104,01,9084,31717,694,86100,7474,3949,5695,1192,1662,1427,731,683,4742,3451,1291,3451,972,2479,2020-01-01,zipcode,Montgomery
ZCTA5 36105,01,9636,32588,841,81800,8169,4113,7363,1899,2196,2166,714,388,5487,4113,1374,4113,2474,1639,2020-01-01,zipcode,Montgomery
ZCTA5 36116,01,45027,51124,901,98600,34602,12071,28904,3431,6916,9082,5464,4011,20543,17838,2705,17838,8622,9216,2020-01-01,zipcode,Montgomery
ZCTA5 36207,01,19737,59832,835,166800,16018,6698,13727,979,3931,4813,2066,1938,9706,8118,1588,8118,5957,2161,2020-01-01,zipcode,Anniston
ZCTA5 36260,01,4286,59228,607,144400,3276,1729,3021,353,1184,868,341,275,1769,1539,230,1539,1236,303,2020-01-01,zipcode,Eastaboga
ZCTA5 36263,01,385,-666666666,710,101400,368,205,320,46,149,68,10,47,254,163,91,163,99,64,2020-01-01,zipcode,Graham
ZCTA5 36265,01,20299,47152,647,144300,17124,7413,12993,1451,4138,4055,1911,1438,9376,8209,1167,8209,5122,3087,2020-01-01,zipcode,Jacksonville
ZCTA5 36267,01,239,-666666666,-666666666,-666666666,97,85,97,0,74,23,0,0,12,12,0,12,12,0,2020-01-01,zipcode,Millerville
ZCTA5 35951,01,12226,45073,603,112400,9382,4422,8020,2275,2417,2308,737,283,4894,4241,653,4241,3177,1064,2020-01-01,zipcode,Albertville
ZCTA5 35957,01,15861,41773,589,96900,12061,5363,10162,1739,3455,3574,915,479,6469,5649,820,5649,3588,2061,2020-01-01,zipcode,Boaz
ZCTA5 35963,01,1076,33451,-666666666,111000,962,475,924,126,267,431,74,26,669,518,151,518,371,147,2020-01-01,zipcode,Dawson
ZCTA5 35972,01,1196,-666666666,-666666666,77600,963,531,869,245,322,186,89,27,554,499,55,499,445,54,2020-01-01,zipcode,Gallant
ZCTA5 35973,01,3368,41694,-666666666,89000,2734,1435,2374,614,785,747,185,43,1546,1224,322,1224,1072,152,2020-01-01,zipcode,Gaylesville
ZCTA5 35022,01,20684,63434,898,185700,17495,6228,14902,1061,4697,5004,2807,1333,9028,8492,536,8492,6584,1908,2020-01-01,zipcode,Bessemer
ZCTA5 35036,01,255,-666666666,256,65000,233,158,157,40,100,13,4,0,155,121,34,121,33,88,2020-01-01,zipcode,Brookside
ZCTA5 35043,01,13297,93731,1099,244700,9697,3509,8390,246,1709,3117,2309,1009,4433,4103,330,4103,3698,405,2020-01-01,zipcode,Chelsea
ZCTA5 35058,01,9216,44514,764,126100,7578,3197,6847,1136,2516,2261,601,333,4194,3610,584,3610,2721,889,2020-01-01,zipcode,Cullman
ZCTA5 35061,01,1593,52989,947,150400,1475,517,1188,108,404,559,92,25,664,479,185,479,310,169,2020-01-01,zipcode,Dolomite
ZCTA5 35062,01,8347,51657,693,124200,6573,3075,5857,800,2079,1867,787,324,3602,3267,335,3267,2632,635,2020-01-01,zipcode,Dora
ZCTA5 35074,01,91,-666666666,-666666666,-666666666,91,0,91,48,0,43,0,0,43,43,0,43,0,43,2020-01-01,zipcode,Green pond
ZCTA5 35077,01,13935,41282,669,123200,11752,5866,10171,2153,3380,3260,781,597,6582,5624,958,5624,3988,1636,2020-01-01,zipcode,Hanceville
ZCTA5 35080,01,19047,93176,1366,197400,14377,4350,12318,537,2083,3744,4236,1718,6820,6416,404,6416,5996,420,2020-01-01,zipcode,Helena
ZCTA5 35089,01,1776,52810,768,86200,1621,744,1445,255,530,528,69,63,852,691,161,691,597,94,2020-01-01,zipcode,Kellyton
ZCTA5 35091,01,3179,93042,859,209900,2277,668,2016,108,566,850,295,197,1269,1109,160,1109,1056,53,2020-01-01,zipcode,Kimberly
ZCTA5 35096,01,8695,59619,858,131100,6933,2633,5935,1068,1882,1993,734,258,4130,3113,1017,3113,2688,425,2020-01-01,zipcode,Lincoln
ZCTA5 35112,01,198,145739,-666666666,-666666666,157,17,157,8,66,83,0,0,93,93,0,93,83,10,2020-01-01,zipcode,Margaret
ZCTA5 35126,01,20761,67992,889,145500,16687,6330,13893,1366,4862,4946,1978,741,8067,7533,534,7533,6398,1135,2020-01-01,zipcode,Pinson
ZCTA5 35130,01,3421,46786,470,100700,2874,1590,2579,555,1108,744,97,75,1954,1500,454,1500,1233,267,2020-01-01,zipcode,Quinton
ZCTA5 35133,01,3295,49764,-666666666,143100,2619,1326,2437,377,868,974,144,74,1433,1229,204,1229,1162,67,2020-01-01,zipcode,Remlap
ZCTA5 35151,01,7827,61507,844,126700,6349,2921,5711,868,1913,1784,636,510,3688,2823,865,2823,2560,263,2020-01-01,zipcode,Sylacauga
ZCTA5 35172,01,2941,37361,765,99500,2477,1224,2301,276,1124,713,148,40,1284,1155,129,1155,840,315,2020-01-01,zipcode,Trafford
ZCTA5 35178,01,3126,33530,767,118600,2407,1275,2159,342,950,588,197,82,1581,1277,304,1277,1061,216,2020-01-01,zipcode,Vincent
ZCTA5 76435,48,443,39500,-666666666,64300,381,211,370,28,190,110,34,8,358,208,150,208,196,12,2020-01-01,zipcode,Carbon
ZCTA5 76455,48,926,55000,-666666666,112900,754,297,628,79,204,211,123,11,573,356,217,356,309,47,2020-01-01,zipcode,Gustine
ZCTA5 76472,48,1502,72979,880,123600,1253,440,1120,197,340,127,342,114,702,615,87,615,444,171,2020-01-01,zipcode,Santo
ZCTA5 76484,48,909,66979,732,124200,779,552,641,53,195,221,111,61,583,331,252,331,298,33,2020-01-01,zipcode,Palo pinto
ZCTA5 76022,48,13945,63782,1222,177800,11268,3531,9807,578,2179,4389,1764,897,6114,5679,435,5679,2955,2724,2020-01-01,zipcode,Bedford
ZCTA5 76073,48,6237,85710,998,163100,5097,1639,4496,514,1596,1248,1089,49,2063,1945,118,1945,1555,390,2020-01-01,zipcode,Paradise
ZCTA5 76655,48,8168,100000,1026,198100,6474,1827,5539,366,1281,2057,1376,459,3158,2938,220,2938,2605,333,2020-01-01,zipcode,Lorena
ZCTA5 76798,48,1630,-666666666,-666666666,-666666666,1630,1382,20,0,0,8,12,0,0,0,0,0,0,0,2020-01-01,zipcode,Waco
ZCTA5 76885,48,234,-666666666,-666666666,-666666666,125,95,108,0,8,56,22,22,183,73,110,73,50,23,2020-01-01,zipcode,Valley spring
ZCTA5 76903,48,31429,40518,785,86200,25063,10035,21552,5210,7157,6286,1985,914,13661,11403,2258,11403,7083,4320,2020-01-01,zipcode,San angelo
ZCTA5 76379,48,680,79375,809,115900,508,133,392,33,134,142,70,13,218,197,21,197,157,40,2020-01-01,zipcode,Scotland
ZCTA5 76070,48,955,90703,-666666666,-666666666,756,314,606,34,73,197,278,24,446,424,22,424,424,0,2020-01-01,zipcode,Nemo
ZCTA5 76126,48,23844,93125,1221,236500,17860,5703,15729,972,3035,5024,4388,2310,9438,8455,983,8455,6942,1513,2020-01-01,zipcode,Fort worth
ZCTA5 75410,48,4332,60644,648,151100,3593,1856,3455,530,1478,878,409,160,2353,1881,472,1881,1633,248,2020-01-01,zipcode,Alba
ZCTA5 75435,48,1146,34911,539,64800,927,451,874,118,328,257,141,30,699,499,200,499,329,170,2020-01-01,zipcode,Deport
ZCTA5 75437,48,1144,67125,950,133000,827,319,764,52,243,328,89,52,521,425,96,425,397,28,2020-01-01,zipcode,Dike
ZCTA5 75167,48,12091,99868,1526,278800,9664,2708,8325,1127,1929,2845,1766,658,3841,3762,79,3762,3370,392,2020-01-01,zipcode,Waxahachie
ZCTA5 75180,48,23939,51945,1024,116800,17328,5260,14075,4699,4405,4005,724,242,7537,6635,902,6635,4346,2289,2020-01-01,zipcode,Balch springs
ZCTA5 75203,48,18295,37418,888,108600,13855,4849,11711,3566,3485,2520,1400,740,7532,6759,773,6759,2520,4239,2020-01-01,zipcode,Dallas
ZCTA5 75209,48,14558,99003,1447,576300,12191,3523,11195,780,1352,1802,4469,2792,7447,6807,640,6807,4100,2707,2020-01-01,zipcode,Dallas
ZCTA5 75215,48,17184,31558,863,82000,13301,5238,11193,2715,3550,3120,1207,601,8015,6601,1414,6601,2243,4358,2020-01-01,zipcode,Dallas
ZCTA5 75218,48,22712,90522,1375,353700,18402,5204,17190,1367,2086,3687,5705,4345,10557,9826,731,9826,6523,3303,2020-01-01,zipcode,Dallas
ZCTA5 75228,48,75303,46061,940,165800,55057,18472,44484,12262,13656,10547,5661,2358,28013,25843,2170,25843,11812,14031,2020-01-01,zipcode,Dallas
ZCTA5 75234,48,39644,72054,1385,200000,31240,8796,26141,5094,5736,6140,6096,3075,15185,13859,1326,13859,8184,5675,2020-01-01,zipcode,Dallas
ZCTA5 75237,48,21607,30638,933,136800,14866,4662,12354,2117,4177,4577,1006,477,10165,9197,968,9197,1210,7987,2020-01-01,zipcode,Dallas
ZCTA5 75247,48,772,18245,925,-666666666,709,427,687,144,208,241,50,44,173,158,15,158,0,158,2020-01-01,zipcode,Dallas
ZCTA5 75401,48,20689,43104,931,95000,15671,5804,13671,2943,5544,3316,1237,631,8134,7462,672,7462,4083,3379,2020-01-01,zipcode,Greenville
ZCTA5 75402,48,17463,69632,1076,157500,14009,5167,12206,1002,3713,4046,1975,1470,7207,6424,783,6424,4271,2153,2020-01-01,zipcode,Greenville
ZCTA5 75407,48,18371,69672,1380,193800,14070,4261,11485,1806,3803,3670,1739,467,6513,6031,482,6031,4594,1437,2020-01-01,zipcode,Princeton
ZCTA5 75418,48,14570,51168,881,123000,12210,6735,10482,1735,3850,3097,1102,698,5597,4835,762,4835,3318,1517,2020-01-01,zipcode,Bonham
ZCTA5 75431,48,1871,51108,812,58900,1487,639,1342,313,614,372,36,7,777,607,170,607,405,202,2020-01-01,zipcode,Como
ZCTA5 75450,48,197,110481,-666666666,187500,177,24,177,11,26,132,8,0,191,112,79,112,104,8,2020-01-01,zipcode,Lake creek
ZCTA5 75451,48,1375,38621,-666666666,117600,1158,567,1007,75,188,498,183,63,755,556,199,556,492,64,2020-01-01,zipcode,Leesburg
ZCTA5 75452,48,4673,63125,879,163400,3608,1366,2831,372,1067,886,332,174,1611,1480,131,1480,1055,425,2020-01-01,zipcode,Leonard
ZCTA5 75471,48,1808,49350,1069,123500,1229,487,975,164,371,320,106,14,629,545,84,545,331,214,2020-01-01,zipcode,Pickton
ZCTA5 75489,48,1110,61094,959,115500,802,342,710,59,167,383,64,37,412,397,15,397,245,152,2020-01-01,zipcode,Tom bean
ZCTA5 75495,48,8621,91110,1041,215900,6783,2128,5626,304,1753,2281,1058,230,3074,2737,337,2737,2265,472,2020-01-01,zipcode,Van alstyne
ZCTA5 75551,48,11268,54844,811,115000,8858,3973,7849,773,3025,2178,1276,597,5040,4246,794,4246,3423,823,2020-01-01,zipcode,Atlanta
ZCTA5 35739,01,4380,49306,742,144100,3636,1359,3282,528,1326,918,390,120,2144,1916,228,1916,1533,383,2020-01-01,zipcode,Ardmore
ZCTA5 35746,01,558,34948,-666666666,-666666666,558,411,535,172,223,130,10,0,432,299,133,299,266,33,2020-01-01,zipcode,Fackler
ZCTA5 35756,01,14757,102135,1425,240600,10859,3766,9376,500,1498,2713,3013,1652,5229,4677,552,4677,4178,499,2020-01-01,zipcode,Madison
ZCTA5 35758,01,47979,86495,1023,252700,38042,12554,32980,823,3870,7849,11671,8767,20654,19804,850,19804,13602,6202,2020-01-01,zipcode,Madison
ZCTA5 35760,01,4797,66042,782,134500,3422,1231,3076,567,945,849,642,73,1817,1619,198,1619,1339,280,2020-01-01,zipcode,New hope
ZCTA5 35764,01,554,26657,580,77500,511,244,464,195,197,60,11,1,288,275,13,275,214,61,2020-01-01,zipcode,Paint rock
ZCTA5 35772,01,4722,36607,626,84700,3753,1971,3383,608,1477,824,337,137,2348,1844,504,1844,1386,458,2020-01-01,zipcode,Stevenson
ZCTA5 07933,34,2651,150404,3309,567100,2347,738,2026,156,271,389,629,581,989,989,0,989,870,119,2020-01-01,zipcode,Gillette
ZCTA5 07727,34,6061,87253,1119,462700,4947,2090,4371,172,1432,899,1056,812,2577,2255,322,2255,1785,470,2020-01-01,zipcode,Farmingdale
ZCTA5 07642,34,10287,155742,1326,566300,8269,2374,6967,294,1211,1395,2297,1770,3535,3454,81,3454,3040,414,2020-01-01,zipcode,Hillsdale
ZCTA5 07644,34,24389,64249,1373,389400,20217,7064,17171,2945,5199,4624,2982,1421,9267,8825,442,8825,3524,5301,2020-01-01,zipcode,Lodi
ZCTA5 07645,34,8538,156042,1789,612600,6872,2352,5962,238,1005,1266,1914,1539,2986,2902,84,2902,2532,370,2020-01-01,zipcode,Montvale
ZCTA5 07648,34,5789,131563,1827,629900,4642,1862,3953,181,957,712,1280,823,2000,1945,55,1945,1625,320,2020-01-01,zipcode,Norwood
ZCTA5 32583,12,30135,66200,1044,164100,26321,13124,23093,4070,7685,7664,2558,1116,10573,9608,965,9608,7458,2150,2020-01-01,zipcode,Milton
ZCTA5 32601,12,19805,24916,865,189000,18097,7340,9011,495,1469,2346,2573,2128,9965,8200,1765,8200,2131,6069,2020-01-01,zipcode,Gainesville
ZCTA5 32626,12,8583,35345,694,106400,7166,3893,6304,677,3046,1878,526,177,4529,3686,843,3686,2807,879,2020-01-01,zipcode,Chiefland
ZCTA5 32643,12,11453,57404,940,173900,9122,3915,7780,871,2377,3180,864,488,4551,4094,457,4094,3399,695,2020-01-01,zipcode,High springs
ZCTA5 32656,12,14538,54631,896,142500,11535,5026,9995,1204,3589,3597,1059,546,6348,5423,925,5423,4362,1061,2020-01-01,zipcode,Keystone heights
ZCTA5 32664,12,379,51196,-666666666,152100,311,190,294,22,79,83,67,43,200,166,34,166,110,56,2020-01-01,zipcode,Mc intosh
ZCTA5 32666,12,6620,56544,1125,164900,6016,3251,5341,374,2058,1583,540,786,3712,2737,975,2737,2379,358,2020-01-01,zipcode,Melrose
ZCTA5 32697,12,226,42031,844,56900,164,73,111,31,50,25,3,2,150,87,63,87,11,76,2020-01-01,zipcode,Worthington springs
ZCTA5 32725,12,49802,55888,1198,173500,39551,17719,34344,4199,11272,12839,4485,1549,18339,16823,1516,16823,12974,3849,2020-01-01,zipcode,Deltona
ZCTA5 32751,12,21478,78337,1395,317800,17750,6026,15427,651,2052,4214,5151,3359,9891,8731,1160,8731,5709,3022,2020-01-01,zipcode,Maitland
ZCTA5 32763,12,23837,49566,1160,155600,19806,8393,17659,1779,6062,6359,2046,1413,10596,9473,1123,9473,5915,3558,2020-01-01,zipcode,Orange city
ZCTA5 32766,12,16415,118395,1948,384100,12537,4243,10588,578,1911,2649,2873,2577,5069,4925,144,4925,4382,543,2020-01-01,zipcode,Oviedo
ZCTA5 32798,12,2583,51399,-666666666,104000,2404,1437,2331,184,888,980,180,99,1554,1329,225,1329,1281,48,2020-01-01,zipcode,Zellwood
ZCTA5 32805,12,19764,33433,825,158100,16285,6398,14903,3211,5583,3115,2129,865,9538,7385,2153,7385,2899,4486,2020-01-01,zipcode,Orlando
ZCTA5 32817,12,35332,64043,1316,239000,30117,11096,20942,1606,5084,6855,4834,2563,13009,11083,1926,11083,6134,4949,2020-01-01,zipcode,Orlando
ZCTA5 32839,12,53012,42124,1137,152500,42179,14587,35060,6938,11095,10843,4538,1646,23385,17392,5993,17392,4208,13184,2020-01-01,zipcode,Orlando
ZCTA5 32948,12,6594,42312,794,115000,4848,1800,3688,1398,1087,707,419,77,2014,1559,455,1559,982,577,2020-01-01,zipcode,Fellsmere
ZCTA5 32952,12,20553,79720,1015,313900,17439,7482,15556,727,3306,4959,4177,2387,10030,8273,1757,8273,7039,1234,2020-01-01,zipcode,Merritt island
ZCTA5 32953,12,23829,66834,1104,291800,20131,8370,17856,1080,4025,6162,4332,2257,11480,9507,1973,9507,7156,2351,2020-01-01,zipcode,Merritt island
ZCTA5 32955,12,39846,72969,1358,247500,33217,13090,29834,1728,7490,10001,6607,4008,18117,15284,2833,15284,12110,3174,2020-01-01,zipcode,Rockledge
ZCTA5 32967,12,22819,51777,959,255800,19293,10422,17097,2208,5241,5008,2487,2153,10575,8009,2566,8009,6317,1692,2020-01-01,zipcode,Vero beach
ZCTA5 32456,12,8113,57872,1159,233200,6766,2819,6130,433,1598,1970,1273,856,6553,3619,2934,3619,2654,965,2020-01-01,zipcode,Port saint joe
ZCTA5 32504,12,21467,62254,1070,187900,16679,6466,14333,975,2887,4503,3311,2657,9723,8985,738,8985,5437,3548,2020-01-01,zipcode,Pensacola
ZCTA5 32505,12,27369,37673,912,72200,21634,9143,19014,2955,7329,6377,1645,708,13198,11025,2173,11025,5111,5914,2020-01-01,zipcode,Pensacola
ZCTA5 32506,12,37604,51477,1092,135300,30208,12122,25416,3263,6834,10050,3382,1887,16301,14283,2018,14283,8476,5807,2020-01-01,zipcode,Pensacola
ZCTA5 32507,12,33689,51842,963,172200,27051,10116,22959,2115,5403,8857,4338,2246,18716,13631,5085,13631,8273,5358,2020-01-01,zipcode,Pensacola
ZCTA5 32541,12,19085,84865,1622,381600,16100,5131,14500,940,2557,4410,4361,2232,16749,8317,8432,8317,5459,2858,2020-01-01,zipcode,Destin
ZCTA5 32564,12,2832,69643,1103,146200,2240,1024,2213,227,660,954,279,93,1185,1100,85,1100,1015,85,2020-01-01,zipcode,Holt
ZCTA5 32568,12,2806,58295,681,170000,2307,888,2078,213,729,864,135,137,1255,1101,154,1101,942,159,2020-01-01,zipcode,Mc david
ZCTA5 32579,12,10796,84375,1266,321500,8882,3557,7853,444,1683,1944,1963,1819,4797,4382,415,4382,3085,1297,2020-01-01,zipcode,Shalimar
ZCTA5 32609,12,19495,37725,953,115300,16371,6797,13777,2058,3883,4803,1930,1103,8287,7160,1127,7160,3838,3322,2020-01-01,zipcode,Gainesville
ZCTA5 32628,12,5377,38500,633,80100,4449,2919,3955,763,2003,913,230,46,1875,1524,351,1524,1203,321,2020-01-01,zipcode,Cross city
ZCTA5 76111,48,22567,51742,996,111900,16796,5339,13316,4885,4105,2550,1383,393,7709,6966,743,6966,4110,2856,2020-01-01,zipcode,Fort worth
ZCTA5 76112,48,42218,46009,939,134800,32635,11073,27830,5098,7831,9115,4016,1770,19111,16697,2414,16697,7978,8719,2020-01-01,zipcode,Fort worth
ZCTA5 76118,48,16594,73542,1055,196500,12973,3621,11273,1171,2778,4312,2064,948,5902,5480,422,5480,4158,1322,2020-01-01,zipcode,Fort worth
ZCTA5 76205,48,21657,52101,1112,242200,18722,6258,12980,1377,2173,4165,3420,1845,8308,7450,858,7450,2781,4669,2020-01-01,zipcode,Denton
ZCTA5 76230,48,9633,62572,974,136700,7600,3288,6726,724,2526,2214,879,383,5123,3954,1169,3954,3102,852,2020-01-01,zipcode,Bowie
ZCTA5 76239,48,1310,60583,732,175000,1119,483,978,59,335,390,135,59,653,583,70,583,412,171,2020-01-01,zipcode,Forestburg
ZCTA5 76245,48,1463,50903,719,121600,1292,818,1292,132,343,590,175,52,1289,733,556,733,579,154,2020-01-01,zipcode,Gordonville
ZCTA5 76432,48,1467,49625,913,158700,1191,555,1076,111,471,307,147,40,795,574,221,574,526,48,2020-01-01,zipcode,Blanket
ZCTA5 76460,48,433,75324,-666666666,178000,416,164,308,15,46,152,63,32,283,165,118,165,129,36,2020-01-01,zipcode,Loving
ZCTA5 76704,48,7681,21383,616,102700,5594,2644,4377,760,2071,1348,63,135,3726,3186,540,3186,1118,2068,2020-01-01,zipcode,Waco
ZCTA5 76682,48,3034,68289,952,106300,2224,782,1851,295,620,532,314,90,1168,992,176,992,779,213,2020-01-01,zipcode,Riesel
ZCTA5 76692,48,10048,55283,672,116500,8320,3778,7456,1071,2581,2396,1009,399,5421,3915,1506,3915,2926,989,2020-01-01,zipcode,Whitney
ZCTA5 76706,48,39667,33321,877,127000,32330,13114,16988,3088,5203,4978,2328,1391,15505,13488,2017,13488,5278,8210,2020-01-01,zipcode,Waco
ZCTA5 76821,48,4680,44031,855,82700,3789,1808,3407,605,1212,1068,385,137,2459,1864,595,1864,1349,515,2020-01-01,zipcode,Ballinger
ZCTA5 76824,48,13,-666666666,-666666666,-666666666,13,13,13,0,0,13,0,0,13,13,0,13,0,13,2020-01-01,zipcode,Bend
ZCTA5 76832,48,709,40625,627,169300,551,222,452,98,142,136,75,1,335,182,153,182,105,77,2020-01-01,zipcode,Cherokee
ZCTA5 76842,48,277,49167,-666666666,-666666666,267,171,252,70,25,86,58,13,192,114,78,114,110,4,2020-01-01,zipcode,Fredonia
ZCTA5 76853,48,1333,59167,1250,161500,1131,541,976,127,310,292,172,75,803,474,329,474,371,103,2020-01-01,zipcode,Lometa
ZCTA5 76857,48,1773,41143,-666666666,150000,1539,945,1424,156,539,476,168,85,1864,868,996,868,646,222,2020-01-01,zipcode,May
ZCTA5 76873,48,93,60486,-666666666,-666666666,69,50,69,7,24,2,14,22,91,41,50,41,38,3,2020-01-01,zipcode,Rockwood
ZCTA5 76901,48,30972,58580,937,129600,24379,8115,20589,2560,7032,6368,2920,1709,12300,11096,1204,11096,7857,3239,2020-01-01,zipcode,San angelo
ZCTA5 76904,48,36688,70555,890,203600,29013,9359,23059,1435,4714,8051,5795,3064,15882,14479,1403,14479,8918,5561,2020-01-01,zipcode,San angelo
ZCTA5 76905,48,12746,66793,1026,135700,9066,3081,7796,1037,2320,2699,1299,441,5124,4521,603,4521,2975,1546,2020-01-01,zipcode,San angelo
ZCTA5 76932,48,3941,60318,857,98500,2798,898,2317,386,957,680,167,127,1390,1176,214,1176,732,444,2020-01-01,zipcode,Big lake
ZCTA5 76559,48,6180,58125,937,141400,4415,1301,3761,281,1120,1659,409,292,2431,2170,261,2170,1339,831,2020-01-01,zipcode,Nolanville
ZCTA5 76565,48,175,65592,-666666666,-666666666,175,122,121,19,29,21,44,8,51,51,0,51,51,0,2020-01-01,zipcode,Pottsville
ZCTA5 76574,48,19328,58631,880,174800,15388,5969,13668,2542,4906,3974,1493,753,7089,6571,518,6571,4594,1977,2020-01-01,zipcode,Taylor
ZCTA5 76637,48,461,60000,515,261800,393,241,335,62,116,98,43,16,303,216,87,216,153,63,2020-01-01,zipcode,Cranfills gap
ZCTA5 76653,48,1481,47059,-666666666,141100,1221,581,1056,109,517,363,55,12,724,590,134,590,489,101,2020-01-01,zipcode,Kosse
ZCTA5 76665,48,2562,50565,584,108900,2177,1062,1888,205,602,750,206,125,1448,1057,391,1057,668,389,2020-01-01,zipcode,Meridian
ZCTA5 76670,48,1617,48472,855,101900,1310,450,1171,251,451,412,42,15,610,523,87,523,354,169,2020-01-01,zipcode,Milford
ZCTA5 76690,48,1081,55000,824,92500,742,333,628,136,282,112,67,31,524,366,158,366,274,92,2020-01-01,zipcode,Walnut springs
ZCTA5 76693,48,1825,41133,737,200600,1465,846,1335,257,263,582,179,54,919,707,212,707,465,242,2020-01-01,zipcode,Wortham
ZCTA5 76705,48,31868,43521,743,109900,25655,11749,20077,4424,6154,6480,2093,926,12452,11050,1402,11050,6300,4750,2020-01-01,zipcode,Waco
ZCTA5 76862,48,210,59286,-666666666,182700,177,84,160,2,74,57,24,3,293,96,197,96,85,11,2020-01-01,zipcode,Millersview
ZCTA5 76871,48,823,57813,875,161400,682,361,576,63,224,173,91,25,593,311,282,311,223,88,2020-01-01,zipcode,Richland springs
ZCTA5 76890,48,865,53984,674,113000,742,386,635,59,202,254,82,38,438,335,103,335,272,63,2020-01-01,zipcode,Zephyr
ZCTA5 76930,48,86,-666666666,-666666666,84000,69,18,69,9,46,14,0,0,55,30,25,30,30,0,2020-01-01,zipcode,Barnhart
ZCTA5 77088,48,57177,45445,949,120100,42846,15891,34803,9881,11242,9575,3020,1085,18984,17616,1368,17616,11284,6332,2020-01-01,zipcode,Houston
ZCTA5 77090,48,39289,41441,1006,166500,29229,7676,23377,2835,6430,8809,3410,1893,17595,15417,2178,15417,3944,11473,2020-01-01,zipcode,Houston
ZCTA5 77098,48,15487,98727,1644,611700,13719,3475,12061,132,523,1310,4889,5207,10037,8825,1212,8825,2807,6018,2020-01-01,zipcode,Houston
ZCTA5 77326,48,59,-666666666,-666666666,-666666666,59,59,59,0,59,0,0,0,107,59,48,59,59,0,2020-01-01,zipcode,Ace
ZCTA5 77327,48,26206,44379,760,97700,19416,8563,16104,3790,5979,4489,1307,539,10303,8900,1403,8900,6716,2184,2020-01-01,zipcode,Cleveland
ZCTA5 77334,48,352,45352,-666666666,-666666666,291,110,291,0,84,207,0,0,110,110,0,110,20,90,2020-01-01,zipcode,Dodge
ZCTA5 77304,48,35893,66010,1104,242600,28675,9130,23459,2106,5378,6952,5564,3459,15288,14407,881,14407,8379,6028,2020-01-01,zipcode,Conroe
ZCTA5 77306,48,16203,56881,976,115400,12357,5223,9390,3744,2626,2089,715,216,5415,4865,550,4865,4154,711,2020-01-01,zipcode,Conroe
ZCTA5 77331,48,8064,49348,825,161600,6699,3348,6029,801,2332,1712,757,427,4662,3178,1484,3178,2643,535,2020-01-01,zipcode,Coldspring
ZCTA5 78558,48,979,68977,-666666666,54200,732,189,629,293,145,161,30,0,289,239,50,239,194,45,2020-01-01,zipcode,La blanca
ZCTA5 78559,48,13733,38313,711,73300,9892,4532,8505,2563,2489,2227,818,408,4836,4265,571,4265,3336,929,2020-01-01,zipcode,La feria
ZCTA5 78161,48,550,55625,-666666666,163500,509,278,426,42,154,146,54,30,329,233,96,233,224,9,2020-01-01,zipcode,Sutherland springs
ZCTA5 78203,48,6162,32967,718,89800,4685,1717,4095,1232,1105,1201,325,232,2481,2088,393,2088,1048,1040,2020-01-01,zipcode,San antonio
ZCTA5 78210,48,37061,41109,868,100600,28991,12056,24370,6614,8009,6540,1900,1307,13816,11828,1988,11828,6756,5072,2020-01-01,zipcode,San antonio
ZCTA5 78213,48,45124,48340,961,145300,35212,12104,29263,5329,7531,10156,4005,2242,17501,16155,1346,16155,7920,8235,2020-01-01,zipcode,San antonio
ZCTA5 78222,48,25935,55884,1021,136900,19507,7958,16839,2908,5869,5499,1660,903,8501,7630,871,7630,5388,2242,2020-01-01,zipcode,San antonio
ZCTA5 78234,48,4917,79306,1795,57000,3202,819,2117,64,193,920,592,348,1015,979,36,979,35,944,2020-01-01,zipcode,Jbsa ft sam houston
ZCTA5 78250,48,62951,71842,1241,163700,48657,13697,41070,2845,9956,15693,8307,4269,19071,18665,406,18665,14247,4418,2020-01-01,zipcode,San antonio
ZCTA5 78257,48,8113,76458,1404,448300,6711,2018,5751,191,1052,1495,1832,1181,4562,3825,737,3825,1784,2041,2020-01-01,zipcode,San antonio
ZCTA5 78338,48,0,-666666666,-666666666,-666666666,0,0,0,0,0,0,0,0,0,0,0,0,0,0,2020-01-01,zipcode,Armstrong
ZCTA5 78343,48,4627,43021,831,96600,3658,1688,3144,658,905,963,485,133,1978,1629,349,1629,1304,325,2020-01-01,zipcode,Bishop
ZCTA5 77384,48,19171,98542,1332,315700,15822,6047,14256,752,1884,4176,4832,2612,9209,8115,1094,8115,4590,3525,2020-01-01,zipcode,Conroe
ZCTA5 77423,48,13210,67236,1030,219200,10004,3503,7972,1789,2118,2005,1098,962,3968,3631,337,3631,2884,747,2020-01-01,zipcode,Brookshire
ZCTA5 77568,48,16676,50532,891,115900,13221,5053,11903,1575,3645,4441,1482,760,7403,6468,935,6468,4574,1894,2020-01-01,zipcode,La marque
ZCTA5 77514,48,5461,53378,862,133300,4252,2068,3887,1070,1224,1209,173,211,2741,2095,646,2095,1600,495,2020-01-01,zipcode,Anahuac
ZCTA5 77573,48,91454,111011,1415,265800,68843,20727,59072,2341,10114,17843,18808,9966,33086,31934,1152,31934,24345,7589,2020-01-01,zipcode,League city
ZCTA5 77585,48,1226,-666666666,-666666666,-666666666,969,479,853,59,540,158,96,0,514,466,48,466,421,45,2020-01-01,zipcode,Saratoga
ZCTA5 77613,48,1045,46615,681,132300,853,412,809,81,295,351,32,50,551,507,44,507,392,115,2020-01-01,zipcode,China
ZCTA5 77615,48,923,95722,576,90000,719,218,659,76,284,232,59,8,430,373,57,373,232,141,2020-01-01,zipcode,Evadale
ZCTA5 77627,48,20969,77933,1004,142900,16216,5764,13935,852,3945,5558,2607,973,9530,8426,1104,8426,6217,2209,2020-01-01,zipcode,Nederland
ZCTA5 77630,48,27279,54708,845,98900,21562,8710,18484,2205,6787,6969,1956,567,12850,10498,2352,10498,7086,3412,2020-01-01,zipcode,Orange
ZCTA5 77663,48,720,-666666666,-666666666,178000,574,449,574,63,152,326,33,0,542,382,160,382,291,91,2020-01-01,zipcode,Village mills
ZCTA5 77707,48,18867,52607,951,127600,14608,5184,11914,1907,3246,3833,1941,987,7609,6839,770,6839,4791,2048,2020-01-01,zipcode,Beaumont
ZCTA5 77801,48,14853,32709,853,139300,11587,4168,6798,1373,1906,1819,951,749,6917,5821,1096,5821,723,5098,2020-01-01,zipcode,Bryan
ZCTA5 77443,48,390,-666666666,-666666666,-666666666,269,76,269,0,112,76,0,81,186,126,60,126,45,81,2020-01-01,zipcode,Glen flora
ZCTA5 77003,48,9612,80083,1371,294500,8492,1576,7256,1034,907,1734,1987,1594,5526,4784,742,4784,2167,2617,2020-01-01,zipcode,Houston
ZCTA5 77351,48,34367,50207,796,138500,28542,15329,25390,4921,9322,7268,2729,1150,17567,12128,5439,12128,9321,2807,2020-01-01,zipcode,Livingston
ZCTA5 77372,48,15484,64180,1075,132600,11157,3998,9348,2031,3877,2771,529,140,5150,4504,646,4504,3758,746,2020-01-01,zipcode,Splendora
ZCTA5 77374,48,507,-666666666,-666666666,45500,410,218,317,29,208,38,42,0,301,222,79,222,186,36,2020-01-01,zipcode,Thicket
ZCTA5 77375,48,60115,83050,1233,210600,43410,13078,36823,3380,7394,11674,9959,4416,20626,19849,777,19849,14642,5207,2020-01-01,zipcode,Tomball
ZCTA5 77376,48,508,26705,-666666666,-666666666,489,200,351,0,307,44,0,0,359,297,62,297,297,0,2020-01-01,zipcode,Votaw
ZCTA5 77414,48,24254,48237,883,134000,18429,7797,15613,2683,4464,5039,2208,1219,12779,9286,3493,9286,5976,3310,2020-01-01,zipcode,Bay city
ZCTA5 77415,48,0,-666666666,-666666666,-666666666,0,0,0,0,0,0,0,0,0,0,0,0,0,0,2020-01-01,zipcode,Cedar lane
ZCTA5 77418,48,10250,57370,705,224800,8225,3292,6941,981,1824,2132,1304,700,4319,3797,522,3797,2837,960,2020-01-01,zipcode,Bellville
ZCTA5 77440,48,28,-666666666,-666666666,-666666666,28,0,28,28,0,0,0,0,28,28,0,28,0,28,2020-01-01,zipcode,Elmaton
ZCTA5 77808,48,12248,80179,932,264300,9885,3333,8841,785,2349,2684,2026,997,4885,4662,223,4662,4255,407,2020-01-01,zipcode,Bryan
ZCTA5 77831,48,2847,46047,688,82900,2188,1101,1952,201,679,702,201,169,1678,1068,610,1068,891,177,2020-01-01,zipcode,Bedias
ZCTA5 77837,48,1873,53250,808,88000,1420,561,1237,146,433,410,152,96,1001,751,250,751,468,283,2020-01-01,zipcode,Calvert
ZCTA5 77840,48,59700,25639,914,200000,54725,25267,18920,1626,2840,5245,4550,4659,25033,20655,4378,20655,2252,18403,2020-01-01,zipcode,College station
ZCTA5 77969,48,177,-666666666,-666666666,-666666666,168,77,155,47,42,66,0,0,90,64,26,64,64,0,2020-01-01,zipcode,La salle
ZCTA5 77990,48,788,51128,825,78400,665,316,622,88,224,197,78,35,528,331,197,331,281,50,2020-01-01,zipcode,Tivoli
ZCTA5 77016,48,30462,36805,918,77700,22925,10226,18782,5873,6819,4404,1108,578,10791,9599,1192,9599,5841,3758,2020-01-01,zipcode,Houston
ZCTA5 36262,01,1402,43750,641,90900,1087,614,1008,247,454,207,86,14,629,498,131,498,414,84,2020-01-01,zipcode,Fruithurst
ZCTA5 36279,01,2864,57886,933,133500,2243,1110,2077,329,713,685,149,201,1240,1039,201,1039,900,139,2020-01-01,zipcode,Wellington
ZCTA5 36319,01,2212,54196,770,89800,1718,830,1568,230,586,531,129,92,1036,848,188,848,700,148,2020-01-01,zipcode,Columbia
ZCTA5 36320,01,3208,37420,675,94400,2656,1342,2364,369,912,771,256,56,1641,1291,350,1291,1035,256,2020-01-01,zipcode,Cottonwood
ZCTA5 36330,01,38010,62545,846,169200,29454,11213,25599,2886,6150,9907,4365,2291,16479,14439,2040,14439,9121,5318,2020-01-01,zipcode,Enterprise
ZCTA5 36401,01,7900,33026,567,85100,6296,3497,5513,697,2667,1469,304,376,4462,2989,1473,2989,2110,879,2020-01-01,zipcode,Evergreen
ZCTA5 36013,01,631,101167,-666666666,367300,541,230,477,53,86,233,66,39,228,228,0,228,228,0,2020-01-01,zipcode,Cecil
ZCTA5 36037,01,13172,44609,640,96300,10415,4580,8960,1268,4060,2152,914,566,6346,4338,2008,4338,2982,1356,2020-01-01,zipcode,Greenville
ZCTA5 36039,01,139,49375,-666666666,-666666666,139,62,126,39,31,43,13,0,54,54,0,54,33,21,2020-01-01,zipcode,Hardaway
ZCTA5 36093,01,10839,106233,1080,256500,8599,3037,7092,200,1317,2143,1986,1446,3878,3735,143,3735,3558,177,2020-01-01,zipcode,Wetumpka
ZCTA5 36111,01,12500,54613,893,161800,9861,3658,8069,1066,1805,2193,1922,1083,5606,4779,827,4779,2780,1999,2020-01-01,zipcode,Montgomery
ZCTA5 36203,01,17705,61182,841,141400,14082,5160,12283,2022,3136,4243,1526,1356,7514,6733,781,6733,4675,2058,2020-01-01,zipcode,Oxford
ZCTA5 36250,01,5258,77721,915,125200,4319,1721,3789,339,1368,1412,416,254,1874,1698,176,1698,1529,169,2020-01-01,zipcode,Alexandria
ZCTA5 36317,01,700,49583,-666666666,92300,666,352,567,136,135,139,91,66,382,313,69,313,269,44,2020-01-01,zipcode,Clopton
ZCTA5 36318,01,1254,52143,588,106000,984,479,804,132,265,316,70,21,698,494,204,494,440,54,2020-01-01,zipcode,Coffee springs
ZCTA5 36866,01,3795,44554,563,84200,2975,1156,2757,460,1049,933,216,99,1894,1554,340,1554,1215,339,2020-01-01,zipcode,Notasulga
ZCTA5 36877,01,13340,57857,887,153900,10458,3925,8670,868,2400,3385,1066,951,5057,4432,625,4432,3235,1197,2020-01-01,zipcode,Smiths station
ZCTA5 36901,01,316,31296,-666666666,60900,316,206,266,65,157,44,0,0,199,174,25,174,109,65,2020-01-01,zipcode,Bellamy
ZCTA5 36005,01,1411,39063,578,91700,1156,583,952,204,346,213,108,81,743,530,213,530,469,61,2020-01-01,zipcode,Banks
ZCTA5 36010,01,5047,39643,691,100700,4069,2063,3380,706,1429,735,333,177,2442,1594,848,1594,1165,429,2020-01-01,zipcode,Brundidge
ZCTA5 36027,01,14282,34969,597,112000,11176,5273,9592,2065,3090,2977,873,587,7353,5804,1549,5804,3348,2456,2020-01-01,zipcode,Eufaula
ZCTA5 32256,12,47883,65549,1235,282700,41237,12558,35054,1581,5966,8955,12115,6437,23734,21791,1943,21791,8545,13246,2020-01-01,zipcode,Jacksonville
ZCTA5 32304,12,50298,23704,955,104100,47407,19090,16168,2173,3727,5070,2926,2272,22831,19099,3732,19099,2507,16592,2020-01-01,zipcode,Tallahassee
ZCTA5 32308,12,21870,63018,1099,231600,18446,6503,16311,470,2715,3958,4606,4562,11343,10547,796,10547,5456,5091,2020-01-01,zipcode,Tallahassee
ZCTA5 32901,12,26014,42822,1028,161800,22870,11379,18468,1928,4938,6056,3385,2161,13064,10658,2406,10658,4860,5798,2020-01-01,zipcode,Melbourne
ZCTA5 32926,12,22862,54366,1020,191300,20102,9610,18387,2279,6156,6378,2261,1313,10331,8923,1408,8923,7259,1664,2020-01-01,zipcode,Cocoa
ZCTA5 32940,12,43046,73601,1571,303200,35292,17106,31927,978,5323,9805,8782,7039,19205,17828,1377,17828,14892,2936,2020-01-01,zipcode,Melbourne
ZCTA5 32950,12,4422,83400,1295,302400,3856,1665,3471,164,1163,1096,815,233,1854,1788,66,1788,1637,151,2020-01-01,zipcode,Malabar
ZCTA5 32968,12,14705,79811,1423,281300,12392,5831,10670,487,3160,3423,2512,1088,5607,4904,703,4904,4592,312,2020-01-01,zipcode,Vero beach
ZCTA5 32780,12,35908,51665,968,171200,30550,15011,27217,2363,7654,10321,4480,2399,19460,15211,4249,15211,10953,4258,2020-01-01,zipcode,Titusville
ZCTA5 32934,12,18298,81106,1370,274000,16092,8082,14306,1090,3160,4840,3098,2118,7561,7159,402,7159,6347,812,2020-01-01,zipcode,Melbourne
ZCTA5 32033,12,4771,67031,1446,199300,4340,2034,3834,319,907,1663,549,396,2200,1924,276,1924,1647,277,2020-01-01,zipcode,Elkton
ZCTA5 32003,12,30582,101685,1464,278300,25209,9798,21532,876,3852,6975,6015,3814,11573,11093,480,11093,9552,1541,2020-01-01,zipcode,Fleming island
ZCTA5 32026,12,2026,-666666666,-666666666,-666666666,2026,2026,1896,901,709,252,23,11,0,0,0,0,0,0,2020-01-01,zipcode,Raiford
ZCTA5 32064,12,6929,44505,725,96700,5824,2389,5013,445,2141,1508,571,348,3068,2450,618,2450,1402,1048,2020-01-01,zipcode,Live oak
ZCTA5 32080,12,22237,78678,1310,392100,19848,9563,17967,672,3263,5033,5631,3368,16453,9976,6477,9976,7901,2075,2020-01-01,zipcode,Saint augustine
ZCTA5 32081,12,16914,124821,1974,419400,12396,5169,11079,96,1397,2753,3339,3494,6495,5476,1019,5476,4883,593,2020-01-01,zipcode,Ponte vedra
ZCTA5 32128,12,22046,76814,1609,278200,18570,8668,16256,715,3527,5160,4343,2511,9462,8695,767,8695,7279,1416,2020-01-01,zipcode,Port orange
ZCTA5 32129,12,23383,51834,1185,175200,20517,8412,17691,1484,5413,6799,2872,1123,11493,10088,1405,10088,7019,3069,2020-01-01,zipcode,Port orange
ZCTA5 32133,12,0,-666666666,-666666666,-666666666,0,0,0,0,0,0,0,0,47,0,47,0,0,0,2020-01-01,zipcode,Eastlake weir
ZCTA5 32162,12,55828,64578,1372,273400,55299,49124,55084,1134,14019,17132,13137,9662,38134,31260,6874,31260,29944,1316,2020-01-01,zipcode,The villages
ZCTA5 32228,12,509,-666666666,-666666666,-666666666,509,0,114,0,0,81,33,0,0,0,0,0,0,0,2020-01-01,zipcode,Jacksonville
ZCTA5 32305,12,21533,43876,857,112200,16827,6281,13248,2096,4159,4460,1592,941,8995,7802,1193,7802,4814,2988,2020-01-01,zipcode,Tallahassee
ZCTA5 32309,12,33359,83744,1091,269200,26104,9481,22762,642,3061,5489,7981,5589,13541,13089,452,13089,10365,2724,2020-01-01,zipcode,Tallahassee
ZCTA5 32317,12,14636,91574,1236,274700,11642,4303,10043,324,1931,2583,2825,2380,5754,5402,352,5402,4888,514,2020-01-01,zipcode,Tallahassee
ZCTA5 32348,12,12980,38963,732,69100,11186,7490,9717,2353,4655,1775,513,421,5202,3761,1441,3761,2784,977,2020-01-01,zipcode,Perry
ZCTA5 32352,12,6030,41250,834,89300,4694,1872,4292,495,1867,1319,384,227,2935,2415,520,2415,1910,505,2020-01-01,zipcode,Quincy
ZCTA5 32435,12,7039,45650,813,149200,5827,2295,4966,430,1873,1514,786,363,3331,2772,559,2772,2000,772,2020-01-01,zipcode,Defuniak springs
ZCTA5 32461,12,16,-666666666,-666666666,-666666666,16,0,16,0,0,0,16,0,112,16,96,16,16,0,2020-01-01,zipcode,Inlet beach
ZCTA5 32502,12,3483,52737,1026,168600,2725,970,2536,281,605,833,429,388,1922,1555,367,1555,795,760,2020-01-01,zipcode,Pensacola
ZCTA5 32509,12,642,-666666666,-666666666,-666666666,642,642,642,79,223,255,12,73,0,0,0,0,0,0,2020-01-01,zipcode,Pensacola
ZCTA5 32511,12,1080,-666666666,-666666666,-666666666,1080,51,142,0,11,83,48,0,0,0,0,0,0,0,2020-01-01,zipcode,Pensacola
ZCTA5 32530,12,39,-666666666,-666666666,-666666666,14,0,14,0,0,14,0,0,4,4,0,4,4,0,2020-01-01,zipcode,Bagdad
ZCTA5 32550,12,8310,70842,1609,400800,7260,3500,6422,138,980,1875,2094,1335,13901,3915,9986,3915,2763,1152,2020-01-01,zipcode,Miramar beach
ZCTA5 32563,12,27807,79157,1354,261600,22599,8841,19812,795,4713,6967,4569,2768,11592,10520,1072,10520,8216,2304,2020-01-01,zipcode,Gulf breeze
ZCTA5 32612,12,6517,2499,-666666666,-666666666,6517,5066,30,0,4,15,1,10,26,26,0,26,0,26,2020-01-01,zipcode,Gainesville
ZCTA5 32631,12,298,59013,-666666666,262200,285,141,285,0,72,97,106,10,169,169,0,169,169,0,2020-01-01,zipcode,Earleton
ZCTA5 32814,12,8405,98750,1881,525600,6623,1421,5895,170,497,618,2290,2320,4118,3417,701,3417,1414,2003,2020-01-01,zipcode,Orlando
ZCTA5 32830,12,0,-666666666,-666666666,-666666666,0,0,0,0,0,0,0,0,0,0,0,0,0,0,2020-01-01,zipcode,Orlando
ZCTA5 32405,12,31875,58520,1109,185300,25449,9458,22231,1457,6318,8130,3882,2444,14893,13232,1661,13232,8132,5100,2020-01-01,zipcode,Panama city
ZCTA5 32131,12,4558,50000,840,165800,3940,1937,3693,740,1307,927,454,265,2215,1832,383,1832,1387,445,2020-01-01,zipcode,East palatka
ZCTA5 78355,48,7222,25850,389,70200,5621,2527,4446,1349,1207,1140,569,181,3362,2406,956,2406,1488,918,2020-01-01,zipcode,Falfurrias
ZCTA5 78380,48,23610,51061,854,99900,18713,8815,15864,3522,5316,4732,1441,853,9189,8124,1065,8124,6125,1999,2020-01-01,zipcode,Robstown
ZCTA5 78390,48,5299,42273,989,73900,3978,1970,3341,1064,1069,906,276,26,2335,1826,509,1826,1079,747,2020-01-01,zipcode,Taft
ZCTA5 78402,48,159,-666666666,1051,180400,159,92,149,8,43,60,31,7,353,110,243,110,51,59,2020-01-01,zipcode,Corpus christi
ZCTA5 78405,48,14224,29379,736,57500,11350,5025,9762,4174,3378,1797,325,88,6163,5238,925,5238,2940,2298,2020-01-01,zipcode,Corpus christi
ZCTA5 78411,48,25548,54030,1043,132500,21225,7717,17880,2436,4818,6232,2494,1900,10872,9362,1510,9362,5892,3470,2020-01-01,zipcode,Corpus christi
ZCTA5 78418,48,29789,77307,1065,225800,24082,8725,21586,2099,5172,7449,4569,2297,15251,12127,3124,12127,7899,4228,2020-01-01,zipcode,Corpus christi
ZCTA5 78576,48,10262,24151,499,66700,6192,3237,4067,1933,1461,493,132,48,2688,2398,290,2398,1995,403,2020-01-01,zipcode,Penitas
ZCTA5 78578,48,11509,35662,674,136600,9057,5002,8157,1921,3124,1706,766,640,6955,4206,2749,4206,2848,1358,2020-01-01,zipcode,Port isabel
ZCTA5 78586,48,59360,35951,727,61600,42009,20009,33331,12051,9529,7648,2791,1312,19208,16556,2652,16556,12987,3569,2020-01-01,zipcode,San benito
ZCTA5 78614,48,547,58693,912,200000,423,137,403,33,146,128,75,21,290,223,67,223,164,59,2020-01-01,zipcode,Cost
ZCTA5 78617,48,28376,64117,1246,178100,21769,7165,17132,4978,5946,3973,1799,436,7524,6981,543,6981,5665,1316,2020-01-01,zipcode,Del valle
ZCTA5 78631,48,3157,58454,1323,237200,2468,1025,2186,134,693,860,264,235,1426,1129,297,1129,952,177,2020-01-01,zipcode,Harper
ZCTA5 78635,48,609,85250,-666666666,-666666666,500,168,354,14,96,244,0,0,198,183,15,183,138,45,2020-01-01,zipcode,Hye
ZCTA5 78656,48,2590,72637,905,120800,2026,481,1607,224,548,643,141,51,865,850,15,850,564,286,2020-01-01,zipcode,Maxwell
ZCTA5 78663,48,782,88750,-666666666,-666666666,693,233,625,18,151,260,88,108,399,304,95,304,249,55,2020-01-01,zipcode,Round mountain
ZCTA5 78722,48,6713,75274,1465,442300,5961,1239,5556,294,584,977,2241,1460,3457,3145,312,3145,1456,1689,2020-01-01,zipcode,Austin
ZCTA5 78664,48,63661,77679,1319,231800,51062,12000,42287,4257,9877,14864,9124,4165,22666,21034,1632,21034,11435,9599,2020-01-01,zipcode,Round rock
ZCTA5 78232,48,39638,75090,1201,257600,31883,10445,27659,1232,4707,8568,8496,4656,15999,15471,528,15471,8512,6959,2020-01-01,zipcode,San antonio
ZCTA5 78235,48,1471,49922,1220,-666666666,1167,299,881,43,210,353,181,94,733,663,70,663,0,663,2020-01-01,zipcode,San antonio
ZCTA5 78238,48,27027,49317,937,147600,20842,7329,17592,2499,5426,6264,2462,941,10610,9712,898,9712,4929,4783,2020-01-01,zipcode,San antonio
ZCTA5 78245,48,76392,72564,1251,168900,54914,16059,45258,5314,12398,16349,7857,3340,22634,21283,1351,21283,15544,5739,2020-01-01,zipcode,San antonio
ZCTA5 78247,48,53597,78974,1274,188600,42366,12505,36127,2200,8668,13299,8367,3593,18495,17644,851,17644,13584,4060,2020-01-01,zipcode,San antonio
ZCTA5 78253,48,41900,105820,1434,251500,30040,8649,24792,1527,4250,8778,6208,4029,12930,11930,1000,11930,9731,2199,2020-01-01,zipcode,San antonio
ZCTA5 78256,48,11435,93866,1353,425700,9425,2616,6192,138,416,1698,2080,1860,4849,4122,727,4122,1279,2843,2020-01-01,zipcode,San antonio
ZCTA5 78259,48,26591,91616,1214,286000,20812,6643,18289,850,2953,5436,5278,3772,10031,9502,529,9502,6441,3061,2020-01-01,zipcode,San antonio
ZCTA5 78260,48,26164,120670,1811,353100,19387,6268,16759,689,2127,4625,6001,3317,8351,7947,404,7947,7169,778,2020-01-01,zipcode,San antonio
ZCTA5 78339,48,476,54038,-666666666,68900,383,141,321,123,62,37,68,31,264,166,98,166,166,0,2020-01-01,zipcode,Banquete
ZCTA5 78359,48,2218,35625,599,73700,1609,685,1266,354,495,337,62,18,773,644,129,644,407,237,2020-01-01,zipcode,Gregory
ZCTA5 78361,48,5273,36045,496,80100,3603,1415,2914,720,1166,630,277,121,2456,1563,893,1563,1120,443,2020-01-01,zipcode,Hebbronville
ZCTA5 78369,48,378,-666666666,-666666666,-666666666,308,150,242,68,93,66,15,0,262,146,116,146,108,38,2020-01-01,zipcode,Mirando city
ZCTA5 78370,48,4458,63036,877,124300,3382,1436,2895,631,818,948,257,241,1837,1497,340,1497,1122,375,2020-01-01,zipcode,Odem
ZCTA5 78373,48,4407,71182,1594,376800,4013,1802,3638,84,1137,1102,833,482,5137,2090,3047,2090,1461,629,2020-01-01,zipcode,Port aransas
ZCTA5 78377,48,3510,53000,578,88400,2700,1284,2244,305,1034,692,151,62,1765,1198,567,1198,762,436,2020-01-01,zipcode,Refugio
ZCTA5 78382,48,19313,53674,935,185300,16324,7737,14349,1796,3432,5310,2548,1263,13444,8033,5411,8033,6720,1313,2020-01-01,zipcode,Rockport
ZCTA5 78385,48,391,40083,-666666666,-666666666,270,116,270,211,39,16,1,3,186,129,57,129,27,102,2020-01-01,zipcode,Sarita
ZCTA5 78002,48,5758,53299,939,115800,4454,1922,3494,926,1201,1179,153,35,1639,1529,110,1529,1192,337,2020-01-01,zipcode,Atascosa
ZCTA5 78017,48,6120,48143,766,87700,4660,2882,3435,1036,1120,855,190,234,1531,1127,404,1127,645,482,2020-01-01,zipcode,Dilley
ZCTA5 78001,48,0,-666666666,-666666666,-666666666,0,0,0,0,0,0,0,0,0,0,0,0,0,0,2020-01-01,zipcode,Artesia wells
ZCTA5 78007,48,198,96845,-666666666,162500,112,46,112,5,75,28,4,0,162,67,95,67,58,9,2020-01-01,zipcode,Calliham
ZCTA5 78011,48,1574,32083,568,41200,1169,547,969,374,331,226,38,0,718,558,160,558,495,63,2020-01-01,zipcode,Charlotte
ZCTA5 78016,48,10940,50176,752,105300,8593,3317,7417,1356,2525,2254,906,376,4074,3442,632,3442,2431,1011,2020-01-01,zipcode,Devine
ZCTA5 78076,48,13279,32560,512,87600,9276,4109,7412,2564,2239,1713,814,82,5864,4377,1487,4377,3039,1338,2020-01-01,zipcode,Zapata
ZCTA5 78947,48,4679,59980,1159,210100,3717,1665,3234,170,1268,1345,282,169,2190,1742,448,1742,1562,180,2020-01-01,zipcode,Lexington
ZCTA5 78948,48,320,-666666666,-666666666,357100,308,180,296,99,134,54,3,6,336,154,182,154,132,22,2020-01-01,zipcode,Lincoln
ZCTA5 78957,48,9218,63036,1031,194900,7465,2836,6546,689,1937,2295,1239,386,4425,3483,942,3483,2813,670,2020-01-01,zipcode,Smithville
ZCTA5 78962,48,5290,63678,519,174000,4412,1740,3574,490,1221,1037,585,241,2688,1906,782,1906,1550,356,2020-01-01,zipcode,Weimar
ZCTA5 07080,34,23961,108244,1675,352200,19725,6036,17443,1273,4830,4561,4353,2426,8464,8198,266,8198,7063,1135,2020-01-01,zipcode,South plainfield
ZCTA5 07502,34,15762,50871,1308,260600,11783,4109,9784,2024,3999,2461,1005,295,4625,4412,213,4412,2155,2257,2020-01-01,zipcode,Paterson
ZCTA5 07522,34,21301,39974,1210,198900,15463,5934,12761,3116,5979,2241,1218,207,6947,6396,551,6396,1168,5228,2020-01-01,zipcode,Paterson
ZCTA5 07457,34,4179,112688,2496,336500,3539,1069,3097,141,784,676,882,614,1896,1853,43,1853,1355,498,2020-01-01,zipcode,Riverdale
ZCTA5 07508,34,22562,80364,1447,355600,18436,6456,15805,1929,6094,3406,3024,1352,7780,7478,302,7478,4736,2742,2020-01-01,zipcode,Haledon
ZCTA5 07621,34,27375,102724,1420,369500,21820,6473,18749,1452,4563,4065,6268,2401,9376,9037,339,9037,6191,2846,2020-01-01,zipcode,Bergenfield
ZCTA5 07627,34,4911,153558,3501,716100,3698,1252,3232,51,195,555,1364,1067,1724,1672,52,1672,1401,271,2020-01-01,zipcode,Demarest
ZCTA5 07605,34,9059,96468,1478,522000,7345,2479,6467,486,949,1316,2326,1390,3425,3344,81,3344,2130,1214,2020-01-01,zipcode,Leonia
ZCTA5 75931,48,1967,49421,1070,111200,1562,693,1461,275,549,446,153,38,1956,868,1088,868,779,89,2020-01-01,zipcode,Brookeland
ZCTA5 75935,48,12994,40806,659,75200,10030,4767,8311,2100,2832,2170,872,337,5818,4802,1016,4802,3695,1107,2020-01-01,zipcode,Center
ZCTA5 75942,48,96,-666666666,-666666666,-666666666,60,30,60,30,30,0,0,0,109,30,79,30,30,0,2020-01-01,zipcode,Doucette
ZCTA5 75951,48,16154,38975,804,101500,12725,6114,10973,1566,4657,2832,1081,837,7670,6089,1581,6089,4213,1876,2020-01-01,zipcode,Jasper
ZCTA5 75978,48,193,72500,-666666666,85000,123,24,114,11,41,43,0,19,69,62,7,62,55,7,2020-01-01,zipcode,Woden
ZCTA5 75979,48,12579,40347,781,80900,10433,6394,8826,2076,3811,1825,852,262,5605,3727,1878,3727,2946,781,2020-01-01,zipcode,Woodville
ZCTA5 75938,48,2425,41604,756,106100,2041,1172,1929,258,825,566,206,74,1856,1060,796,1060,883,177,2020-01-01,zipcode,Colmesneil
ZCTA5 75851,48,4916,53480,792,131900,4471,3528,4109,1077,1643,1072,174,143,1398,947,451,947,797,150,2020-01-01,zipcode,Lovelady
ZCTA5 75949,48,8518,37254,667,74700,6856,3434,6068,889,2332,2265,442,140,4227,3385,842,3385,2460,925,2020-01-01,zipcode,Huntington
ZCTA5 75054,48,13045,136250,2077,344400,9101,2763,7623,373,728,2459,2552,1511,3860,3803,57,3803,3356,447,2020-01-01,zipcode,Grand prairie
ZCTA5 75071,48,62769,113015,1675,332300,46158,13516,40343,2603,6787,12155,12649,6149,20924,20073,851,20073,14783,5290,2020-01-01,zipcode,Mckinney
ZCTA5 75109,48,4150,61078,1267,120200,3435,1562,3124,259,977,1065,525,298,1991,1623,368,1623,1405,218,2020-01-01,zipcode,Corsicana
ZCTA5 75156,48,16718,50767,737,138100,14268,7429,12590,2119,4460,4229,1182,600,9004,6792,2212,6792,5401,1391,2020-01-01,zipcode,Mabank
ZCTA5 75157,48,233,51250,581,70000,204,57,188,33,80,68,4,3,122,106,16,106,88,18,2020-01-01,zipcode,Rosser
ZCTA5 75254,48,26700,56902,1188,288400,20710,3485,17812,2337,2894,5033,4770,2778,14134,12011,2123,12011,2120,9891,2020-01-01,zipcode,Dallas
ZCTA5 75390,48,0,-666666666,-666666666,-666666666,0,0,0,0,0,0,0,0,0,0,0,0,0,0,2020-01-01,zipcode,Dallas
ZCTA5 75642,48,23,-666666666,-666666666,-666666666,23,0,13,0,7,6,0,0,21,6,15,6,6,0,2020-01-01,zipcode,Elysian fields
ZCTA5 75645,48,10393,61625,987,161100,8449,3596,7262,678,2572,2509,1107,396,4524,3811,713,3811,3351,460,2020-01-01,zipcode,Gilmer
ZCTA5 75682,48,572,79821,-666666666,155100,409,224,370,67,92,144,48,19,238,175,63,175,175,0,2020-01-01,zipcode,New london
ZCTA5 75752,48,7263,53625,809,135400,5752,2566,5148,571,1211,1920,886,560,3558,2770,788,2770,2363,407,2020-01-01,zipcode,Athens
ZCTA5 75779,48,110,130357,-666666666,68600,60,12,60,0,36,10,14,0,32,24,8,24,24,0,2020-01-01,zipcode,Neches
ZCTA5 75780,48,242,48839,475,-666666666,199,70,115,60,31,16,0,8,95,63,32,63,51,12,2020-01-01,zipcode,New summerfield
ZCTA5 75803,48,21511,45641,842,116200,18493,12317,16208,3263,6321,5239,902,483,7242,5726,1516,5726,4450,1276,2020-01-01,zipcode,Palestine
ZCTA5 75832,48,0,-666666666,-666666666,-666666666,0,0,0,0,0,0,0,0,0,0,0,0,0,0,2020-01-01,zipcode,Cayuga
ZCTA5 75962,48,3188,-666666666,-666666666,-666666666,3188,2121,48,0,0,31,17,0,0,0,0,0,0,0,2020-01-01,zipcode,
ZCTA5 75438,48,973,90167,1549,108700,795,310,633,84,201,168,150,30,455,364,91,364,281,83,2020-01-01,zipcode,Dodd city
ZCTA5 75974,48,3611,35978,444,79400,2526,1271,2287,577,654,761,235,60,1655,1294,361,1294,867,427,2020-01-01,zipcode,Tenaha
ZCTA5 75976,48,989,54125,567,48400,618,216,545,126,140,154,63,62,328,267,61,267,153,114,2020-01-01,zipcode,Wells
ZCTA5 75965,48,18321,47083,770,186900,15453,5934,10433,515,2146,3268,2734,1770,8867,7642,1225,7642,3870,3772,2020-01-01,zipcode,Nacogdoches
ZCTA5 78255,48,15064,124901,1351,351300,11120,3783,9641,419,1299,2710,2929,2284,5004,4702,302,4702,4025,677,2020-01-01,zipcode,San antonio
ZCTA5 78263,48,3561,80990,1113,210400,3164,1208,2610,250,995,779,426,160,1280,1193,87,1193,1106,87,2020-01-01,zipcode,San antonio
ZCTA5 78330,48,633,40000,1103,74800,477,266,436,86,212,78,34,26,258,232,26,232,205,27,2020-01-01,zipcode,Agua dulce
ZCTA5 78351,48,519,31113,938,-666666666,331,130,246,66,125,28,27,0,191,149,42,149,27,122,2020-01-01,zipcode,Driscoll
ZCTA5 78358,48,599,45897,862,67300,549,400,503,15,181,198,64,45,347,273,74,273,200,73,2020-01-01,zipcode,Fulton
ZCTA5 78387,48,9874,48506,646,79300,7316,2932,6113,1243,2114,2093,408,255,3800,3209,591,3209,2116,1093,2020-01-01,zipcode,Sinton
ZCTA5 32822,12,64013,43930,1247,154600,52254,18774,45108,5377,15282,13920,7308,3221,26002,22655,3347,22655,9272,13383,2020-01-01,zipcode,Orlando
ZCTA5 32909,12,31734,53651,1129,186000,24586,9344,21449,2211,6598,8139,2940,1561,11908,10655,1253,10655,8987,1668,2020-01-01,zipcode,Palm bay
ZCTA5 32616,12,1198,-666666666,927,96200,804,285,684,133,228,232,47,44,364,352,12,352,168,184,2020-01-01,zipcode,
ZCTA5 32750,12,25639,75089,1314,258900,21113,6737,18873,1065,5040,6253,4410,2105,10178,9469,709,9469,6778,2691,2020-01-01,zipcode,Longwood
ZCTA5 32828,12,69913,80746,1581,305600,54565,17124,44627,3857,7600,11353,14429,7388,24636,23465,1171,23465,14616,8849,2020-01-01,zipcode,Orlando
ZCTA5 32641,12,16258,36126,885,103400,12251,5610,10670,1766,3905,3381,1134,484,6087,5130,957,5130,2854,2276,2020-01-01,zipcode,Gainesville
ZCTA5 32464,12,3640,47536,-666666666,83800,3056,1490,2750,521,959,770,360,140,2080,1609,471,1609,1430,179,2020-01-01,zipcode,Westville
ZCTA5 32667,12,4135,64683,855,256500,3530,1613,2980,186,560,961,571,702,2050,1728,322,1728,1360,368,2020-01-01,zipcode,Micanopy
ZCTA5 32765,12,63800,84643,1579,302300,51070,16726,40588,1238,5932,12191,13623,7604,23230,21663,1567,21663,15579,6084,2020-01-01,zipcode,Oviedo
ZCTA5 32824,12,51946,64216,1518,246600,40083,12027,34923,4025,10020,11847,5922,3109,18067,13767,4300,13767,10106,3661,2020-01-01,zipcode,Orlando
ZCTA5 32962,12,25229,52537,995,157600,21173,9539,18532,2920,5149,6810,2739,914,12658,8723,3935,8723,7273,1450,2020-01-01,zipcode,Vero beach
ZCTA5 32356,12,0,-666666666,-666666666,-666666666,0,0,0,0,0,0,0,0,21,0,21,0,0,0,2020-01-01,zipcode,Salem
ZCTA5 32266,12,7214,95819,1262,427800,6105,1644,5345,155,588,1330,2111,1161,3595,3143,452,3143,2267,876,2020-01-01,zipcode,Neptune beach
ZCTA5 32065,12,37905,74406,1201,202800,29713,10117,25252,1555,6290,10398,4790,2219,13226,12482,744,12482,9773,2709,2020-01-01,zipcode,Orange park
ZCTA5 07006,34,25578,130723,1711,567300,20638,6347,18541,673,2782,3219,6714,5153,10027,9573,454,9573,7318,2255,2020-01-01,zipcode,Caldwell
ZCTA5 07011,34,39371,62353,1424,327000,31795,9624,26589,4142,10426,6576,3999,1446,13433,12662,771,12662,5488,7174,2020-01-01,zipcode,Clifton
ZCTA5 07020,34,12890,130267,2422,617500,10931,2865,10017,147,1288,1041,4508,3033,6479,6046,433,6046,2383,3663,2020-01-01,zipcode,Edgewater
ZCTA5 07032,34,41147,73514,1338,354700,33308,11510,29094,5509,9842,5974,5363,2406,14408,13698,710,13698,6386,7312,2020-01-01,zipcode,Kearny
ZCTA5 07035,34,10220,100248,1561,344400,8927,2812,7818,542,2168,1789,2029,1290,4085,3850,235,3850,2862,988,2020-01-01,zipcode,Lincoln park
ZCTA5 07036,34,43908,73885,1313,292800,35934,11197,31448,4090,10961,9099,4888,2410,16495,15503,992,15503,9042,6461,2020-01-01,zipcode,Linden
ZCTA5 07042,34,26526,114074,1693,502100,20757,5939,18093,562,2384,3644,6182,5321,10992,10054,938,10054,5169,4885,2020-01-01,zipcode,Montclair
ZCTA5 07052,34,47528,103956,1580,391200,39051,13120,34606,2604,6708,7737,10187,7370,17875,16804,1071,16804,11497,5307,2020-01-01,zipcode,West orange
ZCTA5 07067,34,17793,108125,1675,369100,14649,4893,13073,1020,3725,3042,3447,1839,6166,6026,140,6026,5337,689,2020-01-01,zipcode,Colonia
ZCTA5 07078,34,13305,250001,3168,1392300,9385,3253,8190,151,254,484,2901,4400,4265,4186,79,4186,3765,421,2020-01-01,zipcode,Short hills
ZCTA5 07087,34,68121,49439,1247,359900,54910,17518,46688,11936,15444,8505,7224,3579,27484,25550,1934,25550,5070,20480,2020-01-01,zipcode,Union city
ZCTA5 07093,34,64062,64130,1386,328200,51489,14697,45921,10414,12738,7276,9893,5600,25670,23585,2085,23585,6041,17544,2020-01-01,zipcode,West new york
ZCTA5 07201,34,27369,49203,1211,279500,21036,6600,18224,4250,6630,4476,2053,815,9975,8976,999,8976,2047,6929,2020-01-01,zipcode,Elizabeth
ZCTA5 07305,34,66595,61704,1243,333100,51686,17746,43678,5811,13401,9920,8979,5567,25536,23147,2389,23147,9646,13501,2020-01-01,zipcode,Jersey city
ZCTA5 07419,34,8935,83665,1385,233600,7151,2164,6452,314,1922,2152,1375,689,4052,3699,353,3699,2810,889,2020-01-01,zipcode,Hamburg
ZCTA5 07436,34,12953,140074,1612,472400,10404,3062,8970,273,1964,2067,2825,1841,4609,4248,361,4248,3767,481,2020-01-01,zipcode,Oakland
ZCTA5 34101,12,0,-666666666,-666666666,-666666666,0,0,0,0,0,0,0,0,0,0,0,0,0,0,2020-01-01,zipcode,Naples
ZCTA5 34140,12,217,-666666666,-666666666,-666666666,155,116,131,0,39,61,31,0,321,70,251,70,31,39,2020-01-01,zipcode,Goodland
ZCTA5 34211,12,10897,127000,1700,428600,9192,4607,8306,178,1405,2931,2187,1605,5740,3972,1768,3972,3569,403,2020-01-01,zipcode,Bradenton
ZCTA5 34212,12,22119,92847,1622,362200,17797,7644,15840,606,2726,5526,4164,2818,9409,7735,1674,7735,6302,1433,2020-01-01,zipcode,Bradenton
ZCTA5 34269,12,5272,45015,757,141400,4678,3125,4425,480,1774,1148,756,267,2957,2195,762,2195,1916,279,2020-01-01,zipcode,Arcadia
ZCTA5 34288,12,11973,60990,1258,217700,9861,3999,8073,608,2078,3221,1380,786,4892,4560,332,4560,3830,730,2020-01-01,zipcode,North port
ZCTA5 34289,12,4097,100181,1259,260800,3480,1262,2692,54,910,983,250,495,1662,1238,424,1238,732,506,2020-01-01,zipcode,North port
ZCTA5 34291,12,6165,55615,1379,227500,4838,2045,4646,270,2165,1605,397,209,2332,2332,0,2332,1939,393,2020-01-01,zipcode,North port
ZCTA5 34445,12,0,-666666666,-666666666,-666666666,0,0,0,0,0,0,0,0,0,0,0,0,0,0,2020-01-01,zipcode,Holder
ZCTA5 77018,48,28049,92153,1004,416700,21625,6879,19914,1904,3592,3838,6207,4373,12872,11445,1427,11445,8031,3414,2020-01-01,zipcode,Houston
ZCTA5 07029,34,20990,66521,1573,335100,17040,4781,15037,2106,4181,2628,3072,3050,8689,8262,427,8262,2073,6189,2020-01-01,zipcode,Harrison
ZCTA5 07932,34,10140,120550,2524,611200,8570,3270,7441,163,1032,1595,2332,2319,4413,4228,185,4228,3016,1212,2020-01-01,zipcode,Florham park
ZCTA5 07062,34,12114,80521,1350,262400,9363,2950,8081,829,2521,2230,1609,892,4381,3994,387,3994,2513,1481,2020-01-01,zipcode,Plainfield
ZCTA5 07202,34,41264,52825,1199,281400,32469,10946,27231,6415,11003,6530,2220,1063,14180,13284,896,13284,3501,9783,2020-01-01,zipcode,Elizabeth
ZCTA5 07461,34,17884,89356,1309,281200,14883,5222,12671,673,4541,3969,2513,975,7951,6782,1169,6782,5711,1071,2020-01-01,zipcode,Sussex
ZCTA5 07470,34,53679,127680,1778,482700,43876,15659,36989,1800,7692,6595,12545,8357,19129,18670,459,18670,14580,4090,2020-01-01,zipcode,Wayne
ZCTA5 07027,34,4341,90732,1552,409600,3730,1189,3269,171,907,820,911,460,1820,1782,38,1782,1022,760,2020-01-01,zipcode,Garwood
ZCTA5 07081,34,17432,123212,1831,445800,14050,3555,12422,482,2077,1755,4740,3368,6938,6797,141,6797,4162,2635,2020-01-01,zipcode,Springfield
ZCTA5 07422,34,5886,96813,1553,225300,5013,1418,4347,155,1373,1284,1079,456,2781,2188,593,2188,2064,124,2020-01-01,zipcode,Highland lakes
ZCTA5 07432,34,7230,121607,1662,497500,5938,1915,5230,218,1322,1044,1630,1016,2921,2885,36,2885,1869,1016,2020-01-01,zipcode,Midland park
ZCTA5 07462,34,6267,81741,1350,211700,5439,1601,4556,231,1912,1418,658,337,3429,2649,780,2649,1986,663,2020-01-01,zipcode,Vernon
ZCTA5 07465,34,6374,96757,1737,344100,5290,1862,4678,261,1128,1293,1473,523,2685,2585,100,2585,2063,522,2020-01-01,zipcode,Wanaque
ZCTA5 07501,34,32484,35396,1127,253800,24411,10258,20178,6176,8505,3826,1344,327,12016,11039,977,11039,1630,9409,2020-01-01,zipcode,Paterson
ZCTA5 07513,34,11417,53043,1366,262900,8521,2633,7226,1801,3052,1583,586,204,3310,3138,172,3138,879,2259,2020-01-01,zipcode,Paterson
ZCTA5 07606,34,2457,85703,1531,400400,2036,591,1776,193,796,378,279,130,843,803,40,803,383,420,2020-01-01,zipcode,South hackensack
ZCTA5 07738,34,6501,156164,559,585900,5257,1956,4585,90,772,1022,1528,1173,2315,2223,92,2223,2022,201,2020-01-01,zipcode,Lincroft
ZCTA5 07739,34,5817,202875,3501,709600,4364,1731,3956,42,410,760,1600,1144,2164,2064,100,2064,1922,142,2020-01-01,zipcode,Little silver
ZCTA5 07850,34,7092,89395,1434,312300,5839,1911,4644,158,1472,1536,975,503,2717,2429,288,2429,1859,570,2020-01-01,zipcode,Landing
ZCTA5 07871,34,20022,137658,1771,377900,15783,4684,13683,309,2634,3036,5025,2679,7922,7167,755,7167,6401,766,2020-01-01,zipcode,Sparta
ZCTA5 07921,34,7549,114924,2115,371200,6736,1911,6313,77,660,1054,2576,1946,4108,3870,238,3870,3018,852,2020-01-01,zipcode,Bedminster
ZCTA5 07931,34,3319,137472,2583,906300,2617,1291,2099,25,375,329,655,715,1244,1047,197,1047,893,154,2020-01-01,zipcode,Far hills
ZCTA5 07960,34,44998,136250,1934,609900,37926,12247,32461,1822,4875,4455,11405,9904,18871,17712,1159,17712,11095,6617,2020-01-01,zipcode,Morristown
ZCTA5 07974,34,12794,152154,1826,634400,9696,3182,8563,160,1179,1248,2904,3072,4590,4511,79,4511,3801,710,2020-01-01,zipcode,New providence
ZCTA5 07107,34,37943,37418,1093,248300,28801,10866,24076,6436,9100,5736,2036,768,15024,13574,1450,13574,3358,10216,2020-01-01,zipcode,Newark
ZCTA5 07310,34,13051,149927,2945,739500,11669,2606,10337,156,483,624,3278,5796,6639,6019,620,6019,755,5264,2020-01-01,zipcode,Jersey city
ZCTA5 07407,34,20019,75779,1698,369500,16151,5388,13936,1289,5042,3235,2896,1474,7278,6933,345,6933,3703,3230,2020-01-01,zipcode,Elmwood park
ZCTA5 07421,34,7824,110560,2104,287700,6177,1446,5524,200,2027,1297,1459,541,3327,2831,496,2831,2522,309,2020-01-01,zipcode,Hewitt
ZCTA5 07424,34,27095,90903,1432,372000,23511,6774,19027,1260,5121,4319,5777,2550,10830,10559,271,10559,7251,3308,2020-01-01,zipcode,Little falls
ZCTA5 07438,34,11807,121161,1163,359700,9381,2970,7986,568,1994,2103,2335,986,4872,4579,293,4579,4232,347,2020-01-01,zipcode,Oak ridge
ZCTA5 33706,12,16404,76277,1176,445300,15536,8283,14820,598,2420,4936,4180,2686,14037,8805,5232,8805,6601,2204,2020-01-01,zipcode,Saint petersburg
ZCTA5 33713,12,32084,58830,1038,182100,27224,8821,24478,2508,6223,8347,5133,2267,15629,13782,1847,13782,9789,3993,2020-01-01,zipcode,Saint petersburg
ZCTA5 33715,12,8010,93877,2309,383000,7102,4132,6760,75,839,1895,1903,2048,7045,3794,3251,3794,3402,392,2020-01-01,zipcode,Saint petersburg
ZCTA5 33756,12,32554,45521,1027,212900,27193,11505,24481,2661,7069,7537,4921,2293,15450,13230,2220,13230,7714,5516,2020-01-01,zipcode,Clearwater
ZCTA5 33764,12,27273,53416,1297,222500,23575,9580,21190,1564,6754,7104,3808,1960,14822,11852,2970,11852,8328,3524,2020-01-01,zipcode,Clearwater
ZCTA5 33785,12,5501,73786,1240,477900,5188,2399,4923,154,771,1641,1511,846,6160,2874,3286,2874,2125,749,2020-01-01,zipcode,Indian rocks beach
ZCTA5 33801,12,34406,37848,881,90000,27822,14140,20828,4233,7794,6004,1825,972,14781,11736,3045,11736,5884,5852,2020-01-01,zipcode,Lakeland
ZCTA5 33809,12,30646,54919,1140,171900,25551,10571,22387,2381,6933,7865,3212,1996,12623,11094,1529,11094,7405,3689,2020-01-01,zipcode,Lakeland
ZCTA5 33825,12,28151,40034,744,107800,22866,12741,19281,3743,7169,5903,1544,922,11864,9629,2235,9629,6825,2804,2020-01-01,zipcode,Avon park
ZCTA5 33194,12,8757,106402,1946,372300,7297,3483,6499,1109,1471,1603,1548,768,1712,1712,0,1712,1286,426,2020-01-01,zipcode,Miami
ZCTA5 33305,12,12976,72451,1394,418700,11900,4197,11408,476,1903,3088,3554,2387,8090,6815,1275,6815,4411,2404,2020-01-01,zipcode,Fort lauderdale
ZCTA5 33827,12,3022,63325,1304,157100,2503,1339,1903,210,576,712,257,148,1259,955,304,955,865,90,2020-01-01,zipcode,Babson park
ZCTA5 33850,12,8608,41895,907,117800,7059,3349,6117,1058,2164,1943,486,466,4508,3440,1068,3440,2354,1086,2020-01-01,zipcode,Lake alfred
ZCTA5 33872,12,15740,52003,898,118900,13919,8864,12906,968,3652,4944,2161,1181,9224,7062,2162,7062,5955,1107,2020-01-01,zipcode,Sebring
ZCTA5 33877,12,529,-666666666,-666666666,-666666666,377,254,178,57,87,34,0,0,119,87,32,87,35,52,2020-01-01,zipcode,Waverly
ZCTA5 33133,12,35445,74398,1577,695500,28415,9349,26574,1784,5738,4887,7593,6572,16986,14081,2905,14081,7222,6859,2020-01-01,zipcode,Miami
ZCTA5 33135,12,36678,30112,1065,312700,31498,12539,28033,7931,9660,5179,3640,1623,15333,14278,1055,14278,3013,11265,2020-01-01,zipcode,Miami
ZCTA5 33138,12,29163,50863,1125,444500,23726,7856,20862,2811,4699,5185,4341,3826,13782,12053,1729,12053,5733,6320,2020-01-01,zipcode,Miami
ZCTA5 33140,12,21248,87384,1643,667500,17253,5944,15866,1490,1861,3406,4532,4577,17478,9002,8476,9002,5125,3877,2020-01-01,zipcode,Miami beach
ZCTA5 33157,12,67268,68832,1245,340400,53200,18780,45342,5798,13036,11391,10210,4907,20553,19184,1369,19184,12910,6274,2020-01-01,zipcode,Miami
ZCTA5 33020,12,44655,48504,1159,233600,37803,10725,32985,4817,9824,9825,5561,2958,21844,18655,3189,18655,6320,12335,2020-01-01,zipcode,Hollywood
ZCTA5 33024,12,75701,61959,1426,271000,59566,17716,50895,5704,15763,16470,9387,3571,25530,23519,2011,23519,15339,8180,2020-01-01,zipcode,Hollywood
ZCTA5 33036,12,3264,75439,1427,810500,2897,1289,2692,44,794,739,644,471,3688,1592,2096,1592,1286,306,2020-01-01,zipcode,Islamorada
ZCTA5 33040,12,34401,73982,1814,630400,29369,8595,26047,2470,7388,7384,5597,3208,18304,14487,3817,14487,6452,8035,2020-01-01,zipcode,Key west
ZCTA5 33122,12,432,94318,2220,-666666666,358,153,296,104,11,28,104,49,166,166,0,166,0,166,2020-01-01,zipcode,Miami
ZCTA5 33128,12,8729,21332,957,230800,7311,2843,6668,2514,2199,1030,683,242,3734,3461,273,3461,157,3304,2020-01-01,zipcode,Miami
ZCTA5 33143,12,32055,69992,1459,575200,26840,9352,23716,1130,3831,5436,7708,5611,14240,12855,1385,12855,7297,5558,2020-01-01,zipcode,Miami
ZCTA5 33162,12,47855,45996,1191,230800,36996,12702,31064,6475,9626,8685,4408,1870,15089,13541,1548,13541,7231,6310,2020-01-01,zipcode,Miami
ZCTA5 33179,12,46620,47974,1315,179100,38660,13031,33770,3832,9821,10683,5408,4026,19000,16919,2081,16919,9649,7270,2020-01-01,zipcode,Miami
ZCTA5 33186,12,69459,72109,1768,321000,55641,19924,48060,4204,11371,16243,10674,5568,22749,21711,1038,21711,14598,7113,2020-01-01,zipcode,Miami
ZCTA5 33196,12,55829,80915,1847,355900,44397,15770,37696,4107,8104,10849,10390,4246,15961,15370,591,15370,10490,4880,2020-01-01,zipcode,Miami
ZCTA5 33301,12,15250,101321,2000,530400,14233,4567,12990,429,1454,3112,4777,3218,11388,8380,3008,8380,3581,4799,2020-01-01,zipcode,Fort lauderdale
ZCTA5 33304,12,17630,60665,1327,434500,15462,4782,14093,952,2435,3819,4277,2610,12087,8980,3107,8980,3435,5545,2020-01-01,zipcode,Fort lauderdale
ZCTA5 33401,12,30315,48958,1432,275400,26033,9616,21298,2617,4597,6013,4756,3315,16753,12537,4216,12537,4515,8022,2020-01-01,zipcode,West palm beach
ZCTA5 33407,12,31124,44042,1221,201300,25240,9116,21995,4320,6509,5694,3388,2084,13636,11084,2552,11084,5094,5990,2020-01-01,zipcode,West palm beach
ZCTA5 33410,12,35410,76488,1696,354200,29986,11020,26814,1324,5828,8060,7683,3919,16958,14701,2257,14701,10519,4182,2020-01-01,zipcode,Palm beach gardens
ZCTA5 33442,12,28934,47437,1674,143800,24811,11645,23092,1925,6423,7546,4897,2301,19344,13835,5509,13835,9051,4784,2020-01-01,zipcode,Deerfield beach
ZCTA5 33461,12,46574,48806,1260,172100,37330,12072,31710,7608,10566,8045,3459,2032,17229,14629,2600,14629,7058,7571,2020-01-01,zipcode,Lake worth
ZCTA5 33019,12,14307,76793,1620,486100,12572,5078,11370,408,1645,3668,2865,2784,12202,6444,5758,6444,4765,1679,2020-01-01,zipcode,Hollywood
ZCTA5 33029,12,45142,112537,2508,422900,34975,10619,29073,1330,6738,8719,7624,4662,13601,12870,731,12870,11297,1573,2020-01-01,zipcode,Hollywood
ZCTA5 33042,12,6512,91352,1896,498200,5826,2281,5463,145,1249,1644,1563,862,4850,2971,1879,2971,2285,686,2020-01-01,zipcode,Summerland key
ZCTA5 33065,12,58637,57287,1438,291300,44646,12827,37714,3362,9962,13206,7590,3594,20097,18697,1400,18697,9750,8947,2020-01-01,zipcode,Coral springs
ZCTA5 33458,12,59098,85862,1661,381400,47625,14769,41498,3113,7579,11421,11727,7658,24039,21850,2189,21850,16052,5798,2020-01-01,zipcode,Jupiter
ZCTA5 33486,12,23729,91883,1678,468500,19016,7332,16654,600,2912,4545,5511,3086,10579,9253,1326,9253,6913,2340,2020-01-01,zipcode,Boca raton
ZCTA5 33498,12,16280,106606,2767,432900,13087,5460,11375,449,1353,2947,3827,2799,5725,5555,170,5555,5098,457,2020-01-01,zipcode,Boca raton
ZCTA5 33956,12,3510,53839,1260,235000,3474,2209,3280,200,1162,1102,322,494,3418,1737,1681,1737,1659,78,2020-01-01,zipcode,Saint james city
ZCTA5 33972,12,15656,64604,1210,190100,12217,4722,10221,1324,4340,3080,1127,350,5149,4423,726,4423,3247,1176,2020-01-01,zipcode,Lehigh acres
ZCTA5 33983,12,15161,61858,1047,250200,13162,7145,12053,815,3899,4162,2087,1090,8024,6232,1792,6232,5315,917,2020-01-01,zipcode,Punta gorda
ZCTA5 33169,12,40221,46656,1227,236200,31236,11304,26662,4765,8752,7546,3975,1624,13240,11984,1256,11984,6344,5640,2020-01-01,zipcode,Miami
ZCTA5 33309,12,39928,59045,1371,212700,31856,8802,28064,3949,9178,7749,4503,2685,14594,13517,1077,13517,8221,5296,2020-01-01,zipcode,Fort lauderdale
ZCTA5 33319,12,49218,46312,1305,160700,39794,14116,35284,4908,10901,10494,6017,2964,23988,19166,4822,19166,12353,6813,2020-01-01,zipcode,Fort lauderdale
ZCTA5 33321,12,48061,52263,1511,189900,41184,17221,37217,4170,10685,12282,6271,3809,22195,19943,2252,19943,14837,5106,2020-01-01,zipcode,Fort lauderdale
ZCTA5 33403,12,12458,53410,1195,228600,10159,3493,8676,1403,2477,2493,1514,789,5152,4345,807,4345,2051,2294,2020-01-01,zipcode,West palm beach
ZCTA5 33404,12,29357,46436,1197,186100,23375,9435,20398,2767,7197,5728,2996,1710,15323,10437,4886,10437,5731,4706,2020-01-01,zipcode,West palm beach
ZCTA5 33418,12,41737,100590,1896,425600,35301,15658,32746,1325,4819,8656,10501,7445,21246,17185,4061,17185,13598,3587,2020-01-01,zipcode,Palm beach gardens
ZCTA5 33435,12,36406,52785,1546,204300,31234,11540,27472,4169,7728,8294,4931,2350,19086,13961,5125,13961,8246,5715,2020-01-01,zipcode,Boynton beach
ZCTA5 33440,12,21254,39792,831,96300,16577,5834,14193,4060,4899,4064,917,253,8180,6967,1213,6967,4893,2074,2020-01-01,zipcode,Clewiston
ZCTA5 33455,12,22031,59724,1056,276800,19275,9895,18055,1447,4991,5575,3902,2140,11988,9574,2414,9574,8104,1470,2020-01-01,zipcode,Hobe sound
ZCTA5 33476,12,8123,21986,619,112900,6124,2960,4855,1836,1440,983,530,66,2648,2366,282,2366,758,1608,2020-01-01,zipcode,Pahokee
ZCTA5 33477,12,12875,89717,1814,428600,12355,7251,11921,350,2071,2733,3707,3060,11910,7188,4722,7188,6188,1000,2020-01-01,zipcode,Jupiter
ZCTA5 33478,12,14745,121275,1411,435000,12050,4214,10958,490,2434,3389,3050,1595,5320,4888,432,4888,4794,94,2020-01-01,zipcode,Jupiter
ZCTA5 33527,12,15593,57834,797,228000,13132,5285,10922,2463,3877,2765,1317,500,5552,5037,515,5037,3794,1243,2020-01-01,zipcode,Dover
ZCTA5 33585,12,1060,53977,850,179500,943,605,877,181,286,344,44,22,434,411,23,411,289,122,2020-01-01,zipcode,Sumterville
ZCTA5 33597,12,9075,49242,813,113600,7687,3641,6338,1042,2544,2061,577,114,3781,2987,794,2987,2411,576,2020-01-01,zipcode,Webster
ZCTA5 33603,12,21084,50607,1037,226700,16941,4875,15067,1922,4042,3994,3239,1870,9693,8753,940,8753,4978,3775,2020-01-01,zipcode,Tampa
ZCTA5 33613,12,36388,35755,948,181000,31274,11453,21164,3459,5890,5599,4325,1891,16976,14911,2065,14911,4292,10619,2020-01-01,zipcode,Tampa
ZCTA5 33621,12,2655,85000,2277,-666666666,1628,489,1030,0,221,386,175,248,612,538,74,538,0,538,2020-01-01,zipcode,Tampa
ZCTA5 33626,12,29337,113550,1590,370600,22634,7193,20098,854,2734,4188,7974,4348,11991,11059,932,11059,7674,3385,2020-01-01,zipcode,Tampa
ZCTA5 33782,12,23671,57150,1306,173700,19615,8414,18092,1928,5708,5540,3153,1763,10427,9273,1154,9273,6730,2543,2020-01-01,zipcode,Pinellas park
ZCTA5 33803,12,29875,54263,1088,170900,24405,10064,21507,1745,6105,6500,4382,2775,14795,11867,2928,11867,7239,4628,2020-01-01,zipcode,Lakeland
ZCTA5 33805,12,26189,37952,996,107800,20740,9609,17977,3569,6573,5097,1952,786,10782,9236,1546,9236,4262,4974,2020-01-01,zipcode,Lakeland
ZCTA5 33907,12,25813,45066,1173,170600,21858,8164,19556,2397,6381,5819,3155,1804,13172,10115,3057,10115,4271,5844,2020-01-01,zipcode,Fort myers
ZCTA5 33912,12,20037,86531,1428,283900,17967,9756,16499,594,3432,4831,4631,3011,11619,8628,2991,8628,7378,1250,2020-01-01,zipcode,Fort myers
ZCTA5 33920,12,6709,78654,920,272100,5526,2378,4982,495,1294,1945,744,504,2684,2288,396,2288,2103,185,2020-01-01,zipcode,Alva
ZCTA5 33928,12,26303,84092,1696,322000,23145,13441,22125,1034,4573,6384,5981,4153,17889,11815,6074,11815,10140,1675,2020-01-01,zipcode,Estero
ZCTA5 33936,12,26157,40129,996,142900,21476,9423,18250,4104,6734,4943,1733,736,9684,8319,1365,8319,5389,2930,2020-01-01,zipcode,Lehigh acres
ZCTA5 33957,12,7378,92875,1100,703800,6965,4437,6785,136,1437,1410,1934,1868,9057,3919,5138,3919,3359,560,2020-01-01,zipcode,Sanibel
ZCTA5 33982,12,11553,46756,930,140300,10304,6471,9667,1551,3478,3047,888,703,5157,4187,970,4187,3578,609,2020-01-01,zipcode,Punta gorda
ZCTA5 33598,12,22776,66709,835,251500,16955,7474,14684,3625,4744,3051,1857,1407,7511,6726,785,6726,5573,1153,2020-01-01,zipcode,Wimauma
ZCTA5 33480,12,10631,141328,1702,903600,10071,6449,9956,248,842,2376,3400,3090,11821,6065,5756,6065,5071,994,2020-01-01,zipcode,Palm beach
ZCTA5 33576,12,4512,62000,1021,216600,4183,2795,3943,188,1106,1452,601,596,2447,2212,235,2212,2009,203,2020-01-01,zipcode,San antonio
ZCTA5 33612,12,51347,35746,991,160800,40406,16705,32871,6909,11357,8298,4665,1642,21022,19021,2001,19021,6608,12413,2020-01-01,zipcode,Tampa
ZCTA5 33614,12,49652,43951,1041,189000,41379,12802,35898,7611,12782,8076,5510,1919,19463,18229,1234,18229,7194,11035,2020-01-01,zipcode,Tampa
ZCTA5 33615,12,49048,53516,1207,195900,40243,11858,35510,4313,12023,9768,6495,2911,20057,18028,2029,18028,9644,8384,2020-01-01,zipcode,Tampa
ZCTA5 33620,12,5286,-666666666,-666666666,-666666666,5286,4007,36,11,0,15,10,0,23,11,12,11,0,11,2020-01-01,zipcode,Tampa
ZCTA5 33709,12,23690,45276,1064,138500,20721,9376,18692,2414,6849,5657,2675,1097,13986,10305,3681,10305,7620,2685,2020-01-01,zipcode,Saint petersburg
ZCTA5 33714,12,21049,36130,1059,113900,17477,6764,15614,2791,5680,5062,1676,405,9760,7926,1834,7926,5047,2879,2020-01-01,zipcode,Saint petersburg
ZCTA5 76641,48,1687,49688,688,110400,1398,691,1230,233,452,399,69,77,767,625,142,625,527,98,2020-01-01,zipcode,Frost
ZCTA5 76649,48,646,43417,850,112500,537,274,485,55,204,142,71,13,479,297,182,297,249,48,2020-01-01,zipcode,Iredell
ZCTA5 76664,48,3387,50491,811,99800,2533,1209,2068,255,727,769,271,46,1326,1083,243,1083,788,295,2020-01-01,zipcode,Mart
ZCTA5 76431,48,3708,60449,971,141300,2890,1418,2633,503,1083,653,170,224,1661,1426,235,1426,1257,169,2020-01-01,zipcode,Chico
ZCTA5 76433,48,1834,75804,1203,306300,1501,693,1257,30,368,369,283,207,716,611,105,611,568,43,2020-01-01,zipcode,Bluff dale
ZCTA5 76561,48,997,61250,589,97000,778,313,690,108,242,219,98,23,409,382,27,382,287,95,2020-01-01,zipcode,Oglesby
ZCTA5 76491,48,466,-666666666,674,82900,349,129,310,21,138,102,40,9,284,211,73,211,168,43,2020-01-01,zipcode,Woodson
ZCTA5 76504,48,22769,42911,879,98500,18040,7345,15243,2339,4435,5275,1985,1209,10289,9009,1280,9009,3072,5937,2020-01-01,zipcode,Temple
ZCTA5 76530,48,1788,57344,779,152400,1583,662,1419,165,642,425,112,75,710,616,94,616,473,143,2020-01-01,zipcode,Granger
ZCTA5 78408,48,11299,35627,685,73200,8273,4065,6891,2208,2410,1712,331,230,4784,4207,577,4207,2357,1850,2020-01-01,zipcode,Corpus christi
ZCTA5 78409,48,2448,56208,675,99400,1972,725,1719,463,515,616,117,8,1040,913,127,913,505,408,2020-01-01,zipcode,Corpus christi
ZCTA5 78416,48,15804,42840,922,75300,12534,5293,10636,3485,3606,2914,538,93,5722,5310,412,5310,3163,2147,2020-01-01,zipcode,Corpus christi
ZCTA5 78543,48,10188,41197,585,60200,7663,3378,6394,1819,2076,1679,536,284,3106,2851,255,2851,2213,638,2020-01-01,zipcode,Elsa
ZCTA5 78557,48,13984,38273,701,114200,10240,3856,8032,3255,1570,1636,1354,217,3944,3774,170,3774,2695,1079,2020-01-01,zipcode,Hidalgo
ZCTA5 78583,48,6915,40299,648,118900,5320,2981,4585,1303,1360,1152,483,287,3419,2259,1160,2259,1889,370,2020-01-01,zipcode,Rio hondo
ZCTA5 78608,48,367,108913,-666666666,221500,340,121,313,52,90,92,62,17,250,142,108,142,103,39,2020-01-01,zipcode,Briggs
ZCTA5 78622,48,238,55536,1131,-666666666,170,68,170,38,70,18,44,0,145,105,40,105,70,35,2020-01-01,zipcode,Fentress
ZCTA5 78624,48,22751,62333,987,317200,18861,7828,16834,1594,5168,4266,4112,1694,11264,9343,1921,9343,6565,2778,2020-01-01,zipcode,Fredericksburg
ZCTA5 78634,48,37298,90843,1590,224000,28730,7127,24791,1557,7358,7750,6060,2066,12016,11461,555,11461,9072,2389,2020-01-01,zipcode,Hutto
ZCTA5 78659,48,2983,76505,-666666666,259000,2408,794,2084,134,577,893,381,99,1245,943,302,943,879,64,2020-01-01,zipcode,Paige
ZCTA5 78642,48,13408,97204,950,313000,10320,2862,8748,1001,2653,2288,2006,800,4082,3825,257,3825,3023,802,2020-01-01,zipcode,Liberty hill
ZCTA5 78626,48,38537,80152,1311,247700,30450,9977,24537,3056,6446,6959,5174,2902,12309,11466,843,11466,7736,3730,2020-01-01,zipcode,Georgetown
ZCTA5 78632,48,1268,97250,-666666666,168400,1095,557,956,37,421,433,35,30,603,503,100,503,482,21,2020-01-01,zipcode,Harwood
ZCTA5 78636,48,3307,63346,969,259100,2919,1282,2724,293,887,801,546,197,1867,1512,355,1512,1132,380,2020-01-01,zipcode,Johnson city
ZCTA5 78643,48,6938,60714,813,227700,5838,2600,5255,718,1600,1740,910,287,3985,2666,1319,2666,2112,554,2020-01-01,zipcode,Llano
ZCTA5 78652,48,5763,88243,1458,320100,4836,1608,4529,467,1059,1054,1170,779,2453,2210,243,2210,1450,760,2020-01-01,zipcode,Manchaca
ZCTA5 78681,48,58983,109246,1451,320200,44572,12571,37736,1751,5415,10832,13131,6607,18743,18018,725,18018,13689,4329,2020-01-01,zipcode,Round rock
ZCTA5 07481,34,16959,162095,1880,787600,13225,5370,11544,391,1843,1840,4345,3125,5999,5808,191,5808,5258,550,2020-01-01,zipcode,Wyckoff
ZCTA5 07506,34,18762,103586,1485,411900,15526,4292,13979,1125,3643,3215,4106,1890,7372,7138,234,7138,4403,2735,2020-01-01,zipcode,Hawthorne
ZCTA5 07647,34,5561,105326,1394,460600,4582,1859,3867,263,826,602,1556,620,1869,1806,63,1806,1540,266,2020-01-01,zipcode,Northvale
ZCTA5 07649,34,8126,144474,1733,642300,6363,2233,5401,139,887,921,2132,1322,2678,2672,6,2672,2351,321,2020-01-01,zipcode,Oradell
ZCTA5 07675,34,27022,146866,1847,587200,21240,6855,18720,948,2690,3680,6405,4997,10273,9697,576,9697,7248,2449,2020-01-01,zipcode,Westwood
ZCTA5 07712,34,38228,75025,1242,435100,31748,9825,27969,2498,6427,6663,8018,4363,18441,16623,1818,16623,7884,8739,2020-01-01,zipcode,Asbury park
ZCTA5 07718,34,7508,138750,1690,392300,5888,1541,5135,283,1429,1428,1484,511,2499,2471,28,2471,2217,254,2020-01-01,zipcode,Belford
ZCTA5 07722,34,9992,175114,2123,750000,7871,2567,6675,118,713,1444,2075,2325,3632,3451,181,3451,3094,357,2020-01-01,zipcode,Colts neck
ZCTA5 07733,34,16530,141115,2582,700400,13456,4917,11477,398,1365,2030,4175,3509,6263,5975,288,5975,5252,723,2020-01-01,zipcode,Holmdel
ZCTA5 07734,34,13125,76747,1405,229700,10494,3720,8841,1197,3606,2360,1338,340,5780,4844,936,4844,2841,2003,2020-01-01,zipcode,Keansburg
ZCTA5 07746,34,18164,166725,2545,565100,14358,5157,12158,252,1970,1827,4336,3773,6008,5808,200,5808,5612,196,2020-01-01,zipcode,Marlboro
ZCTA5 07830,34,7412,134750,1066,520200,5871,1990,5242,62,917,1013,1641,1609,2808,2721,87,2721,2588,133,2020-01-01,zipcode,Califon
ZCTA5 07840,34,30347,93527,1267,308800,24569,7709,20668,1313,4748,5172,6320,3115,12199,11603,596,11603,7912,3691,2020-01-01,zipcode,Hackettstown
ZCTA5 07851,34,185,89015,-666666666,279200,108,36,108,0,12,11,75,10,101,62,39,62,60,2,2020-01-01,zipcode,Layton
ZCTA5 07860,34,25355,92085,1212,270100,21553,7578,18783,1050,5242,5509,4324,2658,11147,9801,1346,9801,7710,2091,2020-01-01,zipcode,Newton
ZCTA5 07930,34,8229,164186,1438,663200,6765,2549,5478,92,783,824,2131,1648,3146,2896,250,2896,2645,251,2020-01-01,zipcode,Chester
ZCTA5 07935,34,349,191750,-666666666,2000001,208,52,188,0,32,10,54,92,128,106,22,106,85,21,2020-01-01,zipcode,Green village
ZCTA5 07946,34,3261,153583,3076,623500,2633,961,2394,31,502,390,858,613,1168,1133,35,1133,1027,106,2020-01-01,zipcode,Millington
ZCTA5 07977,34,503,88421,1717,619300,399,88,324,9,119,54,100,42,222,206,16,206,85,121,2020-01-01,zipcode,Peapack
ZCTA5 34604,12,13026,69974,889,184200,11057,5375,9779,1262,3598,3226,1043,650,4746,4311,435,4311,3736,575,2020-01-01,zipcode,Brooksville
ZCTA5 34637,12,8411,88574,1403,255200,6489,3536,5794,555,1218,1642,1310,1069,2931,2521,410,2521,2219,302,2020-01-01,zipcode,Land o lakes
ZCTA5 33181,12,20242,47009,1260,263100,16307,5348,13601,1572,3501,3886,2589,2053,9170,7768,1402,7768,3148,4620,2020-01-01,zipcode,Miami
ZCTA5 33184,12,21472,60146,1653,273100,18786,7157,16809,4798,4517,2625,3615,1254,6442,6126,316,6126,4600,1526,2020-01-01,zipcode,Miami
ZCTA5 33308,12,27226,73818,1502,440400,24930,11281,23500,1206,4227,5880,6797,5390,22846,14957,7889,14957,10366,4591,2020-01-01,zipcode,Fort lauderdale
ZCTA5 33314,12,27895,55562,1608,199100,22683,7531,18566,2924,5711,4748,3752,1431,10222,9195,1027,9195,3596,5599,2020-01-01,zipcode,Fort lauderdale
ZCTA5 33317,12,38256,72163,1463,323700,30437,9339,26807,3169,6622,7305,6329,3382,13220,12453,767,12453,9594,2859,2020-01-01,zipcode,Fort lauderdale
ZCTA5 33322,12,40832,46994,1778,165500,35446,15490,32577,3047,9023,10484,6393,3630,20574,17901,2673,17901,15079,2822,2020-01-01,zipcode,Fort lauderdale
ZCTA5 33325,12,30985,85789,1671,315600,24847,6730,20900,1915,4925,6217,5373,2470,10808,9933,875,9933,7601,2332,2020-01-01,zipcode,Fort lauderdale
ZCTA5 33430,12,23428,29682,631,114200,17311,8377,14545,5533,4856,2790,1088,278,8263,7219,1044,7219,2450,4769,2020-01-01,zipcode,Belle glade
ZCTA5 33434,12,20685,62047,1203,260300,18412,11142,17476,1232,3159,4169,4791,4125,13411,10008,3403,10008,8096,1912,2020-01-01,zipcode,Boca raton
ZCTA5 33467,12,55279,70917,1373,308800,46042,20182,40633,3193,9944,11655,9741,6100,23907,20539,3368,20539,17613,2926,2020-01-01,zipcode,Lake worth
ZCTA5 33496,12,23442,93561,1910,391400,20027,10649,18574,666,2624,4167,6610,4507,11623,9994,1629,9994,8480,1514,2020-01-01,zipcode,Boca raton
ZCTA5 33510,12,29831,62259,1182,193400,24491,8749,21414,1647,7056,6835,4467,1409,11671,10857,814,10857,6716,4141,2020-01-01,zipcode,Brandon
ZCTA5 33541,12,22432,41521,1091,76500,19591,12702,18167,2784,6732,6139,1682,830,13354,9813,3541,9813,8019,1794,2020-01-01,zipcode,Zephyrhills
ZCTA5 33572,12,21889,97058,1579,290000,17585,5968,15930,680,3322,4898,4308,2722,8993,8239,754,8239,6831,1408,2020-01-01,zipcode,Apollo beach
ZCTA5 33607,12,25018,46587,1374,190200,21614,7233,19130,3248,5760,4179,4046,1897,12847,10932,1915,10932,4519,6413,2020-01-01,zipcode,Tampa
ZCTA5 33609,12,18972,85174,1278,382500,15795,4099,14010,1035,1630,3175,4517,3653,9307,8497,810,8497,5134,3363,2020-01-01,zipcode,Tampa
ZCTA5 33617,12,48456,39830,1029,192500,38524,12807,31293,4026,9454,9084,5496,3233,20942,19281,1661,19281,7601,11680,2020-01-01,zipcode,Tampa
ZCTA5 33647,12,74066,89270,1435,309100,57073,16736,48174,2294,6905,11156,16044,11775,27179,25565,1614,25565,14396,11169,2020-01-01,zipcode,Tampa
ZCTA5 33702,12,32968,54196,1091,195200,28051,10314,25122,2291,6676,7798,5916,2441,16476,14139,2337,14139,9392,4747,2020-01-01,zipcode,Saint petersburg
ZCTA5 33705,12,28013,56914,1126,196700,24141,9650,21125,2155,5676,6848,4246,2200,14860,11210,3650,11210,6537,4673,2020-01-01,zipcode,Saint petersburg
ZCTA5 33707,12,25148,51861,1097,236400,23266,11709,21807,1349,5673,6842,5133,2810,16343,12512,3831,12512,8470,4042,2020-01-01,zipcode,Saint petersburg
ZCTA5 33711,12,19291,52902,1200,177400,15814,7250,12488,1041,4271,3864,2021,1291,9167,6410,2757,6410,3898,2512,2020-01-01,zipcode,Saint petersburg
ZCTA5 07724,34,21162,86953,1312,375800,17406,5414,15160,927,3879,3887,3756,2711,9241,8733,508,8733,5944,2789,2020-01-01,zipcode,Eatontown
ZCTA5 07726,34,43500,127460,1591,468100,34512,11589,30591,1206,6354,7245,9535,6251,16496,15792,704,15792,13430,2362,2020-01-01,zipcode,Englishtown
ZCTA5 77029,48,17478,40209,851,80900,12820,5233,10689,4520,2794,2593,550,232,6487,5695,792,5695,3706,1989,2020-01-01,zipcode,Houston
ZCTA5 77044,48,51978,81009,1528,224600,36913,10762,30441,4531,7641,8774,6718,2777,15779,14827,952,14827,11549,3278,2020-01-01,zipcode,Houston
ZCTA5 77048,48,18520,45987,956,98000,13695,4844,11501,1595,3745,4078,1275,808,6929,6144,785,6144,3451,2693,2020-01-01,zipcode,Houston
ZCTA5 77051,48,17547,31942,929,83800,12581,5832,10103,2399,3482,3136,878,208,7170,6114,1056,6114,2413,3701,2020-01-01,zipcode,Houston
ZCTA5 77054,48,24780,51833,1208,145800,22772,6593,18677,328,2221,4328,5114,6686,17575,14532,3043,14532,1952,12580,2020-01-01,zipcode,Houston
ZCTA5 77059,48,17483,139371,1969,316600,13744,5478,11920,400,984,2297,4464,3775,6013,5868,145,5868,5692,176,2020-01-01,zipcode,Houston
ZCTA5 77062,48,25568,97912,1082,220900,20320,6756,18022,1294,2834,4778,5499,3617,10125,9597,528,9597,7499,2098,2020-01-01,zipcode,Houston
ZCTA5 77066,48,38753,65572,1237,160400,29872,10393,24807,6163,6402,6461,4229,1552,12099,11763,336,11763,8445,3318,2020-01-01,zipcode,Houston
ZCTA5 77075,48,46588,59249,1010,161700,33572,9524,27395,8656,7436,7655,3001,647,14327,13398,929,13398,7173,6225,2020-01-01,zipcode,Houston
ZCTA5 77078,48,14267,37763,931,87800,10733,4376,9127,2465,3176,2156,856,474,5489,4861,628,4861,2959,1902,2020-01-01,zipcode,Houston
ZCTA5 77085,48,18155,56715,1071,123600,14134,4700,11162,3853,3045,2706,834,724,5579,5444,135,5444,3620,1824,2020-01-01,zipcode,Houston
ZCTA5 77950,48,157,49792,-666666666,80900,136,66,124,17,52,40,9,6,156,75,81,75,58,17,2020-01-01,zipcode,Austwell
ZCTA5 77957,48,8454,54461,857,100200,6711,3076,5737,925,1873,1898,764,277,3866,2937,929,2937,2074,863,2020-01-01,zipcode,Edna
ZCTA5 77975,48,1722,65682,809,155500,1399,539,1226,120,476,402,130,98,1056,690,366,690,494,196,2020-01-01,zipcode,Moulton
ZCTA5 77979,48,17295,58057,789,115200,13750,4825,11602,2291,3574,3524,1397,816,8274,6428,1846,6428,4645,1783,2020-01-01,zipcode,Port lavaca
ZCTA5 77988,48,356,-666666666,-666666666,106300,275,107,206,56,30,55,34,31,151,96,55,96,80,16,2020-01-01,zipcode,Telferner
ZCTA5 77482,48,1676,43393,860,94700,1509,613,1315,146,258,761,125,25,944,677,267,677,558,119,2020-01-01,zipcode,Van vleck
ZCTA5 77484,48,11972,75886,986,232400,9748,3176,7573,930,2623,2750,897,373,4319,3772,547,3772,2707,1065,2020-01-01,zipcode,Waller
ZCTA5 77486,48,7509,76635,1131,159900,5955,2507,4895,784,1192,2174,396,349,3135,2779,356,2779,2126,653,2020-01-01,zipcode,West columbia
ZCTA5 77506,48,37968,44929,891,87000,26498,9033,21116,9076,6938,4070,803,229,12079,10535,1544,10535,3854,6681,2020-01-01,zipcode,Pasadena
ZCTA5 77518,48,11513,54242,979,141400,8257,2549,6946,1497,2379,1993,847,230,4113,3672,441,3672,2205,1467,2020-01-01,zipcode,Bacliff
ZCTA5 77520,48,33837,51165,943,99700,25752,9864,21483,6471,6048,6603,1333,1028,13528,11882,1646,11882,7026,4856,2020-01-01,zipcode,Baytown
ZCTA5 77532,48,30042,78489,918,173000,23677,8210,20159,1996,7032,7650,2350,1131,11305,10686,619,10686,8520,2166,2020-01-01,zipcode,Crosby
ZCTA5 77533,48,1045,44632,805,77900,846,377,700,91,387,172,37,13,466,369,97,369,250,119,2020-01-01,zipcode,Daisetta
ZCTA5 77541,48,19072,50180,948,109400,14203,5706,11711,2226,4501,3938,823,223,9302,6813,2489,6813,4351,2462,2020-01-01,zipcode,Freeport
ZCTA5 77561,48,98,-666666666,-666666666,103100,72,23,72,16,44,0,12,0,40,40,0,40,32,8,2020-01-01,zipcode,Hardin
ZCTA5 77565,48,6953,71176,1262,284500,5812,2195,5079,161,866,2046,1246,760,3629,3204,425,3204,1763,1441,2020-01-01,zipcode,Kemah
ZCTA5 77577,48,1497,75714,-666666666,162800,1066,547,950,168,268,367,129,18,696,514,182,514,480,34,2020-01-01,zipcode,Liverpool
ZCTA5 77586,48,23003,96229,1275,256400,18492,6224,15905,919,2199,6009,4694,2084,9728,8869,859,8869,5806,3063,2020-01-01,zipcode,Seabrook
ZCTA5 77598,48,26513,52184,1085,159800,20897,4444,17387,2262,3546,6280,3537,1762,13061,11962,1099,11962,2368,9594,2020-01-01,zipcode,Webster
ZCTA5 77612,48,9619,59515,643,92000,7656,3615,6639,997,3185,1860,521,76,4398,3601,797,3601,3232,369,2020-01-01,zipcode,Buna
ZCTA5 77619,48,15531,56336,1006,119600,12360,4807,10872,1368,4010,4080,1057,357,6430,5747,683,5747,4196,1551,2020-01-01,zipcode,Groves
ZCTA5 77002,48,17026,80220,1598,275800,16827,10464,14143,2237,3979,3037,3066,1824,6350,5341,1009,5341,684,4657,2020-01-01,zipcode,Houston
ZCTA5 77091,48,28351,33497,867,149700,21573,8443,18954,5327,5445,4942,2280,960,11824,10365,1459,10365,4173,6192,2020-01-01,zipcode,Houston
ZCTA5 77024,48,38723,122987,1610,1077500,30547,12082,27247,298,1654,4222,11780,9293,18039,16019,2020,16019,9854,6165,2020-01-01,zipcode,Houston
ZCTA5 77036,48,69154,35771,860,166700,52799,14453,43550,15524,11609,7760,6464,2193,30247,25439,4808,25439,5130,20309,2020-01-01,zipcode,Houston
ZCTA5 77046,48,1344,130092,1822,-666666666,1344,332,1270,0,17,373,360,520,1107,938,169,938,397,541,2020-01-01,zipcode,Houston
ZCTA5 77049,48,38915,62840,1212,156600,27624,7786,21457,5684,5826,7367,1804,776,12223,11143,1080,11143,7692,3451,2020-01-01,zipcode,Houston
ZCTA5 77061,48,26488,41103,835,158100,19231,5893,16206,5198,5445,3178,1658,727,10152,9024,1128,9024,3363,5661,2020-01-01,zipcode,Houston
ZCTA5 77073,48,40979,54631,1096,151600,30718,8640,24753,4327,6775,9585,3016,1050,14879,13878,1001,13878,8116,5762,2020-01-01,zipcode,Houston
ZCTA5 77076,48,34668,36722,946,110000,24738,9444,19534,9096,6817,2796,684,141,10903,10133,770,10133,4914,5219,2020-01-01,zipcode,Houston
ZCTA5 77079,48,32826,85803,1359,533800,24544,7620,21935,1359,1575,4795,8785,5421,15396,12823,2573,12823,7341,5482,2020-01-01,zipcode,Houston
ZCTA5 77080,48,45254,51963,1044,235300,33982,9844,28325,8767,6692,5985,4730,2151,16586,14984,1602,14984,7002,7982,2020-01-01,zipcode,Houston
ZCTA5 77087,48,37703,45763,803,101700,28203,11066,22744,8799,7051,4684,1597,613,12351,11179,1172,11179,6216,4963,2020-01-01,zipcode,Houston
ZCTA5 77092,48,39841,44248,944,186800,31997,9287,27093,7117,7641,6712,3854,1769,15900,14854,1046,14854,5662,9192,2020-01-01,zipcode,Houston
ZCTA5 77095,48,73956,84234,1384,224200,58744,17584,49598,4120,8788,16119,14568,6003,26518,25143,1375,25143,17752,7391,2020-01-01,zipcode,Houston
ZCTA5 77448,48,129,-666666666,-666666666,-666666666,96,20,96,41,4,16,35,0,56,56,0,56,15,41,2020-01-01,zipcode,Hungerford
ZCTA5 77455,48,2121,62188,-666666666,126300,1664,756,1372,355,436,378,156,47,870,684,186,684,624,60,2020-01-01,zipcode,Louise
ZCTA5 77470,48,456,45000,-666666666,-666666666,361,106,294,103,81,91,9,10,269,184,85,184,153,31,2020-01-01,zipcode,Rock island
ZCTA5 77477,48,35496,61103,1232,180600,28373,8058,23440,3174,5180,6423,6553,2110,13724,12951,773,12951,5825,7126,2020-01-01,zipcode,Stafford
ZCTA5 77478,48,24673,97639,1666,314100,21359,8055,18821,1183,2593,4493,6294,4258,9423,9073,350,9073,6798,2275,2020-01-01,zipcode,Sugar land
ZCTA5 77564,48,1532,73872,-666666666,145800,1097,695,963,203,309,262,165,24,730,551,179,551,523,28,2020-01-01,zipcode,Hull
ZCTA5 77485,48,4209,49028,771,151100,3247,1438,2902,372,1161,989,265,115,1789,1525,264,1525,967,558,2020-01-01,zipcode,Wallis
ZCTA5 77502,48,38117,55551,1018,110500,26604,8722,21144,7844,6853,4808,1283,356,11730,10834,896,10834,6753,4081,2020-01-01,zipcode,Pasadena
ZCTA5 77547,48,9895,43341,1010,82000,7071,2569,5566,2137,1714,1290,371,54,2892,2765,127,2765,1811,954,2020-01-01,zipcode,Galena park
ZCTA5 77597,48,1026,64688,-666666666,247000,798,300,592,61,142,293,75,21,430,274,156,274,209,65,2020-01-01,zipcode,Wallisville
ZCTA5 07940,34,17794,157577,1908,740800,14461,4754,10993,394,1343,1445,4076,3735,6009,5755,254,5755,3715,2040,2020-01-01,zipcode,Madison
ZCTA5 07979,34,441,134236,-666666666,677100,399,108,320,0,199,20,65,36,188,171,17,171,171,0,2020-01-01,zipcode,Pottersville
ZCTA5 07439,34,2174,89536,1629,224500,1859,477,1619,107,600,469,297,146,966,801,165,801,701,100,2020-01-01,zipcode,Ogdensburg
ZCTA5 07450,34,25182,179958,2062,743000,18754,6542,16167,493,1585,1813,6581,5695,8764,8441,323,8441,6852,1589,2020-01-01,zipcode,Ridgewood
ZCTA5 07460,34,3521,107115,2212,305700,2804,771,2353,128,657,677,519,372,1439,1288,151,1288,1183,105,2020-01-01,zipcode,Stockholm
ZCTA5 07505,34,3303,16821,859,-666666666,2852,1732,2512,830,1016,453,212,1,1169,1111,58,1111,61,1050,2020-01-01,zipcode,Paterson
ZCTA5 07524,34,13289,42601,1199,286200,9411,3471,7714,1926,3531,1213,902,142,4432,4196,236,4196,1009,3187,2020-01-01,zipcode,Paterson
ZCTA5 07631,34,28390,86485,1511,403800,23074,7557,20162,1984,4816,4181,5063,4118,11894,11064,830,11064,5879,5185,2020-01-01,zipcode,Englewood
ZCTA5 07652,34,26403,130273,2503,614900,22150,9123,19587,1431,4218,4479,6108,3351,8776,8334,442,8334,6886,1448,2020-01-01,zipcode,Paramus
ZCTA5 07740,34,30557,62224,1370,368800,24642,8457,20472,3822,6164,4662,3456,2368,14812,12153,2659,12153,4942,7211,2020-01-01,zipcode,Long branch
ZCTA5 07753,34,36583,80078,1472,306100,31370,10865,26942,1917,6959,8268,6516,3282,16967,16009,958,16009,10697,5312,2020-01-01,zipcode,Neptune
ZCTA5 07756,34,3151,64290,1280,695300,3074,990,2973,136,207,564,1062,1004,2794,1871,923,1871,951,920,2020-01-01,zipcode,Ocean grove
ZCTA5 07758,34,4363,83250,1181,330400,3545,1224,2993,207,896,1077,612,201,1661,1609,52,1609,1307,302,2020-01-01,zipcode,Port monmouth
ZCTA5 07760,34,8348,177255,1779,1037000,6380,2607,5407,19,483,1002,2257,1646,3586,2960,626,2960,2540,420,2020-01-01,zipcode,Rumson
ZCTA5 07848,34,4631,89934,1205,353800,4011,1749,3683,348,1041,953,969,372,1757,1635,122,1635,1420,215,2020-01-01,zipcode,Lafayette
ZCTA5 07857,34,3167,71250,1172,269300,2794,769,2476,275,738,563,699,201,1770,1638,132,1638,856,782,2020-01-01,zipcode,Netcong
ZCTA5 07630,34,7606,129289,1845,532200,6261,2128,5636,285,1081,1469,1807,994,2682,2639,43,2639,2281,358,2020-01-01,zipcode,Emerson
ZCTA5 07641,34,3400,181500,-666666666,679300,2567,935,2230,47,286,301,826,770,1141,1084,57,1084,1042,42,2020-01-01,zipcode,Haworth
ZCTA5 07650,34,20693,79063,1638,577900,18047,6118,15377,1618,3216,2786,6275,1482,7556,7291,265,7291,2729,4562,2020-01-01,zipcode,Palisades park
ZCTA5 07660,34,12928,81908,1402,367500,10320,2650,9017,786,2483,2275,2176,1297,5146,4795,351,4795,2390,2405,2020-01-01,zipcode,Ridgefield park
ZCTA5 07666,34,40461,113934,1467,406500,32380,11325,26487,1787,5307,5025,7679,6689,13720,13164,556,13164,10090,3074,2020-01-01,zipcode,Teaneck
ZCTA5 07828,34,15580,79943,1233,349900,12182,3053,10574,843,2807,2801,2434,1689,6198,5992,206,5992,3172,2820,2020-01-01,zipcode,Budd lake
ZCTA5 07834,34,17717,143481,1599,442000,14387,4364,12557,374,2059,2523,4587,3014,7263,6820,443,6820,5691,1129,2020-01-01,zipcode,Denville
ZCTA5 07836,34,11253,122861,1653,411100,9257,2338,7586,458,1259,2103,1968,1798,4354,4117,237,4117,2634,1483,2020-01-01,zipcode,Flanders
ZCTA5 07838,34,3069,98646,1405,333800,2622,892,2245,90,649,656,601,249,1289,1237,52,1237,1075,162,2020-01-01,zipcode,Great meadows
ZCTA5 07853,34,13037,166276,1911,477000,10182,3605,8322,207,1074,1601,3290,2150,4497,4272,225,4272,4095,177,2020-01-01,zipcode,Long valley
ZCTA5 07874,34,8020,100546,1643,264400,6574,1675,5690,252,1621,1439,1710,668,3177,3021,156,3021,2667,354,2020-01-01,zipcode,Stanhope
ZCTA5 07711,34,1711,105455,1403,761500,1333,487,1159,18,155,232,449,305,843,574,269,574,470,104,2020-01-01,zipcode,Allenhurst
ZCTA5 07716,34,8306,102446,1309,471300,7148,2439,6443,488,1412,1762,1833,948,3864,3593,271,3593,2575,1018,2020-01-01,zipcode,Atlantic highlands
ZCTA5 07717,34,1731,89615,1456,939700,1526,684,1360,30,159,234,544,393,1204,876,328,876,569,307,2020-01-01,zipcode,Avon by the sea
ZCTA5 07751,34,19851,149223,2285,545200,15349,4983,13149,297,2134,2565,4232,3921,6786,6595,191,6595,5974,621,2020-01-01,zipcode,Morganville
ZCTA5 07755,34,6178,101354,1773,434300,4762,1842,3864,217,1045,1152,927,523,2274,2033,241,2033,1726,307,2020-01-01,zipcode,Oakhurst
ZCTA5 07827,34,3979,79828,886,227100,3231,1270,2967,112,1082,879,553,341,2117,1696,421,1696,1497,199,2020-01-01,zipcode,Montague
ZCTA5 07832,34,3223,96932,1145,288500,2690,1034,2406,280,659,628,533,306,1450,1249,201,1249,1131,118,2020-01-01,zipcode,Columbia
ZCTA5 07842,34,69,-666666666,-666666666,-666666666,63,0,57,0,12,8,30,7,31,31,0,31,31,0,2020-01-01,zipcode,Hibernia
ZCTA5 07876,34,9383,140994,1786,399400,7836,2754,7041,333,1620,1828,2110,1150,3429,3307,122,3307,3068,239,2020-01-01,zipcode,Succasunna
ZCTA5 07927,34,4250,129000,2629,486800,3395,1011,3048,327,582,350,957,832,1856,1720,136,1720,1003,717,2020-01-01,zipcode,Cedar knolls
ZCTA5 07934,34,1421,157750,1669,727300,1065,373,1005,21,158,187,326,313,502,497,5,497,444,53,2020-01-01,zipcode,Gladstone
ZCTA5 07945,34,9130,191071,1473,774900,7425,2942,6360,113,632,912,2398,2305,3333,3240,93,3240,2978,262,2020-01-01,zipcode,Mendham
ZCTA5 07950,34,19759,128121,2147,481200,16197,5494,14557,658,2278,2449,5105,4067,7673,7468,205,7468,5641,1827,2020-01-01,zipcode,Morris plains
ZCTA5 33009,12,42070,39834,1280,223900,35642,13961,32105,4402,8552,8292,6096,4763,29273,18988,10285,18988,10265,8723,2020-01-01,zipcode,Hallandale
ZCTA5 33012,12,74603,34175,1223,253000,65080,28625,57865,17928,18506,12115,6557,2759,26292,25596,696,25596,12510,13086,2020-01-01,zipcode,Hialeah
ZCTA5 33018,12,53575,70226,1678,298200,44269,13199,38511,7205,12263,9287,6748,3008,15974,15539,435,15539,11640,3899,2020-01-01,zipcode,Hialeah
ZCTA5 33312,12,55149,59810,1334,276100,44050,15690,38116,5698,10547,11121,6905,3845,20755,18201,2554,18201,10854,7347,2020-01-01,zipcode,Fort lauderdale
ZCTA5 33331,12,25829,126104,2353,517800,20549,7073,17006,809,1791,4575,6016,3815,7680,7357,323,7357,6170,1187,2020-01-01,zipcode,Fort lauderdale
ZCTA5 33324,12,49350,69996,1713,256700,41312,12643,36703,2453,6394,11654,9768,6434,21934,19331,2603,19331,11006,8325,2020-01-01,zipcode,Fort lauderdale
ZCTA5 33327,12,24221,131908,2647,580000,16784,5955,14176,271,1830,2368,5104,4603,6812,6681,131,6681,5139,1542,2020-01-01,zipcode,Fort lauderdale
ZCTA5 33328,12,29355,101007,1694,388800,23839,7502,19761,1172,3948,5747,5600,3294,10817,10179,638,10179,8005,2174,2020-01-01,zipcode,Fort lauderdale
ZCTA5 33408,12,18251,73427,1532,378900,16620,8222,15596,526,3509,3743,4940,2878,13184,9380,3804,9380,7330,2050,2020-01-01,zipcode,North palm beach
ZCTA5 33412,12,15012,91875,1777,393500,12658,5132,11248,486,2968,3281,2735,1778,6246,5227,1019,5227,4293,934,2020-01-01,zipcode,West palm beach
ZCTA5 33414,12,60452,86716,1890,388500,46742,15161,40542,2421,8342,12908,10621,6250,22797,19720,3077,19720,14434,5286,2020-01-01,zipcode,Wellington
ZCTA5 33417,12,34044,39498,1188,101500,28824,11187,25818,4060,8173,7267,4839,1479,19563,15284,4279,15284,8902,6382,2020-01-01,zipcode,West palm beach
ZCTA5 33433,12,40655,58788,1902,308300,34342,16653,30925,1166,5839,7552,9615,6753,23303,18917,4386,18917,13350,5567,2020-01-01,zipcode,Boca raton
ZCTA5 33436,12,46812,61388,1493,258000,38960,15204,35374,3153,8742,11585,7492,4402,22947,18492,4455,18492,13540,4952,2020-01-01,zipcode,Boynton beach
ZCTA5 33444,12,24970,62621,1378,316900,20978,6684,18364,3399,4980,5139,3245,1601,9799,8807,992,8807,4689,4118,2020-01-01,zipcode,Delray beach
ZCTA5 33445,12,31025,55945,1662,216600,27384,11182,24447,1830,5921,6482,6498,3716,17365,13922,3443,13922,9383,4539,2020-01-01,zipcode,Delray beach
ZCTA5 33462,12,34068,55285,1292,237500,28962,9600,25822,4191,7687,6845,4790,2309,15943,12838,3105,12838,7994,4844,2020-01-01,zipcode,Lake worth
ZCTA5 33463,12,64116,55713,1379,231000,49759,15190,42046,8698,12233,11266,6652,3197,21537,18935,2602,18935,13236,5699,2020-01-01,zipcode,Lake worth
ZCTA5 33483,12,13233,100500,1894,634300,12183,5376,11401,592,1693,2506,4038,2572,9474,6476,2998,6476,4400,2076,2020-01-01,zipcode,Delray beach
ZCTA5 33487,12,20794,76073,1883,415500,18223,8599,16382,459,2255,4054,5723,3891,12681,9538,3143,9538,7208,2330,2020-01-01,zipcode,Boca raton
ZCTA5 33493,12,6681,39432,929,91700,5988,4715,5497,2359,1955,842,280,61,963,795,168,795,435,360,2020-01-01,zipcode,South bay
ZCTA5 33521,12,719,33438,706,98500,586,276,536,87,285,131,28,5,370,240,130,240,167,73,2020-01-01,zipcode,Coleman
ZCTA5 33525,12,20337,56706,846,166100,16664,8379,13490,1569,4679,4188,2095,959,8282,6875,1407,6875,5003,1872,2020-01-01,zipcode,Dade city
ZCTA5 33544,12,28417,86707,1545,271600,21688,6218,19058,1632,4038,5154,5143,3091,10320,9689,631,9689,6790,2899,2020-01-01,zipcode,Wesley chapel
ZCTA5 33514,12,2954,41654,825,109700,2215,1010,1940,360,767,578,149,86,1037,808,229,808,514,294,2020-01-01,zipcode,Center hill
ZCTA5 33523,12,18834,51028,824,153300,15631,6262,12941,2245,5062,3345,1555,734,7870,6460,1410,6460,4632,1828,2020-01-01,zipcode,Dade city
ZCTA5 33543,12,27933,84375,1534,237000,21939,8108,19088,1032,3534,6062,5018,3442,10816,9822,994,9822,8273,1549,2020-01-01,zipcode,Wesley chapel
ZCTA5 33566,12,21920,65531,1131,225700,17138,6207,14853,2339,5692,3332,2308,1182,7647,7342,305,7342,5310,2032,2020-01-01,zipcode,Plant city
ZCTA5 33592,12,11706,45064,861,146500,9739,4576,8442,1599,3034,1989,1094,726,4623,3963,660,3963,2612,1351,2020-01-01,zipcode,Thonotosassa
ZCTA5 33605,12,17945,23632,967,134100,14235,5910,12438,3021,4551,2980,1377,509,8938,7585,1353,7585,2755,4830,2020-01-01,zipcode,Tampa
ZCTA5 33610,12,48490,38733,1060,136800,35576,13871,30075,5376,11365,8682,3233,1419,18262,16771,1491,16771,7756,9015,2020-01-01,zipcode,Tampa
ZCTA5 33611,12,34615,66495,1226,298700,28733,9180,26598,1445,5412,6138,8381,5222,17800,16269,1531,16269,9213,7056,2020-01-01,zipcode,Tampa
ZCTA5 33625,12,28619,62539,1426,262300,24141,8565,20715,1414,5675,6249,4501,2876,11871,11232,639,11232,7673,3559,2020-01-01,zipcode,Tampa
ZCTA5 33511,12,59776,61149,1319,216600,48621,17022,41862,3891,9994,13604,10425,3948,24080,22334,1746,22334,11998,10336,2020-01-01,zipcode,Brandon
ZCTA5 33534,12,16608,66295,1009,203600,11816,3533,10051,1920,3552,2744,1275,560,5575,5058,517,5058,3603,1455,2020-01-01,zipcode,Gibsonton
ZCTA5 33815,12,15265,32708,844,22700,11851,5850,9743,1985,4112,2732,664,250,7438,5693,1745,5693,3269,2424,2020-01-01,zipcode,Lakeland
ZCTA5 33839,12,3565,57204,870,130100,2717,954,2379,545,850,634,279,71,1303,1063,240,1063,765,298,2020-01-01,zipcode,Eagle lake
ZCTA5 33848,12,908,59293,917,58500,806,376,625,235,227,123,0,40,442,172,270,172,119,53,2020-01-01,zipcode,Intercession city
ZCTA5 33851,12,1245,50000,947,161800,1020,515,885,139,394,218,126,8,428,342,86,342,305,37,2020-01-01,zipcode,Lake hamilton
ZCTA5 33865,12,1130,57813,-666666666,-666666666,980,474,902,222,373,180,109,18,303,274,29,274,212,62,2020-01-01,zipcode,Ona
ZCTA5 33880,12,42268,44615,893,130700,32961,13478,28567,6590,10738,7917,2192,1130,16373,13688,2685,13688,9127,4561,2020-01-01,zipcode,Winter haven
ZCTA5 33881,12,33577,44281,909,95000,27448,14487,24262,3592,8297,8275,2610,1488,15526,12482,3044,12482,8749,3733,2020-01-01,zipcode,Winter haven
ZCTA5 33905,12,38304,56025,1170,168900,31284,13794,27202,5583,9293,6928,3302,2096,15489,12616,2873,12616,8458,4158,2020-01-01,zipcode,Fort myers
ZCTA5 33909,12,32183,57302,1368,191900,25621,9567,22329,1676,9786,6599,2988,1280,12009,10678,1331,10678,6892,3786,2020-01-01,zipcode,Cape coral
ZCTA5 33914,12,40422,66185,1235,289500,36743,16423,33552,1990,11949,11123,4927,3563,21073,16168,4905,16168,12765,3403,2020-01-01,zipcode,Cape coral
ZCTA5 33930,12,631,-666666666,-666666666,111800,422,93,352,58,184,70,0,40,362,288,74,288,233,55,2020-01-01,zipcode,Felda
ZCTA5 33955,12,10645,66239,1134,250000,9795,5970,9130,1122,2608,2675,1738,987,6628,4562,2066,4562,4163,399,2020-01-01,zipcode,Punta gorda
ZCTA5 33770,12,26979,47908,1092,168500,23172,9278,20430,2375,6803,6696,2875,1681,13710,11561,2149,11561,6987,4574,2020-01-01,zipcode,Largo
ZCTA5 33772,12,23413,60843,1152,224100,19905,8114,17673,1427,4815,6176,3697,1558,11828,9801,2027,9801,7225,2576,2020-01-01,zipcode,Seminole
ZCTA5 33028,12,27314,101439,2185,412700,21676,5910,18386,1005,3627,4652,5457,3645,8977,8407,570,8407,6436,1971,2020-01-01,zipcode,Pembroke pines
ZCTA5 33037,12,10541,68164,1691,490700,9361,4019,8832,797,2401,2545,1707,1382,10335,4758,5577,4758,3575,1183,2020-01-01,zipcode,Key largo
ZCTA5 33054,12,32735,31508,990,189300,25651,11522,20955,5972,8396,4861,1409,317,10143,9518,625,9518,4415,5103,2020-01-01,zipcode,Opa locka
ZCTA5 33060,12,38637,47957,1171,245200,30986,11975,27109,5505,8422,7384,3765,2033,15232,13531,1701,13531,6883,6648,2020-01-01,zipcode,Pompano beach
ZCTA5 33062,12,23303,68526,1438,375200,21957,10594,20967,1234,4742,5866,4875,4250,21662,12839,8823,12839,8798,4041,2020-01-01,zipcode,Pompano beach
ZCTA5 34949,12,7740,69954,1322,311600,7516,4736,7382,324,1518,2175,1925,1440,8142,4333,3809,4333,3423,910,2020-01-01,zipcode,Fort pierce
ZCTA5 34105,12,16185,90011,1658,486900,14345,6984,13261,597,2571,3578,4084,2431,10819,7233,3586,7233,4519,2714,2020-01-01,zipcode,Naples
ZCTA5 34135,12,49455,68440,1319,287800,43679,22377,40012,5638,9390,11331,8146,5507,29533,20275,9258,20275,16174,4101,2020-01-01,zipcode,Bonita springs
ZCTA5 34137,12,339,-666666666,-666666666,-666666666,150,60,150,0,110,40,0,0,93,93,0,93,66,27,2020-01-01,zipcode,
ZCTA5 34145,12,17963,84288,1507,669200,16828,10859,16316,1072,3446,4493,4566,2739,18630,9056,9574,9056,8042,1014,2020-01-01,zipcode,Marco island
ZCTA5 34207,12,36677,39549,1006,94900,30922,14345,27062,4765,10554,7506,2800,1437,19125,14983,4142,14983,9014,5969,2020-01-01,zipcode,Bradenton
ZCTA5 34741,12,48520,39182,1177,187800,37225,13284,32074,5260,9417,11150,4408,1839,20834,16278,4556,16278,5360,10918,2020-01-01,zipcode,Kissimmee
ZCTA5 34748,12,39265,44876,940,162000,34186,21126,31493,3253,11773,10344,3828,2295,21534,17561,3973,17561,12524,5037,2020-01-01,zipcode,Leesburg
ZCTA5 34759,12,38406,49691,1346,203200,30513,16033,26053,4830,6749,7597,4285,2592,15625,12142,3483,12142,9146,2996,2020-01-01,zipcode,Kissimmee
ZCTA5 34771,12,21715,77963,1210,318800,17348,7072,14764,1273,4300,4880,3093,1218,8051,6618,1433,6618,5753,865,2020-01-01,zipcode,Saint cloud
ZCTA5 34984,12,17072,69143,1557,222200,13888,5363,12324,1674,3410,4869,1635,736,6595,5822,773,5822,4758,1064,2020-01-01,zipcode,Port saint lucie
ZCTA5 34134,12,15208,100052,1396,519000,14526,9969,14132,294,2275,3986,3816,3761,14203,7772,6431,7772,6543,1229,2020-01-01,zipcode,Bonita springs
ZCTA5 34237,12,19169,51502,1203,174000,16077,5874,14135,1972,5001,4088,2063,1011,8619,7283,1336,7283,3573,3710,2020-01-01,zipcode,Sarasota
ZCTA5 34103,12,12848,102632,1482,781400,11797,6456,10750,393,2152,2615,3245,2345,10814,5828,4986,5828,4754,1074,2020-01-01,zipcode,Naples
ZCTA5 34110,12,24713,69858,1641,400000,22124,12879,20523,826,4153,5403,5731,4410,16919,11904,5015,11904,8909,2995,2020-01-01,zipcode,Naples
ZCTA5 34120,12,34431,67448,1666,317800,28328,9409,25067,3001,8704,6309,3853,3200,14684,11617,3067,11617,10140,1477,2020-01-01,zipcode,Naples
ZCTA5 34201,12,3729,96824,1920,448400,3372,2195,3124,176,431,678,808,1031,2282,1666,616,1666,1551,115,2020-01-01,zipcode,Bradenton
ZCTA5 34203,12,39350,52186,1107,210100,33242,15381,30513,4429,10838,7931,4328,2987,19238,15615,3623,15615,11709,3906,2020-01-01,zipcode,Bradenton
ZCTA5 34205,12,31871,46190,1022,163100,26381,11098,23644,3859,7848,6879,3473,1585,15981,12775,3206,12775,7518,5257,2020-01-01,zipcode,Bradenton
ZCTA5 34221,12,50857,57820,1175,198100,42305,20544,38014,4728,12502,11243,6257,3284,22155,17455,4700,17455,13644,3811,2020-01-01,zipcode,Palmetto
ZCTA5 34449,12,3650,30808,470,88200,3266,1618,3056,424,1467,870,221,74,1987,1532,455,1532,1146,386,2020-01-01,zipcode,Inglis
ZCTA5 34601,12,22644,40996,839,100600,19149,10282,17109,2314,6075,5360,2359,1001,11932,10043,1889,10043,7043,3000,2020-01-01,zipcode,Brooksville
ZCTA5 34747,12,24445,70744,1548,334000,19547,5419,16208,581,3035,4947,4837,2808,26878,9160,17718,9160,4215,4945,2020-01-01,zipcode,Kissimmee
ZCTA5 34788,12,19344,44703,1122,91000,17061,9044,16151,1655,6395,5050,1982,1069,10327,8422,1905,8422,7053,1369,2020-01-01,zipcode,Leesburg
ZCTA5 34997,12,45382,61661,1189,264900,39019,17604,35163,3313,9807,12443,6089,3511,21375,17886,3489,17886,14475,3411,2020-01-01,zipcode,Stuart
ZCTA5 76626,48,1294,68188,1002,125000,898,371,725,55,242,311,103,14,608,435,173,435,314,121,2020-01-01,zipcode,Blooming grove
ZCTA5 76078,48,9024,75579,1216,175500,6664,2365,5878,569,2165,2076,843,225,3087,2773,314,2773,2351,422,2020-01-01,zipcode,Rhome
ZCTA5 76106,48,38906,44384,938,89800,27249,8960,21828,9839,7357,3393,1028,211,11500,10848,652,10848,4985,5863,2020-01-01,zipcode,Fort worth
ZCTA5 76474,48,327,-666666666,-666666666,318900,264,149,257,14,38,146,42,17,162,137,25,137,133,4,2020-01-01,zipcode,Sidney
ZCTA5 76483,48,895,38313,-666666666,48900,756,320,647,115,236,158,98,40,675,447,228,447,313,134,2020-01-01,zipcode,Throckmorton
ZCTA5 76490,48,107,30521,-666666666,-666666666,107,31,84,0,32,43,5,4,71,49,22,49,38,11,2020-01-01,zipcode,Whitt
ZCTA5 76557,48,5991,70260,855,170500,5009,2281,4097,404,1355,1378,639,321,2225,2033,192,2033,1637,396,2020-01-01,zipcode,Moody
ZCTA5 76579,48,5547,53821,739,137600,4088,1728,3641,349,1244,1331,579,138,1957,1855,102,1855,1284,571,2020-01-01,zipcode,Troy
ZCTA5 76015,48,17773,60986,1251,160300,14034,4459,11327,1393,2526,3837,2384,1187,7060,6313,747,6313,2977,3336,2020-01-01,zipcode,Arlington
ZCTA5 76028,48,72493,81439,1342,210200,54859,17534,47246,3363,14220,16686,8557,4420,25869,24470,1399,24470,18392,6078,2020-01-01,zipcode,Burleson
ZCTA5 76034,48,26693,171122,2261,566500,20961,7584,18662,132,1503,5164,7052,4811,9402,9215,187,9215,8833,382,2020-01-01,zipcode,Colleyville
ZCTA5 76050,48,6094,67271,967,174500,4978,1982,4421,506,1606,1563,573,173,2428,2209,219,2209,1773,436,2020-01-01,zipcode,Grandview
ZCTA5 76053,48,30317,56563,1115,178000,22889,7442,19820,2642,5085,6454,4010,1629,12026,10878,1148,10878,5867,5011,2020-01-01,zipcode,Hurst
ZCTA5 76058,48,21037,57874,1048,137500,15649,5945,12607,2415,4621,3735,1160,676,7600,6917,683,6917,5208,1709,2020-01-01,zipcode,Joshua
ZCTA5 76542,48,49765,62083,1063,161800,37631,12042,30223,1621,6800,13810,5805,2187,19739,18315,1424,18315,10302,8013,2020-01-01,zipcode,Killeen
ZCTA5 76527,48,3696,65750,854,289300,2657,957,2341,214,751,1043,282,51,1271,1187,84,1187,800,387,2020-01-01,zipcode,Florence
ZCTA5 76537,48,7065,79625,1296,188800,5382,1538,4532,678,1540,1488,508,318,2210,2030,180,2030,1640,390,2020-01-01,zipcode,Jarrell
ZCTA5 76539,48,8824,71738,786,198400,7174,3382,6208,308,1607,3041,794,458,3612,3106,506,3106,2895,211,2020-01-01,zipcode,Kempner
ZCTA5 76550,48,14169,58185,752,158200,11326,4804,10007,1242,3273,3784,1193,515,6079,5248,831,5248,3829,1419,2020-01-01,zipcode,Lampasas
ZCTA5 76566,48,231,106042,-666666666,185000,179,76,149,10,53,66,20,0,104,73,31,73,68,5,2020-01-01,zipcode,Purmela
ZCTA5 76567,48,8867,42353,724,115800,7270,2967,6194,1038,2555,1777,496,328,4077,3628,449,3628,2574,1054,2020-01-01,zipcode,Rockdale
ZCTA5 76577,48,3074,69392,821,152400,2476,1016,2098,204,753,642,410,89,1343,1166,177,1166,908,258,2020-01-01,zipcode,Thorndale
ZCTA5 76622,48,1537,63750,1026,158100,1140,413,990,91,322,381,122,74,633,504,129,504,431,73,2020-01-01,zipcode,Aquilla
ZCTA5 76629,48,1954,42396,653,115600,1671,980,1486,249,580,447,165,45,1171,864,307,864,644,220,2020-01-01,zipcode,Bremond
ZCTA5 76645,48,10513,52560,814,96500,8456,3402,6965,1191,2429,2076,828,441,4329,3753,576,3753,2262,1491,2020-01-01,zipcode,Hillsboro
ZCTA5 76687,48,1950,61085,846,243300,1743,1056,1650,88,633,583,278,68,1307,801,506,801,713,88,2020-01-01,zipcode,Thornton
ZCTA5 76710,48,24607,44375,855,151900,19820,7052,17093,1584,4779,5688,3143,1899,12181,10943,1238,10943,5393,5550,2020-01-01,zipcode,Waco
ZCTA5 76711,48,10475,46670,1143,72500,8087,2590,6508,1861,1867,1978,385,417,4166,3653,513,3653,2015,1638,2020-01-01,zipcode,Waco
ZCTA5 76825,48,6682,49200,731,93000,5301,2204,4565,945,1339,1456,589,236,3348,2550,798,2550,1691,859,2020-01-01,zipcode,Brady
ZCTA5 76841,48,174,-666666666,-666666666,-666666666,68,23,45,0,0,0,18,27,78,18,60,18,0,18,2020-01-01,zipcode,Fort mc kavett
ZCTA5 76844,48,3393,50253,647,128600,2866,1305,2491,443,836,712,382,118,2047,1246,801,1246,1066,180,2020-01-01,zipcode,Goldthwaite
ZCTA5 76874,48,14,-666666666,-666666666,-666666666,14,0,14,0,14,0,0,0,113,14,99,14,14,0,2020-01-01,zipcode,Roosevelt
ZCTA5 76875,48,449,48821,1013,132100,380,113,362,10,165,120,46,21,321,246,75,246,197,49,2020-01-01,zipcode,Rowena
ZCTA5 76878,48,1670,56250,656,80400,1326,549,1163,153,334,496,150,30,974,656,318,656,448,208,2020-01-01,zipcode,Santa anna
ZCTA5 76935,48,1852,66250,-666666666,258900,1390,708,1261,14,291,518,351,87,734,603,131,603,603,0,2020-01-01,zipcode,Christoval
ZCTA5 76941,48,1421,53250,1014,122100,1109,464,953,50,361,339,166,37,789,583,206,583,472,111,2020-01-01,zipcode,Mertzon
ZCTA5 76955,48,141,75208,-666666666,218200,110,41,92,13,16,22,30,11,71,45,26,45,38,7,2020-01-01,zipcode,Vancourt
ZCTA5 76226,48,29240,151554,1971,420700,21548,6839,19113,511,2661,4640,7834,3467,9706,9365,341,9365,8695,670,2020-01-01,zipcode,Argyle
ZCTA5 76227,48,36392,102020,1684,259800,26140,6158,23665,1123,4683,8465,6576,2818,12567,12223,344,12223,10146,2077,2020-01-01,zipcode,Aubrey
ZCTA5 76651,48,4084,58427,904,148100,3240,1273,2689,337,1031,933,276,112,1691,1481,210,1481,1011,470,2020-01-01,zipcode,Italy
ZCTA5 76680,48,189,-666666666,-666666666,-666666666,160,56,135,48,56,21,0,10,139,64,75,64,64,0,2020-01-01,zipcode,Reagan
ZCTA5 76060,48,8606,89097,1047,236400,6905,2111,6011,901,1513,1761,1137,699,3277,3013,264,3013,2149,864,2020-01-01,zipcode,Kennedale
ZCTA5 76148,48,23679,75926,1446,151900,18809,5528,16170,1673,5435,5844,2604,614,7894,7684,210,7684,6217,1467,2020-01-01,zipcode,Fort worth
ZCTA5 76305,48,4285,66070,777,120300,3579,1509,3245,362,1186,1014,529,154,2063,1685,378,1685,1480,205,2020-01-01,zipcode,Wichita falls
ZCTA5 76306,48,15726,40892,796,79800,11489,4699,9917,1342,3727,3254,1071,523,6990,5906,1084,5906,3246,2660,2020-01-01,zipcode,Wichita falls
ZCTA5 76365,48,4598,51451,778,104300,3718,1687,3282,331,1004,1031,624,292,2493,1911,582,1911,1484,427,2020-01-01,zipcode,Henrietta
ZCTA5 76367,48,13385,57300,1010,102100,11053,6481,10060,1775,4181,2819,931,354,3947,3638,309,3638,3086,552,2020-01-01,zipcode,Iowa park
ZCTA5 76373,48,144,54583,-666666666,-666666666,138,95,133,65,28,27,13,0,75,68,7,68,68,0,2020-01-01,zipcode,Oklaunion
ZCTA5 76388,48,231,40938,790,30800,198,68,166,34,65,58,4,5,124,104,20,104,73,31,2020-01-01,zipcode,Weinert
ZCTA5 76401,48,29904,52961,965,174200,24266,9063,16841,1743,3980,4912,4065,2141,13430,10557,2873,10557,6093,4464,2020-01-01,zipcode,Stephenville
ZCTA5 75901,48,29148,50503,847,119300,22526,8711,18790,3302,5843,5972,2432,1241,11747,10262,1485,10262,6624,3638,2020-01-01,zipcode,Lufkin
ZCTA5 75928,48,1318,22170,-666666666,67300,1240,652,1029,136,518,363,12,0,665,479,186,479,429,50,2020-01-01,zipcode,Bon wier
ZCTA5 75948,48,6072,38939,669,120700,5396,3418,4923,590,1711,1716,527,379,5383,2717,2666,2717,2371,346,2020-01-01,zipcode,Hemphill
ZCTA5 75954,48,2634,40566,672,93100,2150,1053,1949,419,682,536,194,118,1557,1065,492,1065,808,257,2020-01-01,zipcode,Joaquin
ZCTA5 75960,48,725,52102,-666666666,101900,425,74,321,127,34,146,14,0,329,163,166,163,160,3,2020-01-01,zipcode,Moscow
ZCTA5 75001,48,15418,72050,1397,337300,13385,2533,12104,538,1258,3587,4619,2102,9457,8404,1053,8404,1408,6996,2020-01-01,zipcode,Addison
ZCTA5 75013,48,42956,140098,1436,421400,32680,7886,28179,775,2588,6971,9775,8070,15914,14967,947,14967,10263,4704,2020-01-01,zipcode,Allen
ZCTA5 75022,48,28773,169473,2085,446400,21446,6218,17763,656,2040,3606,7215,4246,8925,8760,165,8760,7812,948,2020-01-01,zipcode,Flower mound
ZCTA5 75034,48,116155,116213,1421,428100,86928,26148,74150,3109,8205,17084,28108,17644,44388,41335,3053,41335,26713,14622,2020-01-01,zipcode,Frisco
ZCTA5 75040,48,61508,64957,1288,166900,47585,14550,39340,10006,9846,11529,5546,2413,19631,18599,1032,18599,13016,5583,2020-01-01,zipcode,Garland
ZCTA5 75050,48,43190,61441,1117,155100,33247,9631,26834,5862,8215,7504,3436,1817,16596,15316,1280,15316,6631,8685,2020-01-01,zipcode,Grand prairie
ZCTA5 75052,48,94060,80799,1326,191200,71238,20357,59973,9132,14790,19368,11666,5017,31013,29461,1552,29461,21229,8232,2020-01-01,zipcode,Grand prairie
ZCTA5 75061,48,53983,49695,1008,155500,39996,11396,32640,11490,8578,7541,3551,1480,18876,17547,1329,17547,7087,10460,2020-01-01,zipcode,Irving
ZCTA5 75063,48,39831,95310,1332,378600,30031,7554,26830,689,2388,4599,10304,8850,17037,15862,1175,15862,6082,9780,2020-01-01,zipcode,Irving
ZCTA5 75078,48,34300,155405,1685,465100,23515,6869,20421,545,1884,5098,8843,4051,10752,10001,751,10001,9085,916,2020-01-01,zipcode,Prosper
ZCTA5 75081,48,40825,82848,1396,252600,32235,9608,28126,2688,3745,9247,8395,4051,15836,15082,754,15082,8296,6786,2020-01-01,zipcode,Richardson
ZCTA5 75119,48,28901,65304,970,147600,22120,7148,18210,3811,5438,5692,2489,780,10521,9537,984,9537,6648,2889,2020-01-01,zipcode,Ennis
ZCTA5 75124,48,4985,63764,691,134800,4062,2351,3488,460,1366,989,479,194,2429,1806,623,1806,1470,336,2020-01-01,zipcode,Eustace
ZCTA5 75146,48,20663,65513,1322,164300,14591,3991,12540,1075,3083,5056,2075,1251,7641,7089,552,7089,4556,2533,2020-01-01,zipcode,Lancaster
ZCTA5 75172,48,4814,55827,908,74300,3819,1171,3162,825,921,1176,210,30,1712,1607,105,1607,932,675,2020-01-01,zipcode,Wilmer
ZCTA5 75181,48,25264,88990,1763,191400,18204,5238,15340,2046,4107,5771,2156,1260,7714,7431,283,7431,6426,1005,2020-01-01,zipcode,Mesquite
ZCTA5 75206,48,39653,75569,1347,433100,34646,6602,30296,1916,2189,4968,13778,7445,24599,21248,3351,21248,5836,15412,2020-01-01,zipcode,Dallas
ZCTA5 75007,48,57513,93770,1302,269900,48288,13438,41444,3998,8362,11767,12461,4856,20437,19744,693,19744,14156,5588,2020-01-01,zipcode,Carrollton
ZCTA5 75009,48,15348,108000,1598,293200,11625,4147,10326,742,1434,4042,3252,856,5017,4850,167,4850,4154,696,2020-01-01,zipcode,Celina
ZCTA5 75020,48,23216,53190,884,118800,18335,7431,15893,1469,5394,6013,1912,1105,10159,8856,1303,8856,5369,3487,2020-01-01,zipcode,Denison
ZCTA5 75067,48,67197,65173,1213,229600,53276,11735,46434,6174,10860,14003,11009,4388,27131,25200,1931,25200,9479,15721,2020-01-01,zipcode,Lewisville
ZCTA5 75080,48,53708,73438,1414,315500,42561,14944,32931,2857,4362,7495,10572,7645,21031,19538,1493,19538,10743,8795,2020-01-01,zipcode,Richardson
ZCTA5 75090,48,25732,44828,857,95400,19483,7657,16018,2691,5135,6004,1336,852,9521,8421,1100,8421,5667,2754,2020-01-01,zipcode,Sherman
ZCTA5 75104,48,48821,76528,1475,191000,36429,10578,30450,2869,6861,11415,5854,3451,16326,15697,629,15697,11249,4448,2020-01-01,zipcode,Cedar hill
ZCTA5 75110,48,29665,43736,789,108000,22259,8304,18485,4267,5039,6207,1804,1168,11663,10234,1429,10234,6463,3771,2020-01-01,zipcode,Corsicana
ZCTA5 75140,48,6877,43471,712,90500,5363,2831,4436,1024,1579,1384,289,160,2747,2290,457,2290,1718,572,2020-01-01,zipcode,Grand saline
ZCTA5 75153,48,571,83125,690,92500,439,178,388,91,71,134,83,9,236,151,85,151,127,24,2020-01-01,zipcode,Powell
ZCTA5 75159,48,20857,63297,1093,159100,15356,7027,12930,2831,4626,3911,1015,547,6232,5553,679,5553,4279,1274,2020-01-01,zipcode,Seagoville
ZCTA5 75161,48,7483,61121,872,156800,6301,2417,5689,849,2655,1620,409,156,2528,2448,80,2448,1890,558,2020-01-01,zipcode,Terrell
ZCTA5 32607,12,30139,41656,973,222200,26039,9362,15615,690,2643,4278,3855,4149,15127,12236,2891,12236,4145,8091,2020-01-01,zipcode,Gainesville
ZCTA5 32622,12,1076,49444,802,135400,841,345,806,163,255,172,96,120,534,462,72,462,273,189,2020-01-01,zipcode,Brooker
ZCTA5 32658,12,327,51429,-666666666,98800,283,153,252,47,105,75,25,0,112,92,20,92,77,15,2020-01-01,zipcode,La crosse
ZCTA5 35184,01,4638,42642,640,82600,3824,1952,3291,662,1537,893,164,35,2310,1635,675,1635,1254,381,2020-01-01,zipcode,West blocton
ZCTA5 75656,48,4897,47542,664,96200,3708,1734,3121,478,1451,748,314,130,2157,1764,393,1764,1290,474,2020-01-01,zipcode,Hughes springs
ZCTA5 75667,48,1327,41654,872,86000,1094,466,880,210,283,333,39,15,545,475,70,475,358,117,2020-01-01,zipcode,Laneville
ZCTA5 77629,48,810,67813,675,92200,699,250,631,129,197,191,77,37,373,340,33,340,300,40,2020-01-01,zipcode,Nome
ZCTA5 77632,48,22200,75127,846,133800,17131,6903,15010,1383,5575,5038,2449,565,9982,8263,1719,8263,6539,1724,2020-01-01,zipcode,Orange
ZCTA5 07060,34,46585,61953,1259,279700,36077,10006,30546,6875,9848,6947,4577,2299,16222,15315,907,15315,6161,9154,2020-01-01,zipcode,Plainfield
ZCTA5 07063,34,13052,65320,1415,264100,10121,3104,8438,1645,3216,1883,1045,649,4182,3902,280,3902,2395,1507,2020-01-01,zipcode,Plainfield
ZCTA5 07939,34,254,43365,-666666666,-666666666,254,251,241,13,152,59,17,0,43,43,0,43,13,30,2020-01-01,zipcode,Lyons
ZCTA5 07961,34,0,-666666666,-666666666,-666666666,0,0,0,0,0,0,0,0,0,0,0,0,0,0,2020-01-01,zipcode,Convent station
ZCTA5 07022,34,14218,58072,1399,426700,12303,3703,10677,2807,3093,1661,2267,849,5588,5395,193,5395,1844,3551,2020-01-01,zipcode,Fairview
ZCTA5 07095,34,20297,94004,1811,283400,16196,5141,14320,1102,3872,3758,3449,2139,7676,7319,357,7319,4023,3296,2020-01-01,zipcode,Woodbridge
ZCTA5 07208,34,32319,50861,1180,332800,24562,6780,20730,4158,7348,4727,3124,1373,12100,11417,683,11417,3017,8400,2020-01-01,zipcode,Elizabeth
ZCTA5 07463,34,10051,127574,1725,462200,7648,2226,6831,398,1356,1433,2640,1004,3399,3399,0,3399,3042,357,2020-01-01,zipcode,Waldwick
ZCTA5 07206,34,27520,46275,1226,260600,20141,6979,16178,5856,5975,3144,770,433,8866,8040,826,8040,2234,5806,2020-01-01,zipcode,Elizabethport
ZCTA5 07418,34,2674,170859,-666666666,276300,2155,505,1826,10,494,514,351,457,975,926,49,926,912,14,2020-01-01,zipcode,Glenwood
ZCTA5 07452,34,11747,178607,1791,666600,8372,2641,7221,176,659,1097,2685,2604,3711,3593,118,3593,3335,258,2020-01-01,zipcode,Glen rock
ZCTA5 07503,34,17535,52286,1256,261800,13955,5474,11471,2671,5175,2367,935,323,5798,5476,322,5476,1741,3735,2020-01-01,zipcode,Paterson
ZCTA5 07512,34,10810,96750,1346,370300,8584,2985,7797,660,2798,2153,1577,609,3742,3692,50,3692,2797,895,2020-01-01,zipcode,Totowa
ZCTA5 07514,34,18507,48921,1204,230200,14288,5009,11812,2234,5375,2954,1037,212,6730,6080,650,6080,1834,4246,2020-01-01,zipcode,Paterson
ZCTA5 33635,12,19590,71768,1411,216500,15803,4874,14275,940,3848,3949,3455,2083,8125,7240,885,7240,4621,2619,2020-01-01,zipcode,Tampa
ZCTA5 75166,48,4624,101150,1720,258100,3343,786,2891,97,711,1141,627,315,1467,1467,0,1467,1276,191,2020-01-01,zipcode,Lavon
ZCTA5 75169,48,12937,49685,761,117300,10332,4676,9169,1703,3155,3097,961,253,6082,5110,972,5110,3887,1223,2020-01-01,zipcode,Wills point
ZCTA5 75189,48,30842,96938,1601,230400,22587,6523,19718,1912,5596,7108,3723,1379,10439,10067,372,10067,8998,1069,2020-01-01,zipcode,Royse city
ZCTA5 75207,48,7715,85075,1619,-666666666,7658,5272,6629,1405,1604,1759,1097,764,2196,1979,217,1979,10,1969,2020-01-01,zipcode,Dallas
ZCTA5 75208,48,30064,66230,1131,325800,24098,6628,20579,5390,3583,4101,4621,2884,12448,11241,1207,11241,6413,4828,2020-01-01,zipcode,Dallas
ZCTA5 75219,48,24038,75476,1405,324600,22533,3864,20525,1513,1424,3853,8336,5399,17796,15484,2312,15484,4777,10707,2020-01-01,zipcode,Dallas
ZCTA5 75232,48,32823,43816,1051,133500,26010,12133,22742,5013,7618,6563,2068,1480,12000,11467,533,11467,7266,4201,2020-01-01,zipcode,Dallas
ZCTA5 75233,48,16920,55393,1057,172300,12258,4384,9706,2856,2696,2191,1111,852,5095,4908,187,4908,2537,2371,2020-01-01,zipcode,Dallas
ZCTA5 75248,48,37602,86326,1289,419300,31472,8787,28385,1194,2976,5956,11056,7203,18548,16983,1565,16983,8731,8252,2020-01-01,zipcode,Dallas
ZCTA5 75270,48,0,-666666666,-666666666,-666666666,0,0,0,0,0,0,0,0,0,0,0,0,0,0,2020-01-01,zipcode,Dallas
ZCTA5 75412,48,659,56875,-666666666,108200,566,245,494,32,101,272,64,25,417,294,123,294,288,6,2020-01-01,zipcode,Bagwell
ZCTA5 75420,48,1135,57975,760,110000,932,285,754,145,210,262,118,19,534,514,20,514,447,67,2020-01-01,zipcode,Brashear
ZCTA5 75424,48,2891,68795,1212,189700,2295,795,1997,383,673,660,187,94,1136,1047,89,1047,877,170,2020-01-01,zipcode,Blue ridge
ZCTA5 75432,48,3196,50735,614,102600,2526,1025,2073,249,626,587,375,236,1495,1220,275,1220,863,357,2020-01-01,zipcode,Cooper
ZCTA5 75442,48,9558,72872,1256,215500,7565,3115,6618,814,2339,2226,977,262,3799,3353,446,3353,2608,745,2020-01-01,zipcode,Farmersville
ZCTA5 75460,48,23926,36539,719,84200,18946,7766,16381,2820,5585,5620,1753,603,11420,10067,1353,10067,5160,4907,2020-01-01,zipcode,Paris
ZCTA5 75470,48,147,67969,-666666666,55200,147,82,147,18,104,7,9,9,133,77,56,77,77,0,2020-01-01,zipcode,Petty
ZCTA5 75476,48,1031,48162,880,145200,960,549,947,187,301,364,54,41,539,469,70,469,415,54,2020-01-01,zipcode,Ravenna
ZCTA5 75482,48,25108,53287,837,124900,19798,7284,16797,2332,5837,4755,2609,1264,10591,9336,1255,9336,6119,3217,2020-01-01,zipcode,Sulphur springs
ZCTA5 75044,48,45284,72101,1338,218400,35983,10778,30370,3775,6579,9155,7298,3563,16041,15607,434,15607,10206,5401,2020-01-01,zipcode,Garland
ZCTA5 75662,48,26318,60318,859,124300,20101,7541,16934,3142,4543,6008,2137,1104,9898,8723,1175,8723,6643,2080,2020-01-01,zipcode,Kilgore
ZCTA5 75701,48,36089,51440,949,141300,29393,11580,23329,2769,5371,8861,4747,1581,14449,12409,2040,12409,7111,5298,2020-01-01,zipcode,Tyler
ZCTA5 75709,48,4624,62670,1064,135300,4091,1538,3435,282,719,1206,776,452,2557,1888,669,1888,1155,733,2020-01-01,zipcode,Tyler
ZCTA5 75755,48,4805,58088,754,155200,4039,1515,3323,566,1148,929,583,97,2385,1824,561,1824,1050,774,2020-01-01,zipcode,Big sandy
ZCTA5 75048,48,26062,108258,1428,259700,21260,6148,17672,1894,3383,5887,4375,2133,9024,8815,209,8815,7796,1019,2020-01-01,zipcode,Sachse
ZCTA5 32696,12,12783,44328,748,153600,10235,4916,9224,1287,3615,2743,1136,443,5784,5139,645,5139,4203,936,2020-01-01,zipcode,Williston
ZCTA5 32702,12,2378,49327,2693,85500,2135,1267,1866,293,626,535,285,127,1516,1099,417,1099,624,475,2020-01-01,zipcode,Altoona
ZCTA5 32726,12,23354,50439,834,166400,18687,7108,16492,2157,6722,4671,2035,907,10331,9101,1230,9101,5908,3193,2020-01-01,zipcode,Eustis
ZCTA5 32730,12,6656,41662,1191,192700,5680,1913,5098,341,1291,2087,1025,354,2993,2809,184,2809,1025,1784,2020-01-01,zipcode,Casselberry
ZCTA5 32736,12,11229,69083,977,288100,8803,3340,7710,590,2103,2792,1519,706,4077,3690,387,3690,3276,414,2020-01-01,zipcode,Eustis
ZCTA5 32757,12,29295,59987,1086,236400,24502,11025,21632,1929,6528,6233,3958,2984,13619,11765,1854,11765,8450,3315,2020-01-01,zipcode,Mount dora
ZCTA5 32759,12,3230,48722,941,175700,2732,1515,2559,297,1084,755,288,135,1599,1226,373,1226,981,245,2020-01-01,zipcode,Oak hill
ZCTA5 32779,12,29618,95005,1586,352100,24334,8951,21493,419,3424,6302,6965,4383,11796,11209,587,11209,9083,2126,2020-01-01,zipcode,Longwood
ZCTA5 32792,12,52670,57214,1262,247600,44261,14939,36486,2643,7330,11748,9067,5698,23766,21236,2530,21236,10105,11131,2020-01-01,zipcode,Winter park
ZCTA5 32829,12,20903,76103,1568,238300,15840,4598,13886,1391,2782,4209,3633,1871,7520,6428,1092,6428,5145,1283,2020-01-01,zipcode,Orlando
ZCTA5 32903,12,14693,81488,1368,356700,12008,5211,10915,385,1716,3364,3169,2281,7264,6165,1099,6165,5102,1063,2020-01-01,zipcode,Indialantic
ZCTA5 32904,12,33869,72981,1364,236700,27692,11191,23721,1538,5436,7995,5548,3204,14165,12791,1374,12791,10453,2338,2020-01-01,zipcode,Melbourne
ZCTA5 32907,12,46911,55322,1160,178200,38701,17258,33667,3880,10703,12953,3924,2207,16944,15617,1327,15617,12931,2686,2020-01-01,zipcode,Palm bay
ZCTA5 32966,12,19957,53750,1115,172700,17291,10310,16327,1174,4811,5581,2852,1909,11239,8559,2680,8559,6680,1879,2020-01-01,zipcode,Vero beach
ZCTA5 32958,12,29057,53395,1137,198600,25657,14192,23886,1903,8420,7184,3663,2716,14771,12414,2357,12414,10264,2150,2020-01-01,zipcode,Sebastian
ZCTA5 32960,12,22974,44648,905,173300,19438,8440,17080,1757,5416,5645,2901,1361,11729,9148,2581,9148,5540,3608,2020-01-01,zipcode,Vero beach
ZCTA5 32221,12,28809,66485,1301,171000,22612,8241,19320,2445,6479,6098,3176,1122,10807,10169,638,10169,7657,2512,2020-01-01,zipcode,Jacksonville
ZCTA5 32225,12,53414,74712,1352,237400,43006,13751,37025,1869,9398,11653,9748,4357,21791,19878,1913,19878,13252,6626,2020-01-01,zipcode,Jacksonville
ZCTA5 32234,12,6475,70420,782,119500,4996,1727,4450,680,2092,1217,327,134,2588,2382,206,2382,1889,493,2020-01-01,zipcode,Jacksonville
ZCTA5 32244,12,61190,54770,1152,141600,47347,14622,41506,4201,13506,14760,7025,2014,24655,22539,2116,22539,12630,9909,2020-01-01,zipcode,Jacksonville
ZCTA5 32254,12,13572,31425,889,59900,10238,4756,8908,2485,3612,2133,516,162,6067,5022,1045,5022,2511,2511,2020-01-01,zipcode,Jacksonville
ZCTA5 32937,12,27054,76548,1316,312900,22718,9780,20226,527,4121,6315,5257,4006,12876,10881,1995,10881,8691,2190,2020-01-01,zipcode,Satellite beach
ZCTA5 32807,12,34239,48469,1167,165600,28044,8613,24087,4575,7720,7181,3215,1396,13184,12012,1172,12012,5845,6167,2020-01-01,zipcode,Orlando
ZCTA5 32920,12,10387,52948,878,265300,9836,4558,9307,491,2552,3172,1970,1122,9101,5939,3162,5939,3517,2422,2020-01-01,zipcode,Cape canaveral
ZCTA5 32925,12,1642,51513,1639,-666666666,1215,461,861,56,125,332,205,143,508,487,21,487,0,487,2020-01-01,zipcode,Patrick afb
ZCTA5 32951,12,12150,68544,1385,364100,10923,6513,10497,393,1560,3280,3272,1992,7762,5928,1834,5928,5059,869,2020-01-01,zipcode,Melbourne beach
ZCTA5 32303,12,49073,52992,1078,157900,40291,10814,31624,1784,6128,10059,8468,5185,22864,20933,1931,20933,10716,10217,2020-01-01,zipcode,Tallahassee
ZCTA5 32327,12,29688,70660,916,172300,24278,10194,21446,2504,7613,7272,2450,1607,11413,10018,1395,10018,8474,1544,2020-01-01,zipcode,Crawfordville
ZCTA5 32343,12,3153,51397,939,162200,2206,441,1910,221,499,700,237,253,1275,1147,128,1147,909,238,2020-01-01,zipcode,Midway
ZCTA5 78376,48,447,50069,929,67900,351,176,334,96,116,101,19,2,398,181,217,181,135,46,2020-01-01,zipcode,Realitos
ZCTA5 78379,48,1285,61078,1146,71300,1120,516,907,153,254,254,119,127,759,499,260,499,432,67,2020-01-01,zipcode,Riviera
ZCTA5 78383,48,6079,61291,795,146500,4602,2184,4259,484,1202,1202,1091,280,2987,1980,1007,1980,1767,213,2020-01-01,zipcode,Sandia
ZCTA5 78389,48,1984,33375,865,51400,1732,840,1465,223,383,586,64,209,916,714,202,714,585,129,2020-01-01,zipcode,Skidmore
ZCTA5 78391,48,223,44833,-666666666,64400,142,44,114,36,28,43,7,0,87,62,25,62,40,22,2020-01-01,zipcode,Tynan
ZCTA5 78410,48,28210,74404,1071,165100,20190,7151,17367,2188,4903,7013,2362,901,10239,9377,862,9377,6268,3109,2020-01-01,zipcode,Corpus christi
ZCTA5 78414,48,44014,86369,1247,211600,33645,10386,28616,1527,5833,11900,5401,3955,17441,16261,1180,16261,10284,5977,2020-01-01,zipcode,Corpus christi
ZCTA5 78075,48,249,-666666666,-666666666,-666666666,196,70,145,26,73,19,27,0,121,121,0,121,91,30,2020-01-01,zipcode,Whitsett
ZCTA5 78117,48,512,34602,-666666666,287500,384,227,353,30,100,102,111,10,309,241,68,241,209,32,2020-01-01,zipcode,Hobson
ZCTA5 78121,48,12901,101649,1096,261500,10143,3529,8847,510,2711,3105,1721,800,4584,4207,377,4207,3870,337,2020-01-01,zipcode,La vernia
ZCTA5 78155,48,50832,58900,967,167900,40156,15776,34103,5804,13458,8631,4293,1917,19545,17693,1852,17693,12427,5266,2020-01-01,zipcode,Seguin
ZCTA5 78660,48,101937,93819,1381,254400,77338,18257,66757,5920,15646,20151,18388,6652,35385,33953,1432,33953,25252,8701,2020-01-01,zipcode,Pflugerville
ZCTA5 07070,34,18376,106817,1474,476200,15058,4949,12785,633,2844,2668,4095,2545,7033,6835,198,6835,4100,2735,2020-01-01,zipcode,Rutherford
ZCTA5 07072,34,6158,103720,1472,403200,5288,1678,4438,379,1773,762,949,575,2497,2318,179,2318,1535,783,2020-01-01,zipcode,Carlstadt
ZCTA5 07076,34,24118,139349,1665,536900,19037,5894,16792,629,2780,3131,5496,4756,8899,8584,315,8584,7212,1372,2020-01-01,zipcode,Scotch plains
ZCTA5 07440,34,4560,148185,1381,462400,3546,925,3123,90,716,726,988,603,1658,1583,75,1583,1377,206,2020-01-01,zipcode,Pequannock
ZCTA5 07442,34,10998,98348,1451,324700,9174,2258,8048,607,2717,1561,2350,813,4252,4216,36,4216,3047,1169,2020-01-01,zipcode,Pompton lakes
ZCTA5 07446,34,14870,155846,1733,605000,11549,3878,10126,323,1176,1478,4607,2542,5605,5346,259,5346,4699,647,2020-01-01,zipcode,Ramsey
ZCTA5 79706,48,27354,89162,1083,216000,18684,6004,15969,2141,4544,6217,2042,1025,9216,8603,613,8603,6797,1806,2020-01-01,zipcode,Midland
ZCTA5 79739,48,1278,74625,810,313500,1109,560,825,253,185,160,141,86,423,355,68,355,241,114,2020-01-01,zipcode,Garden city
ZCTA5 79766,48,7676,62344,842,147400,5428,2604,4656,2044,1603,824,185,0,2124,2069,55,2069,1616,453,2020-01-01,zipcode,Odessa
ZCTA5 79835,48,11171,41238,749,84200,8128,3791,6842,2296,1592,1732,728,494,4047,3559,488,3559,2603,956,2020-01-01,zipcode,Canutillo
ZCTA5 79848,48,835,43815,-666666666,72300,741,420,711,115,175,313,81,27,683,351,332,351,336,15,2020-01-01,zipcode,Sanderson
ZCTA5 79902,48,20752,36998,656,188200,17606,7389,14435,2937,2116,4270,3020,2092,9803,8561,1242,8561,3235,5326,2020-01-01,zipcode,El paso
ZCTA5 79904,48,33084,34778,854,95800,23674,9956,18999,4468,4971,6743,2004,813,12927,11461,1466,11461,4592,6869,2020-01-01,zipcode,El paso
ZCTA5 79847,48,90,-666666666,-666666666,-666666666,46,31,46,0,22,11,13,0,65,28,37,28,20,8,2020-01-01,zipcode,Salt flat
ZCTA5 79853,48,2282,50781,769,72600,1825,888,1424,695,348,253,117,11,747,667,80,667,614,53,2020-01-01,zipcode,Tornillo
ZCTA5 79908,48,6351,57986,1596,-666666666,4518,757,2569,63,488,1298,508,212,939,894,45,894,0,894,2020-01-01,zipcode,El paso
ZCTA5 79930,48,28091,36809,773,98100,22457,8317,17831,5302,3967,5448,2093,1021,12194,10496,1698,10496,4959,5537,2020-01-01,zipcode,El paso
ZCTA5 79003,48,202,76042,1278,94300,169,100,161,38,37,51,28,7,112,75,37,75,50,25,2020-01-01,zipcode,Allison
ZCTA5 79009,48,1734,47647,731,92800,1320,483,1047,302,382,258,74,31,642,538,104,538,316,222,2020-01-01,zipcode,Bovina
ZCTA5 79015,48,22914,70938,836,197400,18099,5312,13214,632,2575,4585,3612,1810,8531,7584,947,7584,5269,2315,2020-01-01,zipcode,Canyon
ZCTA5 79019,48,1890,69079,935,155100,1485,591,1289,118,313,537,215,106,845,692,153,692,572,120,2020-01-01,zipcode,Claude
ZCTA5 79024,48,393,78333,656,111800,316,95,269,19,106,69,49,26,193,148,45,148,108,40,2020-01-01,zipcode,Darrouzett
ZCTA5 79034,48,501,56250,718,96500,381,139,337,23,70,162,69,13,278,180,98,180,138,42,2020-01-01,zipcode,Follett
ZCTA5 79035,48,5166,63241,715,117100,4033,1353,3476,824,947,1086,429,190,2058,1850,208,1850,1252,598,2020-01-01,zipcode,Friona
ZCTA5 79056,48,60,65417,-666666666,77200,52,33,50,2,7,15,19,7,45,35,10,35,29,6,2020-01-01,zipcode,Lipscomb
ZCTA5 79064,48,2436,48182,608,73700,1809,775,1570,434,546,405,153,32,1012,820,192,820,583,237,2020-01-01,zipcode,Olton
ZCTA5 79070,48,9652,53176,815,102400,7062,2427,5575,1453,1870,1351,653,248,3963,3259,704,3259,2363,896,2020-01-01,zipcode,Perryton
ZCTA5 79078,48,175,38750,-666666666,-666666666,129,66,125,13,66,39,1,6,155,61,94,61,55,6,2020-01-01,zipcode,Sanford
ZCTA5 79088,48,5401,32869,549,82200,4335,2313,3627,994,1281,839,421,92,2195,1863,332,1863,1293,570,2020-01-01,zipcode,Tulia
ZCTA5 79093,48,101,-666666666,-666666666,-666666666,53,32,53,13,26,0,6,8,82,40,42,40,40,0,2020-01-01,zipcode,Waka
ZCTA5 79097,48,1001,100000,747,112300,775,269,662,63,195,271,73,60,428,376,52,376,329,47,2020-01-01,zipcode,White deer
ZCTA5 79007,48,13936,58283,817,82300,10862,3901,8984,1339,3072,2990,1178,405,6767,4661,2106,4661,3540,1121,2020-01-01,zipcode,Borger
ZCTA5 79025,48,26,-666666666,-666666666,-666666666,26,4,26,17,9,0,0,0,27,17,10,17,17,0,2020-01-01,zipcode,Dawn
ZCTA5 79027,48,4873,48597,751,85700,3683,1230,3037,721,1066,742,397,111,2111,1715,396,1715,852,863,2020-01-01,zipcode,Dimmitt
ZCTA5 79039,48,844,71071,936,135000,597,207,572,72,172,242,61,25,410,336,74,336,276,60,2020-01-01,zipcode,Groom
ZCTA5 79044,48,694,45321,1213,151700,514,274,385,104,142,64,28,47,363,289,74,289,147,142,2020-01-01,zipcode,Hartley
ZCTA5 79053,48,73,36250,-666666666,85000,61,12,48,4,7,29,8,0,40,21,19,21,11,10,2020-01-01,zipcode,Lazbuddie
ZCTA5 79084,48,2021,49286,694,94600,1561,507,1349,275,313,528,166,67,966,742,224,742,563,179,2020-01-01,zipcode,Stratford
ZCTA5 79101,48,2271,35313,774,75000,2126,1357,1872,298,754,412,282,126,1448,1166,282,1166,83,1083,2020-01-01,zipcode,Amarillo
ZCTA5 79107,48,34204,34674,798,68900,23716,9395,18997,7190,6741,3904,959,203,13158,11385,1773,11385,6598,4787,2020-01-01,zipcode,Amarillo
ZCTA5 79118,48,23668,74686,1072,174300,18486,5882,16000,1806,4504,6104,2796,790,8947,8089,858,8089,6701,1388,2020-01-01,zipcode,Amarillo
ZCTA5 79121,48,5684,75040,933,209600,4863,1881,4442,315,614,1616,1156,741,2858,2464,394,2464,1741,723,2020-01-01,zipcode,Amarillo
ZCTA5 79229,48,451,37411,-666666666,34000,366,203,327,64,100,130,21,12,291,183,108,183,170,13,2020-01-01,zipcode,Dickens
ZCTA5 79231,48,112,-666666666,-666666666,-666666666,65,30,65,0,30,35,0,0,35,35,0,35,0,35,2020-01-01,zipcode,Dougherty
ZCTA5 79250,48,1438,43438,546,60500,1187,501,1033,219,328,306,114,66,762,550,212,550,416,134,2020-01-01,zipcode,Petersburg
ZCTA5 79106,48,28289,43785,818,129200,21400,7555,17738,2746,4788,5874,2593,1737,13693,11960,1733,11960,5746,6214,2020-01-01,zipcode,Amarillo
ZCTA5 79230,48,156,53750,-666666666,-666666666,124,61,121,50,15,7,33,16,68,38,30,38,32,6,2020-01-01,zipcode,Dodson
ZCTA5 79233,48,130,30278,725,26700,97,19,82,12,26,27,17,0,85,62,23,62,36,26,2020-01-01,zipcode,Estelline
ZCTA5 79235,48,3335,51250,664,64400,2404,971,2149,584,589,663,218,95,1806,1338,468,1338,1017,321,2020-01-01,zipcode,Floydada
ZCTA5 79243,48,58,24167,-666666666,61400,58,51,58,6,29,19,4,0,37,22,15,22,16,6,2020-01-01,zipcode,Mcadoo
ZCTA5 79245,48,2339,41576,521,60900,1812,745,1592,312,550,487,162,81,1272,941,331,941,638,303,2020-01-01,zipcode,Memphis
ZCTA5 07603,34,8375,99107,1475,335400,6841,2104,5759,438,1605,1822,1077,817,2988,2883,105,2883,2092,791,2020-01-01,zipcode,Bogota
ZCTA5 07624,34,8551,143947,1956,689100,6636,2140,5661,259,1075,821,1985,1521,2750,2632,118,2632,2183,449,2020-01-01,zipcode,Closter
ZCTA5 07628,34,17598,107172,1353,383900,14968,4890,12782,840,3438,2674,3635,2195,6756,6558,198,6558,4804,1754,2020-01-01,zipcode,Dumont
ZCTA5 07001,34,17539,72203,1441,277900,14260,7011,13048,1222,5693,2916,1774,1443,5345,5145,200,5145,2435,2710,2020-01-01,zipcode,Avenel
ZCTA5 07016,34,24036,132539,1583,507600,19267,6084,16975,639,3205,3074,5736,4321,9381,9079,302,9079,7203,1876,2020-01-01,zipcode,Cranford
ZCTA5 07021,34,2022,215521,3250,861900,1486,529,1323,14,90,127,518,574,777,693,84,693,651,42,2020-01-01,zipcode,Essex fells
ZCTA5 07024,34,37843,88457,1909,348300,32287,12124,29699,1334,5302,5197,10201,7665,18768,17396,1372,17396,10102,7294,2020-01-01,zipcode,Fort lee
ZCTA5 07033,34,8182,95590,1644,356800,6196,1760,5368,542,1595,1620,1161,450,2892,2727,165,2727,1918,809,2020-01-01,zipcode,Kenilworth
ZCTA5 07034,34,9134,80370,1192,336800,7584,2273,6865,564,1685,1042,2605,969,3902,3750,152,3750,2240,1510,2020-01-01,zipcode,Lake hiawatha
ZCTA5 07046,34,4278,225069,1441,837300,3109,1138,2649,44,205,219,1049,1132,1439,1385,54,1385,1327,58,2020-01-01,zipcode,Mountain lakes
ZCTA5 07047,34,61181,66669,1433,375100,49633,15561,43264,7962,11982,10504,8196,4620,23650,21992,1658,21992,8916,13076,2020-01-01,zipcode,North bergen
ZCTA5 07074,34,2714,72000,1021,359100,2000,603,1823,201,705,446,305,166,899,836,63,836,589,247,2020-01-01,zipcode,Moonachie
ZCTA5 07110,34,28385,97955,1401,390600,23344,7031,20887,956,5672,4256,5948,4055,11582,11138,444,11138,7520,3618,2020-01-01,zipcode,Nutley
ZCTA5 07203,34,21699,65307,1192,230600,17476,5377,14413,1728,5130,4338,2171,1046,8147,7445,702,7445,4321,3124,2020-01-01,zipcode,Roselle
ZCTA5 07728,34,55598,93395,1650,398400,44373,15376,37878,3707,8983,8835,9688,6665,21369,20180,1189,20180,14826,5354,2020-01-01,zipcode,Freehold
ZCTA5 07646,34,16477,94821,1442,433000,12996,3838,11480,680,2578,2736,3774,1712,6119,5886,233,5886,3805,2081,2020-01-01,zipcode,New milford
ZCTA5 07663,34,13762,107511,1728,375800,11397,3578,10091,999,2821,2701,2489,1081,5431,5184,247,5184,3373,1811,2020-01-01,zipcode,Saddle brook
ZCTA5 07719,34,21289,95709,1464,487600,18049,6110,15716,879,3460,3892,5179,2306,10531,8742,1789,8742,6268,2474,2020-01-01,zipcode,Belmar
ZCTA5 07721,34,3337,103438,1448,292700,2657,525,2143,124,525,561,562,371,1337,1258,79,1258,750,508,2020-01-01,zipcode,Cliffwood
ZCTA5 07730,34,16664,104186,1016,356600,14140,4922,12447,757,4596,3018,2753,1323,6410,6260,150,6260,5585,675,2020-01-01,zipcode,Hazlet
ZCTA5 07735,34,18530,83466,1177,279200,15657,5140,14046,1083,4412,4538,2793,1220,8263,7567,696,7567,5688,1879,2020-01-01,zipcode,Keyport
ZCTA5 07747,34,31402,109489,1684,374900,25696,7787,23077,937,5562,5541,6986,4051,12683,12235,448,12235,9501,2734,2020-01-01,zipcode,Matawan
ZCTA5 07823,34,7981,66543,795,254900,7164,2994,6295,470,2270,1842,1107,606,3901,3704,197,3704,2425,1279,2020-01-01,zipcode,Belvidere
ZCTA5 07764,34,7911,102037,1467,454900,6658,2553,4861,502,1008,1107,1485,759,2970,2692,278,2692,1959,733,2020-01-01,zipcode,West long branch
ZCTA5 07803,34,3511,95516,1764,297300,2871,831,2462,177,590,660,836,199,1350,1269,81,1269,1122,147,2020-01-01,zipcode,Mine hill
ZCTA5 07821,34,8933,113352,1395,332800,7609,2480,6319,145,1349,1780,1964,1081,3913,3434,479,3434,3076,358,2020-01-01,zipcode,Andover
ZCTA5 07822,34,1002,84677,-666666666,378600,742,333,632,18,189,162,157,106,344,344,0,344,344,0,2020-01-01,zipcode,Augusta
ZCTA5 07825,34,9686,102823,1272,337500,8126,3326,6969,502,1959,1812,1986,710,3844,3420,424,3420,3053,367,2020-01-01,zipcode,Blairstown
ZCTA5 07833,34,111,51445,-666666666,215800,111,18,111,5,47,38,11,10,59,59,0,59,48,11,2020-01-01,zipcode,Delaware
ZCTA5 07846,34,43,86875,-666666666,233300,33,15,33,4,10,6,13,0,20,12,8,12,12,0,2020-01-01,zipcode,Johnsonburg
ZCTA5 07863,34,3767,83879,792,231000,3331,1236,2915,292,1281,705,434,203,1574,1482,92,1482,1286,196,2020-01-01,zipcode,Oxford
ZCTA5 07869,34,25391,145532,1509,549700,20431,6703,17117,762,1824,3109,5940,5482,9358,9024,334,9024,6863,2161,2020-01-01,zipcode,Randolph
ZCTA5 07878,34,550,95147,-666666666,330400,478,188,428,0,63,116,172,77,264,244,20,244,221,23,2020-01-01,zipcode,Mount tabor
ZCTA5 79733,48,449,78750,336,74100,316,59,311,17,131,129,21,13,105,105,0,105,53,52,2020-01-01,zipcode,Forsan
ZCTA5 79738,48,187,57396,-666666666,137500,143,88,125,5,39,23,50,8,96,59,37,59,43,16,2020-01-01,zipcode,Gail
ZCTA5 79855,48,2108,33958,577,62700,1603,587,1379,490,436,228,203,22,1007,655,352,655,431,224,2020-01-01,zipcode,Van horn
ZCTA5 79903,48,15422,29653,753,98100,12497,5610,10460,3003,2382,3472,1165,438,6656,5847,809,5847,3411,2436,2020-01-01,zipcode,El paso
ZCTA5 79912,48,79861,63307,967,194100,61618,20310,51011,4528,8495,13455,14259,10274,32351,28881,3470,28881,15807,13074,2020-01-01,zipcode,El paso
ZCTA5 79915,48,36797,29017,663,91200,28846,14070,23936,8330,6828,6015,2236,527,14186,12964,1222,12964,7531,5433,2020-01-01,zipcode,El paso
ZCTA5 79927,48,42221,38753,776,93700,32601,13086,26323,9203,8200,6934,1591,395,12767,12229,538,12229,9606,2623,2020-01-01,zipcode,El paso
ZCTA5 79932,48,28893,74821,901,184200,21448,7402,17851,2127,3345,5500,4426,2453,10282,9422,860,9422,6705,2717,2020-01-01,zipcode,El paso
ZCTA5 75230,48,27402,95119,1130,656600,23726,8188,21514,882,1610,4792,7877,6353,14972,13459,1513,13459,8110,5349,2020-01-01,zipcode,Dallas
ZCTA5 75236,48,16920,45625,995,153100,11837,3224,9501,2533,2459,2502,1337,670,6582,5869,713,5869,2185,3684,2020-01-01,zipcode,Dallas
ZCTA5 34240,12,12143,94046,2140,419200,9871,4393,8916,283,2121,2136,2408,1968,5939,4393,1546,4393,4285,108,2020-01-01,zipcode,Sarasota
ZCTA5 34743,12,45456,53902,1257,206600,37378,12529,31114,5261,9636,11015,3852,1350,13945,12257,1688,12257,8661,3596,2020-01-01,zipcode,Kissimmee
ZCTA5 34760,12,805,80536,1553,259500,666,222,620,22,126,372,92,8,289,255,34,255,216,39,2020-01-01,zipcode,Oakland
ZCTA5 34761,12,45749,72069,1348,256800,35257,10601,30384,5453,6985,8609,6589,2748,14826,14030,796,14030,9413,4617,2020-01-01,zipcode,Ocoee
ZCTA5 34950,12,17039,33839,918,96100,13582,6362,11583,3601,3703,3168,814,297,7259,5977,1282,5977,2132,3845,2020-01-01,zipcode,Fort pierce
ZCTA5 34983,12,44005,57495,1395,195100,35912,14259,31662,3036,10950,10372,5038,2266,16077,14674,1403,14674,11659,3015,2020-01-01,zipcode,Port saint lucie
ZCTA5 34994,12,17782,52527,1187,188300,14581,7265,13545,1121,3765,4644,2597,1418,9280,7445,1835,7445,4504,2941,2020-01-01,zipcode,Stuart
ZCTA5 34736,12,20564,62186,1290,225900,16594,6916,14906,2102,3934,4577,2517,1776,7916,7531,385,7531,6299,1232,2020-01-01,zipcode,Groveland
ZCTA5 34108,12,17177,98681,1520,744800,16061,10046,15389,570,2757,3371,4709,3982,14657,8196,6461,8196,6818,1378,2020-01-01,zipcode,Naples
ZCTA5 75010,48,30784,85777,1393,347700,25540,5597,22064,1160,3265,6025,8189,3425,13522,12411,1111,12411,5606,6805,2020-01-01,zipcode,Carrollton
ZCTA5 75023,48,50923,91916,1511,292800,41484,12485,36203,1942,4956,10096,13644,5565,19162,18497,665,18497,11671,6826,2020-01-01,zipcode,Plano
ZCTA5 75042,48,37458,53251,997,152000,27574,8787,22572,7585,5587,5936,2379,1085,11475,10909,566,10909,6248,4661,2020-01-01,zipcode,Garland
ZCTA5 75075,48,37310,79627,1350,292900,31514,10369,27184,1854,3910,8099,8696,4625,15749,14784,965,14784,9262,5522,2020-01-01,zipcode,Plano
ZCTA5 75114,48,6870,92679,1075,184300,4926,1432,4163,544,1524,1392,501,202,2107,1877,230,1877,1580,297,2020-01-01,zipcode,Crandall
ZCTA5 75135,48,7183,79426,1034,182600,5335,1900,4484,457,1516,1783,513,215,2329,2236,93,2236,1818,418,2020-01-01,zipcode,Caddo mills
ZCTA5 75143,48,14336,51913,892,117300,11474,5116,9847,1741,3573,2825,1196,512,7384,5340,2044,5340,4250,1090,2020-01-01,zipcode,Kemp
ZCTA5 75144,48,3414,53486,705,108300,2781,1261,2354,336,910,666,226,216,1604,1257,347,1257,902,355,2020-01-01,zipcode,Kerens
ZCTA5 75152,48,5194,71830,1308,125900,3820,1144,3090,463,1215,839,396,177,1868,1668,200,1668,1252,416,2020-01-01,zipcode,Palmer
ZCTA5 75163,48,2590,42500,922,78400,2214,1196,1995,529,562,699,142,63,1665,1178,487,1178,961,217,2020-01-01,zipcode,Trinidad
ZCTA5 75165,48,44571,73221,1113,209700,34619,12246,28686,3519,7775,10416,4619,2357,16472,15206,1266,15206,9700,5506,2020-01-01,zipcode,Waxahachie
ZCTA5 75173,48,4953,93854,1139,215700,3687,1207,3245,299,1332,1119,337,158,1721,1477,244,1477,1315,162,2020-01-01,zipcode,Nevada
ZCTA5 75182,48,6199,143295,-666666666,397800,4840,1559,4297,295,672,1104,1404,822,1931,1873,58,1873,1811,62,2020-01-01,zipcode,Sunnyvale
ZCTA5 75204,48,32032,81914,1538,378600,29735,4825,24764,1573,1748,4503,9624,7316,21702,18839,2863,18839,3576,15263,2020-01-01,zipcode,Dallas
ZCTA5 75216,48,54253,29448,913,78100,39873,19331,33942,10261,13525,7394,2035,727,21134,18827,2307,18827,9548,9279,2020-01-01,zipcode,Dallas
ZCTA5 75217,48,86811,41513,990,94600,59889,25664,46177,19404,15558,9036,1548,631,25231,23659,1572,23659,13993,9666,2020-01-01,zipcode,Dallas
ZCTA5 75220,48,41110,47003,910,296500,30832,8298,25311,11121,5428,3613,3210,1939,16102,14495,1607,14495,4381,10114,2020-01-01,zipcode,Dallas
ZCTA5 75224,48,37602,43912,927,147000,28130,10841,22321,8197,6770,4345,2137,872,12722,11879,843,11879,5860,6019,2020-01-01,zipcode,Dallas
ZCTA5 75238,48,33396,67789,1022,398200,24955,6898,21970,2573,3575,4890,6528,4404,14398,13292,1106,13292,6530,6762,2020-01-01,zipcode,Dallas
ZCTA5 75422,48,3084,53000,930,119200,2445,1149,2273,416,642,602,420,193,1364,1172,192,1172,920,252,2020-01-01,zipcode,Campbell
ZCTA5 75428,48,11474,40545,844,99300,9482,3773,5884,599,1793,1897,832,763,4311,3595,716,3595,1827,1768,2020-01-01,zipcode,Commerce
ZCTA5 75433,48,3115,66645,833,116000,2515,1132,2302,357,756,633,426,130,1342,1185,157,1185,926,259,2020-01-01,zipcode,Cumby
ZCTA5 75134,48,20759,52265,1127,151300,15310,4595,12933,1851,3775,4784,1723,800,7648,7328,320,7328,4731,2597,2020-01-01,zipcode,Lancaster
ZCTA5 75226,48,4774,53405,1301,81700,4250,1478,3788,1115,558,1038,764,313,2079,1960,119,1960,203,1757,2020-01-01,zipcode,Dallas
ZCTA5 75969,48,3522,71833,-666666666,123100,3135,1416,2855,587,985,752,340,191,1656,1378,278,1378,1239,139,2020-01-01,zipcode,Pollok
ZCTA5 75125,48,7664,70192,1025,114900,5659,2127,4836,1809,1132,1350,337,208,2555,2387,168,2387,1992,395,2020-01-01,zipcode,Ferris
ZCTA5 75094,48,23408,140257,2185,367900,16731,5156,14262,819,2275,3594,4153,3421,6372,6309,63,6309,5627,682,2020-01-01,zipcode,Plano
ZCTA5 75227,48,60632,46754,982,125300,43860,16536,35098,10336,11706,9092,2755,1209,20546,19059,1487,19059,10669,8390,2020-01-01,zipcode,Dallas
ZCTA5 75414,48,3394,70421,713,176400,2586,965,2283,168,619,969,397,130,1443,1264,179,1264,1051,213,2020-01-01,zipcode,Bells
ZCTA5 75440,48,7112,53191,656,135100,6028,3030,5546,1006,1936,1752,603,249,3243,2580,663,2580,2121,459,2020-01-01,zipcode,Emory
ZCTA5 75558,48,2216,67438,-666666666,67300,1849,844,1575,422,794,295,58,6,870,743,127,743,707,36,2020-01-01,zipcode,Cookville
ZCTA5 75751,48,17356,41240,839,115600,13437,6287,11066,1832,4017,3240,1104,873,6989,5840,1149,5840,3391,2449,2020-01-01,zipcode,Athens
ZCTA5 75929,48,1653,53472,428,156500,1412,785,1176,91,345,624,84,32,1579,743,836,743,546,197,2020-01-01,zipcode,Broaddus
ZCTA5 75148,48,6396,47712,796,128500,5212,2562,4639,589,1476,1743,612,219,3719,2655,1064,2655,1951,704,2020-01-01,zipcode,Malakoff
ZCTA5 75231,48,40987,42541,953,347700,31458,7362,26556,5303,6235,5952,6304,2762,20929,17849,3080,17849,3061,14788,2020-01-01,zipcode,Dallas
ZCTA5 75448,48,784,37760,-666666666,115000,590,331,517,23,255,195,37,7,265,258,7,258,248,10,2020-01-01,zipcode,Klondike
ZCTA5 75493,48,589,43750,633,50000,373,93,274,105,99,48,19,3,191,153,38,153,108,45,2020-01-01,zipcode,Winfield
ZCTA5 75640,48,5181,80958,786,178800,3760,1364,3248,347,1186,955,334,426,1963,1818,145,1818,1426,392,2020-01-01,zipcode,Diana
ZCTA5 75770,48,2552,56667,779,164200,2161,1270,1898,243,536,732,236,151,1412,1002,410,1002,866,136,2020-01-01,zipcode,Larue
ZCTA5 75762,48,13703,72338,1030,191800,10226,3648,8996,341,1872,2964,2132,1687,5901,4975,926,4975,4011,964,2020-01-01,zipcode,Flint
ZCTA5 75844,48,5632,41904,723,111100,4636,1919,4212,349,1477,1474,638,274,3593,2310,1283,2310,1747,563,2020-01-01,zipcode,Grapeland
ZCTA5 75959,48,859,55743,-666666666,129500,642,263,587,128,153,126,88,92,665,300,365,300,262,38,2020-01-01,zipcode,Milam
ZCTA5 75801,48,15808,41335,826,121000,12147,4341,10409,1169,4118,3226,1173,723,7091,6049,1042,6049,3639,2410,2020-01-01,zipcode,Palestine
ZCTA5 75783,48,8118,55377,780,123600,6576,3327,5894,905,1937,1798,659,595,3946,3160,786,3160,2653,507,2020-01-01,zipcode,Quitman
ZCTA5 75784,48,708,52250,838,114300,577,188,439,56,138,161,32,52,322,225,97,225,194,31,2020-01-01,zipcode,Reklaw
ZCTA5 75792,48,2861,47917,1035,109100,2345,919,2118,184,672,893,232,137,1192,953,239,953,775,178,2020-01-01,zipcode,Winona
ZCTA5 75846,48,2944,39851,695,143100,2143,998,1943,414,861,391,208,69,1959,1183,776,1183,935,248,2020-01-01,zipcode,Jewett
ZCTA5 75860,48,6351,56296,717,89500,5182,3098,4531,902,1607,1589,259,174,2467,1698,769,1698,1421,277,2020-01-01,zipcode,Teague
ZCTA5 32222,12,13933,67289,1235,214000,10941,2789,9656,705,2025,4884,1727,315,5488,4725,763,4725,3662,1063,2020-01-01,zipcode,Jacksonville
ZCTA5 32223,12,24615,83782,1229,275600,20675,7759,18299,719,3725,6726,4341,2788,10287,9979,308,9979,8378,1601,2020-01-01,zipcode,Jacksonville
ZCTA5 32227,12,3599,69984,1728,-666666666,2684,265,1079,27,310,557,124,61,593,481,112,481,0,481,2020-01-01,zipcode,Jacksonville
ZCTA5 79782,48,4304,67050,-666666666,119800,2979,897,2440,562,839,565,259,215,1526,1324,202,1324,889,435,2020-01-01,zipcode,Stanton
ZCTA5 77011,48,18296,36751,691,113100,14566,5673,12333,5551,3118,2376,1008,280,7179,6225,954,6225,3131,3094,2020-01-01,zipcode,Houston
ZCTA5 77012,48,18640,37823,769,88700,13589,5783,11210,5048,3518,1693,704,247,6836,5816,1020,5816,2230,3586,2020-01-01,zipcode,Houston
ZCTA5 77013,48,19548,36647,958,99500,15096,6819,11907,4432,3516,2849,939,171,6968,6169,799,6169,2601,3568,2020-01-01,zipcode,Houston
ZCTA5 77449,48,123157,76481,1512,174600,88792,22062,75199,10690,18023,25172,15619,5695,38659,37436,1223,37436,25930,11506,2020-01-01,zipcode,Katy
ZCTA5 77450,48,75752,93930,1419,272300,57204,19145,48836,2512,7254,13641,15780,9649,26961,25619,1342,25619,17879,7740,2020-01-01,zipcode,Katy
ZCTA5 77456,48,1116,43790,775,131500,870,436,706,138,291,164,113,0,543,390,153,390,339,51,2020-01-01,zipcode,Markham
ZCTA5 77459,48,76662,118130,1860,296900,58418,18825,49328,2675,6641,12321,15955,11736,24781,23823,958,23823,20423,3400,2020-01-01,zipcode,Missouri city
ZCTA5 77476,48,402,36161,-666666666,-666666666,238,131,182,35,88,32,14,13,110,84,26,84,66,18,2020-01-01,zipcode,Simonton
ZCTA5 07720,34,4175,78452,1427,665900,3662,1269,3457,446,527,476,1071,937,2824,1934,890,1934,874,1060,2020-01-01,zipcode,Bradley beach
ZCTA5 07801,34,25174,70287,1523,284500,19772,5256,17473,3693,5531,4504,2532,1213,8945,8472,473,8472,3993,4479,2020-01-01,zipcode,Dover
ZCTA5 07028,34,7716,210068,1725,648600,5570,1485,4692,32,298,645,2046,1671,2488,2441,47,2441,2271,170,2020-01-01,zipcode,Glen ridge
ZCTA5 07204,34,13574,80842,1299,295800,11045,2897,9667,1196,2453,2347,2406,1265,5150,5042,108,5042,2822,2220,2020-01-01,zipcode,Roselle park
ZCTA5 07480,34,15377,95714,1565,292400,12684,4377,11170,367,2594,3628,2695,1886,6453,6018,435,6018,5431,587,2020-01-01,zipcode,West milford
ZCTA5 07643,34,10761,69224,1408,363900,9249,2828,8043,1008,1994,2191,1910,940,4451,4106,345,4106,1601,2505,2020-01-01,zipcode,Little ferry
ZCTA5 07702,34,4082,142870,2940,610300,3111,1282,2693,63,449,433,1013,735,1382,1374,8,1374,1269,105,2020-01-01,zipcode,Shrewsbury
ZCTA5 07928,34,18626,201123,2005,857300,13679,4799,11890,245,976,1204,4765,4700,6701,6304,397,6304,5329,975,2020-01-01,zipcode,Chatham
ZCTA5 07980,34,2607,124590,1509,573800,2052,732,1861,49,345,380,538,549,963,899,64,899,637,262,2020-01-01,zipcode,Stirling
ZCTA5 07417,34,11044,178794,2730,1009800,8776,3430,7378,18,790,1129,2943,2498,4024,3839,185,3839,3429,410,2020-01-01,zipcode,Franklin lakes
ZCTA5 07458,34,11439,197898,2303,1106500,9180,3217,7640,187,891,1373,2735,2454,4044,3867,177,3867,3387,480,2020-01-01,zipcode,Saddle river
ZCTA5 07704,34,5833,184201,3501,772200,4059,1313,3487,91,248,533,1596,1019,1937,1887,50,1887,1775,112,2020-01-01,zipcode,Fair haven
ZCTA5 07843,34,11389,94836,1491,242600,9569,2221,8464,328,3194,2368,1720,854,5109,4341,768,4341,3692,649,2020-01-01,zipcode,Hopatcong
ZCTA5 07069,34,6186,138808,2085,713900,5049,2035,4636,63,834,951,1378,1410,2304,2117,187,2117,1789,328,2020-01-01,zipcode,Watchung
ZCTA5 07086,34,14756,100328,1825,714700,12575,2904,11883,1001,2036,1519,4073,3254,7731,6905,826,6905,2209,4696,2020-01-01,zipcode,Weehawken
ZCTA5 07311,34,675,210625,3208,-666666666,524,34,524,0,0,18,84,422,314,301,13,301,0,301,2020-01-01,zipcode,Jersey city
ZCTA5 07495,34,0,-666666666,-666666666,-666666666,0,0,0,0,0,0,0,0,0,0,0,0,0,0,2020-01-01,zipcode,Mahwah
ZCTA5 07676,34,9136,141000,1412,540800,7359,2609,6667,208,1214,1200,2805,1240,3446,3334,112,3334,3191,143,2020-01-01,zipcode,Township of washington
ZCTA5 07677,34,5836,197632,1980,840100,4616,1632,3787,18,672,335,1631,1131,1966,1890,76,1890,1724,166,2020-01-01,zipcode,Woodcliff lake
ZCTA5 07820,34,7,-666666666,-666666666,-666666666,7,0,7,4,1,0,2,0,0,0,0,0,0,0,2020-01-01,zipcode,Allamuchy
ZCTA5 07870,34,23,-666666666,-666666666,-666666666,23,15,15,0,0,0,0,15,8,8,0,8,8,0,2020-01-01,zipcode,Schooleys mountain
ZCTA5 07880,34,215,123462,-666666666,131800,215,74,145,37,26,44,16,22,64,64,0,64,64,0,2020-01-01,zipcode,Vienna
ZCTA5 07881,34,8,-666666666,-666666666,-666666666,8,4,8,0,0,8,0,0,13,4,9,4,4,0,2020-01-01,zipcode,
ZCTA5 07926,34,54,-666666666,-666666666,-666666666,33,0,33,0,0,13,20,0,20,20,0,20,9,11,2020-01-01,zipcode,Brookside
ZCTA5 78703,48,20297,108065,1583,980500,17001,4180,15775,213,508,1740,6890,6424,10728,9478,1250,9478,5343,4135,2020-01-01,zipcode,Austin
ZCTA5 78721,48,11054,55359,1319,321900,9343,2755,8014,1738,1716,1379,2240,941,4373,4027,346,4027,2119,1908,2020-01-01,zipcode,Austin
ZCTA5 78726,48,13304,88750,1378,468900,10583,2967,8989,59,626,2051,3934,2319,6083,5604,479,5604,2476,3128,2020-01-01,zipcode,Austin
ZCTA5 78702,48,25393,72906,1327,449400,21480,6105,19349,2629,2898,4057,6163,3602,11769,10513,1256,10513,4262,6251,2020-01-01,zipcode,Austin
ZCTA5 78745,48,63287,68669,1373,307700,53756,13401,48874,4545,8546,13356,15528,6899,29410,27994,1416,27994,13565,14429,2020-01-01,zipcode,Austin
ZCTA5 78946,48,1298,54440,938,123000,1215,423,1073,132,446,391,79,25,711,499,212,499,360,139,2020-01-01,zipcode,Ledbetter
ZCTA5 78374,48,17972,76398,1392,177400,13646,4904,11587,836,3199,4338,2122,1092,7314,6201,1113,6201,4222,1979,2020-01-01,zipcode,Portland
ZCTA5 79255,48,480,42250,579,106500,400,199,324,35,124,71,83,11,398,209,189,209,139,70,2020-01-01,zipcode,Quitaque
ZCTA5 79313,48,1505,40455,617,58200,1146,487,1018,306,304,288,76,44,703,550,153,550,399,151,2020-01-01,zipcode,Anton
ZCTA5 79314,48,109,21339,-666666666,-666666666,51,29,51,17,17,15,0,2,56,35,21,35,14,21,2020-01-01,zipcode,Bledsoe
ZCTA5 79343,48,1695,53158,613,86800,1320,453,1073,222,342,299,176,34,666,558,108,558,394,164,2020-01-01,zipcode,Lorenzo
ZCTA5 79364,48,7161,46124,808,81500,5443,2171,4825,585,1722,1732,554,232,3089,2614,475,2614,1807,807,2020-01-01,zipcode,Slaton
ZCTA5 79372,48,1488,52321,547,81300,1186,504,965,217,355,240,84,69,578,499,79,499,413,86,2020-01-01,zipcode,Sundown
ZCTA5 79373,48,2985,35943,838,84100,2287,900,1977,435,616,502,291,133,1361,1125,236,1125,723,402,2020-01-01,zipcode,Tahoka
ZCTA5 79401,48,9084,17951,1026,97000,8605,4117,3645,677,1250,920,422,376,4624,3614,1010,3614,370,3244,2020-01-01,zipcode,Lubbock
ZCTA5 79406,48,7288,-666666666,-666666666,-666666666,7288,5192,47,0,0,9,38,0,0,0,0,0,0,0,2020-01-01,zipcode,Lubbock
ZCTA5 79535,48,188,55625,-666666666,57000,176,113,150,10,49,76,10,5,112,92,20,92,86,6,2020-01-01,zipcode,Maryneal
ZCTA5 79537,48,24,-666666666,-666666666,-666666666,24,23,24,0,23,0,1,0,40,13,27,13,12,1,2020-01-01,zipcode,Nolan
ZCTA5 79544,48,475,39167,645,33400,382,169,295,69,94,100,30,2,269,174,95,174,120,54,2020-01-01,zipcode,Rochester
ZCTA5 79602,48,26033,69651,964,173800,19865,6571,17079,1577,4423,5432,3380,2267,9877,8798,1079,8798,6469,2329,2020-01-01,zipcode,Abilene
ZCTA5 79713,48,725,63750,525,162000,571,279,458,90,88,144,77,59,266,234,32,234,174,60,2020-01-01,zipcode,Ackerly
ZCTA5 78009,48,7632,59176,1051,172600,6056,2343,4952,791,1222,1844,614,481,2857,2511,346,2511,2025,486,2020-01-01,zipcode,Castroville
ZCTA5 78066,48,937,72679,-666666666,177700,530,349,530,0,169,93,170,98,320,264,56,264,249,15,2020-01-01,zipcode,Rio medina
ZCTA5 78595,48,7442,34727,501,59600,4928,1833,3691,1816,786,916,127,46,2207,1974,233,1974,1714,260,2020-01-01,zipcode,Sullivan city
ZCTA5 78672,48,960,47120,-666666666,132100,894,559,849,147,204,400,70,28,922,497,425,497,483,14,2020-01-01,zipcode,Tow
ZCTA5 78109,48,39424,68689,1320,166600,28731,9345,23887,2160,5981,9314,4291,2141,12545,11936,609,11936,8763,3173,2020-01-01,zipcode,Converse
ZCTA5 78029,48,0,-666666666,-666666666,-666666666,0,0,0,0,0,0,0,0,0,0,0,0,0,0,2020-01-01,zipcode,Kerrville
ZCTA5 78044,48,600,34886,636,-666666666,482,289,438,211,167,26,23,11,374,196,178,196,131,65,2020-01-01,zipcode,Laredo
ZCTA5 78060,48,0,-666666666,-666666666,-666666666,0,0,0,0,0,0,0,0,30,0,30,0,0,0,2020-01-01,zipcode,Oakville
ZCTA5 78104,48,176,69063,-666666666,-666666666,146,55,105,0,24,73,3,5,83,60,23,60,39,21,2020-01-01,zipcode,Beeville
ZCTA5 78150,48,41,-666666666,-666666666,-666666666,41,0,11,0,0,11,0,0,0,0,0,0,0,0,2020-01-01,zipcode,Jbsa randolph
ZCTA5 78162,48,393,38913,-666666666,118800,354,213,212,71,26,84,28,3,199,130,69,130,81,49,2020-01-01,zipcode,Tuleta
ZCTA5 78243,48,419,-666666666,-666666666,-666666666,419,0,113,0,0,113,0,0,0,0,0,0,0,0,2020-01-01,zipcode,San antonio
ZCTA5 78335,48,0,-666666666,-666666666,-666666666,0,0,0,0,0,0,0,0,0,0,0,0,0,0,2020-01-01,zipcode,Aransas pass
ZCTA5 78341,48,2318,54674,765,62800,1696,834,1287,233,336,532,120,66,1203,686,517,686,486,200,2020-01-01,zipcode,Benavides
ZCTA5 78342,48,342,42824,842,-666666666,227,85,186,52,46,88,0,0,96,89,7,89,50,39,2020-01-01,zipcode,Ben bolt
ZCTA5 78419,48,861,73667,1750,-666666666,613,98,417,10,59,157,150,41,236,210,26,210,0,210,2020-01-01,zipcode,Corpus christi
ZCTA5 78535,48,732,55469,675,63100,608,247,443,121,182,103,16,21,291,236,55,236,163,73,2020-01-01,zipcode,Combes
ZCTA5 78063,48,9462,63199,1272,209300,8598,3842,7512,746,2056,2857,1274,579,5038,3875,1163,3875,3561,314,2020-01-01,zipcode,Pipe creek
ZCTA5 78057,48,520,-666666666,-666666666,597200,520,345,446,107,39,262,0,38,503,258,245,258,258,0,2020-01-01,zipcode,Moore
ZCTA5 78058,48,763,98160,630,316700,664,325,587,113,75,134,139,126,604,327,277,327,276,51,2020-01-01,zipcode,Mountain home
ZCTA5 78113,48,3253,71908,940,189200,2465,871,2045,205,860,491,428,61,1364,1218,146,1218,1001,217,2020-01-01,zipcode,Falls city
ZCTA5 78122,48,427,61659,-666666666,213600,370,143,362,154,143,19,8,38,251,223,28,223,176,47,2020-01-01,zipcode,Leesville
ZCTA5 78123,48,2801,80341,920,173200,2136,664,1888,157,856,501,223,151,1438,1035,403,1035,859,176,2020-01-01,zipcode,Mc queeney
ZCTA5 78125,48,39,-666666666,-666666666,43800,37,27,37,4,6,15,3,9,53,27,26,27,27,0,2020-01-01,zipcode,Mineral
ZCTA5 78141,48,767,42679,775,61200,673,420,616,90,267,185,63,11,473,321,152,321,273,48,2020-01-01,zipcode,Nordheim
ZCTA5 78143,48,199,-666666666,-666666666,120800,158,78,146,13,35,12,86,0,42,42,0,42,42,0,2020-01-01,zipcode,Pandora
ZCTA5 78144,48,14,-666666666,-666666666,-666666666,14,14,14,0,14,0,0,0,14,14,0,14,0,14,2020-01-01,zipcode,Panna maria
ZCTA5 78163,48,13937,103777,1146,352800,11324,4969,10127,361,2245,3111,2985,1425,5158,4893,265,4893,4578,315,2020-01-01,zipcode,Bulverde
ZCTA5 78205,48,1503,33411,826,377900,1429,716,1266,236,173,255,302,300,1708,1127,581,1127,113,1014,2020-01-01,zipcode,San antonio
ZCTA5 78208,48,4549,18855,740,93200,3393,1760,2893,943,1045,687,124,94,2134,1789,345,1789,623,1166,2020-01-01,zipcode,San antonio
ZCTA5 78209,48,44706,75484,1195,394800,36142,11882,30044,978,3524,6883,9910,8749,21436,18787,2649,18787,9714,9073,2020-01-01,zipcode,San antonio
ZCTA5 78216,48,45325,48496,994,200600,36963,11539,30717,3451,5990,10291,6713,4272,21140,18652,2488,18652,6970,11682,2020-01-01,zipcode,San antonio
ZCTA5 34471,12,24635,51334,991,195900,20247,8320,17055,985,5395,5067,3017,2591,11432,10279,1153,10279,6149,4130,2020-01-01,zipcode,Ocala
ZCTA5 34475,12,13291,24202,732,94200,10325,5904,8933,1959,3481,2398,804,291,5360,4770,590,4770,1967,2803,2020-01-01,zipcode,Ocala
ZCTA5 34479,12,13887,42880,980,119300,11001,4760,9403,1357,3740,2759,1114,433,5849,5280,569,5280,3302,1978,2020-01-01,zipcode,Ocala
ZCTA5 34480,12,21173,58189,855,196800,16735,6603,14213,1444,4900,4330,2306,1233,8994,7864,1130,7864,5795,2069,2020-01-01,zipcode,Ocala
ZCTA5 34655,12,44192,71199,1320,251000,36572,15895,32629,2026,8905,10984,6905,3809,20359,17882,2477,17882,14476,3406,2020-01-01,zipcode,New port richey
ZCTA5 34677,12,22703,69861,1176,255700,19113,7401,16754,992,4382,5041,3982,2357,9734,8566,1168,8566,6373,2193,2020-01-01,zipcode,Oldsmar
ZCTA5 34711,12,61189,75015,1434,259600,49078,19678,42845,3111,10674,14783,8806,5471,23807,21279,2528,21279,16595,4684,2020-01-01,zipcode,Clermont
ZCTA5 34756,12,3641,86607,1140,320200,2837,1149,2334,170,529,976,433,226,1279,1167,112,1167,972,195,2020-01-01,zipcode,Montverde
ZCTA5 34762,12,435,73021,-666666666,151500,417,262,408,104,163,94,29,18,317,187,130,187,187,0,2020-01-01,zipcode,Okahumpka
ZCTA5 34769,12,25524,47805,1077,178600,19628,7802,16326,2404,5837,5137,2023,925,10849,8603,2246,8603,5642,2961,2020-01-01,zipcode,Saint cloud
ZCTA5 34117,12,20129,74346,1451,316800,16508,5380,13998,1955,4624,4611,1990,818,5766,5396,370,5396,4591,805,2020-01-01,zipcode,Naples
ZCTA5 34138,12,1136,81287,-666666666,-666666666,805,404,805,0,354,383,68,0,700,367,333,367,306,61,2020-01-01,zipcode,Chokoloskee
ZCTA5 34139,12,247,49750,725,215000,194,47,194,9,35,56,50,44,507,122,385,122,107,15,2020-01-01,zipcode,Everglades city
ZCTA5 34217,12,5178,62159,1220,575600,4848,3024,4722,82,695,1486,1320,1139,6632,2875,3757,2875,2366,509,2020-01-01,zipcode,Bradenton beach
ZCTA5 34219,12,23970,85477,1718,292300,19869,8594,17960,629,4937,6063,4411,1920,9838,8600,1238,8600,7731,869,2020-01-01,zipcode,Parrish
ZCTA5 34228,12,7299,108015,2208,724600,7230,5805,7130,189,726,1550,2221,2444,9174,3939,5235,3939,3741,198,2020-01-01,zipcode,Longboat key
ZCTA5 34232,12,35486,69075,1464,237000,30006,10590,26787,2232,8923,7955,5089,2588,16061,14386,1675,14386,9944,4442,2020-01-01,zipcode,Sarasota
ZCTA5 34243,12,31700,64853,1628,289200,27574,12878,24512,1342,5640,7790,5625,4115,15397,12873,2524,12873,9878,2995,2020-01-01,zipcode,Sarasota
ZCTA5 34285,12,18117,56234,1183,250200,17390,11543,16491,601,5083,4455,3397,2955,15313,9832,5481,9832,7786,2046,2020-01-01,zipcode,Venice
ZCTA5 34293,12,43988,70357,1382,265900,39621,21994,37397,2146,9795,11654,7846,5956,25303,20250,5053,20250,17857,2393,2020-01-01,zipcode,Venice
ZCTA5 34436,12,8189,44164,707,123300,7233,4112,6699,886,2508,2350,449,506,4947,3821,1126,3821,3190,631,2020-01-01,zipcode,Floral city
ZCTA5 34488,12,11472,34964,865,55800,9250,4396,7901,1107,3177,2228,1147,242,6172,4680,1492,4680,3370,1310,2020-01-01,zipcode,Silver springs
ZCTA5 34498,12,570,37734,1000,167500,433,274,383,27,170,117,44,25,501,249,252,249,181,68,2020-01-01,zipcode,Yankeetown
ZCTA5 34610,12,15679,54078,1020,170400,12596,5259,11012,1929,3533,3423,1715,412,5835,5216,619,5216,4171,1045,2020-01-01,zipcode,Spring hill
ZCTA5 34685,12,17549,77020,1375,359700,14994,7063,13642,608,3078,4179,3641,2136,7852,7282,570,7282,5664,1618,2020-01-01,zipcode,Palm harbor
ZCTA5 34731,12,16508,54005,967,187600,14358,7782,13173,1078,4888,4031,1725,1451,8451,6983,1468,6983,5774,1209,2020-01-01,zipcode,Fruitland park
ZCTA5 34797,12,1455,88989,-666666666,271000,1307,876,1255,0,484,418,226,127,793,602,191,602,579,23,2020-01-01,zipcode,Yalaha
ZCTA5 34952,12,43317,47419,1279,163000,36812,16605,33334,3285,12454,11503,4402,1690,21620,17668,3952,17668,12229,5439,2020-01-01,zipcode,Port saint lucie
ZCTA5 34981,12,5626,54692,1193,257500,4516,1696,3985,327,1721,908,659,370,1908,1621,287,1621,1038,583,2020-01-01,zipcode,Fort pierce
ZCTA5 34986,12,28354,66782,1660,275100,24526,13787,22060,2191,5461,6979,4485,2944,13669,11932,1737,11932,9672,2260,2020-01-01,zipcode,Port saint lucie
ZCTA5 34251,12,7586,73119,860,363400,6025,2295,4852,429,2019,1652,550,202,2374,2151,223,2151,1993,158,2020-01-01,zipcode,Myakka city
ZCTA5 34275,12,20475,67063,1294,318600,18445,10595,16642,799,4664,4666,3676,2837,11416,9529,1887,9529,7851,1678,2020-01-01,zipcode,Nokomis
ZCTA5 34453,12,10236,38624,847,108300,8512,4989,7863,1382,2981,2359,779,362,5424,4282,1142,4282,3597,685,2020-01-01,zipcode,Inverness
ZCTA5 34608,12,36327,50786,1059,151300,29610,14135,26274,3083,9135,9518,3212,1326,15362,14076,1286,14076,10434,3642,2020-01-01,zipcode,Spring hill
ZCTA5 34109,12,26562,76144,1476,415800,22745,12029,21020,808,5251,5491,5762,3708,15138,11515,3623,11515,8012,3503,2020-01-01,zipcode,Naples
ZCTA5 34953,12,72636,63483,1568,227900,56562,18923,47802,5669,15456,17068,6832,2777,24815,23064,1751,23064,19279,3785,2020-01-01,zipcode,Port saint lucie
ZCTA5 34222,12,12466,57047,1108,120200,10671,5284,9589,948,3175,3806,1090,570,7399,5286,2113,5286,4264,1022,2020-01-01,zipcode,Ellenton
ZCTA5 34224,12,16369,43863,950,174200,15094,9162,13766,1146,5196,4265,1929,1230,10913,7631,3282,7631,5994,1637,2020-01-01,zipcode,Englewood
ZCTA5 34229,12,7934,88542,-666666666,509200,6941,4258,6575,204,1131,1083,2082,2075,4643,3487,1156,3487,3011,476,2020-01-01,zipcode,Osprey
ZCTA5 34231,12,32762,56096,1245,278800,28040,12445,25904,1789,7103,8287,5233,3492,18991,15116,3875,15116,9861,5255,2020-01-01,zipcode,Sarasota
ZCTA5 34238,12,20095,78912,1684,385300,18542,11360,17663,349,3450,4429,4449,4986,13048,10385,2663,10385,8173,2212,2020-01-01,zipcode,Sarasota
ZCTA5 34268,12,366,23077,-666666666,-666666666,332,258,243,120,123,0,0,0,143,114,29,114,72,42,2020-01-01,zipcode,Nocatee
ZCTA5 34286,12,19700,61246,1595,198500,16365,7344,13995,2083,4614,3962,2068,1268,7730,6801,929,6801,5859,942,2020-01-01,zipcode,North port
ZCTA5 34428,12,9334,43417,679,198200,7879,3787,7109,636,2701,2480,780,512,5169,4057,1112,4057,3002,1055,2020-01-01,zipcode,Crystal river
ZCTA5 34442,12,15479,46275,808,178100,14175,9571,13325,1032,4730,3972,1843,1748,9438,7327,2111,7327,6448,879,2020-01-01,zipcode,Hernando
ZCTA5 34473,12,21424,57524,1062,161300,17053,7146,15098,1398,6028,5096,2037,539,8104,7158,946,7158,5767,1391,2020-01-01,zipcode,Ocala
ZCTA5 34668,12,48452,37262,1022,102100,39590,19418,34471,4455,14631,10488,3498,1399,23128,20119,3009,20119,11948,8171,2020-01-01,zipcode,Port richey
ZCTA5 34683,12,33699,70375,1277,293500,28677,10940,25631,1755,6317,8468,5921,3170,15280,13380,1900,13380,10301,3079,2020-01-01,zipcode,Palm harbor
ZCTA5 34690,12,11367,36809,1053,83000,9712,4776,8729,1026,4178,2489,746,290,6630,5168,1462,5168,3354,1814,2020-01-01,zipcode,Holiday
ZCTA5 34758,12,44155,55733,1292,186800,33679,10763,27618,3619,10377,8761,2870,1991,14329,11315,3014,11315,8409,2906,2020-01-01,zipcode,Kissimmee
ZCTA5 34946,12,6292,36383,760,103600,5456,2648,4720,1174,1615,1292,450,189,3185,2565,620,2565,1692,873,2020-01-01,zipcode,Fort pierce
ZCTA5 34957,12,22900,55982,1098,274200,20462,11369,18641,1267,4931,5993,4008,2442,17364,10713,6651,10713,7892,2821,2020-01-01,zipcode,Jensen beach
ZCTA5 34990,12,30138,99219,1720,405500,25352,11916,22712,1025,4135,7281,6542,3729,13687,11834,1853,11834,10556,1278,2020-01-01,zipcode,Palm city
ZCTA5 34613,12,17760,46955,959,116700,15817,10210,14996,1791,5279,5215,1856,855,10264,8451,1813,8451,7309,1142,2020-01-01,zipcode,Brooksville
ZCTA5 34614,12,7710,63596,639,184100,6297,2759,5270,667,1509,2066,464,564,2973,2642,331,2642,2488,154,2020-01-01,zipcode,Brooksville
ZCTA5 34639,12,29728,88723,1446,263400,23512,8083,20589,1062,5553,6282,5277,2415,10617,10195,422,10195,8446,1749,2020-01-01,zipcode,Land o lakes
ZCTA5 34654,12,25182,51036,1139,178300,21697,11536,19279,2626,7220,5902,2254,1277,10323,8980,1343,8980,6970,2010,2020-01-01,zipcode,New port richey
ZCTA5 34746,12,46725,58635,1404,224800,37715,14026,32273,4923,8803,10111,5701,2735,23986,14223,9763,14223,10061,4162,2020-01-01,zipcode,Kissimmee
ZCTA5 34786,12,46044,103163,1879,449000,34590,10208,30723,950,3171,8842,11372,6388,17238,14966,2272,14966,10677,4289,2020-01-01,zipcode,Windermere
ZCTA5 34947,12,13399,31398,951,139800,10056,4096,8345,2155,2757,2301,527,605,4753,4057,696,4057,1481,2576,2020-01-01,zipcode,Fort pierce
ZCTA5 76632,48,1400,45093,1090,102200,1136,529,1021,256,282,348,94,41,712,512,200,512,410,102,2020-01-01,zipcode,Chilton
ZCTA5 76633,48,5334,102770,917,236000,4023,1534,3617,188,982,1267,668,512,1797,1746,51,1746,1621,125,2020-01-01,zipcode,China spring
ZCTA5 76636,48,1509,82782,663,181500,1241,466,1075,199,368,329,156,23,666,577,89,577,513,64,2020-01-01,zipcode,Covington
ZCTA5 35183,01,663,58317,-666666666,96700,561,236,526,117,263,122,24,0,353,239,114,239,178,61,2020-01-01,zipcode,Weogufka
ZCTA5 35210,01,13955,60318,912,158200,11572,4313,10505,939,2900,2803,2684,1179,6804,6025,779,6025,4032,1993,2020-01-01,zipcode,Birmingham
ZCTA5 32935,12,42463,53207,1086,171400,35420,13275,31312,2588,9803,10988,5555,2378,19209,16797,2412,16797,9926,6871,2020-01-01,zipcode,Melbourne
ZCTA5 32976,12,9109,40992,821,108100,8950,6209,8658,475,3278,3536,982,387,6972,5165,1807,5165,4910,255,2020-01-01,zipcode,Sebastian
ZCTA5 32694,12,2118,32125,555,111300,1814,641,1552,176,761,363,159,93,1289,1082,207,1082,763,319,2020-01-01,zipcode,Waldo
ZCTA5 32754,12,11398,53338,931,199200,9625,4967,8581,917,3195,3023,1027,419,5675,4402,1273,4402,3897,505,2020-01-01,zipcode,Mims
ZCTA5 32801,12,12945,66350,1400,348000,12106,3236,11408,735,1544,1819,4499,2811,10210,7967,2243,7967,2057,5910,2020-01-01,zipcode,Orlando
ZCTA5 32803,12,20771,82111,1410,302300,18436,3991,16978,663,2458,4132,6172,3553,11305,9764,1541,9764,5287,4477,2020-01-01,zipcode,Orlando
ZCTA5 32811,12,39905,40594,1168,111300,31626,9130,26531,3601,7501,8854,4486,2089,17832,14402,3430,14402,3753,10649,2020-01-01,zipcode,Orlando
ZCTA5 07981,34,8839,120870,1816,519300,7350,2320,6523,240,1616,1326,1991,1350,3749,3701,48,3701,3224,477,2020-01-01,zipcode,Whippany
ZCTA5 07865,34,2227,133490,-666666666,323800,1479,379,1314,58,293,393,381,189,753,651,102,651,567,84,2020-01-01,zipcode,Port murray
ZCTA5 76865,48,216,-666666666,-666666666,95500,216,94,204,37,91,70,0,6,138,85,53,85,81,4,2020-01-01,zipcode,Norton
ZCTA5 76877,48,4225,39072,779,116400,3522,1771,2969,612,1123,754,400,80,2097,1539,558,1539,1099,440,2020-01-01,zipcode,San saba
ZCTA5 76945,48,1762,41207,504,67000,1457,669,1351,219,404,326,259,143,1432,876,556,876,590,286,2020-01-01,zipcode,Robert lee
ZCTA5 76951,48,1274,53194,773,75000,904,303,762,83,371,168,83,57,568,405,163,405,354,51,2020-01-01,zipcode,Sterling city
ZCTA5 76656,48,2656,71779,700,108100,2092,671,1740,184,562,630,267,97,1086,825,261,825,682,143,2020-01-01,zipcode,Lott
ZCTA5 76681,48,732,50652,978,105900,571,219,471,86,180,145,54,6,443,272,171,272,209,63,2020-01-01,zipcode,Richland
ZCTA5 76661,48,7824,26359,508,47700,6582,4419,5744,1782,1891,1800,204,67,3396,2355,1041,2355,1511,844,2020-01-01,zipcode,Marlin
ZCTA5 76666,48,254,45000,-666666666,107500,188,62,161,7,70,72,11,1,129,94,35,94,68,26,2020-01-01,zipcode,Mertens
ZCTA5 76676,48,238,40781,-666666666,71000,216,129,209,29,82,80,15,3,137,110,27,110,103,7,2020-01-01,zipcode,Penelope
ZCTA5 76678,48,246,40927,-666666666,138600,173,76,138,6,37,72,14,9,108,77,31,77,38,39,2020-01-01,zipcode,Prairie hill
ZCTA5 76686,48,188,56250,1264,88100,165,83,161,4,64,50,38,5,117,90,27,90,67,23,2020-01-01,zipcode,Tehuacana
ZCTA5 76001,48,37231,87616,1482,232000,28249,9309,22736,2346,4781,7008,5861,2740,11426,11012,414,11012,8913,2099,2020-01-01,zipcode,Arlington
ZCTA5 76010,48,59526,38461,960,115700,42315,14296,31484,12337,9353,6533,2486,775,20167,18019,2148,18019,6146,11873,2020-01-01,zipcode,Arlington
ZCTA5 76014,48,33289,53896,1212,134700,24874,8239,20532,4947,6282,5691,2794,818,11384,10442,942,10442,5385,5057,2020-01-01,zipcode,Arlington
ZCTA5 76018,48,28353,73760,1556,164800,22263,5740,17130,2661,4471,5360,2820,1818,8659,8364,295,8364,6118,2246,2020-01-01,zipcode,Arlington
ZCTA5 76044,48,5407,75317,873,264800,4499,1833,3798,199,1825,1142,421,211,2130,2041,89,2041,1684,357,2020-01-01,zipcode,Godley
ZCTA5 76064,48,2100,59741,1216,183500,1504,568,1425,268,408,425,118,206,717,690,27,690,424,266,2020-01-01,zipcode,Maypearl
ZCTA5 76088,48,12610,80893,1035,254500,10126,3844,8743,992,3188,2824,1307,432,4551,4292,259,4292,3528,764,2020-01-01,zipcode,Weatherford
ZCTA5 76103,48,16848,46196,881,117400,13169,4966,10647,3094,2605,2671,1336,941,5912,5268,644,5268,3427,1841,2020-01-01,zipcode,Fort worth
ZCTA5 76119,48,52279,39129,948,84300,37563,16130,31180,10123,11105,7649,1627,676,16578,14780,1798,14780,7495,7285,2020-01-01,zipcode,Fort worth
ZCTA5 76127,48,2038,88750,1896,-666666666,1988,1546,1536,306,590,541,43,56,51,51,0,51,10,41,2020-01-01,zipcode,Naval air station jrb
ZCTA5 76357,48,517,55357,727,73300,393,147,353,32,145,88,62,26,314,212,102,212,173,39,2020-01-01,zipcode,Byers
ZCTA5 76238,48,276,49167,-666666666,76300,241,114,220,4,105,79,26,6,133,126,7,126,76,50,2020-01-01,zipcode,Era
ZCTA5 76247,48,12542,93722,1531,224200,9700,2849,8567,540,1839,3554,1986,648,4263,4136,127,4136,3510,626,2020-01-01,zipcode,Justin
ZCTA5 76265,48,1464,64713,663,144700,1190,482,1038,99,354,347,178,60,965,656,309,656,513,143,2020-01-01,zipcode,Saint jo
ZCTA5 76426,48,12694,61233,914,159500,10326,4268,8803,1660,2758,2568,1215,602,4822,4203,619,4203,3037,1166,2020-01-01,zipcode,Bridgeport
ZCTA5 76437,48,5899,58578,617,97000,4804,2214,3922,414,979,1553,755,221,2910,2165,745,2165,1816,349,2020-01-01,zipcode,Cisco
ZCTA5 76538,48,1167,70313,-666666666,120800,1019,528,858,37,232,325,205,59,537,466,71,466,402,64,2020-01-01,zipcode,Jonesboro
ZCTA5 76544,48,23514,44321,1203,-666666666,19151,2708,6956,235,1394,3933,1022,372,6900,2978,3922,2978,57,2921,2020-01-01,zipcode,Fort hood
ZCTA5 78501,48,60299,41345,715,113000,46841,18606,39453,10751,7702,10144,7543,3313,23627,20650,2977,20650,10900,9750,2020-01-01,zipcode,Mcallen
ZCTA5 78521,48,89629,33616,725,73400,64811,28634,50580,20902,12806,10082,5041,1749,28100,25503,2597,25503,15107,10396,2020-01-01,zipcode,Brownsville
ZCTA5 78526,48,50057,58156,917,117300,36314,13804,28566,7874,5819,7338,5700,1835,14878,13915,963,13915,9487,4428,2020-01-01,zipcode,Brownsville
ZCTA5 78566,48,17999,52703,776,118800,13089,5396,10290,2555,2637,3111,1422,565,5975,5246,729,5246,3822,1424,2020-01-01,zipcode,Los fresnos
ZCTA5 78593,48,5432,38051,709,59200,4115,1957,3381,1131,1353,557,244,96,1729,1531,198,1531,1181,350,2020-01-01,zipcode,Santa rosa
ZCTA5 78877,48,938,36716,-666666666,-666666666,713,399,713,467,115,29,35,67,323,278,45,278,262,16,2020-01-01,zipcode,Quemado
ZCTA5 78840,48,47993,47906,767,105800,35703,14230,29327,8834,7196,7721,3629,1947,18808,16221,2587,16221,10486,5735,2020-01-01,zipcode,Del rio
ZCTA5 78860,48,0,-666666666,-666666666,-666666666,0,0,0,0,0,0,0,0,17,0,17,0,0,0,2020-01-01,zipcode,El indio
ZCTA5 78872,48,1376,27500,-666666666,29500,962,485,795,352,169,200,20,54,547,400,147,400,287,113,2020-01-01,zipcode,La pryor
ZCTA5 78933,48,1194,62689,-666666666,120700,946,466,930,114,289,231,222,74,812,510,302,510,370,140,2020-01-01,zipcode,Cat spring
ZCTA5 78953,48,775,74456,1239,161000,713,213,713,67,236,297,69,44,557,403,154,403,282,121,2020-01-01,zipcode,Rosanky
ZCTA5 78954,48,1207,83583,1075,410000,1061,543,1017,77,371,263,206,100,998,505,493,505,467,38,2020-01-01,zipcode,Round top
ZCTA5 78021,48,158,-666666666,-666666666,-666666666,107,103,107,37,66,0,4,0,131,41,90,41,41,0,2020-01-01,zipcode,Fowlerton
ZCTA5 78003,48,10129,57005,864,173600,8072,4086,7528,902,2468,2549,1133,476,4970,3712,1258,3712,3023,689,2020-01-01,zipcode,Bandera
ZCTA5 78004,48,1328,110357,-666666666,403100,1192,636,1077,14,289,365,192,217,436,436,0,436,416,20,2020-01-01,zipcode,Bergheim
ZCTA5 78012,48,227,64583,-666666666,68800,195,85,161,39,68,25,0,29,207,103,104,103,73,30,2020-01-01,zipcode,Christine
ZCTA5 78039,48,2309,73229,600,66000,1966,790,1831,242,993,332,183,81,831,743,88,743,627,116,2020-01-01,zipcode,La coste
ZCTA5 78043,48,46141,43968,853,113200,32824,13058,25628,9233,6633,6679,2293,790,14095,12725,1370,12725,6776,5949,2020-01-01,zipcode,Laredo
ZCTA5 78046,48,71726,40890,862,104600,48325,20286,36814,13966,11012,8209,2814,813,18797,17231,1566,17231,12987,4244,2020-01-01,zipcode,Laredo
ZCTA5 78050,48,682,46098,-666666666,-666666666,511,245,426,240,93,93,0,0,254,217,37,217,161,56,2020-01-01,zipcode,Leming
ZCTA5 78055,48,2120,58496,440,216700,1777,943,1612,130,696,453,193,140,1258,796,462,796,658,138,2020-01-01,zipcode,Medina
ZCTA5 78070,48,15537,86997,1246,320100,13259,5416,11656,900,2913,3952,2362,1529,6214,5635,579,5635,5314,321,2020-01-01,zipcode,Spring branch
ZCTA5 78851,48,11,-666666666,-666666666,-666666666,11,0,11,0,0,0,11,0,22,11,11,11,11,0,2020-01-01,zipcode,Dryden
ZCTA5 78852,48,57160,41794,677,99600,41362,17987,32373,12282,7828,7184,3943,1136,18150,16369,1781,16369,10786,5583,2020-01-01,zipcode,Eagle pass
ZCTA5 78393,48,2182,50903,649,84100,1726,736,1564,406,549,472,112,25,1036,788,248,788,622,166,2020-01-01,zipcode,Woodsboro
ZCTA5 78415,48,41976,50397,1018,107100,31135,11887,26458,5844,10202,7794,1942,676,15185,13871,1314,13871,7892,5979,2020-01-01,zipcode,Corpus christi
ZCTA5 78417,48,4572,55956,1076,116800,3716,1348,3092,889,1007,933,204,59,1518,1379,139,1379,929,450,2020-01-01,zipcode,Corpus christi
ZCTA5 78504,48,61182,62975,935,151700,44734,15727,35561,5247,6781,10524,8178,4831,20114,18506,1608,18506,12176,6330,2020-01-01,zipcode,Mcallen
ZCTA5 78545,48,202,-666666666,-666666666,36600,170,47,155,155,0,0,0,0,128,76,52,76,76,0,2020-01-01,zipcode,Falcon heights
ZCTA5 78548,48,583,35781,-666666666,44600,403,192,332,181,99,36,16,0,219,167,52,167,149,18,2020-01-01,zipcode,Grulla
ZCTA5 78565,48,42,-666666666,-666666666,-666666666,42,42,42,42,0,0,0,0,76,42,34,42,42,0,2020-01-01,zipcode,Los ebanos
ZCTA5 78588,48,135,-666666666,-666666666,-666666666,107,87,105,16,20,60,6,3,70,39,31,39,36,3,2020-01-01,zipcode,San isidro
ZCTA5 78594,48,1538,28438,237,48200,1241,674,925,285,274,287,64,15,613,514,99,514,421,93,2020-01-01,zipcode,Sebastian
ZCTA5 78602,48,28536,65618,1143,209200,23002,10559,19852,2569,6249,5773,3595,1666,10498,9107,1391,9107,6990,2117,2020-01-01,zipcode,Bastrop
ZCTA5 78607,48,139,-666666666,-666666666,356300,139,120,139,0,90,33,16,0,180,55,125,55,45,10,2020-01-01,zipcode,Bluffton
ZCTA5 78621,48,24590,80100,1055,187400,18644,5983,16407,3487,5195,4773,1958,994,8177,7183,994,7183,5704,1479,2020-01-01,zipcode,Elgin
ZCTA5 78640,48,61991,74414,1380,203400,45589,13078,37561,5685,9891,11778,6613,3594,20048,19246,802,19246,13360,5886,2020-01-01,zipcode,Kyle
ZCTA5 78644,48,17675,62811,998,153400,14221,6359,12459,2094,5293,3082,1424,566,6503,5836,667,5836,3901,1935,2020-01-01,zipcode,Lockhart
ZCTA5 78670,48,101,61750,-666666666,167500,93,43,85,10,12,49,14,0,51,41,10,41,28,13,2020-01-01,zipcode,Staples
ZCTA5 78731,48,27664,85586,1369,642300,23217,7602,20947,276,974,3101,8087,8509,14385,13412,973,13412,7313,6099,2020-01-01,zipcode,Austin
ZCTA5 78734,48,19711,114709,1700,436800,15953,5736,14812,501,1523,3917,5993,2878,9180,8181,999,8181,6786,1395,2020-01-01,zipcode,Austin
ZCTA5 78741,48,47529,52048,1174,250500,40842,7457,31557,5566,6203,7305,8987,3496,22595,20714,1881,20714,3467,17247,2020-01-01,zipcode,Austin
ZCTA5 78746,48,27671,151488,1651,936000,21867,7737,19189,262,860,2237,8673,7157,11412,10414,998,10414,7224,3190,2020-01-01,zipcode,Austin
ZCTA5 78613,48,83876,107983,1457,318400,63739,18204,55233,2039,8999,17035,18912,8248,28722,27558,1164,27558,19693,7865,2020-01-01,zipcode,Cedar park
ZCTA5 78615,48,1363,70833,1066,210900,903,293,775,98,250,278,83,66,415,376,39,376,296,80,2020-01-01,zipcode,Coupland
ZCTA5 78623,48,1044,93828,-666666666,277900,943,415,894,5,171,492,152,74,482,427,55,427,397,30,2020-01-01,zipcode,Fischer
ZCTA5 78754,48,26508,77377,1249,245300,20236,4614,17550,2340,3511,4242,4623,2834,9656,9348,308,9348,5410,3938,2020-01-01,zipcode,Austin
ZCTA5 78406,48,2051,47125,1206,49300,1609,1075,1291,409,530,284,53,15,392,355,37,355,207,148,2020-01-01,zipcode,Corpus christi
ZCTA5 78598,48,127,17222,-666666666,112500,127,85,127,0,52,25,6,44,411,92,319,92,86,6,2020-01-01,zipcode,Port mansfield
ZCTA5 78657,48,6509,73983,1143,321100,5825,3136,5156,424,1223,1422,1605,482,5291,2787,2504,2787,2429,358,2020-01-01,zipcode,Horseshoe bay
ZCTA5 78536,48,340,57500,-666666666,85000,314,98,283,62,61,106,38,16,190,126,64,126,119,7,2020-01-01,zipcode,Delmita
ZCTA5 78541,48,44740,37260,782,92300,32098,11477,24683,7422,5953,6239,3416,1653,15175,13635,1540,13635,7258,6377,2020-01-01,zipcode,Edinburg
ZCTA5 78542,48,80837,46200,696,89600,53993,22887,41016,14932,10979,9278,4478,1349,20855,18707,2148,18707,14179,4528,2020-01-01,zipcode,Edinburg
ZCTA5 78561,48,482,26477,-666666666,58300,425,203,307,123,102,63,19,0,147,133,14,133,114,19,2020-01-01,zipcode,Lasara
ZCTA5 78564,48,205,41087,-666666666,-666666666,83,11,83,51,21,11,0,0,89,42,47,42,8,34,2020-01-01,zipcode,Lopeno
ZCTA5 07732,34,4814,76316,1270,290100,4208,1328,3809,227,650,1149,740,1043,3318,2688,630,2688,1943,745,2020-01-01,zipcode,Highlands
ZCTA5 07748,34,26773,123130,1428,453500,22102,7372,18745,762,4691,4362,5697,3233,9846,9584,262,9584,8130,1454,2020-01-01,zipcode,Middletown
ZCTA5 07826,34,5827,93462,1571,285600,4950,1714,4347,243,1488,1174,1098,344,2846,2236,610,2236,1831,405,2020-01-01,zipcode,Branchville
ZCTA5 07750,34,3226,111415,1912,845600,2854,1208,2496,25,364,528,823,756,1894,1485,409,1485,1132,353,2020-01-01,zipcode,Monmouth beach
ZCTA5 07762,34,8156,84800,1485,686800,6933,2995,6286,123,961,1335,2244,1623,5013,3964,1049,3964,2648,1316,2020-01-01,zipcode,Spring lake
ZCTA5 07847,34,2083,68580,1730,267700,1651,530,1563,106,507,520,314,116,848,848,0,848,656,192,2020-01-01,zipcode,Kenvil
ZCTA5 07849,34,8865,101538,1485,349200,7653,2496,6613,297,1764,1940,1717,895,4054,3630,424,3630,3111,519,2020-01-01,zipcode,Lake hopatcong
ZCTA5 07852,34,4130,92750,1608,365100,3500,1176,2872,78,441,701,1256,396,1577,1577,0,1577,1406,171,2020-01-01,zipcode,Ledgewood
ZCTA5 07856,34,4198,96444,2162,329100,3488,1155,3119,112,740,1025,739,503,2375,1837,538,1837,1262,575,2020-01-01,zipcode,Mount arlington
ZCTA5 07008,34,23501,76276,1521,281000,18567,6762,16311,2777,5262,3672,3702,898,8456,8036,420,8036,4641,3395,2020-01-01,zipcode,Carteret
ZCTA5 07002,34,65112,69511,1325,346000,51762,18289,45582,5026,13817,9511,11824,5404,27237,24784,2453,24784,10061,14723,2020-01-01,zipcode,Bayonne
ZCTA5 07012,34,13496,89153,1451,363300,10288,3392,9366,758,2141,2204,2577,1686,5075,4896,179,4896,2669,2227,2020-01-01,zipcode,Clifton
ZCTA5 07014,34,4616,98526,1951,328500,3813,928,3514,122,1124,696,1143,429,1968,1788,180,1788,1302,486,2020-01-01,zipcode,Clifton
ZCTA5 35035,01,959,53818,-666666666,67400,780,260,729,49,297,230,105,48,637,457,180,457,440,17,2020-01-01,zipcode,Brierfield
ZCTA5 35042,01,5732,55572,601,121800,4972,2197,4465,588,2037,1112,358,370,2601,2185,416,2185,1818,367,2020-01-01,zipcode,Centreville
ZCTA5 35082,01,0,-666666666,-666666666,-666666666,0,0,0,0,0,0,0,0,0,0,0,0,0,0,2020-01-01,zipcode,Hollins
ZCTA5 35121,01,16542,45943,677,135300,13344,6949,11381,2569,3204,3766,1252,590,7097,6365,732,6365,4231,2134,2020-01-01,zipcode,Oneonta
ZCTA5 35139,01,132,11429,-666666666,16100,132,64,88,55,26,7,0,0,126,92,34,92,51,41,2020-01-01,zipcode,Sayre
ZCTA5 35147,01,5825,76875,1401,196700,4430,1486,3809,447,746,1062,1095,459,2178,1970,208,1970,1799,171,2020-01-01,zipcode,Sterrett
ZCTA5 35148,01,2209,53214,575,114100,1902,810,1676,265,688,655,43,25,1180,972,208,972,696,276,2020-01-01,zipcode,Sumiton
ZCTA5 35176,01,683,21425,697,-666666666,579,327,474,222,126,85,17,24,331,311,20,311,188,123,2020-01-01,zipcode,Vandiver
ZCTA5 35216,01,37828,66540,1096,286000,28960,8458,24890,1586,4068,6392,8063,4781,16119,14781,1338,14781,8154,6627,2020-01-01,zipcode,Birmingham
ZCTA5 35221,01,4112,32017,834,67700,3402,1766,3067,574,959,1210,259,65,2375,1764,611,1764,1125,639,2020-01-01,zipcode,Birmingham
ZCTA5 35223,01,10388,137400,2031,579400,8442,3683,7480,50,186,1109,3231,2904,4570,4140,430,4140,3654,486,2020-01-01,zipcode,Birmingham
ZCTA5 35224,01,5362,47450,819,67600,4273,1902,3668,273,1521,1486,301,87,2892,2079,813,2079,1171,908,2020-01-01,zipcode,Birmingham
ZCTA5 08551,34,5588,141536,2295,501300,4894,1730,3849,104,780,647,1627,691,2078,1979,99,1979,1783,196,2020-01-01,zipcode,Ringoes
ZCTA5 08648,34,31819,108772,1742,335000,26887,8844,21468,1485,3859,3885,5803,6436,12563,11678,885,11678,7949,3729,2020-01-01,zipcode,Lawrence township
ZCTA5 08720,34,777,131983,-666666666,558500,632,147,507,10,15,152,217,113,270,270,0,270,228,42,2020-01-01,zipcode,Allenwood
ZCTA5 08721,34,21486,92387,1523,291100,16783,5448,15059,1311,5643,4130,2894,1081,8743,7706,1037,7706,6507,1199,2020-01-01,zipcode,Bayville
ZCTA5 08735,34,4139,69200,1419,656300,3790,2024,3606,103,935,826,1079,663,7313,2220,5093,2220,1877,343,2020-01-01,zipcode,Lavallette
ZCTA5 08736,34,13195,135946,1406,654100,10982,3273,9429,205,1230,1897,3694,2403,6436,5188,1248,5188,4539,649,2020-01-01,zipcode,Manasquan
ZCTA5 08750,34,3148,127333,1173,865800,2812,1371,2478,24,304,439,1021,690,1871,1358,513,1358,1247,111,2020-01-01,zipcode,Sea girt
ZCTA5 08753,34,63750,84533,1502,297400,51716,17074,44515,2728,13775,12966,10039,5007,26785,24019,2766,24019,19040,4979,2020-01-01,zipcode,Toms river
ZCTA5 08755,34,26398,70419,1358,280700,21156,9112,18625,1801,6533,5107,3269,1915,10841,10224,617,10224,8471,1753,2020-01-01,zipcode,Toms river
ZCTA5 08758,34,8254,78018,1682,337500,7139,3487,6679,327,2621,1706,1395,630,4051,3491,560,3491,3039,452,2020-01-01,zipcode,Waretown
ZCTA5 08038,34,190,-666666666,-666666666,179200,126,15,106,15,19,72,0,0,92,92,0,92,46,46,2020-01-01,zipcode,Hancocks bridge
ZCTA5 08039,34,186,-666666666,-666666666,311500,128,27,107,55,5,23,19,5,61,44,17,44,23,21,2020-01-01,zipcode,Harrisonville
ZCTA5 08042,34,209,141146,-666666666,601200,152,11,147,0,11,40,24,72,125,112,13,112,100,12,2020-01-01,zipcode,Juliustown
ZCTA5 08050,34,25503,88826,1622,287900,21142,7657,18585,1091,6148,4869,4422,2055,13549,10190,3359,10190,9034,1156,2020-01-01,zipcode,Manahawkin
ZCTA5 08053,34,45138,99454,1558,299800,36898,11485,32583,1162,7023,8491,10361,5546,19213,18109,1104,18109,13078,5031,2020-01-01,zipcode,Marlton
ZCTA5 08061,34,2769,152083,2138,295000,1956,324,1716,20,256,664,490,286,947,893,54,893,851,42,2020-01-01,zipcode,Mount royal
ZCTA5 08074,34,16,-666666666,-666666666,-666666666,16,0,16,8,0,0,0,8,0,0,0,0,0,0,2020-01-01,zipcode,Richwood
ZCTA5 08081,34,50246,87407,1273,203700,39219,11441,32863,2235,10287,10950,5823,3568,18021,16793,1228,16793,13498,3295,2020-01-01,zipcode,Sicklerville
ZCTA5 08084,34,6968,78309,970,180900,5837,1949,4873,206,1680,1234,1206,547,2841,2724,117,2724,2061,663,2020-01-01,zipcode,Stratford
ZCTA5 08086,34,7438,71875,1482,205000,6147,2054,5369,306,1652,1909,1047,455,3478,3197,281,3197,2340,857,2020-01-01,zipcode,Thorofare
ZCTA5 08091,34,5647,75985,1158,187000,4825,1513,4169,282,1686,1268,738,195,2223,2068,155,2068,1486,582,2020-01-01,zipcode,West berlin
ZCTA5 08094,34,40322,82420,1123,205800,32029,9694,27911,2211,9629,8934,4765,2372,15877,15072,805,15072,12878,2194,2020-01-01,zipcode,Williamstown
ZCTA5 08314,34,390,133269,-666666666,166000,330,77,269,16,176,25,20,32,178,146,32,146,136,10,2020-01-01,zipcode,Delmont
ZCTA5 08316,34,177,-666666666,-666666666,132600,117,70,105,32,41,17,0,15,130,68,62,68,68,0,2020-01-01,zipcode,Dorchester
ZCTA5 08348,34,189,84934,-666666666,144100,130,42,126,36,50,40,0,0,53,53,0,53,45,8,2020-01-01,zipcode,Port elizabeth
ZCTA5 08352,34,688,-666666666,-666666666,158400,537,300,434,100,180,60,72,22,219,219,0,219,176,43,2020-01-01,zipcode,Rosenhayn
ZCTA5 08002,34,22794,85291,1493,244500,18849,6421,16451,1387,3744,4823,3903,2594,9570,8684,886,8684,6055,2629,2020-01-01,zipcode,Cherry hill
ZCTA5 08003,34,29856,132441,1712,334900,24257,8117,21490,719,3490,3810,6914,6557,11558,10884,674,10884,9481,1403,2020-01-01,zipcode,Cherry hill
ZCTA5 08007,34,4812,79125,947,174300,4047,1283,3721,240,1083,1040,967,391,2202,2106,96,2106,1110,996,2020-01-01,zipcode,Barrington
ZCTA5 08014,34,403,105208,-666666666,169800,344,114,287,0,136,127,24,0,185,124,61,124,112,12,2020-01-01,zipcode,Bridgeport
ZCTA5 35750,01,13317,54321,866,139500,10617,3875,9301,1308,2945,2610,1699,739,5827,5183,644,5183,4129,1054,2020-01-01,zipcode,Hazel green
ZCTA5 35903,01,18240,41103,676,114700,15199,6402,12675,1735,4257,4676,1207,800,8767,6926,1841,6926,4510,2416,2020-01-01,zipcode,Gadsden
ZCTA5 35754,01,5806,68673,611,160900,5023,2185,4309,962,980,1209,823,335,2537,2287,250,2287,1685,602,2020-01-01,zipcode,Laceys spring
ZCTA5 35811,01,26198,65938,815,172800,21354,7624,18458,1695,4154,6412,4056,2141,11745,10698,1047,10698,8305,2393,2020-01-01,zipcode,Huntsville
ZCTA5 35901,01,18903,39732,633,132400,15265,7050,13288,2121,3774,4401,1864,1128,9267,7426,1841,7426,4742,2684,2020-01-01,zipcode,Gadsden
ZCTA5 35954,01,12095,43715,575,105200,9835,4370,8295,1371,3056,3073,418,377,5719,4568,1151,4568,3673,895,2020-01-01,zipcode,Attalla
ZCTA5 35958,01,3237,38165,521,124000,2575,1459,2143,427,832,512,230,142,1356,1212,144,1212,992,220,2020-01-01,zipcode,Bryant
ZCTA5 35961,01,6623,39244,550,90400,5316,2533,4650,1437,1587,1301,180,145,2882,2387,495,2387,1652,735,2020-01-01,zipcode,Collinsville
ZCTA5 35971,01,6344,37123,665,107500,5213,2553,4256,788,1675,1446,225,122,2482,2299,183,2299,1631,668,2020-01-01,zipcode,Fyffe
ZCTA5 35751,01,227,48500,-666666666,165000,216,77,156,0,68,53,20,15,108,82,26,82,82,0,2020-01-01,zipcode,Hollytree
ZCTA5 35771,01,3681,55662,639,114600,2784,1054,2546,482,851,890,187,136,1533,1245,288,1245,1002,243,2020-01-01,zipcode,Section
ZCTA5 35806,01,24132,62355,1029,221600,20033,5535,16117,721,2239,4352,5433,3372,12346,11621,725,11621,5425,6196,2020-01-01,zipcode,Huntsville
ZCTA5 35808,01,1308,94896,1371,-666666666,1037,248,780,3,132,295,187,163,381,371,10,371,13,358,2020-01-01,zipcode,Huntsville
ZCTA5 35775,01,726,37758,-666666666,80300,541,290,511,117,147,172,45,30,319,277,42,277,265,12,2020-01-01,zipcode,Valhermoso springs
ZCTA5 35803,01,26504,79214,997,189600,21675,8323,19161,750,3309,5207,6082,3813,12244,11424,820,11424,9096,2328,2020-01-01,zipcode,Huntsville
ZCTA5 35044,01,7149,41098,584,95800,5830,2211,4913,725,1839,1928,186,235,3516,3188,328,3188,2011,1177,2020-01-01,zipcode,Childersburg
ZCTA5 35055,01,21535,51479,752,139000,17022,7160,14485,2206,4111,4914,2301,953,9251,8367,884,8367,5329,3038,2020-01-01,zipcode,Cullman
ZCTA5 35071,01,15591,73854,986,183400,12105,4349,10679,755,3216,3565,2047,1096,6650,5996,654,5996,4562,1434,2020-01-01,zipcode,Gardendale
ZCTA5 35986,01,7833,46558,593,145500,6221,2640,5268,929,1579,1934,646,180,3473,3099,374,3099,2278,821,2020-01-01,zipcode,Rainsville
ZCTA5 35004,01,11944,64987,964,165600,9453,3272,8658,408,3305,3266,1273,406,4776,4677,99,4677,3635,1042,2020-01-01,zipcode,Moody
ZCTA5 35005,01,8815,49702,889,103600,7217,3063,6669,840,2978,2067,568,216,3644,3170,474,3170,2524,646,2020-01-01,zipcode,Adamsville
ZCTA5 35045,01,14383,44842,685,124000,11492,5333,10056,1664,4235,2553,955,649,6409,5759,650,5759,4029,1730,2020-01-01,zipcode,Clanton
ZCTA5 35052,01,257,-666666666,-666666666,-666666666,257,203,257,75,110,61,11,0,20,20,0,20,0,20,2020-01-01,zipcode,Cook springs
ZCTA5 35186,01,5068,73010,929,206700,4262,1857,3659,426,1102,1105,664,362,2276,1988,288,1988,1634,354,2020-01-01,zipcode,Wilsonville
ZCTA5 35213,01,13963,128059,1440,558900,10851,3420,9719,74,378,848,4860,3559,6121,5756,365,5756,4437,1319,2020-01-01,zipcode,Birmingham
ZCTA5 35215,01,47438,41940,870,111800,34516,13432,29177,3789,9535,11132,3229,1492,20327,17816,2511,17816,9867,7949,2020-01-01,zipcode,Birmingham
ZCTA5 35442,01,6386,35000,498,87000,5304,3287,4639,1019,1600,1302,480,238,2459,1978,481,1978,1351,627,2020-01-01,zipcode,Aliceville
ZCTA5 35456,01,4332,50244,876,117700,3382,1495,3042,626,1316,860,139,101,1737,1472,265,1472,1037,435,2020-01-01,zipcode,Duncanville
ZCTA5 35118,01,3157,61900,783,134800,2497,1126,2141,300,907,698,124,112,1271,1088,183,1088,863,225,2020-01-01,zipcode,Mulga
ZCTA5 35073,01,2544,54464,853,92000,2158,967,1930,282,628,719,269,32,1222,1063,159,1063,752,311,2020-01-01,zipcode,Graysville
ZCTA5 35085,01,8479,53438,727,97100,6892,3075,5626,1158,2476,1283,491,218,3638,3216,422,3216,2632,584,2020-01-01,zipcode,Jemison
ZCTA5 35111,01,17512,70897,1043,207500,14154,5231,12119,688,3841,3865,2412,1313,7215,6440,775,6440,5814,626,2020-01-01,zipcode,Mc calla
ZCTA5 35124,01,24044,78647,1164,201700,19502,6308,17223,1008,3053,5540,4721,2901,10188,9645,543,9645,8080,1565,2020-01-01,zipcode,Pelham
ZCTA5 35150,01,17326,34718,661,113300,13475,6426,11807,2192,3745,4293,1042,535,8432,7104,1328,7104,4485,2619,2020-01-01,zipcode,Sylacauga
ZCTA5 35203,01,3026,25030,670,262000,2907,1585,2623,487,918,374,428,416,1893,1595,298,1595,348,1247,2020-01-01,zipcode,Birmingham
ZCTA5 35206,01,17211,33256,916,90200,14109,6221,12351,1905,4389,4030,1291,736,8552,6757,1795,6757,3393,3364,2020-01-01,zipcode,Birmingham
ZCTA5 35209,01,29262,64307,1087,358000,23103,6613,18200,815,2479,3484,6269,5153,15595,12445,3150,12445,6263,6182,2020-01-01,zipcode,Birmingham
ZCTA5 35218,01,7283,29545,823,63400,5629,2550,4960,969,1575,2053,279,84,3662,2868,794,2868,1025,1843,2020-01-01,zipcode,Birmingham
ZCTA5 35226,01,35256,108368,1279,293200,26641,7957,23901,554,2315,5102,9156,6774,14026,13214,812,13214,10383,2831,2020-01-01,zipcode,Birmingham
ZCTA5 35235,01,21419,54564,1082,124200,16352,5883,14455,1109,3845,5588,2420,1493,9130,8295,835,8295,5577,2718,2020-01-01,zipcode,Birmingham
ZCTA5 35444,01,4007,48194,733,124600,3206,1315,2720,375,1052,889,335,69,1624,1447,177,1447,1218,229,2020-01-01,zipcode,Brookwood
ZCTA5 35461,01,2140,43750,-666666666,152200,1779,828,1614,186,668,498,191,71,1140,906,234,906,856,50,2020-01-01,zipcode,Ethelsville
ZCTA5 35473,01,16498,64232,807,188000,12594,4130,10778,845,2509,3406,2370,1648,7101,6483,618,6483,4270,2213,2020-01-01,zipcode,Northport
ZCTA5 35490,01,4179,58158,915,141000,3356,1090,2556,497,995,727,216,121,1677,1350,327,1350,982,368,2020-01-01,zipcode,Vance
ZCTA5 35501,01,9719,41276,665,112000,7472,3294,6200,1086,2084,2171,448,411,4662,3591,1071,3591,2070,1521,2020-01-01,zipcode,Jasper
ZCTA5 35540,01,2413,43558,473,86100,1963,917,1733,307,746,528,104,48,1148,961,187,961,809,152,2020-01-01,zipcode,Addison
ZCTA5 35541,01,3399,49283,716,132100,3037,1551,2731,387,881,880,311,272,2745,1593,1152,1593,1371,222,2020-01-01,zipcode,Arley
ZCTA5 35463,01,2183,56652,-666666666,157800,1705,620,1426,191,562,405,210,58,814,727,87,727,653,74,2020-01-01,zipcode,Fosters
ZCTA5 35469,01,49,-666666666,-666666666,-666666666,49,25,49,25,13,0,5,6,186,43,143,43,18,25,2020-01-01,zipcode,Knoxville
ZCTA5 35503,01,9817,49497,672,128500,8017,3522,7023,1179,2330,2396,681,437,4764,3925,839,3925,3112,813,2020-01-01,zipcode,Jasper
ZCTA5 77554,48,8730,78582,1204,299900,8078,3281,6668,363,1112,2298,1701,1194,10270,4092,6178,4092,2818,1274,2020-01-01,zipcode,Galveston
ZCTA5 77560,48,510,95759,-666666666,-666666666,462,216,421,30,178,165,36,12,388,270,118,270,270,0,2020-01-01,zipcode,Hankamer
ZCTA5 77562,48,10064,56927,866,141400,7695,3481,6610,1427,1955,2539,437,252,3846,3600,246,3600,2658,942,2020-01-01,zipcode,Highlands
ZCTA5 77590,48,31045,47786,977,120300,24177,9190,20339,3651,6772,7108,2140,668,13146,11618,1528,11618,6168,5450,2020-01-01,zipcode,Texas city
ZCTA5 77660,48,1589,53147,-666666666,117200,1330,840,1097,218,293,450,111,25,666,443,223,443,400,43,2020-01-01,zipcode,Spurger
ZCTA5 77713,48,13867,70960,1138,163000,10764,3753,9478,1068,2439,3140,2099,732,6735,5822,913,5822,3676,2146,2020-01-01,zipcode,Beaumont
ZCTA5 77807,48,11052,68780,1061,196300,9032,3789,7771,1171,2273,2199,1012,1116,4487,3679,808,3679,2349,1330,2020-01-01,zipcode,Bryan
ZCTA5 77835,48,3121,48162,1067,219600,2455,1004,2199,152,758,680,302,307,1747,1207,540,1207,964,243,2020-01-01,zipcode,Burton
ZCTA5 77857,48,767,39531,831,214100,640,317,600,73,189,232,57,49,459,361,98,361,316,45,2020-01-01,zipcode,Gause
ZCTA5 77861,48,2135,73143,723,171100,1758,736,1530,144,665,430,207,84,1068,798,270,798,691,107,2020-01-01,zipcode,Iola
ZCTA5 77868,48,18344,54460,739,147000,14424,7689,12161,2915,4297,3342,802,805,5930,5133,797,5133,3509,1624,2020-01-01,zipcode,Navasota
ZCTA5 77876,48,246,112708,-666666666,-666666666,203,52,187,0,34,135,18,0,94,70,24,70,58,12,2020-01-01,zipcode,Shiro
ZCTA5 77880,48,1800,76669,-666666666,229000,1402,561,1402,105,666,170,210,251,1242,807,435,807,694,113,2020-01-01,zipcode,Washington
ZCTA5 77905,48,15279,67681,1105,156200,12064,4904,10695,1513,3395,4113,1234,440,6290,5545,745,5545,4739,806,2020-01-01,zipcode,Victoria
ZCTA5 77960,48,62,-666666666,-666666666,-666666666,62,25,62,25,0,37,0,0,75,62,13,62,37,25,2020-01-01,zipcode,Fannin
ZCTA5 77963,48,5733,47526,513,127500,4445,2183,3843,679,953,1554,448,209,2777,2065,712,2065,1616,449,2020-01-01,zipcode,Goliad
ZCTA5 77978,48,576,73750,891,82700,460,164,386,34,129,174,20,29,299,221,78,221,121,100,2020-01-01,zipcode,Point comfort
ZCTA5 77657,48,21323,77408,869,172500,16241,6160,14234,1173,4927,4837,2537,760,8674,7871,803,7871,6450,1421,2020-01-01,zipcode,Lumberton
ZCTA5 77708,48,11385,48146,862,125300,9001,3259,7629,896,3033,2210,1107,383,5471,4882,589,4882,2505,2377,2020-01-01,zipcode,Beaumont
ZCTA5 77833,48,28507,56651,907,188000,23297,9942,18555,2515,5411,5369,3553,1707,12392,10528,1864,10528,7686,2842,2020-01-01,zipcode,Brenham
ZCTA5 77845,48,68757,80696,1168,271200,53353,16841,40950,1589,4770,9751,12950,11890,27665,25639,2026,25639,16737,8902,2020-01-01,zipcode,College station
ZCTA5 77871,48,3009,53241,647,156000,2674,1242,2431,278,968,675,401,109,1777,1362,415,1362,1045,317,2020-01-01,zipcode,Normangee
ZCTA5 77878,48,312,32372,850,-666666666,297,185,259,49,24,97,86,3,170,145,25,145,75,70,2020-01-01,zipcode,Snook
ZCTA5 77995,48,10731,45303,724,119900,8197,3622,6993,1390,3050,1718,721,114,4840,3852,988,3852,2937,915,2020-01-01,zipcode,Yoakum
ZCTA5 77004,48,38721,55498,1107,322600,33358,14230,22754,1576,3622,4851,6265,6440,17683,14577,3106,14577,5030,9547,2020-01-01,zipcode,Houston
ZCTA5 77008,48,36248,121408,1310,464400,30827,6053,28818,1893,2675,4335,11175,8740,18490,17326,1164,17326,10861,6465,2020-01-01,zipcode,Houston
ZCTA5 77006,48,21938,79808,1474,479100,20417,4273,17432,313,812,3195,6714,6398,15153,13130,2023,13130,4632,8498,2020-01-01,zipcode,Houston
ZCTA5 77009,48,37149,61296,915,279200,30383,9891,27246,7145,5920,4845,5367,3969,16764,14847,1917,14847,8584,6263,2020-01-01,zipcode,Houston
ZCTA5 77014,48,36560,50371,971,153700,27652,8907,22665,4341,5899,8155,3071,1199,12559,11505,1054,11505,5490,6015,2020-01-01,zipcode,Houston
ZCTA5 77031,48,17079,43509,941,168300,13537,4410,10927,2910,2662,2847,1722,786,6715,6119,596,6119,2676,3443,2020-01-01,zipcode,Houston
ZCTA5 77034,48,36778,54632,1101,130800,28031,9468,22262,5569,7032,6779,1928,954,13318,11584,1734,11584,5635,5949,2020-01-01,zipcode,Houston
ZCTA5 77055,48,45201,59102,1029,485600,34571,10605,29454,6426,6768,5361,6734,4165,17500,16017,1483,16017,7185,8832,2020-01-01,zipcode,Houston
ZCTA5 77072,48,65015,46127,1050,126200,49862,17554,40283,12355,11291,10255,4797,1585,20549,19035,1514,19035,9115,9920,2020-01-01,zipcode,Houston
ZCTA5 77035,48,36392,50643,919,215500,27812,9823,23783,4666,5481,6520,4318,2798,15969,14159,1810,14159,6272,7887,2020-01-01,zipcode,Houston
ZCTA5 77041,48,33762,84626,1473,210800,27499,9797,23239,4117,5402,5699,5434,2587,11626,10870,756,10870,8216,2654,2020-01-01,zipcode,Houston
ZCTA5 77050,48,6052,33537,926,80800,4324,1859,3507,1803,897,693,87,27,1774,1664,110,1664,1075,589,2020-01-01,zipcode,Houston
ZCTA5 77063,48,41829,48117,1132,240600,34766,10220,29896,3207,4915,7586,9280,4908,22294,19782,2512,19782,4467,15315,2020-01-01,zipcode,Houston
ZCTA5 77071,48,27650,48020,938,165200,21316,7711,18333,2892,4679,4782,3724,2256,11440,10280,1160,10280,5503,4777,2020-01-01,zipcode,Houston
ZCTA5 77074,48,40891,41154,934,152000,28734,9756,23970,7849,6437,4336,4217,1131,15252,13136,2116,13136,4459,8677,2020-01-01,zipcode,Houston
ZCTA5 32526,12,37484,60917,1108,147600,31145,13138,27399,2008,7828,10860,4664,2039,16054,14676,1378,14676,11680,2996,2020-01-01,zipcode,Pensacola
ZCTA5 32533,12,29024,75985,994,186700,23321,9471,20656,1476,5573,7547,3940,2120,11454,10553,901,10553,8906,1647,2020-01-01,zipcode,Cantonment
ZCTA5 32539,12,30357,56597,1016,180300,23499,10026,19864,1859,6290,7626,2895,1194,11062,10096,966,10096,7681,2415,2020-01-01,zipcode,Crestview
ZCTA5 79924,48,59816,45592,864,102300,45628,18671,37184,7791,9715,13088,4553,2037,21991,20366,1625,20366,12608,7758,2020-01-01,zipcode,El paso
ZCTA5 79021,48,147,65156,-666666666,74400,104,38,85,28,18,29,6,4,72,43,29,43,17,26,2020-01-01,zipcode,Cotton center
ZCTA5 79051,48,0,-666666666,-666666666,-666666666,0,0,0,0,0,0,0,0,0,0,0,0,0,0,2020-01-01,zipcode,Kerrick
ZCTA5 79054,48,584,37841,735,31500,453,232,395,31,163,129,65,7,274,213,61,213,166,47,2020-01-01,zipcode,Lefors
ZCTA5 79063,48,754,69773,519,191200,602,260,535,16,195,183,112,29,304,278,26,278,242,36,2020-01-01,zipcode,Nazareth
ZCTA5 79065,48,20148,55225,743,83400,15701,6787,13449,2825,4253,4312,1428,631,9023,7136,1887,7136,5146,1990,2020-01-01,zipcode,Pampa
ZCTA5 79072,48,26404,47961,664,85800,19760,8159,15955,4156,5357,3785,1665,992,10224,8264,1960,8264,4903,3361,2020-01-01,zipcode,Plainview
ZCTA5 79079,48,2570,45684,781,68000,2020,667,1703,386,521,583,162,51,1461,1049,412,1049,710,339,2020-01-01,zipcode,Shamrock
ZCTA5 79086,48,2476,53404,842,88500,1890,725,1587,438,439,364,280,66,1064,852,212,852,668,184,2020-01-01,zipcode,Sunray
ZCTA5 79103,48,10529,45701,909,96200,7620,2575,6305,1260,1960,2365,533,187,3888,3719,169,3719,2577,1142,2020-01-01,zipcode,Amarillo
ZCTA5 79104,48,6861,46793,844,63000,5019,1788,4493,1376,1764,1076,182,95,2821,2431,390,2431,1429,1002,2020-01-01,zipcode,Amarillo
ZCTA5 79345,48,1248,52083,725,79800,872,333,629,116,154,273,76,10,348,290,58,290,213,77,2020-01-01,zipcode,Meadow
ZCTA5 79518,48,67,131563,-666666666,212500,46,15,46,2,12,7,4,21,68,23,45,23,23,0,2020-01-01,zipcode,Girard
ZCTA5 79560,48,160,44479,681,94200,139,49,134,31,62,25,9,7,89,61,28,61,34,27,2020-01-01,zipcode,Sylvester
ZCTA5 79735,48,13636,51838,817,107200,10657,5563,9240,2699,3388,2169,615,369,4855,4199,656,4199,3099,1100,2020-01-01,zipcode,Fort stockton
ZCTA5 79081,48,3546,46250,705,110400,2626,997,2229,666,662,503,356,42,1625,1311,314,1311,974,337,2020-01-01,zipcode,Spearman
ZCTA5 79098,48,365,33239,1087,132600,339,208,309,20,162,85,31,11,194,165,29,165,141,24,2020-01-01,zipcode,Wildorado
ZCTA5 79108,48,14580,50806,959,122200,12906,8574,11742,2575,4714,3399,866,188,4706,3968,738,3968,2965,1003,2020-01-01,zipcode,Amarillo
ZCTA5 79780,48,127,-666666666,-666666666,-666666666,55,24,55,14,31,10,0,0,80,43,37,43,33,10,2020-01-01,zipcode,Saragosa
ZCTA5 79901,48,8821,12025,441,55600,7259,4540,6123,3503,1256,1058,274,32,4395,3436,959,3436,301,3135,2020-01-01,zipcode,El paso
ZCTA5 79707,48,38644,95024,1268,319000,29511,9147,24852,2315,6196,6998,6609,2734,14599,13849,750,13849,8567,5282,2020-01-01,zipcode,Midland
ZCTA5 79762,48,45474,68245,1126,176300,33451,9331,27105,3429,8540,9429,3962,1745,17382,15613,1769,15613,9038,6575,2020-01-01,zipcode,Odessa
ZCTA5 79092,48,1124,67059,787,119900,934,341,851,82,301,320,110,38,485,432,53,432,381,51,2020-01-01,zipcode,Vega
ZCTA5 79016,48,152,-666666666,-666666666,-666666666,152,104,0,0,0,0,0,0,0,0,0,0,0,0,2020-01-01,zipcode,Canyon
ZCTA5 79058,48,0,-666666666,-666666666,-666666666,0,0,0,0,0,0,0,0,28,0,28,0,0,0,2020-01-01,zipcode,Masterson
ZCTA5 79085,48,26,-666666666,-666666666,-666666666,19,7,12,0,5,7,0,0,5,5,0,5,5,0,2020-01-01,zipcode,Summerfield
ZCTA5 79094,48,12,-666666666,-666666666,-666666666,12,4,12,0,0,8,4,0,28,8,20,8,8,0,2020-01-01,zipcode,Wayside
ZCTA5 79105,48,0,-666666666,-666666666,-666666666,0,0,0,0,0,0,0,0,30,0,30,0,0,0,2020-01-01,zipcode,Amarillo
ZCTA5 79258,48,60,65625,-666666666,57500,60,48,48,0,39,9,0,0,27,27,0,27,27,0,2020-01-01,zipcode,South plains
ZCTA5 78618,48,348,72500,950,312800,286,161,276,2,67,85,57,65,355,148,207,148,121,27,2020-01-01,zipcode,Doss
ZCTA5 78620,48,18420,110986,1176,430300,14543,4544,12334,816,2050,3168,4368,1932,6791,6416,375,6416,5509,907,2020-01-01,zipcode,Dripping springs
ZCTA5 78629,48,12612,60092,811,135300,9371,3817,7985,1770,3379,1608,834,394,5336,4487,849,4487,2949,1538,2020-01-01,zipcode,Gonzales
ZCTA5 78645,48,11873,83388,1189,293900,9982,4456,9395,496,1905,3422,2341,1231,5887,4851,1036,4851,4105,746,2020-01-01,zipcode,Leander
ZCTA5 78650,48,2366,54643,825,191700,1677,560,1461,171,720,347,119,104,873,702,171,702,578,124,2020-01-01,zipcode,Mc dade
ZCTA5 78662,48,2697,85934,910,211600,2263,847,2065,127,480,1154,191,113,1174,1041,133,1041,795,246,2020-01-01,zipcode,Red rock
ZCTA5 78719,48,1803,49917,881,153600,1490,640,1293,606,414,221,52,0,465,405,60,405,319,86,2020-01-01,zipcode,Austin
ZCTA5 78723,48,37552,72764,1195,371200,29685,7360,27124,3985,4443,5693,7569,5434,15545,14192,1353,14192,6835,7357,2020-01-01,zipcode,Austin
ZCTA5 78010,48,4224,65388,628,177000,3331,1055,2747,537,788,756,481,185,1842,1499,343,1499,1073,426,2020-01-01,zipcode,Center point
ZCTA5 78014,48,5510,46940,678,83300,4458,2063,3776,1230,1750,517,267,12,2194,1721,473,1721,1197,524,2020-01-01,zipcode,Cotulla
ZCTA5 78023,48,29847,121264,1648,315500,23128,7640,19620,854,2740,5675,6251,4100,8949,8768,181,8768,7978,790,2020-01-01,zipcode,Helotes
ZCTA5 78025,48,4860,54130,844,138900,3890,1563,3341,447,1171,870,666,187,2524,1986,538,1986,1465,521,2020-01-01,zipcode,Ingram
ZCTA5 78061,48,12566,47598,857,78400,10083,5138,7883,2795,2878,1752,309,149,3584,2928,656,2928,2012,916,2020-01-01,zipcode,Pearsall
ZCTA5 78073,48,8897,58038,828,97000,6630,2495,5444,1928,1920,1180,261,155,2363,2033,330,2033,1641,392,2020-01-01,zipcode,Von ormy
ZCTA5 78738,48,15090,117371,1645,568600,11924,4408,11093,152,783,2067,5439,2652,6997,6368,629,6368,4611,1757,2020-01-01,zipcode,Austin
ZCTA5 78067,48,615,46339,-666666666,118500,485,217,425,109,198,38,80,0,415,223,192,223,193,30,2020-01-01,zipcode,San ygnacio
ZCTA5 78072,48,508,62344,993,85600,379,136,330,46,117,103,43,21,277,147,130,147,121,26,2020-01-01,zipcode,Tilden
ZCTA5 78116,48,331,-666666666,-666666666,265900,297,221,282,11,181,46,16,28,177,130,47,130,130,0,2020-01-01,zipcode,Gillett
ZCTA5 78148,48,22955,64457,1038,180000,17373,5652,14798,945,3999,5178,2927,1749,8168,7817,351,7817,4135,3682,2020-01-01,zipcode,Universal city
ZCTA5 78024,48,1466,61125,875,373000,1307,710,1272,61,213,475,294,229,1151,578,573,578,459,119,2020-01-01,zipcode,Hunt
ZCTA5 78724,48,25328,58095,1311,150400,17083,5289,13698,4590,4012,2833,1365,898,6934,6619,315,6619,4180,2439,2020-01-01,zipcode,Austin
ZCTA5 78727,48,31856,83603,1436,320000,26499,6490,24574,1232,2743,5811,8587,6201,14924,13911,1013,13911,6221,7690,2020-01-01,zipcode,Austin
ZCTA5 78730,48,10527,113614,1375,761700,8199,2393,7639,105,638,1453,2923,2520,4617,4453,164,4453,2566,1887,2020-01-01,zipcode,Austin
ZCTA5 78733,48,8711,171027,1887,684400,6175,2117,5591,53,271,964,2055,2248,2916,2839,77,2839,2578,261,2020-01-01,zipcode,Austin
ZCTA5 78567,48,269,24643,-666666666,47100,231,100,190,91,40,41,7,11,136,106,30,106,84,22,2020-01-01,zipcode,Los indios
ZCTA5 78573,48,41336,38774,732,100600,28826,10714,22231,8562,5498,4955,2420,796,11660,10650,1010,10650,7473,3177,2020-01-01,zipcode,Mission
ZCTA5 78574,48,62972,37639,735,84500,42895,17436,32997,14649,7341,6179,3379,1449,17669,15823,1846,15823,12155,3668,2020-01-01,zipcode,Mission
ZCTA5 78585,48,323,-666666666,-666666666,-666666666,244,145,168,65,42,61,0,0,164,88,76,88,84,4,2020-01-01,zipcode,Salineno
ZCTA5 78590,48,298,40357,-666666666,37000,223,64,192,47,79,40,26,0,84,64,20,64,64,0,2020-01-01,zipcode,San perlita
ZCTA5 78591,48,260,-666666666,-666666666,-666666666,202,149,188,0,83,66,38,1,141,73,68,73,59,14,2020-01-01,zipcode,Santa elena
ZCTA5 78633,48,26632,81571,1632,333300,24458,17270,23456,509,3513,6765,7312,5357,12993,12626,367,12626,11580,1046,2020-01-01,zipcode,Georgetown
ZCTA5 78665,48,51925,101410,1476,286300,37623,9199,32310,1176,5520,10465,9464,5685,17484,16257,1227,16257,10702,5555,2020-01-01,zipcode,Round rock
ZCTA5 78677,48,19,-666666666,-666666666,-666666666,19,19,19,0,19,0,0,0,6,6,0,6,6,0,2020-01-01,zipcode,Wrightsboro
ZCTA5 78712,48,887,-666666666,-666666666,-666666666,887,625,26,0,0,0,26,0,0,0,0,0,0,0,2020-01-01,zipcode,Austin
ZCTA5 78802,48,226,-666666666,-666666666,-666666666,226,0,144,60,84,0,0,0,77,60,17,60,0,60,2020-01-01,zipcode,Uvalde
ZCTA5 78843,48,713,-666666666,-666666666,-666666666,713,0,115,0,0,85,30,0,22,22,0,22,0,22,2020-01-01,zipcode,Laughlin afb
ZCTA5 78871,48,31,-666666666,-666666666,-666666666,21,5,21,0,2,8,11,0,64,13,51,13,13,0,2020-01-01,zipcode,Langtry
ZCTA5 78931,48,326,100139,-666666666,336300,235,98,217,30,84,58,33,12,183,127,56,127,115,12,2020-01-01,zipcode,Bleiblerville
ZCTA5 78951,48,0,-666666666,-666666666,-666666666,0,0,0,0,0,0,0,0,0,0,0,0,0,0,2020-01-01,zipcode,Oakland
ZCTA5 78069,48,6187,58698,631,87200,4973,2428,3863,810,1465,1103,344,141,1998,1737,261,1737,1525,212,2020-01-01,zipcode,Somerset
ZCTA5 78132,48,33368,108276,1167,393400,25626,10235,22275,751,4288,6480,6998,3758,12051,11312,739,11312,9422,1890,2020-01-01,zipcode,New braunfels
ZCTA5 78732,48,18535,175118,1455,546400,13760,4034,10939,151,437,2051,4936,3364,6287,6197,90,6197,4597,1600,2020-01-01,zipcode,Austin
ZCTA5 78833,48,1526,28542,769,58700,1299,814,1105,153,510,368,43,31,954,543,411,543,317,226,2020-01-01,zipcode,Camp wood
ZCTA5 78218,48,38749,42870,892,120800,29835,10657,25760,4265,7770,9097,3195,1433,14515,13421,1094,13421,6329,7092,2020-01-01,zipcode,San antonio
ZCTA5 78219,48,17705,37945,959,100100,12948,5262,11167,2489,3200,4075,967,436,5885,5513,372,5513,2910,2603,2020-01-01,zipcode,San antonio
ZCTA5 78223,48,56484,43561,849,101000,42258,16931,35996,7775,13196,10834,3136,1055,19937,18203,1734,18203,10289,7914,2020-01-01,zipcode,San antonio
ZCTA5 78225,48,15147,37587,894,83400,11717,4488,9537,2770,3234,2504,500,529,5251,4921,330,4921,3381,1540,2020-01-01,zipcode,San antonio
ZCTA5 78227,48,49326,40282,882,97800,36756,13914,30732,7449,10250,10161,2107,765,15446,14401,1045,14401,8251,6150,2020-01-01,zipcode,San antonio
ZCTA5 78239,48,26966,62271,1192,154800,21097,8765,17733,2322,4982,5932,2756,1741,8717,7931,786,7931,5814,2117,2020-01-01,zipcode,San antonio
ZCTA5 78254,48,61141,95251,1387,218700,44434,11515,37351,2134,6603,13165,10239,5210,18262,17473,789,17473,13583,3890,2020-01-01,zipcode,San antonio
ZCTA5 78261,48,16518,95581,1477,310600,12334,3400,10726,234,1548,3329,3550,2065,6272,5942,330,5942,4493,1449,2020-01-01,zipcode,San antonio
ZCTA5 78266,48,6592,124131,1977,445600,5484,2274,4818,128,616,1041,1543,1490,2603,2501,102,2501,2393,108,2020-01-01,zipcode,San antonio
ZCTA5 08344,34,4197,64306,1392,174000,3605,1320,3167,234,1123,849,572,389,2060,1761,299,1761,1594,167,2020-01-01,zipcode,Newfield
ZCTA5 08353,34,368,59931,970,159800,307,110,279,40,112,83,22,22,149,135,14,135,96,39,2020-01-01,zipcode,Shiloh
ZCTA5 08029,34,4858,74348,545,170300,4208,1434,3699,284,1814,1007,423,171,2118,2050,68,2050,1469,581,2020-01-01,zipcode,Glendora
ZCTA5 08030,34,13117,57866,1137,127000,10075,3491,8744,1018,3668,2647,983,428,5605,5162,443,5162,3374,1788,2020-01-01,zipcode,Gloucester city
ZCTA5 08036,34,5885,109523,1051,335800,5080,1691,4358,183,1409,1156,1188,422,2400,2313,87,2313,2168,145,2020-01-01,zipcode,Hainesport
ZCTA5 08046,34,31857,79653,1637,171200,26360,8627,22562,1531,8082,7745,3583,1621,11995,10784,1211,10784,8383,2401,2020-01-01,zipcode,Willingboro
ZCTA5 08064,34,225,-666666666,-666666666,-666666666,225,219,225,30,101,58,23,13,22,22,0,22,22,0,2020-01-01,zipcode,New lisbon
ZCTA5 08067,34,1653,93889,1438,233200,1312,467,1131,149,411,296,226,49,644,582,62,582,485,97,2020-01-01,zipcode,Pedricktown
ZCTA5 08087,34,25387,66765,1426,239400,20877,8954,18994,1227,7075,5448,3490,1754,13428,10617,2811,10617,8932,1685,2020-01-01,zipcode,Tuckerton
ZCTA5 08097,34,3153,93269,1038,200100,2654,909,2324,79,736,860,444,205,1176,1146,30,1146,1026,120,2020-01-01,zipcode,Woodbury heights
ZCTA5 08212,34,165,71902,-666666666,847800,164,115,162,0,21,27,52,62,656,93,563,93,92,1,2020-01-01,zipcode,Cape may point
ZCTA5 08012,34,38708,79948,1184,214700,31497,9896,27617,2109,8721,8094,6329,2364,15548,14625,923,14625,10063,4562,2020-01-01,zipcode,Blackwood
ZCTA5 08028,34,21596,75189,1379,211800,18231,7106,12110,912,3340,3308,3046,1504,7488,6696,792,6696,4396,2300,2020-01-01,zipcode,Glassboro
ZCTA5 08033,34,15883,128134,1135,456400,12109,3578,11044,133,1313,1840,3947,3811,6353,6003,350,6003,4474,1529,2020-01-01,zipcode,Haddonfield
ZCTA5 08037,34,22779,73031,1184,231400,18769,6977,16367,1619,6342,4437,2816,1153,9370,8453,917,8453,6371,2082,2020-01-01,zipcode,Hammonton
ZCTA5 08056,34,5006,145039,1447,352500,3668,1085,3228,65,949,647,770,797,1627,1539,88,1539,1478,61,2020-01-01,zipcode,Mickleton
ZCTA5 08059,34,5380,81168,1077,169200,4320,1251,3845,195,1619,1131,617,283,2301,2153,148,2153,1396,757,2020-01-01,zipcode,Mount ephraim
ZCTA5 08073,34,130,-666666666,-666666666,290000,92,36,92,0,52,17,0,23,40,40,0,40,40,0,2020-01-01,zipcode,Rancocas
ZCTA5 08080,34,37216,107566,1447,260400,29992,9340,26441,914,6956,7537,7575,3459,14051,13425,626,13425,11751,1674,2020-01-01,zipcode,Sewell
ZCTA5 08088,34,24018,87216,2035,279400,20006,8693,17696,1098,6071,4487,4054,1986,9896,9440,456,9440,9011,429,2020-01-01,zipcode,Vincentown
ZCTA5 08109,34,22741,68755,1010,172900,18202,6264,15756,2417,5059,4349,2642,1289,8872,8359,513,8359,6079,2280,2020-01-01,zipcode,Merchantville
ZCTA5 08204,34,17257,71695,1130,293800,14717,5949,12819,586,4358,3628,2945,1302,13024,7461,5563,7461,5842,1619,2020-01-01,zipcode,Cape may
ZCTA5 08243,34,2122,76875,1325,732800,1981,1205,1813,37,501,464,511,300,6894,1105,5789,1105,1029,76,2020-01-01,zipcode,Sea isle city
ZCTA5 08260,34,12531,55551,1031,343400,11211,5680,10107,707,3847,2977,1598,978,23772,6251,17521,6251,4204,2047,2020-01-01,zipcode,Wildwood
ZCTA5 08270,34,8285,74776,1075,264500,6691,2582,5778,753,2104,1535,908,478,3725,3111,614,3111,2339,772,2020-01-01,zipcode,Woodbine
ZCTA5 08319,34,1188,99868,-666666666,255800,946,317,811,30,309,195,168,109,534,420,114,420,415,5,2020-01-01,zipcode,Estell manor
ZCTA5 08401,34,37793,29526,927,150000,29679,12093,24834,6524,8230,5572,3115,1393,20664,15775,4889,15775,4454,11321,2020-01-01,zipcode,Atlantic city
ZCTA5 08077,34,19120,113281,1668,280300,15745,4996,13665,446,3433,3844,4026,1916,7309,6837,472,6837,5899,938,2020-01-01,zipcode,Riverton
ZCTA5 08085,34,21074,121645,1637,297100,16014,4570,13572,787,3042,3391,4059,2293,7159,6911,248,6911,5686,1225,2020-01-01,zipcode,Swedesboro
ZCTA5 08090,34,8895,98701,1098,200000,6839,1927,5752,269,1958,1629,1226,670,3005,2911,94,2911,2632,279,2020-01-01,zipcode,Wenonah
ZCTA5 35233,01,2244,42284,1336,261200,2212,636,1435,55,91,87,324,878,1941,1431,510,1431,185,1246,2020-01-01,zipcode,Birmingham
ZCTA5 35243,01,16155,89891,1327,361600,13460,4301,12153,97,918,2266,4924,3948,9475,7798,1677,7798,4281,3517,2020-01-01,zipcode,Birmingham
ZCTA5 35441,01,1058,43750,-666666666,61200,750,286,694,96,253,184,66,95,855,355,500,355,325,30,2020-01-01,zipcode,Akron
ZCTA5 35446,01,1662,42969,817,76900,1343,675,1223,252,424,372,125,50,579,579,0,579,489,90,2020-01-01,zipcode,Buhl
ZCTA5 35452,01,3225,55694,960,163800,2749,1257,2328,341,882,713,211,181,1361,1198,163,1198,1049,149,2020-01-01,zipcode,Coker
ZCTA5 35458,01,279,-666666666,-666666666,167900,240,90,240,12,66,139,12,11,150,135,15,135,83,52,2020-01-01,zipcode,Elrod
ZCTA5 35475,01,17518,87883,778,207500,13280,4254,11827,797,3518,3885,2169,1458,7068,6129,939,6129,5591,538,2020-01-01,zipcode,Northport
ZCTA5 35477,01,132,-666666666,-666666666,-666666666,132,78,104,7,35,57,5,0,92,54,38,54,54,0,2020-01-01,zipcode,Panola
ZCTA5 35549,01,3667,38907,573,57400,2956,1461,2590,503,985,973,90,39,1976,1567,409,1567,1150,417,2020-01-01,zipcode,Carbon hill
ZCTA5 35554,01,1050,37348,546,59700,873,415,779,117,363,258,35,6,541,461,80,461,413,48,2020-01-01,zipcode,Eldridge
ZCTA5 35579,01,3349,46792,423,87600,2663,1387,2449,476,1023,775,153,22,1660,1315,345,1315,1059,256,2020-01-01,zipcode,Oakman
ZCTA5 35640,01,26308,56773,701,146400,21040,9113,18373,2026,6621,6074,2342,1310,10878,9787,1091,9787,7721,2066,2020-01-01,zipcode,Hartselle
ZCTA5 35653,01,10621,45297,683,92800,8352,3257,7045,2016,2639,1654,447,289,4584,3370,1214,3370,2271,1099,2020-01-01,zipcode,Russellville
ZCTA5 35660,01,8925,36774,695,100500,7277,3617,6336,1037,2142,2097,659,401,5087,4118,969,4118,2373,1745,2020-01-01,zipcode,Sheffield
ZCTA5 35677,01,2099,36908,822,108800,1747,871,1334,172,560,392,103,107,1156,777,379,777,665,112,2020-01-01,zipcode,Waterloo
ZCTA5 35749,01,23239,99767,945,191700,18005,5768,15530,1088,3180,4756,3948,2558,8913,8303,610,8303,7668,635,2020-01-01,zipcode,Harvest
ZCTA5 35179,01,8128,51921,705,146100,6630,2991,5667,769,2254,1969,432,243,3610,3101,509,3101,2580,521,2020-01-01,zipcode,Vinemont
ZCTA5 35950,01,20728,48535,716,115500,14870,5940,12735,2634,3735,4064,1648,654,7603,7143,460,7143,4495,2648,2020-01-01,zipcode,Albertville
ZCTA5 35953,01,6944,53679,1053,127100,5931,2917,5285,1116,2029,1818,197,125,3216,2536,680,2536,2060,476,2020-01-01,zipcode,Ashville
ZCTA5 35967,01,15993,41973,598,120500,12176,5108,10590,2248,3096,3486,957,803,7526,6194,1332,6194,4406,1788,2020-01-01,zipcode,Fort payne
ZCTA5 35979,01,1032,48261,-666666666,135000,868,327,725,103,396,184,18,24,552,450,102,450,409,41,2020-01-01,zipcode,Higdon
ZCTA5 35987,01,2421,60306,632,105500,1927,812,1673,312,766,440,82,73,1065,938,127,938,759,179,2020-01-01,zipcode,Steele
ZCTA5 35988,01,2355,41287,547,85300,1748,606,1550,324,518,411,201,96,1015,872,143,872,622,250,2020-01-01,zipcode,Sylvania
ZCTA5 35049,01,3914,39750,691,125500,2975,1228,2550,409,1233,678,145,85,1902,1581,321,1581,973,608,2020-01-01,zipcode,Cleveland
ZCTA5 35051,01,9609,55021,728,167500,7725,3822,6879,1188,2399,1800,1057,435,3597,3208,389,3208,2483,725,2020-01-01,zipcode,Columbiana
ZCTA5 35060,01,187,33468,-666666666,97900,127,67,99,0,54,22,0,23,193,84,109,84,84,0,2020-01-01,zipcode,Docena
ZCTA5 35115,01,16737,41585,706,132700,13547,5504,10345,1708,3485,3043,1602,507,6691,6198,493,6198,4186,2012,2020-01-01,zipcode,Montevallo
ZCTA5 35116,01,4768,73111,938,178800,3804,1382,3483,232,989,1235,811,216,1992,1896,96,1896,1674,222,2020-01-01,zipcode,Morris
ZCTA5 35120,01,16072,64679,746,161100,12364,4042,10174,1334,3729,3381,1231,499,6062,5583,479,5583,4612,971,2020-01-01,zipcode,Odenville
ZCTA5 35160,01,25622,32986,588,103200,21598,11843,18439,4123,6425,5324,1497,1070,12801,10312,2489,10312,6444,3868,2020-01-01,zipcode,Talladega
ZCTA5 35171,01,3557,65611,-666666666,120800,3038,1753,2754,719,831,694,190,320,1585,1399,186,1399,1165,234,2020-01-01,zipcode,Thorsby
ZCTA5 35175,01,5218,62667,636,150000,4377,1963,3870,572,1566,911,537,284,2449,2012,437,2012,1697,315,2020-01-01,zipcode,Union grove
ZCTA5 35968,01,5033,57765,626,120200,3936,1676,3260,784,966,1058,287,165,1712,1506,206,1506,1075,431,2020-01-01,zipcode,Fort payne
ZCTA5 35989,01,4063,42652,586,94200,3022,1379,2539,521,813,818,216,171,1651,1391,260,1391,1109,282,2020-01-01,zipcode,Valley head
ZCTA5 35083,01,3394,42188,710,129700,2742,1257,2329,476,863,778,180,32,1454,1254,200,1254,963,291,2020-01-01,zipcode,Holly pond
ZCTA5 35094,01,15392,59772,906,172400,11673,4344,10307,1261,2869,3511,1674,992,6358,5587,771,5587,4381,1206,2020-01-01,zipcode,Leeds
ZCTA5 35125,01,10945,52340,905,154500,8911,3858,7952,1663,2619,2276,992,402,5007,4412,595,4412,2861,1551,2020-01-01,zipcode,Pell city
ZCTA5 35128,01,10859,67101,887,183100,8686,3039,7631,859,2172,2892,1220,488,4969,4336,633,4336,3377,959,2020-01-01,zipcode,Pell city
ZCTA5 35135,01,1820,47083,947,195100,1398,513,1268,198,431,409,164,66,886,752,134,752,559,193,2020-01-01,zipcode,Riverside
ZCTA5 35173,01,27312,101644,1157,258200,21099,7270,18403,744,3786,6120,5088,2665,10222,9574,648,9574,8638,936,2020-01-01,zipcode,Trussville
ZCTA5 35459,01,913,30313,658,61100,810,466,659,150,282,167,46,14,491,392,99,392,273,119,2020-01-01,zipcode,Emelle
ZCTA5 35460,01,750,24221,-666666666,92500,699,425,505,13,130,167,152,43,428,360,68,360,330,30,2020-01-01,zipcode,Epes
ZCTA5 35480,01,1108,58393,-666666666,179000,959,416,950,69,374,350,115,42,494,427,67,427,367,60,2020-01-01,zipcode,Ralph
ZCTA5 35552,01,1031,45685,-666666666,59900,780,346,609,62,225,187,135,0,501,381,120,381,332,49,2020-01-01,zipcode,Detroit
ZCTA5 35559,01,75,-666666666,-666666666,-666666666,75,8,67,14,44,9,0,0,17,17,0,17,8,9,2020-01-01,zipcode,Glen allen
ZCTA5 35563,01,4287,40507,556,103100,3480,1626,2929,387,1011,1162,198,171,2045,1634,411,1634,1278,356,2020-01-01,zipcode,Guin
ZCTA5 35570,01,11516,43041,513,100200,9736,4885,8261,1560,2855,2617,721,508,5608,4549,1059,4549,3171,1378,2020-01-01,zipcode,Hamilton
ZCTA5 79699,48,118,-666666666,-666666666,-666666666,118,54,0,0,0,0,0,0,97,0,97,0,0,0,2020-01-01,zipcode,Abilene
ZCTA5 79770,48,0,-666666666,-666666666,-666666666,0,0,0,0,0,0,0,0,23,0,23,0,0,0,2020-01-01,zipcode,Orla
ZCTA5 79911,48,5905,98059,1241,234400,4584,1358,3948,69,613,910,1237,1119,2336,2273,63,2273,1747,526,2020-01-01,zipcode,El paso
ZCTA5 79916,48,4238,53841,1341,-666666666,3651,412,1596,0,288,828,362,118,372,346,26,346,0,346,2020-01-01,zipcode,Fort bliss
ZCTA5 79920,48,9,-666666666,-666666666,-666666666,9,0,0,0,0,0,0,0,0,0,0,0,0,0,2020-01-01,zipcode,
ZCTA5 79928,48,62344,58608,942,129900,43908,14198,34918,6370,8742,12322,5721,1763,18657,17370,1287,17370,14821,2549,2020-01-01,zipcode,El paso
ZCTA5 79942,48,0,-666666666,-666666666,-666666666,0,0,0,0,0,0,0,0,0,0,0,0,0,0,2020-01-01,zipcode,El paso
ZCTA5 79040,48,2085,52375,850,167300,1523,545,1233,415,234,204,333,47,789,583,206,583,445,138,2020-01-01,zipcode,Gruver
ZCTA5 79018,48,330,55125,668,87300,257,108,251,17,73,91,48,22,211,133,78,133,73,60,2020-01-01,zipcode,Channing
ZCTA5 79744,48,1362,67500,811,116400,1064,406,810,124,202,341,124,19,518,416,102,416,332,84,2020-01-01,zipcode,Iraan
ZCTA5 79846,48,23,-666666666,-666666666,-666666666,23,9,23,23,0,0,0,0,59,14,45,14,0,14,2020-01-01,zipcode,Redford
ZCTA5 79718,48,1029,47188,702,53100,893,270,665,76,360,121,97,11,391,268,123,268,192,76,2020-01-01,zipcode,Balmorhea
ZCTA5 79834,48,202,41544,671,-666666666,194,27,189,12,11,11,132,23,182,152,30,152,2,150,2020-01-01,zipcode,Big bend national park
ZCTA5 79061,48,182,57857,567,-666666666,161,64,149,8,40,94,7,0,124,88,36,88,75,13,2020-01-01,zipcode,Mobeetie
ZCTA5 79095,48,2677,40272,568,59000,2065,759,1728,406,400,575,281,66,1251,961,290,961,716,245,2020-01-01,zipcode,Wellington
ZCTA5 79925,48,39868,49219,853,140100,31198,11375,25330,3860,5398,9402,4365,2305,15865,14442,1423,14442,7853,6589,2020-01-01,zipcode,El paso
ZCTA5 79525,48,2561,75156,880,131400,1953,725,1650,183,529,569,333,36,1098,1018,80,1018,863,155,2020-01-01,zipcode,Hawley
ZCTA5 79528,48,625,60833,819,46300,455,245,420,29,131,129,83,48,387,254,133,254,199,55,2020-01-01,zipcode,Jayton
ZCTA5 79533,48,392,45938,825,30700,313,154,278,49,64,99,61,5,235,178,57,178,132,46,2020-01-01,zipcode,Lueders
ZCTA5 79539,48,221,71250,633,-666666666,208,94,150,38,26,34,35,17,116,84,32,84,66,18,2020-01-01,zipcode,O brien
ZCTA5 79543,48,1319,54601,645,63300,1000,371,858,81,317,309,115,36,687,533,154,533,435,98,2020-01-01,zipcode,Roby
ZCTA5 79545,48,1950,46201,783,79200,1558,643,1260,228,452,358,158,64,968,767,201,767,648,119,2020-01-01,zipcode,Roscoe
ZCTA5 79549,48,15708,48425,755,88000,12312,5904,10388,2051,3461,3270,1146,460,6585,5651,934,5651,4405,1246,2020-01-01,zipcode,Snyder
ZCTA5 79556,48,12683,42956,738,82100,9722,4038,8088,1414,2791,2719,839,325,5885,4620,1265,4620,3017,1603,2020-01-01,zipcode,Sweetwater
ZCTA5 79562,48,3795,94091,1097,208100,2874,1187,2579,73,688,869,647,302,1304,1230,74,1230,1095,135,2020-01-01,zipcode,Tuscola
ZCTA5 79566,48,218,36429,-666666666,224200,181,101,175,23,49,48,35,20,160,98,62,98,86,12,2020-01-01,zipcode,Wingate
ZCTA5 79714,48,18227,75147,1095,153200,13373,4143,10944,2549,3656,3105,1194,440,6336,5649,687,5649,4220,1429,2020-01-01,zipcode,Andrews
ZCTA5 79741,48,197,41250,1156,78100,154,90,152,22,53,57,16,4,117,98,19,98,83,15,2020-01-01,zipcode,Goldsmith
ZCTA5 79763,48,36688,52031,1001,104600,26246,9770,21727,7334,6613,5683,1525,572,12984,11544,1440,11544,8218,3326,2020-01-01,zipcode,Odessa
ZCTA5 79777,48,174,87292,-666666666,167000,130,26,118,8,48,15,21,26,143,73,70,73,51,22,2020-01-01,zipcode,Pyote
ZCTA5 75693,48,6863,65819,1054,167500,5250,1623,4328,614,1418,1535,630,131,2510,2249,261,2249,1551,698,2020-01-01,zipcode,White oak
ZCTA5 75703,48,42955,64510,1022,239300,33842,12007,28657,1458,4477,11160,7709,3853,18200,16365,1835,16365,8951,7414,2020-01-01,zipcode,Tyler
ZCTA5 75705,48,3138,45179,-666666666,-666666666,2467,1078,2163,243,525,1080,252,63,1184,868,316,868,703,165,2020-01-01,zipcode,Tyler
ZCTA5 75707,48,13206,70174,1214,191800,10851,4282,9410,467,1870,3627,2074,1372,6001,5118,883,5118,4009,1109,2020-01-01,zipcode,Tyler
ZCTA5 75758,48,9041,52889,847,108600,7309,3679,6481,935,2208,2037,1004,297,4397,3446,951,3446,2777,669,2020-01-01,zipcode,Chandler
ZCTA5 75472,48,4014,54342,781,125700,3302,1445,2801,355,1166,840,306,134,1758,1402,356,1402,1018,384,2020-01-01,zipcode,Point
ZCTA5 75491,48,4781,74073,699,160500,3782,1363,3298,328,818,1256,702,194,2073,1761,312,1761,1432,329,2020-01-01,zipcode,Whitewright
ZCTA5 75501,48,35352,40333,692,104200,27401,12890,23746,2959,8401,8731,2572,1083,15319,13062,2257,13062,7521,5541,2020-01-01,zipcode,Texarkana
ZCTA5 75571,48,2909,52798,483,92400,2359,990,2078,117,890,742,201,128,1360,1101,259,1101,1004,97,2020-01-01,zipcode,Omaha
ZCTA5 75603,48,6452,54718,967,130900,4936,1975,4258,286,1449,1748,581,194,2866,2330,536,2330,2065,265,2020-01-01,zipcode,Longview
ZCTA5 75652,48,16078,56721,800,167600,13612,7974,11583,2255,3663,3833,1233,599,5613,4672,941,4672,3340,1332,2020-01-01,zipcode,Henderson
ZCTA5 75686,48,13483,50656,752,115500,10206,4357,8789,1071,2945,2828,1340,605,5958,4619,1339,4619,3383,1236,2020-01-01,zipcode,Pittsburg
ZCTA5 75706,48,10882,62003,736,127000,8322,3079,7178,1386,2454,2530,635,173,3998,3089,909,3089,2367,722,2020-01-01,zipcode,Tyler
ZCTA5 75766,48,26995,47010,781,111000,20281,8002,17321,3868,5310,5140,2033,970,11388,9982,1406,9982,6926,3056,2020-01-01,zipcode,Jacksonville
ZCTA5 75789,48,8379,58071,898,167100,6077,2176,5252,613,1548,1825,958,308,3284,2926,358,2926,2221,705,2020-01-01,zipcode,Troup
ZCTA5 75845,48,3129,52200,694,78300,2678,1301,2434,581,643,848,276,86,1842,1276,566,1276,1034,242,2020-01-01,zipcode,Groveton
ZCTA5 75850,48,1387,-666666666,-666666666,161100,1139,607,1058,355,311,201,160,31,561,474,87,474,418,56,2020-01-01,zipcode,Leona
ZCTA5 75855,48,2952,41131,816,94400,2480,1281,2256,271,916,863,127,79,1793,1208,585,1208,1018,190,2020-01-01,zipcode,Oakwood
ZCTA5 75930,48,1655,29038,892,67700,1416,893,1217,230,514,297,140,36,1071,734,337,734,664,70,2020-01-01,zipcode,Bronson
ZCTA5 75944,48,936,46458,658,75800,839,479,783,100,278,267,105,33,753,475,278,475,455,20,2020-01-01,zipcode,Etoile
ZCTA5 75964,48,19410,46215,770,95100,13796,5380,11940,3225,3567,3197,1085,866,7676,6556,1120,6556,4089,2467,2020-01-01,zipcode,Nacogdoches
ZCTA5 75977,48,444,28365,-666666666,45500,334,126,322,60,144,118,0,0,318,199,119,199,168,31,2020-01-01,zipcode,Wiergate
ZCTA5 75980,48,2255,36750,806,76700,1877,1063,1611,267,551,666,102,25,1946,949,997,949,790,159,2020-01-01,zipcode,Zavalla
ZCTA5 75764,48,212,66346,488,49300,158,44,129,35,43,44,7,0,88,80,8,80,45,35,2020-01-01,zipcode,Gallatin
ZCTA5 75840,48,6297,60147,755,142400,4749,1997,4129,793,1318,1305,571,142,3286,2278,1008,2278,1667,611,2020-01-01,zipcode,Fairfield
ZCTA5 75853,48,559,36930,660,-666666666,547,275,494,42,278,161,9,4,448,294,154,294,210,84,2020-01-01,zipcode,Montalba
ZCTA5 75859,48,1825,43640,1310,137100,1620,935,1522,165,509,435,331,82,1476,894,582,894,733,161,2020-01-01,zipcode,Streetman
ZCTA5 75933,48,1049,24583,-666666666,60200,899,454,831,175,347,257,52,0,458,393,65,393,346,47,2020-01-01,zipcode,Call
ZCTA5 75934,48,201,83438,-666666666,68500,183,40,156,0,40,73,34,9,151,72,79,72,51,21,2020-01-01,zipcode,Camden
ZCTA5 75941,48,8737,51618,396,87700,6687,3389,5758,1425,1642,1899,582,210,3007,2536,471,2536,1969,567,2020-01-01,zipcode,Diboll
ZCTA5 75961,48,15447,36483,770,110500,12006,4017,9062,1628,2967,2847,1119,501,7480,6063,1417,6063,2976,3087,2020-01-01,zipcode,Nacogdoches
ZCTA5 75972,48,6252,40222,629,69400,5141,2516,4667,936,2087,899,481,264,3706,2795,911,2795,2007,788,2020-01-01,zipcode,San augustine
ZCTA5 75074,48,53459,70345,1380,244300,42058,11208,34540,5961,6340,8979,8761,4499,19528,18574,954,18574,9393,9181,2020-01-01,zipcode,Plano
ZCTA5 75088,48,26823,94946,1618,232900,21516,6237,19051,1156,4582,6607,4427,2279,9640,9308,332,9308,7776,1532,2020-01-01,zipcode,Rowlett
ZCTA5 75089,48,37310,107417,1593,239900,28771,7715,25122,1630,5403,8963,6317,2809,12215,11895,320,11895,9832,2063,2020-01-01,zipcode,Rowlett
ZCTA5 75101,48,643,43990,989,80700,487,166,418,135,159,101,18,5,255,231,24,231,122,109,2020-01-01,zipcode,Bardwell
ZCTA5 78751,48,16138,61735,1317,482100,15217,2671,12477,152,1079,2158,5113,3975,9447,8446,1001,8446,2124,6322,2020-01-01,zipcode,Austin
ZCTA5 78828,48,94,72813,-666666666,-666666666,94,72,94,0,11,58,13,12,273,63,210,63,63,0,2020-01-01,zipcode,Barksdale
ZCTA5 78572,48,80135,45274,790,97600,58985,28233,48496,13763,12391,11413,7675,3254,30707,24758,5949,24758,17840,6918,2020-01-01,zipcode,Mission
ZCTA5 78582,48,44047,35441,596,82900,30838,11817,24092,9986,6354,5103,1831,818,13031,10957,2074,10957,8376,2581,2020-01-01,zipcode,Rio grande city
ZCTA5 78592,48,752,29196,580,33200,625,330,491,279,127,68,17,0,251,223,28,223,183,40,2020-01-01,zipcode,Santa maria
ZCTA5 78597,48,2798,58986,1150,422700,2595,946,2446,159,151,848,735,553,7281,1477,5804,1477,1036,441,2020-01-01,zipcode,South padre island
ZCTA5 78609,48,1999,59898,845,182100,1743,839,1636,88,545,624,191,188,1612,850,762,850,658,192,2020-01-01,zipcode,Buchanan dam
ZCTA5 78610,48,39498,84114,1349,274800,29692,7942,25397,2122,6262,6785,6958,3270,13749,13284,465,13284,10341,2943,2020-01-01,zipcode,Buda
ZCTA5 78666,48,81844,45660,1091,186400,71350,25255,43547,5092,12011,12633,8921,4890,31555,29205,2350,29205,11069,18136,2020-01-01,zipcode,San marcos
ZCTA5 78671,48,659,64740,-666666666,162000,571,209,492,222,57,94,111,8,278,229,49,229,174,55,2020-01-01,zipcode,Stonewall
ZCTA5 08241,34,1093,140357,1583,298800,938,297,887,59,175,307,176,170,483,442,41,442,418,24,2020-01-01,zipcode,Port republic
ZCTA5 08093,34,9000,59328,1055,158800,7408,2296,6538,732,3098,1657,718,333,4210,3753,457,3753,2348,1405,2020-01-01,zipcode,Westville
ZCTA5 08095,34,15,-666666666,-666666666,-666666666,15,0,15,8,7,0,0,0,24,7,17,7,7,0,2020-01-01,zipcode,Winslow
ZCTA5 08096,34,35187,78399,1206,196500,29160,9890,25623,2372,8644,6775,5452,2380,14931,13638,1293,13638,10103,3535,2020-01-01,zipcode,Woodbury
ZCTA5 08104,34,22187,26784,885,66900,16276,7146,14010,3766,5711,3424,549,560,10310,8832,1478,8832,3281,5551,2020-01-01,zipcode,Camden
ZCTA5 08110,34,19124,66371,996,139400,14439,4830,11633,3054,3276,3280,1610,413,6468,5868,600,5868,4231,1637,2020-01-01,zipcode,Pennsauken
ZCTA5 08203,34,8725,75329,1300,362100,8018,3427,7347,748,1802,1986,1828,983,9472,4151,5321,4151,2931,1220,2020-01-01,zipcode,Brigantine
ZCTA5 08210,34,16409,75880,1295,255500,13503,5075,12073,1028,3890,3919,2240,996,7989,6614,1375,6614,5399,1215,2020-01-01,zipcode,Cape may court house
ZCTA5 08225,34,8103,84018,1256,225600,6662,2445,5875,563,1550,1448,1458,856,3086,2903,183,2903,2616,287,2020-01-01,zipcode,Northfield
ZCTA5 08244,34,10376,62241,1124,219900,8354,2602,7355,693,2583,2023,1202,854,5695,4460,1235,4460,2468,1992,2020-01-01,zipcode,Somers point
ZCTA5 08251,34,10559,60191,1270,185700,8541,2958,7587,821,3011,2283,1120,352,6623,4555,2068,4555,3653,902,2020-01-01,zipcode,Villas
ZCTA5 08008,34,6896,91483,1290,826000,6429,3431,6054,58,1244,1159,2149,1444,17522,3356,14166,3356,3078,278,2020-01-01,zipcode,Beach haven
ZCTA5 08022,34,9258,97008,1209,324900,7978,3418,6874,366,1899,1552,1839,1218,3832,3729,103,3729,3515,214,2020-01-01,zipcode,Columbus
ZCTA5 08005,34,24444,78389,1693,269200,20855,9358,18064,1154,6900,4841,3355,1814,11005,9660,1345,9660,8562,1098,2020-01-01,zipcode,Barnegat
ZCTA5 08511,34,1226,77708,956,242800,958,192,827,105,288,191,161,82,477,472,5,472,349,123,2020-01-01,zipcode,Cookstown
ZCTA5 08528,34,147,-666666666,-666666666,-666666666,129,0,129,0,0,18,32,79,50,50,0,50,35,15,2020-01-01,zipcode,Kingston
ZCTA5 08328,34,1636,66094,1426,178600,1323,487,1190,172,555,325,99,39,657,657,0,657,557,100,2020-01-01,zipcode,Malaga
ZCTA5 08312,34,7933,85250,963,213000,6369,2017,5571,454,1908,1639,1027,543,3256,2971,285,2971,2318,653,2020-01-01,zipcode,Clayton
ZCTA5 08323,34,457,79750,1096,222900,395,163,353,19,98,125,69,42,272,200,72,200,162,38,2020-01-01,zipcode,Greenwich
ZCTA5 08327,34,5379,68816,1254,128100,5228,5077,5060,1214,2507,1092,189,58,257,192,65,192,125,67,2020-01-01,zipcode,Leesburg
ZCTA5 08349,34,2390,50363,1356,123800,1769,829,1466,133,747,476,96,14,997,809,188,809,559,250,2020-01-01,zipcode,Port norris
ZCTA5 08361,34,18334,85335,1073,218500,15048,6379,12559,1350,3732,3046,2835,1596,6932,6392,540,6392,5152,1240,2020-01-01,zipcode,Vineland
ZCTA5 08502,34,11244,201984,2146,635000,8785,2440,7358,53,632,1076,2296,3301,3757,3654,103,3654,3011,643,2020-01-01,zipcode,Belle mead
ZCTA5 08505,34,17418,95776,1274,293000,14091,4273,12245,498,3225,3327,3343,1852,7150,6729,421,6729,4953,1776,2020-01-01,zipcode,Bordentown
ZCTA5 08512,34,10880,113116,1364,521600,9096,3577,7897,512,1680,1160,2209,2336,4571,4264,307,4264,2516,1748,2020-01-01,zipcode,Cranbury
ZCTA5 08514,34,4964,103427,1661,391600,4195,1536,3600,164,1082,918,945,491,2162,2023,139,2023,1860,163,2020-01-01,zipcode,Cream ridge
ZCTA5 08553,34,655,111346,1700,515300,522,203,448,15,34,54,156,189,271,234,37,234,206,28,2020-01-01,zipcode,Rocky hill
ZCTA5 08555,34,913,110625,2054,317600,629,199,564,15,131,143,168,107,299,288,11,288,232,56,2020-01-01,zipcode,Roosevelt
ZCTA5 08561,34,596,-666666666,-666666666,369200,437,154,369,77,47,74,88,83,172,172,0,172,112,60,2020-01-01,zipcode,Windsor
ZCTA5 08530,34,7364,108963,1389,444500,6411,2178,5810,352,1205,1240,1517,1496,3236,2958,278,2958,2141,817,2020-01-01,zipcode,Lambertville
ZCTA5 36874,01,8892,56489,1046,172300,7061,3131,6278,542,2111,2383,753,489,4022,3317,705,3317,2917,400,2020-01-01,zipcode,Salem
ZCTA5 36875,01,3488,55070,761,154800,2966,1384,2682,244,805,1269,179,185,1718,1499,219,1499,1185,314,2020-01-01,zipcode,Seale
ZCTA5 36879,01,2637,120110,579,267100,1988,625,1792,146,331,316,546,453,1071,916,155,916,798,118,2020-01-01,zipcode,Waverly
ZCTA5 36907,01,1531,29231,843,66400,1294,847,1106,216,399,223,127,141,1076,788,288,788,698,90,2020-01-01,zipcode,Cuba
ZCTA5 36033,01,3824,48482,589,93500,3091,1508,2860,451,1332,626,293,158,2259,1336,923,1336,1074,262,2020-01-01,zipcode,Georgiana
ZCTA5 36277,01,5804,57274,841,109000,4531,1933,3979,562,1209,1471,457,280,2166,1981,185,1981,1598,383,2020-01-01,zipcode,Weaver
ZCTA5 36362,01,5715,61769,1176,-666666666,3822,961,2462,33,356,1119,787,167,1510,1427,83,1427,9,1418,2020-01-01,zipcode,Fort rucker
ZCTA5 36541,01,15135,63566,1056,121900,11240,4295,9783,1631,3646,3359,689,458,5996,5262,734,5262,4794,468,2020-01-01,zipcode,Grand bay
ZCTA5 36482,01,785,35438,-666666666,83600,712,451,638,198,198,136,86,20,508,345,163,345,302,43,2020-01-01,zipcode,Whatley
ZCTA5 36538,01,356,29500,-666666666,-666666666,317,235,312,148,119,33,12,0,328,178,150,178,178,0,2020-01-01,zipcode,Frankville
ZCTA5 36548,01,1019,102542,-666666666,162500,800,371,706,38,186,329,48,105,541,397,144,397,389,8,2020-01-01,zipcode,Leroy
ZCTA5 36549,01,5825,51285,1035,156700,4977,2798,4458,301,1560,1515,867,215,2732,2235,497,2235,1883,352,2020-01-01,zipcode,Lillian
ZCTA5 36550,01,198,-666666666,-666666666,-666666666,198,83,198,39,75,20,33,31,156,116,40,116,83,33,2020-01-01,zipcode,Little river
ZCTA5 36560,01,3246,38164,749,69000,2824,1431,2446,701,1059,454,175,57,1372,1183,189,1183,877,306,2020-01-01,zipcode,Mount vernon
ZCTA5 36561,01,6774,85503,1351,356800,6028,2572,5530,231,1158,1349,1950,842,13520,3219,10301,3219,2501,718,2020-01-01,zipcode,Orange beach
ZCTA5 36580,01,5730,47664,804,183000,4487,1981,3762,866,989,1174,528,205,2535,2089,446,2089,1774,315,2020-01-01,zipcode,Summerdale
ZCTA5 36618,01,16948,46716,1037,112600,13976,5878,11530,1082,3743,3649,1955,1101,7212,6579,633,6579,4949,1630,2020-01-01,zipcode,Mobile
ZCTA5 36720,01,993,19762,-666666666,-666666666,759,455,485,146,195,99,41,4,413,310,103,310,252,58,2020-01-01,zipcode,Alberta
ZCTA5 36750,01,2616,54013,658,123900,1945,977,1719,186,848,555,49,81,1111,916,195,916,704,212,2020-01-01,zipcode,Maplesville
ZCTA5 36769,01,2229,32727,533,66000,1803,1076,1564,262,817,338,99,48,1251,928,323,928,648,280,2020-01-01,zipcode,Pine hill
ZCTA5 36773,01,294,25385,725,-666666666,245,158,192,38,32,98,18,6,237,142,95,142,74,68,2020-01-01,zipcode,Safford
ZCTA5 36775,01,1274,47500,946,80800,1033,618,988,271,342,320,51,4,809,600,209,600,376,224,2020-01-01,zipcode,Sardis
ZCTA5 36786,01,2442,20281,346,54900,1691,942,1597,273,718,312,230,64,1600,1041,559,1041,789,252,2020-01-01,zipcode,Uniontown
ZCTA5 77571,48,37699,77709,1130,162300,29559,9966,25303,2943,8068,9893,2944,1455,13987,13195,792,13195,9619,3576,2020-01-01,zipcode,La porte
ZCTA5 77584,48,91993,107340,1476,269000,68791,19212,60238,3469,7010,16328,20240,13191,33035,31048,1987,31048,23114,7934,2020-01-01,zipcode,Pearland
ZCTA5 77614,48,408,-666666666,-666666666,105600,342,214,331,63,143,125,0,0,258,176,82,176,140,36,2020-01-01,zipcode,Deweyville
ZCTA5 08345,34,598,54886,1313,160700,513,241,457,91,236,68,51,11,415,283,132,283,258,25,2020-01-01,zipcode,Newport
ZCTA5 08360,34,42225,52826,1063,157300,32215,12228,27580,5785,10342,7650,2781,1022,15850,15066,784,15066,9324,5742,2020-01-01,zipcode,Vineland
ZCTA5 08540,34,51813,154859,1967,650300,41192,14796,33279,973,1970,3002,10206,17128,19514,18143,1371,18143,11795,6348,2020-01-01,zipcode,Princeton
ZCTA5 08554,34,4208,89886,1332,163400,3288,860,2804,82,1079,937,556,150,1695,1625,70,1625,1343,282,2020-01-01,zipcode,Roebling
ZCTA5 08619,34,22416,83589,1445,255500,19194,6052,16731,1303,4778,4473,4420,1757,9650,9031,619,9031,6337,2694,2020-01-01,zipcode,Trenton
ZCTA5 08620,34,11904,97250,1043,277600,10459,4566,8529,632,2756,2868,1632,641,4255,3945,310,3945,3170,775,2020-01-01,zipcode,Trenton
ZCTA5 08628,34,9100,83208,1420,290500,8081,3325,7306,251,1600,1099,2600,1756,4508,4133,375,4133,2605,1528,2020-01-01,zipcode,Trenton
ZCTA5 08701,34,104186,52530,1414,359800,56015,25229,43342,5039,12769,11578,8061,5895,26616,24079,2537,24079,12251,11828,2020-01-01,zipcode,Lakewood
ZCTA5 08723,34,33059,84484,1418,298900,27200,9551,23905,1942,8583,7147,4131,2102,14206,12933,1273,12933,9902,3031,2020-01-01,zipcode,Brick
ZCTA5 08734,34,8729,99357,-666666666,325600,7517,2921,6558,331,2016,1921,1376,914,3364,3082,282,3082,2821,261,2020-01-01,zipcode,Lanoka harbor
ZCTA5 08752,34,2157,60700,1322,662000,1967,992,1889,26,505,464,502,392,3984,1248,2736,1248,954,294,2020-01-01,zipcode,Seaside park
ZCTA5 08759,34,33318,42810,1078,131700,31693,21486,30713,3072,12693,8216,4321,2411,22130,19639,2491,19639,16892,2747,2020-01-01,zipcode,Manchester township
ZCTA5 08812,34,14008,103528,1226,335200,11201,3570,9259,498,2886,2094,2650,1131,4920,4551,369,4551,3570,981,2020-01-01,zipcode,Dunellen
ZCTA5 76466,48,125,-666666666,-666666666,-666666666,125,38,125,0,53,72,0,0,259,91,168,91,91,0,2020-01-01,zipcode,Olden
ZCTA5 76475,48,1204,40579,606,77900,924,458,868,144,265,308,87,64,938,447,491,447,318,129,2020-01-01,zipcode,Strawn
ZCTA5 76486,48,970,41806,533,182500,827,358,768,70,290,317,75,16,598,408,190,408,359,49,2020-01-01,zipcode,Perrin
ZCTA5 76513,48,42162,68099,960,179300,31075,10501,25267,2565,6466,8609,4509,3118,15120,14123,997,14123,9398,4725,2020-01-01,zipcode,Belton
ZCTA5 76518,48,1810,49211,671,96800,1368,624,1077,156,506,303,105,7,635,550,85,550,443,107,2020-01-01,zipcode,Buckholts
ZCTA5 76519,48,350,-666666666,-666666666,140800,272,118,233,40,81,58,20,34,316,153,163,153,120,33,2020-01-01,zipcode,Burlington
ZCTA5 76570,48,2780,38700,600,72000,2038,1184,1730,256,719,393,302,60,1341,894,447,894,712,182,2020-01-01,zipcode,Rosebud
ZCTA5 76571,48,9007,88056,760,283700,6861,2657,6095,192,1525,1832,1541,1005,3378,3096,282,3096,2631,465,2020-01-01,zipcode,Salado
ZCTA5 76640,48,3110,41295,810,88800,2303,1131,2027,298,844,659,187,39,1303,1083,220,1083,770,313,2020-01-01,zipcode,Elm mott
ZCTA5 76642,48,6628,46919,661,147800,5331,2817,4567,745,1452,1415,745,210,2984,2403,581,2403,1697,706,2020-01-01,zipcode,Groesbeck
ZCTA5 76671,48,1748,55069,743,148500,1478,767,1317,163,524,464,101,65,1104,703,401,703,589,114,2020-01-01,zipcode,Morgan
ZCTA5 76801,48,24636,46793,803,98600,20083,8397,16673,2402,5905,5159,2304,903,11844,9368,2476,9368,6177,3191,2020-01-01,zipcode,Brownwood
ZCTA5 76689,48,3821,56058,950,151600,2947,1005,2507,303,761,957,337,149,1797,1454,343,1454,1146,308,2020-01-01,zipcode,Valley mills
ZCTA5 76691,48,6479,68112,869,141300,5040,1801,4397,517,1455,1535,576,314,2707,2316,391,2316,1798,518,2020-01-01,zipcode,West
ZCTA5 78008,48,351,-666666666,-666666666,-666666666,323,201,323,143,78,33,29,40,262,183,79,183,139,44,2020-01-01,zipcode,Campbellton
ZCTA5 78375,48,2982,39316,643,70800,2547,1053,2102,596,826,321,302,57,1300,1001,299,1001,688,313,2020-01-01,zipcode,Premont
ZCTA5 78340,48,437,46303,1179,130800,370,138,346,26,161,101,35,23,350,201,149,201,173,28,2020-01-01,zipcode,Bayside
ZCTA5 78371,48,170,-666666666,-666666666,67600,159,89,105,0,38,67,0,0,229,75,154,75,56,19,2020-01-01,zipcode,Oilton
ZCTA5 78372,48,4967,41328,821,78100,3234,1726,2801,612,1336,670,141,42,2105,1363,742,1363,976,387,2020-01-01,zipcode,Orange grove
ZCTA5 77623,48,634,59265,-666666666,77800,577,227,543,35,267,134,50,57,353,262,91,262,248,14,2020-01-01,zipcode,High island
ZCTA5 77625,48,9997,56939,822,84300,8290,4046,6736,1261,2768,1987,463,257,4756,3732,1024,3732,2921,811,2020-01-01,zipcode,Kountze
ZCTA5 77650,48,1930,57429,604,296500,1768,1144,1638,114,754,575,130,65,2739,986,1753,986,829,157,2020-01-01,zipcode,Port bolivar
ZCTA5 77656,48,16744,56761,816,109600,13301,5923,11756,1231,4951,3655,1525,394,7635,6156,1479,6156,4950,1206,2020-01-01,zipcode,Silsbee
ZCTA5 77659,48,5649,84205,983,158300,3952,1745,3375,298,1177,1059,649,192,2072,1797,275,1797,1447,350,2020-01-01,zipcode,Sour lake
ZCTA5 77855,48,218,-666666666,-666666666,-666666666,114,46,114,24,48,42,0,0,173,64,109,64,22,42,2020-01-01,zipcode,Flynn
ZCTA5 77865,48,2154,53283,1096,117700,1687,922,1366,148,489,520,146,63,922,779,143,779,677,102,2020-01-01,zipcode,Marquez
ZCTA5 77873,48,1272,47426,558,156000,1028,290,744,35,232,204,177,96,665,543,122,543,468,75,2020-01-01,zipcode,Richards
ZCTA5 77901,48,42620,45898,917,107300,32699,11642,26402,6347,8808,7742,2551,954,16967,14584,2383,14584,8205,6379,2020-01-01,zipcode,Victoria
ZCTA5 77904,48,28838,79938,996,199200,22335,8370,19801,1470,4994,7787,3559,1991,11894,10695,1199,10695,7600,3095,2020-01-01,zipcode,Victoria
ZCTA5 77951,48,1534,30545,660,50500,1226,557,1064,311,496,193,64,0,727,502,225,502,347,155,2020-01-01,zipcode,Bloomington
ZCTA5 77954,48,11047,55135,890,133700,8974,4695,7981,1517,3242,2236,732,254,4373,3374,999,3374,2176,1198,2020-01-01,zipcode,Cuero
ZCTA5 77973,48,25,-666666666,-666666666,-666666666,25,8,15,7,8,0,0,0,7,7,0,7,0,7,2020-01-01,zipcode,Mcfaddin
ZCTA5 77983,48,2414,50781,1066,113500,1729,693,1451,351,406,494,145,55,1449,911,538,911,762,149,2020-01-01,zipcode,Seadrift
ZCTA5 77083,48,78240,54360,1120,161900,60354,20049,48933,10619,12983,14511,7179,3641,23296,22584,712,22584,14363,8221,2020-01-01,zipcode,Houston
ZCTA5 77367,48,42,-666666666,-666666666,-666666666,41,20,24,10,14,0,0,0,68,14,54,14,14,0,2020-01-01,zipcode,Riverside
ZCTA5 77354,48,39843,91566,1237,282500,29821,10793,26274,2187,7282,7697,6438,2670,14261,13208,1053,13208,9929,3279,2020-01-01,zipcode,Magnolia
ZCTA5 77358,48,5345,64516,584,178000,4035,1592,3318,403,1342,1219,190,164,2486,1745,741,1745,1480,265,2020-01-01,zipcode,New waverly
ZCTA5 77363,48,2961,59792,-666666666,204500,2620,1310,2420,336,669,539,670,206,1578,1333,245,1333,1207,126,2020-01-01,zipcode,Plantersville
ZCTA5 77369,48,612,45219,-666666666,70300,575,400,543,246,126,127,44,0,417,269,148,269,209,60,2020-01-01,zipcode,Rye
ZCTA5 77380,48,28014,73013,1365,268900,23596,7323,20729,761,2981,6335,7081,3571,15015,13454,1561,13454,4988,8466,2020-01-01,zipcode,Spring
ZCTA5 77401,48,19428,184332,1833,826700,14985,5321,13440,308,707,1694,4515,6216,7809,7057,752,7057,6004,1053,2020-01-01,zipcode,Bellaire
ZCTA5 77412,48,0,-666666666,-666666666,-666666666,0,0,0,0,0,0,0,0,5,0,5,0,0,0,2020-01-01,zipcode,Altair
ZCTA5 77430,48,1867,81188,-666666666,195600,1364,620,1159,119,304,319,247,170,829,649,180,649,615,34,2020-01-01,zipcode,Damon
ZCTA5 77433,48,94345,112167,1659,294900,64516,19081,55432,3374,9337,15194,18986,8541,29323,27750,1573,27750,22875,4875,2020-01-01,zipcode,Cypress
ZCTA5 77442,48,1286,45000,607,123400,748,322,607,123,266,153,36,29,467,296,171,296,223,73,2020-01-01,zipcode,Garwood
ZCTA5 77457,48,560,23750,694,121600,472,256,448,107,96,218,25,2,1084,271,813,271,229,42,2020-01-01,zipcode,Matagorda
ZCTA5 77458,48,269,97676,-666666666,94500,269,49,184,78,39,56,11,0,173,145,28,145,127,18,2020-01-01,zipcode,Midfield
ZCTA5 77461,48,12133,74092,1027,209400,9165,3617,8007,1532,2573,2062,1377,463,4428,4117,311,4117,3146,971,2020-01-01,zipcode,Needville
ZCTA5 77467,48,16,-666666666,-666666666,-666666666,16,0,16,0,0,16,0,0,32,16,16,16,0,16,2020-01-01,zipcode,Pierce
ZCTA5 77471,48,38430,55333,1089,168500,28882,10658,23979,5315,6967,7471,3064,1162,14102,12653,1449,12653,7006,5647,2020-01-01,zipcode,Rosenberg
ZCTA5 77483,48,360,78415,-666666666,134100,168,0,168,11,96,61,0,0,291,104,187,104,104,0,2020-01-01,zipcode,Wadsworth
ZCTA5 77504,48,25044,43991,1009,153900,18967,6285,15501,3246,5429,4269,1824,733,10034,8965,1069,8965,3763,5202,2020-01-01,zipcode,Pasadena
ZCTA5 77545,48,23051,81135,1693,197800,17705,4778,14840,2236,3563,4707,2848,1486,7681,7242,439,7242,5877,1365,2020-01-01,zipcode,Fresno
ZCTA5 77566,48,29362,83709,1222,205900,22647,7317,19316,944,4966,6813,4771,1822,11684,10865,819,10865,7050,3815,2020-01-01,zipcode,Lake jackson
ZCTA5 77575,48,16209,53506,871,128200,12333,5837,10288,1569,4370,3042,803,504,7188,6013,1175,6013,4553,1460,2020-01-01,zipcode,Liberty
ZCTA5 77578,48,22822,92891,1081,273800,17279,5198,14596,1238,3210,5268,2952,1928,8250,7559,691,7559,6436,1123,2020-01-01,zipcode,Manvel
ZCTA5 77611,48,8608,86680,841,156600,6756,2147,5848,470,1778,2047,1190,363,3816,3306,510,3306,2386,920,2020-01-01,zipcode,Bridge city
ZCTA5 77617,48,47,-666666666,-666666666,-666666666,47,47,47,9,9,12,17,0,169,38,131,38,29,9,2020-01-01,zipcode,
ZCTA5 77622,48,1396,94896,1104,186500,1107,386,759,44,245,243,187,40,534,455,79,455,407,48,2020-01-01,zipcode,Hamshire
ZCTA5 77655,48,264,61319,-666666666,120000,260,129,246,33,128,64,8,13,191,155,36,155,138,17,2020-01-01,zipcode,Sabine pass
ZCTA5 77338,48,45092,57566,1063,157500,33351,9986,28637,4165,8375,11351,3699,1047,16321,15509,812,15509,8384,7125,2020-01-01,zipcode,Humble
ZCTA5 77339,48,42193,75388,1388,213500,32593,11873,28379,960,5795,10395,6983,4246,18149,16616,1533,16616,10268,6348,2020-01-01,zipcode,Kingwood
ZCTA5 77362,48,4992,71774,1684,180600,3912,1660,3120,235,951,976,870,88,1676,1605,71,1605,1324,281,2020-01-01,zipcode,Pinehurst
ZCTA5 77364,48,2130,39461,813,118200,1839,1079,1794,265,531,567,272,159,1523,1012,511,1012,875,137,2020-01-01,zipcode,Pointblank
ZCTA5 77365,48,34286,77414,1112,212300,25888,9688,21568,3618,4810,8059,3485,1596,12388,11263,1125,11263,9237,2026,2020-01-01,zipcode,Porter
ZCTA5 77371,48,7326,48712,809,89100,5834,2912,5038,827,2435,1419,276,81,3019,2202,817,2202,1668,534,2020-01-01,zipcode,Shepherd
ZCTA5 77429,48,90506,109325,1374,266000,66797,19861,58888,3181,8583,18563,19812,8749,31546,30278,1268,30278,25675,4603,2020-01-01,zipcode,Cypress
ZCTA5 77444,48,582,-666666666,-666666666,235600,427,143,356,66,182,83,21,4,330,222,108,222,156,66,2020-01-01,zipcode,Guy
ZCTA5 77454,48,0,-666666666,-666666666,-666666666,0,0,0,0,0,0,0,0,0,0,0,0,0,0,2020-01-01,zipcode,Lissie
ZCTA5 77468,48,24,-666666666,-666666666,-666666666,24,13,24,0,0,11,0,13,33,13,20,13,13,0,2020-01-01,zipcode,Pledger
ZCTA5 77473,48,38,-666666666,-666666666,-666666666,27,17,27,0,4,23,0,0,30,24,6,24,1,23,2020-01-01,zipcode,San felipe
ZCTA5 77475,48,868,52102,-666666666,175200,778,428,690,33,349,196,75,37,661,356,305,356,356,0,2020-01-01,zipcode,Sheridan
ZCTA5 77489,48,39444,67431,1457,139700,30945,9636,25740,2841,7837,8731,4396,1935,12943,12560,383,12560,9349,3211,2020-01-01,zipcode,Missouri city
ZCTA5 77507,48,326,63178,1436,-666666666,326,54,284,0,109,54,121,0,283,219,64,219,0,219,2020-01-01,zipcode,Pasadena
ZCTA5 77511,48,50140,64855,1057,163800,37956,14100,31760,5276,9357,11528,4197,1402,18932,16877,2055,16877,11503,5374,2020-01-01,zipcode,Alvin
ZCTA5 75473,48,3443,64433,647,96500,2792,1103,2537,353,993,748,313,130,1456,1300,156,1300,1187,113,2020-01-01,zipcode,Powderly
ZCTA5 75479,48,1987,54257,798,119500,1693,707,1556,171,589,512,220,64,788,690,98,690,543,147,2020-01-01,zipcode,Savoy
ZCTA5 75486,48,2311,66375,-666666666,143200,1835,657,1450,155,520,563,159,53,994,847,147,847,749,98,2020-01-01,zipcode,Sumner
ZCTA5 75496,48,3450,73011,808,132400,2790,1156,2312,280,911,702,281,138,1379,1137,242,1137,956,181,2020-01-01,zipcode,Wolfe city
ZCTA5 75550,48,775,50278,440,61800,656,285,544,58,223,168,89,6,395,272,123,272,236,36,2020-01-01,zipcode,Annona
ZCTA5 75560,48,1170,42862,1019,57600,1021,418,843,240,306,130,107,60,586,526,60,526,444,82,2020-01-01,zipcode,Douglassville
ZCTA5 75574,48,1369,55625,559,79400,1116,599,998,133,408,241,143,73,776,620,156,620,516,104,2020-01-01,zipcode,Simms
ZCTA5 75631,48,3029,61618,782,95700,2259,946,2025,210,531,913,212,159,1353,1050,303,1050,814,236,2020-01-01,zipcode,Beckville
ZCTA5 75077,48,38764,115313,1456,326800,30983,9931,26285,1037,4161,8708,9033,3346,13265,12871,394,12871,10529,2342,2020-01-01,zipcode,Lewisville
ZCTA5 75569,48,3554,38708,789,112700,2612,774,1885,102,686,824,70,203,1447,1367,80,1367,734,633,2020-01-01,zipcode,Nash
ZCTA5 75573,48,45,61250,-666666666,-666666666,32,13,32,5,7,9,7,4,18,13,5,13,9,4,2020-01-01,zipcode,Redwater
ZCTA5 75966,48,4534,36449,586,79800,3677,1782,3122,422,1428,866,317,89,2292,1647,645,1647,1178,469,2020-01-01,zipcode,Newton
ZCTA5 75643,48,2151,54375,645,116700,1752,841,1559,305,475,586,129,64,1204,857,347,857,674,183,2020-01-01,zipcode,Gary
ZCTA5 75681,48,2425,43906,715,128600,2122,971,1743,177,729,502,229,106,1232,1045,187,1045,924,121,2020-01-01,zipcode,Mount enterprise
ZCTA5 75683,48,4053,42049,919,102400,3374,1811,2887,527,952,1093,305,10,1843,1513,330,1513,1219,294,2020-01-01,zipcode,Ore city
ZCTA5 75691,48,3963,80838,816,127200,2916,812,2691,297,900,1068,301,125,2009,1411,598,1411,1097,314,2020-01-01,zipcode,Tatum
ZCTA5 75785,48,10931,50899,807,97800,9062,5112,7740,1426,2702,2539,821,252,3926,3382,544,3382,2566,816,2020-01-01,zipcode,Rusk
ZCTA5 75791,48,13952,68539,1061,163400,10644,3603,8866,769,1685,3782,1696,934,5137,4649,488,4649,3482,1167,2020-01-01,zipcode,Whitehouse
ZCTA5 75833,48,2448,47933,776,135400,2121,1187,1921,181,655,662,271,152,1882,1025,857,1025,776,249,2020-01-01,zipcode,Centerville
ZCTA5 75835,48,11425,37356,663,108900,9189,4678,7878,1560,2721,2298,939,360,6136,4630,1506,4630,3072,1558,2020-01-01,zipcode,Crockett
ZCTA5 75861,48,9081,48365,810,83200,8662,7791,8268,2258,3227,2402,260,121,1103,715,388,715,411,304,2020-01-01,zipcode,Tennessee colony
ZCTA5 75925,48,3913,40776,656,87000,3084,1425,2398,414,805,854,239,86,1736,1447,289,1447,917,530,2020-01-01,zipcode,Alto
ZCTA5 75936,48,951,53750,-666666666,107600,757,380,639,94,223,227,74,21,546,334,212,334,287,47,2020-01-01,zipcode,Chester
ZCTA5 75943,48,1338,45208,959,124000,965,386,811,106,294,249,136,26,591,462,129,462,381,81,2020-01-01,zipcode,Douglass
ZCTA5 75788,48,25,-666666666,-666666666,-666666666,25,25,25,0,0,25,0,0,49,25,24,25,0,25,2020-01-01,zipcode,Sacul
ZCTA5 75838,48,679,41250,-666666666,190600,561,323,457,96,170,136,44,11,383,243,140,243,186,57,2020-01-01,zipcode,Donie
ZCTA5 75847,48,1745,39375,595,86500,1404,785,1328,227,474,320,215,92,1172,713,459,713,535,178,2020-01-01,zipcode,Kennard
ZCTA5 75852,48,3634,50764,867,119000,3392,2860,2965,613,1347,809,132,64,686,478,208,478,382,96,2020-01-01,zipcode,Midway
ZCTA5 36305,01,17018,72571,986,183200,13361,5023,11610,678,2711,4025,2444,1752,6989,6209,780,6209,4351,1858,2020-01-01,zipcode,Dothan
ZCTA5 36268,01,5980,54737,763,97300,4508,1700,3844,386,1584,1435,286,153,2731,2280,451,2280,1977,303,2020-01-01,zipcode,Munford
ZCTA5 36269,01,1836,55640,810,114200,1232,491,1140,136,514,313,126,51,718,654,64,654,498,156,2020-01-01,zipcode,Muscadine
ZCTA5 36303,01,31096,46961,727,145300,24444,10956,21157,2613,6222,7017,3380,1925,14384,11620,2764,11620,7029,4591,2020-01-01,zipcode,Dothan
ZCTA5 36311,01,2369,38235,585,76500,1958,975,1539,320,627,383,76,133,1286,966,320,966,777,189,2020-01-01,zipcode,Ariton
ZCTA5 36350,01,6677,39033,705,130300,5248,2010,4471,848,1349,1410,643,221,3113,2691,422,2691,1654,1037,2020-01-01,zipcode,Midland city
ZCTA5 36420,01,9552,46315,609,119700,7869,3505,6988,968,2264,2228,800,728,5043,4091,952,4091,2928,1163,2020-01-01,zipcode,Andalusia
ZCTA5 36451,01,4665,49815,626,104000,3789,1875,3398,506,1358,1124,300,110,2538,1906,632,1906,1493,413,2020-01-01,zipcode,Grove hill
ZCTA5 36470,01,35,-666666666,-666666666,-666666666,35,35,35,17,18,0,0,0,35,35,0,35,0,35,2020-01-01,zipcode,Perdue hill
ZCTA5 36473,01,96,62976,-666666666,113300,90,62,82,17,54,11,0,0,106,40,66,40,40,0,2020-01-01,zipcode,Range
ZCTA5 36518,01,2547,41512,757,131700,2168,1248,1846,352,698,569,145,82,1370,956,414,956,731,225,2020-01-01,zipcode,Chatom
ZCTA5 36526,01,34788,72997,1156,222300,26339,9601,23235,1227,5173,8038,5051,3746,14115,12975,1140,12975,9584,3391,2020-01-01,zipcode,Daphne
ZCTA5 36527,01,15586,96688,1275,267600,11693,4114,9790,423,1655,3137,2550,2025,5916,5577,339,5577,3994,1583,2020-01-01,zipcode,Daphne
ZCTA5 36551,01,10892,60746,883,164900,8715,3191,7572,588,2549,2701,1104,630,3908,3276,632,3276,2658,618,2020-01-01,zipcode,Loxley
ZCTA5 76445,48,486,30625,-666666666,-666666666,395,169,339,36,124,107,0,72,297,164,133,164,164,0,2020-01-01,zipcode,Desdemona
ZCTA5 76449,48,2351,58548,694,141000,2080,936,1963,183,618,750,276,136,3018,1010,2008,1010,856,154,2020-01-01,zipcode,Graford
ZCTA5 76450,48,13036,58427,716,144900,10269,3976,9099,1264,2747,2930,1462,696,6498,5352,1146,5352,4110,1242,2020-01-01,zipcode,Graham
ZCTA5 33073,12,35407,81727,1808,342800,27291,7162,22895,1682,6116,7275,6131,1691,12479,11776,703,11776,6633,5143,2020-01-01,zipcode,Pompano beach
ZCTA5 33134,12,39420,70983,1488,502400,32734,11973,29761,3035,5239,5988,8011,7488,18411,16297,2114,16297,8807,7490,2020-01-01,zipcode,Miami
ZCTA5 33136,12,17065,29897,981,253100,14060,5545,12570,2982,3839,3238,1697,814,7411,6497,914,6497,789,5708,2020-01-01,zipcode,Miami
ZCTA5 33145,12,30450,56239,1462,396800,26373,10239,23900,4099,6054,5205,4918,3624,12911,11710,1201,11710,6095,5615,2020-01-01,zipcode,Miami
ZCTA5 33156,12,33223,126688,1739,868600,25989,10096,22283,782,2832,4332,7030,7307,12726,11004,1722,11004,8100,2904,2020-01-01,zipcode,Miami
ZCTA5 33158,12,6233,159219,2205,690000,4774,1883,3991,57,330,561,1298,1745,2221,1983,238,1983,1893,90,2020-01-01,zipcode,Miami
ZCTA5 33811,12,23623,71224,1103,200100,19141,7082,16288,1592,5071,4883,3572,1170,9161,8064,1097,8064,6215,1849,2020-01-01,zipcode,Lakeland
ZCTA5 33841,12,9650,39663,783,107200,7667,3723,6550,1335,2839,1531,462,383,4121,3207,914,3207,2396,811,2020-01-01,zipcode,Fort meade
ZCTA5 33160,12,39704,50660,1585,286200,34126,14606,31488,2096,5064,10290,8213,5825,35825,19405,16420,19405,10855,8550,2020-01-01,zipcode,North miami beach
ZCTA5 33183,12,36673,60616,1603,281900,30968,11237,26288,3718,6931,7675,5468,2496,12593,12243,350,12243,7772,4471,2020-01-01,zipcode,Miami
ZCTA5 33306,12,3286,71159,1144,482200,3034,1010,2889,82,464,720,958,665,2188,1729,459,1729,1213,516,2020-01-01,zipcode,Fort lauderdale
ZCTA5 33311,12,75705,40684,1120,185500,57259,22892,47991,10865,17107,13401,4371,2247,26989,24216,2773,24216,10475,13741,2020-01-01,zipcode,Fort lauderdale
ZCTA5 33326,12,32586,93333,1893,404300,25588,8765,22215,857,3348,5919,6689,5402,13152,10632,2520,10632,7427,3205,2020-01-01,zipcode,Fort lauderdale
ZCTA5 33330,12,15355,131222,2628,528300,12380,4284,10162,787,1644,2801,2537,2393,4878,4569,309,4569,4167,402,2020-01-01,zipcode,Fort lauderdale
ZCTA5 33351,12,34774,56937,1519,244600,27178,7516,24136,2663,6519,7590,5365,1999,12698,11911,787,11911,6455,5456,2020-01-01,zipcode,Fort lauderdale
ZCTA5 33406,12,26653,64608,1309,229700,22052,7940,18231,3500,5942,4816,2862,1111,8870,8173,697,8173,5348,2825,2020-01-01,zipcode,West palm beach
ZCTA5 33428,12,43566,67202,1704,319000,34988,12310,30509,2674,7605,8524,7662,4044,16672,15030,1642,15030,10498,4532,2020-01-01,zipcode,Boca raton
ZCTA5 33432,12,21017,77952,1765,661500,19179,8209,17261,1001,2545,4522,5343,3850,15142,10751,4391,10751,6607,4144,2020-01-01,zipcode,Boca raton
ZCTA5 33438,12,388,-666666666,-666666666,131300,352,86,284,27,140,57,29,31,134,87,47,87,72,15,2020-01-01,zipcode,Canal point
ZCTA5 33460,12,32848,41561,1116,230400,25570,8995,22171,6778,5427,5663,2524,1779,12697,10887,1810,10887,4625,6262,2020-01-01,zipcode,Lake worth
ZCTA5 33849,12,728,39375,-666666666,88200,609,321,544,139,300,98,0,7,312,196,116,196,167,29,2020-01-01,zipcode,Kathleen
ZCTA5 33868,12,13051,48882,944,128800,10567,6057,9562,1933,3654,2571,938,466,4921,3873,1048,3873,3302,571,2020-01-01,zipcode,Polk city
ZCTA5 33870,12,22664,36619,781,91100,18955,10583,16973,3386,6349,4802,1595,841,11195,8700,2495,8700,5619,3081,2020-01-01,zipcode,Sebring
ZCTA5 33903,12,22616,48710,911,102500,20376,12140,19073,2183,6086,6617,2284,1903,15899,11394,4505,11394,9147,2247,2020-01-01,zipcode,North fort myers
ZCTA5 33917,12,30270,47441,935,114500,26850,14755,25395,3232,9019,8194,3103,1847,17650,13204,4446,13204,10711,2493,2020-01-01,zipcode,North fort myers
ZCTA5 33948,12,18322,50391,1127,197700,16541,9062,15486,1543,5156,5678,1952,1157,9071,7315,1756,7315,6150,1165,2020-01-01,zipcode,Port charlotte
ZCTA5 33991,12,23620,66088,1690,262000,18846,7938,16668,992,6195,5161,2939,1381,10198,8620,1578,8620,6903,1717,2020-01-01,zipcode,Cape coral
ZCTA5 33761,12,19239,57232,1284,188200,16690,8141,15753,989,4020,4889,3871,1984,9931,8736,1195,8736,6975,1761,2020-01-01,zipcode,Clearwater
ZCTA5 33765,12,15076,48400,1117,216500,13091,4925,11976,1417,3809,3837,1841,1072,6918,6372,546,6372,3571,2801,2020-01-01,zipcode,Clearwater
ZCTA5 33767,12,7493,87340,1750,526100,7048,4353,6703,266,1447,1630,1963,1397,8740,4049,4691,4049,3185,864,2020-01-01,zipcode,Clearwater beach
ZCTA5 33776,12,13043,78596,1534,313900,11037,4794,9776,295,2303,2808,2865,1505,5354,4805,549,4805,4366,439,2020-01-01,zipcode,Seminole
ZCTA5 33781,12,26265,43692,938,164500,21854,8485,19542,3765,6410,5529,2578,1260,11739,9974,1765,9974,6263,3711,2020-01-01,zipcode,Pinellas park
ZCTA5 33853,12,11674,41031,835,156800,9097,4021,8019,1547,2534,2461,951,526,5156,4408,748,4408,2194,2214,2020-01-01,zipcode,Lake wales
ZCTA5 33913,12,26232,86649,1480,314200,22373,11375,18487,1082,3937,5063,4916,3489,13486,9244,4242,9244,7834,1410,2020-01-01,zipcode,Fort myers
ZCTA5 78704,48,51422,78861,1476,596200,45740,8899,39129,2467,3765,7117,16907,8873,28993,26471,2522,26471,8758,17713,2020-01-01,zipcode,Austin
ZCTA5 78725,48,8303,74205,1552,190600,6612,1898,6151,1389,1510,1672,772,808,3128,3038,90,3038,2583,455,2020-01-01,zipcode,Austin
ZCTA5 78739,48,20631,169023,2619,493600,14814,4330,13724,154,756,2143,5785,4886,6973,6788,185,6788,6395,393,2020-01-01,zipcode,Austin
ZCTA5 78742,48,888,59792,1051,-666666666,649,238,551,176,153,155,33,34,291,273,18,273,170,103,2020-01-01,zipcode,Austin
ZCTA5 78834,48,8245,26538,722,58700,6120,3144,5015,1629,1537,1055,434,360,3365,2460,905,2460,1683,777,2020-01-01,zipcode,Carrizo springs
ZCTA5 78006,48,37568,97910,1337,374100,29412,11813,25746,1421,4724,7545,7480,4576,13603,12515,1088,12515,9165,3350,2020-01-01,zipcode,Boerne
ZCTA5 77530,48,32070,63155,880,116700,22859,8196,18012,5561,5939,4696,1348,468,9736,8888,848,8888,6384,2504,2020-01-01,zipcode,Channelview
ZCTA5 77550,48,21710,42179,939,180400,18948,7719,15753,2416,3494,5016,2881,1946,14586,10170,4416,10170,4333,5837,2020-01-01,zipcode,Galveston
ZCTA5 75862,48,10115,41069,620,89500,8232,4676,7349,1185,2819,2360,674,311,6395,4188,2207,4188,3113,1075,2020-01-01,zipcode,Trinity
ZCTA5 75926,48,1207,55057,643,79900,990,510,837,85,329,291,81,51,754,511,243,511,423,88,2020-01-01,zipcode,Apple springs
ZCTA5 75939,48,5682,46891,536,70200,4804,1801,3897,625,1700,1150,301,121,2407,1859,548,1859,1276,583,2020-01-01,zipcode,Corrigan
ZCTA5 75946,48,3851,45313,758,109700,3098,1506,2757,368,908,940,463,78,1818,1539,279,1539,1130,409,2020-01-01,zipcode,Garrison
ZCTA5 75968,48,2167,38542,547,70800,1659,785,1443,254,542,544,42,61,1138,868,270,868,672,196,2020-01-01,zipcode,Pineland
ZCTA5 75062,48,49296,57320,1084,175700,37841,10401,30358,7208,6411,7668,6496,2575,17165,16330,835,16330,7153,9177,2020-01-01,zipcode,Irving
ZCTA5 75069,48,37582,60955,1151,297200,29718,11070,24461,4364,5573,6238,5424,2862,15363,14063,1300,14063,7199,6864,2020-01-01,zipcode,Mckinney
ZCTA5 75098,48,58717,99224,1589,260500,44025,10933,37026,3250,7608,12570,9326,4272,18915,18172,743,18172,13983,4189,2020-01-01,zipcode,Wylie
ZCTA5 75105,48,248,26094,-666666666,137500,184,72,116,11,63,25,17,0,79,79,0,79,56,23,2020-01-01,zipcode,Chatfield
ZCTA5 75141,48,5814,34470,1125,80500,4478,3044,3649,1165,1440,874,101,69,1071,984,87,984,538,446,2020-01-01,zipcode,Hutchins
ZCTA5 75147,48,6951,44474,835,156100,5794,2428,4887,615,1829,1870,420,153,2772,2396,376,2396,1624,772,2020-01-01,zipcode,Mabank
ZCTA5 75154,48,42192,81323,1245,212100,31705,9416,26716,3001,7493,8666,4933,2623,14153,13504,649,13504,11032,2472,2020-01-01,zipcode,Red oak
ZCTA5 75158,48,4337,69853,960,215000,3480,1503,3112,349,1077,1182,340,164,1466,1328,138,1328,1179,149,2020-01-01,zipcode,Scurry
ZCTA5 75223,48,15002,57243,1062,133000,11553,3477,9438,3593,2057,1744,1376,668,5346,4705,641,4705,2195,2510,2020-01-01,zipcode,Dallas
ZCTA5 75225,48,22108,163935,1976,1127600,17498,7499,15815,260,560,1907,7806,5282,9784,9035,749,9035,7142,1893,2020-01-01,zipcode,Dallas
ZCTA5 75229,48,32739,105606,1144,430800,25287,7038,22209,5125,3250,3622,5973,4239,12057,11095,962,11095,8032,3063,2020-01-01,zipcode,Dallas
ZCTA5 75235,48,19198,50254,1239,192700,16229,4507,13514,3634,2623,2553,2514,2190,9229,8583,646,8583,2153,6430,2020-01-01,zipcode,Dallas
ZCTA5 75241,48,30863,35845,985,96700,22959,11486,19236,3721,6254,6240,2030,991,11557,10701,856,10701,6633,4068,2020-01-01,zipcode,Dallas
ZCTA5 75244,48,13552,97263,1485,448300,11289,2687,10102,334,902,1910,4147,2809,6824,6113,711,6113,3006,3107,2020-01-01,zipcode,Dallas
ZCTA5 75415,48,353,71542,-666666666,134600,312,208,191,35,82,55,8,11,87,81,6,81,71,10,2020-01-01,zipcode,Ben franklin
ZCTA5 75421,48,719,53359,727,103700,421,173,413,102,183,109,0,19,312,215,97,215,186,29,2020-01-01,zipcode,Brookston
ZCTA5 75453,48,2661,68333,1073,142100,2063,823,1730,184,615,600,285,46,1203,970,233,970,778,192,2020-01-01,zipcode,Lone oak
ZCTA5 75474,48,15912,53953,879,119700,12999,6021,11130,2326,3822,3251,1227,504,6736,5748,988,5748,4572,1176,2020-01-01,zipcode,Quinlan
ZCTA5 75477,48,1172,62763,583,-666666666,936,384,813,84,287,246,139,57,505,420,85,420,296,124,2020-01-01,zipcode,Roxton
ZCTA5 75492,48,369,54583,525,144200,289,147,279,28,99,101,45,6,211,171,40,171,155,16,2020-01-01,zipcode,Windom
ZCTA5 75561,48,5135,48265,729,87600,4098,1689,3623,506,1507,1025,410,175,2466,2075,391,2075,1477,598,2020-01-01,zipcode,Hooks
ZCTA5 75565,48,419,33125,-666666666,83100,260,167,215,56,110,38,11,0,162,125,37,125,79,46,2020-01-01,zipcode,Mc leod
ZCTA5 75572,48,3594,51136,588,59500,2904,1408,2534,379,1140,563,287,165,1813,1438,375,1438,1195,243,2020-01-01,zipcode,Queen city
ZCTA5 75605,48,32438,62048,963,194300,25911,9096,22211,1320,5329,9432,4277,1853,14713,13500,1213,13500,7376,6124,2020-01-01,zipcode,Longview
ZCTA5 75639,48,2756,32101,869,122100,2268,1321,1916,493,676,643,84,20,1526,1065,461,1065,954,111,2020-01-01,zipcode,De berry
ZCTA5 75670,48,18263,36065,740,75900,13967,6062,11393,2340,4142,3360,1012,539,7653,6358,1295,6358,3672,2686,2020-01-01,zipcode,Marshall
ZCTA5 76462,48,4412,84470,1045,202200,3543,1396,3040,283,1098,793,554,312,1644,1374,270,1374,1233,141,2020-01-01,zipcode,Lipan
ZCTA5 76464,48,516,41310,675,63500,467,204,443,79,111,83,118,52,419,262,157,262,201,61,2020-01-01,zipcode,Moran
ZCTA5 76476,48,3151,72103,883,165700,2358,926,2093,300,718,664,286,125,1129,1064,65,1064,882,182,2020-01-01,zipcode,Tolar
ZCTA5 76511,48,2426,42385,665,101700,1946,1022,1712,422,647,527,89,27,904,775,129,775,585,190,2020-01-01,zipcode,Bartlett
ZCTA5 33556,12,23679,112459,1265,402600,18567,6797,16427,590,2679,4665,5334,3159,9159,8310,849,8310,7459,851,2020-01-01,zipcode,Odessa
ZCTA5 33565,12,17922,55410,983,179900,13686,5931,12534,2040,4389,3769,1730,606,6697,6187,510,6187,4923,1264,2020-01-01,zipcode,Plant city
ZCTA5 33567,12,12349,73403,1082,215700,9919,3131,8528,1756,2743,1984,1499,546,4088,3868,220,3868,3062,806,2020-01-01,zipcode,Plant city
ZCTA5 33584,12,27006,54970,1102,189500,21322,8514,18811,2453,5644,6028,3402,1284,10155,9440,715,9440,7219,2221,2020-01-01,zipcode,Seffner
ZCTA5 33604,12,40309,44192,1000,174300,33051,10869,28784,4373,10446,8188,3926,1851,17282,15811,1471,15811,8710,7101,2020-01-01,zipcode,Tampa
ZCTA5 33618,12,28544,68245,1136,292500,23917,8447,21648,686,4912,6255,6177,3618,12967,12100,867,12100,8131,3969,2020-01-01,zipcode,Tampa
ZCTA5 33637,12,17919,50518,1148,167400,14493,4162,11872,1295,2883,3517,2582,1595,7746,7071,675,7071,3085,3986,2020-01-01,zipcode,Tampa
ZCTA5 33701,12,16632,46786,1097,380500,15162,6106,13707,651,2264,3744,3790,3258,12440,9120,3320,9120,3429,5691,2020-01-01,zipcode,Saint petersburg
ZCTA5 33704,12,17202,84295,1015,432900,14951,4898,13785,404,2222,3415,4426,3318,9327,8038,1289,8038,5780,2258,2020-01-01,zipcode,Saint petersburg
ZCTA5 79821,48,7044,40556,829,100600,5496,2850,4644,1153,1381,1534,433,143,2138,1878,260,1878,1493,385,2020-01-01,zipcode,Anthony
ZCTA5 79836,48,5804,42979,752,81500,4106,1623,3353,1027,1011,713,422,180,1922,1772,150,1772,1405,367,2020-01-01,zipcode,Clint
ZCTA5 79041,48,2711,42316,626,81000,2265,1115,1899,524,603,509,213,50,1312,1075,237,1075,822,253,2020-01-01,zipcode,Hale center
ZCTA5 79045,48,18706,50635,767,90500,13375,4558,10957,3086,4028,2508,933,402,7106,6046,1060,6046,3947,2099,2020-01-01,zipcode,Hereford
ZCTA5 79052,48,1322,40577,644,74400,1002,399,853,206,346,192,75,34,634,494,140,494,403,91,2020-01-01,zipcode,Kress
ZCTA5 79922,48,7890,81992,980,237600,6305,2207,5373,528,835,1304,1723,983,3086,2795,291,2795,2457,338,2020-01-01,zipcode,El paso
ZCTA5 07601,34,44266,71079,1493,306700,37522,11633,33582,4213,8637,7491,8746,4495,20836,19537,1299,19537,6583,12954,2020-01-01,zipcode,Hackensack
ZCTA5 07607,34,9626,98511,1581,396000,8088,3024,7182,443,1871,1816,1647,1405,3893,3717,176,3717,2574,1143,2020-01-01,zipcode,Maywood
ZCTA5 07626,34,8701,141706,2467,680500,6896,2478,5914,229,873,1196,1979,1637,3045,2917,128,2917,2357,560,2020-01-01,zipcode,Cresskill
ZCTA5 07632,34,5349,158042,3501,1086600,4314,1726,3943,98,517,498,1451,1379,2090,1906,184,1906,1632,274,2020-01-01,zipcode,Englewood cliffs
ZCTA5 07656,34,8751,143147,1491,605300,7427,2736,6345,202,1089,1251,2347,1456,3547,3315,232,3315,2743,572,2020-01-01,zipcode,Park ridge
ZCTA5 07657,34,11209,79696,1668,471400,9547,3186,8273,702,2247,1911,2468,945,4039,3865,174,3865,1800,2065,2020-01-01,zipcode,Ridgefield
ZCTA5 07661,34,11510,128231,1598,523900,9250,2876,7647,172,739,1656,3030,2050,4262,4119,143,4119,3128,991,2020-01-01,zipcode,River edge
ZCTA5 07701,34,23844,95419,1647,422900,20119,6565,18014,1205,4300,3801,5189,3519,10976,10559,417,10559,6824,3735,2020-01-01,zipcode,Red bank
ZCTA5 07757,34,5598,105038,-666666666,521900,4644,1840,4104,211,652,997,1349,895,2335,2258,77,2258,2015,243,2020-01-01,zipcode,Oceanport
ZCTA5 07003,34,49389,82114,1399,348400,39998,11041,34593,2701,8698,7632,9717,5845,19651,18732,919,18732,9809,8923,2020-01-01,zipcode,Bloomfield
ZCTA5 07004,34,7482,95969,2289,499500,5996,2200,5628,279,1497,969,1953,930,2932,2854,78,2854,2388,466,2020-01-01,zipcode,Fairfield
ZCTA5 07005,34,14644,104531,1406,476900,11944,3509,10277,569,2221,2107,3505,1875,5908,5488,420,5488,3939,1549,2020-01-01,zipcode,Boonton
ZCTA5 07009,34,12593,146432,1447,488500,10434,3865,9173,372,1966,1877,3078,1880,4628,4525,103,4525,3703,822,2020-01-01,zipcode,Cedar grove
ZCTA5 07040,34,25029,149182,1838,544000,19042,5040,16340,639,1782,2738,5728,5453,8522,8110,412,8110,6629,1481,2020-01-01,zipcode,Maplewood
ZCTA5 07044,34,13632,133496,1643,466300,10636,3362,9690,88,1578,1587,3479,2958,5645,5349,296,5349,4394,955,2020-01-01,zipcode,Verona
ZCTA5 07045,34,9853,155565,2846,616500,8342,2996,7333,331,1316,926,2591,2169,3620,3549,71,3549,3382,167,2020-01-01,zipcode,Montville
ZCTA5 07054,34,28943,98178,1404,469700,24044,7069,21012,1615,3360,3542,7562,4933,11613,11222,391,11222,5679,5543,2020-01-01,zipcode,Parsippany
ZCTA5 08343,34,4927,101573,1725,277900,3876,1498,3262,377,951,945,749,240,1695,1587,108,1587,1447,140,2020-01-01,zipcode,Monroeville
ZCTA5 08332,34,34609,62027,1052,164300,27841,10097,24410,4118,9133,6729,2741,1689,15578,14107,1471,14107,9807,4300,2020-01-01,zipcode,Millville
ZCTA5 08020,34,2914,-666666666,-666666666,324200,2585,1574,2436,88,1247,511,487,103,1279,1208,71,1208,1174,34,2020-01-01,zipcode,Clarksboro
ZCTA5 08066,34,8022,50477,894,131200,6968,2607,6301,480,2653,1801,1075,292,4394,3839,555,3839,2394,1445,2020-01-01,zipcode,Paulsboro
ZCTA5 08031,34,11375,60041,977,169400,9093,3255,8020,1381,2742,2452,1066,379,4850,4491,359,4491,2701,1790,2020-01-01,zipcode,Bellmawr
ZCTA5 08043,34,29195,100075,1453,337100,24156,9104,20965,1553,3609,4088,6409,5306,11945,11035,910,11035,7135,3900,2020-01-01,zipcode,Voorhees
ZCTA5 08202,34,1555,110769,1300,1195300,1489,930,1390,16,232,236,537,369,5573,812,4761,812,779,33,2020-01-01,zipcode,Avalon
ZCTA5 08817,34,44582,92298,1667,328700,34987,11439,30958,2496,7523,6876,8317,5746,15973,15071,902,15071,8371,6700,2020-01-01,zipcode,Edison
ZCTA5 08833,34,8260,126858,1697,486300,7212,2615,6282,128,1137,1252,2163,1602,3481,3293,188,3293,2833,460,2020-01-01,zipcode,Lebanon
ZCTA5 08205,34,26412,72004,1386,197200,22181,7465,18850,1665,5397,5533,3980,2275,11522,10208,1314,10208,8091,2117,2020-01-01,zipcode,Absecon
ZCTA5 08240,34,2530,-666666666,-666666666,-666666666,2530,1261,61,0,0,12,49,0,0,0,0,0,0,0,2020-01-01,zipcode,Pomona
ZCTA5 08246,34,64,-666666666,-666666666,-666666666,64,32,64,0,32,0,0,32,163,32,131,32,32,0,2020-01-01,zipcode,South seaville
ZCTA5 36525,01,1702,50179,828,133000,1236,502,1130,156,458,342,144,30,628,577,51,577,435,142,2020-01-01,zipcode,Creola
ZCTA5 36529,01,259,2499,-666666666,-666666666,195,144,133,0,67,31,10,25,162,79,83,79,79,0,2020-01-01,zipcode,Deer park
ZCTA5 36583,01,678,41731,-666666666,126500,529,332,465,31,179,160,51,44,268,268,0,268,252,16,2020-01-01,zipcode,Tibbie
ZCTA5 36749,01,741,22800,-666666666,97100,681,415,595,196,246,118,35,0,510,370,140,370,250,120,2020-01-01,zipcode,Jones
ZCTA5 36617,01,12871,35450,902,70600,10618,5758,9313,1262,3532,2960,992,567,5986,5039,947,5039,2705,2334,2020-01-01,zipcode,Mobile
ZCTA5 36723,01,414,15227,-666666666,81700,225,139,181,92,29,60,0,0,233,138,95,138,86,52,2020-01-01,zipcode,Boykin
ZCTA5 36748,01,2357,40742,680,79700,1921,1032,1640,215,714,498,88,125,1408,875,533,875,588,287,2020-01-01,zipcode,Linden
ZCTA5 36776,01,2016,14552,-666666666,44500,1584,844,1197,253,313,422,209,0,951,630,321,630,432,198,2020-01-01,zipcode,Sawyerville
ZCTA5 36782,01,2578,38173,-666666666,72300,1855,945,1618,195,573,691,139,20,1277,901,376,901,836,65,2020-01-01,zipcode,Sweet water
ZCTA5 36353,01,1564,38950,658,88400,1320,601,1026,141,277,461,95,52,825,591,234,591,530,61,2020-01-01,zipcode,Newville
ZCTA5 36371,01,805,36985,611,124600,624,350,563,102,173,206,61,21,364,343,21,343,225,118,2020-01-01,zipcode,Pinckard
ZCTA5 36453,01,2475,39940,600,79800,2161,1079,1812,308,686,584,156,78,1067,914,153,914,697,217,2020-01-01,zipcode,Kinston
ZCTA5 36467,01,9538,35855,608,92900,7882,3676,7050,1199,2906,2086,553,306,4986,4106,880,4106,3010,1096,2020-01-01,zipcode,Opp
ZCTA5 36790,01,471,-666666666,-666666666,-666666666,414,137,277,30,74,173,0,0,208,169,39,169,139,30,2020-01-01,zipcode,Stanton
ZCTA5 36832,01,25386,30068,861,154800,21741,9412,11954,959,2473,2953,2898,2671,13675,10274,3401,10274,4314,5960,2020-01-01,zipcode,Auburn
ZCTA5 36858,01,354,31458,-666666666,117900,283,175,283,54,100,68,33,28,195,178,17,178,163,15,2020-01-01,zipcode,Hatchechubbee
ZCTA5 36521,01,6482,56964,773,120700,5301,2302,4646,836,2275,1024,371,140,2548,2436,112,2436,2181,255,2020-01-01,zipcode,Chunchula
ZCTA5 36471,01,942,21607,-666666666,44600,820,611,714,94,443,132,30,15,841,431,410,431,219,212,2020-01-01,zipcode,Peterman
ZCTA5 36476,01,3,-666666666,-666666666,-666666666,3,0,3,0,0,3,0,0,21,3,18,3,3,0,2020-01-01,zipcode,River falls
ZCTA5 36480,01,1853,40417,727,131500,1538,869,1253,131,431,506,58,127,1138,683,455,683,544,139,2020-01-01,zipcode,Uriah
ZCTA5 36513,01,388,-666666666,-666666666,76500,286,97,286,0,126,145,0,15,64,64,0,64,64,0,2020-01-01,zipcode,Calvert
ZCTA5 36703,01,11880,28003,625,71800,9466,4945,8088,1399,3237,2563,535,354,5991,4927,1064,4927,2581,2346,2020-01-01,zipcode,Selma
ZCTA5 36572,01,6183,79955,954,158400,4980,2021,4350,331,1685,1145,829,360,2232,2173,59,2173,1719,454,2020-01-01,zipcode,Satsuma
ZCTA5 36575,01,22268,57777,866,151500,17362,7375,15172,1627,6029,4630,2029,857,8446,7763,683,7763,6310,1453,2020-01-01,zipcode,Semmes
ZCTA5 36727,01,138,26280,-666666666,9999,124,92,124,25,8,90,0,1,140,98,42,98,98,0,2020-01-01,zipcode,Campbell
ZCTA5 36736,01,1492,-666666666,-666666666,76400,823,347,763,56,334,133,136,104,540,413,127,413,353,60,2020-01-01,zipcode,Dixons mills
ZCTA5 36740,01,1523,35391,579,106000,1349,798,1056,199,447,305,58,47,955,517,438,517,361,156,2020-01-01,zipcode,Forkland
ZCTA5 36742,01,2663,31338,347,90500,2458,1393,1925,342,496,674,233,180,1401,1093,308,1093,829,264,2020-01-01,zipcode,Gallion
ZCTA5 36751,01,411,40613,-666666666,31900,334,195,235,99,89,17,16,14,312,176,136,176,148,28,2020-01-01,zipcode,Lower peach tree
ZCTA5 36754,01,643,-666666666,-666666666,-666666666,584,292,514,299,170,26,0,19,269,198,71,198,169,29,2020-01-01,zipcode,Magnolia
ZCTA5 36758,01,1448,51759,399,84600,1010,516,875,168,398,166,96,47,537,460,77,460,372,88,2020-01-01,zipcode,Plantersville
ZCTA5 36850,01,2982,37500,370,64400,2436,1392,2087,493,718,630,181,65,1424,1156,268,1156,939,217,2020-01-01,zipcode,Camp hill
ZCTA5 36003,01,1830,22292,435,101900,1558,959,1420,295,528,446,66,85,1177,935,242,935,760,175,2020-01-01,zipcode,Autaugaville
ZCTA5 36022,01,12833,67733,770,173600,9822,3500,8317,518,2662,3047,1552,538,5025,4590,435,4590,3906,684,2020-01-01,zipcode,Deatsville
ZCTA5 36026,01,976,60472,1358,255100,932,555,870,71,234,280,285,0,1108,475,633,475,436,39,2020-01-01,zipcode,Equality
ZCTA5 36032,01,2522,35938,-666666666,62300,1963,935,1593,312,768,353,60,100,1322,1000,322,1000,728,272,2020-01-01,zipcode,Fort deposit
ZCTA5 36020,01,988,40441,743,161000,736,373,633,95,217,216,71,34,391,352,39,352,251,101,2020-01-01,zipcode,Coosada
ZCTA5 36029,01,1008,55744,-666666666,-666666666,812,225,707,146,317,111,75,58,342,285,57,285,239,46,2020-01-01,zipcode,Fitzpatrick
ZCTA5 36432,01,1795,38941,495,86900,1529,856,1301,346,490,312,102,51,1054,578,476,578,429,149,2020-01-01,zipcode,Castleberry
ZCTA5 36435,01,362,54583,-666666666,-666666666,324,160,314,71,102,131,5,5,249,148,101,148,146,2,2020-01-01,zipcode,Coy
ZCTA5 36106,01,14575,61753,956,157400,11851,4099,9891,667,1734,2771,2238,2481,6924,6031,893,6031,3378,2653,2020-01-01,zipcode,Montgomery
ZCTA5 75468,48,1228,57281,-666666666,78900,959,469,806,0,275,407,64,60,425,393,32,393,360,33,2020-01-01,zipcode,Pattonville
ZCTA5 75475,48,111,34250,-666666666,97500,104,58,80,8,33,16,23,0,61,53,8,53,53,0,2020-01-01,zipcode,Randolph
ZCTA5 75487,48,1846,54063,566,100700,1353,494,1175,251,350,383,136,55,692,605,87,605,488,117,2020-01-01,zipcode,Talco
ZCTA5 75490,48,2633,84512,1147,191000,2121,562,1903,137,754,645,250,117,1105,974,131,974,838,136,2020-01-01,zipcode,Trenton
ZCTA5 75252,48,27880,67928,1102,411000,23371,6859,19928,867,1986,4723,7033,5319,14440,12413,2027,12413,5405,7008,2020-01-01,zipcode,Dallas
ZCTA5 75253,48,24666,43574,1145,54400,16220,5774,12773,5637,3449,2825,648,214,7144,6702,442,6702,4229,2473,2020-01-01,zipcode,Dallas
ZCTA5 75287,48,55060,53575,1121,327500,45897,8799,40762,1810,7019,13110,12866,5957,31800,28296,3504,28296,6214,22082,2020-01-01,zipcode,Dallas
ZCTA5 75409,48,16750,87589,1689,216000,12656,4149,10971,1401,3356,2200,3032,982,6148,5461,687,5461,4058,1403,2020-01-01,zipcode,Anna
ZCTA5 75411,48,740,-666666666,1077,-666666666,662,381,651,72,352,123,63,41,444,333,111,333,185,148,2020-01-01,zipcode,Arthur city
ZCTA5 75416,48,2946,62500,773,126200,2221,991,1913,250,655,528,341,139,1279,1096,183,1096,916,180,2020-01-01,zipcode,Blossom
ZCTA5 75441,48,192,-666666666,-666666666,63600,169,110,156,81,31,0,34,10,137,137,0,137,137,0,2020-01-01,zipcode,Enloe
ZCTA5 75446,48,3415,48929,630,120700,2591,1370,2214,365,746,592,382,129,1632,1346,286,1346,984,362,2020-01-01,zipcode,Honey grove
ZCTA5 75447,48,1201,90114,-666666666,173600,945,329,844,134,294,330,59,27,496,435,61,435,409,26,2020-01-01,zipcode,Ivanhoe
ZCTA5 75462,48,11652,53955,767,170400,9163,3616,8087,733,2127,2926,1446,855,4986,4654,332,4654,3406,1248,2020-01-01,zipcode,Paris
ZCTA5 75469,48,310,67917,-666666666,154000,290,155,268,37,75,93,52,11,191,128,63,128,117,11,2020-01-01,zipcode,Pecan gap
ZCTA5 78384,48,5621,32215,563,44400,4306,1981,3709,1310,1096,1081,157,65,2812,1756,1056,1756,1190,566,2020-01-01,zipcode,San diego
ZCTA5 78412,48,42385,48730,1061,137700,34055,12058,24297,2283,7229,8040,4375,2370,16878,15836,1042,15836,7086,8750,2020-01-01,zipcode,Corpus christi
ZCTA5 78413,48,39782,70962,1180,185600,30895,9847,25250,1755,6463,9116,5114,2802,15979,14818,1161,14818,7864,6954,2020-01-01,zipcode,Corpus christi
ZCTA5 78538,48,10698,35083,441,68300,7675,3471,6335,2373,1815,1588,404,155,3684,3125,559,3125,2355,770,2020-01-01,zipcode,Edcouch
ZCTA5 78539,48,37411,61201,837,149400,28252,9830,22640,3574,4266,6639,4680,3481,13843,12831,1012,12831,7435,5396,2020-01-01,zipcode,Edinburg
ZCTA5 78550,48,52022,40105,722,88200,36993,14889,30616,8271,8784,8202,3607,1752,19399,16893,2506,16893,8662,8231,2020-01-01,zipcode,Harlingen
ZCTA5 78575,48,12249,72306,1068,138200,8831,3056,7282,1193,1331,2449,1467,842,3797,3425,372,3425,2590,835,2020-01-01,zipcode,Olmito
ZCTA5 78589,48,41112,42381,759,88800,29448,12194,22939,9084,6029,4824,2242,760,12161,11123,1038,11123,8505,2618,2020-01-01,zipcode,San juan
ZCTA5 78606,48,6315,68350,735,273000,5125,1992,4584,381,1089,1659,1076,379,3095,2383,712,2383,1827,556,2020-01-01,zipcode,Blanco
ZCTA5 78065,48,11134,51598,701,94300,8495,3580,7332,1475,3303,1753,622,179,4027,3521,506,3521,2690,831,2020-01-01,zipcode,Poteet
ZCTA5 78045,48,67981,73541,1154,180500,48163,15535,38981,6636,8034,11339,9041,3931,20919,19698,1221,19698,15219,4479,2020-01-01,zipcode,Laredo
ZCTA5 78052,48,6128,55944,916,95800,5031,1992,3981,674,1606,1102,308,291,2119,1854,265,1854,1512,342,2020-01-01,zipcode,Lytle
ZCTA5 78064,48,16722,66179,1069,160700,12160,5498,10494,1732,3846,2658,1669,589,5875,5109,766,5109,3769,1340,2020-01-01,zipcode,Pleasanton
ZCTA5 78108,48,43579,96207,1738,234100,32279,12352,26551,1620,6093,8737,6362,3739,14176,13401,775,13401,11268,2133,2020-01-01,zipcode,Cibolo
ZCTA5 78130,48,79786,66574,1204,222100,61989,21363,53155,5161,15670,15580,11841,4903,32360,29297,3063,29297,18176,11121,2020-01-01,zipcode,New braunfels
ZCTA5 08320,34,1059,-666666666,-666666666,-666666666,1059,1059,1040,153,584,286,17,0,0,0,0,0,0,0,2020-01-01,zipcode,Fairton
ZCTA5 08808,34,117,75795,-666666666,83000,117,6,117,73,14,30,0,0,105,77,28,77,57,20,2020-01-01,zipcode,Broadway
ZCTA5 08844,34,39852,140391,1861,447300,32032,8627,28107,1021,4945,5389,9898,6854,14940,14039,901,14039,11967,2072,2020-01-01,zipcode,Hillsborough
ZCTA5 08890,34,86,-666666666,-666666666,-666666666,86,34,17,0,9,0,8,0,9,9,0,9,0,9,2020-01-01,zipcode,
ZCTA5 08071,34,9381,81448,1300,190100,7946,2783,6753,350,1982,1954,1738,729,4007,3684,323,3684,2609,1075,2020-01-01,zipcode,Pitman
ZCTA5 08217,34,84,-666666666,-666666666,-666666666,84,84,84,61,23,0,0,0,0,0,0,0,0,0,2020-01-01,zipcode,Elwood
ZCTA5 08340,34,1302,61140,1356,223100,937,357,824,46,395,241,114,28,485,485,0,485,386,99,2020-01-01,zipcode,Milmay
ZCTA5 75480,48,2030,62206,-666666666,257200,1703,851,1563,83,298,751,344,87,1484,821,663,821,813,8,2020-01-01,zipcode,Scroggins
ZCTA5 75459,48,5260,68704,903,134000,4024,955,3463,331,969,1462,546,155,2054,1822,232,1822,1277,545,2020-01-01,zipcode,Howe
ZCTA5 77028,48,18620,27905,902,76400,13953,6281,11443,3515,4347,2750,630,201,6972,6227,745,6227,3414,2813,2020-01-01,zipcode,Houston
ZCTA5 77058,48,15930,54866,1145,190700,13683,3917,11455,733,1709,3871,3226,1916,9323,8086,1237,8086,2394,5692,2020-01-01,zipcode,Houston
ZCTA5 77023,48,28122,39603,885,164200,21864,8564,17960,5972,4636,3421,2420,1511,11528,10119,1409,10119,4526,5593,2020-01-01,zipcode,Houston
ZCTA5 77093,48,46985,31321,884,87500,33834,15761,27735,13967,7934,4913,731,190,14471,13208,1263,13208,7761,5447,2020-01-01,zipcode,Houston
ZCTA5 77360,48,5415,51909,856,110200,4270,2070,3987,455,1518,1519,397,98,3747,2322,1425,2322,1871,451,2020-01-01,zipcode,Onalaska
ZCTA5 77042,48,40659,48741,1088,301900,32436,8130,28020,2303,4875,7273,8438,5131,21329,19074,2255,19074,5269,13805,2020-01-01,zipcode,Houston
ZCTA5 77302,48,18845,79070,1241,209500,14227,5566,12212,1631,3865,4222,1900,594,6820,6213,607,6213,5172,1041,2020-01-01,zipcode,Conroe
ZCTA5 77420,48,2331,44375,879,122700,1872,734,1516,216,298,715,269,18,907,777,130,777,547,230,2020-01-01,zipcode,Boling
ZCTA5 77388,48,50972,92610,1601,208700,38824,11791,32228,2609,6573,11712,7555,3779,17492,16797,695,16797,12119,4678,2020-01-01,zipcode,Spring
ZCTA5 77417,48,3683,42656,877,98100,2323,999,2086,554,820,443,225,44,1136,990,146,990,590,400,2020-01-01,zipcode,Beasley
ZCTA5 77043,48,24957,66325,1173,292400,19612,6181,17040,2750,3294,3667,4715,2614,10501,9422,1079,9422,5540,3882,2020-01-01,zipcode,Houston
ZCTA5 77089,48,55410,75622,1208,167900,42512,13682,34702,6307,8377,11549,5821,2648,18129,17210,919,17210,11820,5390,2020-01-01,zipcode,Houston
ZCTA5 77591,48,14926,51891,1057,142300,11067,4191,9374,1122,3166,3168,1440,478,5987,5187,800,5187,2651,2536,2020-01-01,zipcode,Texas city
ZCTA5 77703,48,13134,26838,730,75100,9131,4333,7697,1740,3192,2266,390,109,5555,4613,942,4613,2255,2358,2020-01-01,zipcode,Beaumont
ZCTA5 77033,48,29267,36484,1002,70100,21536,10191,17558,4927,6388,4442,1189,612,10191,9116,1075,9116,5597,3519,2020-01-01,zipcode,Houston
ZCTA5 77064,48,49042,72808,1301,178900,37818,11136,31310,5470,6896,9819,6447,2678,16772,15593,1179,15593,9581,6012,2020-01-01,zipcode,Houston
ZCTA5 77099,48,50326,41632,970,131200,37205,12449,31224,8797,9065,8624,3809,929,17461,16151,1310,16151,5634,10517,2020-01-01,zipcode,Houston
ZCTA5 77201,48,0,-666666666,-666666666,-666666666,0,0,0,0,0,0,0,0,0,0,0,0,0,0,2020-01-01,zipcode,Houston
ZCTA5 77328,48,16832,48821,1031,122300,12661,5625,11152,2123,4670,3198,858,303,6387,5620,767,5620,4182,1438,2020-01-01,zipcode,Cleveland
ZCTA5 77342,48,0,-666666666,-666666666,-666666666,0,0,0,0,0,0,0,0,0,0,0,0,0,0,2020-01-01,zipcode,Huntsville
ZCTA5 77350,48,90,-666666666,-666666666,-666666666,63,23,54,21,0,15,18,0,36,36,0,36,36,0,2020-01-01,zipcode,Leggett
ZCTA5 77377,48,38233,101901,1468,261600,28218,9299,24417,2020,4744,7308,7075,3270,12961,12338,623,12338,10140,2198,2020-01-01,zipcode,Tomball
ZCTA5 77406,48,57622,123360,1399,314600,43903,15210,39576,1779,6978,12754,11475,6590,19608,18691,917,18691,15843,2848,2020-01-01,zipcode,Richmond
ZCTA5 77407,48,61382,99499,1725,266200,44008,11260,37597,3170,6199,10094,11079,7055,18084,17615,469,17615,14364,3251,2020-01-01,zipcode,Richmond
ZCTA5 77436,48,66,-666666666,-666666666,-666666666,46,29,46,0,0,0,29,17,17,17,0,17,17,0,2020-01-01,zipcode,Egypt
ZCTA5 77453,48,469,-666666666,-666666666,-666666666,276,50,273,14,87,115,57,0,161,136,25,136,55,81,2020-01-01,zipcode,Lane city
ZCTA5 77460,48,43,-666666666,-666666666,-666666666,19,11,19,19,0,0,0,0,17,8,9,8,8,0,2020-01-01,zipcode,Nada
ZCTA5 77498,48,52950,86934,1595,221400,41082,13043,33245,4079,6866,9188,7770,5342,17005,15914,1091,15914,11866,4048,2020-01-01,zipcode,Sugar land
ZCTA5 77523,48,23431,127339,1167,272100,16869,4500,14432,825,3061,6690,2596,1260,8028,7370,658,7370,6655,715,2020-01-01,zipcode,Baytown
ZCTA5 77580,48,999,157887,-666666666,340400,554,185,516,0,68,158,201,89,320,320,0,320,282,38,2020-01-01,zipcode,Mont belvieu
ZCTA5 77661,48,1292,14635,-666666666,114800,878,368,654,164,263,107,38,82,522,481,41,481,358,123,2020-01-01,zipcode,Stowell
ZCTA5 77976,48,38,-666666666,-666666666,178100,38,13,38,0,12,13,9,4,29,17,12,17,17,0,2020-01-01,zipcode,Nursery
ZCTA5 77987,48,218,71667,-666666666,120800,153,36,150,10,77,36,16,11,126,90,36,90,77,13,2020-01-01,zipcode,Sweet home
ZCTA5 77993,48,87,113625,-666666666,-666666666,87,53,61,0,27,23,6,5,93,23,70,23,23,0,2020-01-01,zipcode,Weesatche
ZCTA5 77032,48,14351,33630,988,84600,10012,3848,7698,2482,2502,2038,482,194,4769,4402,367,4402,1588,2814,2020-01-01,zipcode,Houston
ZCTA5 77053,48,31521,50693,1293,95400,23585,8778,19197,5573,6252,5074,1534,764,9234,9022,212,9022,6113,2909,2020-01-01,zipcode,Houston
ZCTA5 77056,48,22155,106974,1658,786200,19504,5831,17738,357,1071,3020,7966,5324,14339,11597,2742,11597,4309,7288,2020-01-01,zipcode,Houston
ZCTA5 77065,48,39951,63220,1152,194700,31872,9322,26936,3098,6824,9665,4841,2508,16845,15777,1068,15777,7173,8604,2020-01-01,zipcode,Houston
ZCTA5 77069,48,18968,60239,1203,268200,14964,5294,12997,874,1967,4393,3787,1976,8752,8019,733,8019,4466,3553,2020-01-01,zipcode,Houston
ZCTA5 77070,48,56260,67390,1312,201000,43124,12535,36659,2994,7456,11581,10068,4560,22781,21174,1607,21174,10289,10885,2020-01-01,zipcode,Houston
ZCTA5 77320,48,36091,48226,922,155200,31579,20982,26888,4711,11503,6465,3063,1146,11244,9060,2184,9060,5997,3063,2020-01-01,zipcode,Huntsville
ZCTA5 77345,48,28593,140593,1687,306900,21452,8523,18251,508,1430,4555,7424,4334,10033,9440,593,9440,8332,1108,2020-01-01,zipcode,Kingwood
ZCTA5 75032,48,33956,118593,1394,354100,26478,8693,22441,1577,3737,6141,6679,4307,12015,11546,469,11546,9816,1730,2020-01-01,zipcode,Rockwall
ZCTA5 75057,48,16670,63721,1264,129200,12299,2987,10295,2345,2480,2827,1917,726,6283,5685,598,5685,2070,3615,2020-01-01,zipcode,Lewisville
ZCTA5 75058,48,3329,105500,1235,357100,2434,861,1908,244,414,533,532,185,1042,940,102,940,722,218,2020-01-01,zipcode,Gunter
ZCTA5 78146,48,834,58235,678,89500,553,242,449,42,187,196,24,0,311,224,87,224,108,116,2020-01-01,zipcode,Pettus
ZCTA5 78015,48,17187,126910,1765,433400,13032,4735,11074,186,1280,2422,5104,2082,5860,5658,202,5658,5271,387,2020-01-01,zipcode,Boerne
ZCTA5 78019,48,2111,57463,721,69900,1891,1148,1458,567,497,225,140,29,705,513,192,513,447,66,2020-01-01,zipcode,Encinal
ZCTA5 78022,48,4082,51655,745,117600,3327,1836,2985,872,829,911,198,175,2174,1368,806,1368,1070,298,2020-01-01,zipcode,George west
ZCTA5 78026,48,7158,63596,861,103100,5476,2334,4540,819,2153,746,713,109,3105,2522,583,2522,1874,648,2020-01-01,zipcode,Jourdanton
ZCTA5 78027,48,990,-666666666,-666666666,250000,885,360,858,0,129,396,236,97,309,230,79,230,230,0,2020-01-01,zipcode,Kendalia
ZCTA5 78040,48,39997,27319,741,78200,27987,13045,22371,11101,4951,4660,1232,427,13691,11581,2110,11581,5062,6519,2020-01-01,zipcode,Laredo
ZCTA5 78041,48,47207,53514,823,160900,35354,13174,28018,7507,6485,6835,4929,2262,15786,14459,1327,14459,7535,6924,2020-01-01,zipcode,Laredo
ZCTA5 78056,48,2024,116167,-666666666,432700,1656,664,1494,0,194,569,345,386,991,806,185,806,738,68,2020-01-01,zipcode,Mico
ZCTA5 78059,48,5327,66632,861,159300,4425,1822,3656,972,1116,851,527,190,2074,1762,312,1762,1568,194,2020-01-01,zipcode,Natalia
ZCTA5 78071,48,4394,45042,768,119400,3624,2174,2977,697,1226,748,226,80,1566,1021,545,1021,787,234,2020-01-01,zipcode,Three rivers
ZCTA5 78107,48,316,29519,-666666666,64200,316,149,316,72,85,133,26,0,257,218,39,218,136,82,2020-01-01,zipcode,Berclair
ZCTA5 78112,48,8725,46349,1061,100900,6575,2676,5703,1452,1986,1899,281,85,2634,2525,109,2525,2196,329,2020-01-01,zipcode,Elmendorf
ZCTA5 78114,48,24463,71643,936,192300,19281,7919,16560,2147,6034,4926,2414,1039,8433,7790,643,7790,6525,1265,2020-01-01,zipcode,Floresville
ZCTA5 78118,48,4418,54316,844,94400,3635,2239,2986,879,1086,586,362,73,1629,1117,512,1117,881,236,2020-01-01,zipcode,Karnes city
ZCTA5 78124,48,6553,73724,983,179700,5477,2168,4806,750,1794,1440,590,232,2360,2294,66,2294,2075,219,2020-01-01,zipcode,Marion
ZCTA5 78142,48,106,-666666666,-666666666,-666666666,89,57,62,9,11,13,6,23,51,36,15,36,32,4,2020-01-01,zipcode,Normanna
ZCTA5 78159,48,1033,54375,832,48200,749,407,568,143,197,157,65,6,454,360,94,360,302,58,2020-01-01,zipcode,Smiley
ZCTA5 78145,48,85,36250,-666666666,24700,55,28,46,11,33,2,0,0,30,24,6,24,17,7,2020-01-01,zipcode,Pawnee
ZCTA5 78147,48,1805,68529,1004,150000,1331,483,1006,111,422,292,137,44,611,504,107,504,318,186,2020-01-01,zipcode,Poth
ZCTA5 78151,48,1705,40417,-666666666,100200,1294,563,1033,249,317,254,76,137,792,657,135,657,423,234,2020-01-01,zipcode,Runge
ZCTA5 78214,48,26805,36421,773,84400,20669,9656,16435,5417,6068,3874,753,323,8264,7939,325,7939,4512,3427,2020-01-01,zipcode,San antonio
ZCTA5 78244,48,33988,61029,1310,145900,26389,8094,22001,3356,5443,7806,3731,1665,10370,9796,574,9796,7264,2532,2020-01-01,zipcode,San antonio
ZCTA5 78252,48,11479,67930,1302,134100,8496,3824,7364,2001,1742,2348,959,314,2754,2655,99,2655,2071,584,2020-01-01,zipcode,San antonio
ZCTA5 78344,48,419,61176,-666666666,90600,345,193,276,10,165,66,35,0,176,138,38,138,119,19,2020-01-01,zipcode,Bruni
ZCTA5 78349,48,598,-666666666,-666666666,72500,511,378,403,217,90,78,18,0,338,154,184,154,149,5,2020-01-01,zipcode,Concepcion
ZCTA5 78362,48,11025,64592,1182,152800,8403,3327,6955,1185,2663,2205,617,285,4296,3779,517,3779,2665,1114,2020-01-01,zipcode,Ingleside
ZCTA5 78537,48,45120,29705,538,62000,29930,13895,23369,10136,5868,5024,1790,551,14874,12207,2667,12207,9228,2979,2020-01-01,zipcode,Donna
ZCTA5 78560,48,4743,33750,707,79800,3319,1541,2588,1078,674,567,161,108,1557,1368,189,1368,804,564,2020-01-01,zipcode,La joya
ZCTA5 78562,48,3198,46591,468,70600,2677,1774,2179,994,577,431,177,0,656,540,116,540,394,146,2020-01-01,zipcode,La villa
ZCTA5 78569,48,4541,43281,561,97300,3758,1843,3114,977,1076,654,254,153,1639,1355,284,1355,1071,284,2020-01-01,zipcode,Lyford
ZCTA5 78579,48,5562,53393,580,58000,4293,1523,3327,1365,689,803,219,251,1438,1232,206,1232,1155,77,2020-01-01,zipcode,Progreso
ZCTA5 78584,48,18286,23936,556,70000,13251,6353,10457,4766,2797,1759,800,335,5993,4802,1191,4802,3325,1477,2020-01-01,zipcode,Roma
ZCTA5 78596,48,68984,45881,738,83300,47887,19905,38568,10927,9110,11113,5295,2123,24181,19053,5128,19053,13074,5979,2020-01-01,zipcode,Weslaco
ZCTA5 78641,48,78568,105096,1539,281700,58104,16150,50621,3688,9114,17487,13739,6593,25436,24371,1065,24371,19304,5067,2020-01-01,zipcode,Leander
ZCTA5 78655,48,3892,49417,1050,148800,3147,880,2656,744,739,821,204,148,1547,1405,142,1405,940,465,2020-01-01,zipcode,Martindale
ZCTA5 78661,48,272,41042,825,90000,213,89,185,33,108,13,28,3,116,97,19,97,76,21,2020-01-01,zipcode,Prairie lea
ZCTA5 78605,48,6035,59224,793,151400,4976,1942,4213,684,1615,1245,532,137,2478,2144,334,2144,1869,275,2020-01-01,zipcode,Bertram
ZCTA5 78611,48,12454,65130,917,195100,10242,4282,8917,776,2975,3036,1334,796,6572,4507,2065,4507,3508,999,2020-01-01,zipcode,Burnet
ZCTA5 78619,48,5840,136779,1270,521100,4467,1229,3972,145,715,1199,1103,810,1970,1907,63,1907,1721,186,2020-01-01,zipcode,Driftwood
ZCTA5 78648,48,8264,52884,926,146300,6889,3054,5839,1202,2214,1654,572,197,3378,3095,283,3095,2110,985,2020-01-01,zipcode,Luling
ZCTA5 78653,48,29622,85544,1501,219800,20654,5080,18077,2863,4545,5599,3470,1600,9685,8981,704,8981,7565,1416,2020-01-01,zipcode,Manor
ZCTA5 78729,48,27707,74782,1346,310800,23112,5195,20420,761,2638,5970,7410,3641,12813,11516,1297,11516,4811,6705,2020-01-01,zipcode,Austin
ZCTA5 78638,48,2112,59403,1153,163300,1730,745,1515,176,607,505,147,80,941,820,121,820,694,126,2020-01-01,zipcode,Kingsbury
ZCTA5 32141,12,19414,51875,1126,177400,16970,7981,15649,1284,5697,5700,1851,1117,9540,8633,907,8633,7340,1293,2020-01-01,zipcode,Edgewater
ZCTA5 32157,12,340,53000,844,143000,308,120,278,114,66,75,23,0,234,148,86,148,82,66,2020-01-01,zipcode,
ZCTA5 32164,12,49642,57835,1385,218300,40984,18989,36951,3560,12036,13450,5267,2638,19883,18365,1518,18365,12766,5599,2020-01-01,zipcode,Palm coast
ZCTA5 32168,12,28284,54692,1213,245300,24776,12925,22636,2013,6638,7696,4671,1618,14370,12310,2060,12310,9594,2716,2020-01-01,zipcode,New smyrna beach
ZCTA5 32189,12,5541,38828,642,90800,4885,2624,4414,787,1459,1583,517,68,3910,2674,1236,2674,1894,780,2020-01-01,zipcode,Satsuma
ZCTA5 32202,12,6965,35947,863,102900,6466,4474,5461,1239,1556,1539,780,347,2701,2265,436,2265,202,2063,2020-01-01,zipcode,Jacksonville
ZCTA5 32212,12,2327,39628,1706,-666666666,1909,79,507,15,52,300,81,59,229,222,7,222,3,219,2020-01-01,zipcode,Jacksonville
ZCTA5 32333,12,11805,49583,763,125000,9917,4560,8999,1426,2753,2344,1769,707,5956,5116,840,5116,4203,913,2020-01-01,zipcode,Havana
ZCTA5 32340,12,11058,29057,701,108600,9314,5520,8150,1736,2970,2258,706,480,4863,3923,940,3923,2622,1301,2020-01-01,zipcode,Madison
ZCTA5 32344,12,12580,46168,767,148500,10969,5910,9817,1783,3323,2376,1519,816,6042,4963,1079,4963,3693,1270,2020-01-01,zipcode,Monticello
ZCTA5 32358,12,1481,62850,857,142400,1260,665,1231,125,366,411,248,81,1348,658,690,658,593,65,2020-01-01,zipcode,Sopchoppy
ZCTA5 75065,48,13026,80020,1278,225800,10634,2778,8908,1043,2331,2656,2110,768,4757,4655,102,4655,3204,1451,2020-01-01,zipcode,Lake dallas
ZCTA5 75647,48,12328,47240,870,137700,9518,3612,8327,1412,2786,2765,1019,345,4973,4466,507,4466,3109,1357,2020-01-01,zipcode,Gladewater
ZCTA5 75559,48,5263,46011,639,95100,4142,2227,3724,349,1632,1092,361,290,2747,2178,569,2178,1552,626,2020-01-01,zipcode,De kalb
ZCTA5 75563,48,4225,42542,531,81800,3553,2007,3062,366,1253,986,319,138,2230,1877,353,1877,1340,537,2020-01-01,zipcode,Linden
ZCTA5 75630,48,2104,32238,736,107700,1842,1115,1740,123,752,601,224,40,1462,1015,447,1015,881,134,2020-01-01,zipcode,Avinger
ZCTA5 75602,48,20576,44230,767,87500,15421,5882,12065,3117,3608,3685,1164,491,8043,6847,1196,6847,4306,2541,2020-01-01,zipcode,Longview
ZCTA5 75604,48,29922,52087,861,142400,22683,9033,19514,3141,5266,6976,2933,1198,12973,11635,1338,11635,6567,5068,2020-01-01,zipcode,Longview
ZCTA5 75633,48,12831,51910,671,126000,10314,4743,8723,1224,2880,2993,1289,337,6329,5000,1329,5000,3608,1392,2020-01-01,zipcode,Carthage
ZCTA5 75644,48,13883,45467,751,135900,10538,5433,9180,1238,3392,3002,961,587,5302,4500,802,4500,3242,1258,2020-01-01,zipcode,Gilmer
ZCTA5 75650,48,9775,68504,973,159400,7492,2863,6616,741,1895,2405,1039,536,4136,3647,489,3647,2356,1291,2020-01-01,zipcode,Hallsville
ZCTA5 75657,48,7274,41115,727,103300,6043,2870,5171,798,2050,1453,655,215,4614,3220,1394,3220,2394,826,2020-01-01,zipcode,Jefferson
ZCTA5 75661,48,2586,53243,678,87500,2308,1129,1938,388,577,543,324,106,1905,929,976,929,764,165,2020-01-01,zipcode,Karnack
ZCTA5 75668,48,2469,48167,763,119100,1994,1003,1696,116,865,566,119,30,1326,1086,240,1086,682,404,2020-01-01,zipcode,Lone star
ZCTA5 75669,48,1332,70979,-666666666,104000,855,484,701,140,159,338,52,12,437,337,100,337,321,16,2020-01-01,zipcode,Long branch
ZCTA5 08542,34,5399,87826,1490,527800,4750,1920,2723,127,364,261,648,1323,1817,1500,317,1500,438,1062,2020-01-01,zipcode,Princeton
ZCTA5 08560,34,3663,108668,1830,378600,3161,1378,2780,139,610,444,798,789,1609,1545,64,1545,1475,70,2020-01-01,zipcode,Titusville
ZCTA5 08611,34,28263,39958,1137,97300,20973,8163,17937,5676,5652,3845,2008,756,10731,9289,1442,9289,3441,5848,2020-01-01,zipcode,Trenton
ZCTA5 08690,34,18010,103350,1382,302600,15312,5510,13470,632,3221,3658,4083,1876,7079,6749,330,6749,5769,980,2020-01-01,zipcode,Trenton
ZCTA5 08731,34,20347,81650,1679,277500,16655,6261,14067,985,5049,4306,2463,1264,9046,7963,1083,7963,6977,986,2020-01-01,zipcode,Forked river
ZCTA5 08757,34,33543,46274,1447,180900,30433,17909,28395,3482,12964,7163,3433,1353,18759,17031,1728,17031,14681,2350,2020-01-01,zipcode,Toms river
ZCTA5 08804,34,2579,95313,595,347500,2141,665,1937,113,322,603,673,226,1171,1067,104,1067,848,219,2020-01-01,zipcode,Bloomsbury
ZCTA5 08809,34,6433,106935,1499,361100,5243,2109,4080,248,798,791,1254,989,2098,2069,29,2069,1548,521,2020-01-01,zipcode,Clinton
ZCTA5 08810,34,8774,128807,1764,411200,6779,2076,5941,164,606,1044,2455,1672,2979,2855,124,2855,2460,395,2020-01-01,zipcode,Dayton
ZCTA5 08904,34,13803,83980,1465,364900,11475,3381,10015,326,1032,1559,3119,3979,6437,6034,403,6034,2509,3525,2020-01-01,zipcode,Highland park
ZCTA5 08861,34,53899,54771,1374,270900,42498,15977,35152,9637,13004,7056,4130,1325,18437,17576,861,17576,5633,11943,2020-01-01,zipcode,Perth amboy
ZCTA5 08882,34,15783,77183,1316,311200,12402,3762,10989,1652,3857,2630,1983,867,6185,5883,302,5883,3634,2249,2020-01-01,zipcode,South river
ZCTA5 08884,34,8255,85703,960,307800,6847,2460,6106,762,2069,1630,1082,563,3216,3150,66,3150,2502,648,2020-01-01,zipcode,Spotswood
ZCTA5 08230,34,5250,95444,1148,326700,4230,1607,3660,68,981,889,1179,543,2545,1966,579,1966,1835,131,2020-01-01,zipcode,Ocean view
ZCTA5 08234,34,41276,81448,1250,215900,32569,9970,28348,2514,9293,7146,6318,3077,15784,14263,1521,14263,12145,2118,2020-01-01,zipcode,Egg harbor township
ZCTA5 08242,34,2975,79250,1227,273900,2379,931,2181,295,709,690,107,380,1815,1340,475,1340,917,423,2020-01-01,zipcode,Rio grande
ZCTA5 08247,34,960,113333,1294,1394200,941,584,818,21,143,136,298,220,3364,506,2858,506,461,45,2020-01-01,zipcode,Stone harbor
ZCTA5 08310,34,1460,44639,974,156800,1358,768,1230,197,724,255,34,20,728,665,63,665,427,238,2020-01-01,zipcode,Buena
ZCTA5 08311,34,1987,60563,1329,156700,1450,523,1251,276,538,310,118,9,778,585,193,585,507,78,2020-01-01,zipcode,Cedarville
ZCTA5 08317,34,1677,84432,-666666666,255000,1345,560,1230,108,451,490,178,3,650,642,8,642,506,136,2020-01-01,zipcode,Dorothy
ZCTA5 08322,34,10292,89570,1344,215400,8337,2628,7302,736,2936,2126,1024,480,3592,3433,159,3433,3052,381,2020-01-01,zipcode,Franklinville
ZCTA5 08550,34,18143,191208,2161,631800,14565,4357,13127,75,698,1302,4660,6392,6944,6620,324,6620,5373,1247,2020-01-01,zipcode,Princeton junction
ZCTA5 08558,34,7545,206287,1451,672100,5935,2289,4986,82,677,620,1523,2084,2777,2549,228,2549,2208,341,2020-01-01,zipcode,Skillman
ZCTA5 08559,34,5252,133580,1744,477200,4822,1732,4132,176,739,847,1298,1072,2398,2166,232,2166,1848,318,2020-01-01,zipcode,Stockton
ZCTA5 33070,12,5138,65286,1743,577400,4492,1683,3987,307,1156,1099,860,565,4287,2238,2049,2238,1601,637,2020-01-01,zipcode,Tavernier
ZCTA5 33126,12,50886,42589,1331,252100,43563,16083,38942,7965,11605,9146,7695,2531,19250,18035,1215,18035,6588,11447,2020-01-01,zipcode,Miami
ZCTA5 33129,12,14220,86922,2102,463100,12405,3613,11148,483,1185,1720,3891,3869,8219,6680,1539,6680,2964,3716,2020-01-01,zipcode,Miami
ZCTA5 33130,12,33938,45040,1229,338500,30439,9584,27074,5517,6494,5194,5437,4432,18949,15856,3093,15856,1770,14086,2020-01-01,zipcode,Miami
ZCTA5 33131,12,20558,102862,2330,487100,18249,3358,16663,259,1180,2490,6330,6404,16894,11265,5629,11265,3753,7512,2020-01-01,zipcode,Miami
ZCTA5 33137,12,22835,64106,1783,394400,19549,5234,17498,2149,2796,4149,5123,3281,12479,9900,2579,9900,2288,7612,2020-01-01,zipcode,Miami
ZCTA5 76258,48,6926,66713,1068,265900,5765,2047,4458,726,909,1318,1112,393,2637,2537,100,2537,1725,812,2020-01-01,zipcode,Pilot point
ZCTA5 76008,48,20288,137833,2002,339400,14978,4361,13052,243,2093,3694,4408,2614,6775,6479,296,6479,6064,415,2020-01-01,zipcode,Aledo
ZCTA5 76006,48,24057,50077,1060,249200,19747,4109,16671,1167,3438,5448,4139,2479,13576,11809,1767,11809,2988,8821,2020-01-01,zipcode,Arlington
ZCTA5 76011,48,22878,43350,984,139800,17680,4549,15182,2812,3386,5294,2507,1183,11365,9853,1512,9853,1771,8082,2020-01-01,zipcode,Arlington
ZCTA5 76021,48,35168,75735,1145,258200,28072,8628,24914,1400,4510,8493,7459,3052,14999,14388,611,14388,7694,6694,2020-01-01,zipcode,Bedford
ZCTA5 76039,48,37896,69745,1295,222000,30704,7019,26683,2139,5393,9050,6649,3452,16477,15650,827,15650,6202,9448,2020-01-01,zipcode,Euless
ZCTA5 76043,48,7525,63462,715,218100,5944,2557,5252,469,1944,1452,986,401,3070,2482,588,2482,1972,510,2020-01-01,zipcode,Glen rose
ZCTA5 76052,48,23080,118864,1591,287700,17318,5065,14868,980,2881,4908,4646,1453,7272,7057,215,7057,6351,706,2020-01-01,zipcode,Haslet
ZCTA5 76092,48,31837,224265,1337,699200,22925,8592,20034,195,2102,3894,8158,5685,9728,9388,340,9388,8879,509,2020-01-01,zipcode,Southlake
ZCTA5 76102,48,10632,73563,1364,275800,9669,5544,7943,1286,1849,1800,1594,1414,4405,3795,610,3795,1063,2732,2020-01-01,zipcode,Fort worth
ZCTA5 76107,48,29377,67844,1190,327000,25603,8281,22180,2499,3452,4203,7598,4428,16635,14592,2043,14592,7025,7567,2020-01-01,zipcode,Fort worth
ZCTA5 76131,48,47377,92830,1549,229300,34395,8955,29737,2289,6239,10047,7985,3177,15593,15265,328,15265,11795,3470,2020-01-01,zipcode,Fort worth
ZCTA5 76140,48,30930,56419,1099,135800,22767,7999,18572,3703,6443,5934,1690,802,10551,9603,948,9603,6504,3099,2020-01-01,zipcode,Fort worth
ZCTA5 76155,48,6329,62875,1186,-666666666,5179,632,4738,290,706,1371,1510,861,3643,3239,404,3239,0,3239,2020-01-01,zipcode,Fort worth
ZCTA5 76234,48,18937,69514,1087,204000,14549,4975,11990,1652,3139,4630,1732,837,7186,6391,795,6391,4884,1507,2020-01-01,zipcode,Decatur
ZCTA5 76259,48,5738,77847,1161,225400,4429,1423,4005,592,1028,1312,729,344,2048,1985,63,1985,1689,296,2020-01-01,zipcode,Ponder
ZCTA5 76262,48,41158,116663,1260,418800,31259,8244,27086,1168,3687,7408,9533,5290,15361,14732,629,14732,11071,3661,2020-01-01,zipcode,Roanoke
ZCTA5 76273,48,9429,70469,1032,178600,7594,3105,6516,726,2317,2280,631,562,3867,3610,257,3610,2747,863,2020-01-01,zipcode,Whitesboro
ZCTA5 76458,48,6121,50444,628,92500,5110,2935,4355,909,1593,1119,450,284,2730,2144,586,2144,1687,457,2020-01-01,zipcode,Jacksboro
ZCTA5 79363,48,5374,63736,864,183200,4097,1372,3655,477,1036,1079,661,402,2138,1971,167,1971,1605,366,2020-01-01,zipcode,Shallowater
ZCTA5 79376,48,15,-666666666,-666666666,-666666666,15,15,15,0,0,0,15,0,49,15,34,15,15,0,2020-01-01,zipcode,Tokio
ZCTA5 79414,48,17806,42432,891,109400,14598,4387,10964,1341,2537,3822,1988,1276,8902,8199,703,8199,3281,4918,2020-01-01,zipcode,Lubbock
ZCTA5 79423,48,42354,70590,1064,170200,31686,9296,27062,2054,6128,8803,6469,3608,16723,15780,943,15780,11002,4778,2020-01-01,zipcode,Lubbock
ZCTA5 79424,48,49191,83769,940,213400,38090,11336,32256,1801,5517,10112,9666,5160,21056,19685,1371,19685,13445,6240,2020-01-01,zipcode,Lubbock
ZCTA5 79511,48,1417,61563,775,101600,1070,349,871,120,223,344,141,43,653,529,124,529,456,73,2020-01-01,zipcode,Coahoma
ZCTA5 79517,48,226,-666666666,-666666666,-666666666,198,30,198,60,17,62,44,15,114,114,0,114,88,26,2020-01-01,zipcode,Fluvanna
ZCTA5 79521,48,3563,54415,632,65200,3034,1515,2477,688,846,549,183,211,2132,1234,898,1234,860,374,2020-01-01,zipcode,Haskell
ZCTA5 79530,48,450,58125,650,52900,401,134,375,44,170,74,80,7,281,206,75,206,176,30,2020-01-01,zipcode,Lawn
ZCTA5 79536,48,5230,61903,944,83800,3848,1550,3407,379,1502,1104,343,79,2138,1792,346,1792,1521,271,2020-01-01,zipcode,Merkel
ZCTA5 79561,48,440,56875,669,98000,382,151,332,41,94,155,31,11,248,183,65,183,132,51,2020-01-01,zipcode,Trent
ZCTA5 79043,48,1480,40333,575,50100,980,413,766,274,269,174,38,11,533,414,119,414,285,129,2020-01-01,zipcode,Hart
ZCTA5 79032,48,85,32273,-666666666,83600,62,22,50,10,17,23,0,0,56,34,22,34,20,14,2020-01-01,zipcode,Edmonson
ZCTA5 79033,48,49,-666666666,-666666666,-666666666,49,37,49,18,0,12,19,0,47,32,15,32,20,12,2020-01-01,zipcode,Farnsworth
ZCTA5 79042,48,1051,48077,819,84200,761,236,629,29,178,206,148,68,554,382,172,382,296,86,2020-01-01,zipcode,Happy
ZCTA5 79011,48,202,54375,825,157500,180,49,169,11,70,45,37,6,135,111,24,111,81,30,2020-01-01,zipcode,Briscoe
ZCTA5 79012,48,2156,126520,-666666666,266000,1525,291,1297,96,237,738,175,51,761,675,86,675,637,38,2020-01-01,zipcode,Bushland
ZCTA5 79022,48,11210,59117,921,118000,8352,3342,7449,1797,2491,1770,927,464,3972,3360,612,3360,2489,871,2020-01-01,zipcode,Dalhart
ZCTA5 79031,48,1360,51328,631,80600,975,365,870,238,279,216,105,32,646,481,165,481,352,129,2020-01-01,zipcode,Earth
ZCTA5 79083,48,2108,49034,921,80200,1596,881,1283,189,358,543,149,44,1226,721,505,721,585,136,2020-01-01,zipcode,Stinnett
ZCTA5 79239,48,161,26685,-666666666,88100,145,89,139,13,72,17,26,11,174,83,91,83,69,14,2020-01-01,zipcode,Lakeview
ZCTA5 79241,48,2166,54680,728,74400,1778,740,1485,356,448,411,193,77,1041,759,282,759,572,187,2020-01-01,zipcode,Lockney
ZCTA5 79316,48,10772,41701,698,77800,8301,3618,7011,2231,2127,1861,561,231,4373,3717,656,3717,2305,1412,2020-01-01,zipcode,Brownfield
ZCTA5 79331,48,12309,39407,691,81100,9575,4907,7749,2229,2607,1845,868,200,4910,4256,654,4256,2984,1272,2020-01-01,zipcode,Lamesa
ZCTA5 79350,48,428,61250,817,50000,365,106,322,67,73,171,7,4,200,175,25,175,146,29,2020-01-01,zipcode,New deal
ZCTA5 79357,48,2071,39052,620,57300,1608,580,1356,363,448,393,83,69,1037,796,241,796,540,256,2020-01-01,zipcode,Ralls
ZCTA5 79369,48,69,-666666666,-666666666,37500,69,36,69,0,46,6,0,17,38,38,0,38,38,0,2020-01-01,zipcode,Spade
ZCTA5 79410,48,10588,38183,1112,155300,8686,3248,6086,735,1082,1577,1255,1437,4522,4195,327,4195,1518,2677,2020-01-01,zipcode,Lubbock
ZCTA5 79416,48,34628,58701,1095,149900,27950,9980,19627,1719,4130,6024,4612,3142,14906,13294,1612,13294,6826,6468,2020-01-01,zipcode,Lubbock
ZCTA5 79519,48,61,117083,-666666666,189200,61,14,61,0,18,7,36,0,57,39,18,39,39,0,2020-01-01,zipcode,Goldsboro
ZCTA5 79520,48,2286,45833,710,45700,1595,638,1286,176,499,446,122,43,1215,924,291,924,654,270,2020-01-01,zipcode,Hamlin
ZCTA5 79529,48,1339,34358,788,40400,1093,499,911,196,216,307,108,84,698,537,161,537,424,113,2020-01-01,zipcode,Knox city
ZCTA5 79534,48,165,-666666666,-666666666,108000,156,58,151,14,9,43,50,35,126,88,38,88,84,4,2020-01-01,zipcode,Mc caulley
ZCTA5 79538,48,264,55694,-666666666,117000,210,100,188,16,69,60,33,10,135,93,42,93,91,2,2020-01-01,zipcode,Novice
ZCTA5 79553,48,3127,46862,729,64800,2316,1235,2098,321,815,528,294,140,1718,1402,316,1402,1071,331,2020-01-01,zipcode,Stamford
ZCTA5 79563,48,1013,49500,834,59700,804,363,632,139,286,164,32,11,456,378,78,378,286,92,2020-01-01,zipcode,Tye
ZCTA5 79565,48,195,44375,-666666666,55000,136,80,121,9,71,32,9,0,105,67,38,67,61,6,2020-01-01,zipcode,Westbrook
ZCTA5 79601,48,27385,46468,811,129600,23711,13254,16466,3117,5727,4521,2005,1096,9371,7654,1717,7654,3680,3974,2020-01-01,zipcode,Abilene
ZCTA5 79603,48,23602,43614,843,82900,18160,6429,14639,2675,5392,4140,1947,485,9802,8501,1301,8501,4819,3682,2020-01-01,zipcode,Abilene
ZCTA5 79734,48,2044,-666666666,1093,140100,1767,1091,1466,238,251,539,178,260,1621,915,706,915,773,142,2020-01-01,zipcode,Fort davis
ZCTA5 79743,48,339,76667,407,62000,276,122,244,17,72,86,37,32,183,120,63,120,56,64,2020-01-01,zipcode,Imperial
ZCTA5 79761,48,33955,54746,1035,122700,25180,8198,19927,5581,5240,6099,2311,696,13565,12106,1459,12106,7097,5009,2020-01-01,zipcode,Odessa
ZCTA5 79330,48,70,106016,-666666666,-666666666,70,38,70,0,44,9,8,9,283,37,246,37,37,0,2020-01-01,zipcode,Justiceburg
ZCTA5 79252,48,3017,45469,447,55200,2533,996,2290,330,717,880,213,150,1862,1327,535,1327,903,424,2020-01-01,zipcode,Quanah
ZCTA5 79322,48,2032,43526,644,61800,1557,663,1328,312,435,352,194,35,956,764,192,764,600,164,2020-01-01,zipcode,Crosbyton
ZCTA5 79325,48,2327,58281,904,107100,1533,551,1278,339,454,335,130,20,908,711,197,711,466,245,2020-01-01,zipcode,Farwell
ZCTA5 32008,12,4887,34864,689,97300,3956,2151,3738,696,1855,815,307,65,3012,2123,889,2123,1756,367,2020-01-01,zipcode,Branford
ZCTA5 32053,12,3990,29688,724,79600,3172,1772,2688,612,1130,625,202,119,1999,1463,536,1463,1171,292,2020-01-01,zipcode,Jennings
ZCTA5 32359,12,986,34106,-666666666,113500,931,699,911,153,416,295,0,47,2180,558,1622,558,379,179,2020-01-01,zipcode,Steinhatchee
ZCTA5 32401,12,21045,40217,869,146700,17253,7404,15263,2193,5225,5084,1729,1032,11249,9662,1587,9662,4944,4718,2020-01-01,zipcode,Panama city
ZCTA5 32413,12,14551,72275,1184,279500,12882,5208,11700,677,2922,4147,2587,1367,18615,6558,12057,6558,4913,1645,2020-01-01,zipcode,Panama city beach
ZCTA5 32423,12,955,47656,1702,123000,887,538,822,64,325,299,127,7,570,471,99,471,446,25,2020-01-01,zipcode,Bascom
ZCTA5 32426,12,798,30745,725,72200,697,430,629,201,279,111,18,20,456,332,124,332,305,27,2020-01-01,zipcode,Campbellton
ZCTA5 32448,12,7232,30853,673,85700,5885,2895,5310,673,2224,1796,351,266,4163,3473,690,3473,2334,1139,2020-01-01,zipcode,Marianna
ZCTA5 32503,12,33163,54708,952,175500,27735,10391,20983,1501,4645,7253,4263,3321,14029,12484,1545,12484,8292,4192,2020-01-01,zipcode,Pensacola
ZCTA5 32544,12,2268,35899,1446,-666666666,1603,138,760,12,97,213,386,52,445,379,66,379,0,379,2020-01-01,zipcode,Hurlburt field
ZCTA5 32571,12,35905,69451,980,193200,27886,11275,24076,1583,6272,9275,4534,2412,13979,12965,1014,12965,10621,2344,2020-01-01,zipcode,Milton
ZCTA5 32608,12,50431,50786,1058,251900,42938,16185,29709,1651,3733,7132,8115,9078,24032,19909,4123,19909,8364,11545,2020-01-01,zipcode,Gainesville
ZCTA5 32621,12,4672,38217,642,82100,3922,2125,3497,658,1394,1057,336,52,2280,2061,219,2061,1513,548,2020-01-01,zipcode,Bronson
ZCTA5 32640,12,10647,43610,827,116100,8821,4885,8133,1325,2970,2499,804,535,5444,4141,1303,4141,3465,676,2020-01-01,zipcode,Hawthorne
ZCTA5 32683,12,409,47083,-666666666,-666666666,252,171,251,47,130,74,0,0,120,103,17,103,80,23,2020-01-01,zipcode,Otter creek
ZCTA5 32686,12,5193,36212,644,209600,4419,2302,3936,837,1127,1315,325,332,2773,2301,472,2301,1531,770,2020-01-01,zipcode,Reddick
ZCTA5 32618,12,8954,63601,653,174500,7429,2678,6387,702,1684,2129,817,1055,3785,3383,402,3383,2978,405,2020-01-01,zipcode,Archer
ZCTA5 32804,12,18695,84471,1321,355000,16148,4941,14697,573,2990,3163,4530,3441,9419,8201,1218,8201,5481,2720,2020-01-01,zipcode,Orlando
ZCTA5 32931,12,14131,67894,1247,346200,13124,6714,12327,323,2194,3801,3514,2495,10939,7451,3488,7451,5339,2112,2020-01-01,zipcode,Cocoa beach
ZCTA5 32707,12,37106,55387,1192,198700,31168,11472,27624,1862,6457,10240,6284,2781,16803,15680,1123,15680,10591,5089,2020-01-01,zipcode,Casselberry
ZCTA5 32712,12,48987,80336,1476,275200,38394,13311,33715,4146,8624,10389,7096,3460,16986,15684,1302,15684,12501,3183,2020-01-01,zipcode,Apopka
ZCTA5 32720,12,33485,56118,926,207900,28490,13241,23892,2550,7766,7868,3631,2077,13784,12430,1354,12430,8501,3929,2020-01-01,zipcode,Deland
ZCTA5 32732,12,5345,86277,1058,335700,4324,1474,3650,163,995,1245,764,483,2228,1868,360,1868,1780,88,2020-01-01,zipcode,Geneva
ZCTA5 32738,12,46727,59548,1186,170800,36704,13315,31358,3404,11169,11737,3967,1081,15964,14966,998,14966,11681,3285,2020-01-01,zipcode,Deltona
ZCTA5 32771,12,57030,67453,1198,241900,44569,15445,38913,3716,9291,13110,8280,4516,22272,20486,1786,20486,12812,7674,2020-01-01,zipcode,Sanford
ZCTA5 32773,12,31090,48089,1167,167600,24210,8526,21539,2110,7403,6853,3778,1395,12346,11327,1019,11327,6239,5088,2020-01-01,zipcode,Sanford
ZCTA5 32776,12,12191,73424,1084,274000,9944,3190,8846,680,2137,4370,1154,505,4475,4183,292,4183,3638,545,2020-01-01,zipcode,Sorrento
ZCTA5 32808,12,60450,39187,1058,150900,45137,14666,37067,7941,12600,11918,3284,1324,20344,18603,1741,18603,7559,11044,2020-01-01,zipcode,Orlando
ZCTA5 32809,12,30100,45205,1083,175900,23568,8850,20647,4501,6628,5087,3036,1395,11133,9457,1676,9457,4895,4562,2020-01-01,zipcode,Orlando
ZCTA5 32819,12,27849,76118,1463,351300,22899,7758,19608,1619,3389,5630,6002,2968,14382,9814,4568,9814,5786,4028,2020-01-01,zipcode,Orlando
ZCTA5 32831,12,3022,36250,-666666666,9999,3022,2994,2635,1067,1077,383,53,55,46,28,18,28,28,0,2020-01-01,zipcode,Orlando
ZCTA5 32835,12,47867,57480,1358,266700,38783,10668,32340,2530,7300,9994,8462,4054,18953,17323,1630,17323,7308,10015,2020-01-01,zipcode,Orlando
ZCTA5 32836,12,19640,111271,1680,478500,15965,5089,14146,331,1857,3502,4969,3487,9171,7117,2054,7117,4626,2491,2020-01-01,zipcode,Orlando
ZCTA5 32905,12,23410,44056,1031,136400,19374,8763,16913,1854,5538,5480,2905,1136,11101,9379,1722,9379,5191,4188,2020-01-01,zipcode,Palm bay
ZCTA5 32322,12,3721,38727,770,178900,3314,2447,3074,657,1342,715,185,175,1912,998,914,998,773,225,2020-01-01,zipcode,Carrabelle
ZCTA5 32440,12,7640,40612,681,98100,6801,4151,5707,1247,2291,1496,452,221,2452,2106,346,2106,1418,688,2020-01-01,zipcode,Graceville
ZCTA5 32566,12,41165,83848,1419,256700,31480,11692,26802,1657,6340,11010,4597,3198,16852,14623,2229,14623,11677,2946,2020-01-01,zipcode,Navarre
ZCTA5 32625,12,1568,53281,836,215500,1275,593,1123,63,399,387,101,173,1250,625,625,625,487,138,2020-01-01,zipcode,Cedar key
ZCTA5 32746,12,46816,89609,1523,318500,38666,12639,34177,1073,5218,10654,10509,6723,20102,19018,1084,19018,12034,6984,2020-01-01,zipcode,Lake mary
ZCTA5 32908,12,12605,53174,1138,163600,10034,3770,8282,1321,2614,3084,727,536,4145,3785,360,3785,3165,620,2020-01-01,zipcode,Palm bay
ZCTA5 32832,12,29359,94718,1747,349900,21704,6659,19293,927,1548,4900,7524,4394,12474,10108,2366,10108,6876,3232,2020-01-01,zipcode,Orlando
ZCTA5 32833,12,9659,74340,1124,281500,7886,3019,6804,742,1728,2266,1385,683,3742,3154,588,3154,2509,645,2020-01-01,zipcode,Orlando
ZCTA5 32837,12,50780,63143,1451,263600,41686,13226,35302,3457,8389,10165,8535,4756,20975,16191,4784,16191,9660,6531,2020-01-01,zipcode,Orlando
ZCTA5 08562,34,4725,71926,1451,170300,3587,1241,3085,364,947,912,602,260,1864,1747,117,1747,1061,686,2020-01-01,zipcode,Wrightstown
ZCTA5 08618,34,37433,38591,1029,172200,29908,13497,22085,3615,7978,5707,2936,1849,15511,12788,2723,12788,5449,7339,2020-01-01,zipcode,Trenton
ZCTA5 08641,34,4028,75543,2091,-666666666,2703,562,1975,51,193,974,509,248,1176,1140,36,1140,0,1140,2020-01-01,zipcode,Joint base mdl
ZCTA5 08732,34,1413,92434,1625,420100,1179,503,1089,15,213,299,344,218,763,655,108,655,575,80,2020-01-01,zipcode,Island heights
ZCTA5 08738,34,1514,120000,1457,1217600,1374,693,1255,23,141,245,528,318,1733,694,1039,694,634,60,2020-01-01,zipcode,Mantoloking
ZCTA5 08741,34,2669,110903,1300,345700,2218,847,1976,49,466,601,588,272,1141,1019,122,1019,939,80,2020-01-01,zipcode,Pine beach
ZCTA5 08801,34,8383,141203,1764,443800,7167,3635,5112,215,817,1084,1623,1373,2724,2563,161,2563,2164,399,2020-01-01,zipcode,Annandale
ZCTA5 08807,34,37638,136314,1676,483400,30385,10157,26271,1473,5431,4431,7630,7306,13547,12996,551,12996,10698,2298,2020-01-01,zipcode,Bridgewater
ZCTA5 08825,34,4040,105000,1350,416100,3438,1040,3090,318,773,720,761,518,1802,1670,132,1670,1260,410,2020-01-01,zipcode,Frenchtown
ZCTA5 08835,34,10193,72615,1387,267400,8348,2736,7182,646,2935,1850,1287,464,4305,4007,298,4007,2896,1111,2020-01-01,zipcode,Manville
ZCTA5 08858,34,107,-666666666,-666666666,-666666666,107,0,70,0,0,0,0,70,35,35,0,35,35,0,2020-01-01,zipcode,Oldwick
ZCTA5 08859,34,22383,90140,1375,322100,18196,4893,16045,1234,4003,4403,4391,2014,8573,8362,211,8362,5285,3077,2020-01-01,zipcode,Parlin
ZCTA5 08869,34,7833,82471,1508,361400,6733,1687,5536,681,1510,1283,1286,776,3242,3005,237,3005,1697,1308,2020-01-01,zipcode,Raritan
ZCTA5 08873,34,54416,92063,1674,350400,44262,15113,39021,2353,7814,8148,11977,8729,22383,20785,1598,20785,14224,6561,2020-01-01,zipcode,Somerset
ZCTA5 08608,34,866,16991,670,-666666666,720,360,663,67,275,282,31,8,595,481,114,481,25,456,2020-01-01,zipcode,Trenton
ZCTA5 08609,34,13003,39467,1060,74500,10347,4393,8116,2126,3733,1685,425,147,5293,4216,1077,4216,1260,2956,2020-01-01,zipcode,Trenton
ZCTA5 08610,34,31363,71388,1239,200800,25163,7994,21429,2587,8553,5726,3379,1184,11802,11024,778,11024,7536,3488,2020-01-01,zipcode,Trenton
ZCTA5 08638,34,22115,57064,1246,176900,18223,7807,15042,1955,5362,3809,2767,1149,9182,8081,1101,8081,4690,3391,2020-01-01,zipcode,Trenton
ZCTA5 08722,34,11274,81658,1642,235700,9102,2739,7612,527,2414,2728,1441,502,4164,3992,172,3992,3614,378,2020-01-01,zipcode,Beachwood
ZCTA5 08733,34,2772,70378,1232,190600,2248,834,1972,279,625,657,298,113,1056,1017,39,1017,637,380,2020-01-01,zipcode,Lakehurst
ZCTA5 08742,34,24474,100394,1649,419200,20417,6157,18203,801,4144,4243,5992,3023,12500,10085,2415,10085,7974,2111,2020-01-01,zipcode,Point pleasant beach
ZCTA5 08837,34,17999,87672,1431,332800,13981,4364,12844,940,2578,2920,3525,2881,6851,6404,447,6404,3094,3310,2020-01-01,zipcode,Edison
ZCTA5 08846,34,13606,84216,1419,320500,11045,3480,9621,757,3173,2845,1882,964,5144,4909,235,4909,3661,1248,2020-01-01,zipcode,Middlesex
ZCTA5 08901,34,57607,43930,1524,267200,46926,22215,26523,9293,6829,4309,3192,2900,16605,15546,1059,15546,3032,12514,2020-01-01,zipcode,New brunswick
ZCTA5 08902,34,40630,97914,1648,339900,32223,9991,28702,3010,5902,5316,8150,6324,15304,14640,664,14640,8163,6477,2020-01-01,zipcode,North brunswick
ZCTA5 08041,34,804,122125,-666666666,388700,710,185,653,55,190,202,150,56,352,320,32,320,307,13,2020-01-01,zipcode,Jobstown
ZCTA5 08049,34,5186,69508,1018,166100,4308,1099,3672,289,1447,975,659,302,2252,2063,189,2063,1405,658,2020-01-01,zipcode,Magnolia
ZCTA5 08051,34,10994,87986,1457,183500,9024,2487,7945,363,2863,2156,1817,746,4355,4104,251,4104,3263,841,2020-01-01,zipcode,Mantua
ZCTA5 08052,34,18590,64666,1245,187400,15597,4813,13623,794,5082,4039,2583,1125,9091,8332,759,8332,3822,4510,2020-01-01,zipcode,Maple shade
ZCTA5 08054,34,41443,97536,1619,275700,34000,11145,30069,1416,6273,6542,9388,6450,18305,17494,811,17494,13243,4251,2020-01-01,zipcode,Mount laurel
ZCTA5 08057,34,20667,155780,1239,506400,16681,5541,13981,476,1806,2463,4771,4465,7789,7215,574,7215,6125,1090,2020-01-01,zipcode,Moorestown
ZCTA5 08060,34,24556,93377,1294,235200,20327,5835,17705,1002,5024,5336,4664,1679,9747,9088,659,9088,6604,2484,2020-01-01,zipcode,Mount holly
ZCTA5 08062,34,16419,140250,1147,361500,12510,3653,10807,440,2382,1941,3229,2815,5827,5467,360,5467,5073,394,2020-01-01,zipcode,Mullica hill
ZCTA5 08068,34,7052,62091,1070,211000,5921,1978,5060,477,1862,1622,783,316,3013,2838,175,2838,1697,1141,2020-01-01,zipcode,Pemberton
ZCTA5 08075,34,28617,75938,1304,226900,23285,7337,19610,1814,6217,5373,4238,1968,11934,11098,836,11098,7410,3688,2020-01-01,zipcode,Riverside
ZCTA5 08079,34,9793,42077,866,167100,7521,3407,6675,923,2760,2004,680,308,4990,4018,972,4018,2379,1639,2020-01-01,zipcode,Salem
ZCTA5 08092,34,3257,71518,1292,279400,2705,1003,2365,204,818,634,498,211,1559,1275,284,1275,1034,241,2020-01-01,zipcode,West creek
ZCTA5 08108,34,18004,94851,1332,274600,14867,4196,13402,410,2601,3305,4073,3013,8479,7951,528,7951,5091,2860,2020-01-01,zipcode,Collingswood
ZCTA5 08232,34,19611,42009,1028,131700,15127,5063,12755,3444,4305,3692,932,382,7200,6232,968,6232,3093,3139,2020-01-01,zipcode,Pleasantville
ZCTA5 08248,34,59,-666666666,-666666666,-666666666,39,17,39,0,17,0,0,22,503,20,483,20,20,0,2020-01-01,zipcode,Strathmere
ZCTA5 08302,34,44640,50481,1125,165000,33513,15427,28609,6635,11907,6304,2521,1242,15169,13622,1547,13622,8071,5551,2020-01-01,zipcode,Bridgeton
ZCTA5 08324,34,341,73621,-666666666,218800,285,145,234,36,86,54,58,0,171,128,43,128,85,43,2020-01-01,zipcode,Heislerville
ZCTA5 08329,34,351,69125,-666666666,269100,273,176,273,0,99,92,70,12,193,141,52,141,124,17,2020-01-01,zipcode,Mauricetown
ZCTA5 08350,34,503,-666666666,-666666666,250000,464,87,420,114,136,110,12,48,237,182,55,182,182,0,2020-01-01,zipcode,Richland
ZCTA5 08501,34,6260,115521,1287,439000,5401,2157,4409,217,837,955,1332,1068,2466,2405,61,2405,2215,190,2020-01-01,zipcode,Allentown
ZCTA5 08510,34,5851,167037,1969,599900,5094,1739,3845,190,931,854,1401,469,1939,1898,41,1898,1742,156,2020-01-01,zipcode,Millstone township
ZCTA5 08520,34,27082,100288,1388,299600,21677,6543,18834,1830,4264,3932,5572,3236,10184,9280,904,9280,6757,2523,2020-01-01,zipcode,Hightstown
ZCTA5 08341,34,2435,-666666666,843,192300,1997,623,1571,207,414,577,250,123,990,915,75,915,427,488,2020-01-01,zipcode,Minotola
ZCTA5 33155,12,44659,66753,1657,378400,37840,13703,34331,4481,8436,9465,7769,4180,15133,14375,758,14375,9812,4563,2020-01-01,zipcode,Miami
ZCTA5 33165,12,54497,65005,1435,348100,47141,18321,40976,7177,12573,10094,7344,3788,17196,16649,547,16649,11719,4930,2020-01-01,zipcode,Miami
ZCTA5 33708,12,15377,63351,1521,350700,14350,7608,13573,671,2944,4568,3227,2163,13639,7929,5710,7929,5872,2057,2020-01-01,zipcode,Saint petersburg
ZCTA5 33760,12,18438,50486,1140,154800,15394,4654,12831,1706,3602,4448,2267,808,8208,7162,1046,7162,3193,3969,2020-01-01,zipcode,Clearwater
ZCTA5 33763,12,19987,46289,1158,144700,17257,8879,16162,1451,5492,4949,2670,1600,11224,9403,1821,9403,6619,2784,2020-01-01,zipcode,Clearwater
ZCTA5 33030,12,35743,38730,1055,257000,24978,9147,20745,8355,5944,3999,1725,722,9734,9091,643,9091,3404,5687,2020-01-01,zipcode,Homestead
ZCTA5 33035,12,14509,65907,1458,198800,10594,2724,9097,908,2250,3216,1977,746,5105,4533,572,4533,2040,2493,2020-01-01,zipcode,Homestead
ZCTA5 33064,12,59942,52740,1388,215600,48925,15883,43248,7866,13358,10593,7796,3635,24491,21303,3188,21303,13220,8083,2020-01-01,zipcode,Pompano beach
ZCTA5 33071,12,39433,90849,1666,393200,31288,8773,26183,1219,5456,8127,7240,4141,13624,12985,639,12985,8614,4371,2020-01-01,zipcode,Coral springs
ZCTA5 33132,12,15496,90759,2078,485800,14424,3800,13083,814,1430,2465,4468,3906,10431,7631,2800,7631,2205,5426,2020-01-01,zipcode,Miami
ZCTA5 33139,12,38488,56227,1503,397900,33718,9951,30767,3587,5325,6533,8615,6707,31360,20559,10801,20559,6481,14078,2020-01-01,zipcode,Miami beach
ZCTA5 33141,12,38442,52913,1403,313100,33424,8832,30334,2643,7448,8195,6790,5258,22752,17387,5365,17387,5703,11684,2020-01-01,zipcode,Miami beach
ZCTA5 33150,12,31637,30311,944,245800,23532,10149,20203,5301,6265,5253,2279,1105,11496,10221,1275,10221,2812,7409,2020-01-01,zipcode,Miami
ZCTA5 33154,12,14511,75702,1736,663200,11052,4326,9942,288,1703,2336,2914,2701,10214,5800,4414,5800,3471,2329,2020-01-01,zipcode,Miami beach
ZCTA5 33166,12,25097,60645,1358,397000,21049,7546,18597,3211,4075,4463,3820,3028,9684,8592,1092,8592,4256,4336,2020-01-01,zipcode,Miami
ZCTA5 33167,12,22618,45879,1146,215700,17688,7223,14914,3844,5338,3565,1619,548,6465,6140,325,6140,3505,2635,2020-01-01,zipcode,Miami
ZCTA5 33176,12,53934,74246,1413,437900,44395,15615,38703,3515,8215,11631,9368,5974,19441,18160,1281,18160,11689,6471,2020-01-01,zipcode,Miami
ZCTA5 33177,12,56862,61341,1663,288400,47202,19453,40321,6409,14772,10572,6127,2441,16015,15423,592,15423,11280,4143,2020-01-01,zipcode,Miami
ZCTA5 33178,12,52885,75907,2161,410400,39930,13154,34183,3171,4440,7867,10450,8255,19352,15834,3518,15834,7814,8020,2020-01-01,zipcode,Miami
ZCTA5 33180,12,32136,78234,1983,391400,26926,11139,24293,1114,2785,7117,7910,5367,21844,14121,7723,14121,8976,5145,2020-01-01,zipcode,Miami
ZCTA5 33919,12,30485,58138,1223,220500,26905,12562,25117,1309,5723,7827,6156,4102,18997,14049,4948,14049,10481,3568,2020-01-01,zipcode,Fort myers
ZCTA5 33953,12,6408,63020,1574,232300,5840,3869,5538,463,1652,2073,818,532,3818,2809,1009,2809,2637,172,2020-01-01,zipcode,Port charlotte
ZCTA5 33001,12,300,44297,2014,-666666666,291,178,291,16,172,51,44,8,739,167,572,167,113,54,2020-01-01,zipcode,Long key
ZCTA5 33014,12,42153,48450,1323,303200,35118,12616,30804,5641,9250,7958,5025,2930,14609,14076,533,14076,6194,7882,2020-01-01,zipcode,Hialeah
ZCTA5 33015,12,67952,58972,1484,286800,55261,17435,47007,6780,13855,14789,7891,3692,22934,22066,868,22066,11157,10909,2020-01-01,zipcode,Hialeah
ZCTA5 33016,12,50269,47929,1399,224300,41314,15206,35283,7291,11238,7896,6481,2377,16231,15816,415,15816,8503,7313,2020-01-01,zipcode,Hialeah
ZCTA5 33026,12,32882,79741,1660,287500,27016,9225,23917,2184,5470,7505,5319,3439,12500,11956,544,11956,9740,2216,2020-01-01,zipcode,Hollywood
ZCTA5 33055,12,38509,46914,1303,222900,31976,13860,27430,7103,10969,5633,2842,883,11570,10985,585,10985,8509,2476,2020-01-01,zipcode,Opa locka
ZCTA5 33056,12,36822,48204,1367,213000,28913,11508,24623,4169,8893,7348,2611,1602,10854,10161,693,10161,6895,3266,2020-01-01,zipcode,Miami gardens
ZCTA5 33716,12,18243,55063,1339,214400,16039,3346,13855,669,2451,4877,3853,2005,10985,9360,1625,9360,1821,7539,2020-01-01,zipcode,Saint petersburg
ZCTA5 33777,12,17186,76278,1515,208600,14530,5341,13232,669,3714,4318,2850,1681,8207,6956,1251,6956,5664,1292,2020-01-01,zipcode,Seminole
ZCTA5 33778,12,15836,50774,1062,174900,13195,5831,12173,1073,3683,4742,1601,1074,7808,6218,1590,6218,5032,1186,2020-01-01,zipcode,Largo
ZCTA5 33823,12,35712,53767,809,155600,28527,12631,24628,3785,9179,6845,3525,1294,13227,11571,1656,11571,8119,3452,2020-01-01,zipcode,Auburndale
ZCTA5 33852,12,20839,41713,829,143500,17733,10718,16459,2592,7081,4400,1449,937,12853,8826,4027,8826,7457,1369,2020-01-01,zipcode,Lake placid
ZCTA5 33901,12,22907,41352,1015,215100,18879,8444,16895,2964,5529,4265,2437,1700,10797,9036,1761,9036,3755,5281,2020-01-01,zipcode,Fort myers
ZCTA5 33904,12,31388,50695,1212,246300,28026,14414,26336,1749,8937,8456,4918,2276,19752,13958,5794,13958,10784,3174,2020-01-01,zipcode,Cape coral
ZCTA5 33916,12,26013,37743,1044,121400,19841,8007,17018,3835,5861,4184,2020,1118,11641,9000,2641,9000,2906,6094,2020-01-01,zipcode,Fort myers
ZCTA5 33950,12,23948,58560,1085,299400,21447,14382,19917,1106,4816,6946,4409,2640,15586,11367,4219,11367,9510,1857,2020-01-01,zipcode,Punta gorda
ZCTA5 33960,12,586,39917,-666666666,127800,525,255,506,39,246,150,57,14,452,278,174,278,262,16,2020-01-01,zipcode,Venus
ZCTA5 33944,12,415,-666666666,-666666666,-666666666,302,138,302,0,214,88,0,0,176,138,38,138,138,0,2020-01-01,zipcode,Palmdale
ZCTA5 33946,12,2368,57984,-666666666,512000,2325,1329,2325,43,748,704,561,269,2931,1256,1675,1256,1132,124,2020-01-01,zipcode,Placida
ZCTA5 33971,12,28101,55548,1272,181600,20596,6858,17132,3302,6145,5429,1421,835,8040,7446,594,7446,5570,1876,2020-01-01,zipcode,Lehigh acres
ZCTA5 33981,12,12009,55152,1213,268300,10730,6285,10420,767,3880,3357,1396,1020,6686,5027,1659,5027,4437,590,2020-01-01,zipcode,Port charlotte
ZCTA5 33990,12,35396,61019,1335,223000,30226,11983,27133,2954,10122,8514,4001,1542,14806,12337,2469,12337,9069,3268,2020-01-01,zipcode,Cape coral
ZCTA5 33993,12,29328,78348,1575,226800,23117,8192,19772,1738,8004,5982,2752,1296,10484,9249,1235,9249,7874,1375,2020-01-01,zipcode,Cape coral
ZCTA5 33173,12,32469,70541,1658,331500,27457,9503,24190,2347,4688,7358,6251,3546,11754,11056,698,11056,7473,3583,2020-01-01,zipcode,Miami
ZCTA5 33174,12,35938,50387,1412,280600,31575,13301,25747,8049,5657,5115,4796,2130,11299,10902,397,10902,5756,5146,2020-01-01,zipcode,Miami
ZCTA5 33187,12,18381,87848,2090,371000,15128,5452,12969,1937,3277,3544,3216,995,5478,5224,254,5224,4532,692,2020-01-01,zipcode,Miami
ZCTA5 33193,12,49083,67779,1546,311300,41453,14274,34936,7423,8759,7698,8457,2599,15573,15108,465,15108,9260,5848,2020-01-01,zipcode,Miami
ZCTA5 33031,12,9148,89450,1720,392000,7482,3011,6023,712,2409,1676,579,647,2554,2490,64,2490,2185,305,2020-01-01,zipcode,Homestead
ZCTA5 33032,12,52073,59878,1294,270400,38903,12109,32722,6112,8886,9810,5933,1981,15302,14559,743,14559,8383,6176,2020-01-01,zipcode,Homestead
ZCTA5 33043,12,4911,75957,1703,376800,4234,1738,3821,277,1064,1379,698,403,2923,2063,860,2063,1582,481,2020-01-01,zipcode,Big pine key
ZCTA5 33146,12,16171,110596,2255,919400,13991,6791,7870,193,548,1363,2390,3376,5622,4841,781,4841,3404,1437,2020-01-01,zipcode,Miami
ZCTA5 77642,48,37902,36017,779,69300,27784,12580,23483,6449,7977,6415,1805,837,16390,13761,2629,13761,7273,6488,2020-01-01,zipcode,Port arthur
ZCTA5 77664,48,2872,58284,433,131100,2364,1357,1898,157,873,452,241,175,1393,1038,355,1038,918,120,2020-01-01,zipcode,Warren
ZCTA5 77701,48,14005,39056,808,53100,10574,4984,9175,3004,3541,1992,418,220,6316,5117,1199,5117,2537,2580,2020-01-01,zipcode,Beaumont
ZCTA5 77010,48,911,250001,3123,-666666666,905,231,897,0,11,150,395,341,835,598,237,598,50,548,2020-01-01,zipcode,Houston
ZCTA5 77020,48,26093,36209,773,81700,19877,8589,16717,6013,5085,3622,1414,583,10040,8846,1194,8846,4087,4759,2020-01-01,zipcode,Houston
ZCTA5 77021,48,25769,38638,988,121100,21060,8910,17530,2361,5166,4475,3171,2357,12283,10506,1777,10506,4389,6117,2020-01-01,zipcode,Houston
ZCTA5 77030,48,11362,86971,1459,660400,9139,3214,7796,202,202,814,2775,3803,5960,5089,871,5089,2227,2862,2020-01-01,zipcode,Houston
ZCTA5 77037,48,18030,41611,958,109600,13194,5058,11147,6287,2867,1317,354,322,5531,5221,310,5221,3727,1494,2020-01-01,zipcode,Houston
ZCTA5 77045,48,35010,60424,1181,92300,26226,9971,20701,4868,7254,5500,2014,1065,10625,10091,534,10091,6165,3926,2020-01-01,zipcode,Houston
ZCTA5 77082,48,52830,51768,1150,169800,42326,12333,36735,5215,8135,10523,8469,4393,23756,21135,2621,21135,7602,13533,2020-01-01,zipcode,Houston
ZCTA5 77084,48,108161,66471,1303,173800,80787,24293,65912,11720,14428,20068,13664,6032,37811,34667,3144,34667,20958,13709,2020-01-01,zipcode,Houston
ZCTA5 77301,48,34512,49842,971,137100,25707,9245,21150,7040,6261,5095,1790,964,11703,10655,1048,10655,5670,4985,2020-01-01,zipcode,Conroe
ZCTA5 77316,48,27475,113602,1556,347200,20499,6503,18006,932,4631,5522,5242,1679,9748,8927,821,8927,8025,902,2020-01-01,zipcode,Montgomery
ZCTA5 77318,48,18553,72014,1065,213700,15615,6627,13878,1571,4894,4210,2093,1110,7903,7123,780,7123,5305,1818,2020-01-01,zipcode,Willis
ZCTA5 77340,48,31404,32403,889,166500,27634,13245,17018,1432,5958,5328,2824,1476,13628,12009,1619,12009,4473,7536,2020-01-01,zipcode,Huntsville
ZCTA5 77346,48,63772,107880,1534,217200,46989,14177,40938,2135,7935,13392,12164,5312,21642,20907,735,20907,17399,3508,2020-01-01,zipcode,Humble
ZCTA5 77355,48,31201,93185,1169,252300,24388,8078,20589,2449,5589,7150,4113,1288,10717,10138,579,10138,8667,1471,2020-01-01,zipcode,Magnolia
ZCTA5 77373,48,62350,73757,1413,164200,47352,14610,40310,4604,11006,14871,7279,2550,21898,20656,1242,20656,14553,6103,2020-01-01,zipcode,Spring
ZCTA5 77434,48,4562,42215,726,58200,3658,1746,2966,660,1101,847,205,153,2054,1602,452,1602,1271,331,2020-01-01,zipcode,Eagle lake
ZCTA5 76033,48,25977,56883,1019,148300,20406,8280,17203,2304,6415,5305,2150,1029,10267,9625,642,9625,6293,3332,2020-01-01,zipcode,Cleburne
ZCTA5 76085,48,10965,75375,1062,246000,8922,3277,7707,889,2638,2782,878,520,3586,3322,264,3322,2772,550,2020-01-01,zipcode,Weatherford
ZCTA5 76129,48,1616,-666666666,-666666666,-666666666,1616,1183,22,0,0,10,12,0,0,0,0,0,0,0,2020-01-01,zipcode,Fort worth
ZCTA5 76164,48,13628,44257,887,88100,10653,4071,8528,4481,2577,1102,293,75,4525,4022,503,4022,2222,1800,2020-01-01,zipcode,Fort worth
ZCTA5 76182,48,31889,95657,1314,262000,25416,7961,22236,1141,4670,7544,6449,2432,11900,11508,392,11508,9601,1907,2020-01-01,zipcode,North richland hills
ZCTA5 76209,48,26244,59617,1123,192500,21048,5532,16312,2058,3367,4956,3639,2292,10527,9607,920,9607,4424,5183,2020-01-01,zipcode,Denton
ZCTA5 76210,48,46046,97070,1490,258900,37457,11278,31025,2715,5663,10230,7915,4502,15680,15190,490,15190,11447,3743,2020-01-01,zipcode,Denton
ZCTA5 76244,48,78815,108595,1612,267700,56960,13775,48712,1771,8438,15174,16789,6540,26447,24890,1557,24890,18574,6316,2020-01-01,zipcode,Keller
ZCTA5 76263,48,23,-666666666,-666666666,-666666666,23,0,23,0,3,20,0,0,28,12,16,12,12,0,2020-01-01,zipcode,Rosston
ZCTA5 76402,48,952,-666666666,-666666666,-666666666,952,555,14,0,0,0,14,0,0,0,0,0,0,0,2020-01-01,zipcode,Stephenville
ZCTA5 76508,48,7,-666666666,-666666666,-666666666,7,7,1,0,1,0,0,0,0,0,0,0,0,0,2020-01-01,zipcode,Temple
ZCTA5 76573,48,28,-666666666,-666666666,-666666666,22,16,14,10,4,0,0,0,10,10,0,10,10,0,2020-01-01,zipcode,Schwertner
ZCTA5 76596,48,1268,-666666666,-666666666,-666666666,1268,1268,1191,326,318,489,46,12,0,0,0,0,0,0,2020-01-01,zipcode,Gatesville
ZCTA5 76597,48,17,-666666666,-666666666,-666666666,17,17,17,4,7,6,0,0,0,0,0,0,0,0,2020-01-01,zipcode,Gatesville
ZCTA5 76598,48,482,-666666666,-666666666,-666666666,482,482,422,129,142,143,5,3,0,0,0,0,0,0,2020-01-01,zipcode,Gatesville
ZCTA5 76599,48,2351,-666666666,-666666666,-666666666,2351,2351,2221,604,618,928,63,8,0,0,0,0,0,0,2020-01-01,zipcode,Gatesville
ZCTA5 76623,48,254,-666666666,-666666666,93300,195,41,188,65,36,84,3,0,83,83,0,83,74,9,2020-01-01,zipcode,Avalon
ZCTA5 76650,48,153,56354,-666666666,75000,116,46,111,23,56,29,3,0,98,57,41,57,49,8,2020-01-01,zipcode,Irene
ZCTA5 76654,48,110,27500,842,137500,104,59,89,17,46,14,9,3,59,56,3,56,30,26,2020-01-01,zipcode,Leroy
ZCTA5 76820,48,86,156065,-666666666,377800,86,33,86,0,27,29,17,13,199,53,146,53,42,11,2020-01-01,zipcode,Art
ZCTA5 76836,48,3,-666666666,-666666666,-666666666,3,0,3,0,0,2,1,0,18,1,17,1,1,0,2020-01-01,zipcode,Doole
ZCTA5 76908,48,2541,-666666666,-666666666,-666666666,2541,0,375,0,53,243,79,0,7,0,7,0,0,0,2020-01-01,zipcode,Goodfellow afb
ZCTA5 76939,48,0,-666666666,-666666666,-666666666,0,0,0,0,0,0,0,0,8,0,8,0,0,0,2020-01-01,zipcode,Knickerbocker
ZCTA5 76957,48,158,-666666666,-666666666,-666666666,75,38,75,0,29,28,0,18,38,38,0,38,9,29,2020-01-01,zipcode,Wall
ZCTA5 76360,48,3581,40536,546,45100,2954,1401,2619,351,992,838,350,88,2051,1563,488,1563,1124,439,2020-01-01,zipcode,Electra
ZCTA5 76372,48,953,55481,458,73500,734,352,607,90,269,124,84,40,517,397,120,397,285,112,2020-01-01,zipcode,Newcastle
ZCTA5 76374,48,3891,39890,636,75500,3035,1384,2782,508,818,780,479,197,2071,1759,312,1759,1207,552,2020-01-01,zipcode,Olney
ZCTA5 76427,48,1041,55313,840,94200,796,385,626,64,285,205,61,11,439,365,74,365,215,150,2020-01-01,zipcode,Bryson
ZCTA5 76429,48,154,43948,-666666666,260000,154,44,154,0,115,29,10,0,261,129,132,129,28,101,2020-01-01,zipcode,Caddo
ZCTA5 76501,48,16922,45846,699,120600,13089,6061,10901,1912,3162,3696,1534,597,6980,6342,638,6342,4132,2210,2020-01-01,zipcode,Temple
ZCTA5 76502,48,42946,70762,1117,166500,31135,11431,27083,1848,5980,9836,5371,4048,16558,15313,1245,15313,10158,5155,2020-01-01,zipcode,Temple
ZCTA5 76261,48,261,67708,-666666666,52500,228,115,212,34,101,22,39,16,147,113,34,113,79,34,2020-01-01,zipcode,Ringgold
ZCTA5 76228,48,1215,62159,829,87900,999,476,878,80,320,282,153,43,575,463,112,463,372,91,2020-01-01,zipcode,Bellevue
ZCTA5 76248,48,39641,140982,1546,392000,30408,9740,25994,1052,3315,6828,9977,4822,13888,13647,241,13647,10838,2809,2020-01-01,zipcode,Keller
ZCTA5 76251,48,763,53750,1161,161700,624,308,569,54,213,181,99,22,343,278,65,278,223,55,2020-01-01,zipcode,Montague
ZCTA5 76268,48,224,53438,-666666666,34000,155,98,155,28,65,48,7,7,89,81,8,81,66,15,2020-01-01,zipcode,Southmayd
ZCTA5 76311,48,8760,72931,1324,-666666666,8034,786,2032,24,372,838,464,334,644,618,26,618,9,609,2020-01-01,zipcode,Sheppard afb
ZCTA5 76364,48,189,60250,1589,59000,139,42,130,8,46,29,27,20,104,79,25,79,47,32,2020-01-01,zipcode,Harrold
ZCTA5 76366,48,2152,47574,896,118600,1691,656,1401,135,568,410,189,99,1038,839,199,839,638,201,2020-01-01,zipcode,Holliday
ZCTA5 76430,48,2169,47436,587,106300,1769,697,1479,177,333,515,307,147,1188,930,258,930,756,174,2020-01-01,zipcode,Albany
ZCTA5 79312,48,1127,46250,519,57700,871,438,743,193,294,196,39,21,409,314,95,314,246,68,2020-01-01,zipcode,Amherst
ZCTA5 79324,48,58,-666666666,-666666666,259100,41,15,23,0,7,16,0,0,34,18,16,18,18,0,2020-01-01,zipcode,Enochs
ZCTA5 79329,48,2891,60410,625,162500,2250,787,2031,375,605,620,366,65,1399,1118,281,1118,860,258,2020-01-01,zipcode,Idalou
ZCTA5 79342,48,479,96111,424,90800,337,116,295,88,80,69,17,41,172,142,30,142,95,47,2020-01-01,zipcode,Loop
ZCTA5 79367,48,667,45114,745,71000,501,150,402,118,112,105,47,20,280,256,24,256,167,89,2020-01-01,zipcode,Smyer
ZCTA5 79370,48,1483,41389,548,55200,1254,655,1132,200,389,321,134,88,1128,626,502,626,484,142,2020-01-01,zipcode,Spur
ZCTA5 79371,48,1415,59688,632,80900,1119,400,945,192,310,296,115,32,747,612,135,612,489,123,2020-01-01,zipcode,Sudan
ZCTA5 79752,48,2415,53015,839,70000,1768,794,1528,364,618,393,71,82,1072,847,225,847,658,189,2020-01-01,zipcode,Mc camey
ZCTA5 79758,48,3425,103167,893,285000,2319,783,2084,130,743,1046,145,20,1147,1090,57,1090,973,117,2020-01-01,zipcode,Gardendale
ZCTA5 79772,48,14265,63264,878,100100,11441,5202,9513,3049,3341,2143,678,302,4107,3445,662,3445,2761,684,2020-01-01,zipcode,Pecos
ZCTA5 79110,48,19729,57040,1091,116300,14749,4402,12079,976,3788,5375,1386,554,7569,6948,621,6948,4449,2499,2020-01-01,zipcode,Amarillo
ZCTA5 79111,48,2140,58021,1054,-666666666,1527,765,1168,126,463,486,68,25,538,487,51,487,8,479,2020-01-01,zipcode,Amarillo
ZCTA5 79119,48,18510,82094,1025,267200,14743,4186,13037,527,2655,4484,3357,2014,7871,7215,656,7215,4701,2514,2020-01-01,zipcode,Amarillo
ZCTA5 79201,48,7227,43768,774,86100,5997,2794,5243,829,1981,1476,757,200,2919,2321,598,2321,1378,943,2020-01-01,zipcode,Childress
ZCTA5 79220,48,271,58375,-666666666,102900,208,60,169,57,41,22,32,17,142,73,69,73,41,32,2020-01-01,zipcode,Afton
ZCTA5 79247,48,35,-666666666,-666666666,21700,27,17,27,5,11,11,0,0,22,22,0,22,20,2,2020-01-01,zipcode,Odell
ZCTA5 79311,48,3777,52246,667,109300,2852,1165,2158,315,757,498,394,194,1473,1328,145,1328,1024,304,2020-01-01,zipcode,Abernathy
ZCTA5 79353,48,11,128750,-666666666,-666666666,11,6,11,0,0,6,5,0,6,6,0,6,6,0,2020-01-01,zipcode,Pep
ZCTA5 79358,48,1306,70000,836,133000,869,287,787,145,209,264,126,43,473,414,59,414,341,73,2020-01-01,zipcode,Ropesville
ZCTA5 79378,48,312,85625,411,85000,184,82,151,40,71,24,12,4,115,77,38,77,66,11,2020-01-01,zipcode,Wellman
ZCTA5 79403,48,16348,38243,809,61300,12281,4899,10162,2535,3910,2778,596,343,6454,5742,712,5742,3193,2549,2020-01-01,zipcode,Lubbock
ZCTA5 79404,48,9630,42826,717,59600,7694,3699,6745,1821,2469,1708,378,369,4336,3422,914,3422,2264,1158,2020-01-01,zipcode,Lubbock
ZCTA5 79407,48,22157,49736,924,122100,17765,5353,12857,1213,3410,3848,2680,1706,10446,9401,1045,9401,4146,5255,2020-01-01,zipcode,Lubbock
ZCTA5 79412,48,15597,34863,839,85100,11557,4329,9191,2641,3031,2418,751,350,6565,5773,792,5773,2886,2887,2020-01-01,zipcode,Lubbock
ZCTA5 79413,48,23820,56044,1195,155300,17692,5528,14440,1678,3681,3818,3467,1796,9450,8667,783,8667,5148,3519,2020-01-01,zipcode,Lubbock
ZCTA5 79502,48,1297,58235,-666666666,53500,1006,344,787,162,313,234,49,29,759,472,287,472,376,96,2020-01-01,zipcode,Aspermont
ZCTA5 79504,48,3375,57065,585,77000,2948,1287,2594,393,719,835,487,160,1582,1280,302,1280,1063,217,2020-01-01,zipcode,Baird
ZCTA5 79505,48,307,39821,-666666666,45000,227,101,214,18,60,111,25,0,208,97,111,97,75,22,2020-01-01,zipcode,Benjamin
ZCTA5 79607,48,3714,52143,1194,-666666666,2661,311,1292,14,152,770,220,136,841,792,49,792,0,792,2020-01-01,zipcode,Dyess afb
ZCTA5 79705,48,43119,97394,1275,269600,32800,8829,28468,3178,6038,8727,7972,2553,16891,15637,1254,15637,10849,4788,2020-01-01,zipcode,Midland
ZCTA5 77446,48,6781,16664,1011,193200,6449,3672,1055,58,214,375,313,95,1196,999,197,999,176,823,2020-01-01,zipcode,Prairie view
ZCTA5 77466,48,539,60250,982,178100,479,108,339,54,102,127,48,8,245,236,9,236,148,88,2020-01-01,zipcode,Pattison
ZCTA5 77469,48,57011,85401,1150,238800,44385,13987,38109,4442,8771,11230,9176,4490,19870,19102,768,19102,14496,4606,2020-01-01,zipcode,Richmond
ZCTA5 77336,48,12398,60802,1005,199400,9438,3921,7694,1213,2098,2834,1123,426,4737,4342,395,4342,3196,1146,2020-01-01,zipcode,Huffman
ZCTA5 77094,48,11022,164564,1533,385500,8644,3512,7896,162,715,1570,3668,1781,4274,3991,283,3991,3396,595,2020-01-01,zipcode,Houston
ZCTA5 77096,48,33299,66440,1069,361600,25447,8204,22447,1989,3371,4998,6489,5600,14819,12797,2022,12797,6507,6290,2020-01-01,zipcode,Houston
ZCTA5 77379,48,82493,99614,1291,262400,62697,20451,54349,2308,9831,15894,18303,8013,28967,27588,1379,27588,21301,6287,2020-01-01,zipcode,Spring
ZCTA5 77386,48,60252,112537,1626,250100,43791,12293,37078,1600,5561,12722,11753,5442,19213,18496,717,18496,14605,3891,2020-01-01,zipcode,Spring
ZCTA5 77389,48,39907,124315,1694,310300,27800,8824,24480,924,4394,6179,8232,4751,13898,12761,1137,12761,10345,2416,2020-01-01,zipcode,Spring
ZCTA5 77437,48,17177,51788,817,156600,12952,5030,10815,2314,3196,3215,1463,627,7214,6442,772,6442,4109,2333,2020-01-01,zipcode,El campo
ZCTA5 77451,48,36,29375,-666666666,-666666666,36,13,21,2,18,1,0,0,34,15,19,15,15,0,2020-01-01,zipcode,Kendleton
ZCTA5 77465,48,7331,62656,523,120900,5774,2307,4965,928,1731,1445,482,379,3831,2618,1213,2618,2154,464,2020-01-01,zipcode,Palacios
ZCTA5 77479,48,95615,139294,1780,384700,73904,24719,63484,3435,6382,12291,22392,18984,30835,29628,1207,29628,24460,5168,2020-01-01,zipcode,Sugar land
ZCTA5 77481,48,66,-666666666,-666666666,-666666666,66,65,66,0,65,1,0,0,70,66,4,66,1,65,2020-01-01,zipcode,Thompsons
ZCTA5 77853,48,1189,43333,650,118800,1050,490,891,245,304,188,109,45,664,508,156,508,436,72,2020-01-01,zipcode,Dime box
ZCTA5 77651,48,12729,75164,965,173900,9952,3513,8385,569,2137,3364,1447,868,5178,4707,471,4707,3731,976,2020-01-01,zipcode,Port neches
ZCTA5 77803,48,34026,42179,888,94100,25063,9523,20416,6625,6677,5487,1109,518,10652,9736,916,9736,5960,3776,2020-01-01,zipcode,Bryan
ZCTA5 77830,48,3007,90705,816,276300,2331,834,2054,174,593,657,393,237,1384,1178,206,1178,934,244,2020-01-01,zipcode,Anderson
ZCTA5 77859,48,6340,48265,751,99900,5127,1899,4292,874,1760,1024,383,251,3013,2644,369,2644,1886,758,2020-01-01,zipcode,Hearne
ZCTA5 77864,48,7824,61523,708,106000,6031,2375,5067,1096,1560,1545,625,241,3447,2767,680,2767,2036,731,2020-01-01,zipcode,Madisonville
ZCTA5 77867,48,315,53125,-666666666,-666666666,196,125,190,43,106,13,28,0,128,109,19,109,73,36,2020-01-01,zipcode,Mumford
ZCTA5 77474,48,13347,73105,964,181900,10254,3197,8929,1092,3299,2839,1298,401,5584,5241,343,5241,4337,904,2020-01-01,zipcode,Sealy
ZCTA5 77488,48,14832,48436,735,128900,11626,5057,9600,2015,2768,3331,877,609,6254,5276,978,5276,3282,1994,2020-01-01,zipcode,Wharton
ZCTA5 77503,48,24102,57584,959,112200,17598,5762,14375,4157,4881,3808,1217,312,8602,7776,826,7776,3849,3927,2020-01-01,zipcode,Pasadena
ZCTA5 77510,48,15223,82653,904,193900,12197,4551,10263,1079,3079,4519,1180,406,6226,5422,804,5422,4338,1084,2020-01-01,zipcode,Santa fe
ZCTA5 77521,48,60703,67918,1020,162900,44614,15295,36724,5720,10086,14441,4707,1770,22237,20786,1451,20786,12586,8200,2020-01-01,zipcode,Baytown
ZCTA5 76250,48,894,82875,1094,190400,697,277,602,35,132,267,105,63,370,359,11,359,314,45,2020-01-01,zipcode,Lindsay
ZCTA5 76943,48,3206,46992,559,104400,2601,886,2401,528,1237,446,133,57,1962,1354,608,1354,945,409,2020-01-01,zipcode,Ozona
ZCTA5 76108,48,42902,70450,1157,167400,32945,10296,28311,3063,8915,8853,4857,2623,16441,15347,1094,15347,10395,4952,2020-01-01,zipcode,Fort worth
ZCTA5 76061,48,59,-666666666,-666666666,-666666666,59,0,59,0,0,40,19,0,39,39,0,39,39,0,2020-01-01,zipcode,Lillian
ZCTA5 76084,48,9574,71375,949,148400,7380,3331,6067,1006,2445,1877,445,294,2817,2580,237,2580,2228,352,2020-01-01,zipcode,Venus
ZCTA5 76114,48,27151,55090,983,113900,21199,7473,17426,4564,6279,4315,1613,655,10099,9281,818,9281,5158,4123,2020-01-01,zipcode,Fort worth
ZCTA5 76120,48,19941,66786,1053,190600,15491,3923,12995,1390,2967,4819,2509,1310,8326,7362,964,7362,3573,3789,2020-01-01,zipcode,Fort worth
ZCTA5 76549,48,53490,54193,1107,146400,37785,11822,30884,1690,7698,14690,4638,2168,20444,18213,2231,18213,9072,9141,2020-01-01,zipcode,Killeen
ZCTA5 76630,48,1375,58846,981,120700,1078,491,993,169,322,399,82,21,590,524,66,524,466,58,2020-01-01,zipcode,Bruceville
ZCTA5 76177,48,10814,99018,1518,262400,8097,1698,7231,321,1459,2468,1972,1011,4190,3818,372,3818,2282,1536,2020-01-01,zipcode,Fort worth
ZCTA5 76208,48,24992,86735,1272,268500,18571,5849,15548,1414,3227,4855,4042,2010,8097,7648,449,7648,5321,2327,2020-01-01,zipcode,Denton
ZCTA5 76041,48,514,-666666666,-666666666,109800,465,160,430,44,71,175,140,0,236,201,35,201,177,24,2020-01-01,zipcode,Forreston
ZCTA5 76082,48,21151,73056,1076,164700,16400,6367,13917,2053,4852,4975,1570,467,7190,6258,932,6258,5258,1000,2020-01-01,zipcode,Springtown
ZCTA5 76133,48,53694,62207,1127,155300,40693,13384,34652,4474,9936,10076,5993,4173,20092,18593,1499,18593,11716,6877,2020-01-01,zipcode,Fort worth
ZCTA5 79323,48,7347,67891,627,161700,5183,1902,4134,1286,1365,1063,353,67,2583,2296,287,2296,1743,553,2020-01-01,zipcode,Denver city
ZCTA5 79326,48,63,-666666666,-666666666,115000,45,23,23,0,3,18,0,2,18,18,0,18,18,0,2020-01-01,zipcode,Fieldton
ZCTA5 79359,48,3129,46827,-666666666,56200,2227,953,1840,582,681,452,112,13,1092,930,162,930,626,304,2020-01-01,zipcode,Seagraves
ZCTA5 79380,48,94,41875,-666666666,-666666666,81,35,68,20,21,16,11,0,45,32,13,32,26,6,2020-01-01,zipcode,Whitharral
ZCTA5 79778,48,1115,65577,563,90800,850,331,710,133,254,190,115,18,493,432,61,432,356,76,2020-01-01,zipcode,Rankin
ZCTA5 35553,01,4359,31813,463,67900,3622,1954,2958,776,1286,581,177,138,2359,1655,704,1655,1332,323,2020-01-01,zipcode,Double springs
ZCTA5 35565,01,12115,38917,570,60400,9493,4578,8676,2092,3280,2388,505,411,6092,4891,1201,4891,3849,1042,2020-01-01,zipcode,Haleyville
ZCTA5 35574,01,1632,45250,291,117400,1282,706,1217,217,564,330,41,65,839,609,230,609,530,79,2020-01-01,zipcode,Kennedy
ZCTA5 35578,01,5691,38237,861,93200,4647,2692,4029,853,1691,973,335,177,2738,2256,482,2256,1944,312,2020-01-01,zipcode,Nauvoo
ZCTA5 35584,01,283,19844,833,49500,232,160,204,86,67,45,0,6,131,97,34,97,82,15,2020-01-01,zipcode,Sipsey
ZCTA5 35618,01,2003,29608,475,81200,1627,924,1313,276,556,357,69,55,1016,813,203,813,556,257,2020-01-01,zipcode,Courtland
ZCTA5 35647,01,1143,63967,355,113800,885,337,725,115,268,164,160,18,349,335,14,335,279,56,2020-01-01,zipcode,Lester
ZCTA5 35649,01,87,146250,-666666666,350000,76,52,75,1,7,30,22,15,23,23,0,23,23,0,2020-01-01,zipcode,Mooresville
ZCTA5 35652,01,9104,60733,714,139300,7330,2997,6632,803,2392,1790,1058,589,4515,3653,862,3653,3026,627,2020-01-01,zipcode,Rogersville
ZCTA5 35670,01,6443,52763,628,127200,5049,1969,4529,777,1173,1679,688,212,3199,2410,789,2410,1876,534,2020-01-01,zipcode,Somerville
ZCTA5 35542,01,681,37969,-666666666,80000,593,392,488,99,201,141,45,2,419,337,82,337,320,17,2020-01-01,zipcode,Bankston
ZCTA5 35544,01,635,47484,768,46400,573,212,562,72,193,184,98,15,345,311,34,311,162,149,2020-01-01,zipcode,Beaverton
ZCTA5 35564,01,2100,28667,573,101600,1754,939,1512,244,538,604,63,63,1172,948,224,948,759,189,2020-01-01,zipcode,Hackleburg
ZCTA5 35601,01,32299,43485,690,103300,25158,11012,21642,5111,6608,5672,3066,1185,14137,12167,1970,12167,7445,4722,2020-01-01,zipcode,Decatur
ZCTA5 35610,01,1721,45000,481,165000,1530,738,1442,177,673,356,119,117,806,732,74,732,616,116,2020-01-01,zipcode,Anderson
ZCTA5 35619,01,4534,51508,690,130400,3751,1668,3317,891,1201,885,266,74,2095,1703,392,1703,1362,341,2020-01-01,zipcode,Danville
ZCTA5 35646,01,4414,45677,516,89200,3857,2099,3334,603,1529,906,155,141,2449,1859,590,1859,1470,389,2020-01-01,zipcode,Leighton
ZCTA5 35654,01,8023,37063,544,133100,6349,3144,5521,1027,2477,1231,517,269,3733,3018,715,3018,2116,902,2020-01-01,zipcode,Russellville
ZCTA5 35672,01,5191,51118,568,106800,3761,1873,3304,422,1356,977,258,291,2621,1961,660,1961,1495,466,2020-01-01,zipcode,Town creek
ZCTA5 35744,01,1720,38672,-666666666,111500,1537,809,1308,213,725,255,53,62,854,669,185,669,535,134,2020-01-01,zipcode,Dutton
ZCTA5 35761,01,13229,62888,913,147000,10171,3585,9163,1158,2583,3070,1698,654,5452,5023,429,5023,4323,700,2020-01-01,zipcode,New market
ZCTA5 35763,01,18422,120629,1484,273300,13815,4631,12367,582,1857,2169,4286,3473,6703,6565,138,6565,5976,589,2020-01-01,zipcode,Owens cross roads
ZCTA5 35765,01,4112,58365,592,112300,3335,1818,2972,448,922,880,360,362,1994,1576,418,1576,1353,223,2020-01-01,zipcode,Pisgah
ZCTA5 35768,01,12224,42059,549,103100,9834,5028,8382,1518,3480,2167,759,458,5539,4602,937,4602,3137,1465,2020-01-01,zipcode,Scottsboro
ZCTA5 35769,01,9376,44969,671,150900,7672,3628,6955,720,1883,2438,1414,500,5075,3992,1083,3992,3153,839,2020-01-01,zipcode,Scottsboro
ZCTA5 35776,01,3596,43661,492,99800,2933,1455,2594,379,1111,741,226,137,1689,1382,307,1382,1165,217,2020-01-01,zipcode,Woodville
ZCTA5 35905,01,5852,55265,677,147300,4704,2375,4251,497,1350,1546,277,581,2964,2283,681,2283,1892,391,2020-01-01,zipcode,Gadsden
ZCTA5 35907,01,8692,70383,951,158300,7020,2954,6306,553,1692,2516,1036,509,3278,3004,274,3004,2693,311,2020-01-01,zipcode,Gadsden
ZCTA5 35960,01,9039,42604,652,158600,7793,4050,6974,1116,2796,2071,426,565,6289,4074,2215,4074,3028,1046,2020-01-01,zipcode,Centre
ZCTA5 35131,01,3784,39375,611,86500,2942,1478,2490,437,1063,632,215,143,1647,1278,369,1278,986,292,2020-01-01,zipcode,Ragland
ZCTA5 79001,48,174,90313,-666666666,97500,140,59,129,11,45,30,33,10,107,61,46,61,46,15,2020-01-01,zipcode,Adrian
ZCTA5 79005,48,1610,61250,776,118800,1244,364,1002,254,301,264,124,59,655,570,85,570,424,146,2020-01-01,zipcode,Booker
ZCTA5 79013,48,3447,37303,584,54200,2545,804,2041,1637,281,97,10,16,1259,1081,178,1081,531,550,2020-01-01,zipcode,Cactus
ZCTA5 79014,48,3844,62583,942,175000,2824,964,2365,421,871,589,382,102,1706,1326,380,1326,890,436,2020-01-01,zipcode,Canadian
ZCTA5 79029,48,15349,57457,892,129100,10711,3552,8841,2216,2636,2507,959,523,5738,4752,986,4752,3210,1542,2020-01-01,zipcode,Dumas
ZCTA5 79046,48,757,64306,-666666666,93600,518,179,436,63,139,114,104,16,313,245,68,245,178,67,2020-01-01,zipcode,Higgins
ZCTA5 79057,48,1320,57778,686,55000,983,393,838,122,291,278,114,33,749,516,233,516,368,148,2020-01-01,zipcode,Mclean
ZCTA5 79059,48,652,61310,531,97000,530,211,463,34,163,156,78,32,386,278,108,278,236,42,2020-01-01,zipcode,Miami
ZCTA5 79501,48,2535,46000,725,72500,2077,994,1898,325,509,799,217,48,1568,1176,392,1176,899,277,2020-01-01,zipcode,Anson
ZCTA5 79503,48,137,80744,-666666666,94000,129,41,129,10,12,57,31,19,127,91,36,91,72,19,2020-01-01,zipcode,Avoca
ZCTA5 79510,48,7801,53379,848,106000,6211,2643,5353,475,2063,1643,877,295,3724,2871,853,2871,2384,487,2020-01-01,zipcode,Clyde
ZCTA5 79526,48,873,50625,655,107000,643,313,590,87,177,173,111,42,485,351,134,351,310,41,2020-01-01,zipcode,Hermleigh
ZCTA5 79546,48,1734,47067,540,57800,1365,478,1205,158,422,368,193,64,1053,761,292,761,502,259,2020-01-01,zipcode,Rotan
ZCTA5 79548,48,197,51477,-666666666,-666666666,156,66,150,29,60,24,34,3,151,85,66,85,72,13,2020-01-01,zipcode,Rule
ZCTA5 79605,48,28259,49793,910,114500,22074,7140,18036,2151,6096,5733,2715,1341,12717,10980,1737,10980,6106,4874,2020-01-01,zipcode,Abilene
ZCTA5 79606,48,25568,65113,959,195300,19900,6411,16452,721,4043,5945,3425,2318,11472,10527,945,10527,5682,4845,2020-01-01,zipcode,Abilene
ZCTA5 79703,48,24683,80666,1371,169400,18431,4980,15003,3119,4896,4732,1671,585,8399,7883,516,7883,5028,2855,2020-01-01,zipcode,Midland
ZCTA5 79720,48,34454,57450,872,104400,27706,13341,23682,4797,8246,7491,2152,996,12543,10776,1767,10776,7055,3721,2020-01-01,zipcode,Big spring
ZCTA5 79731,48,4619,55703,829,89500,3314,1265,2804,661,1023,722,299,99,1633,1463,170,1463,1274,189,2020-01-01,zipcode,Crane
ZCTA5 79742,48,617,71339,548,85700,445,180,383,110,119,76,62,16,240,205,35,205,164,41,2020-01-01,zipcode,Grandfalls
ZCTA5 79745,48,6783,61648,834,80100,5127,2038,3957,1375,1178,1091,231,82,2679,2286,393,2286,1839,447,2020-01-01,zipcode,Kermit
ZCTA5 79068,48,3506,74753,849,124200,2812,853,2362,58,636,875,533,260,1499,1335,164,1335,1071,264,2020-01-01,zipcode,Panhandle
ZCTA5 79080,48,453,50000,-666666666,34700,372,232,341,27,130,144,35,5,401,196,205,196,189,7,2020-01-01,zipcode,Skellytown
ZCTA5 79082,48,165,55750,-666666666,72500,139,45,126,19,28,65,9,5,144,83,61,83,78,5,2020-01-01,zipcode,Springlake
ZCTA5 79087,48,637,56000,717,92500,516,188,465,144,115,115,79,12,320,256,64,256,190,66,2020-01-01,zipcode,Texline
ZCTA5 79096,48,2175,50179,851,117600,1578,573,1405,268,410,444,220,63,971,785,186,785,588,197,2020-01-01,zipcode,Wheeler
ZCTA5 79236,48,265,39018,675,22800,217,118,214,43,112,30,21,8,136,87,49,87,35,52,2020-01-01,zipcode,Guthrie
ZCTA5 79240,48,97,98750,-666666666,-666666666,67,18,62,0,21,29,12,0,36,22,14,22,14,8,2020-01-01,zipcode,Lelia lake
ZCTA5 79259,48,46,-666666666,-666666666,-666666666,46,14,46,0,4,0,42,0,46,16,30,16,16,0,2020-01-01,zipcode,Tell
ZCTA5 35741,01,3829,81654,1038,264300,3713,1437,3310,202,495,406,1797,410,1855,1817,38,1817,1509,308,2020-01-01,zipcode,Brownsboro
ZCTA5 35752,01,2192,41359,839,78000,1866,1012,1670,184,784,532,96,74,1168,981,187,981,756,225,2020-01-01,zipcode,Hollywood
ZCTA5 35759,01,8479,83779,1191,193200,6995,2101,6119,473,1497,1725,1700,724,3490,3434,56,3434,3218,216,2020-01-01,zipcode,Meridianville
ZCTA5 35766,01,171,-666666666,-666666666,-666666666,150,54,150,16,109,5,7,13,112,69,43,69,47,22,2020-01-01,zipcode,Princeton
ZCTA5 35801,01,24337,80276,936,295500,20261,8690,17911,1859,2724,3914,5774,3640,10938,10085,853,10085,6688,3397,2020-01-01,zipcode,Huntsville
ZCTA5 35810,01,30243,38450,896,87300,24558,10617,19314,2983,5463,6588,2972,1308,12775,11487,1288,11487,7374,4113,2020-01-01,zipcode,Huntsville
ZCTA5 35816,01,14219,25424,710,90500,12069,4557,8295,1377,1975,2649,1474,820,7771,6701,1070,6701,1944,4757,2020-01-01,zipcode,Huntsville
ZCTA5 35952,01,8318,40055,622,97900,6658,3050,5980,1271,2409,1701,420,179,3679,3161,518,3161,2384,777,2020-01-01,zipcode,Altoona
ZCTA5 35962,01,8327,48700,700,121500,6613,2614,5640,1377,1883,1590,422,368,3632,3150,482,3150,2317,833,2020-01-01,zipcode,Crossville
ZCTA5 35974,01,1641,46339,668,104500,1212,509,1096,265,314,326,108,83,759,651,108,651,419,232,2020-01-01,zipcode,Geraldine
ZCTA5 35976,01,17655,57885,641,189200,14708,7143,12839,1761,3395,3712,2771,1200,7981,6810,1171,6810,5301,1509,2020-01-01,zipcode,Guntersville
ZCTA5 35990,01,69,18598,-666666666,-666666666,69,65,67,33,32,2,0,0,60,41,19,41,39,2,2020-01-01,zipcode,Walnut grove
ZCTA5 35068,01,8431,69543,1028,162100,6552,2344,5900,644,1415,2324,860,657,3802,3645,157,3645,2701,944,2020-01-01,zipcode,Fultondale
ZCTA5 35645,01,13335,73103,691,187000,10808,4122,9621,555,3598,2970,1702,796,6026,5259,767,5259,4382,877,2020-01-01,zipcode,Killen
ZCTA5 35745,01,137,31250,-666666666,162500,129,76,117,5,81,19,5,7,154,74,80,74,65,9,2020-01-01,zipcode,Estillfork
ZCTA5 35774,01,175,51250,-666666666,-666666666,175,125,134,0,59,51,12,12,77,63,14,63,63,0,2020-01-01,zipcode,Trenton
ZCTA5 35984,01,1623,37420,803,159300,1480,790,1458,178,368,280,373,259,1572,833,739,833,629,204,2020-01-01,zipcode,Mentone
ZCTA5 35978,01,5435,43917,809,96700,4117,1857,3710,703,1593,1039,254,121,2208,1806,402,1806,1475,331,2020-01-01,zipcode,Henagar
ZCTA5 35634,01,9606,73967,875,198100,8228,3841,7237,528,2488,1925,1317,979,4482,3819,663,3819,3155,664,2020-01-01,zipcode,Florence
ZCTA5 35906,01,9926,49222,846,164700,7862,3420,6960,761,2206,2075,1224,694,4593,3746,847,3746,2383,1363,2020-01-01,zipcode,Rainbow city
ZCTA5 35983,01,3827,60324,595,155500,3170,1410,2807,204,1019,1139,253,192,2384,1536,848,1536,1310,226,2020-01-01,zipcode,Leesburg
ZCTA5 35013,01,72,-666666666,-666666666,-666666666,72,6,72,55,0,17,0,0,28,23,5,23,6,17,2020-01-01,zipcode,Allgood
ZCTA5 35032,01,41,-666666666,-666666666,69400,35,19,31,9,19,3,0,0,28,19,9,19,17,2,2020-01-01,zipcode,Bon air
ZCTA5 35187,01,5,-666666666,-666666666,-666666666,5,5,5,0,0,5,0,0,2,2,0,2,2,0,2020-01-01,zipcode,Wilton
ZCTA5 35229,01,816,-666666666,-666666666,-666666666,816,491,0,0,0,0,0,0,0,0,0,0,0,0,2020-01-01,zipcode,Birmingham
ZCTA5 35254,01,1698,-666666666,685,-666666666,1677,1123,175,38,81,0,29,27,239,134,105,134,50,84,2020-01-01,zipcode,Birmingham
ZCTA5 35577,01,61,46111,-666666666,74400,53,25,37,0,15,13,9,0,45,18,27,18,18,0,2020-01-01,zipcode,Natural bridge
ZCTA5 35615,01,162,-666666666,-666666666,-666666666,162,162,162,162,0,0,0,0,33,33,0,33,0,33,2020-01-01,zipcode,Belle mina
ZCTA5 35896,01,615,-666666666,-666666666,-666666666,615,319,0,0,0,0,0,0,0,0,0,0,0,0,2020-01-01,zipcode,Huntsville
ZCTA5 35033,01,2860,39978,525,117800,2223,1126,1974,592,457,653,171,101,1505,1145,360,1145,1007,138,2020-01-01,zipcode,Bremen
ZCTA5 35244,01,31935,95647,1149,295700,25126,7523,21690,855,2702,5537,7222,5374,13253,11845,1408,11845,8605,3240,2020-01-01,zipcode,Birmingham
ZCTA5 35548,01,1864,42283,380,59200,1647,760,1422,362,519,393,81,67,971,855,116,855,671,184,2020-01-01,zipcode,Brilliant
ZCTA5 35747,01,5828,57276,655,179000,4730,2141,4101,469,1507,1243,624,258,3112,2259,853,2259,1795,464,2020-01-01,zipcode,Grant
ZCTA5 35959,01,4348,36038,501,143300,3638,1909,3259,451,1446,889,217,256,3837,1872,1965,1872,1500,372,2020-01-01,zipcode,Cedar bluff
ZCTA5 78675,48,304,55054,-666666666,-666666666,275,108,256,72,82,19,68,15,247,129,118,129,106,23,2020-01-01,zipcode,Willow city
ZCTA5 78676,48,13981,76094,1066,355400,12035,4948,10375,705,1394,3251,2880,2145,6808,5884,924,5884,4608,1276,2020-01-01,zipcode,Wimberley
ZCTA5 78717,48,29463,117803,1407,390000,21010,5753,18454,506,1961,4617,6597,4773,10338,9916,422,9916,5900,4016,2020-01-01,zipcode,Austin
ZCTA5 78737,48,20609,134545,1682,482000,14049,4915,12695,199,1492,2986,4971,3047,6421,6280,141,6280,5708,572,2020-01-01,zipcode,Austin
ZCTA5 78747,48,20137,84098,1585,247200,16046,4323,13871,1689,3122,4134,3303,1623,6970,6657,313,6657,5305,1352,2020-01-01,zipcode,Austin
ZCTA5 78749,48,38503,102303,1460,363600,31339,8497,28549,926,2597,6229,10963,7834,16569,15836,733,15836,10462,5374,2020-01-01,zipcode,Austin
ZCTA5 78757,48,26485,77560,1238,447000,20960,5503,19421,1466,2982,3942,6841,4190,11917,11261,656,11261,6369,4892,2020-01-01,zipcode,Austin
ZCTA5 78836,48,80,-666666666,-666666666,-666666666,73,52,73,61,12,0,0,0,77,20,57,20,20,0,2020-01-01,zipcode,Catarina
ZCTA5 78220,48,17095,33243,940,80000,13036,6643,10384,2598,3669,2883,883,351,5873,5436,437,5436,3147,2289,2020-01-01,zipcode,San antonio
ZCTA5 78224,48,22569,50961,947,100700,16275,5829,13670,3402,4515,4095,1324,334,6353,6005,348,6005,3270,2735,2020-01-01,zipcode,San antonio
ZCTA5 78229,48,35589,40213,1017,153400,29032,9354,23503,2877,4960,7976,4636,3054,16937,14847,2090,14847,2339,12508,2020-01-01,zipcode,San antonio
ZCTA5 78264,48,10603,48799,993,101600,8049,3639,6540,1945,2109,1713,621,152,3277,2890,387,2890,2319,571,2020-01-01,zipcode,San antonio
ZCTA5 78336,48,12533,46483,916,146400,9793,4531,8352,1497,3601,2205,812,237,6684,4751,1933,4751,3197,1554,2020-01-01,zipcode,Aransas pass
ZCTA5 78352,48,256,-666666666,-666666666,32600,143,70,143,44,78,21,0,0,101,65,36,65,65,0,2020-01-01,zipcode,Edroy
ZCTA5 78368,48,9305,35131,563,74700,7641,3910,6593,1796,2079,2176,404,138,5043,3801,1242,3801,2890,911,2020-01-01,zipcode,Mathis
ZCTA5 07620,34,1459,161346,1117,2000001,1150,544,1052,72,94,87,484,315,572,518,54,518,455,63,2020-01-01,zipcode,Alpine
ZCTA5 07640,34,4735,135750,3010,597400,3714,1303,3363,36,366,700,1389,872,1796,1746,50,1746,1689,57,2020-01-01,zipcode,Harrington park
ZCTA5 07662,34,5580,87171,1710,391500,4992,1710,4157,375,1242,919,1176,445,2189,2139,50,2139,1686,453,2020-01-01,zipcode,Rochelle park
ZCTA5 07670,34,14550,180601,3073,848600,10380,3281,9157,241,723,811,3366,4016,4776,4670,106,4670,3673,997,2020-01-01,zipcode,Tenafly
ZCTA5 07703,34,117,-666666666,-666666666,-666666666,117,15,117,7,16,36,12,46,221,46,175,46,33,13,2020-01-01,zipcode,Fort monmouth
ZCTA5 07723,34,770,66500,1153,1066900,631,353,443,55,95,146,100,47,1145,284,861,284,159,125,2020-01-01,zipcode,Deal
ZCTA5 07731,34,38783,115403,1672,351500,30792,8619,25758,1596,7018,6809,6986,3349,13197,12737,460,12737,11384,1353,2020-01-01,zipcode,Howell
ZCTA5 07737,34,4186,114597,1387,340400,3244,843,2693,99,734,677,899,284,1528,1422,106,1422,1280,142,2020-01-01,zipcode,Leonardo
ZCTA5 07023,34,7686,171023,1859,495700,6017,1651,5391,92,868,709,2202,1520,2658,2604,54,2604,2253,351,2020-01-01,zipcode,Fanwood
ZCTA5 07026,34,31935,64236,1357,356500,26244,9588,22296,3361,8962,5026,3469,1478,12396,11670,726,11670,5207,6463,2020-01-01,zipcode,Garfield
ZCTA5 35205,01,20145,42071,852,200100,18651,6489,13652,801,2180,3248,4332,3091,12454,9978,2476,9978,2884,7094,2020-01-01,zipcode,Birmingham
ZCTA5 35208,01,13752,31480,875,78000,11018,5484,9170,1176,3251,3467,885,391,7229,5585,1644,5585,3286,2299,2020-01-01,zipcode,Birmingham
ZCTA5 35212,01,10498,28990,583,146300,7745,2878,6903,1078,1852,1991,1145,837,5718,4430,1288,4430,1927,2503,2020-01-01,zipcode,Birmingham
ZCTA5 35222,01,9299,62670,825,282100,7647,2258,6903,444,885,1561,2099,1914,4620,4081,539,4081,2310,1771,2020-01-01,zipcode,Birmingham
ZCTA5 35234,01,5545,20256,621,57200,4888,2822,4457,1090,1558,1362,362,85,2954,2254,700,2254,1143,1111,2020-01-01,zipcode,Birmingham
ZCTA5 35007,01,26510,75372,1096,172300,20512,6661,17712,1694,4161,5666,3917,2274,10138,9566,572,9566,7826,1740,2020-01-01,zipcode,Alabaster
ZCTA5 35016,01,17066,49046,606,151900,13380,6132,11532,1380,3579,4300,1534,739,7178,6319,859,6319,4826,1493,2020-01-01,zipcode,Arab
ZCTA5 07068,34,5841,142776,2594,516500,4646,1511,4323,108,700,930,1453,1132,2373,2237,136,2237,1716,521,2020-01-01,zipcode,Roseland
ZCTA5 07071,34,22453,90181,1488,408400,18845,5769,16458,1544,4834,3585,4265,2230,9495,9043,452,9043,5227,3816,2020-01-01,zipcode,Lyndhurst
ZCTA5 07083,34,55465,97246,1680,341700,47058,15077,40168,3957,10989,9917,10486,4819,20160,19268,892,19268,14395,4873,2020-01-01,zipcode,Union
ZCTA5 07102,34,13581,28990,874,310800,11319,5586,8689,2264,2512,1977,1057,879,6046,5721,325,5721,537,5184,2020-01-01,zipcode,Newark
ZCTA5 07108,34,24777,26758,918,207500,17644,6900,14828,2569,5283,5031,1498,447,11464,9658,1806,9658,1648,8010,2020-01-01,zipcode,Newark
ZCTA5 07109,34,36394,73384,1391,307300,30283,9638,25697,3382,8287,6720,5094,2214,13845,12819,1026,12819,7028,5791,2020-01-01,zipcode,Belleville
ZCTA5 07114,34,11947,24004,696,347600,10312,6878,9155,2460,4049,2080,452,114,4260,3537,723,3537,579,2958,2020-01-01,zipcode,Newark
ZCTA5 07410,34,32986,129965,1826,439100,26023,8081,22954,834,4148,4536,7525,5911,11824,11488,336,11488,9236,2252,2020-01-01,zipcode,Fair lawn
ZCTA5 07416,34,5491,78072,1112,200100,4613,1854,4135,294,1740,1351,550,200,2914,2543,371,2543,1634,909,2020-01-01,zipcode,Franklin
ZCTA5 07420,34,5470,84636,1466,269000,4620,1553,4085,339,1517,1043,785,401,2007,1888,119,1888,1473,415,2020-01-01,zipcode,Haskell
ZCTA5 07435,34,2898,121721,2062,407400,2431,822,2118,31,494,696,641,256,1551,1144,407,1144,953,191,2020-01-01,zipcode,Newfoundland
ZCTA5 07444,34,10542,95500,2574,401800,9177,4198,7875,253,2071,1941,2032,1578,5037,4814,223,4814,3899,915,2020-01-01,zipcode,Pompton plains
ZCTA5 07456,34,12183,123206,1827,359800,10084,2996,8743,442,2446,1922,2645,1288,4344,4232,112,4232,3998,234,2020-01-01,zipcode,Ringwood
ZCTA5 07604,34,12026,95784,1553,432000,9985,3127,8605,636,2147,2050,2320,1452,4469,4250,219,4250,2878,1372,2020-01-01,zipcode,Hasbrouck heights
ZCTA5 07608,34,110,-666666666,1643,-666666666,84,40,68,23,11,17,12,5,36,36,0,36,0,36,2020-01-01,zipcode,Teterboro
ZCTA5 79851,48,1689,-666666666,-666666666,-666666666,1442,1189,1276,566,424,225,61,0,358,270,88,270,202,68,2020-01-01,zipcode,Sierra blanca
ZCTA5 79010,48,833,-666666666,-666666666,-666666666,376,231,242,0,76,13,129,24,149,118,31,118,53,65,2020-01-01,zipcode,Boys ranch
ZCTA5 79036,48,5245,62835,798,82600,4246,1871,3869,413,1343,1655,395,63,2606,1790,816,1790,1645,145,2020-01-01,zipcode,Fritch
ZCTA5 79355,48,1926,62125,744,69900,1305,467,1116,389,159,406,136,26,706,567,139,567,349,218,2020-01-01,zipcode,Plains
ZCTA5 79356,48,5931,52917,701,79500,5285,3406,4327,1549,1333,940,345,160,1893,1669,224,1669,1133,536,2020-01-01,zipcode,Post
ZCTA5 07017,34,36313,53367,1145,229100,28859,9670,24901,3114,9735,7170,3568,1314,15660,13722,1938,13722,3546,10176,2020-01-01,zipcode,East orange
ZCTA5 07031,34,15681,87589,1408,372400,13291,3947,11961,984,3777,3019,2729,1452,6597,6376,221,6376,3072,3304,2020-01-01,zipcode,North arlington
ZCTA5 07064,34,3973,106544,1326,322000,3062,943,2718,320,742,766,579,311,1350,1283,67,1283,1102,181,2020-01-01,zipcode,Port reading
ZCTA5 07065,34,29691,77393,1271,276500,24203,7660,21232,2198,7386,5213,4081,2354,12249,11621,628,11621,6687,4934,2020-01-01,zipcode,Rahway
ZCTA5 07090,34,29668,158491,1713,773800,22067,7618,19227,385,2148,2346,7779,6569,10659,10177,482,10177,8224,1953,2020-01-01,zipcode,Westfield
ZCTA5 07094,34,20667,125142,1907,473600,17273,6039,15429,1220,3183,2703,5126,3197,8120,7672,448,7672,4395,3277,2020-01-01,zipcode,Secaucus
ZCTA5 07104,34,51084,40957,1139,282100,39573,14764,32726,8970,10229,7708,4073,1746,19983,18429,1554,18429,4673,13756,2020-01-01,zipcode,Newark
ZCTA5 07302,34,47339,144172,2524,736700,40636,8070,38721,1832,3206,3690,15087,14906,25615,23261,2354,23261,5983,17278,2020-01-01,zipcode,Jersey city
ZCTA5 07307,34,40012,66795,1382,452500,32468,9722,28693,4214,7112,5194,7458,4715,16765,15628,1137,15628,4891,10737,2020-01-01,zipcode,Jersey city
ZCTA5 07403,34,8001,97674,1797,319800,6306,2091,5030,262,1475,1072,1479,742,2996,2897,99,2897,1951,946,2020-01-01,zipcode,Bloomingdale
ZCTA5 07423,34,4096,230682,2405,786800,2974,908,2705,23,165,248,1099,1170,1595,1438,157,1438,1354,84,2020-01-01,zipcode,Ho ho kus
ZCTA5 77039,48,27987,36943,965,105500,20137,8065,15995,7237,5027,3030,583,118,8679,7995,684,7995,4530,3465,2020-01-01,zipcode,Houston
ZCTA5 77040,48,50343,60572,1131,171700,39350,12093,33174,6364,7706,9864,6461,2779,19191,18259,932,18259,9801,8458,2020-01-01,zipcode,Houston
ZCTA5 77057,48,42897,58900,1144,312000,34602,9283,31161,4226,3894,6403,10121,6517,23686,20520,3166,20520,6706,13814,2020-01-01,zipcode,Houston
ZCTA5 77060,48,45376,31173,846,103200,30731,10693,24168,10737,7071,4876,1229,255,16530,14318,2212,14318,3287,11031,2020-01-01,zipcode,Houston
ZCTA5 77067,48,34582,44196,935,135000,24675,8456,19635,5541,5952,5621,1586,935,11334,10140,1194,10140,4369,5771,2020-01-01,zipcode,Houston
ZCTA5 77068,48,10837,82911,1152,233400,8459,2446,7190,917,1406,2487,1693,687,4175,3721,454,3721,2500,1221,2020-01-01,zipcode,Houston
ZCTA5 77077,48,61908,61550,1240,300100,50050,14854,44396,1466,5391,12308,15586,9645,32109,28771,3338,28771,10183,18588,2020-01-01,zipcode,Houston
ZCTA5 77303,48,22040,58417,1050,159100,16242,4786,13526,2083,5674,4324,770,675,8013,7317,696,7317,5292,2025,2020-01-01,zipcode,Conroe
ZCTA5 77335,48,3468,47386,1052,122600,2718,967,2267,404,815,736,291,21,1666,1240,426,1240,1016,224,2020-01-01,zipcode,Goodrich
ZCTA5 77368,48,102,-666666666,-666666666,-666666666,87,55,87,24,36,9,0,18,90,45,45,45,45,0,2020-01-01,zipcode,Romayor
ZCTA5 77381,48,35487,121069,1421,361200,28233,11477,24587,601,3232,5616,9356,5782,13642,13027,615,13027,9903,3124,2020-01-01,zipcode,Spring
ZCTA5 77385,48,24619,94957,1414,234100,18355,5445,16070,930,3039,5854,4226,2021,8914,8448,466,8448,6883,1565,2020-01-01,zipcode,Conroe
ZCTA5 77422,48,13965,62966,920,152800,11638,6579,10114,1432,3758,3747,854,323,6394,4957,1437,4957,4044,913,2020-01-01,zipcode,Brazoria
ZCTA5 77426,48,2415,82308,1301,262600,2024,801,1721,238,406,635,315,127,1178,916,262,916,648,268,2020-01-01,zipcode,Chappell hill
ZCTA5 77445,48,14629,50605,966,168100,10339,4143,8533,1160,3128,2740,1079,426,5662,5047,615,5047,2963,2084,2020-01-01,zipcode,Hempstead
ZCTA5 77081,48,51781,34817,863,318300,36785,9811,30355,11122,7693,5039,4293,2208,20763,18632,2131,18632,1091,17541,2020-01-01,zipcode,Houston
ZCTA5 75684,48,8086,46107,807,111900,6194,2917,5442,944,2120,1842,451,85,2879,2402,477,2402,1919,483,2020-01-01,zipcode,Overton
ZCTA5 75692,48,4387,63500,1105,97200,3598,1756,3193,395,1132,1074,408,184,1873,1458,415,1458,1320,138,2020-01-01,zipcode,Waskom
ZCTA5 75708,48,9461,55100,737,113500,6697,2460,5382,1884,1606,1489,232,171,3154,2625,529,2625,1951,674,2020-01-01,zipcode,Tyler
ZCTA5 75750,48,3414,64597,803,124600,2748,1130,2457,322,1088,708,235,104,1265,1175,90,1175,930,245,2020-01-01,zipcode,Arp
ZCTA5 75759,48,116,21923,-666666666,84600,97,49,70,11,27,32,0,0,43,32,11,32,30,2,2020-01-01,zipcode,Cuney
ZCTA5 75778,48,2468,39856,664,101000,2004,1156,1779,177,574,609,353,66,1314,1011,303,1011,806,205,2020-01-01,zipcode,Murchison
ZCTA5 75035,48,80269,136579,1854,388600,57941,15677,50293,1836,4187,10872,19180,14218,26977,25783,1194,25783,20049,5734,2020-01-01,zipcode,Frisco
ZCTA5 75038,48,29886,61021,1160,279800,23179,5201,20026,1400,4067,5428,5567,3564,14155,12698,1457,12698,2199,10499,2020-01-01,zipcode,Irving
ZCTA5 75051,48,41317,41455,963,118700,29891,10973,24198,8053,8465,5169,1782,729,14514,13453,1061,13453,6597,6856,2020-01-01,zipcode,Grand prairie
ZCTA5 75060,48,49307,59539,1069,158000,36019,11372,29332,10542,7577,6062,3676,1475,14973,14175,798,14175,9002,5173,2020-01-01,zipcode,Irving
ZCTA5 75856,48,171,-666666666,-666666666,-666666666,150,25,41,0,16,25,0,0,117,64,53,64,16,48,2020-01-01,zipcode,Pennington
ZCTA5 75024,48,43041,102030,1474,432500,34361,9271,29846,549,2911,5527,12397,8462,19098,17490,1608,17490,6911,10579,2020-01-01,zipcode,Plano
ZCTA5 75028,48,48641,130075,1751,341100,36816,9901,32617,859,3993,8125,13256,6384,17531,17046,485,17046,14236,2810,2020-01-01,zipcode,Flower mound
ZCTA5 75039,48,20627,92120,1525,453500,16970,3128,15836,172,896,2929,6618,5221,11331,10075,1256,10075,1536,8539,2020-01-01,zipcode,Irving
ZCTA5 75041,48,31250,53446,1072,151000,22662,7069,18014,5828,4758,4887,1801,740,10181,9459,722,9459,5504,3955,2020-01-01,zipcode,Garland
ZCTA5 75043,48,62721,66461,1163,179700,48095,14210,39681,7094,9063,13685,6196,3643,22269,21160,1109,21160,12942,8218,2020-01-01,zipcode,Garland
ZCTA5 75056,48,59674,93382,1436,286600,46868,10730,41555,2496,7466,12102,13516,5975,23763,22310,1453,22310,14386,7924,2020-01-01,zipcode,The colony
ZCTA5 75076,48,8297,57476,1028,168600,6978,2573,6293,362,2134,2523,964,310,4416,3237,1179,3237,2584,653,2020-01-01,zipcode,Pottsboro
ZCTA5 75102,48,1455,51705,929,95000,1138,417,991,232,229,417,112,1,611,463,148,463,383,80,2020-01-01,zipcode,Barry
ZCTA5 75082,48,23418,112622,1685,362300,19340,5777,17036,308,1632,3847,6529,4720,9172,8670,502,8670,6152,2518,2020-01-01,zipcode,Richardson
ZCTA5 75093,48,47908,113428,1487,477800,39285,12958,34961,662,3094,6752,14096,10357,21042,19566,1476,19566,12415,7151,2020-01-01,zipcode,Plano
ZCTA5 75103,48,15358,59129,963,172600,12676,6588,11363,1361,3723,4253,1504,522,6535,5797,738,5797,4757,1040,2020-01-01,zipcode,Canton
ZCTA5 75116,48,19755,45427,1147,147700,15059,5669,12501,2183,4004,4040,1378,896,7228,6811,417,6811,4023,2788,2020-01-01,zipcode,Duncanville
ZCTA5 75117,48,4505,71080,1042,162800,3062,1249,2645,176,765,1301,290,113,1697,1446,251,1446,1114,332,2020-01-01,zipcode,Edgewood
ZCTA5 75126,48,52078,92808,1524,231400,37298,10106,31261,2659,8252,11199,6582,2569,15924,15405,519,15405,12737,2668,2020-01-01,zipcode,Forney
ZCTA5 75132,48,2326,88981,2107,225700,1778,464,1427,87,284,320,448,288,916,866,50,866,704,162,2020-01-01,zipcode,Fate
ZCTA5 75137,48,19341,75298,1360,185600,15210,5972,12741,1529,3466,3966,2071,1709,7194,6762,432,6762,4776,1986,2020-01-01,zipcode,Duncanville
ZCTA5 75149,48,57758,52304,1113,139400,42500,14295,34339,8156,11050,10823,3064,1246,19320,18502,818,18502,11534,6968,2020-01-01,zipcode,Mesquite
ZCTA5 75150,48,61863,59189,1155,161000,46377,14287,37982,7242,11152,11949,5440,2199,23253,21308,1945,21308,9909,11399,2020-01-01,zipcode,Mesquite
ZCTA5 75202,48,2739,92500,1543,269200,2637,288,2223,19,102,526,930,646,2219,1736,483,1736,489,1247,2020-01-01,zipcode,Dallas
ZCTA5 75205,48,24726,159076,1742,1212700,20265,7925,14729,203,556,1600,6252,6118,10514,9065,1449,9065,5470,3595,2020-01-01,zipcode,Dallas
ZCTA5 75214,48,34658,92676,1300,516200,27844,6609,25594,1091,2304,4471,10448,7280,17484,16061,1423,16061,8779,7282,2020-01-01,zipcode,Dallas
ZCTA5 75251,48,3750,75769,1427,-666666666,3303,602,2587,45,282,810,991,459,2837,2266,571,2266,0,2266,2020-01-01,zipcode,Dallas
ZCTA5 07030,34,53283,153438,2360,759800,46372,9531,40387,1825,3354,3080,19532,12596,27740,24983,2757,24983,8654,16329,2020-01-01,zipcode,Hoboken
ZCTA5 07041,34,6862,160469,1663,833500,5205,1669,4724,193,512,442,1508,2069,2743,2537,206,2537,1750,787,2020-01-01,zipcode,Millburn
ZCTA5 07050,34,30374,43568,1197,256300,23194,8615,19787,3756,6905,5140,2619,1367,12784,11831,953,11831,2241,9590,2020-01-01,zipcode,Orange
ZCTA5 07058,34,5665,153500,2039,661800,4478,1253,4132,54,413,951,1539,1175,2180,2114,66,2114,1411,703,2020-01-01,zipcode,Pine brook
ZCTA5 07059,34,15699,160921,2000,779000,12346,4185,10940,383,1909,1705,3552,3391,5586,5298,288,5298,4640,658,2020-01-01,zipcode,Warren
ZCTA5 07066,34,15835,106764,1460,466400,12947,4256,11483,824,3067,2565,2998,2029,6221,6043,178,6043,4725,1318,2020-01-01,zipcode,Clark
ZCTA5 07075,34,9016,119840,1614,443600,7719,2241,6468,135,1649,1558,1970,1156,3511,3408,103,3408,2286,1122,2020-01-01,zipcode,Wood ridge
ZCTA5 07079,34,16795,150469,1857,644900,13826,4611,10067,225,1065,1434,3755,3588,5600,5201,399,5201,3551,1650,2020-01-01,zipcode,South orange
ZCTA5 07082,34,5244,91063,2653,486600,4053,1620,3480,58,571,585,1475,791,2106,1979,127,1979,1891,88,2020-01-01,zipcode,Towaco
ZCTA5 07088,34,3395,67604,1695,258600,2862,1210,2319,313,746,786,350,124,1182,1114,68,1114,654,460,2020-01-01,zipcode,Vauxhall
ZCTA5 07092,34,6918,124000,3432,638500,5529,2434,5111,255,945,952,1656,1303,2558,2544,14,2544,2198,346,2020-01-01,zipcode,Mountainside
ZCTA5 07103,34,33548,34117,1048,195800,25680,10847,20335,4591,6410,5561,2475,1298,13877,12192,1685,12192,2894,9298,2020-01-01,zipcode,Newark
ZCTA5 07106,34,33688,40989,1088,240200,26905,9075,22647,2808,8806,6820,2820,1393,13907,11944,1963,11944,3948,7996,2020-01-01,zipcode,Newark
ZCTA5 07010,34,25410,83989,1552,454400,21527,8161,18979,2206,4121,3809,5806,3037,11444,10592,852,10592,5324,5268,2020-01-01,zipcode,Cliffside park
ZCTA5 07013,34,26942,99886,1358,373600,23192,8113,20596,2621,4903,4174,5934,2964,10715,10335,380,10335,7164,3171,2020-01-01,zipcode,Clifton
ZCTA5 07018,34,28680,49464,1180,218500,22802,7728,19066,2646,6386,5970,2756,1308,12619,10720,1899,10720,2259,8461,2020-01-01,zipcode,East orange
ZCTA5 07073,34,9707,76777,1504,381000,8131,2742,7404,474,2183,1901,1983,863,4661,4319,342,4319,1425,2894,2020-01-01,zipcode,East rutherford
ZCTA5 07039,34,30059,168120,2472,626000,23151,8271,20434,687,2455,2368,7131,7793,10620,10280,340,10280,8730,1550,2020-01-01,zipcode,Livingston
ZCTA5 07043,34,12544,211094,2140,741900,9282,3223,7878,110,341,897,2969,3561,4330,4057,273,4057,3458,599,2020-01-01,zipcode,Montclair
ZCTA5 07055,34,69842,44832,1189,347900,49260,17490,39242,12948,14075,6070,4042,2107,20662,19837,825,19837,4280,15557,2020-01-01,zipcode,Passaic
ZCTA5 07077,34,2708,95505,1462,314800,2231,566,1995,181,712,436,475,191,1112,984,128,984,665,319,2020-01-01,zipcode,Sewaren
ZCTA5 07105,34,51097,45222,1281,341400,40523,14665,35451,11252,14595,4857,3401,1346,18180,17353,827,17353,3633,13720,2020-01-01,zipcode,Newark
ZCTA5 07111,34,54220,44898,1089,212000,41970,12929,35619,5097,13062,9971,4996,2493,23983,20636,3347,20636,5717,14919,2020-01-01,zipcode,Irvington
ZCTA5 07112,34,24376,36289,1127,241100,19363,6047,16299,2010,6060,5520,2283,426,11841,9911,1930,9911,2753,7158,2020-01-01,zipcode,Newark
ZCTA5 07205,34,21955,78779,1440,274600,17876,4914,15121,2067,4816,4048,3016,1174,7570,7162,408,7162,4974,2188,2020-01-01,zipcode,Hillside
ZCTA5 07304,34,43554,52903,1204,361900,33488,10841,29321,4274,9369,5791,6684,3203,17102,15476,1626,15476,4765,10711,2020-01-01,zipcode,Jersey city
ZCTA5 07306,34,51378,62734,1270,386100,42380,15958,36674,5608,7402,6211,11263,6190,21861,20026,1835,20026,4697,15329,2020-01-01,zipcode,Jersey city
ZCTA5 07401,34,6757,157958,1964,699100,5003,1951,4400,137,342,682,1909,1330,2444,2235,209,2235,1714,521,2020-01-01,zipcode,Allendale
ZCTA5 07405,34,17657,117077,1369,462600,14534,4204,12616,398,2716,2564,4448,2490,6952,6703,249,6703,5286,1417,2020-01-01,zipcode,Butler
ZCTA5 35006,01,3170,52788,-666666666,79600,2647,1238,2318,341,1185,652,94,46,1526,1133,393,1133,1061,72,2020-01-01,zipcode,Adger
ZCTA5 35014,01,4803,48284,1051,87900,4238,2449,3466,859,1309,990,171,137,1855,1582,273,1582,1466,116,2020-01-01,zipcode,Alpine
ZCTA5 78332,48,28301,43906,800,75400,21097,9234,17597,4016,6161,5031,1804,585,10953,9006,1947,9006,6070,2936,2020-01-01,zipcode,Alice
ZCTA5 78353,48,320,-666666666,-666666666,62900,296,241,296,176,35,56,29,0,364,214,150,214,132,82,2020-01-01,zipcode,Encino
ZCTA5 78503,48,20703,35130,977,104500,14890,6627,11763,4770,2008,1968,2027,990,7435,6137,1298,6137,3831,2306,2020-01-01,zipcode,Mcallen
ZCTA5 78577,48,78731,40463,774,81700,55110,22900,44943,14612,12193,10582,5619,1937,25829,22690,3139,22690,13423,9267,2020-01-01,zipcode,Pharr
ZCTA5 78932,48,470,87768,-666666666,-666666666,412,224,368,17,72,109,151,19,419,181,238,181,158,23,2020-01-01,zipcode,Carmine
ZCTA5 78885,48,124,80313,-666666666,309100,124,62,100,0,27,48,10,15,174,49,125,49,46,3,2020-01-01,zipcode,Vanderpool
ZCTA5 78870,48,1092,55972,-666666666,123800,819,257,632,106,192,156,146,32,399,323,76,323,243,80,2020-01-01,zipcode,Knippa
ZCTA5 78881,48,1601,26667,697,67600,1205,638,1159,274,466,260,78,81,1006,706,300,706,565,141,2020-01-01,zipcode,Sabinal
ZCTA5 78884,48,1645,66406,1036,180400,1269,514,1078,77,313,433,143,112,903,540,363,540,450,90,2020-01-01,zipcode,Utopia
ZCTA5 78934,48,6698,55775,768,161000,5143,2182,4475,593,1736,1185,749,212,3356,2246,1110,2246,1815,431,2020-01-01,zipcode,Columbus
ZCTA5 78935,48,926,-666666666,-666666666,-666666666,797,453,765,16,331,186,138,94,538,412,126,412,412,0,2020-01-01,zipcode,Alleyton
ZCTA5 78705,48,33262,23509,1365,405800,32752,17224,7264,296,784,1092,3263,1829,10506,8492,2014,8492,764,7728,2020-01-01,zipcode,Austin
ZCTA5 78759,48,45901,87080,1309,459600,38537,10044,34777,606,3113,7134,14042,9882,23061,21740,1321,21740,10542,11198,2020-01-01,zipcode,Austin
ZCTA5 78563,48,293,62589,-666666666,165100,293,137,293,31,174,42,36,10,144,104,40,104,87,17,2020-01-01,zipcode,Linn
ZCTA5 78133,48,19405,70938,1156,227500,16245,7311,14683,732,4646,4880,2576,1849,9743,7664,2079,7664,6661,1003,2020-01-01,zipcode,Canyon lake
ZCTA5 78258,48,47146,103908,1428,351300,36193,12252,31071,998,3132,8299,11642,7000,17452,16380,1072,16380,10555,5825,2020-01-01,zipcode,San antonio
ZCTA5 78404,48,16852,49112,960,117000,13718,5096,12200,2654,3331,3409,1669,1137,7604,6271,1333,6271,3198,3073,2020-01-01,zipcode,Corpus christi
ZCTA5 78580,48,14734,38096,723,58600,11358,4789,9168,2832,3534,2137,499,166,4632,3831,801,3831,2290,1541,2020-01-01,zipcode,Raymondville
ZCTA5 78639,48,8869,49916,828,192200,7712,3982,6821,1361,1760,2306,955,439,5191,3481,1710,3481,2461,1020,2020-01-01,zipcode,Kingsland
ZCTA5 78628,48,39529,97494,1218,329200,30596,11912,26972,1200,5384,8160,8096,4132,13569,13159,410,13159,9788,3371,2020-01-01,zipcode,Georgetown
ZCTA5 07430,34,26225,101405,2091,490500,21721,7995,17062,658,2994,3331,6396,3683,10026,9788,238,9788,7720,2068,2020-01-01,zipcode,Mahwah
ZCTA5 07504,34,11886,60636,1306,293900,9645,3386,8067,1119,3346,2034,1197,371,4007,3779,228,3779,1394,2385,2020-01-01,zipcode,Paterson
ZCTA5 35571,01,794,47202,681,83800,611,255,520,98,190,168,44,20,433,265,168,265,219,46,2020-01-01,zipcode,Hodges
ZCTA5 35576,01,3135,59028,491,113700,2497,1019,2205,214,991,700,165,135,1607,1227,380,1227,1063,164,2020-01-01,zipcode,Millport
ZCTA5 35594,01,6784,47860,562,118700,5404,2499,4829,825,1674,1683,412,235,3223,2469,754,2469,1860,609,2020-01-01,zipcode,Winfield
ZCTA5 35613,01,25936,81618,962,202200,21375,9971,19235,2774,4882,6215,3945,1419,8333,7884,449,7884,6932,952,2020-01-01,zipcode,Athens
ZCTA5 35614,01,7570,47961,768,132800,5415,2456,4780,833,1693,1545,476,233,2914,2487,427,2487,1978,509,2020-01-01,zipcode,Athens
ZCTA5 35650,01,13534,51683,523,130100,10912,5509,9581,1580,3817,2455,987,742,6072,5137,935,5137,4156,981,2020-01-01,zipcode,Moulton
ZCTA5 35671,01,2621,51903,1258,81000,2419,871,2130,395,885,328,410,112,1391,1125,266,1125,537,588,2020-01-01,zipcode,Tanner
ZCTA5 35673,01,7971,55213,611,124700,6416,2747,5613,939,2139,1695,587,253,3350,2816,534,2816,2182,634,2020-01-01,zipcode,Trinity
ZCTA5 35740,01,3342,37866,338,104200,2909,1596,2537,370,1123,766,225,53,1772,1553,219,1553,1024,529,2020-01-01,zipcode,Bridgeport
ZCTA5 08015,34,19236,67565,1292,167200,15361,5205,13136,1424,5161,4505,1321,725,8062,7173,889,7173,5734,1439,2020-01-01,zipcode,Browns mills
ZCTA5 08021,34,43835,55474,1060,148600,35045,10931,30813,2569,11161,9768,5173,2142,20431,18973,1458,18973,9167,9806,2020-01-01,zipcode,Clementon
ZCTA5 08226,34,11065,87060,1291,573400,9598,4488,8697,270,2003,1793,2733,1898,20549,5203,15346,5203,3696,1507,2020-01-01,zipcode,Ocean city
ZCTA5 08103,34,14239,27342,993,79800,11157,6105,8983,2572,3559,1743,641,468,5862,4932,930,4932,1735,3197,2020-01-01,zipcode,Camden
ZCTA5 08098,34,9125,95357,1082,264500,7708,3072,6665,395,2001,1733,1548,988,3729,3428,301,3428,2559,869,2020-01-01,zipcode,Woodstown
ZCTA5 08102,34,8050,22212,691,85300,6088,3477,4656,1887,1239,1071,381,78,3153,2687,466,2687,671,2016,2020-01-01,zipcode,Camden
ZCTA5 77517,48,6515,62127,1171,180600,5467,2149,4326,500,1708,1664,357,97,2105,2074,31,2074,1942,132,2020-01-01,zipcode,Santa fe
ZCTA5 77535,48,34603,58813,885,134800,27573,14307,23784,5121,9170,7543,1585,365,10942,9678,1264,9678,8052,1626,2020-01-01,zipcode,Dayton
ZCTA5 77539,48,44228,73285,1125,183400,34576,12516,30244,4126,7747,10303,5734,2334,18147,16255,1892,16255,12402,3853,2020-01-01,zipcode,Dickinson
ZCTA5 77551,48,22198,52222,1066,190600,18368,7921,15766,2432,4449,4622,2751,1512,10287,8751,1536,8751,3787,4964,2020-01-01,zipcode,Galveston
ZCTA5 75562,48,133,38939,-666666666,70000,133,48,104,0,43,33,23,5,66,66,0,66,66,0,2020-01-01,zipcode,Kildare
ZCTA5 75570,48,10703,54229,645,99700,9321,5518,8116,1596,3137,2131,945,307,3750,3050,700,3050,2024,1026,2020-01-01,zipcode,New boston
ZCTA5 75601,48,15256,46774,760,144900,12103,5422,10707,1583,3174,3633,1523,794,6608,5658,950,5658,3549,2109,2020-01-01,zipcode,Longview
ZCTA5 75638,48,5106,42609,673,80000,4234,2033,3587,319,1413,1206,479,170,2506,2242,264,2242,1685,557,2020-01-01,zipcode,Daingerfield
ZCTA5 75651,48,2300,50083,894,156600,1765,792,1584,197,595,476,239,77,1041,917,124,917,788,129,2020-01-01,zipcode,Harleton
ZCTA5 75654,48,12268,50323,708,139700,9354,3809,7927,1571,2293,2375,944,744,5222,4550,672,4550,3595,955,2020-01-01,zipcode,Henderson
ZCTA5 75704,48,10367,40583,877,125100,8507,3868,7562,1954,1662,2782,835,329,3861,3031,830,3031,2416,615,2020-01-01,zipcode,Tyler
ZCTA5 75756,48,4332,71208,906,108700,3268,945,2803,324,763,951,359,406,1914,1564,350,1564,1214,350,2020-01-01,zipcode,Brownsboro
ZCTA5 75757,48,13641,71029,1122,203300,10658,4740,8974,842,2238,2934,1861,1099,5122,4576,546,4576,3916,660,2020-01-01,zipcode,Bullard
ZCTA5 75760,48,2386,65142,540,131400,1891,991,1784,185,706,515,179,199,1322,1019,303,1019,827,192,2020-01-01,zipcode,Cushing
ZCTA5 75765,48,7507,52212,814,132900,6499,3727,5364,497,1496,1792,932,647,4286,2958,1328,2958,2465,493,2020-01-01,zipcode,Hawkins
ZCTA5 75771,48,20509,78037,1100,199300,16205,7254,13958,1103,3801,5075,2763,1216,8453,7109,1344,7109,5690,1419,2020-01-01,zipcode,Lindale
ZCTA5 75773,48,14305,53709,797,153500,11889,6030,10135,1858,3648,3171,832,626,5800,4939,861,4939,3667,1272,2020-01-01,zipcode,Mineola
ZCTA5 75790,48,3656,57269,809,127700,2702,893,2269,258,719,836,311,145,1501,1348,153,1348,1012,336,2020-01-01,zipcode,Van
ZCTA5 75831,48,6155,42395,784,88700,4771,2247,4227,964,1581,1166,348,168,2930,2209,721,2209,1582,627,2020-01-01,zipcode,Buffalo
ZCTA5 75839,48,6398,48986,906,94700,4753,2047,3869,417,1596,1351,370,135,2556,2161,395,2161,1779,382,2020-01-01,zipcode,Elkhart
ZCTA5 75848,48,100,39167,610,58500,78,38,45,7,13,21,4,0,54,42,12,42,27,15,2020-01-01,zipcode,Kirvin
ZCTA5 75849,48,51,35750,679,-666666666,47,26,29,4,19,6,0,0,24,17,7,17,5,12,2020-01-01,zipcode,Latexo
ZCTA5 75858,48,0,-666666666,-666666666,-666666666,0,0,0,0,0,0,0,0,21,0,21,0,0,0,2020-01-01,zipcode,Ratcliff
ZCTA5 75904,48,35208,51014,836,129400,26498,10169,22475,3314,6324,8114,3258,1465,14708,13009,1699,13009,7680,5329,2020-01-01,zipcode,Lufkin
ZCTA5 75932,48,1628,49583,-666666666,98600,1333,748,1142,243,398,415,64,22,1308,604,704,604,573,31,2020-01-01,zipcode,Burkeville
ZCTA5 75937,48,1033,39605,544,74600,837,443,721,105,307,216,67,26,460,374,86,374,319,55,2020-01-01,zipcode,Chireno
ZCTA5 75956,48,9595,36413,645,120000,7576,3627,6266,1163,2906,1561,253,383,4244,3664,580,3664,2820,844,2020-01-01,zipcode,Kirbyville
ZCTA5 75973,48,3036,49097,-666666666,108600,2434,1140,2080,354,798,609,261,58,1712,1188,524,1188,997,191,2020-01-01,zipcode,Shelbyville
ZCTA5 75211,48,77920,46226,967,122100,58307,21007,44987,19088,12717,8023,3692,1467,24380,22763,1617,22763,12464,10299,2020-01-01,zipcode,Dallas
ZCTA5 75449,48,1247,46118,792,96400,1019,484,797,95,210,319,112,61,768,483,285,483,309,174,2020-01-01,zipcode,Ladonia
ZCTA5 32744,12,3478,55446,1089,189400,2708,1078,2467,357,795,743,408,164,1442,1241,201,1241,1089,152,2020-01-01,zipcode,Lake helen
ZCTA5 32767,12,3226,56250,1044,97500,2737,1128,2392,437,1237,630,37,51,1340,1064,276,1064,898,166,2020-01-01,zipcode,Paisley
ZCTA5 32810,12,38248,53551,1229,175600,30030,8191,26158,3418,7912,8237,4975,1616,14325,13410,915,13410,7012,6398,2020-01-01,zipcode,Orlando
ZCTA5 32818,12,61027,48478,1131,189000,46967,13701,39099,6876,12236,12453,5417,2117,18679,17456,1223,17456,10016,7440,2020-01-01,zipcode,Orlando
ZCTA5 32820,12,10934,87054,1432,312900,8365,2253,6758,649,1831,1611,1301,1366,3291,2992,299,2992,2477,515,2020-01-01,zipcode,Orlando
ZCTA5 32827,12,9775,81545,1838,289400,7866,2851,6608,225,1184,1763,1987,1449,4609,3561,1048,3561,2150,1411,2020-01-01,zipcode,Orlando
ZCTA5 32922,12,17384,36397,835,112100,13150,4995,11383,1720,3722,4316,1033,592,8600,6982,1618,6982,3028,3954,2020-01-01,zipcode,Cocoa
ZCTA5 32927,12,27344,64940,1067,178400,22398,8226,20210,2075,5748,8099,2949,1339,11660,10005,1655,10005,8706,1299,2020-01-01,zipcode,Cocoa
ZCTA5 32949,12,2711,87250,-666666666,353000,2386,1133,2122,153,609,657,464,239,1149,954,195,954,906,48,2020-01-01,zipcode,Grant
ZCTA5 32407,12,11277,61450,1489,236300,9614,3140,8336,659,2168,2821,1718,970,8372,4976,3396,4976,2814,2162,2020-01-01,zipcode,Panama city beach
ZCTA5 32410,12,901,52607,1396,265300,887,470,852,12,148,355,171,166,1346,507,839,507,378,129,2020-01-01,zipcode,Mexico beach
ZCTA5 32425,12,14330,36866,700,89800,11663,6697,10243,2283,4475,2689,593,203,6067,4958,1109,4958,3615,1343,2020-01-01,zipcode,Bonifay
ZCTA5 32427,12,888,30625,591,104200,790,436,605,200,186,159,28,32,443,403,40,403,275,128,2020-01-01,zipcode,Caryville
ZCTA5 32431,12,4154,45234,658,113100,3447,1604,3118,587,1255,840,282,154,2345,1816,529,1816,1371,445,2020-01-01,zipcode,Cottondale
ZCTA5 32445,12,2427,44643,690,98100,2159,1706,1976,631,691,549,70,35,598,472,126,472,307,165,2020-01-01,zipcode,Malone
ZCTA5 32501,12,11422,28479,730,155800,9006,4448,7762,1381,2319,1997,1157,908,5461,4516,945,4516,2106,2410,2020-01-01,zipcode,Pensacola
ZCTA5 07001,34,17132,75947,1515,288100,13828,6850,12595,1259,5319,2765,1917,1335,5262,5055,207,5055,2779,2276,2021-01-01,zipcode,Avenel
ZCTA5 07002,34,70553,72839,1394,359800,56120,19636,49414,4915,15053,10502,13360,5584,29143,27036,2107,27036,10642,16394,2021-01-01,zipcode,Bayonne
ZCTA5 07003,34,52323,86195,1517,359500,42619,11984,36648,2835,9114,7533,11068,6098,20785,19959,826,19959,10223,9736,2021-01-01,zipcode,Bloomfield
ZCTA5 07004,34,7751,109100,2234,557100,6172,2124,5734,262,1312,1113,1901,1146,3020,2946,74,2946,2507,439,2021-01-01,zipcode,Fairfield
ZCTA5 07005,34,14912,110350,1503,481300,12031,3789,10341,523,2241,2050,3411,2116,5879,5606,273,5606,3899,1707,2021-01-01,zipcode,Boonton
ZCTA5 07006,34,26403,131864,1817,561900,21161,6532,18831,804,2497,3429,6668,5433,10134,9816,318,9816,7585,2231,2021-01-01,zipcode,Caldwell
ZCTA5 07008,34,25085,74623,1632,284000,19548,7045,16917,2708,5869,3923,3436,981,8740,8231,509,8231,4678,3553,2021-01-01,zipcode,Carteret
ZCTA5 07009,34,13073,139701,1315,514900,10830,3946,9491,359,1886,2038,3205,2003,4872,4791,81,4791,3908,883,2021-01-01,zipcode,Cedar grove
ZCTA5 07010,34,25515,89387,1586,470500,21584,8046,18655,2234,4372,3915,5393,2741,11198,10296,902,10296,4890,5406,2021-01-01,zipcode,Cliffside park
ZCTA5 07011,34,40680,65590,1467,342600,32818,9994,27634,4404,10663,6858,4446,1263,13940,13357,583,13357,5918,7439,2021-01-01,zipcode,Clifton
ZCTA5 07012,34,14711,89639,1498,377200,11169,3677,10081,764,2557,2278,2541,1941,5322,5215,107,5215,2818,2397,2021-01-01,zipcode,Clifton
ZCTA5 07013,34,29322,103292,1537,389100,24939,8567,22289,2280,5868,4601,6229,3311,11663,11341,322,11341,8046,3295,2021-01-01,zipcode,Clifton
ZCTA5 07014,34,4029,96759,1686,347800,3452,977,3146,84,1043,602,1008,409,1996,1716,280,1716,1236,480,2021-01-01,zipcode,Clifton
ZCTA5 07016,34,23823,139394,1796,538900,19082,5985,16811,503,3364,2698,5946,4300,9265,9029,236,9029,7160,1869,2021-01-01,zipcode,Cranford
ZCTA5 07017,34,38771,55501,1179,245600,30830,10609,27120,3312,10483,7876,3886,1563,16177,14597,1580,14597,4125,10472,2021-01-01,zipcode,East orange
ZCTA5 07018,34,30047,53926,1302,240100,23663,7850,20205,2541,6553,6406,3133,1572,13094,11407,1687,11407,2456,8951,2021-01-01,zipcode,East orange
ZCTA5 07020,34,14234,126483,2566,653000,12085,3189,11122,221,1406,1205,4625,3665,7438,6788,650,6788,2854,3934,2021-01-01,zipcode,Edgewater
ZCTA5 07021,34,2270,250001,3501,890200,1617,571,1428,14,84,131,569,630,808,714,94,714,688,26,2021-01-01,zipcode,Essex fells
ZCTA5 07022,34,14918,54904,1360,429600,13075,4173,11423,2598,3601,2351,2074,799,6369,6127,242,6127,2048,4079,2021-01-01,zipcode,Fairview
ZCTA5 07023,34,7727,178311,1869,498400,6086,1666,5414,122,700,783,2179,1630,2724,2670,54,2670,2390,280,2021-01-01,zipcode,Fanwood
ZCTA5 07024,34,39701,92456,1982,356200,33598,12523,31037,1609,5721,5006,10622,8079,19591,18189,1402,18189,10550,7639,2021-01-01,zipcode,Fort lee
ZCTA5 07026,34,32481,66296,1399,372900,26514,9571,22825,3361,9268,4893,3511,1792,12440,11762,678,11762,5291,6471,2021-01-01,zipcode,Garfield
ZCTA5 07027,34,4425,92981,1638,409800,3826,1149,3366,155,1031,954,770,456,1824,1814,10,1814,985,829,2021-01-01,zipcode,Garwood
ZCTA5 07028,34,7970,239779,1814,668400,5834,1711,4997,33,408,438,2190,1928,2539,2539,0,2539,2387,152,2021-01-01,zipcode,Glen ridge
ZCTA5 07029,34,21845,67829,1712,354700,17724,5092,15629,2271,4333,2747,3185,3093,9371,8771,600,8771,2139,6632,2021-01-01,zipcode,Harrison
ZCTA5 07030,34,59369,160890,2479,777600,51120,9728,44907,1935,3390,3524,21869,14189,30591,27932,2659,27932,9802,18130,2021-01-01,zipcode,Hoboken
ZCTA5 07031,34,16339,94012,1498,388100,13688,4357,12387,731,4167,3145,2769,1575,6975,6660,315,6660,3238,3422,2021-01-01,zipcode,North arlington
ZCTA5 07032,34,41790,76647,1416,359800,33870,11313,29861,4981,9991,6624,5624,2641,15024,14294,730,14294,6670,7624,2021-01-01,zipcode,Kearny
ZCTA5 07033,34,8377,107316,1758,384700,6398,1924,5522,588,1459,1699,1216,560,2931,2755,176,2755,1978,777,2021-01-01,zipcode,Kenilworth
ZCTA5 07034,34,9987,85757,1339,341500,8289,2521,7392,544,1525,1330,2829,1164,4242,4064,178,4064,2396,1668,2021-01-01,zipcode,Lake hiawatha
ZCTA5 07035,34,10898,105409,1636,353500,9438,3101,8317,509,2188,1816,2447,1357,4283,4079,204,4079,3116,963,2021-01-01,zipcode,Lincoln park
ZCTA5 07036,34,44931,79129,1369,306000,36965,11455,32534,4094,11416,9428,5058,2538,17185,16300,885,16300,9552,6748,2021-01-01,zipcode,Linden
ZCTA5 07039,34,31103,176991,2513,645800,24187,8492,21055,726,2227,2792,7289,8021,10835,10452,383,10452,9080,1372,2021-01-01,zipcode,Livingston
ZCTA5 07040,34,25420,156477,1884,566300,19064,4794,16554,478,1706,2985,6020,5365,8616,8264,352,8264,6654,1610,2021-01-01,zipcode,Maplewood
ZCTA5 07041,34,7352,180000,1801,846000,5503,1666,4982,205,477,320,1689,2291,2892,2668,224,2668,1862,806,2021-01-01,zipcode,Millburn
ZCTA5 07042,34,28049,128581,1827,553600,21948,5913,19280,623,2627,3807,6414,5809,11233,10454,779,10454,5557,4897,2021-01-01,zipcode,Montclair
ZCTA5 07043,34,13051,225263,2246,783200,9718,3040,8270,136,361,982,2806,3985,4394,4148,246,4148,3536,612,2021-01-01,zipcode,Montclair
ZCTA5 07044,34,14479,141040,1785,483400,11324,3711,10352,198,1678,1474,3834,3168,6002,5714,288,5714,4709,1005,2021-01-01,zipcode,Verona
ZCTA5 07045,34,10133,149659,1947,613400,8763,3126,7700,383,1422,1016,2754,2125,3743,3629,114,3629,3507,122,2021-01-01,zipcode,Montville
ZCTA5 07046,34,4464,250001,-666666666,818900,3133,1008,2688,67,224,204,1033,1160,1471,1413,58,1413,1318,95,2021-01-01,zipcode,Mountain lakes
ZCTA5 07047,34,62686,70934,1475,385900,51350,16260,45351,8715,11458,10883,9048,5247,24920,23315,1605,23315,9579,13736,2021-01-01,zipcode,North bergen
ZCTA5 07050,34,33505,48504,1242,268800,25843,9401,21938,4206,7389,5757,3225,1361,13364,12420,944,12420,2720,9700,2021-01-01,zipcode,Orange
ZCTA5 07052,34,48480,118326,1655,417700,39775,12552,34851,2798,6648,7294,10152,7959,17868,16977,891,16977,12201,4776,2021-01-01,zipcode,West orange
ZCTA5 07054,34,30692,100778,1491,479500,25600,7690,22359,1621,3389,3683,8151,5515,12239,11845,394,11845,5930,5915,2021-01-01,zipcode,Parsippany
ZCTA5 07055,34,70308,49436,1246,347900,49995,17185,39680,12889,14693,5799,4141,2158,20978,20217,761,20217,4308,15909,2021-01-01,zipcode,Passaic
ZCTA5 07057,34,11833,75410,1338,396300,10200,3496,8912,686,2863,2125,2261,977,5206,4917,289,4917,1846,3071,2021-01-01,zipcode,Wallington
ZCTA5 07058,34,5974,160019,2123,672000,4704,1448,4317,18,459,1177,1405,1258,2123,2123,0,2123,1475,648,2021-01-01,zipcode,Pine brook
ZCTA5 07059,34,16198,180708,2030,782700,12759,4209,11251,278,1960,1726,3631,3656,5754,5500,254,5500,4886,614,2021-01-01,zipcode,Warren
ZCTA5 07060,34,47683,62414,1332,288000,36613,10590,30855,6780,10106,6999,4756,2214,16610,15777,833,15777,6203,9574,2021-01-01,zipcode,Plainfield
ZCTA5 07062,34,14357,83640,1401,287200,11434,3369,9781,1316,3079,2625,1902,859,4820,4540,280,4540,2677,1863,2021-01-01,zipcode,Plainfield
ZCTA5 07063,34,14764,69750,1474,282000,11084,3029,9500,2027,3196,2186,1333,758,4534,4366,168,4366,2607,1759,2021-01-01,zipcode,Plainfield
ZCTA5 07064,34,3920,124228,1306,349600,3055,850,2750,271,715,872,701,191,1336,1286,50,1286,1126,160,2021-01-01,zipcode,Port reading
ZCTA5 07065,34,29582,81368,1405,293300,24061,7885,21259,1968,6354,5514,4984,2439,12819,12158,661,12158,6788,5370,2021-01-01,zipcode,Rahway
ZCTA5 07066,34,15445,114141,1467,488500,12548,4011,11032,515,2965,2565,2829,2158,6100,5902,198,5902,4657,1245,2021-01-01,zipcode,Clark
ZCTA5 07067,34,18776,109331,1750,381600,15271,5065,13543,961,3443,3299,3941,1899,6402,6249,153,6249,5548,701,2021-01-01,zipcode,Colonia
ZCTA5 07068,34,6240,145994,2598,551900,4995,1617,4756,91,702,921,1652,1390,2547,2429,118,2429,1922,507,2021-01-01,zipcode,Roseland
ZCTA5 07069,34,6696,139583,2269,704000,5416,1894,4959,174,746,1122,1560,1357,2475,2327,148,2327,2018,309,2021-01-01,zipcode,Watchung
ZCTA5 07070,34,18781,118462,1589,497200,15512,5022,13079,619,2574,2691,4359,2836,6946,6720,226,6720,4120,2600,2021-01-01,zipcode,Rutherford
ZCTA5 07071,34,22315,91367,1488,424000,18761,5842,16391,1691,5038,3628,4012,2022,9464,9083,381,9083,5223,3860,2021-01-01,zipcode,Lyndhurst
ZCTA5 07072,34,6358,108479,1609,428800,5506,1742,4547,279,1798,971,1076,423,2568,2411,157,2411,1477,934,2021-01-01,zipcode,Carlstadt
ZCTA5 07073,34,9918,86592,1577,402800,8440,2479,7585,692,1731,1943,2352,867,4658,4356,302,4356,1503,2853,2021-01-01,zipcode,East rutherford
ZCTA5 07074,34,3079,83125,1096,373500,2324,678,2099,144,792,584,372,207,1002,970,32,970,676,294,2021-01-01,zipcode,Moonachie
ZCTA5 07075,34,9865,123184,1775,454700,8193,2332,6931,260,1432,1727,2206,1306,3820,3735,85,3735,2367,1368,2021-01-01,zipcode,Wood ridge
ZCTA5 07076,34,24737,161348,1722,568200,19356,5711,16974,581,2625,2799,6143,4826,9077,8903,174,8903,7384,1519,2021-01-01,zipcode,Scotch plains
ZCTA5 07077,34,3342,101532,1398,321700,2809,649,2454,258,812,486,559,339,1210,1187,23,1187,759,428,2021-01-01,zipcode,Sewaren
ZCTA5 07078,34,14285,250001,3501,1394000,10115,3339,8882,135,263,656,2745,5083,4527,4464,63,4464,4006,458,2021-01-01,zipcode,Short hills
ZCTA5 07079,34,18450,158333,1944,666900,14919,4970,11118,271,1211,1435,4185,4016,5960,5680,280,5680,3814,1866,2021-01-01,zipcode,South orange
ZCTA5 07080,34,24251,114293,1766,362200,20033,5833,17689,1208,4667,4548,4550,2716,8390,8144,246,8144,6977,1167,2021-01-01,zipcode,South plainfield
ZCTA5 07081,34,17004,137390,1855,463900,13914,3373,12126,430,1988,1804,4842,3062,6763,6534,229,6534,4279,2255,2021-01-01,zipcode,Springfield
ZCTA5 07082,34,5867,141000,1650,522400,4393,1497,3700,52,559,528,1515,1046,2116,1980,136,1980,1944,36,2021-01-01,zipcode,Towaco
ZCTA5 07083,34,56903,105578,1770,352700,48178,14941,41709,4029,10605,10113,11627,5335,20588,19667,921,19667,14863,4804,2021-01-01,zipcode,Union
ZCTA5 07086,34,16215,104892,1938,739300,13587,3006,12904,941,2209,1814,4458,3482,8737,7565,1172,7565,2449,5116,2021-01-01,zipcode,Weehawken
ZCTA5 07087,34,67903,53177,1334,382200,54632,17858,45343,11529,14866,8236,7267,3445,27284,25292,1992,25292,4807,20485,2021-01-01,zipcode,Union city
ZCTA5 07088,34,2922,76875,1540,285500,2384,1009,2022,261,535,659,405,162,1128,1108,20,1108,612,496,2021-01-01,zipcode,Vauxhall
ZCTA5 07090,34,30967,185093,2008,809600,22879,7565,19813,327,1933,2431,8173,6949,11064,10531,533,10531,8437,2094,2021-01-01,zipcode,Westfield
ZCTA5 07092,34,7047,134808,2926,651100,5613,2448,5110,228,915,914,1610,1443,2591,2546,45,2546,2142,404,2021-01-01,zipcode,Mountainside
ZCTA5 07093,34,64318,65843,1432,343800,52223,15291,46372,9654,12720,7456,10033,6509,26880,24973,1907,24973,6561,18412,2021-01-01,zipcode,West new york
ZCTA5 07094,34,21439,125246,2036,490700,17732,5739,16040,1021,2890,2622,5579,3928,8540,8000,540,8000,4473,3527,2021-01-01,zipcode,Secaucus
ZCTA5 07095,34,21314,96919,1891,305400,17047,5278,14943,1049,4005,4227,3374,2288,8209,7748,461,7748,4111,3637,2021-01-01,zipcode,Woodbridge
ZCTA5 07102,34,13585,32375,1026,329100,11226,5063,8906,2027,2654,1956,1240,1029,6176,5835,341,5835,487,5348,2021-01-01,zipcode,Newark
ZCTA5 07103,34,36025,35043,1107,217700,27540,12346,21150,4880,6501,5554,2765,1450,14001,12484,1517,12484,2804,9680,2021-01-01,zipcode,Newark
ZCTA5 07104,34,54736,45070,1174,306300,42029,15307,34933,9528,10964,8111,4423,1907,20868,19433,1435,19433,4996,14437,2021-01-01,zipcode,Newark
ZCTA5 07105,34,55781,48863,1367,374100,44434,14967,38921,11678,17581,4562,3767,1333,19809,18883,926,18883,3631,15252,2021-01-01,zipcode,Newark
ZCTA5 07106,34,35724,43288,1088,246100,28403,9532,24427,3013,9662,7255,3127,1370,14294,12625,1669,12625,4127,8498,2021-01-01,zipcode,Newark
ZCTA5 07107,34,41999,39375,1130,275800,31636,11418,26565,7140,10196,6241,2098,890,15891,14693,1198,14693,3893,10800,2021-01-01,zipcode,Newark
ZCTA5 07108,34,28267,29657,983,198200,20416,8437,17075,2857,6177,5403,2012,626,12695,11094,1601,11094,1815,9279,2021-01-01,zipcode,Newark
ZCTA5 07109,34,37963,75974,1424,319600,31939,10306,27177,3725,8881,6555,5522,2494,14558,13536,1022,13536,7576,5960,2021-01-01,zipcode,Belleville
ZCTA5 07110,34,29811,105183,1487,405100,24494,7397,21936,1006,5636,4585,6249,4460,12195,11711,484,11711,7927,3784,2021-01-01,zipcode,Nutley
ZCTA5 07111,34,60224,50020,1155,229500,46577,14620,39636,5868,14130,10876,5829,2933,25130,22208,2922,22208,6226,15982,2021-01-01,zipcode,Irvington
ZCTA5 07112,34,26684,45540,1212,258000,21091,6646,17461,1969,6452,5847,2566,627,12092,10549,1543,10549,2950,7599,2021-01-01,zipcode,Newark
ZCTA5 07114,34,13617,25042,557,336100,11791,7543,10544,2954,4561,2273,676,80,5080,4268,812,4268,767,3501,2021-01-01,zipcode,Newark
ZCTA5 07201,34,28207,52768,1301,303800,21460,6696,18509,4374,7021,4274,2138,702,10472,9394,1078,9394,2193,7201,2021-01-01,zipcode,Elizabeth
ZCTA5 07202,34,43795,57911,1288,310400,34286,12004,29001,6861,11757,6946,2233,1204,15073,14261,812,14261,3420,10841,2021-01-01,zipcode,Elizabeth
ZCTA5 07203,34,22511,68369,1248,249700,18354,5414,15072,1826,5338,4536,2162,1210,8373,7915,458,7915,4509,3406,2021-01-01,zipcode,Roselle
ZCTA5 07204,34,13973,85427,1344,319400,11264,2984,10036,1062,2666,2401,2587,1320,5286,5204,82,5204,3062,2142,2021-01-01,zipcode,Roselle park
ZCTA5 07205,34,22319,82850,1424,300200,17866,4722,15205,2165,4738,4135,2890,1277,7682,7191,491,7191,5026,2165,2021-01-01,zipcode,Hillside
ZCTA5 07206,34,29387,51870,1336,269000,22042,8022,17572,6046,6805,3450,792,479,9258,8504,754,8504,2321,6183,2021-01-01,zipcode,Elizabethport
ZCTA5 07208,34,34383,54683,1229,348900,26246,7315,22321,4515,7628,4984,3572,1622,13023,12195,828,12195,3271,8924,2021-01-01,zipcode,Elizabeth
ZCTA5 07302,34,51452,150254,2640,744600,44066,8403,42149,1685,3703,3703,16644,16414,27798,25272,2526,25272,6825,18447,2021-01-01,zipcode,Jersey city
ZCTA5 07304,34,50444,60787,1320,377600,39163,12991,34200,4179,10211,6846,8400,4564,20579,18673,1906,18673,5436,13237,2021-01-01,zipcode,Jersey city
ZCTA5 07305,34,71911,67048,1340,348800,55819,20199,47549,6308,14482,10880,10170,5709,27740,25335,2405,25335,10634,14701,2021-01-01,zipcode,Jersey city
ZCTA5 07306,34,55053,66812,1373,393700,44608,16633,38238,5044,7740,6728,11601,7125,23940,21825,2115,21825,5107,16718,2021-01-01,zipcode,Jersey city
ZCTA5 07307,34,43151,69124,1466,484900,35253,10959,31242,4303,8063,5245,8412,5219,18643,17009,1634,17009,5479,11530,2021-01-01,zipcode,Jersey city
ZCTA5 07310,34,13641,163405,3042,730300,12349,2525,11119,121,722,656,3476,6144,7308,6624,684,6624,712,5912,2021-01-01,zipcode,Jersey city
ZCTA5 07311,34,1494,163967,3432,-666666666,1318,103,1304,25,0,27,487,765,995,916,79,916,0,916,2021-01-01,zipcode,Jersey city
ZCTA5 07401,34,6820,165599,2470,726900,5041,2047,4398,125,272,728,1893,1380,2361,2213,148,2213,1695,518,2021-01-01,zipcode,Allendale
ZCTA5 07403,34,7759,116305,1803,326900,6658,2112,5368,405,1500,1330,1291,842,2974,2896,78,2896,1927,969,2021-01-01,zipcode,Bloomingdale
ZCTA5 07405,34,17992,117740,1413,461600,14982,4313,12741,433,2704,2754,4530,2320,6867,6729,138,6729,5229,1500,2021-01-01,zipcode,Butler
ZCTA5 07407,34,21239,75091,1769,376700,16910,5440,14425,1359,5140,3544,2951,1431,7471,7121,350,7121,3881,3240,2021-01-01,zipcode,Elmwood park
ZCTA5 07410,34,34820,133209,1864,447500,26986,8383,23847,830,4000,4627,7983,6407,12253,11892,361,11892,9409,2483,2021-01-01,zipcode,Fair lawn
ZCTA5 07416,34,5544,80264,1099,205600,4678,1772,4222,331,1704,1320,627,240,2945,2530,415,2530,1687,843,2021-01-01,zipcode,Franklin
ZCTA5 07417,34,11037,188217,2861,1016000,8742,3384,7615,42,779,1057,3104,2633,4035,3847,188,3847,3408,439,2021-01-01,zipcode,Franklin lakes
ZCTA5 07418,34,2843,177971,-666666666,281300,2317,489,1908,40,561,510,373,424,1002,995,7,995,973,22,2021-01-01,zipcode,Glenwood
ZCTA5 07419,34,9720,102862,1557,253500,7887,2310,7065,355,2134,2158,1580,838,4298,3949,349,3949,3046,903,2021-01-01,zipcode,Hamburg
ZCTA5 07420,34,5395,100130,1748,284200,4614,1382,4051,305,1602,844,949,351,1945,1877,68,1877,1372,505,2021-01-01,zipcode,Haskell
ZCTA5 07421,34,7371,115139,2135,305600,6048,1352,5368,167,1905,1224,1538,534,3266,2819,447,2819,2553,266,2021-01-01,zipcode,Hewitt
ZCTA5 07422,34,5666,108358,1621,234200,4792,1415,4215,145,1272,1376,992,430,2628,2178,450,2178,2021,157,2021-01-01,zipcode,Highland lakes
ZCTA5 07423,34,4248,244493,2773,815200,3072,930,2699,39,135,247,1132,1146,1623,1444,179,1444,1365,79,2021-01-01,zipcode,Ho ho kus
ZCTA5 07424,34,26893,97631,1484,385400,23317,7133,19109,1168,5288,4202,5813,2638,10896,10669,227,10669,7277,3392,2021-01-01,zipcode,Little falls
ZCTA5 07430,34,25530,111075,2053,509300,21333,7752,16564,813,2664,3332,6048,3707,9613,9430,183,9430,7448,1982,2021-01-01,zipcode,Mahwah
ZCTA5 07432,34,7033,128920,1695,493300,5727,1727,5042,183,1150,1066,1754,889,2876,2796,80,2796,1810,986,2021-01-01,zipcode,Midland park
ZCTA5 07435,34,2510,126826,2121,407700,2177,697,1875,13,457,624,557,224,1419,1035,384,1035,844,191,2021-01-01,zipcode,Newfoundland
ZCTA5 07436,34,12770,152364,1745,475400,10289,3028,8951,247,1963,2035,2922,1784,4568,4223,345,4223,3750,473,2021-01-01,zipcode,Oakland
ZCTA5 07438,34,11219,112570,1257,361200,9097,2939,7920,485,2174,2034,2283,944,4834,4482,352,4482,4009,473,2021-01-01,zipcode,Oak ridge
ZCTA5 07439,34,2192,92500,1571,235600,1875,444,1650,91,590,543,321,105,970,828,142,828,727,101,2021-01-01,zipcode,Ogdensburg
ZCTA5 07440,34,4793,155497,-666666666,450600,3734,1030,3236,142,848,716,946,584,1608,1531,77,1531,1347,184,2021-01-01,zipcode,Pequannock
ZCTA5 07442,34,11113,100906,1479,338500,9038,2490,7849,450,2413,1728,2407,851,4322,4224,98,4224,3199,1025,2021-01-01,zipcode,Pompton lakes
ZCTA5 07444,34,10784,104503,2987,439300,9498,4329,8234,254,1903,2121,2078,1878,4994,4736,258,4736,3917,819,2021-01-01,zipcode,Pompton plains
ZCTA5 07446,34,14801,156473,1751,606600,11501,3808,9922,296,1089,1557,4445,2535,5506,5300,206,5300,4564,736,2021-01-01,zipcode,Ramsey
ZCTA5 07450,34,25999,194198,2200,789500,19481,6770,16695,382,1695,1550,6936,6132,8979,8659,320,8659,7108,1551,2021-01-01,zipcode,Ridgewood
ZCTA5 07452,34,12098,182292,1818,695300,8507,2558,7115,166,554,1014,2730,2651,3778,3630,148,3630,3358,272,2021-01-01,zipcode,Glen rock
ZCTA5 07456,34,11778,130833,2077,370900,9713,2915,8533,322,2102,1963,2825,1321,4307,4200,107,4200,4000,200,2021-01-01,zipcode,Ringwood
ZCTA5 07457,34,4049,101219,2572,343000,3379,1114,2961,143,734,663,802,619,1910,1839,71,1839,1282,557,2021-01-01,zipcode,Riverdale
ZCTA5 07458,34,11714,221325,3501,1081100,9340,3346,8044,144,857,1354,3060,2629,4206,4000,206,4000,3537,463,2021-01-01,zipcode,Saddle river
ZCTA5 07460,34,3046,96961,2203,300500,2436,641,2125,144,617,522,480,362,1260,1192,68,1192,1079,113,2021-01-01,zipcode,Stockholm
ZCTA5 07461,34,17994,92565,1389,286500,15058,5102,12733,865,4351,3656,2699,1162,7727,6728,999,6728,5645,1083,2021-01-01,zipcode,Sussex
ZCTA5 07462,34,6674,86736,1473,211100,5734,1596,4965,179,2086,1376,907,417,3453,2871,582,2871,2245,626,2021-01-01,zipcode,Vernon
ZCTA5 07463,34,10086,132315,1810,483200,7531,2188,6857,376,1369,1431,2581,1100,3354,3354,0,3354,3030,324,2021-01-01,zipcode,Waldwick
ZCTA5 07465,34,5890,111653,2106,343800,5066,1671,4373,259,1019,1123,1474,498,2471,2374,97,2374,1941,433,2021-01-01,zipcode,Wanaque
ZCTA5 07470,34,55280,137168,1902,498500,45046,15833,37708,1623,7770,6713,12866,8736,19747,19147,600,19147,15022,4125,2021-01-01,zipcode,Wayne
ZCTA5 07480,34,14991,95521,1495,299300,12512,4308,10929,425,2869,3450,2502,1683,6364,5975,389,5975,5312,663,2021-01-01,zipcode,West milford
ZCTA5 07481,34,16746,167368,2127,803500,13051,4950,11698,432,1746,1903,4438,3179,6039,5749,290,5749,5173,576,2021-01-01,zipcode,Wyckoff
ZCTA5 07501,34,36019,37256,1210,258800,26628,10736,21933,6688,9015,4337,1559,334,13065,12269,796,12269,1901,10368,2021-01-01,zipcode,Paterson
ZCTA5 07502,34,18113,64653,1353,279500,13407,4350,10996,2169,4363,2652,1480,332,4929,4794,135,4794,2523,2271,2021-01-01,zipcode,Paterson
ZCTA5 07503,34,19365,56645,1350,271600,15253,5673,12484,2548,5640,2603,1361,332,6435,6086,349,6086,1884,4202,2021-01-01,zipcode,Paterson
ZCTA5 07504,34,12198,61786,1373,320700,9756,3717,8157,1179,3149,2042,1406,381,4208,3984,224,3984,1357,2627,2021-01-01,zipcode,Paterson
ZCTA5 07505,34,4122,17574,951,263800,3367,1964,2893,1046,1139,410,234,64,1395,1332,63,1332,81,1251,2021-01-01,zipcode,Paterson
ZCTA5 07506,34,19507,107416,1580,419800,15868,4356,14523,877,3722,3412,4467,2045,7782,7463,319,7463,4923,2540,2021-01-01,zipcode,Hawthorne
ZCTA5 07508,34,23730,89160,1531,365400,19240,6658,16879,2063,6397,3607,3396,1416,8399,8045,354,8045,5058,2987,2021-01-01,zipcode,Haledon
ZCTA5 07512,34,11013,103419,1471,389300,8636,2764,7811,549,2750,2291,1687,534,3856,3803,53,3803,2922,881,2021-01-01,zipcode,Totowa
ZCTA5 07513,34,11600,55625,1450,286900,8745,2699,7602,1544,3283,1845,662,268,3308,3182,126,3182,982,2200,2021-01-01,zipcode,Paterson
ZCTA5 07514,34,19254,53254,1273,235000,14685,5023,12505,2493,5609,2957,1159,287,7292,6582,710,6582,2004,4578,2021-01-01,zipcode,Paterson
ZCTA5 07522,34,22645,41612,1254,194800,16600,6096,13640,3035,6480,2664,1206,255,7503,7013,490,7013,1324,5689,2021-01-01,zipcode,Paterson
ZCTA5 07524,34,14611,42724,1277,304600,10448,3741,8568,2060,4110,1363,823,212,4724,4459,265,4459,987,3472,2021-01-01,zipcode,Paterson
ZCTA5 07601,34,45723,73716,1576,302200,38861,11917,34780,4897,8296,7669,9134,4784,21125,19995,1130,19995,7296,12699,2021-01-01,zipcode,Hackensack
ZCTA5 07603,34,8830,104949,1506,349600,7331,2175,6280,502,1471,1941,1220,1146,3297,3102,195,3102,2150,952,2021-01-01,zipcode,Bogota
ZCTA5 07604,34,12120,102639,1589,448300,9988,2865,8551,502,2152,2158,2207,1532,4489,4226,263,4226,2884,1342,2021-01-01,zipcode,Hasbrouck heights
ZCTA5 07605,34,9283,102381,1639,546000,7595,2472,6712,547,859,1341,2553,1412,3551,3470,81,3470,2273,1197,2021-01-01,zipcode,Leonia
ZCTA5 07606,34,2865,89911,1654,398700,2344,671,1969,277,717,414,412,149,929,869,60,869,404,465,2021-01-01,zipcode,South hackensack
ZCTA5 07607,34,10049,99832,1763,417200,8461,3053,7408,524,1854,1853,1917,1260,3879,3755,124,3755,2610,1145,2021-01-01,zipcode,Maywood
ZCTA5 07608,34,92,-666666666,1639,-666666666,69,30,58,19,10,15,11,3,26,26,0,26,0,26,2021-01-01,zipcode,Teterboro
ZCTA5 07620,34,1336,196875,2188,2000001,1072,493,982,40,104,103,426,309,570,485,85,485,457,28,2021-01-01,zipcode,Alpine
ZCTA5 07621,34,28282,111851,1465,386900,22725,6887,19399,1609,4933,3979,6507,2371,9440,9146,294,9146,6325,2821,2021-01-01,zipcode,Bergenfield
ZCTA5 07624,34,8573,166125,2308,697800,6630,2113,5767,303,955,711,2097,1701,2903,2791,112,2791,2294,497,2021-01-01,zipcode,Closter
ZCTA5 07626,34,9096,155515,2194,676400,7010,2441,6129,264,918,1214,2041,1692,3124,3036,88,3036,2526,510,2021-01-01,zipcode,Cresskill
ZCTA5 07627,34,4977,191346,3501,786500,3697,1373,3244,51,228,422,1321,1222,1732,1656,76,1656,1401,255,2021-01-01,zipcode,Demarest
ZCTA5 07628,34,17965,108333,1478,393600,15078,4945,12796,781,3420,2855,3389,2351,6872,6626,246,6626,4833,1793,2021-01-01,zipcode,Dumont
ZCTA5 07630,34,7317,135396,1966,556100,5974,1952,5389,287,985,1429,1782,906,2564,2537,27,2537,2211,326,2021-01-01,zipcode,Emerson
ZCTA5 07631,34,29129,91164,1573,410200,23725,7416,20857,2100,4527,4831,4563,4836,12107,11320,787,11320,6070,5250,2021-01-01,zipcode,Englewood
ZCTA5 07632,34,5358,191875,3501,1159200,4412,1718,3975,98,359,479,1458,1581,2089,1905,184,1905,1573,332,2021-01-01,zipcode,Englewood cliffs
ZCTA5 07640,34,4801,140958,3188,612000,3751,1421,3349,11,384,628,1498,828,1802,1737,65,1737,1697,40,2021-01-01,zipcode,Harrington park
ZCTA5 07641,34,3341,196932,3501,696600,2478,889,2164,51,244,355,783,731,1170,1059,111,1059,1006,53,2021-01-01,zipcode,Haworth
ZCTA5 07642,34,10166,165964,1385,582200,8310,2301,6947,286,1145,1323,2399,1794,3506,3457,49,3457,3114,343,2021-01-01,zipcode,Hillsdale
ZCTA5 07643,34,10973,77368,1459,361800,9450,2829,8268,1003,2239,2285,1917,824,4584,4353,231,4353,1920,2433,2021-01-01,zipcode,Little ferry
ZCTA5 07644,34,25983,70821,1442,393500,21439,7489,18162,2875,5092,5028,3358,1809,9684,9235,449,9235,3848,5387,2021-01-01,zipcode,Lodi
ZCTA5 07645,34,8413,163170,1894,657800,6857,2336,5824,229,956,1228,2008,1403,2987,2920,67,2920,2570,350,2021-01-01,zipcode,Montvale
ZCTA5 07646,34,16912,98992,1471,442000,13328,3803,11841,785,2417,2866,3804,1969,6435,6167,268,6167,3992,2175,2021-01-01,zipcode,New milford
ZCTA5 07647,34,5394,112610,1635,482500,4460,1920,3773,193,938,627,1346,669,1732,1693,39,1693,1419,274,2021-01-01,zipcode,Northvale
ZCTA5 07648,34,5666,144390,1935,615300,4586,1851,3919,148,880,737,1419,735,1967,1921,46,1921,1608,313,2021-01-01,zipcode,Norwood
ZCTA5 07649,34,8236,174643,1792,661900,6452,2250,5431,119,883,833,2134,1462,2710,2702,8,2702,2428,274,2021-01-01,zipcode,Oradell
ZCTA5 07650,34,20291,76297,1697,604500,17840,6119,15455,1608,3458,2596,6175,1618,7365,7142,223,7142,2666,4476,2021-01-01,zipcode,Palisades park
ZCTA5 07652,34,26650,130446,2470,623900,22512,9244,19688,1100,4600,4281,6289,3418,8886,8354,532,8354,6803,1551,2021-01-01,zipcode,Paramus
ZCTA5 07656,34,8987,168269,1716,609500,7639,2622,6424,197,1189,1261,2348,1429,3523,3246,277,3246,2766,480,2021-01-01,zipcode,Park ridge
ZCTA5 07657,34,11477,93045,1718,457300,9723,3120,8421,739,2023,1781,2884,994,4134,4032,102,4032,1909,2123,2021-01-01,zipcode,Ridgefield
ZCTA5 07660,34,13202,86502,1444,388600,10676,2880,9459,859,2708,2685,2080,1127,5330,4971,359,4971,2594,2377,2021-01-01,zipcode,Ridgefield park
ZCTA5 07661,34,12024,142214,1715,549500,9626,2883,8165,148,574,1703,3384,2356,4503,4352,151,4352,3342,1010,2021-01-01,zipcode,River edge
ZCTA5 07662,34,5805,101689,1746,409100,5163,1691,4296,294,1333,888,1232,549,2302,2248,54,2248,1790,458,2021-01-01,zipcode,Rochelle park
ZCTA5 07663,34,14313,113738,1767,390900,11844,3419,10383,783,2803,2974,2559,1264,5438,5245,193,5245,3473,1772,2021-01-01,zipcode,Saddle brook
ZCTA5 07666,34,41335,125368,1559,429300,32704,10841,26685,1601,4927,5323,7553,7281,13593,13122,471,13122,10255,2867,2021-01-01,zipcode,Teaneck
ZCTA5 07670,34,15307,179833,2985,858900,10825,3396,9602,182,567,949,3632,4272,5150,4981,169,4981,3658,1323,2021-01-01,zipcode,Tenafly
ZCTA5 07675,34,27025,155135,1856,602800,21247,6891,18820,921,2810,3378,6668,5043,10190,9689,501,9689,7402,2287,2021-01-01,zipcode,Westwood
ZCTA5 07676,34,9293,142682,2036,564900,7598,2899,6774,273,1092,1391,2943,1075,3474,3410,64,3410,3291,119,2021-01-01,zipcode,Township of washington
ZCTA5 07677,34,6112,210078,-666666666,845900,4834,1839,4082,40,648,419,1824,1151,2110,2021,89,2021,1826,195,2021-01-01,zipcode,Woodcliff lake
ZCTA5 07701,34,25010,102191,1739,441300,20703,6866,18798,983,3973,4078,5778,3986,11337,11023,314,11023,7265,3758,2021-01-01,zipcode,Red bank
ZCTA5 07702,34,4129,149792,3403,642300,3100,1283,2686,39,460,453,1007,727,1370,1361,9,1361,1182,179,2021-01-01,zipcode,Shrewsbury
ZCTA5 07703,34,0,-666666666,-666666666,-666666666,0,0,0,0,0,0,0,0,73,0,73,0,0,0,2021-01-01,zipcode,Fort monmouth
ZCTA5 07704,34,6235,192500,2143,796500,4318,1391,3818,100,201,468,1955,1094,2048,2038,10,2038,1922,116,2021-01-01,zipcode,Fair haven
ZCTA5 07711,34,1749,94716,1484,756800,1383,488,1194,22,159,211,461,341,880,595,285,595,486,109,2021-01-01,zipcode,Allenhurst
ZCTA5 07712,34,39491,84328,1338,451300,32646,9927,29308,2390,6549,7177,8212,4980,18696,17010,1686,17010,8365,8645,2021-01-01,zipcode,Asbury park
ZCTA5 07716,34,8173,102227,1460,478900,7103,2517,6456,438,1548,1769,1930,771,3900,3638,262,3638,2485,1153,2021-01-01,zipcode,Atlantic highlands
ZCTA5 07717,34,1760,95781,1439,913700,1541,673,1375,36,174,218,545,402,1241,868,373,868,578,290,2021-01-01,zipcode,Avon by the sea
ZCTA5 07718,34,6901,152898,1633,406700,5422,1413,4850,245,1127,1358,1513,607,2458,2393,65,2393,2214,179,2021-01-01,zipcode,Belford
ZCTA5 07719,34,21857,105707,1512,516000,18632,6279,16473,794,3511,3961,5605,2602,10781,9064,1717,9064,6590,2474,2021-01-01,zipcode,Belmar
ZCTA5 07720,34,4170,90357,1540,732400,3642,1288,3435,443,432,471,1056,1033,2834,1956,878,1956,954,1002,2021-01-01,zipcode,Bradley beach
ZCTA5 07721,34,3770,107009,1726,286900,3023,618,2481,167,639,577,676,422,1486,1439,47,1439,800,639,2021-01-01,zipcode,Cliffwood
ZCTA5 07722,34,10123,180208,2148,765700,7994,2706,6738,121,674,1464,2149,2330,3705,3510,195,3510,3207,303,2021-01-01,zipcode,Colts neck
ZCTA5 07723,34,603,62292,1197,1066700,520,263,382,46,106,114,80,36,1189,259,930,259,140,119,2021-01-01,zipcode,Deal
ZCTA5 07724,34,23332,90827,1421,394100,19168,5992,16803,963,4135,4160,4443,3102,10078,9575,503,9575,6625,2950,2021-01-01,zipcode,Eatontown
ZCTA5 07726,34,44954,135953,1620,485400,36273,12017,31899,1257,6290,7227,10527,6598,16887,16214,673,16214,13976,2238,2021-01-01,zipcode,Englishtown
ZCTA5 07727,34,6394,112042,1266,494300,5212,1939,4673,169,1439,970,1246,849,2664,2366,298,2366,1984,382,2021-01-01,zipcode,Farmingdale
ZCTA5 07728,34,57245,101043,1706,408600,45714,15344,39146,3686,8765,9271,10373,7051,21666,20651,1015,20651,15530,5121,2021-01-01,zipcode,Freehold
ZCTA5 07730,34,16845,108990,875,374000,14263,4743,12428,677,4568,3148,2742,1293,6365,6300,65,6300,5756,544,2021-01-01,zipcode,Hazlet
ZCTA5 07731,34,39457,122239,1760,362400,31187,8657,26271,1398,7349,6732,7154,3638,13404,12958,446,12958,11673,1285,2021-01-01,zipcode,Howell
ZCTA5 07732,34,4744,85268,1503,341100,4088,1253,3864,353,617,1038,859,997,3026,2559,467,2559,1759,800,2021-01-01,zipcode,Highlands
ZCTA5 07733,34,17135,156996,2761,722200,13830,5484,11957,503,1509,2188,4321,3436,6263,6084,179,6084,5491,593,2021-01-01,zipcode,Holmdel
ZCTA5 07734,34,13323,79425,1518,238000,10678,3892,9204,1076,3773,2649,1318,388,5664,4952,712,4952,2984,1968,2021-01-01,zipcode,Keansburg
ZCTA5 07735,34,19661,86411,1228,291200,16812,5078,14835,1321,4482,4685,2913,1434,8654,7954,700,7954,6094,1860,2021-01-01,zipcode,Keyport
ZCTA5 07737,34,4353,122589,1336,349000,3415,866,2834,48,737,689,1040,320,1627,1508,119,1508,1368,140,2021-01-01,zipcode,Leonardo
ZCTA5 07738,34,6812,172710,809,591100,5510,2122,4731,95,781,1022,1626,1207,2410,2321,89,2321,2114,207,2021-01-01,zipcode,Lincroft
ZCTA5 07739,34,6103,212069,3501,709100,4716,1642,4321,41,447,735,1753,1345,2308,2224,84,2224,2101,123,2021-01-01,zipcode,Little silver
ZCTA5 07740,34,31863,65647,1485,394600,25701,9015,21178,3742,5857,4647,4080,2852,15057,12817,2240,12817,5366,7451,2021-01-01,zipcode,Long branch
ZCTA5 07746,34,18437,172765,2741,562200,14524,5167,12240,342,1961,1855,4286,3796,6023,5944,79,5944,5709,235,2021-01-01,zipcode,Marlboro
ZCTA5 07747,34,32462,115272,1773,382800,26951,7974,24210,843,5765,5905,7573,4124,13311,12839,472,12839,9998,2841,2021-01-01,zipcode,Matawan
ZCTA5 07748,34,28295,128740,1319,462400,23120,7307,19478,760,4864,4400,6244,3210,10437,10067,370,10067,8515,1552,2021-01-01,zipcode,Middletown
ZCTA5 07750,34,3197,131250,2055,847300,2816,1224,2521,30,332,504,887,768,1889,1479,410,1479,1146,333,2021-01-01,zipcode,Monmouth beach
ZCTA5 07751,34,20782,154453,2310,569600,16372,5508,13649,370,2091,2607,4429,4152,7286,7018,268,7018,6437,581,2021-01-01,zipcode,Morganville
ZCTA5 07753,34,37370,81268,1587,320200,31630,11058,27040,1717,6814,8954,6595,2960,16609,15843,766,15843,10676,5167,2021-01-01,zipcode,Neptune
ZCTA5 07755,34,6651,115436,2142,478700,4935,1878,3927,179,824,1234,1001,689,2320,2037,283,2037,1707,330,2021-01-01,zipcode,Oakhurst
ZCTA5 07756,34,3076,65078,1270,771800,3040,1108,2927,201,254,514,1041,917,2831,1773,1058,1773,911,862,2021-01-01,zipcode,Ocean grove
ZCTA5 07757,34,6115,111400,2639,568500,5116,1894,4463,186,556,1196,1550,975,2541,2384,157,2384,2158,226,2021-01-01,zipcode,Oceanport
ZCTA5 07758,34,4345,93125,1189,357200,3648,1220,2909,191,938,949,612,219,1636,1589,47,1589,1250,339,2021-01-01,zipcode,Port monmouth
ZCTA5 07760,34,9451,184336,1950,1067800,7367,2941,6060,37,431,1147,2655,1790,3869,3365,504,3365,2872,493,2021-01-01,zipcode,Rumson
ZCTA5 07762,34,8442,95609,1595,682200,7194,3073,6544,91,1050,1359,2283,1761,5158,4133,1025,4133,2730,1403,2021-01-01,zipcode,Spring lake
ZCTA5 07764,34,8470,107059,1594,483300,7067,2726,5050,442,1090,1252,1512,754,3172,2858,314,2858,2112,746,2021-01-01,zipcode,West long branch
ZCTA5 07801,34,26036,73919,1599,299200,20426,5699,17678,3877,5928,4402,2309,1162,8743,8299,444,8299,3916,4383,2021-01-01,zipcode,Dover
ZCTA5 07803,34,3976,100327,1821,317400,3214,962,2747,190,731,694,905,227,1451,1387,64,1387,1217,170,2021-01-01,zipcode,Mine hill
ZCTA5 07820,34,8,-666666666,-666666666,-666666666,8,0,8,6,2,0,0,0,0,0,0,0,0,0,2021-01-01,zipcode,Allamuchy
ZCTA5 07821,34,9277,122206,1497,339700,7796,2631,6438,174,1391,1622,1924,1327,3840,3438,402,3438,3047,391,2021-01-01,zipcode,Andover
ZCTA5 07822,34,1084,95139,-666666666,400000,809,310,656,7,199,159,190,101,385,352,33,352,352,0,2021-01-01,zipcode,Augusta
ZCTA5 07823,34,7814,68500,861,252600,6965,3120,6205,485,2318,1814,1005,583,3782,3640,142,3640,2388,1252,2021-01-01,zipcode,Belvidere
ZCTA5 07825,34,9738,112592,1283,348100,8239,3199,7136,433,2060,1843,2010,790,3771,3459,312,3459,3105,354,2021-01-01,zipcode,Blairstown
ZCTA5 07826,34,5548,102196,1682,296600,4710,1503,4192,205,1350,1088,1070,479,2750,2181,569,2181,1866,315,2021-01-01,zipcode,Branchville
ZCTA5 07827,34,4068,90116,1163,249200,3309,1264,3018,52,1038,984,628,316,2035,1613,422,1613,1483,130,2021-01-01,zipcode,Montague
ZCTA5 07828,34,14602,84344,1302,365700,11659,2770,10419,634,2918,2640,2467,1760,5937,5699,238,5699,3172,2527,2021-01-01,zipcode,Budd lake
ZCTA5 07830,34,7389,156832,1210,556000,6039,2005,5514,89,790,1154,1555,1926,2815,2777,38,2777,2676,101,2021-01-01,zipcode,Califon
ZCTA5 07832,34,3123,104205,1155,297000,2525,980,2359,236,589,660,621,253,1396,1209,187,1209,1087,122,2021-01-01,zipcode,Columbia
ZCTA5 07833,34,91,-666666666,-666666666,215800,91,24,91,0,26,49,6,10,48,48,0,48,48,0,2021-01-01,zipcode,Delaware
ZCTA5 07834,34,18207,148716,1814,457100,14788,4529,13122,422,2229,2658,4527,3286,7446,6880,566,6880,5785,1095,2021-01-01,zipcode,Denville
ZCTA5 07836,34,12262,132262,1767,423700,9992,2767,8370,663,1624,2454,2105,1524,4645,4458,187,4458,2995,1463,2021-01-01,zipcode,Flanders
ZCTA5 07838,34,3083,111875,1722,335600,2648,861,2266,82,651,576,682,275,1345,1274,71,1274,1116,158,2021-01-01,zipcode,Great meadows
ZCTA5 07840,34,31581,97544,1318,315100,25912,8455,21918,1174,5078,5444,6795,3427,12500,12148,352,12148,8483,3665,2021-01-01,zipcode,Hackettstown
ZCTA5 07842,34,38,-666666666,-666666666,-666666666,28,0,18,0,0,0,18,0,10,10,0,10,10,0,2021-01-01,zipcode,Hibernia
ZCTA5 07843,34,11267,97670,1398,251900,9398,2445,8514,350,3146,2659,1550,809,5052,4391,661,4391,3750,641,2021-01-01,zipcode,Hopatcong
ZCTA5 07846,34,18,-666666666,-666666666,-666666666,18,3,13,0,4,6,3,0,15,6,9,6,6,0,2021-01-01,zipcode,Johnsonburg
ZCTA5 07847,34,1940,69583,1736,304600,1528,557,1460,109,491,518,250,92,791,791,0,791,622,169,2021-01-01,zipcode,Kenvil
ZCTA5 07848,34,4822,94974,1309,363500,4200,1873,3879,365,1149,876,1040,449,1779,1662,117,1662,1451,211,2021-01-01,zipcode,Lafayette
ZCTA5 07849,34,8916,113542,1505,365300,7461,2407,6488,374,1614,1849,1731,920,3802,3422,380,3422,3007,415,2021-01-01,zipcode,Lake hopatcong
ZCTA5 07850,34,7498,97241,1625,326800,6105,1839,4930,185,1381,1638,1097,629,2721,2494,227,2494,1945,549,2021-01-01,zipcode,Landing
ZCTA5 07851,34,342,93393,-666666666,275000,261,101,244,13,27,69,118,17,186,153,33,153,135,18,2021-01-01,zipcode,Layton
ZCTA5 07852,34,3817,88302,1594,396600,3351,1122,2683,84,493,666,1076,364,1510,1480,30,1480,1235,245,2021-01-01,zipcode,Ledgewood
ZCTA5 07853,34,12821,175833,1958,483200,10155,3299,8450,145,1243,1625,3039,2398,4436,4306,130,4306,4086,220,2021-01-01,zipcode,Long valley
ZCTA5 07856,34,4033,79107,2244,354200,3337,1166,2936,79,715,977,710,455,2239,1709,530,1709,1137,572,2021-01-01,zipcode,Mount arlington
ZCTA5 07857,34,3418,74549,1256,284500,2968,795,2679,228,764,715,768,204,1931,1793,138,1793,972,821,2021-01-01,zipcode,Netcong
ZCTA5 07860,34,26151,98237,1217,281000,22304,8024,19594,1004,5472,5449,4727,2942,11423,10152,1271,10152,8050,2102,2021-01-01,zipcode,Newton
ZCTA5 07863,34,3711,81375,1291,230100,3263,1295,2859,223,1299,575,534,228,1601,1510,91,1510,1314,196,2021-01-01,zipcode,Oxford
ZCTA5 07865,34,2942,126492,1937,343100,2125,548,1806,126,430,557,418,275,926,895,31,895,739,156,2021-01-01,zipcode,Port murray
ZCTA5 07866,34,22689,119255,1502,366600,18545,5809,15826,637,2868,4094,5200,3027,8369,8274,95,8274,6889,1385,2021-01-01,zipcode,Rockaway
ZCTA5 07869,34,26170,151346,1633,561700,20695,6704,17552,806,1577,3197,6615,5357,9361,9118,243,9118,6955,2163,2021-01-01,zipcode,Randolph
ZCTA5 07870,34,50,-666666666,-666666666,-666666666,50,14,41,13,0,0,14,14,21,21,0,21,21,0,2021-01-01,zipcode,Schooleys mountain
ZCTA5 07871,34,20908,145385,1646,387600,16383,4855,14175,269,2506,3046,5196,3158,8129,7538,591,7538,6756,782,2021-01-01,zipcode,Sparta
ZCTA5 07874,34,8504,106618,1742,266000,6932,1745,5986,297,1658,1659,1676,696,3212,3091,121,3091,2730,361,2021-01-01,zipcode,Stanhope
ZCTA5 07876,34,9279,150840,2112,418300,7772,2517,6866,198,1578,1896,1994,1200,3328,3179,149,3179,2966,213,2021-01-01,zipcode,Succasunna
ZCTA5 07878,34,531,92738,-666666666,339700,445,218,410,0,130,64,161,55,246,246,0,246,219,27,2021-01-01,zipcode,Mount tabor
ZCTA5 07880,34,347,123750,-666666666,325700,290,83,228,18,56,114,13,27,102,102,0,102,79,23,2021-01-01,zipcode,Vienna
ZCTA5 07881,34,9,-666666666,-666666666,-666666666,9,4,9,0,0,9,0,0,16,5,11,5,5,0,2021-01-01,zipcode,
ZCTA5 07882,34,14521,82616,1169,257400,11739,3924,10179,833,3667,2840,2055,784,6233,5836,397,5836,4009,1827,2021-01-01,zipcode,Washington
ZCTA5 07885,34,11329,95603,1769,310400,9415,2615,8195,618,2781,2002,1952,842,4813,4237,576,4237,2770,1467,2021-01-01,zipcode,Wharton
ZCTA5 07901,34,24218,148945,1979,839700,18498,5790,16022,715,1939,2097,5448,5823,9051,8555,496,8555,5810,2745,2021-01-01,zipcode,Summit
ZCTA5 07920,34,28451,160180,2141,666400,22787,8537,19288,665,1947,2571,6730,7375,10623,10227,396,10227,8482,1745,2021-01-01,zipcode,Basking ridge
ZCTA5 07921,34,7596,118382,2098,391900,6648,1937,6034,102,748,1282,2000,1902,4154,3921,233,3921,3123,798,2021-01-01,zipcode,Bedminster
ZCTA5 07922,34,12059,171875,2283,640000,9561,3600,8504,248,1025,1123,3132,2976,4302,4089,213,4089,3937,152,2021-01-01,zipcode,Berkeley heights
ZCTA5 07924,34,7754,200438,1698,664300,6043,1925,5321,310,719,542,2323,1427,2772,2668,104,2668,2342,326,2021-01-01,zipcode,Bernardsville
ZCTA5 07926,34,65,-666666666,-666666666,-666666666,34,0,34,0,0,15,19,0,19,19,0,19,11,8,2021-01-01,zipcode,Brookside
ZCTA5 07927,34,4286,134054,2790,491700,3501,925,3103,294,602,323,920,964,1917,1812,105,1812,1073,739,2021-01-01,zipcode,Cedar knolls
ZCTA5 07928,34,19553,207059,2054,876400,14423,4743,12417,150,1049,1249,5044,4925,6886,6614,272,6614,5498,1116,2021-01-01,zipcode,Chatham
ZCTA5 07930,34,8485,178731,1585,665100,6926,2646,5779,100,805,891,2040,1943,3071,2955,116,2955,2705,250,2021-01-01,zipcode,Chester
ZCTA5 07931,34,3432,143140,2406,946800,2809,1312,2465,26,502,329,734,874,1350,1185,165,1185,1027,158,2021-01-01,zipcode,Far hills
ZCTA5 07932,34,10915,132154,2632,622800,9208,3386,7853,108,1024,1424,2543,2754,4567,4351,216,4351,3065,1286,2021-01-01,zipcode,Florham park
ZCTA5 07933,34,2648,147813,3501,556200,2341,820,2080,107,265,412,742,554,952,952,0,952,871,81,2021-01-01,zipcode,Gillette
ZCTA5 07934,34,1357,162333,2068,703500,987,315,928,13,90,212,301,312,498,498,0,498,438,60,2021-01-01,zipcode,Gladstone
ZCTA5 07935,34,389,92212,-666666666,753300,347,153,272,0,93,12,87,80,145,135,10,135,119,16,2021-01-01,zipcode,Green village
ZCTA5 07936,34,11128,129329,2765,621600,9374,3240,7895,525,2202,1120,2374,1674,3869,3797,72,3797,3560,237,2021-01-01,zipcode,East hanover
ZCTA5 07939,34,212,-666666666,-666666666,-666666666,212,212,198,22,115,61,0,0,26,26,0,26,13,13,2021-01-01,zipcode,Lyons
ZCTA5 07940,34,18054,152469,2003,748000,14665,4791,10919,308,1586,1407,4043,3575,5961,5710,251,5710,3663,2047,2021-01-01,zipcode,Madison
ZCTA5 07945,34,9518,210846,1750,774800,7707,2855,6537,143,581,913,2430,2470,3444,3377,67,3377,3081,296,2021-01-01,zipcode,Mendham
ZCTA5 07946,34,3090,198000,-666666666,642000,2577,923,2368,75,408,430,828,627,1090,1038,52,1038,994,44,2021-01-01,zipcode,Millington
ZCTA5 07950,34,21068,134726,2302,497100,17530,6103,15684,736,2392,2538,4994,5024,8145,7938,207,7938,6087,1851,2021-01-01,zipcode,Morris plains
ZCTA5 07960,34,46463,147949,1994,615600,38762,12179,33767,2079,4866,4334,12057,10431,19212,18312,900,18312,11319,6993,2021-01-01,zipcode,Morristown
ZCTA5 07961,34,337,-666666666,-666666666,-666666666,337,124,31,0,0,5,13,13,0,0,0,0,0,0,2021-01-01,zipcode,Convent station
ZCTA5 07970,34,232,-666666666,-666666666,-666666666,172,51,147,0,0,0,135,12,75,75,0,75,75,0,2021-01-01,zipcode,Mount freedom
ZCTA5 07974,34,13038,157416,1875,633400,9887,3536,8661,221,1407,1051,2881,3101,4671,4588,83,4588,3797,791,2021-01-01,zipcode,New providence
ZCTA5 07976,34,288,63125,-666666666,2000001,267,185,267,0,40,101,98,28,129,129,0,129,62,67,2021-01-01,zipcode,New vernon
ZCTA5 07977,34,885,-666666666,1808,659100,678,335,414,10,134,45,150,75,212,212,0,212,108,104,2021-01-01,zipcode,Peapack
ZCTA5 07979,34,212,-666666666,-666666666,-666666666,181,45,109,0,38,0,35,36,57,57,0,57,57,0,2021-01-01,zipcode,Pottersville
ZCTA5 07980,34,2911,131125,1659,592400,2166,785,1948,23,314,446,515,650,944,913,31,913,647,266,2021-01-01,zipcode,Stirling
ZCTA5 07981,34,9116,129396,2311,540200,7612,2452,6690,185,1616,1423,2041,1425,3892,3809,83,3809,3359,450,2021-01-01,zipcode,Whippany
ZCTA5 08001,34,814,93421,1183,286300,755,332,532,7,162,231,99,33,306,284,22,284,229,55,2021-01-01,zipcode,Alloway
ZCTA5 08002,34,23613,93651,1592,251700,19201,6149,17240,1324,3967,4703,4019,3227,9841,9052,789,9052,6018,3034,2021-01-01,zipcode,Cherry hill
ZCTA5 08003,34,31082,138472,1743,350700,25195,8003,22341,930,3544,3488,7375,7004,11881,11143,738,11143,9768,1375,2021-01-01,zipcode,Cherry hill
ZCTA5 08004,34,10884,88476,1445,212200,9161,2976,8339,1019,2928,2334,1505,553,4049,3838,211,3838,3308,530,2021-01-01,zipcode,Atco
ZCTA5 08005,34,25319,83232,1608,276100,21857,9384,19179,1222,7601,4706,3618,2032,11450,10093,1357,10093,9019,1074,2021-01-01,zipcode,Barnegat
ZCTA5 08006,34,427,85833,-666666666,743400,387,225,366,7,50,56,177,76,1257,214,1043,214,199,15,2021-01-01,zipcode,Barnegat light
ZCTA5 08007,34,5521,85041,1102,184700,4649,1556,4213,255,1230,1254,1107,367,2503,2390,113,2390,1360,1030,2021-01-01,zipcode,Barrington
ZCTA5 08008,34,6882,97247,1487,865300,6383,3374,6075,138,1095,1089,2237,1516,17284,3355,13929,3355,3100,255,2021-01-01,zipcode,Beach haven
ZCTA5 08009,34,13995,89369,1278,241400,11452,3790,9843,568,2673,3458,2190,954,5641,5391,250,5391,4355,1036,2021-01-01,zipcode,Berlin
ZCTA5 08010,34,11042,75060,1338,190500,8992,3211,7897,717,2814,2441,1329,596,4713,4202,511,4202,2886,1316,2021-01-01,zipcode,Beverly
ZCTA5 08011,34,0,-666666666,-666666666,-666666666,0,0,0,0,0,0,0,0,0,0,0,0,0,0,2021-01-01,zipcode,Birmingham
ZCTA5 08012,34,38901,84053,1331,222700,31622,9948,27713,1465,8817,8197,6674,2560,15982,15076,906,15076,10170,4906,2021-01-01,zipcode,Blackwood
ZCTA5 08014,34,395,107097,-666666666,171000,329,110,278,0,144,103,31,0,193,124,69,124,124,0,2021-01-01,zipcode,Bridgeport
ZCTA5 08015,34,19060,71649,1174,171700,15734,5388,13359,1552,4959,4498,1502,848,8120,7243,877,7243,5967,1276,2021-01-01,zipcode,Browns mills
ZCTA5 08016,34,34433,86185,1150,254500,27602,8507,23625,2095,6732,7391,5044,2363,13473,12594,879,12594,9369,3225,2021-01-01,zipcode,Burlington
ZCTA5 08019,34,998,125972,2107,332300,765,212,718,58,299,174,159,28,402,375,27,375,328,47,2021-01-01,zipcode,Chatsworth
ZCTA5 08020,34,2607,108564,-666666666,304800,2101,967,2032,71,761,487,547,166,968,968,0,968,908,60,2021-01-01,zipcode,Clarksboro
ZCTA5 08021,34,48202,58116,1083,154000,38351,12014,34247,3085,12377,10221,5984,2580,22452,21033,1419,21033,10402,10631,2021-01-01,zipcode,Clementon
ZCTA5 08022,34,9511,104323,1660,333600,8259,3461,7206,399,2000,1782,1669,1356,3943,3815,128,3815,3613,202,2021-01-01,zipcode,Columbus
ZCTA5 08023,34,313,32171,1290,147700,274,110,236,13,96,127,0,0,158,119,39,119,48,71,2021-01-01,zipcode,Deepwater
ZCTA5 08026,34,2303,95000,-666666666,236500,1817,779,1555,105,627,397,304,122,810,758,52,758,684,74,2021-01-01,zipcode,Gibbsboro
ZCTA5 08027,34,4954,83219,1201,189800,4228,1703,3861,251,1581,964,771,294,2100,1978,122,1978,1708,270,2021-01-01,zipcode,Gibbstown
ZCTA5 08028,34,21809,72701,1386,222500,18778,7435,12642,995,3195,3523,3288,1641,7845,7080,765,7080,4537,2543,2021-01-01,zipcode,Glassboro
ZCTA5 08029,34,5561,78222,612,171800,4743,1560,4043,340,1916,1027,502,258,2326,2253,73,2253,1575,678,2021-01-01,zipcode,Glendora
ZCTA5 08030,34,13222,58452,1299,135500,10114,3660,8847,1127,3822,2402,913,583,5692,5129,563,5129,3402,1727,2021-01-01,zipcode,Gloucester city
ZCTA5 08031,34,11631,66667,1046,174600,9512,3410,8347,1167,3160,2144,1320,556,5043,4696,347,4696,2935,1761,2021-01-01,zipcode,Bellmawr
ZCTA5 08033,34,16565,132500,1209,471900,12469,3740,11130,169,1044,1738,4103,4076,6669,6308,361,6308,4662,1646,2021-01-01,zipcode,Haddonfield
ZCTA5 08034,34,19522,100173,1463,260400,15958,5336,14360,933,2645,3112,4579,3091,7910,7689,221,7689,6130,1559,2021-01-01,zipcode,Cherry hill
ZCTA5 08035,34,7615,102670,1146,296400,6128,1868,5499,196,1129,1325,1887,962,3391,3194,197,3194,2461,733,2021-01-01,zipcode,Haddon heights
ZCTA5 08036,34,6026,114519,1000,365300,5097,1695,4554,87,1325,1234,1357,551,2587,2474,113,2474,2286,188,2021-01-01,zipcode,Hainesport
ZCTA5 08037,34,23729,76977,1225,245000,19781,7090,17354,1903,6348,4705,2999,1399,9766,8907,859,8907,6668,2239,2021-01-01,zipcode,Hammonton
ZCTA5 08038,34,410,68750,1362,152900,303,54,252,23,109,102,18,0,172,163,9,163,82,81,2021-01-01,zipcode,Hancocks bridge
ZCTA5 08039,34,19,-666666666,-666666666,-666666666,19,7,19,7,0,6,0,6,6,6,0,6,6,0,2021-01-01,zipcode,Harrisonville
ZCTA5 08041,34,930,147781,-666666666,439800,808,206,712,57,181,221,138,115,435,402,33,402,393,9,2021-01-01,zipcode,Jobstown
ZCTA5 08042,34,125,98750,-666666666,310000,65,20,59,0,13,33,13,0,31,31,0,31,18,13,2021-01-01,zipcode,Juliustown
ZCTA5 08043,34,30864,102606,1511,341700,25167,9328,21907,1311,3545,4355,6727,5969,12295,11683,612,11683,7563,4120,2021-01-01,zipcode,Voorhees
ZCTA5 08045,34,2966,70156,1021,171600,2516,1046,2347,171,784,693,248,451,1261,1198,63,1198,841,357,2021-01-01,zipcode,Lawnside
ZCTA5 08046,34,31747,83331,1652,182700,26230,8548,22757,1536,7918,7741,3902,1660,11758,10701,1057,10701,8463,2238,2021-01-01,zipcode,Willingboro
ZCTA5 08048,34,12752,108924,1495,342100,10498,3127,9206,546,2002,2872,2213,1573,5148,4793,355,4793,3610,1183,2021-01-01,zipcode,Lumberton
ZCTA5 08049,34,5238,74306,1154,175500,4365,1124,3747,299,1472,999,696,281,2228,2058,170,2058,1488,570,2021-01-01,zipcode,Magnolia
ZCTA5 08050,34,26673,93933,1637,293000,22235,7928,19922,1124,6340,5188,4801,2469,13910,10646,3264,10646,9434,1212,2021-01-01,zipcode,Manahawkin
ZCTA5 08051,34,11722,91766,1421,204100,9835,2943,8526,415,3386,2019,1855,851,4487,4298,189,4298,3362,936,2021-01-01,zipcode,Mantua
ZCTA5 08052,34,19818,66529,1328,195300,16328,5480,14361,627,5072,4314,3073,1275,9468,8767,701,8767,3983,4784,2021-01-01,zipcode,Maple shade
ZCTA5 08053,34,46775,107154,1679,311100,38249,11988,33640,1031,7013,8427,11251,5918,19710,18653,1057,18653,13591,5062,2021-01-01,zipcode,Marlton
ZCTA5 08054,34,44473,103399,1718,281200,36330,11681,32368,1376,6541,6910,10478,7063,19475,18545,930,18545,14262,4283,2021-01-01,zipcode,Mount laurel
ZCTA5 08055,34,28519,140441,1441,371500,23381,7821,20508,471,3384,4418,7996,4239,10742,10332,410,10332,9175,1157,2021-01-01,zipcode,Medford
ZCTA5 08056,34,5656,130037,-666666666,361000,4145,1233,3622,68,1038,690,1059,767,1848,1729,119,1729,1680,49,2021-01-01,zipcode,Mickleton
ZCTA5 08057,34,20892,146465,1231,491700,16890,5773,14376,404,1917,2673,4696,4686,8024,7490,534,7490,6365,1125,2021-01-01,zipcode,Moorestown
ZCTA5 08059,34,5667,83089,1236,179600,4612,1275,3979,220,1556,1249,656,298,2395,2249,146,2249,1429,820,2021-01-01,zipcode,Mount ephraim
ZCTA5 08060,34,25333,97341,1387,241300,20736,6193,17970,1067,4607,5523,4848,1925,9898,9312,586,9312,6729,2583,2021-01-01,zipcode,Mount holly
ZCTA5 08061,34,3414,117625,-666666666,310000,2585,794,2248,50,725,700,434,339,1308,1265,43,1265,1227,38,2021-01-01,zipcode,Mount royal
ZCTA5 08062,34,17669,144468,1267,383800,13425,4298,11641,511,2722,2085,3523,2800,6003,5701,302,5701,5290,411,2021-01-01,zipcode,Mullica hill
ZCTA5 08063,34,3111,75365,1263,158800,2600,898,2173,179,917,706,268,103,1202,1125,77,1125,1005,120,2021-01-01,zipcode,National park
ZCTA5 08064,34,53,-666666666,-666666666,-666666666,53,39,53,0,0,23,14,16,37,37,0,37,37,0,2021-01-01,zipcode,New lisbon
ZCTA5 08065,34,7429,78736,1473,175400,6264,1759,5326,253,1603,1832,1199,439,3391,3078,313,3078,2268,810,2021-01-01,zipcode,Palmyra
ZCTA5 08066,34,8242,51065,978,135900,7052,2862,6371,559,2779,1819,989,225,4397,3761,636,3761,2445,1316,2021-01-01,zipcode,Paulsboro
ZCTA5 08067,34,1675,106875,1450,258500,1296,427,1136,79,401,351,222,83,618,569,49,569,481,88,2021-01-01,zipcode,Pedricktown
ZCTA5 08068,34,7135,67260,1091,220300,6027,2172,5240,443,1766,1732,898,401,3002,2832,170,2832,1754,1078,2021-01-01,zipcode,Pemberton
ZCTA5 08069,34,13412,53225,1067,146600,10545,4078,8872,1072,3887,2492,1088,333,5589,4995,594,4995,2753,2242,2021-01-01,zipcode,Penns grove
ZCTA5 08070,34,12365,70318,1052,155300,9995,3849,9028,769,3489,2963,1185,622,5795,5127,668,5127,3911,1216,2021-01-01,zipcode,Pennsville
ZCTA5 08071,34,9363,84643,1298,196800,7889,2728,6924,185,2043,1953,1942,801,4038,3742,296,3742,2730,1012,2021-01-01,zipcode,Pitman
ZCTA5 08072,34,351,57989,-666666666,185700,255,80,217,11,57,48,38,63,151,133,18,133,106,27,2021-01-01,zipcode,Quinton
ZCTA5 08073,34,0,-666666666,-666666666,-666666666,0,0,0,0,0,0,0,0,0,0,0,0,0,0,2021-01-01,zipcode,Rancocas
ZCTA5 08074,34,146,-666666666,-666666666,-666666666,82,0,82,9,0,0,0,73,32,32,0,32,32,0,2021-01-01,zipcode,Richwood
ZCTA5 08075,34,30186,80801,1331,234000,24482,7692,20703,1843,6555,5106,4915,2284,12594,11748,846,11748,7931,3817,2021-01-01,zipcode,Riverside
ZCTA5 08077,34,20298,120174,1751,290000,16467,5084,14416,525,3581,3760,4255,2295,7597,7200,397,7200,6248,952,2021-01-01,zipcode,Riverton
ZCTA5 08078,34,8020,77148,1133,163800,6414,1934,5470,371,2150,1708,949,292,3328,3053,275,3053,2097,956,2021-01-01,zipcode,Runnemede
ZCTA5 08079,34,10200,44763,952,163000,7928,3534,7052,964,2872,2031,824,361,5025,4112,913,4112,2367,1745,2021-01-01,zipcode,Salem
ZCTA5 08080,34,39122,116348,1488,272200,31476,10069,28022,1032,7063,7819,8392,3716,14642,14080,562,14080,12540,1540,2021-01-01,zipcode,Sewell
ZCTA5 08081,34,51518,90318,1312,211500,40294,12240,33700,2206,9871,11374,6615,3634,18476,17337,1139,17337,13875,3462,2021-01-01,zipcode,Sicklerville
ZCTA5 08083,34,9704,82799,1138,208100,8101,2353,6902,450,2121,2336,1209,786,3891,3691,200,3691,2929,762,2021-01-01,zipcode,Somerdale
ZCTA5 08084,34,6967,81310,1027,184700,5847,1838,5060,252,1755,1177,1308,568,2653,2598,55,2598,1995,603,2021-01-01,zipcode,Stratford
ZCTA5 08085,34,21142,117556,1696,290200,16160,4677,13746,785,3436,3490,3755,2280,7419,7080,339,7080,5762,1318,2021-01-01,zipcode,Swedesboro
ZCTA5 08086,34,7697,76875,1544,212700,6373,2104,5694,363,1616,1897,1158,660,3704,3468,236,3468,2361,1107,2021-01-01,zipcode,Thorofare
ZCTA5 08087,34,24951,75686,1565,258500,20882,8553,19047,1132,6996,5685,3361,1873,13162,10601,2561,10601,8928,1673,2021-01-01,zipcode,Tuckerton
ZCTA5 08088,34,24203,94271,2043,288600,20295,8847,17755,1274,5769,4435,4253,2024,9642,9189,453,9189,8744,445,2021-01-01,zipcode,Vincentown
ZCTA5 08089,34,4213,89479,1091,193600,3606,1175,3067,288,1082,1124,403,170,1454,1363,91,1363,1256,107,2021-01-01,zipcode,Waterford works
ZCTA5 08090,34,9408,103535,798,208200,7169,2126,6093,324,1837,1882,1195,855,3171,3061,110,3061,2773,288,2021-01-01,zipcode,Wenonah
ZCTA5 08091,34,5823,84564,1222,200800,4927,1467,4342,392,1662,1270,757,261,2215,2105,110,2105,1493,612,2021-01-01,zipcode,West berlin
ZCTA5 08092,34,3044,100662,1172,350300,2566,794,2195,130,733,552,547,233,1415,1141,274,1141,946,195,2021-01-01,zipcode,West creek
ZCTA5 08093,34,9812,61530,1161,161000,8026,2451,7130,548,3042,2142,852,546,4678,4218,460,4218,2460,1758,2021-01-01,zipcode,Westville
ZCTA5 08094,34,40845,86588,1174,213900,32531,10146,28249,2197,8989,9451,5076,2536,15757,14952,805,14952,12658,2294,2021-01-01,zipcode,Williamstown
ZCTA5 08095,34,0,-666666666,-666666666,-666666666,0,0,0,0,0,0,0,0,0,0,0,0,0,0,2021-01-01,zipcode,Winslow
ZCTA5 08096,34,36038,82046,1213,201200,29541,10023,25719,2367,8831,6863,5271,2387,14714,13643,1071,13643,10064,3579,2021-01-01,zipcode,Woodbury
ZCTA5 08097,34,3337,87813,1112,200000,2764,977,2434,154,715,865,497,203,1230,1200,30,1200,1064,136,2021-01-01,zipcode,Woodbury heights
ZCTA5 08098,34,9444,108281,1086,275800,7964,3229,6977,460,2041,1767,1699,1010,3822,3493,329,3493,2681,812,2021-01-01,zipcode,Woodstown
ZCTA5 08102,34,8603,27442,998,84000,6696,3648,5048,1752,1430,1106,444,316,3568,3095,473,3095,634,2461,2021-01-01,zipcode,Camden
ZCTA5 08103,34,12984,26007,1040,83600,10262,5835,8290,2466,3103,1864,505,352,5393,4355,1038,4355,1737,2618,2021-01-01,zipcode,Camden
ZCTA5 08104,34,21530,27399,911,73200,15657,6619,13163,3404,5071,3375,692,621,10226,8537,1689,8537,3064,5473,2021-01-01,zipcode,Camden
ZCTA5 08105,34,26968,36274,1106,90100,19284,7437,15820,5797,5364,3459,904,296,9100,8411,689,8411,3740,4671,2021-01-01,zipcode,Camden
ZCTA5 08106,34,9727,88429,982,235300,7690,2136,6855,236,2230,1703,1776,910,4030,3835,195,3835,2504,1331,2021-01-01,zipcode,Audubon
ZCTA5 08107,34,13798,64370,1164,205800,11361,3238,9787,845,3009,2786,2134,1013,6087,5710,377,5710,2935,2775,2021-01-01,zipcode,Oaklyn
ZCTA5 08108,34,18827,99087,1408,290600,15410,4181,13883,411,2445,3492,4071,3464,8809,8385,424,8385,5397,2988,2021-01-01,zipcode,Collingswood
ZCTA5 08109,34,23273,73111,1082,183400,19129,6539,16371,2322,5276,4577,2726,1470,9167,8635,532,8635,6288,2347,2021-01-01,zipcode,Merchantville
ZCTA5 08110,34,19658,73575,1158,150800,14861,5004,11995,2992,3518,3207,1752,526,6642,6098,544,6098,4428,1670,2021-01-01,zipcode,Pennsauken
ZCTA5 08201,34,10220,60536,1486,198100,8173,2730,7118,562,2426,1724,1715,691,4469,4075,394,4075,2684,1391,2021-01-01,zipcode,Absecon
ZCTA5 08202,34,1584,120625,1205,1290100,1493,902,1356,22,205,223,576,330,5628,789,4839,789,767,22,2021-01-01,zipcode,Avalon
ZCTA5 08203,34,7890,81830,1337,374600,7210,2902,6665,617,1611,1728,1638,1071,9177,3769,5408,3769,2749,1020,2021-01-01,zipcode,Brigantine
ZCTA5 08204,34,17565,74543,1090,304800,14882,6032,13056,654,4077,3792,3141,1392,12932,7614,5318,7614,5948,1666,2021-01-01,zipcode,Cape may
ZCTA5 08205,34,28051,74556,1430,201400,23868,9067,20668,1851,5809,6148,4472,2388,12042,11031,1011,11031,8767,2264,2021-01-01,zipcode,Absecon
ZCTA5 08210,34,17385,83859,1326,267500,14396,5425,12841,813,4115,4226,2429,1258,8126,7039,1087,7039,5743,1296,2021-01-01,zipcode,Cape may court house
ZCTA5 08212,34,150,77102,-666666666,889400,150,99,147,0,21,23,48,55,675,79,596,79,79,0,2021-01-01,zipcode,Cape may point
ZCTA5 08215,34,14230,71213,1114,228300,11938,4681,10464,1170,4163,2904,1363,864,5921,5594,327,5594,3852,1742,2021-01-01,zipcode,Egg harbor city
ZCTA5 08217,34,0,-666666666,-666666666,-666666666,0,0,0,0,0,0,0,0,0,0,0,0,0,0,2021-01-01,zipcode,Elwood
ZCTA5 08221,34,6957,118795,1799,287800,5800,2037,5093,305,824,1104,1611,1249,2842,2621,221,2621,2274,347,2021-01-01,zipcode,Linwood
ZCTA5 08223,34,4207,80750,1596,290000,3403,1222,3131,35,638,964,882,612,2406,1868,538,1868,1641,227,2021-01-01,zipcode,Marmora
ZCTA5 08224,34,211,138750,-666666666,255000,159,32,138,0,28,48,62,0,90,62,28,62,62,0,2021-01-01,zipcode,New gretna
ZCTA5 08225,34,8419,88232,1413,224600,6962,2477,6067,582,1496,1424,1643,922,3251,3084,167,3084,2757,327,2021-01-01,zipcode,Northfield
ZCTA5 08226,34,11211,88414,1332,594700,9870,4642,8889,285,2097,1709,2817,1981,20835,5353,15482,5353,3764,1589,2021-01-01,zipcode,Ocean city
ZCTA5 08230,34,5718,98393,-666666666,331600,4543,1746,4005,125,978,1121,1122,659,2592,2099,493,2099,2035,64,2021-01-01,zipcode,Ocean view
ZCTA5 08232,34,20107,44147,998,138200,15666,5461,13338,3510,5026,3440,913,449,7159,6359,800,6359,3007,3352,2021-01-01,zipcode,Pleasantville
ZCTA5 08234,34,45998,86783,1340,228300,36063,10784,31446,2715,10399,7588,7589,3155,17227,15773,1454,15773,13295,2478,2021-01-01,zipcode,Egg harbor township
ZCTA5 08240,34,2690,-666666666,-666666666,-666666666,2690,1330,89,0,9,19,50,11,5,5,0,5,5,0,2021-01-01,zipcode,Pomona
ZCTA5 08241,34,1058,130500,1525,318500,927,339,880,40,221,276,208,135,483,450,33,450,428,22,2021-01-01,zipcode,Port republic
ZCTA5 08242,34,3812,80893,1220,277100,3058,1358,2854,335,978,783,287,471,2207,1782,425,1782,1226,556,2021-01-01,zipcode,Rio grande
ZCTA5 08243,34,2068,86359,1589,794800,1931,1204,1811,29,493,471,491,327,6821,1083,5738,1083,1006,77,2021-01-01,zipcode,Sea isle city
ZCTA5 08244,34,10620,61781,1178,229400,8693,2867,7475,860,2479,2077,1165,894,5679,4635,1044,4635,2343,2292,2021-01-01,zipcode,Somers point
ZCTA5 08246,34,53,-666666666,-666666666,-666666666,53,27,53,0,27,0,0,26,135,26,109,26,26,0,2021-01-01,zipcode,South seaville
ZCTA5 08247,34,1051,122031,1300,1542300,1032,634,895,20,156,113,380,226,3346,553,2793,553,502,51,2021-01-01,zipcode,Stone harbor
ZCTA5 08248,34,161,117917,-666666666,937500,143,50,143,0,0,53,7,83,475,76,399,76,76,0,2021-01-01,zipcode,Strathmere
ZCTA5 08251,34,10631,65515,1453,203900,8580,3439,7690,628,2906,2533,1186,437,6727,4658,2069,4658,3810,848,2021-01-01,zipcode,Villas
ZCTA5 08260,34,12509,57869,1081,363800,11141,5539,9864,697,3909,2651,1599,1008,23333,6145,17188,6145,3968,2177,2021-01-01,zipcode,Wildwood
ZCTA5 08270,34,8278,78848,1091,263600,6693,2620,5784,683,2150,1477,949,525,3640,3101,539,3101,2480,621,2021-01-01,zipcode,Woodbine
ZCTA5 08302,34,47358,53599,1180,167100,35222,16284,29926,6660,13166,6033,2582,1485,15278,13716,1562,13716,8251,5465,2021-01-01,zipcode,Bridgeton
ZCTA5 08310,34,1245,46674,982,150500,1144,564,1018,223,518,222,28,27,635,567,68,567,416,151,2021-01-01,zipcode,Buena
ZCTA5 08311,34,1830,65357,1134,153800,1400,606,1277,220,624,317,99,17,704,544,160,544,472,72,2021-01-01,zipcode,Cedarville
ZCTA5 08312,34,8310,89973,1150,211000,6632,2220,5532,437,1939,1763,823,570,3244,2921,323,2921,2205,716,2021-01-01,zipcode,Clayton
ZCTA5 08314,34,489,-666666666,-666666666,163500,423,155,346,3,257,36,15,35,214,180,34,180,167,13,2021-01-01,zipcode,Delmont
ZCTA5 08316,34,125,21914,-666666666,130900,124,102,105,0,29,43,8,25,154,85,69,85,53,32,2021-01-01,zipcode,Dorchester
ZCTA5 08317,34,1388,78295,-666666666,254200,1151,535,1037,71,467,329,127,43,623,571,52,571,441,130,2021-01-01,zipcode,Dorothy
ZCTA5 08318,34,12046,76263,1156,225500,10152,3860,8456,738,3303,2136,1495,784,4801,4482,319,4482,3743,739,2021-01-01,zipcode,Elmer
ZCTA5 08319,34,1304,107969,-666666666,261100,1028,363,889,27,367,197,181,117,531,451,80,451,445,6,2021-01-01,zipcode,Estell manor
ZCTA5 08320,34,1097,-666666666,-666666666,-666666666,1097,1097,1089,222,603,245,19,0,0,0,0,0,0,0,2021-01-01,zipcode,Fairton
ZCTA5 08321,34,118,34444,-666666666,210000,116,78,116,7,87,5,10,7,271,70,201,70,50,20,2021-01-01,zipcode,Fortescue
ZCTA5 08322,34,10208,92738,1370,217200,8327,2583,7275,722,2979,2148,960,466,3598,3418,180,3418,3023,395,2021-01-01,zipcode,Franklinville
ZCTA5 08323,34,515,88906,1023,219600,452,214,393,18,100,148,71,56,278,223,55,223,188,35,2021-01-01,zipcode,Greenwich
ZCTA5 08324,34,308,63750,-666666666,184900,242,137,176,48,66,30,32,0,153,100,53,100,57,43,2021-01-01,zipcode,Heislerville
ZCTA5 08326,34,1259,69803,1669,168900,929,267,827,75,333,201,185,33,516,443,73,443,315,128,2021-01-01,zipcode,Landisville
ZCTA5 08327,34,4981,71000,-666666666,130100,4904,4683,4778,1111,2608,831,191,37,192,192,0,192,151,41,2021-01-01,zipcode,Leesburg
ZCTA5 08328,34,1773,83929,-666666666,188800,1370,431,1190,114,488,450,92,46,668,634,34,634,547,87,2021-01-01,zipcode,Malaga
ZCTA5 08329,34,265,-666666666,-666666666,279300,199,134,199,0,60,66,60,13,119,103,16,103,89,14,2021-01-01,zipcode,Mauricetown
ZCTA5 08330,34,29580,75405,1466,202900,24180,8678,20581,1348,7078,5778,4478,1899,12390,11503,887,11503,8627,2876,2021-01-01,zipcode,Mays landing
ZCTA5 08332,34,35532,61660,1035,167200,28394,10542,24847,4137,9386,6916,2832,1576,15872,14571,1301,14571,9960,4611,2021-01-01,zipcode,Millville
ZCTA5 08340,34,978,69773,985,238200,705,315,651,49,169,255,161,17,386,386,0,386,305,81,2021-01-01,zipcode,Milmay
ZCTA5 08341,34,2200,60833,940,168600,1734,514,1369,228,380,502,152,107,870,846,24,846,350,496,2021-01-01,zipcode,Minotola
ZCTA5 08343,34,4835,120288,1686,293600,3997,1587,3283,308,1070,792,779,334,1712,1572,140,1572,1452,120,2021-01-01,zipcode,Monroeville
ZCTA5 08344,34,4657,64731,1461,173600,4060,1433,3512,246,1351,923,594,398,2152,1930,222,1930,1821,109,2021-01-01,zipcode,Newfield
ZCTA5 08345,34,649,56094,1328,158800,535,234,479,71,265,60,69,14,446,292,154,292,268,24,2021-01-01,zipcode,Newport
ZCTA5 08346,34,484,-666666666,-666666666,201200,385,100,326,26,149,91,60,0,194,194,0,194,194,0,2021-01-01,zipcode,Newtonville
ZCTA5 08348,34,50,93750,-666666666,-666666666,43,21,35,14,7,14,0,0,22,22,0,22,15,7,2021-01-01,zipcode,Port elizabeth
ZCTA5 08349,34,2457,47813,1347,120000,1821,830,1513,159,698,528,113,15,1063,837,226,837,543,294,2021-01-01,zipcode,Port norris
ZCTA5 08350,34,475,-666666666,-666666666,212900,427,91,404,91,168,114,31,0,207,150,57,150,150,0,2021-01-01,zipcode,Richland
ZCTA5 08352,34,441,71761,1683,153300,252,64,214,0,79,64,52,19,115,115,0,115,63,52,2021-01-01,zipcode,Rosenhayn
ZCTA5 08353,34,323,67500,983,165300,265,103,244,31,99,68,27,19,133,120,13,120,84,36,2021-01-01,zipcode,Shiloh
ZCTA5 08360,34,44080,57905,1119,163100,34162,12237,29211,6030,10394,8025,3468,1294,16293,15543,750,15543,9741,5802,2021-01-01,zipcode,Vineland
ZCTA5 08361,34,18953,83728,1250,226100,15565,6915,13040,1679,3559,3329,2613,1860,7017,6520,497,6520,5193,1327,2021-01-01,zipcode,Vineland
ZCTA5 08401,34,38496,29789,963,151000,29637,12664,24818,6421,8509,5302,3238,1348,20731,16176,4555,16176,4520,11656,2021-01-01,zipcode,Atlantic city
ZCTA5 08402,34,5388,106206,1337,508200,4730,1981,4234,194,673,984,1071,1312,6888,2651,4237,2651,2288,363,2021-01-01,zipcode,Margate city
ZCTA5 08403,34,906,105385,1912,782800,854,475,824,11,175,223,254,161,1594,482,1112,482,395,87,2021-01-01,zipcode,Longport
ZCTA5 08406,34,9332,66657,1420,265000,8262,3281,7455,698,2238,2031,1547,941,7642,4243,3399,4243,2744,1499,2021-01-01,zipcode,Ventnor city
ZCTA5 08501,34,6395,125172,1371,460200,5582,2335,4564,182,869,935,1410,1168,2497,2476,21,2476,2247,229,2021-01-01,zipcode,Allentown
ZCTA5 08502,34,11467,206250,2196,637100,8949,2571,7581,84,589,1208,2382,3318,3776,3717,59,3717,3102,615,2021-01-01,zipcode,Belle mead
ZCTA5 08505,34,17549,98479,1368,297700,14300,4265,12450,444,3312,3518,3325,1851,7268,6831,437,6831,4888,1943,2021-01-01,zipcode,Bordentown
ZCTA5 08510,34,5207,176349,2225,601300,4555,1488,3562,205,700,718,1517,422,1768,1738,30,1738,1592,146,2021-01-01,zipcode,Millstone township
ZCTA5 08511,34,838,62443,983,282500,623,113,529,107,159,120,85,58,345,339,6,339,207,132,2021-01-01,zipcode,Cookstown
ZCTA5 08512,34,11540,120898,1445,508300,9653,3440,8300,546,1606,1205,2641,2302,4678,4406,272,4406,2754,1652,2021-01-01,zipcode,Cranbury
ZCTA5 08514,34,5151,107344,1220,431800,4226,1552,3578,160,1201,886,893,438,2166,1976,190,1976,1774,202,2021-01-01,zipcode,Cream ridge
ZCTA5 08515,34,7884,160781,1942,461400,5982,1858,4986,304,936,749,1749,1248,2325,2272,53,2272,2136,136,2021-01-01,zipcode,Chesterfield
ZCTA5 08518,34,5632,88431,1080,248100,4377,929,3878,483,1142,1277,703,273,2373,2214,159,2214,1387,827,2021-01-01,zipcode,Florence
ZCTA5 08520,34,29799,107241,1444,305100,23759,7375,20709,1839,4911,4364,5911,3684,11206,10362,844,10362,7339,3023,2021-01-01,zipcode,Hightstown
ZCTA5 08525,34,4611,133649,1781,471100,3786,840,3361,148,589,566,1154,904,1983,1828,155,1828,1517,311,2021-01-01,zipcode,Hopewell
ZCTA5 08527,34,57357,100885,1573,381900,45390,15340,39068,2256,11444,10896,9885,4587,21692,20567,1125,20567,17689,2878,2021-01-01,zipcode,Jackson
ZCTA5 08528,34,219,53935,-666666666,232900,219,159,202,0,0,29,31,142,187,187,0,187,187,0,2021-01-01,zipcode,Kingston
ZCTA5 08530,34,8075,111671,1547,455800,7024,2379,6317,362,1311,1345,1596,1703,3563,3291,272,3291,2353,938,2021-01-01,zipcode,Lambertville
ZCTA5 08533,34,6384,97488,1286,361500,5112,1304,4204,419,1332,1015,929,509,2522,2431,91,2431,1925,506,2021-01-01,zipcode,New egypt
ZCTA5 08534,34,12672,145747,1813,478100,9734,3693,8458,272,1055,1082,2808,3241,4898,4574,324,4574,3834,740,2021-01-01,zipcode,Pennington
ZCTA5 08535,34,5189,191068,2241,590900,4292,1234,3706,158,673,753,1427,695,1778,1669,109,1669,1518,151,2021-01-01,zipcode,Millstone township
ZCTA5 08536,34,20523,115685,1714,564800,16036,4433,14396,171,1203,1691,5264,6067,8684,8168,516,8168,3636,4532,2021-01-01,zipcode,Plainsboro
ZCTA5 08540,34,48700,163074,1931,661500,38762,13093,32651,722,1984,2862,10538,16545,19020,17695,1325,17695,11568,6127,2021-01-01,zipcode,Princeton
ZCTA5 08542,34,2542,121103,2058,452900,2136,507,1863,98,65,303,316,1081,1366,1007,359,1007,386,621,2021-01-01,zipcode,Princeton
ZCTA5 08550,34,20546,196066,2291,645800,16225,5183,14265,136,814,1473,4726,7116,7649,7310,339,7310,5677,1633,2021-01-01,zipcode,Princeton junction
ZCTA5 08551,34,5567,140539,2167,500400,4877,1761,3833,119,671,656,1717,670,2088,1975,113,1975,1796,179,2021-01-01,zipcode,Ringoes
ZCTA5 08553,34,752,126389,1500,510200,620,228,529,16,38,69,184,222,298,280,18,280,241,39,2021-01-01,zipcode,Rocky hill
ZCTA5 08554,34,4236,90435,1416,167800,3399,907,2814,97,1104,954,542,117,1699,1646,53,1646,1341,305,2021-01-01,zipcode,Roebling
ZCTA5 08555,34,1006,99911,2138,316500,733,248,644,16,158,164,185,121,350,339,11,339,279,60,2021-01-01,zipcode,Roosevelt
ZCTA5 08558,34,7810,213966,1496,692300,6127,2358,5137,93,697,595,1522,2230,2771,2610,161,2610,2191,419,2021-01-01,zipcode,Skillman
ZCTA5 08559,34,5295,137524,1853,525200,4872,1752,4126,56,638,913,1478,1041,2487,2253,234,2253,1941,312,2021-01-01,zipcode,Stockton
ZCTA5 08560,34,3904,113156,2239,385000,3298,1350,2789,151,825,497,632,684,1589,1483,106,1483,1366,117,2021-01-01,zipcode,Titusville
ZCTA5 08561,34,433,-666666666,-666666666,336500,347,145,282,46,57,98,45,36,144,144,0,144,77,67,2021-01-01,zipcode,Windsor
ZCTA5 08562,34,3924,81597,1020,210300,3090,1205,2651,372,880,693,521,185,1640,1476,164,1476,1119,357,2021-01-01,zipcode,Wrightstown
ZCTA5 08608,34,982,20990,715,-666666666,699,333,661,112,175,292,42,40,634,505,129,505,31,474,2021-01-01,zipcode,Trenton
ZCTA5 08609,34,13298,41718,1118,75000,10372,4743,8429,2278,3988,1459,538,166,5249,4364,885,4364,1339,3025,2021-01-01,zipcode,Trenton
ZCTA5 08610,34,32159,75493,1329,206300,26181,8100,22573,3237,8480,5830,3619,1407,12199,11675,524,11675,7774,3901,2021-01-01,zipcode,Trenton
ZCTA5 08611,34,31283,42962,1186,105100,23194,9646,19913,5970,6952,4182,2108,701,11486,10269,1217,10269,3925,6344,2021-01-01,zipcode,Trenton
ZCTA5 08618,34,39148,42628,1069,171100,30947,12797,23440,3481,8326,6029,3408,2196,15839,13691,2148,13691,5607,8084,2021-01-01,zipcode,Trenton
ZCTA5 08619,34,23438,89825,1469,267000,19870,6311,17362,1015,4597,4653,4879,2218,9588,9103,485,9103,6416,2687,2021-01-01,zipcode,Trenton
ZCTA5 08620,34,12587,99394,1173,285100,11006,4713,9058,618,2874,2903,1970,693,4433,4152,281,4152,3409,743,2021-01-01,zipcode,Trenton
ZCTA5 08628,34,9646,87579,1377,289200,8556,3766,7612,306,1640,1253,2725,1688,4515,4092,423,4092,2515,1577,2021-01-01,zipcode,Trenton
ZCTA5 08629,34,12722,73054,1205,107700,10655,3873,9348,2077,3588,2274,980,429,4420,4208,212,4208,2874,1334,2021-01-01,zipcode,Trenton
ZCTA5 08638,34,23960,60185,1302,181400,20439,8651,16110,1928,5722,3944,2881,1635,10154,8723,1431,8723,5055,3668,2021-01-01,zipcode,Trenton
ZCTA5 08640,34,7904,83468,2122,-666666666,6724,4918,5791,1049,2392,1465,702,183,930,866,64,866,2,864,2021-01-01,zipcode,Joint base mdl
ZCTA5 08641,34,5216,79500,2188,-666666666,3312,716,2506,17,255,1240,593,401,1535,1432,103,1432,0,1432,2021-01-01,zipcode,Joint base mdl
ZCTA5 08648,34,32508,113214,1773,343200,26941,8932,21239,1579,3777,3808,5786,6289,12315,11480,835,11480,7921,3559,2021-01-01,zipcode,Lawrence township
ZCTA5 08690,34,20445,105158,1420,305400,17542,6221,15539,758,3673,4171,4772,2165,8151,7857,294,7857,6547,1310,2021-01-01,zipcode,Trenton
ZCTA5 08691,34,16730,126733,1792,417000,13230,4173,11778,358,2180,1946,3889,3405,6982,6635,347,6635,5452,1183,2021-01-01,zipcode,Trenton
ZCTA5 08701,34,130352,53380,1534,356000,70457,31802,54505,5958,16014,14685,10066,7782,32922,30408,2514,30408,15475,14933,2021-01-01,zipcode,Lakewood
ZCTA5 08720,34,687,126375,-666666666,556500,623,191,499,40,80,173,153,53,215,215,0,215,166,49,2021-01-01,zipcode,Allenwood
ZCTA5 08721,34,21725,97087,1512,293500,17214,5504,15215,1321,5432,4351,2919,1192,9074,7862,1212,7862,6655,1207,2021-01-01,zipcode,Bayville
ZCTA5 08722,34,10863,88940,1710,243900,8920,2666,7538,424,2390,2740,1419,565,4168,3916,252,3916,3564,352,2021-01-01,zipcode,Beachwood
ZCTA5 08723,34,32686,92434,1492,317900,27190,9124,23561,1753,8676,6760,4382,1990,13825,12649,1176,12649,9783,2866,2021-01-01,zipcode,Brick
ZCTA5 08724,34,39809,81793,1677,302700,33376,11229,29145,1564,9489,8224,6741,3127,17337,15927,1410,15927,13143,2784,2021-01-01,zipcode,Brick
ZCTA5 08730,34,4955,155993,2389,666600,3793,1249,3293,93,477,560,1388,775,2139,1805,334,1805,1701,104,2021-01-01,zipcode,Brielle
ZCTA5 08731,34,21037,85321,1887,296200,17630,6607,15302,1062,5091,4764,3061,1324,9523,8504,1019,8504,7209,1295,2021-01-01,zipcode,Forked river
ZCTA5 08732,34,1447,100278,1742,429500,1238,498,1146,23,216,304,362,241,773,664,109,664,598,66,2021-01-01,zipcode,Island heights
ZCTA5 08733,34,2693,64614,1488,194200,2244,868,1943,227,754,517,306,139,1098,1037,61,1037,647,390,2021-01-01,zipcode,Lakehurst
ZCTA5 08734,34,7536,105282,-666666666,319600,6406,2410,5490,352,1765,1472,1157,744,2862,2532,330,2532,2383,149,2021-01-01,zipcode,Lanoka harbor
ZCTA5 08735,34,3982,76768,1509,692200,3635,1869,3463,91,878,824,1091,579,7337,2156,5181,2156,1844,312,2021-01-01,zipcode,Lavallette
ZCTA5 08736,34,13366,152697,1412,690000,11119,3343,9590,169,1140,1948,3866,2467,6314,5297,1017,5297,4701,596,2021-01-01,zipcode,Manasquan
ZCTA5 08738,34,1422,153636,1833,1226900,1261,630,1132,29,124,255,433,291,1767,634,1133,634,578,56,2021-01-01,zipcode,Mantoloking
ZCTA5 08740,34,1629,59397,1773,268300,1384,553,1205,79,525,241,289,71,1242,757,485,757,566,191,2021-01-01,zipcode,Ocean gate
ZCTA5 08741,34,2754,117969,1224,352200,2373,818,2113,39,553,638,624,259,1204,1051,153,1051,972,79,2021-01-01,zipcode,Pine beach
ZCTA5 08742,34,24902,103079,1709,441300,21217,5923,18839,922,4458,4366,6227,2866,12573,10376,2197,10376,8169,2207,2021-01-01,zipcode,Point pleasant beach
ZCTA5 08750,34,3576,140868,-666666666,874000,3102,1428,2749,24,301,513,1162,749,2016,1475,541,1475,1315,160,2021-01-01,zipcode,Sea girt
ZCTA5 08751,34,3671,63661,1186,450900,3268,1851,2911,307,852,719,654,379,5238,1928,3310,1928,1168,760,2021-01-01,zipcode,Seaside heights
ZCTA5 08752,34,2364,66875,1428,653400,2219,1094,2137,38,561,473,596,469,4144,1335,2809,1335,1095,240,2021-01-01,zipcode,Seaside park
ZCTA5 08753,34,64708,90034,1526,311100,53195,17614,46056,2413,14639,12910,10949,5145,27449,24947,2502,24947,19889,5058,2021-01-01,zipcode,Toms river
ZCTA5 08755,34,27164,73857,1423,298300,21524,9144,18900,1498,6494,5079,3752,2077,11075,10299,776,10299,8387,1912,2021-01-01,zipcode,Toms river
ZCTA5 08757,34,34957,50807,1505,195800,31899,18611,29931,3366,13303,7791,3732,1739,19478,17702,1776,17702,15032,2670,2021-01-01,zipcode,Toms river
ZCTA5 08758,34,7783,87768,1539,357800,6808,3312,6235,185,2275,1583,1401,791,3829,3303,526,3303,2973,330,2021-01-01,zipcode,Waretown
ZCTA5 08759,34,34007,45996,1148,135400,32379,21605,31480,2678,12992,8560,4663,2587,22203,19912,2291,19912,17267,2645,2021-01-01,zipcode,Manchester township
ZCTA5 08801,34,8296,143030,1900,451300,7255,3758,5312,225,941,1043,1659,1444,2721,2530,191,2530,2125,405,2021-01-01,zipcode,Annandale
ZCTA5 08802,34,4301,114083,2052,377900,3607,1173,3089,15,843,865,971,395,1532,1461,71,1461,1361,100,2021-01-01,zipcode,Asbury
ZCTA5 08804,34,2948,102065,-666666666,365600,2517,933,2248,100,604,694,633,217,1236,1138,98,1138,895,243,2021-01-01,zipcode,Bloomsbury
ZCTA5 08805,34,13730,71942,1567,320000,10967,2991,9489,1096,2903,2487,1824,1179,5524,5128,396,5128,2564,2564,2021-01-01,zipcode,Bound brook
ZCTA5 08807,34,38916,138549,1776,488900,31571,10736,27471,1529,5390,4407,8336,7809,14268,13740,528,13740,11324,2416,2021-01-01,zipcode,Bridgewater
ZCTA5 08809,34,6948,110369,1543,371100,5716,2324,4455,359,955,885,1313,943,2263,2231,32,2231,1729,502,2021-01-01,zipcode,Clinton
ZCTA5 08810,34,8185,127975,1869,408900,6418,1906,5535,123,648,786,2493,1485,2899,2761,138,2761,2460,301,2021-01-01,zipcode,Dayton
ZCTA5 08812,34,14074,104295,1541,341500,11484,3797,9519,825,2816,2368,2495,1015,4947,4544,403,4544,3509,1035,2021-01-01,zipcode,Dunellen
ZCTA5 08816,34,48950,127717,1743,413200,38852,12515,34051,1972,5861,6305,10972,8941,17150,16472,678,16472,13519,2953,2021-01-01,zipcode,East brunswick
ZCTA5 08817,34,47590,98184,1765,344400,37054,11671,33129,2684,7665,7150,9142,6488,17130,16234,896,16234,9024,7210,2021-01-01,zipcode,Edison
ZCTA5 08820,34,40083,146149,1775,520800,31464,10978,28162,2305,3291,3038,9632,9896,13485,13310,175,13310,10020,3290,2021-01-01,zipcode,Edison
ZCTA5 08821,34,548,103199,-666666666,433700,378,110,339,9,124,104,82,20,200,165,35,165,165,0,2021-01-01,zipcode,Flagtown
ZCTA5 08822,34,30717,121220,1479,441900,24766,7235,21623,1234,4038,4364,6974,5013,11890,11462,428,11462,8966,2496,2021-01-01,zipcode,Flemington
ZCTA5 08823,34,9071,96110,1962,264100,7240,1628,6293,313,916,1262,2039,1763,3554,3476,78,3476,2410,1066,2021-01-01,zipcode,Franklin park
ZCTA5 08824,34,13511,159321,2013,506500,10783,3203,9431,282,1268,1735,3791,2355,4675,4503,172,4503,3949,554,2021-01-01,zipcode,Kendall park
ZCTA5 08825,34,4611,109125,1420,410500,3872,1197,3489,266,854,791,931,647,2043,1917,126,1917,1537,380,2021-01-01,zipcode,Frenchtown
ZCTA5 08826,34,5429,112339,1362,352400,4618,1536,3947,149,878,1153,1067,700,2298,2181,117,2181,1878,303,2021-01-01,zipcode,Glen gardner
ZCTA5 08827,34,3824,111793,748,378800,3288,1110,2938,118,682,840,813,485,1697,1561,136,1561,1404,157,2021-01-01,zipcode,Hampton
ZCTA5 08828,34,2365,100273,1719,254900,1979,469,1754,77,543,476,470,188,999,991,8,991,723,268,2021-01-01,zipcode,Helmetta
ZCTA5 08829,34,3547,103692,1425,267600,2984,973,2449,128,706,481,677,457,1491,1427,64,1427,1102,325,2021-01-01,zipcode,High bridge
ZCTA5 08830,34,17684,103179,1880,328400,14513,4882,13208,1133,3197,1898,4031,2949,6817,6410,407,6410,4554,1856,2021-01-01,zipcode,Iselin
ZCTA5 08831,34,53894,101137,1603,391500,44860,20503,41578,2370,10715,8906,12158,7429,24167,22751,1416,22751,20309,2442,2021-01-01,zipcode,Monroe township
ZCTA5 08832,34,2937,71071,1563,317100,2268,565,1631,282,665,223,317,144,1009,976,33,976,218,758,2021-01-01,zipcode,Keasbey
ZCTA5 08833,34,9062,147679,1693,488300,7641,2851,6729,128,1173,1438,2388,1602,3706,3516,190,3516,3031,485,2021-01-01,zipcode,Lebanon
ZCTA5 08835,34,10861,79766,1487,266800,9134,3017,7842,494,3240,1946,1454,708,4638,4380,258,4380,3287,1093,2021-01-01,zipcode,Manville
ZCTA5 08836,34,4220,187625,1694,661600,3079,972,2693,3,340,457,1130,763,1345,1336,9,1336,1295,41,2021-01-01,zipcode,Martinsville
ZCTA5 08837,34,19371,98468,1575,343300,14726,4339,13452,887,2529,2999,3688,3349,7245,6874,371,6874,3445,3429,2021-01-01,zipcode,Edison
ZCTA5 08840,34,17757,137399,1840,435000,13623,4058,12240,621,1878,2413,3880,3448,6340,6083,257,6083,4723,1360,2021-01-01,zipcode,Metuchen
ZCTA5 08844,34,42818,145903,1960,458100,34596,9312,30559,1218,5152,5608,10664,7917,15928,15293,635,15293,12845,2448,2021-01-01,zipcode,Hillsborough
ZCTA5 08846,34,14513,90162,1574,333200,11675,3480,10408,1010,3385,2988,1995,1030,5603,5459,144,5459,4063,1396,2021-01-01,zipcode,Middlesex
ZCTA5 08848,34,8463,121715,1453,341000,6697,2442,5925,296,1474,1362,1922,871,3187,2993,194,2993,2767,226,2021-01-01,zipcode,Milford
ZCTA5 08850,34,8364,111081,1741,353200,6659,1895,6128,213,1546,1671,1919,779,3138,3043,95,3043,2505,538,2021-01-01,zipcode,Milltown
ZCTA5 08852,34,18480,109462,1752,425400,14564,4039,12837,403,1779,1667,5188,3800,7331,7141,190,7141,4855,2286,2021-01-01,zipcode,Monmouth junction
ZCTA5 08853,34,5260,192681,1603,582100,4314,1010,3412,97,301,531,1258,1225,1996,1913,83,1913,1615,298,2021-01-01,zipcode,Neshanic station
ZCTA5 08854,34,60467,112980,1764,353600,50912,19080,37565,2902,7683,8404,11467,7109,17699,16954,745,16954,11153,5801,2021-01-01,zipcode,Piscataway
ZCTA5 08857,34,40725,95968,1340,376100,34217,10343,30114,2032,8911,7520,7777,3874,16223,15753,470,15753,10419,5334,2021-01-01,zipcode,Old bridge
ZCTA5 08858,34,0,-666666666,-666666666,-666666666,0,0,0,0,0,0,0,0,0,0,0,0,0,0,2021-01-01,zipcode,Oldwick
ZCTA5 08859,34,24408,89881,1419,342200,19853,5511,17299,1325,4298,4534,5026,2116,8989,8837,152,8837,5303,3534,2021-01-01,zipcode,Parlin
ZCTA5 08861,34,57515,54587,1442,281600,45894,16894,37831,10722,12954,8943,3984,1228,20017,19135,882,19135,6497,12638,2021-01-01,zipcode,Perth amboy
ZCTA5 08863,34,12897,105505,1724,327800,10500,3453,9180,1063,2267,2698,2089,1063,4593,4349,244,4349,3082,1267,2021-01-01,zipcode,Fords
ZCTA5 08865,34,30179,66779,1104,199400,25034,8635,22220,1710,8012,6125,4021,2352,13923,12885,1038,12885,8604,4281,2021-01-01,zipcode,Phillipsburg
ZCTA5 08867,34,5436,164259,1185,500000,4566,1346,3708,116,521,874,1250,947,1990,1892,98,1892,1770,122,2021-01-01,zipcode,Pittstown
ZCTA5 08869,34,7993,90125,1717,369400,6956,1621,5711,601,1684,1338,1266,822,3256,3119,137,3119,1744,1375,2021-01-01,zipcode,Raritan
ZCTA5 08872,34,19711,83750,1337,324200,15803,4703,14218,1228,4442,3627,3375,1546,7829,7501,328,7501,4443,3058,2021-01-01,zipcode,Sayreville
ZCTA5 08873,34,55115,98251,1767,358300,44674,14685,39404,2143,8213,8323,11739,8986,22086,20794,1292,20794,14225,6569,2021-01-01,zipcode,Somerset
ZCTA5 08876,34,22691,108769,1515,397300,19041,5485,16355,1268,3197,3066,5355,3469,9324,8926,398,8926,5925,3001,2021-01-01,zipcode,Somerville
ZCTA5 08879,34,21940,89041,1473,317100,18614,5486,16762,1452,5751,4142,3556,1861,9520,9004,516,9004,5298,3706,2021-01-01,zipcode,South amboy
ZCTA5 08880,34,4818,83986,1623,275900,3789,884,3232,310,973,1044,559,346,1860,1778,82,1778,992,786,2021-01-01,zipcode,South bound brook
ZCTA5 08882,34,16087,82031,1416,322200,12568,3979,11069,1466,3556,2989,1998,1060,5972,5658,314,5658,3753,1905,2021-01-01,zipcode,South river
ZCTA5 08884,34,8175,92188,973,317100,6763,2433,6038,737,1969,1584,1145,603,3189,3143,46,3143,2585,558,2021-01-01,zipcode,Spotswood
ZCTA5 08886,34,7225,139132,1734,353700,5876,1605,4879,184,1044,1213,1697,741,2548,2519,29,2519,2119,400,2021-01-01,zipcode,Stewartsville
ZCTA5 08887,34,1294,91964,1477,218000,1110,320,946,143,153,217,270,163,626,584,42,584,376,208,2021-01-01,zipcode,Three bridges
ZCTA5 08889,34,10269,114830,1564,448800,8723,3692,7680,254,1657,1384,2420,1965,4276,4242,34,4242,3768,474,2021-01-01,zipcode,Whitehouse station
ZCTA5 08890,34,94,-666666666,-666666666,-666666666,94,40,15,0,7,0,8,0,47,7,40,7,0,7,2021-01-01,zipcode,
ZCTA5 08901,34,57257,49338,1597,265700,46366,21354,26791,9118,7145,3949,3641,2938,16698,15464,1234,15464,3059,12405,2021-01-01,zipcode,New brunswick
ZCTA5 08902,34,42570,103488,1799,352700,33973,10307,30408,3381,6062,5472,8818,6675,15962,15488,474,15488,8805,6683,2021-01-01,zipcode,North brunswick
ZCTA5 08904,34,14947,85652,1611,377100,12584,3759,10964,328,1122,1633,3441,4440,6944,6502,442,6502,2666,3836,2021-01-01,zipcode,Highland park
ZCTA5 32003,12,29505,103019,1684,292800,24621,9840,21129,681,3678,6860,6017,3893,11736,11090,646,11090,9586,1504,2021-01-01,zipcode,Fleming island
ZCTA5 32008,12,5920,42802,820,96000,4499,2252,4063,692,2022,810,447,92,3212,2354,858,2354,1873,481,2021-01-01,zipcode,Branford
ZCTA5 32009,12,3372,65850,864,149600,2877,1036,2367,275,982,861,161,88,1448,1383,65,1383,1200,183,2021-01-01,zipcode,Bryceville
ZCTA5 32011,12,14791,67087,873,185700,12002,5135,10410,1655,4273,3123,852,507,5983,5480,503,5480,4613,867,2021-01-01,zipcode,Callahan
ZCTA5 32024,12,18712,57636,1022,159000,15388,6644,13535,1566,5084,4663,1701,521,7963,7220,743,7220,6067,1153,2021-01-01,zipcode,Lake city
ZCTA5 32025,12,23649,47439,858,148400,19257,10131,15688,2353,5440,5321,1687,887,9291,8127,1164,8127,4797,3330,2021-01-01,zipcode,Lake city
ZCTA5 32026,12,3368,-666666666,-666666666,-666666666,3368,3368,3185,1259,1208,639,51,28,0,0,0,0,0,0,2021-01-01,zipcode,Raiford
ZCTA5 32033,12,4666,71360,1069,252000,4446,1937,3910,313,918,1763,540,376,2199,1915,284,1915,1646,269,2021-01-01,zipcode,Elkton
ZCTA5 32034,12,38747,87047,1008,365900,33214,15289,30737,1195,6487,7984,9519,5552,21065,16526,4539,16526,13872,2654,2021-01-01,zipcode,Fernandina beach
ZCTA5 32038,12,9905,45188,792,146000,8163,3801,7396,838,2713,2860,710,275,4662,3824,838,3824,3239,585,2021-01-01,zipcode,Fort white
ZCTA5 32040,12,8006,61040,968,147800,6122,2359,5295,739,2595,1507,335,119,3037,2663,374,2663,2338,325,2021-01-01,zipcode,Glen saint mary
ZCTA5 32043,12,30249,64973,1133,217900,23601,9565,20449,1879,6033,6948,4129,1460,12336,11018,1318,11018,8718,2300,2021-01-01,zipcode,Green cove springs
ZCTA5 32044,12,2268,41214,1073,66400,1720,939,1452,296,528,553,66,9,877,813,64,813,554,259,2021-01-01,zipcode,Hampton
ZCTA5 32046,12,10745,64338,766,189400,8413,3792,7605,928,3636,2248,617,176,4012,3602,410,3602,2742,860,2021-01-01,zipcode,Hilliard
ZCTA5 32052,12,8712,43330,685,95600,7446,5037,6714,1905,3096,1213,410,90,2982,2245,737,2245,1558,687,2021-01-01,zipcode,Jasper
ZCTA5 32053,12,3729,34267,740,74300,2852,1530,2567,454,1139,693,169,112,1808,1289,519,1289,1001,288,2021-01-01,zipcode,Jennings
ZCTA5 32054,12,12757,54696,699,133400,10408,6512,9061,1928,3343,2577,848,365,4004,3567,437,3567,2535,1032,2021-01-01,zipcode,Lake butler
ZCTA5 32055,12,16184,41065,788,122800,12442,5618,10528,1545,4110,3387,894,592,7338,6190,1148,6190,4014,2176,2021-01-01,zipcode,Lake city
ZCTA5 32058,12,5411,53529,867,136100,4387,2160,3706,824,1683,1036,101,62,1694,1494,200,1494,1141,353,2021-01-01,zipcode,Lawtey
ZCTA5 32059,12,2670,43634,728,74600,2285,1063,2039,427,686,748,113,65,1377,1109,268,1109,806,303,2021-01-01,zipcode,Lee
ZCTA5 32060,12,23078,49604,631,123700,18640,9777,16456,3098,6160,4178,1744,1276,9519,7754,1765,7754,6152,1602,2021-01-01,zipcode,Live oak
ZCTA5 32061,12,344,-666666666,-666666666,184400,308,137,157,6,93,25,33,0,85,85,0,85,72,13,2021-01-01,zipcode,Lulu
ZCTA5 32062,12,1862,56311,-666666666,149600,1566,795,1265,241,646,211,86,81,984,668,316,668,521,147,2021-01-01,zipcode,Mc alpin
ZCTA5 32063,12,14024,64533,901,183200,10939,4659,9298,1024,3507,2541,1292,934,5098,4523,575,4523,3269,1254,2021-01-01,zipcode,Macclenny
ZCTA5 32064,12,7433,40871,797,120800,6285,2913,5141,507,2058,1603,578,395,3516,2865,651,2865,1326,1539,2021-01-01,zipcode,Live oak
ZCTA5 32065,12,39146,79984,1373,221500,30258,10670,25843,1722,6337,10497,5365,1922,14195,13336,859,13336,10305,3031,2021-01-01,zipcode,Orange park
ZCTA5 32066,12,6973,57747,675,112800,6016,3264,5057,1445,2070,1182,272,88,2452,1978,474,1978,1519,459,2021-01-01,zipcode,Mayo
ZCTA5 32068,12,57231,73178,1237,185300,44763,15706,38458,3383,13896,13928,5242,2009,21551,19950,1601,19950,15333,4617,2021-01-01,zipcode,Middleburg
ZCTA5 32071,12,2987,39531,-666666666,116700,2598,1415,2078,329,771,700,176,102,1576,1173,403,1173,994,179,2021-01-01,zipcode,O brien
ZCTA5 32072,12,80,142557,-666666666,251100,80,29,80,0,12,39,21,8,43,43,0,43,43,0,2021-01-01,zipcode,
ZCTA5 32073,12,42278,67370,1200,196500,34638,12304,30566,2938,7511,12086,5377,2654,16472,15600,872,15600,9857,5743,2021-01-01,zipcode,Orange park
ZCTA5 32079,12,384,52500,1564,-666666666,384,363,384,90,43,64,88,99,196,172,24,172,17,155,2021-01-01,zipcode,Penney farms
ZCTA5 32080,12,21001,82231,1400,400300,18808,8825,17080,574,2820,4949,5632,3105,15990,9618,6372,9618,7613,2005,2021-01-01,zipcode,Saint augustine
ZCTA5 32081,12,20867,128570,2491,442500,15122,6561,13768,141,1616,2903,4776,4332,8158,7113,1045,7113,6295,818,2021-01-01,zipcode,Ponte vedra
ZCTA5 32082,12,28721,114291,1606,574800,23944,10356,21371,407,2314,4518,8786,5346,14627,11696,2931,11696,9529,2167,2021-01-01,zipcode,Ponte vedra beach
ZCTA5 32083,12,2159,55800,893,112600,1697,1124,1557,279,600,559,94,25,712,616,96,616,397,219,2021-01-01,zipcode,Raiford
ZCTA5 32084,12,35618,61025,1129,228400,30543,12768,26712,2198,9335,7258,5052,2869,16668,13125,3543,13125,8972,4153,2021-01-01,zipcode,Saint augustine
ZCTA5 32086,12,32753,63840,1309,260400,28186,11805,25388,1934,6744,9218,4497,2995,14489,12531,1958,12531,9386,3145,2021-01-01,zipcode,Saint augustine
ZCTA5 32087,12,5605,69375,730,133500,4676,2963,4073,892,2066,978,63,74,1500,1209,291,1209,809,400,2021-01-01,zipcode,Sanderson
ZCTA5 32091,12,15618,48175,805,109800,12703,5706,11302,1551,5019,3443,834,455,6712,5457,1255,5457,3316,2141,2021-01-01,zipcode,Starke
ZCTA5 32092,12,42245,91116,1864,335100,33670,12577,29412,2579,6691,7118,8093,4931,16337,14569,1768,14569,12889,1680,2021-01-01,zipcode,Saint augustine
ZCTA5 32094,12,3358,58086,808,109200,2776,1382,2557,444,1259,657,84,113,1140,925,215,925,724,201,2021-01-01,zipcode,Wellborn
ZCTA5 32095,12,15021,92941,1193,377300,11529,4155,10094,501,2191,2569,2579,2254,5436,5218,218,5218,4524,694,2021-01-01,zipcode,Saint augustine
ZCTA5 32096,12,2793,41192,558,93300,2237,1310,2014,470,862,456,184,42,1410,1142,268,1142,902,240,2021-01-01,zipcode,White springs
ZCTA5 32097,12,20752,73779,1423,223500,16424,5838,14215,1492,4802,4615,2225,1081,8212,7650,562,7650,5962,1688,2021-01-01,zipcode,Yulee
ZCTA5 32102,12,2319,48500,1172,159600,2013,1205,1876,452,715,380,234,95,1749,1120,629,1120,980,140,2021-01-01,zipcode,Astor
ZCTA5 32110,12,8909,40526,936,135600,7290,3518,6413,807,3206,1392,693,315,3872,3272,600,3272,2323,949,2021-01-01,zipcode,Bunnell
ZCTA5 32112,12,7501,38913,674,113800,6073,2964,5207,2053,1609,995,414,136,3644,2767,877,2767,1909,858,2021-01-01,zipcode,Crescent city
ZCTA5 32113,12,4966,38526,811,101500,3969,1935,3408,501,1517,993,195,202,2525,1927,598,1927,1494,433,2021-01-01,zipcode,Citra
ZCTA5 32114,12,34560,36034,1004,136500,29187,13529,22825,3210,7466,7599,3126,1424,16681,14270,2411,14270,4592,9678,2021-01-01,zipcode,Daytona beach
ZCTA5 32117,12,29100,44139,1157,132300,23941,10221,21115,2303,7640,7028,2987,1157,14177,12399,1778,12399,6042,6357,2021-01-01,zipcode,Daytona beach
ZCTA5 32118,12,18123,45962,1095,269900,16251,8179,15083,1034,4460,4868,2843,1878,16232,9639,6593,9639,5986,3653,2021-01-01,zipcode,Daytona beach
ZCTA5 32119,12,22677,46606,1172,159700,19446,8937,17055,1674,5268,5859,2696,1558,12026,10403,1623,10403,6414,3989,2021-01-01,zipcode,Daytona beach
ZCTA5 32124,12,7449,70455,1417,271500,6663,4119,6077,1039,2108,1375,927,628,2571,2312,259,2312,1890,422,2021-01-01,zipcode,Daytona beach
ZCTA5 32127,12,28136,57760,1147,230200,24526,11321,22270,1615,6327,7773,3894,2661,15986,12799,3187,12799,9477,3322,2021-01-01,zipcode,Port orange
ZCTA5 32128,12,21811,82553,1470,303200,18246,8952,15953,617,3679,5103,4524,2030,9372,8901,471,8901,7299,1602,2021-01-01,zipcode,Port orange
ZCTA5 32129,12,22670,53091,1244,189100,20198,8220,17119,1510,5478,6333,2639,1159,11490,10166,1324,10166,7180,2986,2021-01-01,zipcode,Port orange
ZCTA5 32130,12,4756,52889,1179,206200,3941,1895,3517,329,1564,1045,383,196,1894,1661,233,1661,1410,251,2021-01-01,zipcode,De leon springs
ZCTA5 32131,12,4273,56553,864,173700,3696,1834,3467,563,1264,951,425,264,2042,1665,377,1665,1323,342,2021-01-01,zipcode,East palatka
ZCTA5 32132,12,7667,43709,896,182300,6948,3323,6503,487,2424,2604,502,486,4122,3741,381,3741,3119,622,2021-01-01,zipcode,Edgewater
ZCTA5 32133,12,711,123985,-666666666,592900,711,181,546,0,48,16,223,259,345,294,51,294,264,30,2021-01-01,zipcode,Eastlake weir
ZCTA5 32134,12,7147,39586,653,95900,6399,3960,5919,878,2682,1788,429,142,5792,3198,2594,3198,2887,311,2021-01-01,zipcode,Fort mc coy
ZCTA5 32136,12,8209,58433,1168,334700,7488,4689,7183,187,2000,2547,1485,964,5566,3905,1661,3905,3239,666,2021-01-01,zipcode,Flagler beach
ZCTA5 32137,12,44687,66902,1491,270600,38905,20234,35137,2169,10424,11050,7301,4193,23313,18346,4967,18346,15523,2823,2021-01-01,zipcode,Palm coast
ZCTA5 32139,12,853,52606,-666666666,78600,801,637,784,162,442,70,75,35,533,338,195,338,317,21,2021-01-01,zipcode,Georgetown
ZCTA5 32140,12,1802,54032,902,73100,1473,657,1226,242,457,461,60,6,700,570,130,570,495,75,2021-01-01,zipcode,Florahome
ZCTA5 32141,12,18859,54326,1151,187900,16369,7675,15365,1271,5421,5699,1964,1010,9540,8592,948,8592,7567,1025,2021-01-01,zipcode,Edgewater
ZCTA5 32145,12,5539,66075,933,162300,4294,1728,3771,627,1263,1297,478,106,2357,1989,368,1989,1536,453,2021-01-01,zipcode,Hastings
ZCTA5 32147,12,1961,31398,-666666666,82700,1505,495,1210,77,802,182,149,0,796,796,0,796,666,130,2021-01-01,zipcode,Hollister
ZCTA5 32148,12,10552,36008,679,63100,8442,4887,7564,1478,3770,1483,664,169,5346,4359,987,4359,3401,958,2021-01-01,zipcode,Interlachen
ZCTA5 32157,12,376,52292,884,139300,333,133,306,106,63,102,35,0,278,163,115,163,93,70,2021-01-01,zipcode,
ZCTA5 32159,12,29613,49198,1106,214700,27349,18661,26073,1756,8528,9040,3559,3190,18858,15676,3182,15676,12663,3013,2021-01-01,zipcode,Lady lake
ZCTA5 32162,12,51373,66366,1541,281600,51257,46032,51233,1253,12856,15336,13252,8536,35958,29994,5964,29994,28334,1660,2021-01-01,zipcode,The villages
ZCTA5 32164,12,50008,63091,1451,231600,41226,19054,37206,3491,12054,13307,5770,2584,20840,18982,1858,18982,13620,5362,2021-01-01,zipcode,Palm coast
ZCTA5 32168,12,30060,58750,1267,252300,26105,13230,23970,2155,7138,7837,4844,1996,15682,13517,2165,13517,10643,2874,2021-01-01,zipcode,New smyrna beach
ZCTA5 32169,12,10400,80503,1531,375000,9861,5833,9585,261,1851,3459,2240,1774,12612,5889,6723,5889,4954,935,2021-01-01,zipcode,New smyrna beach
ZCTA5 32174,12,51319,60911,1131,238700,43862,21775,39957,3342,10343,14072,8075,4125,25294,22934,2360,22934,18094,4840,2021-01-01,zipcode,Ormond beach
ZCTA5 32176,12,13741,54958,1257,272000,12651,6298,11679,673,2895,3960,2417,1734,10358,6885,3473,6885,5407,1478,2021-01-01,zipcode,Ormond beach
ZCTA5 32177,12,26087,39133,762,127000,20150,10556,17844,2405,8467,5026,1212,734,11271,10055,1216,10055,6246,3809,2021-01-01,zipcode,Palatka
ZCTA5 32179,12,8043,38671,923,103000,7054,3631,6325,937,2316,2054,586,432,5053,3665,1388,3665,2951,714,2021-01-01,zipcode,Ocklawaha
ZCTA5 32180,12,5144,63476,860,177400,3664,1746,3089,663,1006,1127,199,94,1563,1409,154,1409,1065,344,2021-01-01,zipcode,Pierson
ZCTA5 32181,12,3119,37898,797,88100,2465,1323,1885,253,782,631,143,76,1492,1159,333,1159,780,379,2021-01-01,zipcode,Pomona park
ZCTA5 32187,12,1337,35951,950,128300,1183,778,1075,157,368,326,208,16,654,615,39,615,520,95,2021-01-01,zipcode,San mateo
ZCTA5 32189,12,5287,37075,672,79000,4539,2515,4140,878,1282,1474,446,60,3562,2449,1113,2449,1663,786,2021-01-01,zipcode,Satsuma
ZCTA5 32190,12,1524,62837,686,208900,1178,595,1010,143,477,167,129,94,617,513,104,513,397,116,2021-01-01,zipcode,Seville
ZCTA5 32193,12,1057,44125,832,207500,890,590,795,148,363,171,68,45,886,560,326,560,464,96,2021-01-01,zipcode,Welaka
ZCTA5 32195,12,2984,55000,-666666666,141500,2713,1280,2345,493,874,804,139,35,1270,1114,156,1114,1049,65,2021-01-01,zipcode,Weirsdale
ZCTA5 32202,12,6717,33224,850,153600,6244,4439,5281,1204,1644,1513,638,282,2645,2149,496,2149,224,1925,2021-01-01,zipcode,Jacksonville
ZCTA5 32204,12,7750,49879,972,222400,6812,1904,6051,534,1200,1546,1707,1064,4995,4314,681,4314,1086,3228,2021-01-01,zipcode,Jacksonville
ZCTA5 32205,12,31398,53488,1015,203700,25824,8075,23592,2671,6027,6815,5078,3001,16342,14447,1895,14447,7522,6925,2021-01-01,zipcode,Jacksonville
ZCTA5 32206,12,16406,31783,822,102600,12739,5123,10968,2130,3780,3242,1224,592,9187,6840,2347,6840,3191,3649,2021-01-01,zipcode,Jacksonville
ZCTA5 32207,12,36711,52846,954,189500,29388,9479,25732,3533,6225,6731,5712,3531,18478,15890,2588,15890,7857,8033,2021-01-01,zipcode,Jacksonville
ZCTA5 32208,12,32244,36707,1036,99500,24867,11436,22116,3811,7898,7600,1855,952,15392,13365,2027,13365,7114,6251,2021-01-01,zipcode,Jacksonville
ZCTA5 32209,12,35915,26890,853,68300,27883,13776,24274,4876,10380,6694,1632,692,17671,14517,3154,14517,6680,7837,2021-01-01,zipcode,Jacksonville
ZCTA5 32210,12,66824,51262,1049,157100,52024,17283,45220,5613,15671,14149,6741,3046,28915,26474,2441,26474,14017,12457,2021-01-01,zipcode,Jacksonville
ZCTA5 32211,12,35668,49205,971,153100,27224,8758,23570,2776,8795,7584,3191,1224,14858,13301,1557,13301,6844,6457,2021-01-01,zipcode,Jacksonville
ZCTA5 32212,12,2275,44241,1741,-666666666,1899,95,513,15,83,312,54,49,242,237,5,237,2,235,2021-01-01,zipcode,Jacksonville
ZCTA5 32216,12,39762,54739,1076,192200,32519,11339,28556,2972,8361,8325,6002,2896,19346,17224,2122,17224,7763,9461,2021-01-01,zipcode,Jacksonville
ZCTA5 32217,12,20303,54036,999,240400,16564,5584,14812,910,3604,4407,3825,2066,9498,8807,691,8807,4860,3947,2021-01-01,zipcode,Jacksonville
ZCTA5 32218,12,68534,59938,1174,196900,51605,17910,44458,4548,13566,15436,7415,3493,26129,23743,2386,23743,15356,8387,2021-01-01,zipcode,Jacksonville
ZCTA5 32219,12,14169,56195,917,156500,11263,5031,9680,1234,3948,2604,1335,559,5384,5019,365,5019,4121,898,2021-01-01,zipcode,Jacksonville
ZCTA5 32220,12,12020,66808,1092,166800,9567,3286,8629,824,3658,2883,756,508,4898,4604,294,4604,3850,754,2021-01-01,zipcode,Jacksonville
ZCTA5 32221,12,29346,66846,1374,182400,23268,8711,19569,2377,6491,6252,3067,1382,11041,10397,644,10397,7764,2633,2021-01-01,zipcode,Jacksonville
ZCTA5 32222,12,14879,71077,1407,221400,12050,3178,10889,917,2763,4907,1772,530,6009,5450,559,5450,4043,1407,2021-01-01,zipcode,Jacksonville
ZCTA5 32223,12,25824,88364,1324,292000,21351,8159,18960,725,3849,6804,4810,2772,10610,10311,299,10311,8600,1711,2021-01-01,zipcode,Jacksonville
ZCTA5 32224,12,41366,81185,1391,347000,34549,11605,25782,872,4428,7101,8341,5040,16575,15366,1209,15366,8797,6569,2021-01-01,zipcode,Jacksonville
ZCTA5 32225,12,55401,78411,1430,251800,44166,14115,38239,1732,9083,12340,10363,4721,22923,21065,1858,21065,14131,6934,2021-01-01,zipcode,Jacksonville
ZCTA5 32226,12,18097,88070,1792,262900,14305,5518,12988,1250,3599,4271,2526,1342,7329,6389,940,6389,5910,479,2021-01-01,zipcode,Jacksonville
ZCTA5 32227,12,3510,71667,1759,-666666666,2598,327,1177,23,320,622,121,91,659,544,115,544,0,544,2021-01-01,zipcode,Jacksonville
ZCTA5 32228,12,412,-666666666,-666666666,-666666666,412,0,73,0,0,54,19,0,0,0,0,0,0,0,2021-01-01,zipcode,Jacksonville
ZCTA5 32233,12,24489,70781,1251,337800,20663,6280,17555,1016,4129,5159,4771,2480,11240,9901,1339,9901,5902,3999,2021-01-01,zipcode,Atlantic beach
ZCTA5 32234,12,7780,72825,799,171400,5804,1872,5045,813,2102,1391,559,180,2978,2750,228,2750,2272,478,2021-01-01,zipcode,Jacksonville
ZCTA5 32244,12,63709,55700,1206,163800,48854,15535,43213,3659,15447,14970,6822,2315,25494,23759,1735,23759,13088,10671,2021-01-01,zipcode,Jacksonville
ZCTA5 32246,12,56222,68500,1352,225800,45195,12815,39021,2912,9378,11992,10360,4379,24852,22370,2482,22370,12366,10004,2021-01-01,zipcode,Jacksonville
ZCTA5 32250,12,28859,95474,1615,398500,24129,7597,21342,1362,3690,4962,6886,4442,14294,12403,1891,12403,8386,4017,2021-01-01,zipcode,Jacksonville beach
ZCTA5 32254,12,13798,34159,924,65400,10606,4815,9108,2503,3757,2089,588,171,6177,5100,1077,5100,2521,2579,2021-01-01,zipcode,Jacksonville
ZCTA5 32256,12,48988,64543,1319,279500,41274,12171,34563,1265,5830,8857,12365,6246,24489,22519,1970,22519,8446,14073,2021-01-01,zipcode,Jacksonville
ZCTA5 32257,12,41487,67739,1199,235400,33440,10928,29613,2467,7444,9315,6761,3626,18147,16968,1179,16968,10527,6441,2021-01-01,zipcode,Jacksonville
ZCTA5 32258,12,41004,89671,1669,261700,31118,9239,26772,656,4835,8980,8459,3842,15366,14831,535,14831,9898,4933,2021-01-01,zipcode,Jacksonville
ZCTA5 32259,12,62354,134552,2013,372100,46110,15127,39739,760,7443,10193,13108,8235,20370,19000,1370,19000,16458,2542,2021-01-01,zipcode,Saint johns
ZCTA5 32266,12,6880,98856,1365,462200,5847,1542,5083,145,597,1176,2013,1152,3407,2957,450,2957,2092,865,2021-01-01,zipcode,Neptune beach
ZCTA5 32277,12,33948,51545,1074,188000,27042,9148,21795,1994,7409,7337,3736,1319,13784,12859,925,12859,6196,6663,2021-01-01,zipcode,Jacksonville
ZCTA5 32301,12,32425,46241,1037,166000,27265,8248,19690,1733,3585,5560,5231,3581,16627,14163,2464,14163,4184,9979,2021-01-01,zipcode,Tallahassee
ZCTA5 32303,12,50598,52450,1132,166300,42353,11667,31088,1742,6290,9434,8106,5516,24005,21986,2019,21986,10783,11203,2021-01-01,zipcode,Tallahassee
ZCTA5 32304,12,45853,26060,996,129700,42534,15574,16071,2013,3592,5256,3122,2088,22038,18175,3863,18175,2600,15575,2021-01-01,zipcode,Tallahassee
ZCTA5 32305,12,20815,47602,870,117800,15782,6004,13273,2249,4267,4113,1482,1162,8727,7603,1124,7603,4687,2916,2021-01-01,zipcode,Tallahassee
ZCTA5 32308,12,22415,65726,1138,240400,19093,7148,16571,521,2737,4047,4704,4562,11655,10827,828,10827,5669,5158,2021-01-01,zipcode,Tallahassee
ZCTA5 32309,12,33505,90858,1135,288500,26116,9333,22495,613,3106,5549,7530,5697,13614,13011,603,13011,10276,2735,2021-01-01,zipcode,Tallahassee
ZCTA5 32310,12,14090,37225,859,89800,11360,4781,8551,1438,2947,2121,1378,667,7556,5775,1781,5775,2913,2862,2021-01-01,zipcode,Tallahassee
ZCTA5 32311,12,21231,76494,1284,239000,17188,5125,14948,700,2968,3300,4293,3687,9548,8555,993,8555,5459,3096,2021-01-01,zipcode,Tallahassee
ZCTA5 32312,12,31956,107615,1335,327900,25440,8301,21567,464,1962,5247,7759,6135,12931,12229,702,12229,10430,1799,2021-01-01,zipcode,Tallahassee
ZCTA5 32317,12,14492,102318,1250,286900,11750,4413,10172,391,1700,2703,2906,2472,5697,5353,344,5353,4966,387,2021-01-01,zipcode,Tallahassee
ZCTA5 32320,12,4010,55390,872,188400,3541,1550,3286,773,1012,826,389,286,2229,1801,428,1801,1297,504,2021-01-01,zipcode,Apalachicola
ZCTA5 32321,12,6443,41723,805,99200,5502,3481,4703,1191,1955,904,406,247,2289,1662,627,1662,1294,368,2021-01-01,zipcode,Bristol
ZCTA5 32322,12,3824,36197,871,173700,3312,2470,3073,801,1222,687,224,139,1902,951,951,951,771,180,2021-01-01,zipcode,Carrabelle
ZCTA5 32323,12,104,-666666666,-666666666,-666666666,104,104,104,0,31,32,20,21,299,53,246,53,42,11,2021-01-01,zipcode,
ZCTA5 32324,12,5039,47448,573,63400,4518,2880,4191,743,2001,958,307,182,2228,1843,385,1843,1221,622,2021-01-01,zipcode,Chattahoochee
ZCTA5 32327,12,29946,74075,968,184000,24529,10262,21543,2459,7797,6906,2569,1812,11276,9942,1334,9942,8311,1631,2021-01-01,zipcode,Crawfordville
ZCTA5 32328,12,3889,52157,971,251900,3145,1382,2750,452,692,813,433,360,3027,1508,1519,1508,1222,286,2021-01-01,zipcode,Eastpoint
ZCTA5 32330,12,779,41850,725,96100,558,311,445,178,144,96,27,0,271,212,59,212,97,115,2021-01-01,zipcode,Greensboro
ZCTA5 32331,12,4775,39831,738,69500,3894,2389,3390,571,1656,853,265,45,2320,1725,595,1725,1461,264,2021-01-01,zipcode,Greenville
ZCTA5 32332,12,1178,26538,651,75300,1003,595,865,276,312,126,89,62,612,520,92,520,231,289,2021-01-01,zipcode,Gretna
ZCTA5 32333,12,11695,53814,808,159600,9706,4435,8784,1254,2395,2383,2025,727,5091,4494,597,4494,3696,798,2021-01-01,zipcode,Havana
ZCTA5 32334,12,1494,48386,707,104600,1334,551,999,120,390,368,72,49,769,581,188,581,466,115,2021-01-01,zipcode,Hosford
ZCTA5 32336,12,1553,33295,805,68200,1224,766,1071,174,409,253,160,75,842,531,311,531,389,142,2021-01-01,zipcode,Lamont
ZCTA5 32340,12,10456,35230,712,113400,8807,5182,7832,1583,2835,2340,639,435,4472,3526,946,3526,2386,1140,2021-01-01,zipcode,Madison
ZCTA5 32343,12,3416,56288,940,164500,2385,649,1952,254,544,693,262,199,1191,1098,93,1098,936,162,2021-01-01,zipcode,Midway
ZCTA5 32344,12,12151,50635,675,162500,10436,5200,9285,1568,3178,2460,1365,714,5660,4577,1083,4577,3488,1089,2021-01-01,zipcode,Monticello
ZCTA5 32346,12,2049,45647,1418,201500,1700,1005,1600,296,555,560,132,57,1670,873,797,873,716,157,2021-01-01,zipcode,Panacea
ZCTA5 32347,12,7072,49430,724,112500,5327,2449,4608,483,1729,1592,586,218,3178,2455,723,2455,1738,717,2021-01-01,zipcode,Perry
ZCTA5 32348,12,13032,44735,853,73100,11113,7303,9870,2247,4555,2057,669,342,5362,3920,1442,3920,3030,890,2021-01-01,zipcode,Perry
ZCTA5 32350,12,1421,41139,648,77900,1292,809,1181,136,443,388,196,18,851,681,170,681,558,123,2021-01-01,zipcode,Pinetta
ZCTA5 32351,12,17508,35456,655,85200,13759,7528,11730,2722,4444,2768,1002,794,7088,5792,1296,5792,3967,1825,2021-01-01,zipcode,Quincy
ZCTA5 32352,12,4618,44461,913,107600,3613,1611,3184,560,1245,949,274,156,2228,1810,418,1810,1400,410,2021-01-01,zipcode,Quincy
ZCTA5 32355,12,298,43125,880,218800,282,189,270,14,88,153,15,0,280,152,128,152,122,30,2021-01-01,zipcode,Saint marks
ZCTA5 32356,12,0,-666666666,-666666666,-666666666,0,0,0,0,0,0,0,0,20,0,20,0,0,0,2021-01-01,zipcode,Salem
ZCTA5 32358,12,1256,69712,888,172100,1090,544,1072,80,271,336,322,63,1206,545,661,545,502,43,2021-01-01,zipcode,Sopchoppy
ZCTA5 32359,12,958,44175,-666666666,109700,919,542,898,84,322,375,66,51,2096,497,1599,497,443,54,2021-01-01,zipcode,Steinhatchee
ZCTA5 32361,12,430,-666666666,908,80200,315,79,295,31,111,134,19,0,207,207,0,207,183,24,2021-01-01,zipcode,Wacissa
ZCTA5 32399,12,0,-666666666,-666666666,-666666666,0,0,0,0,0,0,0,0,0,0,0,0,0,0,2021-01-01,zipcode,Tallahassee
ZCTA5 32401,12,19208,41484,925,152300,15805,6892,14157,2197,4691,4525,1704,1040,10116,8804,1312,8804,4714,4090,2021-01-01,zipcode,Panama city
ZCTA5 32403,12,1416,67500,1715,-666666666,1037,210,493,0,69,201,132,91,383,266,117,266,0,266,2021-01-01,zipcode,Panama city
ZCTA5 32404,12,39832,58853,1139,173100,32182,13256,27960,3859,8755,10460,2958,1928,16870,14273,2597,14273,10167,4106,2021-01-01,zipcode,Panama city
ZCTA5 32405,12,29999,61947,1219,191600,24030,9213,20642,1705,5564,7348,3519,2506,13602,12216,1386,12216,7482,4734,2021-01-01,zipcode,Panama city
ZCTA5 32407,12,14355,64102,1667,279500,12033,3870,10559,900,2220,3746,2374,1319,11234,6153,5081,6153,3550,2603,2021-01-01,zipcode,Panama city beach
ZCTA5 32408,12,19821,62386,1149,271400,16452,5771,15167,724,3362,5756,3660,1665,16854,8706,8148,8706,6157,2549,2021-01-01,zipcode,Panama city
ZCTA5 32409,12,10004,53811,1015,158200,8054,3510,7176,806,2737,2273,988,372,4248,3729,519,3729,3208,521,2021-01-01,zipcode,Panama city
ZCTA5 32410,12,517,56875,1423,262200,497,242,497,7,91,235,101,63,881,279,602,279,209,70,2021-01-01,zipcode,Mexico beach
ZCTA5 32413,12,14472,71125,1247,280900,13071,5147,11710,718,3044,4293,2290,1365,15340,6835,8505,6835,5028,1807,2021-01-01,zipcode,Panama city beach
ZCTA5 32420,12,2275,41267,640,115300,2030,973,1864,334,748,606,145,31,1497,1178,319,1178,1090,88,2021-01-01,zipcode,Alford
ZCTA5 32421,12,4197,37029,646,83500,3287,1741,2971,589,1155,987,211,29,1797,1445,352,1445,1291,154,2021-01-01,zipcode,Altha
ZCTA5 32423,12,974,48958,1660,146900,887,507,828,30,335,309,146,8,635,487,148,487,446,41,2021-01-01,zipcode,Bascom
ZCTA5 32424,12,7208,39907,527,113900,6081,3905,5428,1220,2399,1160,432,217,2797,2179,618,2179,1587,592,2021-01-01,zipcode,Blountstown
ZCTA5 32425,12,14135,39515,774,99600,11590,6710,10196,2232,4562,2625,568,209,5909,4766,1143,4766,3447,1319,2021-01-01,zipcode,Bonifay
ZCTA5 32426,12,802,32239,-666666666,78200,711,482,668,264,249,123,27,5,384,294,90,294,276,18,2021-01-01,zipcode,Campbellton
ZCTA5 32427,12,1088,31250,701,108200,901,418,706,213,218,212,28,35,488,469,19,469,269,200,2021-01-01,zipcode,Caryville
ZCTA5 32428,12,17578,43542,729,130200,14365,8051,12874,1989,5356,3716,1221,592,7167,5936,1231,5936,4704,1232,2021-01-01,zipcode,Chipley
ZCTA5 32430,12,837,52685,-666666666,119100,677,172,645,123,314,202,6,0,334,326,8,326,246,80,2021-01-01,zipcode,Clarksville
ZCTA5 32431,12,4412,52436,709,113500,3664,1845,3310,447,1632,778,271,182,2201,1780,421,1780,1397,383,2021-01-01,zipcode,Cottondale
ZCTA5 32432,12,0,-666666666,-666666666,-666666666,0,0,0,0,0,0,0,0,0,0,0,0,0,0,2021-01-01,zipcode,Cypress
ZCTA5 32433,12,19500,45734,873,97500,14947,6964,13496,2273,5524,3906,1067,726,8013,6971,1042,6971,5271,1700,2021-01-01,zipcode,Defuniak springs
ZCTA5 32435,12,6638,47175,764,143100,5343,2161,4539,481,1548,1497,705,308,3137,2694,443,2694,1900,794,2021-01-01,zipcode,Defuniak springs
ZCTA5 32437,12,601,38750,806,108900,511,204,471,61,243,147,18,2,326,282,44,282,207,75,2021-01-01,zipcode,Ebro
ZCTA5 32438,12,4920,38490,772,68100,3772,1803,3057,681,1067,972,293,44,1936,1756,180,1756,1549,207,2021-01-01,zipcode,Fountain
ZCTA5 32439,12,13306,68341,1137,257700,10745,3989,9543,522,2458,3522,2132,909,6253,5303,950,5303,4225,1078,2021-01-01,zipcode,Freeport
ZCTA5 32440,12,7731,46592,710,88600,6751,4138,5711,1266,2388,1363,393,301,2361,1999,362,1999,1357,642,2021-01-01,zipcode,Graceville
ZCTA5 32442,12,3568,41667,682,122800,2793,1399,2408,294,1052,810,125,127,1689,1396,293,1396,886,510,2021-01-01,zipcode,Grand ridge
ZCTA5 32443,12,3082,40430,673,100000,2396,1325,2070,308,739,711,174,138,1369,1109,260,1109,946,163,2021-01-01,zipcode,Greenwood
ZCTA5 32444,12,21148,76712,1367,235600,15968,5146,13578,825,3349,5198,2916,1290,8544,7600,944,7600,5504,2096,2021-01-01,zipcode,Lynn haven
ZCTA5 32445,12,2483,46333,696,69800,2176,1726,2013,697,724,478,68,46,571,474,97,474,313,161,2021-01-01,zipcode,Malone
ZCTA5 32446,12,11161,50822,792,130200,9124,4119,7866,758,2764,2726,865,753,4515,3916,599,3916,2661,1255,2021-01-01,zipcode,Marianna
ZCTA5 32448,12,7524,33614,660,88000,6116,3444,5113,635,2307,1673,343,155,3882,3349,533,3349,2309,1040,2021-01-01,zipcode,Marianna
ZCTA5 32449,12,998,-666666666,-666666666,66300,699,280,699,258,227,135,72,7,485,340,145,340,309,31,2021-01-01,zipcode,Wewahitchka
ZCTA5 32455,12,3953,43034,687,84500,3440,1614,3002,573,1578,586,222,43,2139,1694,445,1694,1382,312,2021-01-01,zipcode,Ponce de leon
ZCTA5 32456,12,8088,64456,1241,262400,6777,3096,6304,338,1620,2070,1397,879,6374,3655,2719,3655,2782,873,2021-01-01,zipcode,Port saint joe
ZCTA5 32459,12,18544,94648,1727,432800,15358,5131,14020,736,2667,3962,4476,2179,15661,7880,7781,7880,6211,1669,2021-01-01,zipcode,Santa rosa beach
ZCTA5 32460,12,5891,43942,742,95200,5256,3790,4759,1009,1775,1494,253,228,1976,1690,286,1690,1284,406,2021-01-01,zipcode,Sneads
ZCTA5 32461,12,2158,127148,2235,677700,1833,944,1813,64,310,496,643,300,5097,953,4144,953,783,170,2021-01-01,zipcode,Inlet beach
ZCTA5 32462,12,3691,33507,750,112000,3136,1737,2715,506,1182,787,111,129,1854,1376,478,1376,1198,178,2021-01-01,zipcode,Vernon
ZCTA5 32463,12,191,45250,698,151400,167,61,136,14,49,68,0,5,90,81,9,81,45,36,2021-01-01,zipcode,Wausau
ZCTA5 32464,12,3729,50506,727,75400,3150,1404,2866,446,1154,771,293,202,1991,1565,426,1565,1411,154,2021-01-01,zipcode,Westville
ZCTA5 32465,12,7873,42394,677,118000,7066,4891,6179,1263,2387,1857,455,217,3224,2273,951,2273,1841,432,2021-01-01,zipcode,Wewahitchka
ZCTA5 32466,12,5718,60548,950,130000,4538,2207,4025,441,1550,1739,179,116,2444,2019,425,2019,1666,353,2021-01-01,zipcode,Youngstown
ZCTA5 32501,12,10985,32541,825,195100,8793,4356,7517,1144,2324,2059,1173,817,5518,4474,1044,4474,2043,2431,2021-01-01,zipcode,Pensacola
ZCTA5 32502,12,3799,60113,1046,209700,3106,1030,2717,249,597,887,539,445,2192,1725,467,1725,891,834,2021-01-01,zipcode,Pensacola
ZCTA5 32503,12,32950,56486,1039,204300,27364,9938,21106,1384,4775,7069,4652,3226,14457,12984,1473,12984,8617,4367,2021-01-01,zipcode,Pensacola
ZCTA5 32504,12,21687,64147,1118,203500,17588,6914,15121,1055,2825,5103,3371,2767,10182,9608,574,9608,5817,3791,2021-01-01,zipcode,Pensacola
ZCTA5 32505,12,27661,38863,954,76400,21196,9274,18774,2925,7307,6163,1455,924,12998,10852,2146,10852,5232,5620,2021-01-01,zipcode,Pensacola
ZCTA5 32506,12,37202,54391,1090,154500,30134,11728,25276,3227,6912,9582,3791,1764,16438,14482,1956,14482,8662,5820,2021-01-01,zipcode,Pensacola
ZCTA5 32507,12,33615,58443,1039,192000,26916,10025,22894,2069,5390,8857,4359,2219,18859,13618,5241,13618,8397,5221,2021-01-01,zipcode,Pensacola
ZCTA5 32508,12,5423,53063,1424,-666666666,5004,315,1168,6,218,433,423,88,659,555,104,555,0,555,2021-01-01,zipcode,Pensacola
ZCTA5 32509,12,566,-666666666,-666666666,-666666666,566,566,566,113,189,225,0,39,0,0,0,0,0,0,2021-01-01,zipcode,Pensacola
ZCTA5 32511,12,1292,-666666666,-666666666,-666666666,1292,36,186,0,27,105,54,0,0,0,0,0,0,0,2021-01-01,zipcode,Pensacola
ZCTA5 32514,12,42059,57018,1143,170600,33900,12208,27703,2129,7090,9484,5703,3297,19013,17435,1578,17435,8239,9196,2021-01-01,zipcode,Pensacola
ZCTA5 32526,12,39318,64543,1162,162800,32019,13285,28101,2143,8225,10936,4748,2049,16388,15004,1384,15004,11933,3071,2021-01-01,zipcode,Pensacola
ZCTA5 32530,12,92,-666666666,-666666666,-666666666,54,30,54,0,0,54,0,0,20,20,0,20,20,0,2021-01-01,zipcode,Bagdad
ZCTA5 32531,12,6452,72668,869,218300,5095,2059,4830,274,1946,1566,577,467,3143,2748,395,2748,2349,399,2021-01-01,zipcode,Baker
ZCTA5 32533,12,29568,80973,932,201300,23704,9166,20765,1605,5669,7827,3585,2079,11584,10783,801,10783,9156,1627,2021-01-01,zipcode,Cantonment
ZCTA5 32534,12,15931,53828,1132,139900,13081,4529,11479,722,3499,4802,1787,669,7329,6778,551,6778,4224,2554,2021-01-01,zipcode,Pensacola
ZCTA5 32535,12,5689,37076,627,74100,5032,3286,4363,1001,2032,1042,161,127,2023,1669,354,1669,1148,521,2021-01-01,zipcode,Century
ZCTA5 32536,12,24643,72818,1165,211700,19354,6827,15902,1428,4359,5792,2486,1837,9584,8780,804,8780,5718,3062,2021-01-01,zipcode,Crestview
ZCTA5 32539,12,30924,62129,1108,200800,24253,10219,20239,1927,5792,7863,3181,1476,11588,10637,951,10637,8030,2607,2021-01-01,zipcode,Crestview
ZCTA5 32541,12,20559,84319,1669,397700,17272,5658,15662,911,2710,4838,4941,2262,17665,9104,8561,9104,6007,3097,2021-01-01,zipcode,Destin
ZCTA5 32542,12,4244,57553,1814,-666666666,3214,325,1545,71,208,721,427,118,1105,881,224,881,0,881,2021-01-01,zipcode,Eglin afb
ZCTA5 32544,12,2169,36408,1615,-666666666,1495,174,782,0,111,202,427,42,456,416,40,416,0,416,2021-01-01,zipcode,Hurlburt field
ZCTA5 32547,12,32556,55853,1157,209800,26451,8578,23072,2107,5893,8933,4145,1994,15485,14313,1172,14313,7652,6661,2021-01-01,zipcode,Fort walton beach
ZCTA5 32548,12,22938,55726,1103,225200,18784,6387,16524,1265,4707,5703,3012,1837,13638,9937,3701,9937,5717,4220,2021-01-01,zipcode,Fort walton beach
ZCTA5 32550,12,8648,74683,1546,432800,7776,3858,7094,118,1147,2035,2190,1604,13969,4251,9718,4251,3034,1217,2021-01-01,zipcode,Miramar beach
ZCTA5 32561,12,9610,108205,1684,463800,7818,3503,7188,202,711,2099,2261,1915,6583,4123,2460,4123,3240,883,2021-01-01,zipcode,Gulf breeze
ZCTA5 32563,12,28186,87054,1402,284200,23044,8887,19946,792,4608,6769,5101,2676,11992,10811,1181,10811,8674,2137,2021-01-01,zipcode,Gulf breeze
ZCTA5 32564,12,2577,64118,866,116700,2183,1071,1835,185,480,891,194,85,1071,992,79,992,860,132,2021-01-01,zipcode,Holt
ZCTA5 32565,12,5192,65313,1045,145300,4086,1727,3602,393,1262,1284,541,122,2455,2039,416,2039,1663,376,2021-01-01,zipcode,Jay
ZCTA5 32566,12,42753,90381,1541,270400,32896,11758,28369,1337,6415,11800,5188,3629,17366,15286,2080,15286,12358,2928,2021-01-01,zipcode,Navarre
ZCTA5 32567,12,4554,63289,704,162500,3320,1580,2727,339,859,1228,184,117,1883,1574,309,1574,1251,323,2021-01-01,zipcode,Laurel hill
ZCTA5 32568,12,3269,67125,917,173800,2636,1072,2315,213,694,990,268,150,1322,1214,108,1214,1052,162,2021-01-01,zipcode,Mc david
ZCTA5 32569,12,12184,61201,1092,234500,10380,3240,9209,629,2238,2886,2419,1037,5336,4828,508,4828,3467,1361,2021-01-01,zipcode,Mary esther
ZCTA5 32570,12,33099,66310,1147,182600,27482,11140,23764,1938,7494,8591,4137,1604,15005,13445,1560,13445,9019,4426,2021-01-01,zipcode,Milton
ZCTA5 32571,12,37727,73760,1075,213100,29314,12304,25141,1810,6891,8827,5120,2493,14374,13461,913,13461,11188,2273,2021-01-01,zipcode,Milton
ZCTA5 32577,12,4453,62980,880,165800,3643,1441,3115,242,904,1093,697,179,2096,1855,241,1855,1593,262,2021-01-01,zipcode,Molino
ZCTA5 32578,12,34015,93706,1440,324500,26548,9800,23228,652,4919,7594,5307,4756,14189,12862,1327,12862,9498,3364,2021-01-01,zipcode,Niceville
ZCTA5 32579,12,10452,88722,1422,329100,8581,3226,7591,403,1491,1915,1998,1784,4923,4452,471,4452,3105,1347,2021-01-01,zipcode,Shalimar
ZCTA5 32580,12,3860,73211,1177,285900,2978,874,2634,159,550,1152,572,201,1834,1535,299,1535,968,567,2021-01-01,zipcode,Valparaiso
ZCTA5 32583,12,30379,72348,1023,177200,25967,12988,23383,3552,7898,7554,2737,1642,10478,9570,908,9570,7642,1928,2021-01-01,zipcode,Milton
ZCTA5 32601,12,21460,29422,943,203400,19561,7800,9630,356,1498,2436,2861,2479,10208,8603,1605,8603,2173,6430,2021-01-01,zipcode,Gainesville
ZCTA5 32603,12,5625,18380,953,227700,5499,3126,1192,60,83,222,324,503,2369,1740,629,1740,185,1555,2021-01-01,zipcode,Gainesville
ZCTA5 32605,12,28058,73145,1241,216800,23829,8267,20450,796,2499,4984,6533,5638,12163,11298,865,11298,8259,3039,2021-01-01,zipcode,Gainesville
ZCTA5 32606,12,23682,66777,1356,254100,19504,6845,16653,396,3117,3629,4377,5134,11714,10323,1391,10323,4873,5450,2021-01-01,zipcode,Gainesville
ZCTA5 32607,12,30445,43278,1056,231800,26362,9249,16665,847,2957,4483,4009,4369,15359,12175,3184,12175,4274,7901,2021-01-01,zipcode,Gainesville
ZCTA5 32608,12,51317,53688,1170,276700,43374,15880,30094,1527,3920,7255,7939,9453,24775,20707,4068,20707,8753,11954,2021-01-01,zipcode,Gainesville
ZCTA5 32609,12,19542,40619,937,126000,15928,6502,13711,1973,3747,4632,2076,1283,8456,7463,993,7463,3976,3487,2021-01-01,zipcode,Gainesville
ZCTA5 32612,12,7152,-666666666,-666666666,-666666666,7152,5770,16,0,4,6,2,4,4,4,0,4,0,4,2021-01-01,zipcode,Gainesville
ZCTA5 32615,12,14933,65588,1046,211500,11868,4496,10684,589,2799,3214,2478,1604,6737,5984,753,5984,4634,1350,2021-01-01,zipcode,Alachua
ZCTA5 32616,12,149,-666666666,-666666666,-666666666,138,58,122,54,28,29,11,0,79,79,0,79,18,61,2021-01-01,zipcode,
ZCTA5 32617,12,4090,41953,655,126900,3732,2155,3318,220,1605,799,595,99,1732,1432,300,1432,1253,179,2021-01-01,zipcode,Anthony
ZCTA5 32618,12,8640,55129,735,169500,7234,2777,6212,725,1856,2102,735,794,3514,3229,285,3229,2635,594,2021-01-01,zipcode,Archer
ZCTA5 32619,12,5139,50370,593,106700,4356,1754,3541,501,1570,1133,234,103,2226,2013,213,2013,1735,278,2021-01-01,zipcode,Bell
ZCTA5 32621,12,4703,45870,673,92300,3977,2040,3513,424,1523,1134,360,72,2185,2016,169,2016,1591,425,2021-01-01,zipcode,Bronson
ZCTA5 32622,12,1510,60984,638,167500,1167,439,1033,152,322,303,136,120,628,575,53,575,360,215,2021-01-01,zipcode,Brooker
ZCTA5 32625,12,1527,51447,878,212900,1333,650,1134,84,355,336,161,198,1310,682,628,682,528,154,2021-01-01,zipcode,Cedar key
ZCTA5 32626,12,8950,40037,733,122900,7182,3876,6451,750,3004,1839,623,235,4593,3781,812,3781,2888,893,2021-01-01,zipcode,Chiefland
ZCTA5 32628,12,5262,38787,753,82900,4377,2844,3824,696,1938,835,310,45,1903,1581,322,1581,1264,317,2021-01-01,zipcode,Cross city
ZCTA5 32631,12,366,-666666666,-666666666,139400,333,174,333,0,112,124,97,0,235,183,52,183,183,0,2021-01-01,zipcode,Earleton
ZCTA5 32639,12,248,37056,-666666666,-666666666,194,137,194,20,118,0,31,25,182,127,55,127,114,13,2021-01-01,zipcode,Gulf hammock
ZCTA5 32640,12,10543,49560,917,129200,8759,4644,7990,1398,2888,2455,683,566,5225,4028,1197,4028,3385,643,2021-01-01,zipcode,Hawthorne
ZCTA5 32641,12,17035,38530,907,105700,12888,5872,11194,1719,4169,3340,1401,565,6122,5142,980,5142,2898,2244,2021-01-01,zipcode,Gainesville
ZCTA5 32643,12,12260,67490,939,190400,9271,4084,8062,958,2374,3088,1110,532,4722,4171,551,4171,3523,648,2021-01-01,zipcode,High springs
ZCTA5 32648,12,369,71750,-666666666,171300,254,112,196,40,75,73,8,0,528,103,425,103,103,0,2021-01-01,zipcode,Horseshoe beach
ZCTA5 32653,12,15799,74386,935,208400,12295,4822,11084,424,1965,3376,2705,2614,6747,6383,364,6383,5253,1130,2021-01-01,zipcode,Gainesville
ZCTA5 32656,12,13900,52758,895,154300,11062,5113,9408,1107,3266,3431,1024,580,6279,5103,1176,5103,4145,958,2021-01-01,zipcode,Keystone heights
ZCTA5 32658,12,446,64063,-666666666,68500,404,177,280,43,98,120,19,0,79,73,6,73,58,15,2021-01-01,zipcode,La crosse
ZCTA5 32664,12,290,54663,1109,173600,223,119,223,0,59,68,62,34,175,139,36,139,106,33,2021-01-01,zipcode,Mc intosh
ZCTA5 32666,12,6804,58929,569,164000,5839,2825,5316,368,2007,1690,520,731,3591,2746,845,2746,2493,253,2021-01-01,zipcode,Melrose
ZCTA5 32667,12,4399,66950,953,257900,3853,1900,3383,154,661,1169,603,796,2197,1865,332,1865,1467,398,2021-01-01,zipcode,Micanopy
ZCTA5 32668,12,5694,48438,862,167400,4910,2515,4511,659,2134,1162,380,176,2555,2279,276,2279,2000,279,2021-01-01,zipcode,Morriston
ZCTA5 32669,12,15125,81846,1126,243100,11668,4408,9874,402,2143,3444,2217,1668,5788,5282,506,5282,4583,699,2021-01-01,zipcode,Newberry
ZCTA5 32680,12,10682,44616,483,84000,9045,5110,8119,1540,3796,1862,406,515,5936,4197,1739,4197,3653,544,2021-01-01,zipcode,Old town
ZCTA5 32681,12,255,-666666666,-666666666,-666666666,255,165,255,63,192,0,0,0,114,63,51,63,63,0,2021-01-01,zipcode,Orange lake
ZCTA5 32683,12,281,56128,-666666666,-666666666,184,114,142,28,95,13,6,0,128,99,29,99,54,45,2021-01-01,zipcode,Otter creek
ZCTA5 32686,12,5232,47870,713,255700,4566,2203,4057,573,1225,1481,347,431,2719,2344,375,2344,1529,815,2021-01-01,zipcode,Reddick
ZCTA5 32692,12,40,-666666666,-666666666,-666666666,40,40,40,22,0,0,18,0,588,40,548,40,40,0,2021-01-01,zipcode,Suwannee
ZCTA5 32693,12,10872,46490,768,131100,9188,4767,7608,1081,2897,2642,694,294,4648,3978,670,3978,3213,765,2021-01-01,zipcode,Trenton
ZCTA5 32694,12,1753,38576,635,111500,1476,586,1354,238,610,279,130,97,1206,975,231,975,619,356,2021-01-01,zipcode,Waldo
ZCTA5 32696,12,13955,51477,771,158600,11109,5056,9890,1256,3879,3095,1212,448,5937,5302,635,5302,4200,1102,2021-01-01,zipcode,Williston
ZCTA5 32697,12,147,-666666666,1030,76000,113,37,90,23,24,30,8,5,127,68,59,68,10,58,2021-01-01,zipcode,Worthington springs
ZCTA5 32701,12,24931,60212,1316,202300,21185,6766,18827,1026,3420,7776,4912,1693,12389,11274,1115,11274,5500,5774,2021-01-01,zipcode,Altamonte springs
ZCTA5 32702,12,2576,45000,2742,69800,2249,1294,2022,331,726,569,253,143,1591,1228,363,1228,763,465,2021-01-01,zipcode,Altoona
ZCTA5 32703,12,54551,54744,1279,225400,43098,15814,37429,5556,11207,10883,7204,2579,20826,19247,1579,19247,12765,6482,2021-01-01,zipcode,Apopka
ZCTA5 32707,12,37495,59894,1274,226500,31218,10590,27736,2125,6489,9565,6733,2824,16547,15695,852,15695,10818,4877,2021-01-01,zipcode,Casselberry
ZCTA5 32708,12,48218,79320,1477,279500,40199,13448,35303,1492,5802,10867,11334,5808,20376,19422,954,19422,14498,4924,2021-01-01,zipcode,Winter springs
ZCTA5 32709,12,1310,74250,-666666666,286700,1153,409,1041,119,255,377,243,47,591,546,45,546,479,67,2021-01-01,zipcode,Christmas
ZCTA5 32712,12,49441,91771,1638,301800,39083,13290,34426,3648,8553,10635,7601,3989,17238,15902,1336,15902,12847,3055,2021-01-01,zipcode,Apopka
ZCTA5 32713,12,22154,75415,1290,251900,18885,7934,16886,913,5206,6115,3407,1245,9870,9149,721,9149,8122,1027,2021-01-01,zipcode,Debary
ZCTA5 32714,12,37957,56155,1354,220100,30857,9157,27106,1866,5841,9337,7275,2787,17225,15818,1407,15818,7711,8107,2021-01-01,zipcode,Altamonte springs
ZCTA5 32720,12,33239,61356,1036,225200,27682,11879,23274,2476,7804,7253,3476,2265,13634,12271,1363,12271,8310,3961,2021-01-01,zipcode,Deland
ZCTA5 32724,12,40157,59460,1073,211300,33086,15811,28202,2070,7954,9468,5534,3176,17567,16055,1512,16055,11614,4441,2021-01-01,zipcode,Deland
ZCTA5 32725,12,50336,61502,1262,188900,40320,17343,35319,3698,11743,13019,5046,1813,19237,18035,1202,18035,13921,4114,2021-01-01,zipcode,Deltona
ZCTA5 32726,12,23236,52240,902,174000,18498,6776,16246,1909,6427,5019,2034,857,10667,9424,1243,9424,6110,3314,2021-01-01,zipcode,Eustis
ZCTA5 32730,12,6536,46344,1274,215000,5518,1785,5063,324,1366,2023,984,366,3109,2865,244,2865,1056,1809,2021-01-01,zipcode,Casselberry
ZCTA5 32732,12,5394,99321,1112,368200,4338,1146,3790,78,895,1286,991,540,2156,1817,339,1817,1745,72,2021-01-01,zipcode,Geneva
ZCTA5 32735,12,5050,63714,1510,175300,4286,2170,3921,333,1529,1257,586,216,2547,2169,378,2169,1789,380,2021-01-01,zipcode,Grand island
ZCTA5 32736,12,11748,78074,1187,296300,9473,3162,8356,598,2556,3139,1506,557,4509,4120,389,4120,3690,430,2021-01-01,zipcode,Eustis
ZCTA5 32738,12,47559,64716,1213,183900,37292,13679,31918,2752,12399,12010,3584,1173,16618,15798,820,15798,12456,3342,2021-01-01,zipcode,Deltona
ZCTA5 32744,12,3487,61550,1095,227800,2652,1143,2451,380,772,792,356,151,1382,1197,185,1197,1022,175,2021-01-01,zipcode,Lake helen
ZCTA5 32746,12,45145,95610,1606,331300,37715,12609,33055,1018,5371,9560,10456,6650,19603,18501,1102,18501,11862,6639,2021-01-01,zipcode,Lake mary
ZCTA5 32750,12,25189,75313,1362,271900,20667,6807,18620,1314,4905,5916,4491,1994,10143,9522,621,9522,7009,2513,2021-01-01,zipcode,Longwood
ZCTA5 32751,12,22671,83142,1441,346800,18879,5932,16397,554,2319,4718,5335,3471,10380,9243,1137,9243,5915,3328,2021-01-01,zipcode,Maitland
ZCTA5 32754,12,12159,59525,958,214900,10414,5342,9290,1049,3242,3217,1233,549,5788,4664,1124,4664,4246,418,2021-01-01,zipcode,Mims
ZCTA5 32757,12,29950,65259,1244,257700,24823,11528,22593,1733,6697,6548,4600,3015,13975,12268,1707,12268,8908,3360,2021-01-01,zipcode,Mount dora
ZCTA5 32759,12,2544,50054,1055,189300,2198,1281,2071,210,902,618,222,119,1366,1014,352,1014,843,171,2021-01-01,zipcode,Oak hill
ZCTA5 32763,12,23839,58261,1236,174100,19816,8028,17180,1817,5382,6051,2531,1399,10894,9817,1077,9817,6125,3692,2021-01-01,zipcode,Orange city
ZCTA5 32764,12,2687,73634,998,272300,2409,1135,2076,214,778,664,359,61,1253,1032,221,1032,945,87,2021-01-01,zipcode,Osteen
ZCTA5 32765,12,62675,88156,1667,320600,50258,16547,40188,1268,5957,11612,14146,7205,23017,21830,1187,21830,15894,5936,2021-01-01,zipcode,Oviedo
ZCTA5 32766,12,16523,125451,1860,411400,12738,4120,10701,579,1872,2783,3007,2460,5087,5087,0,5087,4444,643,2021-01-01,zipcode,Oviedo
ZCTA5 32767,12,3156,63641,1025,93400,2748,1145,2455,499,1143,760,34,19,1314,1110,204,1110,966,144,2021-01-01,zipcode,Paisley
ZCTA5 32771,12,57074,65746,1289,261800,45000,15515,38724,3849,9089,12418,8584,4784,22246,20680,1566,20680,13088,7592,2021-01-01,zipcode,Sanford
ZCTA5 32773,12,31903,53391,1269,184100,24959,8550,22311,2269,7941,6777,3865,1459,12557,11807,750,11807,6529,5278,2021-01-01,zipcode,Sanford
ZCTA5 32776,12,12620,77476,1335,299200,10494,3781,9154,424,2358,4395,1021,956,4812,4493,319,4493,3701,792,2021-01-01,zipcode,Sorrento
ZCTA5 32778,12,23210,52076,1048,181500,19841,10663,18094,2134,5000,6208,3365,1387,12375,10458,1917,10458,7904,2554,2021-01-01,zipcode,Tavares
ZCTA5 32779,12,28948,101546,1732,368800,23713,8619,21171,437,3193,5965,6991,4585,11625,11083,542,11083,8925,2158,2021-01-01,zipcode,Longwood
ZCTA5 32780,12,37301,52066,1047,183200,31922,15140,28332,2381,8024,10799,4715,2413,20133,16126,4007,16126,11493,4633,2021-01-01,zipcode,Titusville
ZCTA5 32784,12,10929,61952,788,168800,8853,3963,7836,1208,2701,2691,613,623,5231,4258,973,4258,3202,1056,2021-01-01,zipcode,Umatilla
ZCTA5 32789,12,25801,89875,1407,526300,22191,9131,18898,644,2819,3951,6029,5455,12397,11035,1362,11035,7313,3722,2021-01-01,zipcode,Winter park
ZCTA5 32792,12,51929,59653,1366,274000,43165,14708,35312,2475,6734,11391,8937,5775,23144,20913,2231,20913,10102,10811,2021-01-01,zipcode,Winter park
ZCTA5 32796,12,20953,52660,1047,168500,17765,8828,16028,1478,5994,4988,2238,1330,9835,8419,1416,8419,6840,1579,2021-01-01,zipcode,Titusville
ZCTA5 32798,12,2235,48023,991,116300,2069,1304,2042,157,787,821,185,92,1380,1117,263,1117,1044,73,2021-01-01,zipcode,Zellwood
ZCTA5 32801,12,13589,67954,1407,374600,12694,3673,11833,696,1978,1743,4302,3114,10934,8621,2313,8621,2393,6228,2021-01-01,zipcode,Orlando
ZCTA5 32803,12,22136,87635,1546,324200,19635,4472,18317,672,2847,4483,6463,3852,11658,10420,1238,10420,5610,4810,2021-01-01,zipcode,Orlando
ZCTA5 32804,12,20073,97695,1427,388700,17328,4996,15541,536,2774,3288,4937,4006,9921,8676,1245,8676,5715,2961,2021-01-01,zipcode,Orlando
ZCTA5 32805,12,18547,35179,859,177000,15575,6358,14285,2850,5458,3602,1561,814,9463,6944,2519,6944,2893,4051,2021-01-01,zipcode,Orlando
ZCTA5 32806,12,27050,78816,1269,341300,22247,6057,20287,1011,3872,4922,6327,4155,12458,11120,1338,11120,6947,4173,2021-01-01,zipcode,Orlando
ZCTA5 32807,12,35638,51645,1217,181100,28914,8574,25344,4230,8186,7905,3204,1819,13590,12429,1161,12429,6215,6214,2021-01-01,zipcode,Orlando
ZCTA5 32808,12,64001,42259,1154,164900,47505,15098,38800,8305,13386,12388,3412,1309,20723,19218,1505,19218,7854,11364,2021-01-01,zipcode,Orlando
ZCTA5 32809,12,30744,45840,1111,197200,23955,9296,21131,4458,7267,5100,2891,1415,10761,9259,1502,9259,4772,4487,2021-01-01,zipcode,Orlando
ZCTA5 32810,12,39602,54407,1310,200300,30807,8634,27207,3495,7539,9039,5291,1843,14696,13830,866,13830,7034,6796,2021-01-01,zipcode,Orlando
ZCTA5 32811,12,40402,42028,1233,129900,31710,9598,27166,3337,8119,8738,4901,2071,18312,14154,4158,14154,3830,10324,2021-01-01,zipcode,Orlando
ZCTA5 32812,12,37241,59278,1238,273200,30340,9842,26111,2275,6900,8167,6221,2548,15274,14091,1183,14091,7834,6257,2021-01-01,zipcode,Orlando
ZCTA5 32814,12,9293,109710,1970,588900,7410,1685,6714,20,500,698,2629,2867,4429,3941,488,3941,1602,2339,2021-01-01,zipcode,Orlando
ZCTA5 32817,12,35491,70273,1432,247700,30357,11106,21642,1454,5372,7026,4980,2810,13048,11123,1925,11123,6518,4605,2021-01-01,zipcode,Orlando
ZCTA5 32818,12,62693,51060,1211,206500,47856,13664,39855,7006,12466,12957,5140,2286,18621,17486,1135,17486,9831,7655,2021-01-01,zipcode,Orlando
ZCTA5 32819,12,28765,76218,1590,364100,23571,8527,20475,1446,3866,5844,6182,3137,14666,10034,4632,10034,5978,4056,2021-01-01,zipcode,Orlando
ZCTA5 32820,12,11162,100433,1819,331900,8580,2151,6969,421,1950,1623,1524,1451,3427,3123,304,3123,2692,431,2021-01-01,zipcode,Orlando
ZCTA5 32821,12,20618,58461,1542,234700,17519,4343,14789,545,3062,5249,4452,1481,15272,8437,6835,8437,2823,5614,2021-01-01,zipcode,Orlando
ZCTA5 32822,12,67238,45613,1347,169100,55155,19890,47537,5550,15635,14961,8027,3364,26504,23119,3385,23119,9697,13422,2021-01-01,zipcode,Orlando
ZCTA5 32824,12,53049,68083,1561,263100,41698,12570,36510,4042,11397,11301,6598,3172,18678,14440,4238,14440,10823,3617,2021-01-01,zipcode,Orlando
ZCTA5 32825,12,60846,68524,1450,251900,50496,15405,41532,4213,9648,14812,8365,4494,21704,19278,2426,19278,12883,6395,2021-01-01,zipcode,Orlando
ZCTA5 32826,12,25763,58323,1269,187300,23427,9840,15155,1440,3832,4542,3165,2176,9729,8632,1097,8632,4382,4250,2021-01-01,zipcode,Orlando
ZCTA5 32827,12,16007,104613,2026,397300,12552,4481,10672,309,1679,2864,3139,2681,7009,5401,1608,5401,3284,2117,2021-01-01,zipcode,Orlando
ZCTA5 32828,12,70039,88668,1623,315900,56050,17231,45713,2861,9080,12070,14520,7182,24738,23591,1147,23591,14906,8685,2021-01-01,zipcode,Orlando
ZCTA5 32829,12,19331,78967,1653,260200,15133,4466,13208,1353,2560,4124,3584,1587,7387,6142,1245,6142,4566,1576,2021-01-01,zipcode,Orlando
ZCTA5 32830,12,44,111346,-666666666,95400,43,7,43,0,5,17,18,3,32,22,10,22,22,0,2021-01-01,zipcode,Orlando
ZCTA5 32831,12,2679,41094,-666666666,10000,2679,2644,2437,904,1049,387,61,36,52,35,17,35,28,7,2021-01-01,zipcode,Orlando
ZCTA5 32832,12,27072,97167,1819,344600,20797,5952,18028,759,1961,4986,6686,3636,11646,9545,2101,9545,6355,3190,2021-01-01,zipcode,Orlando
ZCTA5 32833,12,10299,82859,1180,291100,8507,3432,7351,708,1901,2515,1412,815,3680,3271,409,3271,2542,729,2021-01-01,zipcode,Orlando
ZCTA5 32835,12,50115,62777,1454,274400,40462,11225,33400,2554,6946,10601,9075,4224,19141,17730,1411,17730,7641,10089,2021-01-01,zipcode,Orlando
ZCTA5 32836,12,21868,109918,1851,523200,17803,5646,15704,319,2157,4122,5393,3713,9654,7751,1903,7751,4764,2987,2021-01-01,zipcode,Orlando
ZCTA5 32837,12,49669,71114,1637,278000,41077,13492,35392,3561,8119,10614,8292,4806,20610,15618,4992,15618,9264,6354,2021-01-01,zipcode,Orlando
ZCTA5 32839,12,52756,44592,1197,165700,42425,14330,34770,6583,11473,10337,4396,1981,23550,16899,6651,16899,4307,12592,2021-01-01,zipcode,Orlando
ZCTA5 32901,12,25176,41890,1099,174300,22372,11466,18117,1814,4911,6163,3324,1905,12857,10648,2209,10648,5116,5532,2021-01-01,zipcode,Melbourne
ZCTA5 32903,12,14347,88388,1466,387100,11826,5165,10832,356,1637,3356,2910,2573,7422,6233,1189,6233,5224,1009,2021-01-01,zipcode,Indialantic
ZCTA5 32904,12,35079,75801,1474,255200,28446,11553,24231,1363,5690,8095,5636,3447,14793,13444,1349,13444,11024,2420,2021-01-01,zipcode,Melbourne
ZCTA5 32905,12,26073,48299,1174,152000,21413,9380,18880,1639,6180,6027,3450,1584,12431,10685,1746,10685,5935,4750,2021-01-01,zipcode,Palm bay
ZCTA5 32907,12,47209,59364,1339,193000,38995,17152,33652,3861,10923,12579,4166,2123,17356,16193,1163,16193,13762,2431,2021-01-01,zipcode,Palm bay
ZCTA5 32908,12,13351,56373,1260,182500,10599,3505,8864,1222,2253,3655,1135,599,4514,4270,244,4270,3740,530,2021-01-01,zipcode,Palm bay
ZCTA5 32909,12,34156,56811,1179,195700,26673,10091,23090,2321,6731,8761,3470,1807,12794,11530,1264,11530,9534,1996,2021-01-01,zipcode,Palm bay
ZCTA5 32920,12,9979,58396,938,270100,9418,4293,8927,474,2410,2932,2089,1022,8983,5906,3077,5906,3535,2371,2021-01-01,zipcode,Cape canaveral
ZCTA5 32922,12,15108,40359,893,121100,11429,4215,10311,1521,3248,3676,1330,536,8075,6505,1570,6505,3185,3320,2021-01-01,zipcode,Cocoa
ZCTA5 32925,12,1609,66250,1734,-666666666,1236,456,821,54,120,316,188,143,508,484,24,484,0,484,2021-01-01,zipcode,Patrick afb
ZCTA5 32926,12,23193,55687,1070,206600,20478,9351,18706,2403,6164,6229,2585,1325,10531,9333,1198,9333,7461,1872,2021-01-01,zipcode,Cocoa
ZCTA5 32927,12,28618,72276,1107,197400,23488,9348,21023,1961,6197,8240,3091,1534,11799,10224,1575,10224,9048,1176,2021-01-01,zipcode,Cocoa
ZCTA5 32931,12,13469,75126,1327,369500,12416,6359,11688,316,1987,3608,3369,2408,10626,7179,3447,7179,5111,2068,2021-01-01,zipcode,Cocoa beach
ZCTA5 32934,12,18901,91600,1452,301400,16556,8228,14340,942,3274,4563,3418,2143,7693,7309,384,7309,6544,765,2021-01-01,zipcode,Melbourne
ZCTA5 32935,12,41744,56749,1147,182400,34597,12605,31120,2368,9372,11501,5454,2425,19619,17254,2365,17254,10385,6869,2021-01-01,zipcode,Melbourne
ZCTA5 32937,12,27557,77359,1483,328400,22508,10149,20123,561,3513,6552,5181,4316,13110,11227,1883,11227,8861,2366,2021-01-01,zipcode,Satellite beach
ZCTA5 32940,12,45050,86347,1718,335400,36867,16980,33446,1049,5398,10084,8781,8134,20155,18599,1556,18599,15538,3061,2021-01-01,zipcode,Melbourne
ZCTA5 32948,12,6079,38221,873,152400,4618,1515,3852,1221,1285,883,427,36,2050,1735,315,1735,1203,532,2021-01-01,zipcode,Fellsmere
ZCTA5 32949,12,2616,94792,-666666666,382300,2374,1262,2175,182,774,545,406,268,1158,962,196,962,923,39,2021-01-01,zipcode,Grant
ZCTA5 32950,12,4565,72969,1269,334800,4037,1849,3583,150,1139,1207,820,267,1862,1821,41,1821,1645,176,2021-01-01,zipcode,Malabar
ZCTA5 32951,12,11814,75094,1421,393500,10629,6362,10172,406,1522,3175,3189,1880,7717,5826,1891,5826,4878,948,2021-01-01,zipcode,Melbourne beach
ZCTA5 32952,12,20515,85120,1084,334400,17487,7552,15476,600,3256,4802,4065,2753,10043,8228,1815,8228,6970,1258,2021-01-01,zipcode,Merritt island
ZCTA5 32953,12,23853,75188,1077,321000,20091,8671,17878,1026,4210,6143,4063,2436,11414,9322,2092,9322,7166,2156,2021-01-01,zipcode,Merritt island
ZCTA5 32955,12,38892,76701,1380,262500,32519,12155,28999,1706,7360,9501,6151,4281,18605,15437,3168,15437,12067,3370,2021-01-01,zipcode,Rockledge
ZCTA5 32958,12,28339,59700,1185,217600,25251,13174,23590,1467,7863,7153,4113,2994,14659,12440,2219,12440,10221,2219,2021-01-01,zipcode,Sebastian
ZCTA5 32960,12,23085,45111,985,192900,19251,7804,16703,1473,4897,5896,3067,1370,11639,9367,2272,9367,5641,3726,2021-01-01,zipcode,Vero beach
ZCTA5 32962,12,25958,55884,1058,168100,21844,10240,19243,2879,5158,7152,2971,1083,12691,9314,3377,9314,7832,1482,2021-01-01,zipcode,Vero beach
ZCTA5 32963,12,15182,126650,1543,678100,14416,9665,14016,161,1501,2714,5068,4572,12302,7594,4708,7594,7155,439,2021-01-01,zipcode,Vero beach
ZCTA5 32966,12,18916,57851,1193,204800,16487,9648,15677,719,4691,5559,2879,1829,11484,8651,2833,8651,6683,1968,2021-01-01,zipcode,Vero beach
ZCTA5 32967,12,24405,63047,1039,292900,20274,10841,18004,2307,5349,5420,2641,2287,11412,8791,2621,8791,6695,2096,2021-01-01,zipcode,Vero beach
ZCTA5 32968,12,15825,82326,1714,299300,13584,5764,11318,633,3011,3762,2597,1315,6273,5440,833,5440,4978,462,2021-01-01,zipcode,Vero beach
ZCTA5 32970,12,213,-666666666,-666666666,-666666666,213,146,213,15,171,27,0,0,45,45,0,45,18,27,2021-01-01,zipcode,Wabasso
ZCTA5 32976,12,8759,43918,983,119000,8537,5965,8390,445,3002,3494,964,485,6925,5048,1877,5048,4842,206,2021-01-01,zipcode,Sebastian
ZCTA5 33001,12,341,46397,1981,-666666666,331,200,331,19,200,50,51,11,730,179,551,179,121,58,2021-01-01,zipcode,Long key
ZCTA5 33004,12,15876,43138,1379,251100,13091,4573,12001,1220,3266,4004,2380,1131,8827,7003,1824,7003,3025,3978,2021-01-01,zipcode,Dania
ZCTA5 33009,12,43547,41580,1352,225700,36739,14426,33264,4365,9346,8078,6680,4795,30991,20180,10811,20180,10741,9439,2021-01-01,zipcode,Hallandale
ZCTA5 33010,12,42246,36703,1142,286900,36583,15240,32525,11082,10830,4920,4039,1654,16235,15483,752,15483,4630,10853,2021-01-01,zipcode,Hialeah
ZCTA5 33012,12,70485,36594,1311,277500,60671,26445,54028,16233,17145,11808,6235,2607,25681,24959,722,24959,12205,12754,2021-01-01,zipcode,Hialeah
ZCTA5 33013,12,30706,49197,1273,307100,26765,10156,23262,6259,8862,4387,2650,1104,9823,9481,342,9481,5723,3758,2021-01-01,zipcode,Hialeah
ZCTA5 33014,12,41021,57213,1434,336100,34011,11281,29968,5259,8223,8508,4894,3084,14911,14311,600,14311,6158,8153,2021-01-01,zipcode,Hialeah
ZCTA5 33015,12,69023,61784,1597,306700,56106,16884,47791,6672,13286,14515,9130,4188,23923,23078,845,23078,11746,11332,2021-01-01,zipcode,Hialeah
ZCTA5 33016,12,46498,50418,1464,233500,38533,13935,33120,6166,11020,7663,5883,2388,16026,15606,420,15606,7995,7611,2021-01-01,zipcode,Hialeah
ZCTA5 33018,12,55079,76986,1777,330800,45319,13202,39474,6335,12259,10322,7210,3348,17192,16681,511,16681,12295,4386,2021-01-01,zipcode,Hialeah
ZCTA5 33019,12,13613,80510,1647,490500,12062,5275,10743,568,1279,2887,2963,3046,12467,6371,6096,6371,4790,1581,2021-01-01,zipcode,Hollywood
ZCTA5 33020,12,45416,48372,1243,242300,37976,10417,33070,4929,9538,9508,5656,3439,22290,19434,2856,19434,6372,13062,2021-01-01,zipcode,Hollywood
ZCTA5 33021,12,49788,62314,1470,319400,40009,13291,34813,3580,8418,10789,6839,5187,21515,18969,2546,18969,12176,6793,2021-01-01,zipcode,Hollywood
ZCTA5 33023,12,71463,58020,1381,263200,55985,16939,48000,7513,16422,16219,5266,2580,22198,20812,1386,20812,13648,7164,2021-01-01,zipcode,Hollywood
ZCTA5 33024,12,74017,64467,1472,286300,58096,17543,49706,4954,15969,16760,8598,3425,26056,24329,1727,24329,15640,8689,2021-01-01,zipcode,Hollywood
ZCTA5 33025,12,71690,59970,1542,268400,58142,17142,51356,2787,21398,14964,7138,5069,29409,26946,2463,26946,12103,14843,2021-01-01,zipcode,Hollywood
ZCTA5 33026,12,31671,82645,1693,297200,26114,9034,23393,1788,5503,7355,5529,3218,12558,12071,487,12071,9672,2399,2021-01-01,zipcode,Hollywood
ZCTA5 33027,12,63068,62606,1459,330400,53081,21309,47422,3076,13563,12084,11337,7362,25725,24219,1506,24219,19076,5143,2021-01-01,zipcode,Hollywood
ZCTA5 33028,12,27530,107412,2158,426700,21646,5530,18330,910,3514,4226,5730,3950,9177,8730,447,8730,6613,2117,2021-01-01,zipcode,Pembroke pines
ZCTA5 33029,12,45177,125817,2318,443000,35409,9914,29556,1297,7261,8319,7893,4786,13805,13150,655,13150,11903,1247,2021-01-01,zipcode,Hollywood
ZCTA5 33030,12,37225,36687,1157,270900,25930,9654,21463,8817,6223,3820,1970,633,10949,10199,750,10199,3800,6399,2021-01-01,zipcode,Homestead
ZCTA5 33031,12,9190,98088,1137,408200,7394,3017,6275,547,2390,1948,732,658,2755,2690,65,2690,2417,273,2021-01-01,zipcode,Homestead
ZCTA5 33032,12,54545,64109,1411,279500,41027,12488,34470,6360,9365,9870,6560,2315,16761,16043,718,16043,9401,6642,2021-01-01,zipcode,Homestead
ZCTA5 33033,12,67265,57779,1468,274000,48975,16135,40334,8701,10237,11447,6805,3144,19676,19036,640,19036,10562,8474,2021-01-01,zipcode,Homestead
ZCTA5 33034,12,23044,42771,1166,158700,15601,8024,12958,4749,3782,3320,817,290,6022,5448,574,5448,1801,3647,2021-01-01,zipcode,Homestead
ZCTA5 33035,12,16127,60053,1704,205200,12144,3089,10256,1078,2395,3788,2038,957,5828,5287,541,5287,2585,2702,2021-01-01,zipcode,Homestead
ZCTA5 33036,12,3810,77123,1622,801000,3360,1492,3161,103,872,892,734,560,3651,1792,1859,1792,1428,364,2021-01-01,zipcode,Islamorada
ZCTA5 33037,12,12090,67236,1702,562000,10553,4634,9831,710,2574,2784,2151,1612,10165,5159,5006,5159,3986,1173,2021-01-01,zipcode,Key largo
ZCTA5 33039,12,0,-666666666,-666666666,-666666666,0,0,0,0,0,0,0,0,0,0,0,0,0,0,2021-01-01,zipcode,Homestead
ZCTA5 33040,12,37404,73884,1880,679100,32002,9332,28574,2525,8170,7779,6220,3880,18696,14608,4088,14608,6885,7723,2021-01-01,zipcode,Key west
ZCTA5 33042,12,7054,95365,2249,591300,6233,2390,5729,181,1320,1838,1450,940,4818,2908,1910,2908,2274,634,2021-01-01,zipcode,Summerland key
ZCTA5 33043,12,4801,71364,1728,406400,4065,1781,3721,306,982,1367,691,375,2729,1896,833,1896,1498,398,2021-01-01,zipcode,Big pine key
ZCTA5 33050,12,10423,65014,1391,619800,8972,3009,8065,887,2346,2346,1560,926,7308,4299,3009,4299,2362,1937,2021-01-01,zipcode,Marathon
ZCTA5 33051,12,744,94485,1491,574800,735,442,726,23,170,215,227,91,1287,410,877,410,281,129,2021-01-01,zipcode,Key colony beach
ZCTA5 33054,12,32390,36911,1103,216100,25911,11687,21558,6298,8242,5182,1389,447,10598,10164,434,10164,4740,5424,2021-01-01,zipcode,Opa locka
ZCTA5 33055,12,38817,51577,1368,265400,31753,13777,27871,6919,10944,5947,2910,1151,11939,11464,475,11464,8897,2567,2021-01-01,zipcode,Opa locka
ZCTA5 33056,12,37579,52538,1428,245900,29604,11980,25310,4379,9380,7203,2634,1714,11582,10925,657,10925,7176,3749,2021-01-01,zipcode,Miami gardens
ZCTA5 33060,12,37826,51374,1218,273100,30796,11399,26886,5495,7935,7465,3866,2125,15795,13959,1836,13959,7074,6885,2021-01-01,zipcode,Pompano beach
ZCTA5 33062,12,23763,72329,1584,404500,22375,10623,21257,1163,4561,5789,5335,4409,22026,13274,8752,13274,9118,4156,2021-01-01,zipcode,Pompano beach
ZCTA5 33063,12,54907,53594,1470,223300,47959,16418,43687,4529,14867,12858,8124,3309,27923,24961,2962,24961,17789,7172,2021-01-01,zipcode,Pompano beach
ZCTA5 33064,12,60586,57565,1469,231300,49384,15015,44394,7780,13310,10935,8247,4122,26040,22668,3372,22668,14100,8568,2021-01-01,zipcode,Pompano beach
ZCTA5 33065,12,60590,63184,1548,317100,45938,13568,38826,3288,10954,12818,8351,3415,20943,19546,1397,19546,9810,9736,2021-01-01,zipcode,Coral springs
ZCTA5 33066,12,16163,49568,1490,154400,14112,6464,13201,1025,3368,4249,2647,1912,10420,8453,1967,8453,7067,1386,2021-01-01,zipcode,Pompano beach
ZCTA5 33067,12,25649,115397,1754,479000,20202,5878,17602,610,2709,5025,5235,4023,8843,8380,463,8380,6149,2231,2021-01-01,zipcode,Pompano beach
ZCTA5 33068,12,52541,50463,1645,215100,41958,11597,34956,4964,13215,10340,4233,2204,19901,18539,1362,18539,10720,7819,2021-01-01,zipcode,Pompano beach
ZCTA5 33069,12,29089,52715,1417,191000,23667,10589,21155,2655,6067,5833,4110,2490,15505,11115,4390,11115,5079,6036,2021-01-01,zipcode,Pompano beach
ZCTA5 33070,12,5559,65933,1688,605000,4888,1904,4296,359,1256,1177,871,633,4301,2378,1923,2378,1765,613,2021-01-01,zipcode,Tavernier
ZCTA5 33071,12,39182,91934,1739,424300,30964,8747,26131,1060,5468,8412,7266,3925,13973,13401,572,13401,9051,4350,2021-01-01,zipcode,Coral springs
ZCTA5 33073,12,34243,87591,1889,356200,26747,7791,22250,1548,5460,7135,5990,2117,12543,11655,888,11655,6538,5117,2021-01-01,zipcode,Pompano beach
ZCTA5 33076,12,42044,148680,2587,566100,30584,10782,25859,582,4783,4715,7974,7805,13641,12833,808,12833,11176,1657,2021-01-01,zipcode,Pompano beach
ZCTA5 33101,12,0,-666666666,-666666666,-666666666,0,0,0,0,0,0,0,0,0,0,0,0,0,0,2021-01-01,zipcode,Miami
ZCTA5 33109,12,568,250001,-666666666,2000001,493,319,493,0,30,54,129,280,772,258,514,258,242,16,2021-01-01,zipcode,Miami beach
ZCTA5 33122,12,1771,78232,2184,1089800,1369,427,1126,194,94,194,367,277,933,724,209,724,79,645,2021-01-01,zipcode,Miami
ZCTA5 33125,12,55161,33172,1175,289200,47689,20379,42259,13454,13750,6977,5568,2510,22200,20956,1244,20956,5388,15568,2021-01-01,zipcode,Miami
ZCTA5 33126,12,48130,45660,1428,261000,41536,14600,37273,7810,10913,8409,7378,2763,19307,18017,1290,18017,6597,11420,2021-01-01,zipcode,Miami
ZCTA5 33127,12,29097,34102,1161,298300,23087,10130,19984,5998,6716,4413,1831,1026,11449,9891,1558,9891,2939,6952,2021-01-01,zipcode,Miami
ZCTA5 33128,12,8665,25984,1045,266300,7081,2597,6429,2459,2120,972,693,185,3985,3577,408,3577,117,3460,2021-01-01,zipcode,Miami
ZCTA5 33129,12,14390,78316,1977,456000,12765,3833,11482,472,1759,1750,4422,3079,8330,6906,1424,6906,3112,3794,2021-01-01,zipcode,Miami
ZCTA5 33130,12,31835,50305,1399,370900,28799,8789,25719,4839,6121,4598,5741,4420,19345,16124,3221,16124,1695,14429,2021-01-01,zipcode,Miami
ZCTA5 33131,12,22529,107171,2324,488900,19869,3486,18296,268,1236,2954,6875,6963,18297,12296,6001,12296,3804,8492,2021-01-01,zipcode,Miami
ZCTA5 33132,12,15834,90160,2217,504300,14933,3916,13454,916,1335,2971,4207,4025,10592,8126,2466,8126,2132,5994,2021-01-01,zipcode,Miami
ZCTA5 33133,12,34434,76560,1655,718200,27662,8588,25753,1624,4605,4834,8214,6476,16936,14203,2733,14203,7314,6889,2021-01-01,zipcode,Miami
ZCTA5 33134,12,39082,79544,1598,549800,32370,11400,29038,2502,5099,5602,8307,7528,18610,16171,2439,16171,8964,7207,2021-01-01,zipcode,Miami
ZCTA5 33135,12,35115,32460,1133,324400,29998,11559,26831,7766,8592,5353,3528,1592,15508,14245,1263,14245,3110,11135,2021-01-01,zipcode,Miami
ZCTA5 33136,12,16190,30036,1078,289200,13664,5148,12243,3385,3540,3006,1497,815,7494,6634,860,6634,731,5903,2021-01-01,zipcode,Miami
ZCTA5 33137,12,22768,66225,1922,407000,19670,5082,17732,1854,3017,3971,5204,3686,13257,10405,2852,10405,2592,7813,2021-01-01,zipcode,Miami
ZCTA5 33138,12,30029,57063,1243,510900,24537,8007,21387,2673,4353,4987,4908,4466,14392,12766,1626,12766,6227,6539,2021-01-01,zipcode,Miami
ZCTA5 33139,12,35393,56548,1600,393100,31433,9478,28583,2970,4649,6136,8291,6537,30329,19898,10431,19898,5933,13965,2021-01-01,zipcode,Miami beach
ZCTA5 33140,12,20672,90812,1797,689800,16454,5655,15094,1225,1617,3243,4568,4441,16718,8709,8009,8709,4839,3870,2021-01-01,zipcode,Miami beach
ZCTA5 33141,12,35855,55306,1471,337600,31136,8672,28261,2753,6172,7757,7005,4574,21544,16538,5006,16538,5566,10972,2021-01-01,zipcode,Miami beach
ZCTA5 33142,12,57733,30915,1066,242200,45623,18771,39275,13468,12948,7851,3572,1436,21774,20091,1683,20091,5500,14591,2021-01-01,zipcode,Miami
ZCTA5 33143,12,31012,74254,1585,624000,25624,9360,22542,1216,3644,4851,7109,5722,14140,12669,1471,12669,7191,5478,2021-01-01,zipcode,Miami
ZCTA5 33144,12,28606,55647,1456,340400,24820,9450,22480,3611,7098,5696,4384,1691,10073,9535,538,9535,5242,4293,2021-01-01,zipcode,Miami
ZCTA5 33145,12,28944,62806,1597,429200,24875,9060,22359,3625,4415,5427,5282,3610,12682,11459,1223,11459,5752,5707,2021-01-01,zipcode,Miami
ZCTA5 33146,12,16507,116312,2338,982400,14351,7019,8203,160,522,1406,2519,3596,6083,5160,923,5160,3533,1627,2021-01-01,zipcode,Miami
ZCTA5 33147,12,46363,39861,1119,192900,36415,15990,31575,7575,11866,7586,3150,1398,15998,14747,1251,14747,6957,7790,2021-01-01,zipcode,Miami
ZCTA5 33149,12,14611,167438,2697,1238000,10703,4351,9001,329,722,1357,3438,3155,7516,4601,2915,4601,3185,1416,2021-01-01,zipcode,Key biscayne
ZCTA5 33150,12,33116,33770,1000,275800,24436,9972,21095,5344,6981,5690,2078,1002,12219,11030,1189,11030,3151,7879,2021-01-01,zipcode,Miami
ZCTA5 33154,12,14636,75350,1895,649400,10781,3914,9738,204,1934,2106,2757,2737,10294,5687,4607,5687,3431,2256,2021-01-01,zipcode,Miami beach
ZCTA5 33155,12,44440,71646,1701,411900,37453,13221,33718,4231,8209,8745,8348,4185,15720,14866,854,14866,10052,4814,2021-01-01,zipcode,Miami
ZCTA5 33156,12,33111,123991,1809,846000,25911,9159,22518,877,2841,4308,6920,7572,13193,11749,1444,11749,8462,3287,2021-01-01,zipcode,Miami
ZCTA5 33157,12,69212,71824,1318,363100,55155,19354,47393,5972,13591,12133,10374,5323,21923,20554,1369,20554,13612,6942,2021-01-01,zipcode,Miami
ZCTA5 33158,12,6351,163565,2375,715300,4895,2080,4153,36,393,549,1494,1681,2266,2017,249,2017,1915,102,2021-01-01,zipcode,Miami
ZCTA5 33160,12,42053,53393,1724,271100,35805,15523,32745,2203,5570,9962,8748,6262,36480,20050,16430,20050,11792,8258,2021-01-01,zipcode,North miami beach
ZCTA5 33161,12,54241,44779,1254,293100,42652,15006,36673,7534,13123,8776,5003,2237,18887,17264,1623,17264,7279,9985,2021-01-01,zipcode,Miami
ZCTA5 33162,12,47698,50751,1296,255500,36733,12609,31661,6275,10030,8482,4999,1875,16003,14605,1398,14605,7709,6896,2021-01-01,zipcode,Miami
ZCTA5 33165,12,53198,67982,1587,374000,46257,17814,40428,7406,11991,9947,7463,3621,17683,17042,641,17042,12329,4713,2021-01-01,zipcode,Miami
ZCTA5 33166,12,25177,65902,1431,419600,21418,7380,18909,3050,3701,4485,4271,3402,10217,9418,799,9418,4880,4538,2021-01-01,zipcode,Miami
ZCTA5 33167,12,22081,51581,1164,240400,17550,7083,14371,3496,5215,3434,1563,663,6846,6537,309,6537,3901,2636,2021-01-01,zipcode,Miami
ZCTA5 33168,12,23938,52192,1346,245600,19725,7671,16981,4189,6513,3963,1629,687,7068,6687,381,6687,5020,1667,2021-01-01,zipcode,Miami
ZCTA5 33169,12,41417,50611,1331,265900,31948,11289,27495,4089,9111,8295,4244,1756,14073,12858,1215,12858,6932,5926,2021-01-01,zipcode,Miami
ZCTA5 33170,12,13788,52463,1277,311500,11031,4127,9476,2415,2791,2122,1353,795,4575,4201,374,4201,2471,1730,2021-01-01,zipcode,Miami
ZCTA5 33172,12,40897,53740,1702,194000,34707,11260,30922,7268,7228,6968,6078,3380,16091,14604,1487,14604,6709,7895,2021-01-01,zipcode,Miami
ZCTA5 33173,12,33089,77108,1794,352900,27617,10038,24509,1910,4765,7720,6473,3641,12252,11644,608,11644,8012,3632,2021-01-01,zipcode,Miami
ZCTA5 33174,12,34114,51959,1530,293500,30033,12310,24399,7361,5866,4523,4499,2150,11426,11170,256,11170,5748,5422,2021-01-01,zipcode,Miami
ZCTA5 33175,12,51693,66052,1708,358200,45323,17023,40442,7654,11546,9483,7775,3984,17494,17019,475,17019,12823,4196,2021-01-01,zipcode,Miami
ZCTA5 33176,12,52932,73960,1465,460600,43815,15520,38187,3380,8028,11278,9764,5737,19869,18635,1234,18635,11907,6728,2021-01-01,zipcode,Miami
ZCTA5 33177,12,57167,66492,1784,309300,47445,19042,40878,6534,14498,10935,6061,2850,16517,16052,465,16052,11957,4095,2021-01-01,zipcode,Miami
ZCTA5 33178,12,64366,79532,2277,414500,49703,17521,42108,5197,5297,9560,11978,10076,22185,19069,3116,19069,9169,9900,2021-01-01,zipcode,Miami
ZCTA5 33179,12,46858,52902,1460,193000,38699,12844,33522,3343,9256,10382,5993,4548,20183,17863,2320,17863,10156,7707,2021-01-01,zipcode,Miami
ZCTA5 33180,12,32925,79449,2063,391400,27310,10804,24659,1200,3022,7006,7694,5737,22583,14528,8055,14528,9559,4969,2021-01-01,zipcode,Miami
ZCTA5 33181,12,20180,46726,1355,266000,16674,5406,13822,1437,3944,3732,2771,1938,9393,8164,1229,8164,3350,4814,2021-01-01,zipcode,Miami
ZCTA5 33182,12,13060,81585,2147,369400,11131,4111,9596,1245,2213,2248,2946,944,4237,4106,131,4106,3369,737,2021-01-01,zipcode,Miami
ZCTA5 33183,12,34662,61806,1649,299300,29673,11321,25128,3580,7130,6856,5224,2338,12802,12472,330,12472,7926,4546,2021-01-01,zipcode,Miami
ZCTA5 33184,12,21528,65536,1698,303700,18743,6635,16266,4637,3895,2621,3653,1460,6808,6455,353,6455,4592,1863,2021-01-01,zipcode,Miami
ZCTA5 33185,12,29599,93002,2328,396000,23729,8730,20468,2648,4570,5309,5081,2860,8989,8799,190,8799,7200,1599,2021-01-01,zipcode,Miami
ZCTA5 33186,12,67686,75699,1865,337800,54830,19965,47382,3762,11852,15394,10535,5839,23693,22617,1076,22617,15414,7203,2021-01-01,zipcode,Miami
ZCTA5 33187,12,18781,97524,2124,394000,15331,5245,13360,1766,3331,3790,3467,1006,5771,5523,248,5523,4849,674,2021-01-01,zipcode,Miami
ZCTA5 33189,12,24120,54286,1342,306900,18907,6584,16685,2955,5323,4169,2907,1331,8663,8156,507,8156,4564,3592,2021-01-01,zipcode,Miami
ZCTA5 33190,12,17230,66546,1523,295000,13001,3859,11126,1485,2499,4047,2448,647,5250,5118,132,5118,2472,2646,2021-01-01,zipcode,Miami
ZCTA5 33193,12,47571,67418,1612,321800,40517,14109,34319,7315,8713,7370,8103,2818,15987,15548,439,15548,9491,6057,2021-01-01,zipcode,Miami
ZCTA5 33194,12,9388,119740,2317,402300,7926,3682,6998,1046,1486,1818,1855,793,2093,2093,0,2093,1608,485,2021-01-01,zipcode,Miami
ZCTA5 33196,12,55287,82422,1920,375400,44265,15529,37511,3657,8684,10929,9820,4421,17104,16601,503,16601,11335,5266,2021-01-01,zipcode,Miami
ZCTA5 33301,12,16261,104436,2061,587100,15287,4746,14007,492,1714,3410,4979,3412,12636,9170,3466,9170,3644,5526,2021-01-01,zipcode,Fort lauderdale
ZCTA5 33304,12,18085,69343,1411,465500,16132,5177,14862,1178,2452,3584,5022,2626,12683,9530,3153,9530,3642,5888,2021-01-01,zipcode,Fort lauderdale
ZCTA5 33305,12,12634,85800,1467,453400,11359,3779,10856,480,1707,2565,3473,2631,8065,6640,1425,6640,4505,2135,2021-01-01,zipcode,Fort lauderdale
ZCTA5 33306,12,3111,66367,1197,445900,2926,932,2846,69,474,812,844,647,2285,1843,442,1843,1349,494,2021-01-01,zipcode,Fort lauderdale
ZCTA5 33308,12,28428,73390,1622,438000,25681,11303,24106,1005,4309,5956,7217,5619,23703,15638,8065,15638,10975,4663,2021-01-01,zipcode,Fort lauderdale
ZCTA5 33309,12,40100,61898,1495,235400,32191,8420,27698,3717,9449,7569,4376,2587,15101,14066,1035,14066,8246,5820,2021-01-01,zipcode,Fort lauderdale
ZCTA5 33311,12,73388,43007,1172,215500,55208,22541,45851,9853,15508,12970,5013,2507,27714,24737,2977,24737,11141,13596,2021-01-01,zipcode,Fort lauderdale
ZCTA5 33312,12,53855,63240,1427,299000,43077,15073,37248,5245,9978,10911,6699,4415,21379,18490,2889,18490,11267,7223,2021-01-01,zipcode,Fort lauderdale
ZCTA5 33313,12,63715,42177,1312,175900,48462,17221,40400,6288,15985,12030,4281,1816,25213,21780,3433,21780,9381,12399,2021-01-01,zipcode,Fort lauderdale
ZCTA5 33314,12,28730,55317,1689,228900,23198,7383,18940,2949,5264,4984,3888,1855,11483,10435,1048,10435,3889,6546,2021-01-01,zipcode,Fort lauderdale
ZCTA5 33315,12,13178,81501,1426,356700,11410,3534,10583,708,3551,2585,2193,1546,6991,5895,1096,5895,3510,2385,2021-01-01,zipcode,Fort lauderdale
ZCTA5 33316,12,11194,82973,1557,660200,9878,3533,9246,407,1239,2426,3160,2014,8498,5552,2946,5552,3168,2384,2021-01-01,zipcode,Fort lauderdale
ZCTA5 33317,12,37161,75767,1556,350400,29773,9443,26518,3019,7176,7152,5844,3327,13550,12762,788,12762,9621,3141,2021-01-01,zipcode,Fort lauderdale
ZCTA5 33319,12,50703,49770,1387,173600,41497,14198,36732,4739,11365,11151,6015,3462,25170,20733,4437,20733,13417,7316,2021-01-01,zipcode,Fort lauderdale
ZCTA5 33321,12,50513,54428,1632,199900,43287,18191,38664,4189,10537,13150,6771,4017,23867,21625,2242,21625,15877,5748,2021-01-01,zipcode,Fort lauderdale
ZCTA5 33322,12,40244,55281,1790,201400,34815,14161,32573,2972,8292,10748,6946,3615,21244,18399,2845,18399,15467,2932,2021-01-01,zipcode,Fort lauderdale
ZCTA5 33323,12,23099,100478,2139,362700,19321,5133,16658,1107,2842,5266,5034,2409,9104,8319,785,8319,5754,2565,2021-01-01,zipcode,Fort lauderdale
ZCTA5 33324,12,49343,73772,1830,267700,40226,12898,35455,2151,6326,10836,9837,6305,22019,19516,2503,19516,11296,8220,2021-01-01,zipcode,Fort lauderdale
ZCTA5 33325,12,31410,85607,1770,331600,25035,6692,21199,1884,4990,6489,5158,2678,11155,10364,791,10364,7839,2525,2021-01-01,zipcode,Fort lauderdale
ZCTA5 33326,12,31687,99828,2023,423600,24602,8328,21368,706,2929,5552,6821,5360,12967,10655,2312,10655,7642,3013,2021-01-01,zipcode,Fort lauderdale
ZCTA5 33327,12,23593,147103,2735,592000,16644,5967,14022,254,1721,2348,5025,4674,6617,6557,60,6557,5182,1375,2021-01-01,zipcode,Fort lauderdale
ZCTA5 33328,12,28373,108569,1752,417100,23074,6907,19210,1055,3745,5480,5685,3245,10562,9940,622,9940,8009,1931,2021-01-01,zipcode,Fort lauderdale
ZCTA5 33330,12,14450,126782,2541,567400,11377,3827,9736,706,1491,2392,2489,2658,4848,4614,234,4614,4359,255,2021-01-01,zipcode,Fort lauderdale
ZCTA5 33331,12,25150,128421,2416,538400,20121,7273,16701,798,1874,4417,5885,3727,7740,7454,286,7454,6278,1176,2021-01-01,zipcode,Fort lauderdale
ZCTA5 33332,12,11484,144625,2738,643900,9101,3413,7524,304,728,1538,2348,2606,3519,3393,126,3393,2973,420,2021-01-01,zipcode,Fort lauderdale
ZCTA5 33334,12,29497,61013,1332,348200,24774,7067,22007,2424,5866,5995,4455,3267,14033,12730,1303,12730,7351,5379,2021-01-01,zipcode,Fort lauderdale
ZCTA5 33351,12,34699,63941,1670,261000,27604,7429,24656,2146,6415,8164,5476,2455,13527,12589,938,12589,7229,5360,2021-01-01,zipcode,Fort lauderdale
ZCTA5 33401,12,31144,49554,1480,297700,26675,9954,21892,2724,4474,5955,5140,3599,17766,13578,4188,13578,4704,8874,2021-01-01,zipcode,West palm beach
ZCTA5 33403,12,14139,59516,1261,248000,11340,3739,9750,1365,3108,2831,1469,977,5798,4922,876,4922,2181,2741,2021-01-01,zipcode,West palm beach
ZCTA5 33404,12,30431,49433,1245,216200,24215,9498,20937,2875,7121,5827,3258,1856,16262,11356,4906,11356,6016,5340,2021-01-01,zipcode,West palm beach
ZCTA5 33405,12,21138,68079,1192,305700,17565,5772,15762,3075,3430,4448,2813,1996,9245,8368,877,8368,4898,3470,2021-01-01,zipcode,West palm beach
ZCTA5 33406,12,26006,65035,1397,241500,21568,7609,17582,3319,5879,4591,2663,1130,9181,8451,730,8451,5683,2768,2021-01-01,zipcode,West palm beach
ZCTA5 33407,12,32422,46638,1313,214200,26536,9638,23166,4470,6536,6305,3758,2097,14657,12174,2483,12174,5748,6426,2021-01-01,zipcode,West palm beach
ZCTA5 33408,12,18522,82162,1585,394000,16908,8251,15771,502,3029,4106,5109,3025,13349,9535,3814,9535,7517,2018,2021-01-01,zipcode,North palm beach
ZCTA5 33409,12,33146,55687,1401,210000,26436,7816,21462,3980,5462,5843,4322,1855,13369,11569,1800,11569,5080,6489,2021-01-01,zipcode,West palm beach
ZCTA5 33410,12,35711,85747,1786,371200,30128,11039,27151,1294,5599,7829,8064,4365,17555,15085,2470,15085,10629,4456,2021-01-01,zipcode,Palm beach gardens
ZCTA5 33411,12,74923,77190,1621,306800,60742,21933,53279,5463,12462,15736,11851,7767,29662,27024,2638,27024,20452,6572,2021-01-01,zipcode,West palm beach
ZCTA5 33412,12,15234,107822,1764,423200,13062,5239,11805,528,2939,3349,3071,1918,6489,5551,938,5551,4699,852,2021-01-01,zipcode,West palm beach
ZCTA5 33413,12,16910,65276,1726,293500,12781,3763,10784,1506,2815,3658,1654,1151,5901,5421,480,5421,3634,1787,2021-01-01,zipcode,West palm beach
ZCTA5 33414,12,58505,95941,1923,413400,45225,14634,38948,2536,7173,12334,10225,6680,22262,19306,2956,19306,14587,4719,2021-01-01,zipcode,Wellington
ZCTA5 33415,12,51913,47815,1330,169100,41407,14397,35173,7494,11995,9548,4441,1695,20321,18184,2137,18184,10640,7544,2021-01-01,zipcode,West palm beach
ZCTA5 33417,12,35443,43599,1279,114200,29824,11592,27060,4465,7872,7659,5109,1955,20280,16050,4230,16050,9014,7036,2021-01-01,zipcode,West palm beach
ZCTA5 33418,12,42372,110482,1970,449900,35803,15862,32943,1135,4756,8746,10117,8189,21731,18010,3721,18010,14028,3982,2021-01-01,zipcode,Palm beach gardens
ZCTA5 33426,12,23591,66186,1696,234500,20687,6768,18384,1592,5382,6041,3544,1825,11464,9992,1472,9992,6134,3858,2021-01-01,zipcode,Boynton beach
ZCTA5 33428,12,44551,71594,1815,332300,35353,12256,30942,2809,7291,8583,7817,4442,17259,15775,1484,15775,10922,4853,2021-01-01,zipcode,Boca raton
ZCTA5 33430,12,20628,34178,684,116800,15197,6680,12978,4831,4349,2546,967,285,7509,6524,985,6524,2289,4235,2021-01-01,zipcode,Belle glade
ZCTA5 33431,12,21554,93636,1942,434800,17795,7898,13299,895,1824,3070,4450,3060,9099,7546,1553,7546,5406,2140,2021-01-01,zipcode,Boca raton
ZCTA5 33432,12,20263,81566,1830,680500,18299,7564,16333,671,2106,4190,5657,3709,14797,10287,4510,10287,6166,4121,2021-01-01,zipcode,Boca raton
ZCTA5 33433,12,42684,65716,1958,326600,35606,16648,32163,1115,6464,7826,9443,7315,23320,19372,3948,19372,13796,5576,2021-01-01,zipcode,Boca raton
ZCTA5 33434,12,21017,63472,1336,259900,18657,11292,17791,1088,2928,4059,5100,4616,13499,10331,3168,10331,8110,2221,2021-01-01,zipcode,Boca raton
ZCTA5 33435,12,36644,57925,1611,230600,30849,11481,27273,3768,7889,8069,5301,2246,19286,14236,5050,14236,8551,5685,2021-01-01,zipcode,Boynton beach
ZCTA5 33436,12,47089,64205,1669,266200,38954,14677,34996,3154,8809,10771,7825,4437,23204,19144,4060,19144,14071,5073,2021-01-01,zipcode,Boynton beach
ZCTA5 33437,12,37997,66272,1647,315000,34973,21074,32473,1250,7015,9537,7834,6837,21636,18053,3583,18053,15676,2377,2021-01-01,zipcode,Boynton beach
ZCTA5 33438,12,431,95188,-666666666,88600,405,158,355,51,180,68,29,27,234,153,81,153,116,37,2021-01-01,zipcode,Canal point
ZCTA5 33440,12,20438,41351,829,101200,16195,6274,13569,4081,4549,3775,947,217,8155,6985,1170,6985,4878,2107,2021-01-01,zipcode,Clewiston
ZCTA5 33441,12,29347,48132,1292,295500,24780,8682,21735,3327,6273,6921,3451,1763,15411,12682,2729,12682,6548,6134,2021-01-01,zipcode,Deerfield beach
ZCTA5 33442,12,31680,48571,1721,157200,27209,12231,25409,2042,6594,8342,5712,2719,21310,15358,5952,15358,10250,5108,2021-01-01,zipcode,Deerfield beach
ZCTA5 33444,12,23842,60706,1424,342800,19875,6161,17601,2866,4721,4963,3241,1810,10099,8984,1115,8984,4694,4290,2021-01-01,zipcode,Delray beach
ZCTA5 33445,12,30309,58948,1733,235600,26374,10878,24291,1869,5802,6493,6600,3527,17395,13796,3599,13796,9690,4106,2021-01-01,zipcode,Delray beach
ZCTA5 33446,12,26791,64217,1373,310600,24290,15990,23395,829,4730,6520,6004,5312,17696,13680,4016,13680,12113,1567,2021-01-01,zipcode,Delray beach
ZCTA5 33449,12,9799,142056,2811,491800,7878,3322,6644,244,1256,1717,1704,1723,3649,3265,384,3265,3103,162,2021-01-01,zipcode,Lake worth
ZCTA5 33455,12,21068,63351,1106,295000,18237,9506,17131,1122,4829,5360,3864,1956,11721,9399,2322,9399,8007,1392,2021-01-01,zipcode,Hobe sound
ZCTA5 33458,12,56174,89515,1799,416100,44968,13986,39138,2758,6881,10333,11777,7389,22759,20913,1846,20913,15471,5442,2021-01-01,zipcode,Jupiter
ZCTA5 33460,12,36346,51272,1229,255000,28191,9448,23847,6741,5863,6156,2960,2127,14002,12328,1674,12328,5358,6970,2021-01-01,zipcode,Lake worth
ZCTA5 33461,12,47633,52621,1333,193300,37956,11684,32611,8101,10465,7870,3774,2401,18212,15771,2441,15771,7644,8127,2021-01-01,zipcode,Lake worth
ZCTA5 33462,12,32371,59868,1400,251700,27674,8997,24723,3712,7274,7262,4247,2228,15652,12727,2925,12727,7847,4880,2021-01-01,zipcode,Lake worth
ZCTA5 33463,12,65754,59791,1469,244900,51323,15746,43557,8198,12628,12157,7076,3498,22817,20371,2446,20371,14336,6035,2021-01-01,zipcode,Lake worth
ZCTA5 33467,12,54790,75617,1452,326400,46019,19990,40951,2997,10026,11955,10168,5805,24669,21173,3496,21173,18510,2663,2021-01-01,zipcode,Lake worth
ZCTA5 33469,12,14754,90920,1785,430600,12675,6559,11741,302,2299,3443,3609,2088,8598,6711,1887,6711,5884,827,2021-01-01,zipcode,Jupiter
ZCTA5 33470,12,28800,97741,2207,383700,23816,8038,20383,2322,5670,7457,3308,1626,9639,8961,678,8961,8116,845,2021-01-01,zipcode,Loxahatchee
ZCTA5 33471,12,6571,36912,675,79400,5796,4030,5316,1807,1760,994,512,243,3368,2380,988,2380,1815,565,2021-01-01,zipcode,Moore haven
ZCTA5 33472,12,19422,78828,1988,322200,17102,9277,15747,807,3496,5028,3503,2913,8871,8020,851,8020,7558,462,2021-01-01,zipcode,Boynton beach
ZCTA5 33473,12,11454,131484,3205,594400,8834,4328,8002,105,874,2191,1745,3087,4735,4116,619,4116,3958,158,2021-01-01,zipcode,Boynton beach
ZCTA5 33476,12,7001,22079,674,97700,5343,2690,4329,1409,1401,924,526,69,2319,2083,236,2083,731,1352,2021-01-01,zipcode,Pahokee
ZCTA5 33477,12,11712,99865,1978,473400,11165,6792,10747,278,1663,2656,3553,2597,11015,6532,4483,6532,5694,838,2021-01-01,zipcode,Jupiter
ZCTA5 33478,12,15064,130041,2518,470200,12204,4104,11136,459,2243,3428,3304,1702,5587,5132,455,5132,4984,148,2021-01-01,zipcode,Jupiter
ZCTA5 33480,12,11050,144300,1720,1008600,10487,6984,10360,208,984,2428,3380,3360,12325,6436,5889,6436,5361,1075,2021-01-01,zipcode,Palm beach
ZCTA5 33483,12,12795,106108,2088,625000,11883,5236,11124,550,1412,2540,3904,2718,9620,6584,3036,6584,4510,2074,2021-01-01,zipcode,Delray beach
ZCTA5 33484,12,26457,47056,1420,167900,24678,15069,23554,1418,6163,7294,4852,3827,18998,14639,4359,14639,11709,2930,2021-01-01,zipcode,Delray beach
ZCTA5 33486,12,22515,94338,1925,505800,17891,6407,15428,547,2644,4249,5224,2764,9967,8816,1151,8816,6464,2352,2021-01-01,zipcode,Boca raton
ZCTA5 33487,12,21691,80034,1912,442200,18754,8587,16909,533,2040,4221,5911,4204,13457,9859,3598,9859,7196,2663,2021-01-01,zipcode,Boca raton
ZCTA5 33493,12,6298,50125,988,99500,5646,4334,5187,2223,1834,782,266,82,969,860,109,860,488,372,2021-01-01,zipcode,South bay
ZCTA5 33496,12,23144,97855,2274,384900,19806,10345,18114,700,2448,3808,6611,4547,11962,10121,1841,10121,8507,1614,2021-01-01,zipcode,Boca raton
ZCTA5 33498,12,16769,110440,2484,446200,13310,5281,11755,849,1528,2804,3705,2869,6034,5742,292,5742,5158,584,2021-01-01,zipcode,Boca raton
ZCTA5 33503,12,269,-666666666,-666666666,332100,269,56,135,49,27,44,15,0,77,77,0,77,57,20,2021-01-01,zipcode,Balm
ZCTA5 33510,12,29629,62579,1184,213500,24417,8886,21322,1728,7162,6810,4275,1347,11965,11312,653,11312,6859,4453,2021-01-01,zipcode,Brandon
ZCTA5 33511,12,59118,63863,1398,237600,47808,17150,41380,3603,10023,13231,10531,3992,24098,22233,1865,22233,11906,10327,2021-01-01,zipcode,Brandon
ZCTA5 33513,12,12781,47535,927,156500,10577,6673,9208,1668,3709,2747,650,434,5222,4138,1084,4138,3237,901,2021-01-01,zipcode,Bushnell
ZCTA5 33514,12,2391,56198,856,119100,1832,782,1640,401,715,339,107,78,835,761,74,761,461,300,2021-01-01,zipcode,Center hill
ZCTA5 33521,12,596,50114,838,108600,481,218,412,77,205,109,15,6,322,206,116,206,147,59,2021-01-01,zipcode,Coleman
ZCTA5 33523,12,18684,53775,836,179200,15477,6203,12908,2223,5011,3059,1633,982,7794,6552,1242,6552,4748,1804,2021-01-01,zipcode,Dade city
ZCTA5 33525,12,17940,60452,872,184600,14627,7147,12903,1452,4438,3769,2261,983,8046,6860,1186,6860,5010,1850,2021-01-01,zipcode,Dade city
ZCTA5 33527,12,16814,62641,802,256200,13717,5543,11594,2419,4065,2866,1480,764,5777,5359,418,5359,4004,1355,2021-01-01,zipcode,Dover
ZCTA5 33534,12,17859,73443,1147,214400,12428,3661,10572,1875,3557,3134,1378,628,5985,5520,465,5520,3810,1710,2021-01-01,zipcode,Gibsonton
ZCTA5 33538,12,4983,40199,690,121400,4236,2174,3861,674,1514,1040,430,203,3019,2305,714,2305,1789,516,2021-01-01,zipcode,Lake panasoffkee
ZCTA5 33540,12,10223,43569,858,97200,9007,5197,8060,1031,3210,2724,774,321,5476,4539,937,4539,3665,874,2021-01-01,zipcode,Zephyrhills
ZCTA5 33541,12,22459,44324,1117,82500,19393,12366,17994,2579,6391,6165,1950,909,13715,9991,3724,9991,8254,1737,2021-01-01,zipcode,Zephyrhills
ZCTA5 33542,12,23134,40765,933,94400,19693,11567,17639,2191,6756,6134,1702,856,13458,10393,3065,10393,7268,3125,2021-01-01,zipcode,Zephyrhills
ZCTA5 33543,12,32610,93289,1686,256300,25159,8577,21695,1200,3738,6476,5878,4403,12350,11371,979,11371,9592,1779,2021-01-01,zipcode,Wesley chapel
ZCTA5 33544,12,28270,91647,1727,286800,21442,6300,18451,1796,3752,5270,4538,3095,9967,9437,530,9437,6553,2884,2021-01-01,zipcode,Wesley chapel
ZCTA5 33545,12,23118,90118,1711,248300,18028,4846,15232,744,3061,5758,3548,2121,7678,7199,479,7199,5717,1482,2021-01-01,zipcode,Wesley chapel
ZCTA5 33547,12,29236,107883,1927,360800,20799,6909,18041,542,4002,5030,5034,3433,9759,9100,659,9100,7340,1760,2021-01-01,zipcode,Lithia
ZCTA5 33548,12,7385,123060,1558,405400,5874,1874,5148,137,884,1268,1616,1243,2766,2688,78,2688,2340,348,2021-01-01,zipcode,Lutz
ZCTA5 33549,12,18677,72618,1348,249600,15713,6047,13976,766,3320,4542,3004,2344,7732,7376,356,7376,5801,1575,2021-01-01,zipcode,Lutz
ZCTA5 33556,12,27729,128333,1419,445700,21606,7577,19148,560,3045,5009,6263,4271,10444,9714,730,9714,8497,1217,2021-01-01,zipcode,Odessa
ZCTA5 33558,12,27309,92650,1202,372000,21236,7212,18393,479,3514,4365,5671,4364,10548,9958,590,9958,7295,2663,2021-01-01,zipcode,Lutz
ZCTA5 33559,12,17355,76075,1341,236700,14356,4260,11082,901,3173,2984,2473,1551,6651,6335,316,6335,4002,2333,2021-01-01,zipcode,Lutz
ZCTA5 33563,12,27097,48675,1015,147600,21220,7321,18025,4029,5820,5162,2223,791,10867,9940,927,9940,5638,4302,2021-01-01,zipcode,Plant city
ZCTA5 33565,12,17394,53434,977,189700,13416,5703,12139,2110,4045,3686,1555,743,6696,6086,610,6086,4915,1171,2021-01-01,zipcode,Plant city
ZCTA5 33566,12,22415,65550,1177,232600,17624,6223,15161,2035,5750,3731,2419,1226,8059,7752,307,7752,5423,2329,2021-01-01,zipcode,Plant city
ZCTA5 33567,12,11821,83763,1108,230100,9607,2964,8275,1771,2831,1724,1378,571,4057,3769,288,3769,3091,678,2021-01-01,zipcode,Plant city
ZCTA5 33569,12,25960,83073,1690,251700,20472,6705,18119,1368,4730,5752,4090,2179,10049,9421,628,9421,7742,1679,2021-01-01,zipcode,Riverview
ZCTA5 33570,12,30088,61112,1044,189300,23199,8697,19880,2685,6535,6536,2617,1507,12549,10296,2253,10296,7465,2831,2021-01-01,zipcode,Ruskin
ZCTA5 33572,12,22771,101828,1738,311900,18193,6149,16491,513,3262,5292,4471,2953,9423,8767,656,8767,7376,1391,2021-01-01,zipcode,Apollo beach
ZCTA5 33573,12,26042,55912,1697,200400,24247,17637,23510,1197,6693,7523,4988,3109,15736,13640,2096,13640,11133,2507,2021-01-01,zipcode,Sun city center
ZCTA5 33576,12,4698,68750,895,231400,4371,2750,4134,147,1066,1529,816,576,2563,2317,246,2317,2122,195,2021-01-01,zipcode,San antonio
ZCTA5 33578,12,54136,64993,1455,226200,42664,11917,37143,2328,9927,12506,8319,4063,24060,22071,1989,22071,12443,9628,2021-01-01,zipcode,Riverview
ZCTA5 33579,12,39551,90018,1869,261400,29971,8536,26660,3182,6255,8798,5861,2564,13313,12506,807,12506,9413,3093,2021-01-01,zipcode,Riverview
ZCTA5 33584,12,26711,58025,1195,218900,21222,8671,18875,2676,5586,6017,3229,1367,10301,9582,719,9582,7148,2434,2021-01-01,zipcode,Seffner
ZCTA5 33585,12,1350,59400,868,190200,1167,673,1044,226,333,357,75,53,608,484,124,484,380,104,2021-01-01,zipcode,Sumterville
ZCTA5 33592,12,11771,50817,862,160800,9898,4613,8536,1606,3246,1898,1008,778,4712,4055,657,4055,2672,1383,2021-01-01,zipcode,Thonotosassa
ZCTA5 33594,12,36154,80437,1521,222500,29774,9594,25469,2352,7245,7964,5537,2371,13755,13077,678,13077,10174,2903,2021-01-01,zipcode,Valrico
ZCTA5 33596,12,30103,101813,1935,306800,24375,8138,21317,1224,4086,6054,6817,3136,10649,10198,451,10198,8519,1679,2021-01-01,zipcode,Valrico
ZCTA5 33597,12,8414,52319,835,138900,7172,3033,6047,979,2428,1960,605,75,3888,3187,701,3187,2600,587,2021-01-01,zipcode,Webster
ZCTA5 33598,12,26115,77790,965,266400,19303,8694,16549,3660,5050,3870,2246,1723,8353,7705,648,7705,6485,1220,2021-01-01,zipcode,Wimauma
ZCTA5 33602,12,16044,82755,1778,407100,14168,3871,12961,1053,1894,2490,4237,3287,10344,8892,1452,8892,3072,5820,2021-01-01,zipcode,Tampa
ZCTA5 33603,12,20245,54650,1100,249500,16456,4408,14642,1505,3813,3920,3421,1983,9494,8560,934,8560,5050,3510,2021-01-01,zipcode,Tampa
ZCTA5 33604,12,38743,46617,1061,199800,31335,10427,27619,4081,9221,7874,4425,2018,16771,15302,1469,15302,8620,6682,2021-01-01,zipcode,Tampa
ZCTA5 33605,12,16139,28219,972,165800,13032,5519,11427,2781,4061,2835,1222,528,8557,7140,1417,7140,2502,4638,2021-01-01,zipcode,Tampa
ZCTA5 33606,12,21281,100386,1617,669500,18557,6130,13137,214,1161,1960,5845,3957,10058,8693,1365,8693,3752,4941,2021-01-01,zipcode,Tampa
ZCTA5 33607,12,24171,50241,1511,217000,20898,7071,18553,3255,5252,4002,3840,2204,12485,10694,1791,10694,4462,6232,2021-01-01,zipcode,Tampa
ZCTA5 33609,12,18117,88794,1434,419600,15152,4464,13466,1022,1544,2670,4545,3685,9085,8330,755,8330,5121,3209,2021-01-01,zipcode,Tampa
ZCTA5 33610,12,47068,40085,1107,153800,34397,13388,29109,5568,10460,8272,3110,1699,18098,16775,1323,16775,7749,9026,2021-01-01,zipcode,Tampa
ZCTA5 33611,12,34295,68602,1291,324300,28107,8914,25967,1320,5136,6086,7986,5439,17580,16136,1444,16136,8914,7222,2021-01-01,zipcode,Tampa
ZCTA5 33612,12,49352,38023,1047,177900,38394,15489,31611,6807,10847,7967,4458,1532,20643,18746,1897,18746,6640,12106,2021-01-01,zipcode,Tampa
ZCTA5 33613,12,36941,38085,1000,187900,31672,11292,21393,3172,6032,5855,4077,2257,17860,15808,2052,15808,4700,11108,2021-01-01,zipcode,Tampa
ZCTA5 33614,12,47591,46740,1111,213200,40252,12325,35051,7349,12154,7935,5675,1938,19547,18410,1137,18410,7364,11046,2021-01-01,zipcode,Tampa
ZCTA5 33615,12,47969,56352,1320,225200,39145,10661,35015,3937,12344,9252,6615,2867,20242,18494,1748,18494,9917,8577,2021-01-01,zipcode,Tampa
ZCTA5 33616,12,14531,74245,1402,273700,11837,3112,10452,540,2652,2823,2470,1967,6651,6086,565,6086,3097,2989,2021-01-01,zipcode,Tampa
ZCTA5 33617,12,47472,41961,1099,212600,39113,13258,30479,4138,8741,8879,5544,3177,20854,19168,1686,19168,7675,11493,2021-01-01,zipcode,Tampa
ZCTA5 33618,12,27396,69313,1172,312900,23062,7885,20756,813,4621,5880,5976,3466,12656,11957,699,11957,7932,4025,2021-01-01,zipcode,Tampa
ZCTA5 33619,12,41225,50967,1319,151100,31965,12526,27005,4588,9491,7416,3398,2112,15102,14074,1028,14074,7323,6751,2021-01-01,zipcode,Tampa
ZCTA5 33620,12,4743,-666666666,-666666666,-666666666,4743,3496,43,10,0,33,0,0,22,10,12,10,0,10,2021-01-01,zipcode,Tampa
ZCTA5 33621,12,2599,82188,2349,-666666666,1716,508,1050,0,240,308,236,266,611,536,75,536,0,536,2021-01-01,zipcode,Tampa
ZCTA5 33624,12,40904,73107,1405,265500,33252,9979,29506,1887,6777,8271,8246,4325,16100,15533,567,15533,10104,5429,2021-01-01,zipcode,Tampa
ZCTA5 33625,12,28577,76694,1599,280600,23856,8028,20788,1372,5185,6240,5062,2929,11746,11133,613,11133,7519,3614,2021-01-01,zipcode,Tampa
ZCTA5 33626,12,29944,114449,1719,381200,23554,7421,20735,890,2804,4408,7933,4700,12188,11518,670,11518,8022,3496,2021-01-01,zipcode,Tampa
ZCTA5 33629,12,26175,139158,1415,629800,19670,6322,17746,431,1291,2894,6777,6353,11059,10163,896,10163,7971,2192,2021-01-01,zipcode,Tampa
ZCTA5 33634,12,23662,62334,1405,219100,19063,6251,16142,1836,4754,4524,3606,1422,8307,7839,468,7839,4418,3421,2021-01-01,zipcode,Tampa
ZCTA5 33635,12,20075,74867,1433,231000,16283,4958,14578,913,3676,4157,4009,1823,8466,7624,842,7624,4624,3000,2021-01-01,zipcode,Tampa
ZCTA5 33637,12,18522,52280,1209,171400,14597,4520,12359,1412,2758,3775,2844,1570,7833,7236,597,7236,3190,4046,2021-01-01,zipcode,Tampa
ZCTA5 33647,12,71767,96843,1545,330100,55173,16198,47521,1938,6785,10983,15685,12130,26694,25206,1488,25206,14554,10652,2021-01-01,zipcode,Tampa
ZCTA5 33701,12,16802,54192,1227,413300,15358,5889,14017,572,2248,3777,4266,3154,13113,9405,3708,9405,3627,5778,2021-01-01,zipcode,Saint petersburg
ZCTA5 33702,12,32150,57512,1139,213900,27263,10150,24386,2145,6340,7371,5942,2588,16399,14241,2158,14241,9350,4891,2021-01-01,zipcode,Saint petersburg
ZCTA5 33703,12,26709,90641,1304,310100,22052,7420,20087,694,3263,5805,5723,4602,12335,11132,1203,11132,8868,2264,2021-01-01,zipcode,Saint petersburg
ZCTA5 33704,12,16059,89120,1165,468400,13877,4177,12875,307,2023,3131,4289,3125,8905,7689,1216,7689,5374,2315,2021-01-01,zipcode,Saint petersburg
ZCTA5 33705,12,26749,62672,1223,222100,22803,8420,20210,1710,5266,6277,4666,2291,15031,11145,3886,11145,6656,4489,2021-01-01,zipcode,Saint petersburg
ZCTA5 33706,12,15478,88219,1308,478700,14717,7481,13992,496,2330,4340,4316,2510,13764,8273,5491,8273,6284,1989,2021-01-01,zipcode,Saint petersburg
ZCTA5 33707,12,25260,56393,1217,262900,23325,11894,21783,1244,5325,7262,4959,2993,16645,12659,3986,12659,8597,4062,2021-01-01,zipcode,Saint petersburg
ZCTA5 33708,12,14826,66959,1571,363300,13813,7297,13013,523,2892,4308,3134,2156,13596,7747,5849,7747,5793,1954,2021-01-01,zipcode,Saint petersburg
ZCTA5 33709,12,23264,46290,1140,150900,20375,9153,18519,2279,6892,5606,2633,1109,14037,10493,3544,10493,7936,2557,2021-01-01,zipcode,Saint petersburg
ZCTA5 33710,12,34462,65195,1315,227200,28921,10293,26007,1828,7394,7553,6668,2564,16487,14176,2311,14176,11411,2765,2021-01-01,zipcode,Saint petersburg
ZCTA5 33711,12,18409,60488,1313,200300,15217,6889,12007,549,4256,3750,2191,1261,9046,6180,2866,6180,4109,2071,2021-01-01,zipcode,Saint petersburg
ZCTA5 33712,12,24495,52507,1183,213100,19629,7615,16698,1330,4965,5440,3447,1516,12692,9340,3352,9340,5301,4039,2021-01-01,zipcode,Saint petersburg
ZCTA5 33713,12,32572,62088,1132,201400,27447,8746,25063,2742,6500,7914,5667,2240,15722,14053,1669,14053,9714,4339,2021-01-01,zipcode,Saint petersburg
ZCTA5 33714,12,20163,41239,1113,125300,16865,7042,15055,2278,5880,4302,2032,563,9959,8172,1787,8172,5177,2995,2021-01-01,zipcode,Saint petersburg
ZCTA5 33715,12,7653,96250,2316,390600,6768,3891,6500,88,838,2006,1631,1937,7041,3672,3369,3672,3289,383,2021-01-01,zipcode,Saint petersburg
ZCTA5 33716,12,18396,63434,1446,138700,16171,3136,13910,628,2239,5031,4020,1992,11115,9557,1558,9557,1879,7678,2021-01-01,zipcode,Saint petersburg
ZCTA5 33744,12,73,-666666666,-666666666,-666666666,73,73,61,20,41,0,0,0,0,0,0,0,0,0,2021-01-01,zipcode,Bay pines
ZCTA5 33755,12,27437,47013,1068,214000,22260,8256,19775,2743,6395,5995,2993,1649,11823,10529,1294,10529,5969,4560,2021-01-01,zipcode,Clearwater
ZCTA5 33756,12,32899,49911,1077,232300,27495,11584,24813,2837,7642,7068,4900,2366,15581,13378,2203,13378,7887,5491,2021-01-01,zipcode,Clearwater
ZCTA5 33759,12,17370,57259,1500,211800,14537,6192,12925,1136,3187,4032,2856,1714,8814,7746,1068,7746,4154,3592,2021-01-01,zipcode,Clearwater
ZCTA5 33760,12,21304,51224,1176,159200,18506,7682,15756,2477,4962,4925,2309,1083,8641,7524,1117,7524,3374,4150,2021-01-01,zipcode,Clearwater
ZCTA5 33761,12,19308,61001,1373,206200,16608,8119,15551,957,3788,4964,3560,2282,9954,8881,1073,8881,6897,1984,2021-01-01,zipcode,Clearwater
ZCTA5 33762,12,5402,71268,1459,248900,4769,1463,4504,98,834,1301,1450,821,3179,2655,524,2655,2069,586,2021-01-01,zipcode,Clearwater
ZCTA5 33763,12,20657,45589,1233,154300,17851,9128,16502,1507,5139,5274,2799,1783,11464,9755,1709,9755,7059,2696,2021-01-01,zipcode,Clearwater
ZCTA5 33764,12,27600,56530,1351,236300,23761,9243,21247,1307,6410,6775,4399,2356,14902,12091,2811,12091,8280,3811,2021-01-01,zipcode,Clearwater
ZCTA5 33765,12,15257,53892,1264,222700,13130,4665,11824,1664,3461,3468,2149,1082,7028,6526,502,6526,3555,2971,2021-01-01,zipcode,Clearwater
ZCTA5 33767,12,7615,94167,1778,557200,7224,4497,6881,231,1350,1645,2030,1625,8923,4120,4803,4120,3358,762,2021-01-01,zipcode,Clearwater beach
ZCTA5 33770,12,25880,51968,1160,189800,22562,9068,19385,2041,6068,6310,2986,1980,13312,11275,2037,11275,6895,4380,2021-01-01,zipcode,Largo
ZCTA5 33771,12,28174,51138,1186,92300,24315,10892,22186,1968,7374,7575,3930,1339,16772,12788,3984,12788,7713,5075,2021-01-01,zipcode,Largo
ZCTA5 33772,12,23559,65775,1247,243600,20109,8342,18024,1451,4776,6101,4127,1569,11953,9904,2049,9904,7235,2669,2021-01-01,zipcode,Seminole
ZCTA5 33773,12,17135,64017,1287,212600,14835,5062,13340,1345,3487,4417,3188,903,8265,7043,1222,7043,5387,1656,2021-01-01,zipcode,Largo
ZCTA5 33774,12,19691,64717,1236,243000,16165,6787,14799,1006,3898,5979,2490,1426,10445,8330,2115,8330,6438,1892,2021-01-01,zipcode,Largo
ZCTA5 33776,12,13181,86951,1822,343800,10984,4705,9825,300,2331,2601,2937,1656,5506,5004,502,5004,4555,449,2021-01-01,zipcode,Seminole
ZCTA5 33777,12,17214,78330,1501,218300,14535,5284,13112,699,3485,4129,3101,1698,8299,7057,1242,7057,5972,1085,2021-01-01,zipcode,Seminole
ZCTA5 33778,12,15912,57697,1161,206600,13212,5366,12053,1028,3434,4491,1804,1296,7865,6219,1646,6219,5130,1089,2021-01-01,zipcode,Largo
ZCTA5 33781,12,26887,47210,959,175200,22582,8666,20224,3805,6046,6081,3088,1204,12252,10384,1868,10384,6507,3877,2021-01-01,zipcode,Pinellas park
ZCTA5 33782,12,22457,58548,1375,186700,19041,8218,17351,1909,5205,5679,3051,1507,10579,9249,1330,9249,6868,2381,2021-01-01,zipcode,Pinellas park
ZCTA5 33785,12,4873,85391,1371,496900,4556,1989,4180,115,632,1335,1291,807,5856,2477,3379,2477,1879,598,2021-01-01,zipcode,Indian rocks beach
ZCTA5 33786,12,1607,106250,2353,769000,1438,738,1366,65,150,347,472,332,1162,718,444,718,647,71,2021-01-01,zipcode,Belleair beach
ZCTA5 33801,12,32411,41008,930,98200,26012,12689,20360,3417,8188,5969,1771,1015,15078,11630,3448,11630,5786,5844,2021-01-01,zipcode,Lakeland
ZCTA5 33803,12,29942,58437,1149,179700,24544,10038,21157,1642,6123,6117,4328,2947,14737,11878,2859,11878,7328,4550,2021-01-01,zipcode,Lakeland
ZCTA5 33805,12,25229,41818,1050,122000,20115,9291,17643,3340,6822,4780,1838,863,11003,9473,1530,9473,4408,5065,2021-01-01,zipcode,Lakeland
ZCTA5 33809,12,30368,58037,1226,186100,24974,10312,21744,2085,6923,7367,3475,1894,12510,11272,1238,11272,7321,3951,2021-01-01,zipcode,Lakeland
ZCTA5 33810,12,51505,60228,1233,180300,42065,17765,36504,4542,12823,12850,4278,2011,21356,18926,2430,18926,14258,4668,2021-01-01,zipcode,Lakeland
ZCTA5 33811,12,24186,75483,1138,218700,19445,7037,16758,1532,4694,5340,3845,1347,9586,8554,1032,8554,6612,1942,2021-01-01,zipcode,Lakeland
ZCTA5 33812,12,14241,87885,1366,228200,11413,3798,9465,531,2899,2961,1702,1372,5399,4556,843,4556,3525,1031,2021-01-01,zipcode,Lakeland
ZCTA5 33813,12,38103,89774,1430,262100,29247,10630,25313,1288,6101,8313,6209,3402,14325,13391,934,13391,10401,2990,2021-01-01,zipcode,Lakeland
ZCTA5 33815,12,14965,33422,907,23000,11795,6180,10056,2372,3936,2754,707,287,7543,6004,1539,6004,3384,2620,2021-01-01,zipcode,Lakeland
ZCTA5 33823,12,36098,57879,885,173200,29084,12175,25142,4085,9508,6752,3525,1272,13779,12068,1711,12068,8475,3593,2021-01-01,zipcode,Auburndale
ZCTA5 33825,12,25264,41275,766,113400,21157,11875,18506,3600,6520,5688,1786,912,12098,9905,2193,9905,7206,2699,2021-01-01,zipcode,Avon park
ZCTA5 33827,12,2770,59464,1597,180000,2331,1197,1791,240,649,579,198,125,1257,879,378,879,774,105,2021-01-01,zipcode,Babson park
ZCTA5 33830,12,29151,50298,901,161500,23050,9219,20000,2495,7704,5757,2927,1117,11419,9917,1502,9917,6537,3380,2021-01-01,zipcode,Bartow
ZCTA5 33834,12,6799,41981,797,84500,5481,3290,4605,1087,2198,881,285,154,2092,1652,440,1652,1088,564,2021-01-01,zipcode,Bowling green
ZCTA5 33837,12,34428,63266,1544,226800,27190,11987,24290,2299,7550,7993,4402,2046,15979,11775,4204,11775,9461,2314,2021-01-01,zipcode,Davenport
ZCTA5 33838,12,5070,40737,993,166000,3758,1847,3368,1030,1209,936,143,50,1864,1492,372,1492,1007,485,2021-01-01,zipcode,Dundee
ZCTA5 33839,12,4221,65417,1002,142300,3198,1124,2678,646,841,797,328,66,1571,1260,311,1260,941,319,2021-01-01,zipcode,Eagle lake
ZCTA5 33841,12,8149,39708,800,121800,6643,3403,5664,1012,2528,1402,418,304,3651,2841,810,2841,2160,681,2021-01-01,zipcode,Fort meade
ZCTA5 33843,12,11034,49726,796,76900,9736,6185,8554,1993,3210,2202,598,551,5817,3942,1875,3942,3297,645,2021-01-01,zipcode,Frostproof
ZCTA5 33844,12,43911,51748,1021,156600,35229,15109,29987,5287,10840,9212,3113,1535,19852,14563,5289,14563,10157,4406,2021-01-01,zipcode,Haines city
ZCTA5 33847,12,288,60000,675,112500,236,114,171,16,34,96,18,7,102,102,0,102,78,24,2021-01-01,zipcode,Homeland
ZCTA5 33848,12,1062,61594,905,-666666666,915,417,743,255,340,120,0,28,342,209,133,209,130,79,2021-01-01,zipcode,Intercession city
ZCTA5 33849,12,534,28810,-666666666,148200,481,350,420,110,266,34,0,10,262,168,94,168,126,42,2021-01-01,zipcode,Kathleen
ZCTA5 33850,12,8535,43886,939,165700,7180,3219,6567,946,2784,1753,601,483,4309,3175,1134,3175,2263,912,2021-01-01,zipcode,Lake alfred
ZCTA5 33851,12,805,52109,-666666666,174400,665,377,596,131,219,176,54,16,355,255,100,255,228,27,2021-01-01,zipcode,Lake hamilton
ZCTA5 33852,12,20813,46525,913,148000,17472,9942,16305,2525,6582,4341,1750,1107,13031,8995,4036,8995,7208,1787,2021-01-01,zipcode,Lake placid
ZCTA5 33853,12,11530,40423,890,167100,8960,4270,8007,1354,2806,2409,933,505,5277,4452,825,4452,2364,2088,2021-01-01,zipcode,Lake wales
ZCTA5 33854,12,530,35139,645,74200,505,364,482,122,89,155,79,37,671,273,398,273,85,188,2021-01-01,zipcode,Lakeshore
ZCTA5 33855,12,112,51250,-666666666,275000,112,72,112,27,68,17,0,0,37,37,0,37,37,0,2021-01-01,zipcode,Indian lake estates
ZCTA5 33856,12,297,24538,568,-666666666,297,203,297,19,91,159,28,0,497,235,262,235,6,229,2021-01-01,zipcode,Nalcrest
ZCTA5 33857,12,1200,32304,-666666666,70100,1121,639,1087,99,670,212,93,13,1095,619,476,619,473,146,2021-01-01,zipcode,Lorida
ZCTA5 33859,12,10573,50879,949,167000,8819,4774,7739,921,2646,2740,822,610,5589,4263,1326,4263,3219,1044,2021-01-01,zipcode,Lake wales
ZCTA5 33860,12,26338,56770,1003,166800,19861,7119,16925,2924,5851,5682,1621,847,9747,8556,1191,8556,5756,2800,2021-01-01,zipcode,Mulberry
ZCTA5 33865,12,1006,58345,596,135700,919,487,859,208,287,240,91,33,291,291,0,291,211,80,2021-01-01,zipcode,Ona
ZCTA5 33867,12,139,38958,-666666666,86400,139,127,139,14,50,62,13,0,125,90,35,90,90,0,2021-01-01,zipcode,River ranch
ZCTA5 33868,12,13718,57051,971,154200,11073,6178,9888,1614,3800,2898,1052,524,5282,4146,1136,4146,3606,540,2021-01-01,zipcode,Polk city
ZCTA5 33870,12,25301,38610,844,108100,21237,12070,18830,3106,6870,5846,1979,1029,13995,10974,3021,10974,7398,3576,2021-01-01,zipcode,Sebring
ZCTA5 33872,12,12916,63706,974,137800,11384,7228,10441,778,2934,3718,1882,1129,7638,5834,1804,5834,5081,753,2021-01-01,zipcode,Sebring
ZCTA5 33873,12,13273,35082,816,105900,9778,4705,8279,1934,3839,1655,637,214,5619,4741,878,4741,2996,1745,2021-01-01,zipcode,Wauchula
ZCTA5 33875,12,10616,61481,797,171600,9062,4833,8488,774,2952,2610,1460,692,5403,4734,669,4734,3783,951,2021-01-01,zipcode,Sebring
ZCTA5 33876,12,6098,49026,933,126300,5307,3351,5018,593,2008,1728,485,204,3173,2501,672,2501,2129,372,2021-01-01,zipcode,Sebring
ZCTA5 33877,12,158,-666666666,-666666666,167200,158,43,158,0,91,67,0,0,195,125,70,125,125,0,2021-01-01,zipcode,Waverly
ZCTA5 33880,12,43354,50502,939,150700,33149,13269,28239,5722,10606,8360,2564,987,16830,14590,2240,14590,9202,5388,2021-01-01,zipcode,Winter haven
ZCTA5 33881,12,35142,45910,1010,113600,28257,15116,25134,3299,8818,8702,2844,1471,16665,13437,3228,13437,9371,4066,2021-01-01,zipcode,Winter haven
ZCTA5 33884,12,36300,62203,1278,211500,30406,13743,26571,2346,7466,9388,4950,2421,15782,13607,2175,13607,10354,3253,2021-01-01,zipcode,Winter haven
ZCTA5 33890,12,4750,46750,813,99900,3564,1485,2945,711,1449,495,186,104,1841,1400,441,1400,1079,321,2021-01-01,zipcode,Zolfo springs
ZCTA5 33896,12,17830,59858,1646,233800,14920,4071,12245,809,2802,4702,2656,1276,9565,6471,3094,6471,3078,3393,2021-01-01,zipcode,Davenport
ZCTA5 33897,12,25842,59636,1698,213500,20580,6897,18028,1289,6249,6388,3039,1063,13281,8803,4478,8803,5959,2844,2021-01-01,zipcode,Davenport
ZCTA5 33898,12,16194,48185,968,123400,13300,6976,12167,2216,4257,3665,1416,613,9446,6670,2776,6670,5494,1176,2021-01-01,zipcode,Lake wales
ZCTA5 33901,12,23531,43565,1076,238500,18948,8610,16524,2814,5535,3892,2567,1716,11163,9246,1917,9246,3772,5474,2021-01-01,zipcode,Fort myers
ZCTA5 33903,12,21509,51758,969,106300,19446,11214,18082,1861,5744,6538,2397,1542,15362,10902,4460,10902,8739,2163,2021-01-01,zipcode,North fort myers
ZCTA5 33904,12,31594,55026,1296,256900,28176,14460,26820,1516,9535,9015,4577,2177,20255,14605,5650,14605,11214,3391,2021-01-01,zipcode,Cape coral
ZCTA5 33905,12,37700,59081,1303,175900,30838,13667,26816,5484,9026,7073,3356,1877,15910,13046,2864,13046,8575,4471,2021-01-01,zipcode,Fort myers
ZCTA5 33907,12,25268,47108,1233,185900,21439,7984,19008,2181,5943,5724,3271,1889,13757,10805,2952,10805,4427,6378,2021-01-01,zipcode,Fort myers
ZCTA5 33908,12,36555,61875,1446,267900,33908,20629,31859,1448,8734,8094,7829,5754,31475,18899,12576,18899,13211,5688,2021-01-01,zipcode,Fort myers
ZCTA5 33909,12,33658,67325,1456,214700,27064,9781,23485,1623,9412,7266,3227,1957,12846,11751,1095,11751,8274,3477,2021-01-01,zipcode,Cape coral
ZCTA5 33912,12,19521,90633,1476,294400,17580,9667,16152,544,3407,4583,4413,3205,11752,8609,3143,8609,7361,1248,2021-01-01,zipcode,Fort myers
ZCTA5 33913,12,26117,94881,1496,331600,22074,11466,19174,1207,4151,5175,5032,3609,14145,10000,4145,10000,8706,1294,2021-01-01,zipcode,Fort myers
ZCTA5 33914,12,42036,67034,1353,310700,37838,16242,34896,1918,12130,12014,5310,3524,21985,17216,4769,17216,13901,3315,2021-01-01,zipcode,Cape coral
ZCTA5 33916,12,25429,39477,1091,154500,19984,7958,17069,3455,6347,3870,2294,1103,11873,9339,2534,9339,3175,6164,2021-01-01,zipcode,Fort myers
ZCTA5 33917,12,30120,48005,983,130900,26977,14575,25236,3054,9168,8418,2944,1652,18124,13709,4415,13709,11209,2500,2021-01-01,zipcode,North fort myers
ZCTA5 33919,12,28787,62778,1357,230300,25775,12458,24224,1214,5484,7565,6031,3930,18996,14015,4981,14015,10603,3412,2021-01-01,zipcode,Fort myers
ZCTA5 33920,12,6488,77051,869,254400,5282,2359,4793,415,1285,1814,836,443,2799,2401,398,2401,2224,177,2021-01-01,zipcode,Alva
ZCTA5 33921,12,925,120208,-666666666,2000001,923,706,905,28,94,302,280,201,1803,435,1368,435,410,25,2021-01-01,zipcode,Boca grande
ZCTA5 33922,12,4236,50216,1098,238900,3599,2218,3430,460,1014,935,513,508,2829,1779,1050,1779,1497,282,2021-01-01,zipcode,Bokeelia
ZCTA5 33924,12,173,-666666666,-666666666,-666666666,173,81,145,59,16,22,42,6,1856,35,1821,35,35,0,2021-01-01,zipcode,Captiva
ZCTA5 33928,12,28600,89220,1763,323500,25218,14515,24055,910,4813,7468,6231,4633,19687,13072,6615,13072,11142,1930,2021-01-01,zipcode,Estero
ZCTA5 33930,12,577,-666666666,-666666666,110300,430,96,346,57,161,84,0,44,384,292,92,292,226,66,2021-01-01,zipcode,Felda
ZCTA5 33931,12,9186,66898,1384,358700,8945,6110,8645,461,2663,2535,1585,1401,14661,4695,9966,4695,4231,464,2021-01-01,zipcode,Fort myers beach
ZCTA5 33935,12,22083,39283,906,130800,16544,6434,13922,4359,4832,3181,1052,498,8079,6924,1155,6924,4993,1931,2021-01-01,zipcode,Labelle
ZCTA5 33936,12,27178,41634,1089,152700,21723,9716,18733,3966,7342,4862,1716,847,10400,9360,1040,9360,5925,3435,2021-01-01,zipcode,Lehigh acres
ZCTA5 33944,12,182,-666666666,-666666666,-666666666,182,106,182,0,91,91,0,0,144,106,38,106,106,0,2021-01-01,zipcode,Palmdale
ZCTA5 33946,12,2830,90625,-666666666,509000,2698,1512,2578,45,693,871,535,434,3037,1374,1663,1374,1267,107,2021-01-01,zipcode,Placida
ZCTA5 33947,12,9486,55720,1155,261500,8926,5784,8614,565,2780,3214,1341,714,6508,4885,1623,4885,3827,1058,2021-01-01,zipcode,Rotonda west
ZCTA5 33948,12,17523,54487,1182,217300,15931,8855,14985,1391,5121,5492,1914,1067,9351,7666,1685,7666,6523,1143,2021-01-01,zipcode,Port charlotte
ZCTA5 33950,12,24039,64856,1172,311200,21417,13682,20008,901,4901,7229,4292,2685,15867,11693,4174,11693,9581,2112,2021-01-01,zipcode,Punta gorda
ZCTA5 33952,12,34214,48992,1048,169300,29938,15183,27031,2981,10062,8856,3393,1739,17126,14601,2525,14601,10767,3834,2021-01-01,zipcode,Port charlotte
ZCTA5 33953,12,7084,66287,985,250000,6574,4093,5996,490,1762,2092,1072,580,3967,3037,930,3037,2946,91,2021-01-01,zipcode,Port charlotte
ZCTA5 33954,12,10355,73098,1377,248700,9071,3880,8273,707,2419,3183,1386,578,4402,4108,294,4108,3183,925,2021-01-01,zipcode,Port charlotte
ZCTA5 33955,12,10429,69461,1131,260500,9507,5932,8957,986,2500,2734,1713,1024,6746,4684,2062,4684,4413,271,2021-01-01,zipcode,Punta gorda
ZCTA5 33956,12,3551,59098,2139,238700,3370,2121,3244,240,1165,1099,332,408,3529,1719,1810,1719,1531,188,2021-01-01,zipcode,Saint james city
ZCTA5 33957,12,6437,103413,794,730400,6292,3979,6134,59,1251,1257,1715,1852,8611,3471,5140,3471,3114,357,2021-01-01,zipcode,Sanibel
ZCTA5 33960,12,603,37647,-666666666,181900,483,247,476,47,191,155,58,25,505,304,201,304,263,41,2021-01-01,zipcode,Venus
ZCTA5 33965,12,2530,-666666666,-666666666,-666666666,2530,1370,36,0,0,33,3,0,0,0,0,0,0,0,2021-01-01,zipcode,Fort myers
ZCTA5 33966,12,9738,70949,1338,297000,8057,3414,7491,254,1348,2359,2240,1290,6165,4491,1674,4491,3118,1373,2021-01-01,zipcode,Fort myers
ZCTA5 33967,12,26690,75641,1419,255200,21580,6617,17961,1711,4639,6313,3570,1728,10775,9185,1590,9185,6816,2369,2021-01-01,zipcode,Fort myers
ZCTA5 33971,12,28061,61465,1386,193700,20814,6934,16953,3448,5961,5112,1615,817,8333,7847,486,7847,5996,1851,2021-01-01,zipcode,Lehigh acres
ZCTA5 33972,12,14883,61908,1275,219300,11455,4727,9921,1159,4131,2974,1195,462,5013,4405,608,4405,3418,987,2021-01-01,zipcode,Lehigh acres
ZCTA5 33973,12,15048,44429,1166,243800,10040,3834,8141,1767,2908,2461,557,448,4342,4037,305,4037,830,3207,2021-01-01,zipcode,Lehigh acres
ZCTA5 33974,12,19187,55456,1377,193700,14606,5318,12080,1860,4636,3572,1365,647,5627,5180,447,5180,3384,1796,2021-01-01,zipcode,Lehigh acres
ZCTA5 33976,12,17137,58269,1364,186200,12267,3373,10063,2144,3161,3154,1220,384,4995,4708,287,4708,3225,1483,2021-01-01,zipcode,Lehigh acres
ZCTA5 33980,12,13173,54011,951,167700,11629,7369,10696,685,4139,3204,1661,1007,8139,6038,2101,6038,4740,1298,2021-01-01,zipcode,Punta gorda
ZCTA5 33981,12,12683,61544,1338,273700,11267,6789,10972,729,3870,3576,1622,1175,6980,5448,1532,5448,4882,566,2021-01-01,zipcode,Port charlotte
ZCTA5 33982,12,11016,50654,961,168100,9871,6286,9346,1554,3439,2757,861,735,5194,4157,1037,4157,3564,593,2021-01-01,zipcode,Punta gorda
ZCTA5 33983,12,15487,60954,1061,265500,13334,6750,12139,629,4316,4151,2116,927,8424,6812,1612,6812,5660,1152,2021-01-01,zipcode,Punta gorda
ZCTA5 33990,12,35283,63249,1400,246100,30076,11854,26801,2612,10223,7905,4404,1657,15336,12993,2343,12993,9306,3687,2021-01-01,zipcode,Cape coral
ZCTA5 33991,12,23899,70457,1706,269100,19328,7987,16779,894,5900,5647,3139,1199,10715,9004,1711,9004,7159,1845,2021-01-01,zipcode,Cape coral
ZCTA5 33993,12,29502,74807,1688,247300,23658,9214,20404,2117,7852,6318,2611,1506,11098,9987,1111,9987,8403,1584,2021-01-01,zipcode,Cape coral
ZCTA5 34101,12,0,-666666666,-666666666,-666666666,0,0,0,0,0,0,0,0,0,0,0,0,0,0,2021-01-01,zipcode,Naples
ZCTA5 34102,12,10723,101944,1273,1025800,9556,5464,8956,516,1281,2051,2845,2263,9434,5334,4100,5334,3864,1470,2021-01-01,zipcode,Naples
ZCTA5 34103,12,11310,104309,1461,790400,10420,5851,9509,302,1734,2252,2998,2223,10413,5535,4878,5535,4580,955,2021-01-01,zipcode,Naples
ZCTA5 34104,12,23813,58333,1464,269700,19641,9510,18302,1899,5267,5527,3673,1936,15398,10888,4510,10888,7271,3617,2021-01-01,zipcode,Naples
ZCTA5 34105,12,16530,90260,1785,473900,14598,6993,13523,402,2708,3475,4149,2789,11415,7766,3649,7766,4963,2803,2021-01-01,zipcode,Naples
ZCTA5 34108,12,16631,106290,1694,783400,15684,9697,14993,560,2386,3270,5091,3686,14995,8389,6606,8389,7103,1286,2021-01-01,zipcode,Naples
ZCTA5 34109,12,26000,81140,1466,447300,21860,11178,20178,904,4867,4639,5657,4111,15618,11908,3710,11908,8396,3512,2021-01-01,zipcode,Naples
ZCTA5 34110,12,24773,78133,1790,402200,22097,12686,20548,672,3952,5286,6246,4392,17724,12584,5140,12584,9146,3438,2021-01-01,zipcode,Naples
ZCTA5 34112,12,26789,63191,1226,236800,24510,13406,22480,2214,6755,6042,4304,3165,20038,12938,7100,12938,10014,2924,2021-01-01,zipcode,Naples
ZCTA5 34113,12,24383,67715,1452,355600,21509,11005,19228,2343,5354,4454,4384,2693,15564,10341,5223,10341,7241,3100,2021-01-01,zipcode,Naples
ZCTA5 34114,12,18599,72481,1573,331100,16574,9932,15572,1431,3999,4236,3362,2544,14198,8634,5564,8634,7142,1492,2021-01-01,zipcode,Naples
ZCTA5 34116,12,35705,62366,1369,282100,28297,7947,23971,4903,9190,5775,2588,1515,11304,10541,763,10541,5697,4844,2021-01-01,zipcode,Naples
ZCTA5 34117,12,18927,91241,1529,332300,15241,4734,13247,1745,4266,4378,2032,826,5763,5331,432,5331,4407,924,2021-01-01,zipcode,Naples
ZCTA5 34119,12,31714,96692,1481,512500,25770,12771,23629,735,4796,6186,6671,5241,17114,13477,3637,13477,10686,2791,2021-01-01,zipcode,Naples
ZCTA5 34120,12,35117,78015,1803,327300,29328,9523,25587,2852,8813,6883,4064,2975,15781,12228,3553,12228,10619,1609,2021-01-01,zipcode,Naples
ZCTA5 34134,12,14859,111258,1451,528600,14196,9551,13844,281,2026,3830,3972,3735,14392,7754,6638,7754,6351,1403,2021-01-01,zipcode,Bonita springs
ZCTA5 34135,12,45996,76355,1418,324300,40368,20548,37170,4995,7890,10483,8224,5578,29075,19189,9886,19189,14997,4192,2021-01-01,zipcode,Bonita springs
ZCTA5 34137,12,492,-666666666,-666666666,135200,236,60,236,0,159,77,0,0,139,139,0,139,114,25,2021-01-01,zipcode,
ZCTA5 34138,12,958,83779,-666666666,-666666666,693,370,693,0,316,318,59,0,682,326,356,326,272,54,2021-01-01,zipcode,Chokoloskee
ZCTA5 34139,12,110,82750,-666666666,350000,102,37,102,0,32,29,15,26,547,61,486,61,61,0,2021-01-01,zipcode,Everglades city
ZCTA5 34140,12,168,-666666666,-666666666,-666666666,122,89,93,0,33,33,27,0,255,60,195,60,27,33,2021-01-01,zipcode,Goodland
ZCTA5 34141,12,110,-666666666,-666666666,-666666666,61,29,46,0,14,13,4,15,16,16,0,16,3,13,2021-01-01,zipcode,Ochopee
ZCTA5 34142,12,33241,45870,842,218500,24614,8735,19250,7854,5952,2887,1652,905,9935,8598,1337,8598,4069,4529,2021-01-01,zipcode,Immokalee
ZCTA5 34145,12,15929,93134,1775,689000,14931,9794,14324,650,3145,4137,3795,2597,17943,8131,9812,8131,7290,841,2021-01-01,zipcode,Marco island
ZCTA5 34201,12,3695,106014,1835,484900,3435,2348,3214,114,385,595,998,1122,2361,1706,655,1706,1617,89,2021-01-01,zipcode,Bradenton
ZCTA5 34202,12,24920,104907,1810,468200,20670,9765,18529,683,2764,5074,5295,4713,11710,9519,2191,9519,7227,2292,2021-01-01,zipcode,Bradenton
ZCTA5 34203,12,38698,60603,1200,227900,32887,14821,30023,3739,10957,7732,4852,2743,19922,16032,3890,16032,12187,3845,2021-01-01,zipcode,Bradenton
ZCTA5 34205,12,31061,47533,1093,176300,26055,10707,23180,3772,7503,6749,3476,1680,16043,12856,3187,12856,7737,5119,2021-01-01,zipcode,Bradenton
ZCTA5 34207,12,35394,42846,1093,96200,29741,13630,26010,4290,10138,7197,2939,1446,19292,14881,4411,14881,8983,5898,2021-01-01,zipcode,Bradenton
ZCTA5 34208,12,41102,51210,1207,208800,31489,13208,27476,5949,8781,6830,3730,2186,16339,13860,2479,13860,8022,5838,2021-01-01,zipcode,Bradenton
ZCTA5 34209,12,34848,70356,1409,269800,30499,15108,28061,1634,8190,8704,5713,3820,19009,15080,3929,15080,11916,3164,2021-01-01,zipcode,Bradenton
ZCTA5 34210,12,16579,51242,1226,222800,14690,7778,12901,849,3904,3704,2780,1664,11690,7618,4072,7618,4798,2820,2021-01-01,zipcode,Bradenton
ZCTA5 34211,12,13251,111952,1807,428300,11066,4785,9881,447,1629,3026,2982,1797,6983,5004,1979,5004,4423,581,2021-01-01,zipcode,Bradenton
ZCTA5 34212,12,22962,98293,1703,379900,18606,7977,16827,534,2748,5404,4788,3353,10385,8462,1923,8462,6926,1536,2021-01-01,zipcode,Bradenton
ZCTA5 34215,12,778,45125,-666666666,766000,766,513,730,0,75,348,180,127,596,357,239,357,338,19,2021-01-01,zipcode,Cortez
ZCTA5 34216,12,1021,88472,-666666666,991900,997,689,976,25,119,238,375,219,1814,610,1204,610,584,26,2021-01-01,zipcode,Anna maria
ZCTA5 34217,12,3927,66944,1652,553900,3557,2123,3472,56,516,937,1154,809,5830,2042,3788,2042,1655,387,2021-01-01,zipcode,Bradenton beach
ZCTA5 34219,12,25658,96813,1754,320900,21030,8477,19127,491,4968,6271,5083,2314,10538,9253,1285,9253,8316,937,2021-01-01,zipcode,Parrish
ZCTA5 34221,12,51531,63311,1190,219500,42853,19614,38220,4369,13270,10812,6300,3469,22795,18247,4548,18247,14366,3881,2021-01-01,zipcode,Palmetto
ZCTA5 34222,12,13076,58915,1194,150900,10924,5686,9817,689,3206,3817,1189,916,7800,5552,2248,5552,4624,928,2021-01-01,zipcode,Ellenton
ZCTA5 34223,12,18760,60342,1137,283100,17592,12151,16980,622,5497,4955,3620,2286,14106,9827,4279,9827,8266,1561,2021-01-01,zipcode,Englewood
ZCTA5 34224,12,15387,49637,1002,182500,14305,8736,13239,982,5056,4119,1934,1148,10956,7624,3332,7624,6173,1451,2021-01-01,zipcode,Englewood
ZCTA5 34228,12,7446,121797,2509,756500,7370,5848,7302,166,785,1474,2305,2572,9707,4106,5601,4106,3850,256,2021-01-01,zipcode,Longboat key
ZCTA5 34229,12,7820,86761,1175,547600,6950,4002,6510,184,1033,1205,2207,1881,4639,3534,1105,3534,3103,431,2021-01-01,zipcode,Osprey
ZCTA5 34231,12,32460,61937,1347,294000,27642,12165,25657,1581,7412,7781,5253,3630,19041,15069,3972,15069,9881,5188,2021-01-01,zipcode,Sarasota
ZCTA5 34232,12,34108,73212,1587,249800,28916,10086,26028,2062,8104,7960,5174,2728,16636,14658,1978,14658,10106,4552,2021-01-01,zipcode,Sarasota
ZCTA5 34233,12,19195,68972,1523,295200,16021,6349,14721,776,4425,3969,3567,1984,9385,8415,970,8415,5841,2574,2021-01-01,zipcode,Sarasota
ZCTA5 34234,12,21692,46772,1150,159000,17804,8310,15664,2526,5292,3809,2535,1502,10312,8696,1616,8696,5134,3562,2021-01-01,zipcode,Sarasota
ZCTA5 34235,12,14349,63364,1467,260500,12934,6326,11836,597,3314,3581,2600,1744,8185,6935,1250,6935,5125,1810,2021-01-01,zipcode,Sarasota
ZCTA5 34236,12,12523,87679,1543,741800,11863,7314,11498,645,1504,2431,3280,3638,11102,7186,3916,7186,4188,2998,2021-01-01,zipcode,Sarasota
ZCTA5 34237,12,17742,55828,1302,200500,14782,5125,12774,1617,4419,3885,1927,926,8584,6940,1644,6940,3111,3829,2021-01-01,zipcode,Sarasota
ZCTA5 34238,12,21148,85881,1622,408000,19342,11377,18262,357,3385,4533,4537,5450,13343,10711,2632,10711,8337,2374,2021-01-01,zipcode,Sarasota
ZCTA5 34239,12,14203,63413,1472,325200,12310,4949,11474,926,2496,3415,2935,1702,7913,6708,1205,6708,4936,1772,2021-01-01,zipcode,Sarasota
ZCTA5 34240,12,12713,110143,1237,449300,10617,4738,9663,246,2209,2710,2628,1870,6527,4975,1552,4975,4558,417,2021-01-01,zipcode,Sarasota
ZCTA5 34241,12,15737,92874,1660,376700,12889,5853,11295,401,2382,3403,3184,1925,6633,5865,768,5865,5079,786,2021-01-01,zipcode,Sarasota
ZCTA5 34242,12,7387,116033,1827,768700,6979,4389,6670,189,676,1529,2342,1934,10523,3962,6561,3962,3451,511,2021-01-01,zipcode,Sarasota
ZCTA5 34243,12,31400,70875,1722,307900,27582,12258,24676,971,5775,7690,5444,4796,16026,13301,2725,13301,10491,2810,2021-01-01,zipcode,Sarasota
ZCTA5 34251,12,7659,78261,850,385200,6092,2220,4997,379,2090,1766,512,250,2411,2322,89,2322,2112,210,2021-01-01,zipcode,Myakka city
ZCTA5 34266,12,28317,37251,781,103900,23275,11958,20078,5644,8506,3810,1375,743,12078,9826,2252,9826,6516,3310,2021-01-01,zipcode,Arcadia
ZCTA5 34268,12,392,24292,-666666666,23100,392,247,265,134,53,17,61,0,143,86,57,86,83,3,2021-01-01,zipcode,Nocatee
ZCTA5 34269,12,5199,48955,921,156000,4546,2669,4228,437,1746,1083,742,220,3193,2256,937,2256,2025,231,2021-01-01,zipcode,Arcadia
ZCTA5 34275,12,19555,72715,1323,332900,17930,10243,16489,696,4285,4822,3702,2984,11817,9789,2028,9789,8227,1562,2021-01-01,zipcode,Nokomis
ZCTA5 34285,12,18746,59670,1197,251000,17905,11678,17045,580,5157,4546,3609,3153,15708,10348,5360,10348,8195,2153,2021-01-01,zipcode,Venice
ZCTA5 34286,12,20264,64728,1612,211200,16838,7065,13731,1614,3890,4976,1973,1278,8202,7418,784,7418,6154,1264,2021-01-01,zipcode,North port
ZCTA5 34287,12,28218,52641,1156,167000,24027,14043,22203,1970,8138,7615,2771,1709,15616,11635,3981,11635,8792,2843,2021-01-01,zipcode,North port
ZCTA5 34288,12,13476,68881,1421,214400,10897,4145,8842,834,2024,3161,2025,798,5274,5010,264,5010,4249,761,2021-01-01,zipcode,North port
ZCTA5 34289,12,4511,82362,1338,282600,3906,1425,3226,342,942,1129,557,256,1816,1434,382,1434,779,655,2021-01-01,zipcode,North port
ZCTA5 34291,12,6786,82873,1419,241600,5761,2161,5088,272,2344,1923,348,201,2514,2460,54,2460,2117,343,2021-01-01,zipcode,North port
ZCTA5 34292,12,15676,74136,1793,328000,14559,9892,13897,598,3260,4209,3195,2635,10167,7919,2248,7919,6264,1655,2021-01-01,zipcode,Venice
ZCTA5 34293,12,44643,75516,1475,283200,40432,21996,38342,1895,9279,12597,8058,6513,26197,21260,4937,21260,18758,2502,2021-01-01,zipcode,Venice
ZCTA5 34420,12,18060,44813,804,126400,14784,6496,12519,1305,4913,4482,1275,544,8095,7081,1014,7081,5007,2074,2021-01-01,zipcode,Belleview
ZCTA5 34428,12,9164,42800,761,207700,7941,4174,6921,868,2315,2428,885,425,4994,4028,966,4028,2903,1125,2021-01-01,zipcode,Crystal river
ZCTA5 34429,12,8903,50690,892,159400,7880,5019,7453,683,2817,2006,1228,719,5364,4057,1307,4057,3474,583,2021-01-01,zipcode,Crystal river
ZCTA5 34431,12,7933,39974,736,133100,6875,4191,6433,1038,2225,2124,749,297,4630,3701,929,3701,3228,473,2021-01-01,zipcode,Dunnellon
ZCTA5 34432,12,12657,43884,820,159000,10934,6821,10267,1140,3857,3171,1269,830,6614,5699,915,5699,4884,815,2021-01-01,zipcode,Dunnellon
ZCTA5 34433,12,7604,60292,1055,165200,6262,3187,5431,776,2154,1581,606,314,3685,2973,712,2973,2755,218,2021-01-01,zipcode,Dunnellon
ZCTA5 34434,12,9424,54816,1098,148900,7415,3802,7054,735,2745,2310,931,333,4158,3421,737,3421,2881,540,2021-01-01,zipcode,Dunnellon
ZCTA5 34436,12,7694,46049,636,143700,6760,4152,6401,715,2503,2223,460,500,4893,3645,1248,3645,3120,525,2021-01-01,zipcode,Floral city
ZCTA5 34442,12,16532,47807,873,208900,15141,10309,14147,969,5129,4076,2057,1916,9767,7673,2094,7673,6677,996,2021-01-01,zipcode,Hernando
ZCTA5 34445,12,0,-666666666,-666666666,-666666666,0,0,0,0,0,0,0,0,0,0,0,0,0,0,2021-01-01,zipcode,Holder
ZCTA5 34446,12,18033,47008,882,159000,15815,11136,14557,1487,5375,5287,1403,1005,9299,8033,1266,8033,7194,839,2021-01-01,zipcode,Homosassa
ZCTA5 34448,12,10180,49072,839,117200,9059,5173,8624,1091,3611,2666,970,286,6257,4699,1558,4699,3860,839,2021-01-01,zipcode,Homosassa
ZCTA5 34449,12,3273,41570,478,102600,2958,1421,2707,337,1359,677,255,79,1856,1394,462,1394,1041,353,2021-01-01,zipcode,Inglis
ZCTA5 34450,12,10066,39774,885,154300,9214,5837,8201,657,2740,2989,1229,586,6369,4984,1385,4984,3910,1074,2021-01-01,zipcode,Inverness
ZCTA5 34452,12,13206,51683,1009,144600,11028,5391,10223,1121,3861,3890,1104,247,6145,5378,767,5378,4353,1025,2021-01-01,zipcode,Inverness
ZCTA5 34453,12,9835,45781,893,121600,8370,4993,7843,1110,3446,2241,753,293,5362,4194,1168,4194,3547,647,2021-01-01,zipcode,Inverness
ZCTA5 34461,12,12397,52755,885,214700,10973,6760,9737,954,4188,2407,1186,1002,5622,4557,1065,4557,3909,648,2021-01-01,zipcode,Lecanto
ZCTA5 34465,12,18483,50903,1009,180800,15835,9369,14136,1065,5100,5024,1543,1404,8854,8026,828,8026,6390,1636,2021-01-01,zipcode,Beverly hills
ZCTA5 34470,12,20707,43308,955,126200,16621,7467,14496,1914,4776,4840,1943,1023,9593,8723,870,8723,4871,3852,2021-01-01,zipcode,Ocala
ZCTA5 34471,12,26420,54723,1073,215800,21210,8775,18237,1231,5148,5492,3424,2942,11740,10885,855,10885,6770,4115,2021-01-01,zipcode,Ocala
ZCTA5 34472,12,32035,50308,1070,140300,24979,10956,21608,3258,7454,7183,2304,1409,13107,11911,1196,11911,9245,2666,2021-01-01,zipcode,Ocala
ZCTA5 34473,12,22441,63213,1172,161700,17650,7218,15764,1477,5998,5750,1772,767,8367,7397,970,7397,6305,1092,2021-01-01,zipcode,Ocala
ZCTA5 34474,12,17686,54886,1237,157000,14529,5710,12880,1327,3696,3777,2910,1170,8299,7418,881,7418,3238,4180,2021-01-01,zipcode,Ocala
ZCTA5 34475,12,14387,27421,753,95500,10992,6204,9586,1929,4114,2462,716,365,5669,4788,881,4788,2093,2695,2021-01-01,zipcode,Ocala
ZCTA5 34476,12,23924,56786,1068,189100,20539,11561,19040,1412,6386,6200,3196,1846,12233,10931,1302,10931,9868,1063,2021-01-01,zipcode,Ocala
ZCTA5 34479,12,14205,55225,1037,152800,11482,4919,10099,1399,4332,3030,917,421,6160,5542,618,5542,3695,1847,2021-01-01,zipcode,Ocala
ZCTA5 34480,12,22352,64851,941,199500,17794,6601,14702,1203,4888,4378,2948,1285,9425,8398,1027,8398,6519,1879,2021-01-01,zipcode,Ocala
ZCTA5 34481,12,22890,46325,1093,145700,21617,16434,20385,1440,6867,6324,3404,2350,12851,11958,893,11958,10720,1238,2021-01-01,zipcode,Ocala
ZCTA5 34482,12,23415,55461,942,174000,20481,13642,18563,3596,6902,5048,2193,824,9220,7422,1798,7422,6084,1338,2021-01-01,zipcode,Ocala
ZCTA5 34484,12,5399,59720,-666666666,308100,4717,2019,4295,798,1235,1040,590,632,3199,2769,430,2769,1626,1143,2021-01-01,zipcode,Oxford
ZCTA5 34488,12,11878,41969,932,62900,9486,4423,8347,1058,3526,2332,1186,245,6246,4886,1360,4886,3392,1494,2021-01-01,zipcode,Silver springs
ZCTA5 34491,12,31192,60831,981,191200,26144,15171,24277,2547,9313,7517,2905,1995,15134,13125,2009,13125,11511,1614,2021-01-01,zipcode,Summerfield
ZCTA5 34498,12,614,44318,917,208300,487,323,454,22,190,114,78,50,523,292,231,292,223,69,2021-01-01,zipcode,Yankeetown
ZCTA5 34601,12,22995,44244,899,108900,19395,10316,17456,2190,6343,5581,2282,1060,12131,10336,1795,10336,7115,3221,2021-01-01,zipcode,Brooksville
ZCTA5 34602,12,8590,67708,1021,190400,7225,3398,6605,905,2527,1846,790,537,3323,2980,343,2980,2593,387,2021-01-01,zipcode,Brooksville
ZCTA5 34604,12,13398,74118,1061,196400,11332,5567,9988,1269,3425,3557,1077,660,4809,4425,384,4425,3895,530,2021-01-01,zipcode,Brooksville
ZCTA5 34606,12,28162,46250,1001,161900,23789,12707,21449,1913,7807,7203,3141,1385,13935,12399,1536,12399,9494,2905,2021-01-01,zipcode,Spring hill
ZCTA5 34607,12,8300,50574,1117,252100,7294,3897,6586,499,1827,2729,999,532,4822,3701,1121,3701,3103,598,2021-01-01,zipcode,Spring hill
ZCTA5 34608,12,35708,53764,1091,167000,29389,13820,26055,3208,8631,9723,3054,1439,15196,14207,989,14207,10674,3533,2021-01-01,zipcode,Spring hill
ZCTA5 34609,12,43429,63063,1295,199800,35468,16473,31376,3020,9234,12633,4299,2190,17735,16397,1338,16397,13249,3148,2021-01-01,zipcode,Spring hill
ZCTA5 34610,12,16566,63938,1061,183300,13035,4895,11535,1833,3654,3692,1874,482,6215,5531,684,5531,4473,1058,2021-01-01,zipcode,Spring hill
ZCTA5 34613,12,17388,47874,1042,127600,15308,9547,14619,1604,5130,5124,2018,743,10283,8360,1923,8360,7200,1160,2021-01-01,zipcode,Brooksville
ZCTA5 34614,12,8072,69129,696,215100,6411,2675,5286,634,1504,1986,547,615,3056,2719,337,2719,2581,138,2021-01-01,zipcode,Brooksville
ZCTA5 34637,12,10548,104004,1633,293000,7962,4179,7036,431,1471,2000,1914,1220,3409,3075,334,3075,2762,313,2021-01-01,zipcode,Land o lakes
ZCTA5 34638,12,32345,104038,1880,290400,23400,7161,20472,1042,4992,6386,5545,2507,10700,10292,408,10292,8423,1869,2021-01-01,zipcode,Land o lakes
ZCTA5 34639,12,29652,86861,1536,275500,23614,7979,20623,1221,5160,6596,5234,2412,10783,10454,329,10454,8513,1941,2021-01-01,zipcode,Land o lakes
ZCTA5 34652,12,25101,45872,1000,149900,21841,10501,19436,2393,7778,5673,2481,1111,14722,11249,3473,11249,6902,4347,2021-01-01,zipcode,New port richey
ZCTA5 34653,12,33790,42666,1095,131700,28654,14457,25976,2377,10920,8264,3062,1353,17287,15021,2266,15021,9752,5269,2021-01-01,zipcode,New port richey
ZCTA5 34654,12,24321,57973,1279,187700,20775,10017,18545,2438,6790,5765,2212,1340,10251,8938,1313,8938,6938,2000,2021-01-01,zipcode,New port richey
ZCTA5 34655,12,44069,71553,1384,269900,36594,15764,32910,1988,8578,11030,7237,4077,20366,18283,2083,18283,14597,3686,2021-01-01,zipcode,New port richey
ZCTA5 34661,12,289,26538,-666666666,159900,247,141,247,39,128,66,14,0,266,166,100,166,94,72,2021-01-01,zipcode,Nobleton
ZCTA5 34667,12,31137,45874,1054,156000,27779,16467,26264,2794,10809,7740,3087,1834,19862,15467,4395,15467,11497,3970,2021-01-01,zipcode,Hudson
ZCTA5 34668,12,49271,39682,1087,117900,40601,20195,35114,4305,15466,10516,3382,1445,23859,21043,2816,21043,12566,8477,2021-01-01,zipcode,Port richey
ZCTA5 34669,12,13915,51139,1145,166400,11639,5880,10168,1079,4551,3050,1109,379,6423,5467,956,5467,4629,838,2021-01-01,zipcode,Hudson
ZCTA5 34677,12,22528,76217,1230,276600,18824,7164,16764,824,4306,5153,3978,2503,10048,8788,1260,8788,6747,2041,2021-01-01,zipcode,Oldsmar
ZCTA5 34679,12,77,-666666666,-666666666,-666666666,77,54,77,0,54,23,0,0,133,33,100,33,33,0,2021-01-01,zipcode,Aripeka
ZCTA5 34681,12,923,59250,-666666666,413300,734,331,683,1,130,241,278,33,529,422,107,422,422,0,2021-01-01,zipcode,Crystal beach
ZCTA5 34683,12,33490,75189,1348,317700,28514,10108,25550,1285,5881,8595,6372,3417,15482,13571,1911,13571,10384,3187,2021-01-01,zipcode,Palm harbor
ZCTA5 34684,12,27304,57768,1454,214500,23866,10950,21833,1142,5998,7590,4774,2329,14501,13090,1411,13090,9394,3696,2021-01-01,zipcode,Palm harbor
ZCTA5 34685,12,17555,79968,1435,378500,14870,6885,13617,643,2864,4192,3756,2162,7845,7345,500,7345,5523,1822,2021-01-01,zipcode,Palm harbor
ZCTA5 34688,12,8689,103997,1191,389400,7527,3547,6798,254,1376,1932,1926,1310,3668,3399,269,3399,3109,290,2021-01-01,zipcode,Tarpon springs
ZCTA5 34689,12,26393,56155,996,236400,22803,10986,20822,1552,6028,6644,4123,2475,13674,11529,2145,11529,8966,2563,2021-01-01,zipcode,Tarpon springs
ZCTA5 34690,12,11285,39235,1100,89300,9505,4622,8737,914,4228,2521,753,321,6746,5163,1583,5163,3156,2007,2021-01-01,zipcode,Holiday
ZCTA5 34691,12,20625,39891,1055,123600,16897,7413,15548,1329,7558,4596,1454,611,12323,9391,2932,9391,5744,3647,2021-01-01,zipcode,Holiday
ZCTA5 34695,12,17778,92019,1386,297600,14616,5229,13191,367,3188,3819,3912,1905,7861,7116,745,7116,5964,1152,2021-01-01,zipcode,Safety harbor
ZCTA5 34698,12,38390,56118,1148,247700,34885,16452,32351,2035,8566,10645,6525,4580,22596,18883,3713,18883,13695,5188,2021-01-01,zipcode,Dunedin
ZCTA5 34705,12,3141,49405,867,172900,2444,1023,2028,363,775,601,233,56,1243,1122,121,1122,943,179,2021-01-01,zipcode,Astatula
ZCTA5 34711,12,66167,77866,1629,281600,53829,22733,46747,2870,11640,16179,10148,5910,26881,24097,2784,24097,18599,5498,2021-01-01,zipcode,Clermont
ZCTA5 34714,12,24200,66258,1390,237500,19183,5945,16148,1355,4480,6187,2644,1482,10109,8159,1950,8159,4070,4089,2021-01-01,zipcode,Clermont
ZCTA5 34715,12,23642,81222,1591,310900,18344,6980,16441,1750,4863,5529,2668,1631,8006,7537,469,7537,5696,1841,2021-01-01,zipcode,Clermont
ZCTA5 34731,12,11546,51438,1065,146800,9799,4215,8677,685,3740,2630,1031,591,6107,4754,1353,4754,3799,955,2021-01-01,zipcode,Fruitland park
ZCTA5 34734,12,4581,66591,1631,301300,3113,1067,2732,30,736,999,709,258,1327,1300,27,1300,1081,219,2021-01-01,zipcode,Gotha
ZCTA5 34736,12,23734,71250,1543,247200,19171,7746,16946,1982,4494,5478,3141,1851,9865,9232,633,9232,7831,1401,2021-01-01,zipcode,Groveland
ZCTA5 34737,12,3715,62083,1363,253000,3267,1233,2965,500,600,1035,522,308,1836,1654,182,1654,1421,233,2021-01-01,zipcode,Howey in the hills
ZCTA5 34739,12,581,107686,-666666666,122900,554,198,415,136,210,51,18,0,444,247,197,247,133,114,2021-01-01,zipcode,Kenansville
ZCTA5 34741,12,52998,40153,1281,204200,40541,14109,34223,4987,10167,11703,5129,2237,20306,16380,3926,16380,5257,11123,2021-01-01,zipcode,Kissimmee
ZCTA5 34743,12,46292,53455,1389,217000,37686,11403,31485,5311,9906,10905,3991,1372,12952,11739,1213,11739,8528,3211,2021-01-01,zipcode,Kissimmee
ZCTA5 34744,12,60324,58452,1200,246600,48657,16303,40559,6192,12096,12315,6558,3398,19998,17589,2409,17589,12021,5568,2021-01-01,zipcode,Kissimmee
ZCTA5 34746,12,50514,60564,1485,251100,40477,15318,35103,4669,9395,11233,6353,3453,23433,14803,8630,14803,10714,4089,2021-01-01,zipcode,Kissimmee
ZCTA5 34747,12,22109,74865,1614,356800,17173,5011,14777,414,2625,4813,4429,2496,21857,8069,13788,8069,4251,3818,2021-01-01,zipcode,Kissimmee
ZCTA5 34748,12,42457,46806,961,172100,36593,22313,33518,3328,11954,11354,4503,2379,23566,19237,4329,19237,13901,5336,2021-01-01,zipcode,Leesburg
ZCTA5 34753,12,6563,59657,1220,184900,4796,1505,3883,1095,1100,1205,341,142,1933,1885,48,1885,1506,379,2021-01-01,zipcode,Mascotte
ZCTA5 34756,12,3879,91100,1211,366700,3215,1375,2610,185,560,1052,529,284,1476,1298,178,1298,1036,262,2021-01-01,zipcode,Montverde
ZCTA5 34758,12,42974,54284,1418,199700,32632,11145,27150,3722,9989,9219,2638,1582,13581,10796,2785,10796,8423,2373,2021-01-01,zipcode,Kissimmee
ZCTA5 34759,12,39453,54264,1403,216600,31836,15921,26534,4689,7264,8344,3967,2270,15954,12708,3246,12708,9376,3332,2021-01-01,zipcode,Kissimmee
ZCTA5 34760,12,989,120781,1542,311500,860,335,775,38,173,408,125,31,353,304,49,304,251,53,2021-01-01,zipcode,Oakland
ZCTA5 34761,12,46585,80786,1430,283100,36121,11121,31257,5540,7066,9420,6250,2981,14690,14022,668,14022,9896,4126,2021-01-01,zipcode,Ocoee
ZCTA5 34762,12,315,66181,-666666666,-666666666,315,200,315,89,118,76,14,18,277,143,134,143,143,0,2021-01-01,zipcode,Okahumpka
ZCTA5 34769,12,29985,54887,1114,212900,22518,9086,19254,3047,6396,5784,2805,1222,11031,8879,2152,8879,6157,2722,2021-01-01,zipcode,Saint cloud
ZCTA5 34771,12,23948,85549,1356,336700,19376,7640,16240,1707,4135,5026,3856,1516,8562,7042,1520,7042,6156,886,2021-01-01,zipcode,Saint cloud
ZCTA5 34772,12,31178,76327,1448,265300,24197,9437,20513,1432,6089,7726,3879,1387,10346,8931,1415,8931,7681,1250,2021-01-01,zipcode,Saint cloud
ZCTA5 34773,12,4074,69337,2028,242600,2877,1444,2576,377,595,805,447,352,1438,1220,218,1220,1051,169,2021-01-01,zipcode,Saint cloud
ZCTA5 34785,12,19972,39545,1054,99700,17405,11638,16589,2849,7652,4280,1217,591,7355,6249,1106,6249,3951,2298,2021-01-01,zipcode,Wildwood
ZCTA5 34786,12,46817,105774,1916,471200,34475,10578,31059,926,2898,9394,11961,5880,16916,14869,2047,14869,10673,4196,2021-01-01,zipcode,Windermere
ZCTA5 34787,12,81398,96033,1627,367400,60707,17918,53226,4120,10254,15141,14819,8892,28750,26245,2505,26245,19198,7047,2021-01-01,zipcode,Winter garden
ZCTA5 34788,12,20689,48708,1209,110600,17938,8820,16784,1776,6642,5132,2180,1054,10970,8832,2138,8832,7256,1576,2021-01-01,zipcode,Leesburg
ZCTA5 34797,12,1473,92652,-666666666,261600,1306,827,1260,14,402,449,253,142,864,641,223,641,619,22,2021-01-01,zipcode,Yalaha
ZCTA5 34945,12,5314,56794,637,222100,4474,2985,3998,599,1244,1210,611,334,1790,1461,329,1461,1359,102,2021-01-01,zipcode,Fort pierce
ZCTA5 34946,12,5916,37425,749,108100,5036,2262,4342,1212,1344,1228,372,186,3207,2523,684,2523,1508,1015,2021-01-01,zipcode,Fort pierce
ZCTA5 34947,12,13216,33962,979,151000,10022,4197,7835,2076,2428,2230,411,690,4667,4076,591,4076,1413,2663,2021-01-01,zipcode,Fort pierce
ZCTA5 34949,12,7960,82644,1322,323000,7813,4440,7395,324,1446,2157,2022,1446,8001,4435,3566,4435,3450,985,2021-01-01,zipcode,Fort pierce
ZCTA5 34950,12,16675,33204,933,116900,13457,6584,11352,3515,3849,2715,1015,258,7474,6250,1224,6250,2317,3933,2021-01-01,zipcode,Fort pierce
ZCTA5 34951,12,16275,51375,1068,160700,14360,7463,12911,1617,3967,4538,2158,631,8355,6997,1358,6997,6142,855,2021-01-01,zipcode,Fort pierce
ZCTA5 34952,12,42196,51552,1358,183900,35998,16270,32541,3103,11257,11620,4709,1852,21393,17478,3915,17478,12090,5388,2021-01-01,zipcode,Port saint lucie
ZCTA5 34953,12,74414,75226,1676,245400,58262,18366,50126,5181,15623,17918,7828,3576,25862,24483,1379,24483,20642,3841,2021-01-01,zipcode,Port saint lucie
ZCTA5 34956,12,9751,45234,921,101800,7953,4072,6336,2025,1891,1777,562,81,2884,2484,400,2484,1687,797,2021-01-01,zipcode,Indiantown
ZCTA5 34957,12,22583,62441,1243,297300,20090,11091,18581,1314,4722,5806,3996,2743,16915,10730,6185,10730,7863,2867,2021-01-01,zipcode,Jensen beach
ZCTA5 34972,12,19728,46258,895,150500,15906,8313,13599,3002,5125,3242,1424,806,7237,6085,1152,6085,4006,2079,2021-01-01,zipcode,Okeechobee
ZCTA5 34974,12,23055,46575,876,115200,19334,10359,17273,2839,6402,5320,1939,773,13451,10109,3342,10109,7989,2120,2021-01-01,zipcode,Okeechobee
ZCTA5 34981,12,6167,62381,1243,268000,4709,1676,4088,296,1577,1116,564,535,1896,1662,234,1662,943,719,2021-01-01,zipcode,Fort pierce
ZCTA5 34982,12,25825,45135,1076,167400,21223,9168,18512,2806,6495,6167,2100,944,11950,10768,1182,10768,8044,2724,2021-01-01,zipcode,Fort pierce
ZCTA5 34983,12,44999,63890,1501,221700,36252,13847,32538,3091,11081,9968,5732,2666,16699,15387,1312,15387,12798,2589,2021-01-01,zipcode,Port saint lucie
ZCTA5 34984,12,18333,70854,1678,258900,14835,5743,13455,1881,3827,5379,1724,644,6783,6161,622,6161,4963,1198,2021-01-01,zipcode,Port saint lucie
ZCTA5 34986,12,28438,71141,1659,284900,23974,14015,21412,1408,5942,6287,4618,3157,13731,11487,2244,11487,9635,1852,2021-01-01,zipcode,Port saint lucie
ZCTA5 34987,12,12818,71923,1812,309800,11202,6533,10591,526,3006,3003,2381,1675,5953,5464,489,5464,4157,1307,2021-01-01,zipcode,Port saint lucie
ZCTA5 34990,12,30156,105527,1712,430900,25271,11176,22792,789,3849,7375,6751,4028,13696,12039,1657,12039,10713,1326,2021-01-01,zipcode,Palm city
ZCTA5 34994,12,18187,51706,1200,189600,14997,7449,13762,1143,3876,4609,2784,1350,9538,7841,1697,7841,4731,3110,2021-01-01,zipcode,Stuart
ZCTA5 34996,12,11062,73350,1177,356400,10091,5766,9716,410,2182,3044,2121,1959,8935,5825,3110,5825,4807,1018,2021-01-01,zipcode,Stuart
ZCTA5 34997,12,44630,64594,1239,271300,38416,17665,34613,2997,9834,12079,6385,3318,21878,18365,3513,18365,14975,3390,2021-01-01,zipcode,Stuart
ZCTA5 35004,01,11917,68086,1114,170600,9408,3596,8518,459,3069,3266,1188,536,4745,4616,129,4616,3423,1193,2021-01-01,zipcode,Moody
ZCTA5 35005,01,8180,48583,914,104700,6871,3110,6359,1045,2885,1726,489,214,3460,2869,591,2869,2359,510,2021-01-01,zipcode,Adamsville
ZCTA5 35006,01,3386,58799,-666666666,102400,2827,1301,2444,365,1317,641,83,38,1646,1190,456,1190,1093,97,2021-01-01,zipcode,Adger
ZCTA5 35007,01,27323,74741,1111,182100,21056,6554,18279,1557,4975,5264,4175,2308,10421,9896,525,9896,8334,1562,2021-01-01,zipcode,Alabaster
ZCTA5 35010,01,20899,48874,628,104900,16812,7725,14753,2702,5038,4618,1425,970,10636,8082,2554,8082,5871,2211,2021-01-01,zipcode,Alexander city
ZCTA5 35013,01,99,-666666666,-666666666,-666666666,99,9,99,81,0,18,0,0,27,27,0,27,9,18,2021-01-01,zipcode,Allgood
ZCTA5 35014,01,4212,50893,1010,99600,3700,1834,3095,634,1150,891,154,266,2005,1683,322,1683,1520,163,2021-01-01,zipcode,Alpine
ZCTA5 35016,01,16906,49813,658,151800,13389,5992,11554,1310,3867,4195,1389,793,7274,6446,828,6446,4738,1708,2021-01-01,zipcode,Arab
ZCTA5 35019,01,2289,53639,672,113200,1821,720,1520,273,604,438,174,31,1049,867,182,867,686,181,2021-01-01,zipcode,Baileyton
ZCTA5 35020,01,25763,28812,755,76600,20123,9758,17485,3192,7058,5269,1412,554,12890,10145,2745,10145,5521,4624,2021-01-01,zipcode,Bessemer
ZCTA5 35022,01,22211,68139,930,200700,18572,6960,16323,1211,4594,5586,3227,1705,9831,9062,769,9062,7151,1911,2021-01-01,zipcode,Bessemer
ZCTA5 35023,01,24780,61632,1048,122900,19519,7929,17006,1753,6188,5705,2455,905,9889,8632,1257,8632,6656,1976,2021-01-01,zipcode,Bessemer
ZCTA5 35031,01,7379,50186,635,119800,5975,2603,5177,763,1785,1768,422,439,3263,2601,662,2601,1898,703,2021-01-01,zipcode,Blountsville
ZCTA5 35032,01,50,-666666666,-666666666,65600,44,31,36,19,15,2,0,0,31,22,9,22,18,4,2021-01-01,zipcode,Bon air
ZCTA5 35033,01,3235,41989,905,120700,2479,1200,2179,496,529,850,226,78,1532,1250,282,1250,1065,185,2021-01-01,zipcode,Bremen
ZCTA5 35034,01,5451,43929,763,87500,4356,3138,3682,1000,1841,468,235,138,1532,1276,256,1276,906,370,2021-01-01,zipcode,Brent
ZCTA5 35035,01,991,56416,-666666666,67300,828,373,666,34,333,158,127,14,432,364,68,364,330,34,2021-01-01,zipcode,Brierfield
ZCTA5 35036,01,153,-666666666,264,-666666666,143,110,92,0,79,11,2,0,79,75,4,75,0,75,2021-01-01,zipcode,Brookside
ZCTA5 35040,01,18433,68848,1306,159100,13878,3617,11754,862,2903,4293,2617,1079,7132,6688,444,6688,5357,1331,2021-01-01,zipcode,Calera
ZCTA5 35042,01,6221,62778,504,117300,5304,2381,4826,735,1918,1325,481,367,2778,2248,530,2248,1827,421,2021-01-01,zipcode,Centreville
ZCTA5 35043,01,14054,94959,1087,258900,10499,3911,9155,322,2033,3274,2627,899,4610,4325,285,4325,3890,435,2021-01-01,zipcode,Chelsea
ZCTA5 35044,01,7960,38081,683,89400,6616,3173,5676,1117,1996,2034,231,298,3614,3310,304,3310,2097,1213,2021-01-01,zipcode,Childersburg
ZCTA5 35045,01,14576,52056,783,140900,11651,5652,10377,1568,4300,2759,841,909,6429,5676,753,5676,3785,1891,2021-01-01,zipcode,Clanton
ZCTA5 35046,01,5106,58851,746,136600,3824,1581,3338,505,1643,739,266,185,2651,1895,756,1895,1478,417,2021-01-01,zipcode,Clanton
ZCTA5 35049,01,3643,44984,694,135000,2801,1044,2405,439,1022,699,148,97,1560,1373,187,1373,957,416,2021-01-01,zipcode,Cleveland
ZCTA5 35051,01,8627,55899,734,172800,7116,3393,6317,1217,2257,1622,854,367,3170,2897,273,2897,2201,696,2021-01-01,zipcode,Columbiana
ZCTA5 35052,01,224,-666666666,-666666666,-666666666,224,196,224,84,93,31,12,4,19,19,0,19,0,19,2021-01-01,zipcode,Cook springs
ZCTA5 35053,01,2833,72031,842,225200,2168,1108,2076,250,638,694,334,160,2402,1039,1363,1039,973,66,2021-01-01,zipcode,Crane hill
ZCTA5 35054,01,4233,79569,1021,263100,3268,1446,2631,257,708,999,437,230,1889,1538,351,1538,1388,150,2021-01-01,zipcode,Cropwell
ZCTA5 35055,01,22597,53810,807,150800,18326,7498,15509,1857,4139,5345,2796,1372,10117,9088,1029,9088,5880,3208,2021-01-01,zipcode,Cullman
ZCTA5 35057,01,14165,59731,763,157400,11142,4139,9651,1576,3166,3550,835,524,6157,5022,1135,5022,4087,935,2021-01-01,zipcode,Cullman
ZCTA5 35058,01,10112,50564,778,144100,8323,3316,7504,1254,2863,2468,627,292,4384,3862,522,3862,2907,955,2021-01-01,zipcode,Cullman
ZCTA5 35060,01,184,25662,-666666666,108000,140,73,116,0,79,21,0,16,201,99,102,99,99,0,2021-01-01,zipcode,Docena
ZCTA5 35061,01,1517,62788,1049,155500,1409,492,1159,75,463,488,110,23,616,427,189,427,269,158,2021-01-01,zipcode,Dolomite
ZCTA5 35062,01,8698,55341,694,148500,6904,3216,5961,816,2193,1918,737,297,3593,3152,441,3152,2546,606,2021-01-01,zipcode,Dora
ZCTA5 35063,01,3085,54722,913,84900,2660,1325,2369,544,791,911,100,23,1579,1178,401,1178,1059,119,2021-01-01,zipcode,Empire
ZCTA5 35064,01,10083,44039,871,99400,8141,3400,6407,350,2452,2179,1003,423,4911,3917,994,3917,2071,1846,2021-01-01,zipcode,Fairfield
ZCTA5 35068,01,8205,72881,1032,164600,6299,2106,5529,536,1382,2013,962,636,3565,3461,104,3461,2570,891,2021-01-01,zipcode,Fultondale
ZCTA5 35070,01,112,58438,-666666666,115500,89,61,89,6,26,41,16,0,42,42,0,42,40,2,2021-01-01,zipcode,Garden city
ZCTA5 35071,01,17487,74507,934,193200,13803,5326,11966,915,3650,3915,2323,1163,7378,6837,541,6837,5270,1567,2021-01-01,zipcode,Gardendale
ZCTA5 35072,01,4791,44599,548,84400,3688,1995,3302,494,1580,817,274,137,2477,1745,732,1745,1403,342,2021-01-01,zipcode,Goodwater
ZCTA5 35073,01,3082,46000,824,93500,2647,1097,2264,445,680,796,254,89,1464,1260,204,1260,868,392,2021-01-01,zipcode,Graysville
ZCTA5 35074,01,114,-666666666,-666666666,-666666666,114,0,114,64,0,50,0,0,50,50,0,50,0,50,2021-01-01,zipcode,Green pond
ZCTA5 35077,01,14184,44825,757,123500,11664,5499,10117,2097,3449,3360,668,543,6407,5578,829,5578,3977,1601,2021-01-01,zipcode,Hanceville
ZCTA5 35078,01,1951,66922,-666666666,163500,1553,614,1420,198,443,530,157,92,1053,781,272,781,655,126,2021-01-01,zipcode,Harpersville
ZCTA5 35079,01,9469,77500,868,164900,7632,3382,6587,513,2683,2322,745,324,3711,3250,461,3250,3070,180,2021-01-01,zipcode,Hayden
ZCTA5 35080,01,19266,97993,1334,212800,14471,4390,12425,450,2179,3916,4134,1746,6879,6466,413,6466,6000,466,2021-01-01,zipcode,Helena
ZCTA5 35082,01,0,-666666666,-666666666,-666666666,0,0,0,0,0,0,0,0,0,0,0,0,0,0,2021-01-01,zipcode,Hollins
ZCTA5 35083,01,4024,51875,780,151900,3067,1246,2637,559,864,970,163,81,1501,1381,120,1381,1124,257,2021-01-01,zipcode,Holly pond
ZCTA5 35085,01,8140,61123,763,103400,6400,2400,5228,1175,2102,1252,483,216,3406,2894,512,2894,2325,569,2021-01-01,zipcode,Jemison
ZCTA5 35087,01,2702,43698,823,119600,2194,801,1949,205,543,902,202,97,1025,987,38,987,818,169,2021-01-01,zipcode,Joppa
ZCTA5 35089,01,1546,55040,703,-666666666,1454,706,1253,186,542,495,9,21,664,559,105,559,480,79,2021-01-01,zipcode,Kellyton
ZCTA5 35091,01,3193,97882,1219,219300,2407,733,2099,126,540,885,261,287,1277,1071,206,1071,1012,59,2021-01-01,zipcode,Kimberly
ZCTA5 35094,01,15206,64154,819,177000,11859,4345,10547,1312,2744,3540,1879,1072,6508,5690,818,5690,4503,1187,2021-01-01,zipcode,Leeds
ZCTA5 35096,01,8644,63582,942,141600,6746,2540,5681,816,1975,1930,678,282,3885,2975,910,2975,2574,401,2021-01-01,zipcode,Lincoln
ZCTA5 35097,01,1940,44688,1069,125000,1633,863,1403,309,537,402,113,42,843,709,134,709,648,61,2021-01-01,zipcode,Locust fork
ZCTA5 35098,01,1337,53750,793,-666666666,1075,460,865,169,239,382,58,17,625,533,92,533,348,185,2021-01-01,zipcode,Logan
ZCTA5 35111,01,17103,72217,883,215600,13781,4842,12061,712,3408,4270,2351,1320,6996,6445,551,6445,5826,619,2021-01-01,zipcode,Mc calla
ZCTA5 35112,01,0,-666666666,-666666666,-666666666,0,0,0,0,0,0,0,0,53,0,53,0,0,0,2021-01-01,zipcode,Margaret
ZCTA5 35114,01,8156,93438,1095,212600,6158,1947,5230,192,1023,1679,1299,1037,3045,2869,176,2869,2491,378,2021-01-01,zipcode,Alabaster
ZCTA5 35115,01,17448,47500,743,137500,13930,5957,10586,1740,3374,3212,1789,471,6518,6046,472,6046,4153,1893,2021-01-01,zipcode,Montevallo
ZCTA5 35116,01,4885,73250,946,177000,3814,1316,3501,247,1113,1146,780,215,1998,1865,133,1865,1685,180,2021-01-01,zipcode,Morris
ZCTA5 35117,01,5866,79210,784,166300,4716,1686,3966,282,952,1726,745,261,2522,2275,247,2275,2111,164,2021-01-01,zipcode,Mount olive
ZCTA5 35118,01,3477,62054,875,122600,2659,1367,2245,376,901,713,168,87,1231,1069,162,1069,840,229,2021-01-01,zipcode,Mulga
ZCTA5 35119,01,136,-666666666,-666666666,-666666666,136,64,136,100,36,0,0,0,28,28,0,28,0,28,2021-01-01,zipcode,New castle
ZCTA5 35120,01,17106,65795,870,156300,13303,4390,11612,1574,4228,3774,1364,672,6690,6239,451,6239,5218,1021,2021-01-01,zipcode,Odenville
ZCTA5 35121,01,16441,49083,672,136300,13203,6756,11380,2482,3187,3766,1157,788,6974,6224,750,6224,4421,1803,2021-01-01,zipcode,Oneonta
ZCTA5 35124,01,24594,80261,1190,222600,19887,6100,17778,903,3380,5527,4959,3009,10108,9752,356,9752,8230,1522,2021-01-01,zipcode,Pelham
ZCTA5 35125,01,10752,49030,894,144300,8623,3901,7372,1600,2774,1885,810,303,4578,3961,617,3961,2588,1373,2021-01-01,zipcode,Pell city
ZCTA5 35126,01,21997,71303,892,156000,17503,6178,14581,1381,5131,5360,1963,746,8288,7508,780,7508,6469,1039,2021-01-01,zipcode,Pinson
ZCTA5 35127,01,9638,67000,1076,160600,7849,2983,6728,416,1662,3092,1036,522,3808,3398,410,3398,2725,673,2021-01-01,zipcode,Pleasant grove
ZCTA5 35128,01,10831,69503,968,189500,8710,3224,7536,806,2471,2731,1015,513,4698,4177,521,4177,3218,959,2021-01-01,zipcode,Pell city
ZCTA5 35130,01,3509,42939,532,102900,2798,1676,2409,440,1135,663,96,75,1926,1411,515,1411,1197,214,2021-01-01,zipcode,Quinton
ZCTA5 35131,01,3347,40938,672,85500,2609,1341,2278,441,921,566,220,130,1650,1252,398,1252,940,312,2021-01-01,zipcode,Ragland
ZCTA5 35133,01,3406,52137,743,144100,2687,1348,2522,423,853,963,186,97,1482,1272,210,1272,1126,146,2021-01-01,zipcode,Remlap
ZCTA5 35135,01,2075,49091,959,196800,1629,676,1481,256,515,370,232,108,952,842,110,842,650,192,2021-01-01,zipcode,Riverside
ZCTA5 35136,01,2153,47500,325,159800,1831,973,1535,153,479,602,268,33,1196,764,432,764,583,181,2021-01-01,zipcode,Rockford
ZCTA5 35143,01,3238,73367,659,217200,2752,1217,2400,167,865,793,545,30,2121,1244,877,1244,1026,218,2021-01-01,zipcode,Shelby
ZCTA5 35146,01,12049,73230,642,211500,10020,4962,8756,1288,2932,2455,1375,706,4310,3915,395,3915,3347,568,2021-01-01,zipcode,Springville
ZCTA5 35147,01,5752,78432,1529,221900,4446,1368,3743,288,612,1258,1116,469,2172,2004,168,2004,1788,216,2021-01-01,zipcode,Sterrett
ZCTA5 35148,01,2419,56500,558,113800,2041,836,1752,298,677,667,74,36,1190,956,234,956,663,293,2021-01-01,zipcode,Sumiton
ZCTA5 35149,01,127,-666666666,-666666666,-666666666,127,26,101,0,101,0,0,0,80,80,0,80,54,26,2021-01-01,zipcode,Sycamore
ZCTA5 35150,01,17421,37402,643,114600,13495,6535,11835,1996,3918,4226,1051,644,8253,7029,1224,7029,4286,2743,2021-01-01,zipcode,Sylacauga
ZCTA5 35151,01,7893,61875,907,124700,6510,2823,5831,759,1694,2131,755,492,3693,2979,714,2979,2612,367,2021-01-01,zipcode,Sylacauga
ZCTA5 35160,01,26369,36762,629,110300,22268,11858,18972,4028,7017,5207,1695,1025,12831,10192,2639,10192,6486,3706,2021-01-01,zipcode,Talladega
ZCTA5 35171,01,3556,55764,-666666666,122700,2885,1638,2616,553,882,805,264,112,1331,1215,116,1215,1008,207,2021-01-01,zipcode,Thorsby
ZCTA5 35172,01,2761,44821,769,89900,2291,1070,2027,179,1131,574,107,36,1185,1024,161,1024,755,269,2021-01-01,zipcode,Trafford
ZCTA5 35173,01,30218,103097,1327,269500,23289,8127,20071,1094,4443,6456,5322,2756,10956,10343,613,10343,9356,987,2021-01-01,zipcode,Trussville
ZCTA5 35175,01,5054,64167,806,154000,4167,1920,3652,590,1271,963,550,278,2420,2040,380,2040,1731,309,2021-01-01,zipcode,Union grove
ZCTA5 35176,01,766,22235,759,107000,636,370,524,233,126,110,20,35,355,355,0,355,210,145,2021-01-01,zipcode,Vandiver
ZCTA5 35178,01,2894,34216,-666666666,124500,2290,1331,2027,368,869,503,225,62,1549,1190,359,1190,995,195,2021-01-01,zipcode,Vincent
ZCTA5 35179,01,8602,54205,690,156800,7037,3073,5831,787,2189,1999,586,270,3555,3033,522,3033,2546,487,2021-01-01,zipcode,Vinemont
ZCTA5 35180,01,14615,66285,753,158400,11234,5176,9681,1090,3452,3710,982,447,5462,4968,494,4968,4133,835,2021-01-01,zipcode,Warrior
ZCTA5 35183,01,949,64107,-666666666,103000,910,500,910,174,439,263,7,27,431,312,119,312,272,40,2021-01-01,zipcode,Weogufka
ZCTA5 35184,01,5788,54102,823,90000,4677,2029,3940,811,1994,956,135,44,2522,1891,631,1891,1577,314,2021-01-01,zipcode,West blocton
ZCTA5 35186,01,5151,89118,1025,226600,4215,1799,3665,389,1014,1239,661,362,2127,1924,203,1924,1558,366,2021-01-01,zipcode,Wilsonville
ZCTA5 35188,01,2745,49308,847,142600,2095,995,1787,344,848,513,51,31,1012,829,183,829,691,138,2021-01-01,zipcode,Woodstock
ZCTA5 35203,01,3160,36847,543,273000,2992,1677,2806,604,922,388,423,469,1889,1563,326,1563,405,1158,2021-01-01,zipcode,Birmingham
ZCTA5 35204,01,9287,27140,682,65200,7894,4385,6765,1279,2706,1925,587,268,5455,4167,1288,4167,1835,2332,2021-01-01,zipcode,Birmingham
ZCTA5 35205,01,18709,43277,894,226500,17444,6179,12626,663,1942,3161,3835,3025,11671,9251,2420,9251,2713,6538,2021-01-01,zipcode,Birmingham
ZCTA5 35206,01,16447,33366,932,92600,13451,5957,11967,1742,4587,3839,1176,623,8027,6388,1639,6388,3053,3335,2021-01-01,zipcode,Birmingham
ZCTA5 35207,01,7153,26967,691,67100,5635,2861,4818,970,1635,1554,370,289,3949,3131,818,3131,1703,1428,2021-01-01,zipcode,Birmingham
ZCTA5 35208,01,14112,32277,852,78200,11496,5801,9802,1346,3700,3346,1012,398,7284,5663,1621,5663,3385,2278,2021-01-01,zipcode,Birmingham
ZCTA5 35209,01,29287,67814,1115,372100,22816,6302,18550,820,2579,3710,6435,5006,15227,12457,2770,12457,6488,5969,2021-01-01,zipcode,Birmingham
ZCTA5 35210,01,13457,63784,938,169100,11578,4071,10610,767,2714,2872,2757,1500,6803,6074,729,6074,4290,1784,2021-01-01,zipcode,Birmingham
ZCTA5 35211,01,24762,33043,885,82700,19744,8570,17153,2377,5224,5809,2583,1160,14330,11273,3057,11273,4812,6461,2021-01-01,zipcode,Birmingham
ZCTA5 35212,01,10626,30113,624,162700,7435,2617,6656,871,1787,1870,1221,907,5425,4245,1180,4245,1831,2414,2021-01-01,zipcode,Birmingham
ZCTA5 35213,01,14807,125060,1497,576100,11617,3582,10253,58,418,919,5040,3818,6406,6153,253,6153,4651,1502,2021-01-01,zipcode,Birmingham
ZCTA5 35214,01,18106,54180,854,119600,15321,6643,13120,1153,3787,4741,2295,1144,8364,7171,1193,7171,4860,2311,2021-01-01,zipcode,Birmingham
ZCTA5 35215,01,46817,41814,924,115100,33796,13727,28650,3426,10102,10055,3459,1608,19640,17142,2498,17142,9568,7574,2021-01-01,zipcode,Birmingham
ZCTA5 35216,01,38829,65803,1157,299400,29679,8494,25416,1260,4020,6757,8423,4956,16844,15492,1352,15492,8661,6831,2021-01-01,zipcode,Birmingham
ZCTA5 35217,01,12906,39388,808,95700,10200,4506,8636,1664,3107,2795,661,409,5776,4759,1017,4759,2498,2261,2021-01-01,zipcode,Birmingham
ZCTA5 35218,01,7622,30725,855,64000,6226,3023,5459,970,1759,2207,368,155,3613,2755,858,2755,1123,1632,2021-01-01,zipcode,Birmingham
ZCTA5 35221,01,3787,34531,885,65200,3206,1684,2944,520,907,1219,250,48,2188,1517,671,1517,1030,487,2021-01-01,zipcode,Birmingham
ZCTA5 35222,01,8739,65665,861,332500,7173,2080,6464,334,772,1547,2001,1810,4335,3768,567,3768,2091,1677,2021-01-01,zipcode,Birmingham
ZCTA5 35223,01,11432,138438,2047,621100,9286,3961,8309,62,309,1066,3658,3214,4788,4514,274,4514,3972,542,2021-01-01,zipcode,Birmingham
ZCTA5 35224,01,5535,45679,876,67600,4348,1881,3606,323,1516,1393,293,81,2791,1971,820,1971,1072,899,2021-01-01,zipcode,Birmingham
ZCTA5 35226,01,38064,114509,1286,313800,29103,8560,26034,612,2287,5759,9607,7769,15036,14283,753,14283,11237,3046,2021-01-01,zipcode,Birmingham
ZCTA5 35228,01,10152,43283,877,71200,8223,3269,7055,891,2495,2206,1104,359,4579,3820,759,3820,2436,1384,2021-01-01,zipcode,Birmingham
ZCTA5 35229,01,1985,-666666666,-666666666,-666666666,1985,1177,5,0,0,5,0,0,0,0,0,0,0,0,2021-01-01,zipcode,Birmingham
ZCTA5 35233,01,2469,44394,1368,255100,2422,679,1503,38,148,84,343,890,2112,1596,516,1596,221,1375,2021-01-01,zipcode,Birmingham
ZCTA5 35234,01,4887,22774,639,59100,4312,2598,3949,930,1359,1290,329,41,2648,1941,707,1941,998,943,2021-01-01,zipcode,Birmingham
ZCTA5 35235,01,21357,58246,1131,129000,16194,5990,14328,861,4055,5403,2488,1521,9069,8290,779,8290,5630,2660,2021-01-01,zipcode,Birmingham
ZCTA5 35242,01,57077,107191,1211,380400,47124,15836,40402,1296,4119,8878,16692,9417,24789,23129,1660,23129,16847,6282,2021-01-01,zipcode,Birmingham
ZCTA5 35243,01,17532,93317,1416,394600,14468,4511,13289,118,1301,2486,5360,4024,10014,8474,1540,8474,4814,3660,2021-01-01,zipcode,Birmingham
ZCTA5 35244,01,36121,97668,1271,315400,28552,8980,24867,915,3434,6289,8229,6000,14710,13462,1248,13462,9611,3851,2021-01-01,zipcode,Birmingham
ZCTA5 35254,01,1395,-666666666,-666666666,-666666666,1395,934,0,0,0,0,0,0,0,0,0,0,0,0,2021-01-01,zipcode,Birmingham
ZCTA5 35401,01,36403,24209,827,115200,31969,17148,17352,2798,5803,4208,2538,2005,18856,12352,6504,12352,4150,8202,2021-01-01,zipcode,Tuscaloosa
ZCTA5 35404,01,23644,42387,934,137300,18779,7263,13555,1757,4942,3972,1684,1200,10942,8051,2891,8051,4331,3720,2021-01-01,zipcode,Tuscaloosa
ZCTA5 35405,01,47828,58695,942,185700,39016,12557,32189,2655,9076,9815,6822,3821,21729,18842,2887,18842,10292,8550,2021-01-01,zipcode,Tuscaloosa
ZCTA5 35406,01,18228,108188,1178,374500,14219,5361,12426,462,1200,2285,4242,4237,8155,7178,977,7178,5485,1693,2021-01-01,zipcode,Tuscaloosa
ZCTA5 35441,01,1170,45391,-666666666,66900,891,337,797,104,292,224,48,129,852,353,499,353,321,32,2021-01-01,zipcode,Akron
ZCTA5 35442,01,5798,30589,544,94400,4899,3129,4396,1042,1547,1161,482,164,2227,1713,514,1713,1033,680,2021-01-01,zipcode,Aliceville
ZCTA5 35443,01,1170,18578,491,54500,933,649,869,67,599,156,20,27,996,471,525,471,365,106,2021-01-01,zipcode,Boligee
ZCTA5 35444,01,4216,52875,787,132000,3357,1308,2884,385,1084,983,374,58,1761,1570,191,1570,1261,309,2021-01-01,zipcode,Brookwood
ZCTA5 35446,01,2168,49146,920,103800,1698,788,1520,285,558,501,137,39,751,724,27,724,608,116,2021-01-01,zipcode,Buhl
ZCTA5 35447,01,3173,39635,606,118800,2746,1459,2430,360,1188,642,156,84,1646,1220,426,1220,926,294,2021-01-01,zipcode,Carrollton
ZCTA5 35452,01,3886,57157,1285,160700,3196,1437,2701,363,936,1054,237,111,1708,1494,214,1494,1349,145,2021-01-01,zipcode,Coker
ZCTA5 35453,01,12163,65119,899,132500,9546,3518,8421,1252,3411,2470,755,533,5073,4294,779,4294,3543,751,2021-01-01,zipcode,Cottondale
ZCTA5 35456,01,4855,54135,862,153200,3739,1442,3165,529,1498,908,101,129,2002,1712,290,1712,1181,531,2021-01-01,zipcode,Duncanville
ZCTA5 35457,01,57,-666666666,-666666666,-666666666,57,0,57,0,57,0,0,0,57,57,0,57,57,0,2021-01-01,zipcode,Echola
ZCTA5 35458,01,742,-666666666,-666666666,409700,532,158,361,16,15,112,15,203,260,210,50,210,177,33,2021-01-01,zipcode,Elrod
ZCTA5 35459,01,976,31413,716,63700,873,504,705,149,273,185,55,43,522,432,90,432,329,103,2021-01-01,zipcode,Emelle
ZCTA5 35460,01,782,25300,-666666666,92400,601,403,478,8,197,208,65,0,382,322,60,322,255,67,2021-01-01,zipcode,Epes
ZCTA5 35461,01,1949,42100,1092,152200,1649,787,1451,181,652,403,148,67,1045,836,209,836,794,42,2021-01-01,zipcode,Ethelsville
ZCTA5 35462,01,4408,29817,600,90300,3476,2059,3307,660,835,1368,294,150,2326,1813,513,1813,1172,641,2021-01-01,zipcode,Eutaw
ZCTA5 35463,01,2143,56918,1087,165000,1763,535,1585,133,815,337,222,78,894,725,169,725,641,84,2021-01-01,zipcode,Fosters
ZCTA5 35464,01,642,13986,486,-666666666,458,291,264,27,88,88,61,0,252,158,94,158,52,106,2021-01-01,zipcode,Gainesville
ZCTA5 35466,01,5310,55572,571,108200,4098,1869,3499,401,1335,1200,307,256,2405,2015,390,2015,1751,264,2021-01-01,zipcode,Gordo
ZCTA5 35469,01,432,-666666666,-666666666,58400,337,210,299,25,29,143,85,17,217,217,0,217,166,51,2021-01-01,zipcode,Knoxville
ZCTA5 35470,01,5067,22586,639,126000,4159,2227,2457,223,785,826,262,361,2067,1632,435,1632,921,711,2021-01-01,zipcode,Livingston
ZCTA5 35473,01,19138,71931,791,190900,14657,4438,12227,1172,2746,3888,2767,1654,8234,7590,644,7590,4865,2725,2021-01-01,zipcode,Northport
ZCTA5 35474,01,7335,61053,826,134400,5760,1961,4648,638,1664,1134,615,597,2763,2244,519,2244,1977,267,2021-01-01,zipcode,Moundville
ZCTA5 35475,01,19533,90953,774,239400,14757,5136,13078,627,3955,4098,2715,1683,7771,6762,1009,6762,6262,500,2021-01-01,zipcode,Northport
ZCTA5 35476,01,7755,48805,865,156600,6283,2165,5532,601,1606,1955,821,549,3554,3071,483,3071,1238,1833,2021-01-01,zipcode,Northport
ZCTA5 35477,01,137,59531,-666666666,-666666666,89,29,89,0,46,37,6,0,48,33,15,33,33,0,2021-01-01,zipcode,Panola
ZCTA5 35480,01,1926,75545,-666666666,190700,1524,702,1156,197,399,378,161,21,581,505,76,505,443,62,2021-01-01,zipcode,Ralph
ZCTA5 35481,01,3308,42664,427,86300,2789,1396,2288,388,1106,593,112,89,1554,1300,254,1300,897,403,2021-01-01,zipcode,Reform
ZCTA5 35490,01,5445,62542,955,142400,4593,1657,3496,583,1426,1069,309,109,2148,1833,315,1833,1454,379,2021-01-01,zipcode,Vance
ZCTA5 35501,01,10045,41618,689,135900,7794,3569,6523,963,2212,2289,563,496,4550,3548,1002,3548,2121,1427,2021-01-01,zipcode,Jasper
ZCTA5 35503,01,9450,51314,646,126400,7712,3405,6882,1069,2202,2499,702,410,4320,3674,646,3674,3034,640,2021-01-01,zipcode,Jasper
ZCTA5 35504,01,13582,60547,614,165900,10780,4799,9385,1426,2577,3331,1329,722,5917,5207,710,5207,4010,1197,2021-01-01,zipcode,Jasper
ZCTA5 35540,01,2410,47180,521,107300,1857,755,1695,213,689,591,145,57,1139,969,170,969,811,158,2021-01-01,zipcode,Addison
ZCTA5 35541,01,3707,52008,753,153600,3205,1707,2847,410,976,922,308,231,2576,1480,1096,1480,1271,209,2021-01-01,zipcode,Arley
ZCTA5 35542,01,888,27609,708,60300,736,405,584,109,210,231,32,2,439,372,67,372,337,35,2021-01-01,zipcode,Bankston
ZCTA5 35543,01,1266,22361,569,67300,929,530,797,312,262,141,56,26,596,472,124,472,342,130,2021-01-01,zipcode,Bear creek
ZCTA5 35544,01,794,49009,773,-666666666,745,376,734,162,208,217,118,29,368,330,38,330,225,105,2021-01-01,zipcode,Beaverton
ZCTA5 35545,01,165,41250,-666666666,92900,139,83,117,44,36,32,3,2,62,59,3,59,44,15,2021-01-01,zipcode,Belk
ZCTA5 35546,01,3784,53663,516,114200,2968,1469,2555,378,1030,815,190,142,1649,1380,269,1380,1190,190,2021-01-01,zipcode,Berry
ZCTA5 35548,01,2066,42018,356,62900,1767,785,1494,377,478,496,106,37,974,849,125,849,702,147,2021-01-01,zipcode,Brilliant
ZCTA5 35549,01,3152,40357,607,58200,2653,1242,2290,433,830,908,72,47,1836,1446,390,1446,1096,350,2021-01-01,zipcode,Carbon hill
ZCTA5 35550,01,5184,45000,439,83000,4142,2252,3747,604,1393,1343,251,156,2389,1956,433,1956,1607,349,2021-01-01,zipcode,Cordova
ZCTA5 35552,01,1331,49344,335,68200,1028,319,826,63,352,249,148,14,586,464,122,464,406,58,2021-01-01,zipcode,Detroit
ZCTA5 35553,01,4882,43676,522,75900,3872,1964,3102,727,1270,707,170,228,2408,1772,636,1772,1433,339,2021-01-01,zipcode,Double springs
ZCTA5 35554,01,1074,40761,596,79400,854,409,756,115,336,266,33,6,523,408,115,408,343,65,2021-01-01,zipcode,Eldridge
ZCTA5 35555,01,9688,47923,546,103100,8012,3862,7045,964,2886,2133,773,289,4866,3693,1173,3693,2525,1168,2021-01-01,zipcode,Fayette
ZCTA5 35559,01,64,-666666666,-666666666,-666666666,61,9,48,0,38,10,0,0,12,12,0,12,2,10,2021-01-01,zipcode,Glen allen
ZCTA5 35563,01,3816,43605,656,96700,3088,1390,2587,304,933,1020,181,149,1898,1386,512,1386,1103,283,2021-01-01,zipcode,Guin
ZCTA5 35564,01,2114,32485,548,90000,1657,844,1437,245,484,565,106,37,1098,851,247,851,644,207,2021-01-01,zipcode,Hackleburg
ZCTA5 35565,01,11431,40682,601,78000,9197,4442,8343,2011,3250,2264,371,447,5712,4448,1264,4448,3371,1077,2021-01-01,zipcode,Haleyville
ZCTA5 35570,01,11097,45154,536,96800,9509,4966,8133,1621,2961,2522,641,388,5276,4281,995,4281,2832,1449,2021-01-01,zipcode,Hamilton
ZCTA5 35571,01,754,56458,-666666666,82500,568,260,492,77,199,147,45,24,388,248,140,248,211,37,2021-01-01,zipcode,Hodges
ZCTA5 35572,01,1426,60243,-666666666,268200,1364,662,1217,308,569,223,76,41,1076,677,399,677,633,44,2021-01-01,zipcode,Houston
ZCTA5 35574,01,1411,54375,313,116800,1124,615,1099,218,575,247,27,32,713,520,193,520,457,63,2021-01-01,zipcode,Kennedy
ZCTA5 35575,01,1020,43289,691,77500,820,421,788,149,298,253,39,49,527,434,93,434,356,78,2021-01-01,zipcode,Lynn
ZCTA5 35576,01,3356,60815,498,113100,2733,1147,2355,308,987,794,158,108,1623,1233,390,1233,1066,167,2021-01-01,zipcode,Millport
ZCTA5 35577,01,3,-666666666,-666666666,-666666666,3,3,3,0,1,2,0,0,2,2,0,2,2,0,2021-01-01,zipcode,Natural bridge
ZCTA5 35578,01,5331,42420,921,97600,4215,2202,3624,730,1450,976,265,203,2478,2014,464,2014,1742,272,2021-01-01,zipcode,Nauvoo
ZCTA5 35579,01,3597,42298,458,94100,2894,1653,2650,507,1190,784,145,24,1610,1267,343,1267,1062,205,2021-01-01,zipcode,Oakman
ZCTA5 35580,01,3817,50053,624,88700,3056,1280,2792,677,1017,742,204,152,1788,1426,362,1426,1220,206,2021-01-01,zipcode,Parrish
ZCTA5 35581,01,5925,46034,649,85600,4463,2221,3852,770,1609,1057,259,157,2359,1858,501,1858,1372,486,2021-01-01,zipcode,Phil campbell
ZCTA5 35582,01,4590,35336,477,82700,3549,1599,3258,574,1257,674,599,154,2326,1880,446,1880,1312,568,2021-01-01,zipcode,Red bay
ZCTA5 35584,01,262,20592,890,48700,196,143,173,69,59,41,0,4,126,91,35,91,68,23,2021-01-01,zipcode,Sipsey
ZCTA5 35585,01,1728,46351,-666666666,206400,1133,587,1003,176,198,299,263,67,633,502,131,502,391,111,2021-01-01,zipcode,Spruce pine
ZCTA5 35586,01,3851,38172,473,78800,2935,1260,2568,434,986,927,119,102,1936,1468,468,1468,1094,374,2021-01-01,zipcode,Sulligent
ZCTA5 35587,01,616,37292,719,-666666666,532,309,532,200,231,89,0,12,373,258,115,258,193,65,2021-01-01,zipcode,Townley
ZCTA5 35592,01,4127,36019,436,114100,3403,2011,3041,613,1358,770,179,121,2410,1698,712,1698,970,728,2021-01-01,zipcode,Vernon
ZCTA5 35593,01,1713,52895,588,88400,1446,685,1280,169,651,261,98,101,803,614,189,614,507,107,2021-01-01,zipcode,Vina
ZCTA5 35594,01,7198,56125,635,127600,5730,2556,5216,769,1759,1870,415,403,3308,2565,743,2565,1936,629,2021-01-01,zipcode,Winfield
ZCTA5 35601,01,34682,45776,723,110300,27039,11339,23193,5426,6914,6293,3204,1356,14937,13231,1706,13231,7934,5297,2021-01-01,zipcode,Decatur
ZCTA5 35603,01,32186,65453,729,182600,26120,10914,22940,2137,6489,7843,4216,2255,14444,13724,720,13724,10038,3686,2021-01-01,zipcode,Decatur
ZCTA5 35610,01,1799,63472,542,157900,1644,665,1343,146,568,355,114,160,762,687,75,687,581,106,2021-01-01,zipcode,Anderson
ZCTA5 35611,01,26761,48178,701,149800,22099,9646,19305,3332,5723,6167,2821,1262,13176,11416,1760,11416,6975,4441,2021-01-01,zipcode,Athens
ZCTA5 35613,01,20475,84512,1003,225000,16788,6699,15090,1548,3505,5048,3514,1475,8151,7803,348,7803,6745,1058,2021-01-01,zipcode,Athens
ZCTA5 35614,01,6950,49722,885,131900,5423,2349,4650,766,1851,1249,474,310,3040,2592,448,2592,2005,587,2021-01-01,zipcode,Athens
ZCTA5 35615,01,0,-666666666,-666666666,-666666666,0,0,0,0,0,0,0,0,0,0,0,0,0,0,2021-01-01,zipcode,Belle mina
ZCTA5 35616,01,3519,45326,754,85200,2794,1184,2473,485,987,683,140,178,2109,1438,671,1438,1013,425,2021-01-01,zipcode,Cherokee
ZCTA5 35618,01,2148,41415,527,88700,1730,1021,1487,219,596,441,120,111,1000,834,166,834,614,220,2021-01-01,zipcode,Courtland
ZCTA5 35619,01,4703,53879,873,139500,3795,1728,3348,795,1321,898,229,105,2205,1723,482,1723,1326,397,2021-01-01,zipcode,Danville
ZCTA5 35620,01,11572,73232,841,148500,9517,3249,7764,891,2799,3044,541,489,4692,4248,444,4248,3655,593,2021-01-01,zipcode,Elkmont
ZCTA5 35621,01,2932,71125,930,139700,2170,778,1909,285,516,621,395,92,1078,1032,46,1032,888,144,2021-01-01,zipcode,Eva
ZCTA5 35622,01,7331,51062,770,115800,5336,2378,4746,587,2171,1406,388,194,2931,2461,470,2461,1732,729,2021-01-01,zipcode,Falkville
ZCTA5 35630,01,32632,36164,693,127400,26987,11852,21463,2863,7497,5904,3264,1935,17175,14573,2602,14573,5990,8583,2021-01-01,zipcode,Florence
ZCTA5 35633,01,20454,58758,735,141500,16716,7288,14601,1755,4896,4160,2365,1425,9211,8210,1001,8210,6882,1328,2021-01-01,zipcode,Florence
ZCTA5 35634,01,10375,73188,811,206800,8535,3812,7658,491,2576,2177,1497,917,4826,4084,742,4084,3332,752,2021-01-01,zipcode,Florence
ZCTA5 35640,01,26780,61193,692,150300,21577,9278,18474,1946,6386,5939,2770,1433,11114,9942,1172,9942,8015,1927,2021-01-01,zipcode,Hartselle
ZCTA5 35643,01,4061,46594,663,102600,3298,1509,2981,1018,1064,538,218,143,1743,1542,201,1542,1351,191,2021-01-01,zipcode,Hillsboro
ZCTA5 35645,01,13206,74809,698,192600,10337,3862,9320,619,3329,2791,1732,849,5611,4929,682,4929,4145,784,2021-01-01,zipcode,Killen
ZCTA5 35646,01,4327,50714,626,98300,3768,1934,3385,659,1563,922,130,111,2360,1814,546,1814,1521,293,2021-01-01,zipcode,Leighton
ZCTA5 35647,01,1191,69757,694,127200,883,363,705,109,279,155,132,30,386,379,7,379,338,41,2021-01-01,zipcode,Lester
ZCTA5 35648,01,3325,60920,594,115800,2774,1215,2322,353,855,701,201,212,1429,1223,206,1223,993,230,2021-01-01,zipcode,Lexington
ZCTA5 35649,01,83,-666666666,-666666666,296400,74,41,71,2,8,12,30,19,35,32,3,32,32,0,2021-01-01,zipcode,Mooresville
ZCTA5 35650,01,12996,55199,558,133800,10482,5037,9176,1456,3765,2283,1000,672,5905,4980,925,4980,3988,992,2021-01-01,zipcode,Moulton
ZCTA5 35651,01,1441,60893,-666666666,173400,1256,659,1029,137,414,188,280,10,611,474,137,474,398,76,2021-01-01,zipcode,Mount hope
ZCTA5 35652,01,9350,59861,784,149300,7625,3048,6610,847,2421,1752,1048,542,4568,3664,904,3664,2945,719,2021-01-01,zipcode,Rogersville
ZCTA5 35653,01,10904,44067,598,90100,8445,3153,7056,1987,2863,1477,477,252,4603,3536,1067,3536,2397,1139,2021-01-01,zipcode,Russellville
ZCTA5 35654,01,7939,40997,556,138300,6244,3092,5397,982,2571,1220,443,181,3629,2903,726,2903,1966,937,2021-01-01,zipcode,Russellville
ZCTA5 35660,01,9438,37372,725,106300,7851,3862,6759,1078,2370,2177,696,438,5271,4282,989,4282,2484,1798,2021-01-01,zipcode,Sheffield
ZCTA5 35661,01,18799,63319,898,151700,15336,6002,13775,1302,4490,5068,1854,1061,8597,7466,1131,7466,6054,1412,2021-01-01,zipcode,Muscle shoals
ZCTA5 35670,01,6667,55559,664,155000,5233,2179,4654,865,1317,1562,732,178,3119,2383,736,2383,1792,591,2021-01-01,zipcode,Somerville
ZCTA5 35671,01,1874,46218,384,85800,1596,663,1346,253,619,255,151,68,889,654,235,654,517,137,2021-01-01,zipcode,Tanner
ZCTA5 35672,01,5391,52996,567,120600,4118,1964,3547,376,1520,1199,273,179,2630,2009,621,2009,1461,548,2021-01-01,zipcode,Town creek
ZCTA5 35673,01,7350,63278,671,150900,5912,2318,5191,441,2199,1860,470,221,3269,2685,584,2685,2042,643,2021-01-01,zipcode,Trinity
ZCTA5 35674,01,19841,53087,731,130200,15678,6671,13430,1660,5606,3591,1638,935,8640,7321,1319,7321,5043,2278,2021-01-01,zipcode,Tuscumbia
ZCTA5 35677,01,2120,42466,-666666666,-666666666,1799,959,1412,215,574,414,104,105,1159,771,388,771,699,72,2021-01-01,zipcode,Waterloo
ZCTA5 35739,01,4887,54260,716,157200,4129,1786,3674,547,1587,904,347,289,2288,2129,159,2129,1727,402,2021-01-01,zipcode,Ardmore
ZCTA5 35740,01,3371,39925,380,104300,2815,1570,2440,379,1060,705,229,67,1719,1493,226,1493,942,551,2021-01-01,zipcode,Bridgeport
ZCTA5 35741,01,3415,81857,1009,274300,3267,1281,2932,170,466,402,1419,475,1789,1703,86,1703,1352,351,2021-01-01,zipcode,Brownsboro
ZCTA5 35744,01,1995,40938,691,121600,1809,853,1547,274,691,462,63,57,829,705,124,705,526,179,2021-01-01,zipcode,Dutton
ZCTA5 35745,01,100,34000,-666666666,168800,100,59,88,5,59,12,6,6,138,56,82,56,48,8,2021-01-01,zipcode,Estillfork
ZCTA5 35746,01,570,37250,-666666666,-666666666,570,376,552,177,233,82,32,28,380,272,108,272,272,0,2021-01-01,zipcode,Fackler
ZCTA5 35747,01,5930,75903,706,180100,4702,1840,4089,496,1289,1202,728,374,3211,2287,924,2287,2017,270,2021-01-01,zipcode,Grant
ZCTA5 35748,01,7338,85855,690,257600,6070,2432,5257,453,1558,1192,1270,784,3077,2834,243,2834,2455,379,2021-01-01,zipcode,Gurley
ZCTA5 35749,01,27196,101941,1046,204700,22187,8717,18734,2049,3852,5731,4461,2641,9573,8869,704,8869,8033,836,2021-01-01,zipcode,Harvest
ZCTA5 35750,01,13349,60610,917,148700,10762,3982,9317,1329,3091,2507,1771,619,5492,5003,489,5003,3824,1179,2021-01-01,zipcode,Hazel green
ZCTA5 35751,01,264,41875,-666666666,208100,230,83,170,0,75,47,35,13,118,94,24,94,94,0,2021-01-01,zipcode,Hollytree
ZCTA5 35752,01,2091,38182,815,76400,1781,894,1604,215,716,466,98,109,1138,936,202,936,646,290,2021-01-01,zipcode,Hollywood
ZCTA5 35754,01,5699,73824,656,170600,4886,2011,4224,797,980,1167,786,494,2515,2260,255,2260,1785,475,2021-01-01,zipcode,Laceys spring
ZCTA5 35755,01,455,39449,486,-666666666,420,227,328,18,68,159,49,34,420,205,215,205,139,66,2021-01-01,zipcode,Langston
ZCTA5 35756,01,22410,111070,1333,237600,16200,5291,14197,614,1638,3770,4975,3200,8417,7855,562,7855,6663,1192,2021-01-01,zipcode,Madison
ZCTA5 35757,01,17829,95239,1210,225800,13617,4165,12061,808,1590,3510,3831,2322,6617,6344,273,6344,5282,1062,2021-01-01,zipcode,Madison
ZCTA5 35758,01,47184,94132,1106,264500,36887,12440,32493,1010,3950,7311,11135,9087,19710,19142,568,19142,13168,5974,2021-01-01,zipcode,Madison
ZCTA5 35759,01,10557,89165,1281,207700,8381,2606,7363,624,1780,1966,2149,844,4087,3967,120,3967,3770,197,2021-01-01,zipcode,Meridianville
ZCTA5 35760,01,5077,59297,728,136200,3591,1281,3187,573,969,890,633,122,1885,1731,154,1731,1372,359,2021-01-01,zipcode,New hope
ZCTA5 35761,01,13187,68864,910,163600,9891,3409,8646,1007,2087,3176,1824,552,5130,4780,350,4780,4006,774,2021-01-01,zipcode,New market
ZCTA5 35763,01,19328,118683,1719,295500,14537,5309,13158,537,2028,2505,4518,3570,7139,7010,129,7010,6429,581,2021-01-01,zipcode,Owens cross roads
ZCTA5 35764,01,557,35605,625,75600,519,316,473,135,277,51,8,2,310,259,51,259,223,36,2021-01-01,zipcode,Paint rock
ZCTA5 35765,01,4768,49777,573,122000,3723,1997,3332,661,988,948,336,399,2051,1681,370,1681,1409,272,2021-01-01,zipcode,Pisgah
ZCTA5 35766,01,231,77788,-666666666,75800,205,49,191,23,136,22,6,4,119,79,40,79,56,23,2021-01-01,zipcode,Princeton
ZCTA5 35768,01,12851,43621,633,113000,10444,5451,8948,1593,3733,2305,784,533,5639,4743,896,4743,3115,1628,2021-01-01,zipcode,Scottsboro
ZCTA5 35769,01,9810,48660,685,137300,8000,3680,7188,740,2034,2491,1275,648,4935,4123,812,4123,3307,816,2021-01-01,zipcode,Scottsboro
ZCTA5 35771,01,3071,56453,635,98000,2315,935,2117,462,698,684,181,92,1444,1102,342,1102,920,182,2021-01-01,zipcode,Section
ZCTA5 35772,01,4895,37231,696,95900,3816,2078,3478,792,1317,863,358,148,2325,1856,469,1856,1372,484,2021-01-01,zipcode,Stevenson
ZCTA5 35773,01,14089,56635,798,138800,11598,4008,10844,937,3553,3585,1711,1058,5801,5475,326,5475,4756,719,2021-01-01,zipcode,Toney
ZCTA5 35774,01,199,78077,-666666666,90000,199,123,160,0,73,60,13,14,71,58,13,58,58,0,2021-01-01,zipcode,Trenton
ZCTA5 35775,01,554,40559,-666666666,82700,431,214,399,79,136,128,34,22,256,207,49,207,197,10,2021-01-01,zipcode,Valhermoso springs
ZCTA5 35776,01,3447,44868,516,111600,2801,1425,2452,340,982,746,258,126,1609,1322,287,1322,1112,210,2021-01-01,zipcode,Woodville
ZCTA5 35801,01,25145,85880,986,312300,21405,8751,18816,2042,2906,3906,6088,3874,11518,10555,963,10555,6885,3670,2021-01-01,zipcode,Huntsville
ZCTA5 35802,01,23629,64208,924,249700,19738,7511,17452,729,2347,5738,5049,3589,12352,11209,1143,11209,5918,5291,2021-01-01,zipcode,Huntsville
ZCTA5 35803,01,27990,84951,998,196100,22761,9022,20241,773,3582,5465,6368,4053,12738,11846,892,11846,9537,2309,2021-01-01,zipcode,Huntsville
ZCTA5 35805,01,20033,28232,702,83500,15452,5825,12690,2910,3299,4138,1591,752,10305,9252,1053,9252,2916,6336,2021-01-01,zipcode,Huntsville
ZCTA5 35806,01,26199,66702,1090,237500,22054,6186,17609,821,2102,4567,6079,4040,13423,12886,537,12886,6113,6773,2021-01-01,zipcode,Huntsville
ZCTA5 35808,01,1218,105781,1578,-666666666,980,268,715,0,125,274,154,162,388,379,9,379,13,366,2021-01-01,zipcode,Huntsville
ZCTA5 35810,01,31735,40395,942,91800,24689,10555,20760,3022,5655,7353,3202,1528,13194,12067,1127,12067,7870,4197,2021-01-01,zipcode,Huntsville
ZCTA5 35811,01,28129,75303,878,196900,23715,8893,19196,1422,4106,7372,4259,2037,12002,11011,991,11011,8308,2703,2021-01-01,zipcode,Huntsville
ZCTA5 35816,01,14440,29162,764,91200,12310,4633,8477,1264,1910,2782,1648,873,7736,6758,978,6758,1948,4810,2021-01-01,zipcode,Huntsville
ZCTA5 35824,01,9129,93857,1000,267700,7905,2001,6674,118,733,1711,1898,2214,4464,4218,246,4218,2239,1979,2021-01-01,zipcode,Huntsville
ZCTA5 35896,01,619,-666666666,-666666666,-666666666,619,351,0,0,0,0,0,0,0,0,0,0,0,0,2021-01-01,zipcode,Huntsville
ZCTA5 35901,01,18827,40350,659,144600,15065,6984,12846,1914,3739,4109,1888,1196,9047,7123,1924,7123,4606,2517,2021-01-01,zipcode,Gadsden
ZCTA5 35903,01,18240,44003,720,127200,15537,6183,13014,1759,4148,4998,1261,848,8758,7051,1707,7051,4579,2472,2021-01-01,zipcode,Gadsden
ZCTA5 35904,01,13571,39267,690,79900,10847,5317,9562,1335,3869,3104,809,445,6435,5056,1379,5056,3856,1200,2021-01-01,zipcode,Gadsden
ZCTA5 35905,01,5934,59576,718,158200,4690,2114,4175,283,1284,1522,473,613,2836,2196,640,2196,1865,331,2021-01-01,zipcode,Gadsden
ZCTA5 35906,01,10309,51975,847,169200,8013,3392,7180,759,2197,2332,1262,630,4689,3882,807,3882,2305,1577,2021-01-01,zipcode,Rainbow city
ZCTA5 35907,01,9138,66730,999,161500,7179,2844,6553,547,1967,2604,868,567,3272,2971,301,2971,2696,275,2021-01-01,zipcode,Gadsden
ZCTA5 35950,01,20816,49508,772,121300,15092,5817,12972,2838,3594,4056,1675,809,7724,7185,539,7185,4731,2454,2021-01-01,zipcode,Albertville
ZCTA5 35951,01,13348,45543,663,123400,10308,4825,8822,2269,2882,2500,819,352,5327,4526,801,4526,3387,1139,2021-01-01,zipcode,Albertville
ZCTA5 35952,01,8682,42615,639,107000,6967,3240,6277,1450,2395,1725,507,200,3716,3221,495,3221,2574,647,2021-01-01,zipcode,Altoona
ZCTA5 35953,01,6967,53657,951,151300,6082,3149,5590,1067,2340,1866,165,152,3513,2770,743,2770,2252,518,2021-01-01,zipcode,Ashville
ZCTA5 35954,01,12551,46985,623,101300,10342,4682,8911,1499,3530,3050,478,354,5801,4642,1159,4642,3782,860,2021-01-01,zipcode,Attalla
ZCTA5 35956,01,8562,53497,721,146800,6765,3147,5735,873,1990,1971,498,403,3730,2983,747,2983,2365,618,2021-01-01,zipcode,Boaz
ZCTA5 35957,01,16240,42411,596,104100,12184,5286,10351,1658,3669,3479,1027,518,6871,5961,910,5961,4020,1941,2021-01-01,zipcode,Boaz
ZCTA5 35958,01,3403,47763,540,134900,2653,1386,2264,435,947,473,257,152,1335,1186,149,1186,979,207,2021-01-01,zipcode,Bryant
ZCTA5 35959,01,4212,37717,557,156400,3466,1912,3221,546,1256,897,251,271,3411,1774,1637,1774,1428,346,2021-01-01,zipcode,Cedar bluff
ZCTA5 35960,01,8459,40672,697,155700,7409,3844,6730,1394,2353,2011,418,554,5381,3452,1929,3452,2579,873,2021-01-01,zipcode,Centre
ZCTA5 35961,01,6144,38714,604,77700,4898,2261,4141,1297,1438,1094,116,196,2540,2049,491,2049,1481,568,2021-01-01,zipcode,Collinsville
ZCTA5 35962,01,8139,48100,758,125700,6514,2825,5575,1642,1877,1390,320,346,3411,2846,565,2846,2099,747,2021-01-01,zipcode,Crossville
ZCTA5 35963,01,1137,50938,-666666666,-666666666,979,331,913,84,309,430,63,27,548,495,53,495,375,120,2021-01-01,zipcode,Dawson
ZCTA5 35966,01,3336,43355,494,113900,2827,1424,2417,769,754,683,159,52,1732,1259,473,1259,1070,189,2021-01-01,zipcode,Flat rock
ZCTA5 35967,01,16649,44027,645,122400,12628,5419,11072,2300,3421,3400,1086,865,7603,6287,1316,6287,4319,1968,2021-01-01,zipcode,Fort payne
ZCTA5 35968,01,5237,43068,634,110000,4188,1996,3552,801,1399,935,261,156,2088,1766,322,1766,1341,425,2021-01-01,zipcode,Fort payne
ZCTA5 35971,01,5661,41800,709,104200,4691,2355,3903,758,1547,1292,190,116,2067,1928,139,1928,1369,559,2021-01-01,zipcode,Fyffe
ZCTA5 35972,01,1036,-666666666,-666666666,76600,813,435,722,194,226,185,54,63,557,463,94,463,417,46,2021-01-01,zipcode,Gallant
ZCTA5 35973,01,3577,48750,954,79100,2771,1336,2235,541,753,761,149,31,1408,1120,288,1120,935,185,2021-01-01,zipcode,Gaylesville
ZCTA5 35974,01,1749,58632,634,158500,1341,430,1204,154,381,408,133,128,711,644,67,644,443,201,2021-01-01,zipcode,Geraldine
ZCTA5 35975,01,1306,32917,673,152600,1058,495,866,46,487,252,51,30,449,449,0,449,411,38,2021-01-01,zipcode,Groveoak
ZCTA5 35976,01,17292,60315,678,199400,14319,6978,12514,1725,3207,3601,2962,1019,7696,6683,1013,6683,5219,1464,2021-01-01,zipcode,Guntersville
ZCTA5 35978,01,5538,48182,901,119400,4137,1850,3804,594,1660,1095,299,156,2210,1804,406,1804,1443,361,2021-01-01,zipcode,Henagar
ZCTA5 35979,01,1005,-666666666,-666666666,132800,779,348,610,113,269,194,14,20,464,382,82,382,346,36,2021-01-01,zipcode,Higdon
ZCTA5 35980,01,6208,52677,703,121600,4689,2187,3822,829,1449,887,354,303,2167,1915,252,1915,1571,344,2021-01-01,zipcode,Horton
ZCTA5 35981,01,2015,37560,-666666666,97600,1759,796,1459,294,620,325,206,14,856,649,207,649,502,147,2021-01-01,zipcode,Ider
ZCTA5 35983,01,3966,58867,634,151700,3257,1588,2863,291,1150,1034,213,175,2192,1488,704,1488,1261,227,2021-01-01,zipcode,Leesburg
ZCTA5 35984,01,1401,37837,830,161300,1309,714,1287,174,344,281,237,251,1542,747,795,747,560,187,2021-01-01,zipcode,Mentone
ZCTA5 35986,01,7844,52467,578,161300,6296,2585,5373,986,1399,1956,782,250,3458,3075,383,3075,2372,703,2021-01-01,zipcode,Rainsville
ZCTA5 35987,01,2483,62703,-666666666,119500,1935,869,1672,348,708,446,123,47,1083,932,151,932,738,194,2021-01-01,zipcode,Steele
ZCTA5 35988,01,2423,45081,587,91200,1934,706,1493,269,479,417,244,84,900,802,98,802,553,249,2021-01-01,zipcode,Sylvania
ZCTA5 35989,01,3750,43684,612,78300,2790,1442,2363,518,770,751,201,123,1452,1288,164,1288,1078,210,2021-01-01,zipcode,Valley head
ZCTA5 35990,01,0,-666666666,-666666666,-666666666,0,0,0,0,0,0,0,0,12,0,12,0,0,0,2021-01-01,zipcode,Walnut grove
ZCTA5 36003,01,2397,28023,410,108700,1962,1231,1792,402,687,530,60,113,1267,1056,211,1056,851,205,2021-01-01,zipcode,Autaugaville
ZCTA5 36005,01,1486,41797,847,118100,1267,617,1045,193,363,261,142,86,874,563,311,563,479,84,2021-01-01,zipcode,Banks
ZCTA5 36006,01,1685,-666666666,1043,171900,1396,623,1319,125,530,520,120,24,813,699,114,699,643,56,2021-01-01,zipcode,Billingsley
ZCTA5 36009,01,2233,44762,562,89200,1846,939,1617,169,806,303,217,122,1189,866,323,866,628,238,2021-01-01,zipcode,Brantley
ZCTA5 36010,01,5316,36384,620,109000,4238,2133,3666,660,1732,717,365,192,2767,1852,915,1852,1243,609,2021-01-01,zipcode,Brundidge
ZCTA5 36013,01,395,105200,-666666666,368900,323,167,291,54,58,148,14,17,164,148,16,148,148,0,2021-01-01,zipcode,Cecil
ZCTA5 36016,01,4990,48289,594,56700,4270,2642,3924,1031,1655,1000,178,60,1969,1484,485,1484,975,509,2021-01-01,zipcode,Clayton
ZCTA5 36017,01,3257,29637,414,56000,2825,2080,2595,942,949,539,115,50,1018,791,227,791,498,293,2021-01-01,zipcode,Clio
ZCTA5 36020,01,1119,48750,1009,156700,906,431,767,107,268,245,98,49,481,414,67,414,307,107,2021-01-01,zipcode,Coosada
ZCTA5 36022,01,15336,74158,1018,180900,11773,3819,10129,653,3242,3626,1819,789,5888,5373,515,5373,4717,656,2021-01-01,zipcode,Deatsville
ZCTA5 36024,01,5152,51684,728,218100,4478,2078,4046,366,1587,1268,566,259,3450,2208,1242,2208,1744,464,2021-01-01,zipcode,Eclectic
ZCTA5 36025,01,7267,46227,1032,150400,6452,4434,5860,1772,2135,1108,608,237,1733,1581,152,1581,1129,452,2021-01-01,zipcode,Elmore
ZCTA5 36026,01,1239,89375,-666666666,283700,1163,591,1099,77,314,412,287,9,973,541,432,541,522,19,2021-01-01,zipcode,Equality
ZCTA5 36027,01,14825,36761,621,109200,11604,5568,9817,1958,3294,3100,828,637,7188,5768,1420,5768,3370,2398,2021-01-01,zipcode,Eufaula
ZCTA5 36028,01,1501,38269,525,109600,1310,771,1138,253,290,330,199,66,867,588,279,588,384,204,2021-01-01,zipcode,Dozier
ZCTA5 36029,01,1188,57800,-666666666,153800,950,341,892,175,356,163,131,67,393,334,59,334,277,57,2021-01-01,zipcode,Fitzpatrick
ZCTA5 36030,01,425,-666666666,659,113300,377,233,335,9,242,59,18,7,256,126,130,126,103,23,2021-01-01,zipcode,Forest home
ZCTA5 36031,01,107,-666666666,-666666666,-666666666,87,62,58,0,52,6,0,0,26,26,0,26,26,0,2021-01-01,zipcode,Fort davis
ZCTA5 36032,01,2355,30671,416,62600,1759,926,1500,311,747,305,55,82,1100,862,238,862,631,231,2021-01-01,zipcode,Fort deposit
ZCTA5 36033,01,3544,37967,635,77300,2851,1484,2634,412,1206,655,246,115,2198,1306,892,1306,1021,285,2021-01-01,zipcode,Georgiana
ZCTA5 36034,01,975,34917,575,77800,745,338,604,45,251,176,85,47,431,309,122,309,266,43,2021-01-01,zipcode,Glenwood
ZCTA5 36035,01,1972,46518,800,101900,1510,671,1292,148,561,273,202,108,1125,733,392,733,632,101,2021-01-01,zipcode,Goshen
ZCTA5 36036,01,1933,43897,828,119000,1812,994,1490,376,488,344,127,155,1038,743,295,743,634,109,2021-01-01,zipcode,Grady
ZCTA5 36037,01,13194,47467,684,96600,10471,4612,9064,1340,4028,2404,684,608,6263,4345,1918,4345,2984,1361,2021-01-01,zipcode,Greenville
ZCTA5 36038,01,80,76250,-666666666,-666666666,73,41,71,5,26,29,11,0,33,25,8,25,23,2,2021-01-01,zipcode,Gantt
ZCTA5 36039,01,279,50761,-666666666,-666666666,279,147,240,57,89,78,16,0,137,92,45,92,46,46,2021-01-01,zipcode,Hardaway
ZCTA5 36040,01,3762,30521,717,67600,3092,1644,2645,440,1175,603,235,192,1519,1345,174,1345,879,466,2021-01-01,zipcode,Hayneville
ZCTA5 36041,01,1423,40407,615,100300,1101,556,916,181,366,251,101,17,746,530,216,530,474,56,2021-01-01,zipcode,Highland home
ZCTA5 36042,01,1188,65833,-666666666,98800,901,334,814,112,352,217,93,40,789,404,385,404,370,34,2021-01-01,zipcode,Honoraville
ZCTA5 36043,01,3805,79044,1054,199900,3304,1465,2651,433,888,680,341,309,1564,1307,257,1307,1097,210,2021-01-01,zipcode,Hope hull
ZCTA5 36046,01,1556,43229,-666666666,112100,1205,509,1027,260,337,308,62,60,581,491,90,491,470,21,2021-01-01,zipcode,Lapine
ZCTA5 36047,01,940,-666666666,-666666666,54400,900,395,834,112,292,347,57,26,532,385,147,385,375,10,2021-01-01,zipcode,Letohatchee
ZCTA5 36048,01,1243,25625,575,-666666666,1121,545,1022,252,469,226,58,17,796,581,215,581,403,178,2021-01-01,zipcode,Louisville
ZCTA5 36049,01,5984,46909,623,83400,4835,2215,4288,814,1763,917,582,212,2593,1941,652,1941,1452,489,2021-01-01,zipcode,Luverne
ZCTA5 36051,01,3080,71314,949,59200,2338,723,2122,226,1009,731,85,71,1145,1004,141,1004,846,158,2021-01-01,zipcode,Marbury
ZCTA5 36052,01,668,113594,-666666666,591300,616,224,537,23,102,111,187,114,382,357,25,357,325,32,2021-01-01,zipcode,Mathews
ZCTA5 36053,01,2419,31196,491,82800,2069,1127,1668,335,623,581,51,78,1280,910,370,910,696,214,2021-01-01,zipcode,Midway
ZCTA5 36054,01,15362,53877,868,142300,11503,4558,9418,1010,3030,3018,1542,818,6180,5706,474,5706,3867,1839,2021-01-01,zipcode,Millbrook
ZCTA5 36064,01,12737,108385,1338,301500,9130,2486,8045,296,1298,2031,2552,1868,4753,4305,448,4305,3668,637,2021-01-01,zipcode,Pike road
ZCTA5 36066,01,21383,67166,1166,184900,17436,6383,14260,954,3342,3699,3601,2664,8957,8677,280,8677,5238,3439,2021-01-01,zipcode,Prattville
ZCTA5 36067,01,27717,57554,892,143600,22148,9553,19015,2384,6734,5663,2473,1761,11197,9971,1226,9971,7510,2461,2021-01-01,zipcode,Prattville
ZCTA5 36069,01,1950,41549,822,99500,1772,898,1540,256,536,453,176,119,1213,919,294,919,704,215,2021-01-01,zipcode,Ramer
ZCTA5 36071,01,356,39659,630,101000,293,183,286,49,142,32,43,20,256,163,93,163,131,32,2021-01-01,zipcode,Rutledge
ZCTA5 36075,01,1770,41875,808,83900,1586,931,1449,267,549,454,104,75,913,731,182,731,629,102,2021-01-01,zipcode,Shorter
ZCTA5 36078,01,13346,58470,785,152800,11118,4751,9297,1368,3275,3072,1065,517,5840,5207,633,5207,3646,1561,2021-01-01,zipcode,Tallassee
ZCTA5 36079,01,9397,51472,879,127000,7498,3225,6534,900,2274,1635,891,834,4305,3340,965,3340,2646,694,2021-01-01,zipcode,Troy
ZCTA5 36080,01,2413,73517,876,199300,1907,858,1803,333,658,403,277,132,1058,843,215,843,680,163,2021-01-01,zipcode,Titus
ZCTA5 36081,01,15653,33829,680,152200,13154,6178,7808,734,2487,1890,1618,1079,7736,5606,2130,5606,2493,3113,2021-01-01,zipcode,Troy
ZCTA5 36082,01,979,-666666666,-666666666,-666666666,979,800,13,0,8,5,0,0,0,0,0,0,0,0,2021-01-01,zipcode,Troy
ZCTA5 36083,01,9145,38653,612,75200,7766,3723,5825,914,1623,1874,707,707,4572,3399,1173,3399,2059,1340,2021-01-01,zipcode,Tuskegee
ZCTA5 36088,01,3561,36164,730,89400,3137,1460,1649,218,357,482,310,282,1846,1105,741,1105,604,501,2021-01-01,zipcode,Tuskegee institute
ZCTA5 36089,01,7743,22917,553,73600,5778,3209,4928,1231,1953,1143,440,161,3381,2547,834,2547,1560,987,2021-01-01,zipcode,Union springs
ZCTA5 36091,01,3670,42708,782,104900,3232,1733,2935,629,1291,731,135,149,2009,1532,477,1532,1195,337,2021-01-01,zipcode,Verbena
ZCTA5 36092,01,20457,66484,919,160800,16291,7231,14177,1667,5508,4313,1959,730,8882,7752,1130,7752,5865,1887,2021-01-01,zipcode,Wetumpka
ZCTA5 36093,01,12291,106367,797,266400,9786,3488,8089,401,1402,2607,2184,1495,4540,4235,305,4235,3896,339,2021-01-01,zipcode,Wetumpka
ZCTA5 36104,01,9291,32863,700,77800,7666,3808,5957,1194,1772,1566,758,667,5147,3825,1322,3825,1025,2800,2021-01-01,zipcode,Montgomery
ZCTA5 36105,01,10559,36788,897,71700,8760,4221,8057,2004,2384,2356,869,444,5674,4383,1291,4383,2710,1673,2021-01-01,zipcode,Montgomery
ZCTA5 36106,01,15276,62482,988,157200,12450,4429,10199,715,2048,2735,2216,2485,7013,6220,793,6220,3478,2742,2021-01-01,zipcode,Montgomery
ZCTA5 36107,01,7965,29156,788,62000,6015,2777,5022,1110,1400,1566,580,366,4106,3095,1011,3095,1169,1926,2021-01-01,zipcode,Montgomery
ZCTA5 36108,01,15588,25028,660,64800,12616,6887,11118,2896,3871,2617,1118,616,8686,6363,2323,6363,3848,2515,2021-01-01,zipcode,Montgomery
ZCTA5 36109,01,24344,54884,950,117900,19889,7985,16805,1516,5001,5101,3263,1924,11116,10058,1058,10058,6635,3423,2021-01-01,zipcode,Montgomery
ZCTA5 36110,01,11932,38100,914,63900,9413,4769,8103,1743,3225,2359,533,243,5241,3952,1289,3952,2139,1813,2021-01-01,zipcode,Montgomery
ZCTA5 36111,01,13058,56523,961,149800,10230,4154,8569,1168,2164,1876,2007,1354,5665,4790,875,4790,2916,1874,2021-01-01,zipcode,Montgomery
ZCTA5 36112,01,217,36563,913,-666666666,202,13,96,0,4,62,26,4,17,17,0,17,0,17,2021-01-01,zipcode,Montgomery
ZCTA5 36113,01,1807,110304,1665,-666666666,1535,1000,1303,211,275,450,188,179,313,270,43,270,0,270,2021-01-01,zipcode,Montgomery
ZCTA5 36115,01,1278,87647,1394,-666666666,758,161,507,0,88,225,110,84,250,242,8,242,0,242,2021-01-01,zipcode,Montgomery
ZCTA5 36116,01,44722,47620,941,113300,34653,12929,28696,3077,7789,8884,5126,3820,19932,17215,2717,17215,7971,9244,2021-01-01,zipcode,Montgomery
ZCTA5 36117,01,52622,69422,1037,188500,40750,13573,34265,1793,6296,10028,9673,6475,23426,21303,2123,21303,12807,8496,2021-01-01,zipcode,Montgomery
ZCTA5 36201,01,17748,30610,624,66400,15050,7303,13156,2985,5481,3949,547,194,9753,7388,2365,7388,4554,2834,2021-01-01,zipcode,Anniston
ZCTA5 36203,01,18895,58934,849,140500,15127,5748,13287,2062,3461,4519,1728,1517,7794,7026,768,7026,4872,2154,2021-01-01,zipcode,Oxford
ZCTA5 36205,01,1030,23944,726,224800,836,468,726,127,181,306,49,63,518,423,95,423,225,198,2021-01-01,zipcode,Anniston
ZCTA5 36206,01,11019,51474,820,99400,8504,3223,7378,1104,2580,2302,725,667,4821,4172,649,4172,2681,1491,2021-01-01,zipcode,Anniston
ZCTA5 36207,01,18940,62334,918,171600,15130,6417,13018,1022,3746,4311,2201,1738,9130,7663,1467,7663,5616,2047,2021-01-01,zipcode,Anniston
ZCTA5 36250,01,4650,78984,920,140700,3800,1483,3457,225,1268,1277,427,260,1671,1534,137,1534,1312,222,2021-01-01,zipcode,Alexandria
ZCTA5 36251,01,5413,44121,380,114900,4466,1924,3677,715,1303,1250,338,71,2469,2035,434,2035,1515,520,2021-01-01,zipcode,Ashland
ZCTA5 36255,01,1016,67727,-666666666,122700,872,409,679,136,239,233,9,62,500,402,98,402,378,24,2021-01-01,zipcode,Cragford
ZCTA5 36256,01,1478,46932,563,112500,1130,530,994,123,312,409,60,90,754,625,129,625,548,77,2021-01-01,zipcode,Daviston
ZCTA5 36258,01,1303,43167,-666666666,113800,1125,671,985,132,353,373,119,8,752,550,202,550,493,57,2021-01-01,zipcode,Delta
ZCTA5 36260,01,4386,50529,621,129900,3358,1767,3056,488,1119,935,348,166,1601,1398,203,1398,1141,257,2021-01-01,zipcode,Eastaboga
ZCTA5 36262,01,1647,48385,767,89300,1322,726,1162,287,554,211,89,21,691,567,124,567,495,72,2021-01-01,zipcode,Fruithurst
ZCTA5 36263,01,482,50455,-666666666,115500,375,174,298,129,99,56,0,14,271,156,115,156,121,35,2021-01-01,zipcode,Graham
ZCTA5 36264,01,8731,48388,695,123900,6968,3493,6163,1151,2086,1896,766,264,3809,3142,667,3142,2245,897,2021-01-01,zipcode,Heflin
ZCTA5 36265,01,21422,49246,698,140800,18384,7925,13802,1573,4420,4070,2256,1483,9578,8338,1240,8338,5501,2837,2021-01-01,zipcode,Jacksonville
ZCTA5 36266,01,6159,45461,575,133300,4775,2308,4365,703,1886,1157,423,196,3229,2377,852,2377,1686,691,2021-01-01,zipcode,Lineville
ZCTA5 36267,01,228,-666666666,-666666666,-666666666,83,70,83,0,65,18,0,0,13,13,0,13,13,0,2021-01-01,zipcode,Millerville
ZCTA5 36268,01,5944,56399,822,91600,4410,1774,3690,395,1622,1267,178,228,2646,2135,511,2135,1900,235,2021-01-01,zipcode,Munford
ZCTA5 36269,01,1492,41538,834,110800,1015,422,949,130,425,234,120,40,629,544,85,544,399,145,2021-01-01,zipcode,Muscadine
ZCTA5 36271,01,6056,47281,765,99900,4641,2073,4215,623,1718,1266,332,276,2849,2300,549,2300,2109,191,2021-01-01,zipcode,Ohatchee
ZCTA5 36272,01,13091,46014,679,90300,10849,5158,9391,1978,3729,2455,640,589,6518,5134,1384,5134,3982,1152,2021-01-01,zipcode,Piedmont
ZCTA5 36273,01,2851,50577,740,113700,2217,1032,1903,298,694,553,240,118,1421,1150,271,1150,987,163,2021-01-01,zipcode,Ranburne
ZCTA5 36274,01,10187,36471,650,90200,8447,4307,7370,1381,2892,2241,605,251,5227,4123,1104,4123,3140,983,2021-01-01,zipcode,Roanoke
ZCTA5 36276,01,2817,41494,609,85600,2333,1178,1832,269,676,594,230,63,1184,997,187,997,788,209,2021-01-01,zipcode,Wadley
ZCTA5 36277,01,5912,59271,811,112500,4518,2008,4005,640,1166,1381,508,310,2292,1924,368,1924,1614,310,2021-01-01,zipcode,Weaver
ZCTA5 36278,01,3985,41149,603,172700,3266,1926,3065,555,726,1134,256,394,3319,1740,1579,1740,1469,271,2021-01-01,zipcode,Wedowee
ZCTA5 36279,01,2921,58636,950,125000,2101,921,1924,297,766,568,160,133,1092,914,178,914,776,138,2021-01-01,zipcode,Wellington
ZCTA5 36280,01,4237,67961,757,139800,3291,1461,2908,470,1012,698,315,413,2056,1585,471,1585,1349,236,2021-01-01,zipcode,Woodland
ZCTA5 36301,01,37699,43054,792,127900,29978,12994,26142,3667,9053,8944,2892,1586,17681,15084,2597,15084,9101,5983,2021-01-01,zipcode,Dothan
ZCTA5 36303,01,31269,48141,749,148300,24477,10775,21104,2402,6070,6988,3627,2017,14747,11898,2849,11898,7166,4732,2021-01-01,zipcode,Dothan
ZCTA5 36305,01,16878,75365,996,193200,13261,5010,11520,705,2772,3756,2507,1780,7118,6350,768,6350,4396,1954,2021-01-01,zipcode,Dothan
ZCTA5 36310,01,5929,38672,526,102300,5145,2965,4566,1043,1752,1076,426,269,4144,2408,1736,2408,1853,555,2021-01-01,zipcode,Abbeville
ZCTA5 36311,01,2280,42604,658,103200,1840,889,1529,267,650,457,60,95,1183,912,271,912,735,177,2021-01-01,zipcode,Ariton
ZCTA5 36312,01,6095,46707,736,134000,4925,2253,4249,605,1569,1437,461,177,2806,2339,467,2339,1697,642,2021-01-01,zipcode,Ashford
ZCTA5 36313,01,166,61554,-666666666,162200,140,0,140,46,0,74,0,20,179,140,39,140,116,24,2021-01-01,zipcode,Bellwood
ZCTA5 36314,01,531,50762,519,59200,391,178,388,22,171,158,37,0,263,207,56,207,178,29,2021-01-01,zipcode,Black
ZCTA5 36316,01,2138,66658,771,148700,1801,751,1607,161,399,699,267,81,963,790,173,790,687,103,2021-01-01,zipcode,Chancellor
ZCTA5 36317,01,651,54688,-666666666,104000,614,333,555,129,134,124,101,67,327,266,61,266,239,27,2021-01-01,zipcode,Clopton
ZCTA5 36318,01,1505,54063,588,106600,1186,599,992,158,312,364,106,52,758,554,204,554,504,50,2021-01-01,zipcode,Coffee springs
ZCTA5 36319,01,2385,55962,739,114200,1844,837,1601,173,653,548,149,78,1047,878,169,878,714,164,2021-01-01,zipcode,Columbia
ZCTA5 36320,01,3250,38182,695,95800,2785,1418,2528,480,1058,685,250,55,1655,1304,351,1304,1076,228,2021-01-01,zipcode,Cottonwood
ZCTA5 36321,01,2133,51708,753,132700,1600,747,1425,241,537,485,90,72,852,761,91,761,604,157,2021-01-01,zipcode,Cowarts
ZCTA5 36322,01,8437,43836,679,96800,7035,2949,6080,1009,2140,2032,627,272,4613,3922,691,3922,2264,1658,2021-01-01,zipcode,Daleville
ZCTA5 36323,01,7865,42939,708,85000,6646,3346,5714,1360,1940,1681,500,233,3805,2970,835,2970,2295,675,2021-01-01,zipcode,Elba
ZCTA5 36330,01,37874,65814,905,179700,29606,11917,25582,2737,6540,9590,4289,2426,16554,14726,1828,14726,9531,5195,2021-01-01,zipcode,Enterprise
ZCTA5 36340,01,5533,38222,607,112400,4258,2423,3977,932,1498,991,293,263,2669,2327,342,2327,1533,794,2021-01-01,zipcode,Geneva
ZCTA5 36343,01,1300,41125,928,81600,1132,636,1033,206,404,351,63,9,721,535,186,535,417,118,2021-01-01,zipcode,Gordon
ZCTA5 36344,01,6176,47888,716,152700,4697,2188,4137,546,1521,1518,394,158,2716,2100,616,2100,1533,567,2021-01-01,zipcode,Hartford
ZCTA5 36345,01,8630,64812,806,154100,6582,2496,5911,847,1611,1799,1171,483,3571,3146,425,3146,2669,477,2021-01-01,zipcode,Headland
ZCTA5 36346,01,1150,52500,675,113900,941,429,836,187,278,201,90,80,724,474,250,474,424,50,2021-01-01,zipcode,Jack
ZCTA5 36350,01,7634,46023,689,137000,6000,2314,5217,1245,1608,1397,730,237,3355,2940,415,2940,1795,1145,2021-01-01,zipcode,Midland city
ZCTA5 36351,01,3678,60313,675,119000,2883,1241,2510,353,760,904,290,203,1800,1509,291,1509,1232,277,2021-01-01,zipcode,New brockton
ZCTA5 36352,01,5442,64762,730,157400,4485,1927,3768,341,1206,1601,340,280,2052,1882,170,1882,1622,260,2021-01-01,zipcode,Newton
ZCTA5 36353,01,1614,44345,728,96200,1400,652,1143,167,370,445,116,45,811,581,230,581,533,48,2021-01-01,zipcode,Newville
ZCTA5 36360,01,19022,45400,676,125400,15323,7856,13401,1971,4169,4865,1398,998,9087,7823,1264,7823,5036,2787,2021-01-01,zipcode,Ozark
ZCTA5 36362,01,5912,67574,1211,-666666666,3971,956,2655,24,336,1219,875,201,1519,1461,58,1461,10,1451,2021-01-01,zipcode,Fort rucker
ZCTA5 36370,01,990,38000,543,84100,820,425,757,154,363,186,50,4,485,398,87,398,370,28,2021-01-01,zipcode,Pansey
ZCTA5 36371,01,434,35750,631,106600,364,159,316,36,97,145,26,12,206,195,11,195,147,48,2021-01-01,zipcode,Pinckard
ZCTA5 36373,01,665,45063,-666666666,60900,637,353,408,166,155,87,0,0,466,217,249,217,192,25,2021-01-01,zipcode,Shorterville
ZCTA5 36374,01,534,70625,864,65700,456,167,405,102,70,122,45,66,457,222,235,222,180,42,2021-01-01,zipcode,Skipperville
ZCTA5 36375,01,6882,45275,747,113600,5673,2766,4843,729,1921,1570,442,181,3095,2611,484,2611,1913,698,2021-01-01,zipcode,Slocomb
ZCTA5 36376,01,2276,43418,767,79300,1850,893,1691,296,790,466,72,67,1121,915,206,915,745,170,2021-01-01,zipcode,Webb
ZCTA5 36401,01,7398,36551,642,82000,5974,3401,5152,486,2459,1655,222,330,3969,2577,1392,2577,2002,575,2021-01-01,zipcode,Evergreen
ZCTA5 36420,01,10367,44819,629,135800,8408,3903,7401,1133,2436,2236,862,734,5126,4076,1050,4076,2971,1105,2021-01-01,zipcode,Andalusia
ZCTA5 36421,01,9720,53966,665,122300,7434,3454,6473,873,2076,2334,728,462,4938,3581,1357,3581,2606,975,2021-01-01,zipcode,Andalusia
ZCTA5 36425,01,843,35375,-666666666,60000,710,395,537,79,281,129,42,6,491,293,198,293,214,79,2021-01-01,zipcode,Beatrice
ZCTA5 36426,01,15351,43942,630,103900,12167,5371,10542,1659,4067,3107,1217,492,7053,5328,1725,5328,3668,1660,2021-01-01,zipcode,Brewton
ZCTA5 36432,01,2073,40175,707,81700,1787,937,1678,334,771,348,160,65,1052,665,387,665,463,202,2021-01-01,zipcode,Castleberry
ZCTA5 36435,01,493,38843,-666666666,103700,449,252,437,112,138,164,6,17,286,167,119,167,140,27,2021-01-01,zipcode,Coy
ZCTA5 36436,01,619,59063,-666666666,116400,532,250,427,116,108,203,0,0,333,202,131,202,182,20,2021-01-01,zipcode,Dickinson
ZCTA5 36439,01,82,-666666666,-666666666,206300,65,40,51,8,11,20,9,3,70,34,36,34,21,13,2021-01-01,zipcode,Excel
ZCTA5 36441,01,3824,34547,572,107300,2836,1329,2588,364,1166,742,207,109,2057,1461,596,1461,1044,417,2021-01-01,zipcode,Flomaton
ZCTA5 36442,01,3631,41719,707,94100,2901,1412,2576,425,1103,873,104,71,1698,1231,467,1231,889,342,2021-01-01,zipcode,Florala
ZCTA5 36444,01,653,40000,-666666666,70000,573,382,563,185,260,93,14,11,458,252,206,252,200,52,2021-01-01,zipcode,Franklin
ZCTA5 36445,01,5339,41953,680,99200,4442,2552,3888,883,1778,892,202,133,2329,1901,428,1901,1531,370,2021-01-01,zipcode,Frisco city
ZCTA5 36446,01,451,51000,-666666666,86800,334,157,284,34,134,86,30,0,214,136,78,136,99,37,2021-01-01,zipcode,Fulton
ZCTA5 36451,01,4706,44872,705,102800,3786,2007,3338,513,1297,1115,301,112,2363,1800,563,1800,1361,439,2021-01-01,zipcode,Grove hill
ZCTA5 36453,01,2472,42609,621,81400,2172,1118,1839,276,751,571,152,89,1088,940,148,940,738,202,2021-01-01,zipcode,Kinston
ZCTA5 36454,01,23,-666666666,-666666666,-666666666,23,3,23,0,23,0,0,0,57,22,35,22,22,0,2021-01-01,zipcode,Lenox
ZCTA5 36455,01,261,31591,613,73000,228,130,213,31,131,38,5,8,190,116,74,116,71,45,2021-01-01,zipcode,Lockhart
ZCTA5 36456,01,1725,55417,450,60000,1322,737,1152,145,556,309,112,30,907,648,259,648,526,122,2021-01-01,zipcode,Mc kenzie
ZCTA5 36460,01,9960,29428,533,108600,7972,4143,6596,1128,2869,1546,696,357,4912,3735,1177,3735,2469,1266,2021-01-01,zipcode,Monroeville
ZCTA5 36467,01,9829,40734,638,94900,8013,3489,7131,1145,3069,2131,515,271,4824,3958,866,3958,2983,975,2021-01-01,zipcode,Opp
ZCTA5 36470,01,0,-666666666,-666666666,-666666666,0,0,0,0,0,0,0,0,0,0,0,0,0,0,2021-01-01,zipcode,Perdue hill
ZCTA5 36471,01,716,26528,673,68000,624,450,554,16,376,97,18,47,563,310,253,310,156,154,2021-01-01,zipcode,Peterman
ZCTA5 36473,01,323,50417,-666666666,121700,187,103,177,40,87,39,0,11,140,74,66,74,52,22,2021-01-01,zipcode,Range
ZCTA5 36474,01,2682,43672,668,88100,2198,932,1762,243,936,409,94,80,1460,1051,409,1051,931,120,2021-01-01,zipcode,Red level
ZCTA5 36475,01,1662,35610,646,108700,1432,664,1302,128,631,263,205,75,912,623,289,623,560,63,2021-01-01,zipcode,Repton
ZCTA5 36476,01,26,-666666666,-666666666,-666666666,20,11,14,11,3,0,0,0,34,11,23,11,3,8,2021-01-01,zipcode,River falls
ZCTA5 36477,01,3647,42277,580,86600,3070,1443,2792,712,870,970,164,76,1923,1511,412,1511,1133,378,2021-01-01,zipcode,Samson
ZCTA5 36480,01,1669,43711,-666666666,134200,1449,809,1151,61,426,520,64,80,931,575,356,575,510,65,2021-01-01,zipcode,Uriah
ZCTA5 36481,01,258,-666666666,-666666666,154500,221,155,192,64,83,31,0,14,138,69,69,69,57,12,2021-01-01,zipcode,Vredenburgh
ZCTA5 36482,01,995,-666666666,-666666666,86900,930,532,818,246,348,128,96,0,514,363,151,363,319,44,2021-01-01,zipcode,Whatley
ZCTA5 36483,01,545,51350,-666666666,140600,492,276,466,39,256,92,63,16,277,211,66,211,179,32,2021-01-01,zipcode,Wing
ZCTA5 36502,01,16285,35205,623,120600,12948,6774,11196,1876,5552,2592,740,436,7513,6053,1460,6053,3871,2182,2021-01-01,zipcode,Atmore
ZCTA5 36505,01,920,61563,803,138100,731,355,603,119,238,115,69,62,377,366,11,366,331,35,2021-01-01,zipcode,Axis
ZCTA5 36507,01,20910,44918,780,143500,16908,7571,13843,2451,4832,4581,1164,815,7976,7121,855,7121,5390,1731,2021-01-01,zipcode,Bay minette
ZCTA5 36509,01,1596,33173,774,73400,1384,668,1199,489,337,309,57,7,771,593,178,593,378,215,2021-01-01,zipcode,Bayou la batre
ZCTA5 36511,01,355,53795,-666666666,119200,355,92,355,150,95,26,84,0,534,271,263,271,271,0,2021-01-01,zipcode,Bon secour
ZCTA5 36512,01,13,-666666666,-666666666,-666666666,13,13,13,13,0,0,0,0,7,7,0,7,7,0,2021-01-01,zipcode,Bucks
ZCTA5 36513,01,298,26340,-666666666,93600,248,156,248,0,152,96,0,0,126,104,22,104,104,0,2021-01-01,zipcode,Calvert
ZCTA5 36518,01,2497,49279,607,150500,2160,1135,1908,421,630,642,106,109,1148,785,363,785,628,157,2021-01-01,zipcode,Chatom
ZCTA5 36521,01,5165,58871,767,135100,4218,1843,3729,585,1917,846,231,150,2121,1949,172,1949,1763,186,2021-01-01,zipcode,Chunchula
ZCTA5 36522,01,7063,48421,661,119700,5195,2421,4554,622,1960,1542,284,146,2918,2454,464,2454,1726,728,2021-01-01,zipcode,Citronelle
ZCTA5 36523,01,2913,53021,1025,160400,2254,1238,1976,498,780,390,207,101,1092,932,160,932,675,257,2021-01-01,zipcode,Coden
ZCTA5 36524,01,1165,50764,450,108200,961,593,860,214,336,197,36,77,866,428,438,428,355,73,2021-01-01,zipcode,Coffeeville
ZCTA5 36525,01,2335,55526,821,138100,1667,718,1534,219,613,478,181,43,806,744,62,744,574,170,2021-01-01,zipcode,Creola
ZCTA5 36526,01,34627,76810,1239,230400,25839,8996,22888,1029,5189,7829,5709,3132,13800,12682,1118,12682,9214,3468,2021-01-01,zipcode,Daphne
ZCTA5 36527,01,17146,103882,1351,285000,12288,4066,10420,238,1680,3351,2828,2323,6579,5926,653,5926,4316,1610,2021-01-01,zipcode,Daphne
ZCTA5 36528,01,1771,62560,1094,310900,1663,916,1539,64,259,637,370,209,2157,773,1384,773,736,37,2021-01-01,zipcode,Dauphin island
ZCTA5 36529,01,256,-666666666,-666666666,-666666666,211,142,144,0,73,22,24,25,191,86,105,86,86,0,2021-01-01,zipcode,Deer park
ZCTA5 36530,01,6411,50905,906,184700,5659,2416,4949,733,1575,1667,707,267,3821,2870,951,2870,2258,612,2021-01-01,zipcode,Elberta
ZCTA5 36532,01,35688,79061,1264,328300,28413,12338,25457,1528,4391,6655,7832,5051,15921,13481,2440,13481,11442,2039,2021-01-01,zipcode,Fairhope
ZCTA5 36535,01,36605,56426,911,202500,31376,13257,28285,3140,9368,8965,4445,2367,17850,15286,2564,15286,11818,3468,2021-01-01,zipcode,Foley
ZCTA5 36538,01,363,31063,-666666666,44500,313,240,308,47,214,24,11,12,269,146,123,146,106,40,2021-01-01,zipcode,Frankville
ZCTA5 36539,01,542,53523,-666666666,113000,434,261,295,30,147,82,16,20,317,203,114,203,196,7,2021-01-01,zipcode,Fruitdale
ZCTA5 36540,01,863,25824,-666666666,-666666666,600,309,552,174,295,78,1,4,360,257,103,257,208,49,2021-01-01,zipcode,Gainestown
ZCTA5 36541,01,15048,66840,944,126400,11308,4742,10148,1353,4026,3735,599,435,6188,5214,974,5214,4557,657,2021-01-01,zipcode,Grand bay
ZCTA5 36542,01,16699,53327,1132,272800,14982,5819,13039,854,3290,4249,2785,1861,18322,7926,10396,7926,5094,2832,2021-01-01,zipcode,Gulf shores
ZCTA5 36543,01,8,-666666666,-666666666,-666666666,8,0,8,0,0,8,0,0,5,5,0,5,5,0,2021-01-01,zipcode,Huxford
ZCTA5 36544,01,12049,46828,741,114700,9591,4111,8306,2243,3354,1974,616,119,4884,4263,621,4263,3146,1117,2021-01-01,zipcode,Irvington
ZCTA5 36545,01,9006,47997,660,120900,7446,3908,6309,1124,2562,1491,694,438,4369,3151,1218,3151,2275,876,2021-01-01,zipcode,Jackson
ZCTA5 36548,01,1018,61250,-666666666,150000,671,316,604,58,213,214,48,71,459,319,140,319,306,13,2021-01-01,zipcode,Leroy
ZCTA5 36549,01,5759,55714,1015,152600,5103,2873,4608,265,1714,1560,791,278,2901,2314,587,2314,1968,346,2021-01-01,zipcode,Lillian
ZCTA5 36550,01,349,-666666666,-666666666,-666666666,306,146,256,36,139,72,0,9,194,143,51,143,101,42,2021-01-01,zipcode,Little river
ZCTA5 36551,01,12635,59395,973,175500,9652,3249,8542,564,2931,3071,1233,743,4523,3873,650,3873,3143,730,2021-01-01,zipcode,Loxley
ZCTA5 36553,01,3361,44929,625,154100,2817,1496,1867,138,815,636,80,198,1459,1007,452,1007,958,49,2021-01-01,zipcode,Mc intosh
ZCTA5 36555,01,1351,86591,1050,334600,1139,471,996,5,96,410,322,163,647,446,201,446,403,43,2021-01-01,zipcode,Magnolia springs
ZCTA5 36556,01,133,29677,-666666666,66100,133,108,106,13,25,68,0,0,316,54,262,54,54,0,2021-01-01,zipcode,Malcolm
ZCTA5 36558,01,3969,51895,523,112300,3143,1682,2762,532,1021,669,219,321,1945,1421,524,1421,1319,102,2021-01-01,zipcode,Millry
ZCTA5 36559,01,150,-666666666,-666666666,628000,150,136,134,0,0,67,13,54,184,69,115,69,69,0,2021-01-01,zipcode,Montrose
ZCTA5 36560,01,2936,37972,679,74800,2507,1383,2144,542,872,463,228,39,1313,1075,238,1075,800,275,2021-01-01,zipcode,Mount vernon
ZCTA5 36561,01,8801,85694,1199,376500,7795,3165,7031,229,1560,1949,2263,1030,15689,4029,11660,4029,2993,1036,2021-01-01,zipcode,Orange beach
ZCTA5 36562,01,1404,34096,-666666666,106800,1089,576,1023,236,538,148,82,19,647,532,115,532,437,95,2021-01-01,zipcode,Perdido
ZCTA5 36564,01,0,-666666666,-666666666,-666666666,0,0,0,0,0,0,0,0,0,0,0,0,0,0,2021-01-01,zipcode,Point clear
ZCTA5 36567,01,14005,57217,978,164300,11304,4984,9919,1592,3540,2856,1516,415,5564,5051,513,5051,3901,1150,2021-01-01,zipcode,Robertsdale
ZCTA5 36568,01,99,-666666666,-666666666,-666666666,99,44,72,17,0,21,0,34,55,55,0,55,34,21,2021-01-01,zipcode,Saint elmo
ZCTA5 36569,01,710,45208,-666666666,67500,679,494,679,49,386,203,24,17,340,231,109,231,225,6,2021-01-01,zipcode,Saint stephens
ZCTA5 36571,01,16543,60998,918,163200,12878,5371,11666,1270,4810,3072,1737,777,7245,6421,824,6421,5001,1420,2021-01-01,zipcode,Saraland
ZCTA5 36572,01,6725,88241,1118,161500,5407,2189,4894,502,1763,1267,873,489,2543,2395,148,2395,1958,437,2021-01-01,zipcode,Satsuma
ZCTA5 36574,01,1559,41589,976,137500,1324,852,1079,68,554,264,153,40,626,485,141,485,405,80,2021-01-01,zipcode,Seminole
ZCTA5 36575,01,22027,63531,963,152700,17231,6887,14956,1270,6300,4279,2103,1004,8144,7610,534,7610,6227,1383,2021-01-01,zipcode,Semmes
ZCTA5 36576,01,4285,60063,1016,191500,3513,1041,3089,264,947,1139,500,239,1981,1701,280,1701,1381,320,2021-01-01,zipcode,Silverhill
ZCTA5 36578,01,1215,85341,-666666666,217100,988,314,939,35,331,334,120,119,552,448,104,448,427,21,2021-01-01,zipcode,Stapleton
ZCTA5 36579,01,1252,59189,592,236100,1106,591,1018,129,475,161,253,0,955,430,525,430,389,41,2021-01-01,zipcode,Stockton
ZCTA5 36580,01,5919,46845,1045,188000,4465,2052,4082,1129,995,1129,571,258,2506,2072,434,2072,1743,329,2021-01-01,zipcode,Summerdale
ZCTA5 36581,01,303,-666666666,-666666666,233300,283,170,283,17,206,60,0,0,165,132,33,132,132,0,2021-01-01,zipcode,Sunflower
ZCTA5 36582,01,24274,56658,794,144600,18895,8120,16624,2458,5827,5146,2114,1079,10254,9216,1038,9216,7029,2187,2021-01-01,zipcode,Theodore
ZCTA5 36583,01,834,70667,-666666666,157300,700,342,639,23,266,302,33,15,340,304,36,304,293,11,2021-01-01,zipcode,Tibbie
ZCTA5 36584,01,449,-666666666,-666666666,76600,404,272,381,124,126,93,31,7,426,272,154,272,237,35,2021-01-01,zipcode,Vinegar bend
ZCTA5 36585,01,996,54792,853,63900,729,320,618,18,366,120,38,76,402,297,105,297,262,35,2021-01-01,zipcode,Wagarville
ZCTA5 36587,01,12279,55210,800,133900,9803,5092,7768,1658,3349,1952,509,300,4809,3942,867,3942,3145,797,2021-01-01,zipcode,Wilmer
ZCTA5 36602,01,861,23750,345,192700,853,500,787,96,181,249,161,100,743,588,155,588,120,468,2021-01-01,zipcode,Mobile
ZCTA5 36603,01,8438,24754,684,89000,6730,4510,5862,1185,2295,1611,428,343,4007,2971,1036,2971,1036,1935,2021-01-01,zipcode,Mobile
ZCTA5 36604,01,9158,49927,816,181300,7434,2704,6580,546,1606,1638,1610,1180,4992,3825,1167,3825,2146,1679,2021-01-01,zipcode,Mobile
ZCTA5 36605,01,26830,38503,919,84300,20872,9486,17445,2615,7299,4983,1694,854,12098,9965,2133,9965,5125,4840,2021-01-01,zipcode,Mobile
ZCTA5 36606,01,18697,44662,895,125100,14421,5009,12960,1494,4643,2950,2480,1393,9143,7943,1200,7943,3945,3998,2021-01-01,zipcode,Mobile
ZCTA5 36607,01,6004,38520,846,114200,5237,2526,4639,678,1484,1098,961,418,3177,2545,632,2545,1220,1325,2021-01-01,zipcode,Mobile
ZCTA5 36608,01,35268,53217,945,169200,28677,11225,23216,1833,5010,7010,5486,3877,17428,15134,2294,15134,7918,7216,2021-01-01,zipcode,Mobile
ZCTA5 36609,01,23413,41851,912,163500,18864,6992,16192,1264,4354,5054,3385,2135,12809,11099,1710,11099,4733,6366,2021-01-01,zipcode,Mobile
ZCTA5 36610,01,9948,25805,691,46900,7814,4561,6600,1346,2952,1755,395,152,5293,3671,1622,3671,1637,2034,2021-01-01,zipcode,Mobile
ZCTA5 36611,01,6421,36196,834,78600,4617,1867,3761,482,1409,1378,350,142,2785,2316,469,2316,1095,1221,2021-01-01,zipcode,Mobile
ZCTA5 36612,01,4208,30388,719,68200,3008,1691,2510,614,1072,545,119,160,1725,1414,311,1414,861,553,2021-01-01,zipcode,Mobile
ZCTA5 36613,01,12659,43137,1022,126900,9721,4933,7893,1192,3256,2369,672,404,5094,4140,954,4140,2993,1147,2021-01-01,zipcode,Eight mile
ZCTA5 36615,01,0,-666666666,-666666666,-666666666,0,0,0,0,0,0,0,0,0,0,0,0,0,0,2021-01-01,zipcode,Mobile
ZCTA5 36617,01,12409,38067,986,69700,10581,5915,9234,1333,3194,3019,1084,604,5834,5012,822,5012,2383,2629,2021-01-01,zipcode,Mobile
ZCTA5 36618,01,18204,46800,1021,116700,14932,6019,11926,1182,3881,3941,1935,987,7281,6801,480,6801,4991,1810,2021-01-01,zipcode,Mobile
ZCTA5 36619,01,15334,50146,945,140500,12158,5063,10846,1246,3683,3797,1461,659,6298,5606,692,5606,3865,1741,2021-01-01,zipcode,Mobile
ZCTA5 36688,01,1275,5761,594,-666666666,1275,608,105,46,0,50,0,9,173,96,77,96,0,96,2021-01-01,zipcode,Mobile
ZCTA5 36693,01,19528,64619,981,166200,15569,5871,13451,756,3613,4180,3389,1513,8779,7609,1170,7609,5314,2295,2021-01-01,zipcode,Mobile
ZCTA5 36695,01,52433,72074,1113,198800,40692,14720,34732,2230,9732,11391,7433,3946,20955,19367,1588,19367,13025,6342,2021-01-01,zipcode,Mobile
ZCTA5 36701,01,21247,40226,752,93100,16590,6846,14208,1493,5211,4439,1879,1186,10334,7746,2588,7746,4716,3030,2021-01-01,zipcode,Selma
ZCTA5 36703,01,12471,28513,637,72700,10237,5532,8574,1402,3421,2940,403,408,5919,4756,1163,4756,2676,2080,2021-01-01,zipcode,Selma
ZCTA5 36720,01,668,14750,-666666666,63700,540,393,420,125,210,54,22,9,316,237,79,237,196,41,2021-01-01,zipcode,Alberta
ZCTA5 36722,01,118,-666666666,-666666666,56300,90,50,82,8,6,68,0,0,170,66,104,66,45,21,2021-01-01,zipcode,Arlington
ZCTA5 36723,01,444,33319,-666666666,-666666666,297,167,149,50,30,69,0,0,240,123,117,123,113,10,2021-01-01,zipcode,Boykin
ZCTA5 36726,01,4986,38687,802,84100,3874,2211,3505,687,1279,1089,324,126,2411,1734,677,1734,1259,475,2021-01-01,zipcode,Camden
ZCTA5 36727,01,108,28877,-666666666,9999,100,70,100,23,1,75,0,1,113,76,37,76,76,0,2021-01-01,zipcode,Campbell
ZCTA5 36728,01,539,-666666666,-666666666,9999,301,179,261,81,94,73,7,6,248,137,111,137,113,24,2021-01-01,zipcode,Catherine
ZCTA5 36732,01,7425,41603,606,159000,5803,2384,5107,379,1808,1614,843,463,3927,3178,749,3178,1937,1241,2021-01-01,zipcode,Demopolis
ZCTA5 36736,01,1725,38333,1000,73700,1084,579,916,97,405,161,106,147,549,424,125,424,374,50,2021-01-01,zipcode,Dixons mills
ZCTA5 36738,01,1021,22685,673,62500,945,729,801,104,372,150,42,133,409,284,125,284,198,86,2021-01-01,zipcode,Faunsdale
ZCTA5 36740,01,1083,-666666666,640,100900,967,633,736,129,367,102,99,39,686,361,325,361,239,122,2021-01-01,zipcode,Forkland
ZCTA5 36742,01,2917,32150,631,64100,2686,1639,1822,347,404,703,182,186,1238,1029,209,1029,851,178,2021-01-01,zipcode,Gallion
ZCTA5 36744,01,5681,29876,612,122900,4618,2326,3921,846,1593,810,454,218,3070,2194,876,2194,1468,726,2021-01-01,zipcode,Greensboro
ZCTA5 36748,01,2520,42470,694,85600,2122,1133,1856,246,760,627,93,130,1374,893,481,893,639,254,2021-01-01,zipcode,Linden
ZCTA5 36749,01,734,17455,-666666666,86500,646,395,553,189,254,110,0,0,407,297,110,297,180,117,2021-01-01,zipcode,Jones
ZCTA5 36750,01,2320,55729,1007,135100,1715,827,1592,227,845,379,68,73,1032,844,188,844,723,121,2021-01-01,zipcode,Maplesville
ZCTA5 36751,01,538,44500,-666666666,24700,430,243,319,86,165,29,25,14,248,136,112,136,119,17,2021-01-01,zipcode,Lower peach tree
ZCTA5 36752,01,1014,32321,-666666666,116700,832,408,800,26,265,378,86,45,673,498,175,498,464,34,2021-01-01,zipcode,Lowndesboro
ZCTA5 36753,01,27,-666666666,-666666666,-666666666,27,27,27,0,0,0,0,27,34,27,7,27,27,0,2021-01-01,zipcode,Mc williams
ZCTA5 36754,01,594,-666666666,-666666666,-666666666,472,234,411,276,112,9,0,14,146,136,10,136,110,26,2021-01-01,zipcode,Magnolia
ZCTA5 36756,01,5180,29543,604,81800,4192,2843,3149,860,1031,555,459,244,2069,1490,579,1490,1049,441,2021-01-01,zipcode,Marion
ZCTA5 36758,01,1367,66625,-666666666,82700,1015,484,925,209,346,240,101,29,543,453,90,453,396,57,2021-01-01,zipcode,Plantersville
ZCTA5 36759,01,2106,31111,657,65300,1576,716,1385,220,546,455,127,37,927,716,211,716,596,120,2021-01-01,zipcode,Marion junction
ZCTA5 36761,01,667,24653,743,31400,510,375,463,116,193,119,10,25,491,303,188,303,201,102,2021-01-01,zipcode,Minter
ZCTA5 36763,01,126,71250,-666666666,57100,120,40,109,14,57,29,4,5,69,38,31,38,35,3,2021-01-01,zipcode,Myrtlewood
ZCTA5 36765,01,1554,24338,1063,70600,1314,630,984,225,508,194,50,7,596,513,83,513,471,42,2021-01-01,zipcode,Newbern
ZCTA5 36766,01,24,-666666666,-666666666,142500,24,15,24,7,0,0,12,5,30,16,14,16,11,5,2021-01-01,zipcode,Oak hill
ZCTA5 36767,01,1383,28201,318,69400,849,468,685,142,276,165,82,20,715,371,344,371,302,69,2021-01-01,zipcode,Orrville
ZCTA5 36768,01,990,36435,840,64500,890,355,730,129,225,270,61,45,542,325,217,325,232,93,2021-01-01,zipcode,Pine apple
ZCTA5 36769,01,2037,34395,-666666666,65300,1692,1054,1428,239,720,345,106,18,1145,829,316,829,661,168,2021-01-01,zipcode,Pine hill
ZCTA5 36773,01,290,27788,623,-666666666,254,165,246,60,20,156,6,4,201,99,102,99,55,44,2021-01-01,zipcode,Safford
ZCTA5 36775,01,1319,55014,1113,87400,997,612,908,274,332,239,56,7,763,584,179,584,379,205,2021-01-01,zipcode,Sardis
ZCTA5 36776,01,1986,-666666666,-666666666,43200,1495,719,1150,221,388,368,173,0,861,569,292,569,442,127,2021-01-01,zipcode,Sawyerville
ZCTA5 36782,01,2140,39583,729,73900,1625,724,1355,133,442,661,98,21,1156,776,380,776,699,77,2021-01-01,zipcode,Sweet water
ZCTA5 36783,01,708,37875,618,61300,617,385,547,48,237,149,69,44,562,324,238,324,207,117,2021-01-01,zipcode,Thomaston
ZCTA5 36784,01,6019,44688,718,129900,4648,2161,3897,543,1810,1062,226,256,3032,2040,992,2040,1294,746,2021-01-01,zipcode,Thomasville
ZCTA5 36785,01,916,37292,843,100800,797,415,770,74,375,267,38,16,590,426,164,426,322,104,2021-01-01,zipcode,Tyler
ZCTA5 36786,01,2396,22880,399,61400,1916,980,1804,247,909,364,182,102,1349,981,368,981,668,313,2021-01-01,zipcode,Uniontown
ZCTA5 36790,01,579,58309,-666666666,-666666666,497,198,395,83,119,193,0,0,276,238,38,238,178,60,2021-01-01,zipcode,Stanton
ZCTA5 36792,01,1246,72762,-666666666,108400,996,484,996,136,433,380,4,43,753,469,284,469,395,74,2021-01-01,zipcode,Randolph
ZCTA5 36793,01,680,77257,-666666666,165100,580,248,443,25,196,196,26,0,265,191,74,191,143,48,2021-01-01,zipcode,Lawley
ZCTA5 36801,01,23566,50224,786,158300,19142,7854,16542,1819,4567,4921,2939,2296,10640,9454,1186,9454,6208,3246,2021-01-01,zipcode,Opelika
ZCTA5 36804,01,19307,51699,655,121200,15544,7162,13297,1902,3611,4158,2144,1482,7826,6961,865,6961,5698,1263,2021-01-01,zipcode,Opelika
ZCTA5 36830,01,48282,63012,926,283000,39646,15059,29463,1127,3627,7031,9229,8449,22519,19492,3027,19492,10485,9007,2021-01-01,zipcode,Auburn
ZCTA5 36832,01,27384,32618,905,173800,22555,9498,13687,1221,2921,3445,3014,3086,13506,10248,3258,10248,4895,5353,2021-01-01,zipcode,Auburn
ZCTA5 36849,01,4339,-666666666,-666666666,-666666666,4339,2989,28,0,0,19,9,0,0,0,0,0,0,0,2021-01-01,zipcode,Auburn university
ZCTA5 36850,01,2799,38290,387,62600,2357,1388,2044,497,730,636,135,46,1473,1117,356,1117,888,229,2021-01-01,zipcode,Camp hill
ZCTA5 36852,01,2862,60625,933,140300,1887,671,1605,134,542,825,83,21,961,761,200,761,542,219,2021-01-01,zipcode,Cusseta
ZCTA5 36853,01,8163,56727,760,193700,6930,3722,6322,995,1478,2181,1091,577,5827,3238,2589,3238,2582,656,2021-01-01,zipcode,Dadeville
ZCTA5 36854,01,16226,53528,891,115700,12916,5066,10761,1660,3546,3687,1311,557,7724,6201,1523,6201,4085,2116,2021-01-01,zipcode,Valley
ZCTA5 36855,01,1305,53442,876,134400,1121,461,1075,135,376,440,87,37,651,561,90,561,487,74,2021-01-01,zipcode,Five points
ZCTA5 36856,01,8606,61527,1619,200800,6062,2935,5512,674,858,2767,904,309,2897,2737,160,2737,2492,245,2021-01-01,zipcode,Fort mitchell
ZCTA5 36858,01,473,30759,-666666666,146500,365,207,365,50,153,73,39,50,241,224,17,224,213,11,2021-01-01,zipcode,Hatchechubbee
ZCTA5 36860,01,1854,41910,586,63000,1703,892,1422,324,427,510,91,70,1026,775,251,775,560,215,2021-01-01,zipcode,Hurtsboro
ZCTA5 36861,01,2816,60000,668,161400,2503,1107,2297,451,663,648,294,241,2030,1218,812,1218,1143,75,2021-01-01,zipcode,Jacksons gap
ZCTA5 36862,01,5380,39077,601,122500,4473,2284,4102,797,1648,1141,396,120,2658,2115,543,2115,1516,599,2021-01-01,zipcode,Lafayette
ZCTA5 36863,01,12408,44543,670,105700,10233,4492,9011,1831,3192,2982,758,248,5826,4549,1277,4549,3140,1409,2021-01-01,zipcode,Lanett
ZCTA5 36865,01,42,58542,-666666666,121900,42,8,24,0,7,12,5,0,19,13,6,13,7,6,2021-01-01,zipcode,Loachapoka
ZCTA5 36866,01,4145,52123,638,86700,3407,1367,2997,739,1039,823,277,119,1948,1670,278,1670,1264,406,2021-01-01,zipcode,Notasulga
ZCTA5 36867,01,21298,42914,877,144400,17088,6818,14185,1752,3995,4977,1988,1473,10384,8852,1532,8852,4070,4782,2021-01-01,zipcode,Phenix city
ZCTA5 36869,01,22109,42004,808,112000,17390,7330,14943,2588,4621,5279,1591,864,10190,8732,1458,8732,5284,3448,2021-01-01,zipcode,Phenix city
ZCTA5 36870,01,19581,66082,998,158800,15561,5396,13344,1291,3527,5652,1512,1362,8021,7254,767,7254,5429,1825,2021-01-01,zipcode,Phenix city
ZCTA5 36871,01,1085,35083,830,95000,885,559,836,228,345,151,61,51,676,435,241,435,392,43,2021-01-01,zipcode,Pittsview
ZCTA5 36874,01,9488,59985,857,163100,7504,3175,6681,573,2172,2481,933,522,4180,3487,693,3487,3191,296,2021-01-01,zipcode,Salem
ZCTA5 36875,01,3732,56553,684,156400,3093,1365,2677,229,742,1388,158,160,1642,1445,197,1445,1134,311,2021-01-01,zipcode,Seale
ZCTA5 36877,01,12904,56117,927,151500,9757,3480,8111,794,2417,3321,769,810,4479,4020,459,4020,3090,930,2021-01-01,zipcode,Smiths station
ZCTA5 36879,01,2583,118929,666,268100,1958,653,1722,120,336,384,541,341,960,826,134,826,685,141,2021-01-01,zipcode,Waverly
ZCTA5 36901,01,74,-666666666,-666666666,-666666666,74,65,74,18,9,47,0,0,57,34,23,34,34,0,2021-01-01,zipcode,Bellamy
ZCTA5 36904,01,3842,37898,633,100100,3088,1517,2686,352,1081,919,277,57,2141,1582,559,1582,1241,341,2021-01-01,zipcode,Butler
ZCTA5 36907,01,1800,35000,1026,58300,1500,959,1282,280,422,290,166,124,1104,794,310,794,678,116,2021-01-01,zipcode,Cuba
ZCTA5 36908,01,1824,61875,713,76300,1504,750,1294,160,446,476,193,19,1068,682,386,682,594,88,2021-01-01,zipcode,Gilbertown
ZCTA5 36910,01,14,-666666666,-666666666,-666666666,14,14,14,0,0,14,0,0,6,6,0,6,6,0,2021-01-01,zipcode,Jachin
ZCTA5 36912,01,1814,50500,1074,71200,1585,833,1455,142,389,722,66,136,949,640,309,640,543,97,2021-01-01,zipcode,Lisman
ZCTA5 36913,01,50,-666666666,-666666666,-666666666,50,50,50,38,0,12,0,0,23,23,0,23,23,0,2021-01-01,zipcode,Melvin
ZCTA5 36915,01,741,30473,-666666666,57600,639,292,507,57,202,161,86,1,380,290,90,290,227,63,2021-01-01,zipcode,Needham
ZCTA5 36916,01,770,27006,326,72400,617,369,556,133,161,212,9,41,406,307,99,307,245,62,2021-01-01,zipcode,Pennington
ZCTA5 36919,01,1730,36111,438,71000,1464,919,1325,354,607,264,62,38,926,700,226,700,584,116,2021-01-01,zipcode,Silas
ZCTA5 36921,01,969,24489,397,115000,911,622,821,348,328,125,20,0,721,641,80,641,566,75,2021-01-01,zipcode,Toxey
ZCTA5 36922,01,724,41553,-666666666,73600,531,348,449,208,158,71,12,0,372,205,167,205,178,27,2021-01-01,zipcode,Ward
ZCTA5 36925,01,2863,31966,497,41100,2350,1060,2194,271,752,812,217,142,1681,1337,344,1337,802,535,2021-01-01,zipcode,York
ZCTA5 75001,48,16287,73383,1473,343700,14160,2648,12620,589,1259,3546,4744,2482,9896,8835,1061,8835,1402,7433,2021-01-01,zipcode,Addison
ZCTA5 75002,48,71102,110796,1712,315600,54350,17208,45770,2139,6909,13296,15863,7563,23265,22095,1170,22095,17603,4492,2021-01-01,zipcode,Allen
ZCTA5 75006,48,48104,73088,1333,244700,38126,9991,32773,5915,8025,8211,7459,3163,18838,18161,677,18161,9303,8858,2021-01-01,zipcode,Carrollton
ZCTA5 75007,48,54448,96051,1383,284300,45893,12659,39422,3584,7527,11595,11823,4893,20878,19938,940,19938,13770,6168,2021-01-01,zipcode,Carrollton
ZCTA5 75009,48,24737,140933,1605,379700,18456,6034,16218,692,2588,5468,5920,1550,7796,7649,147,7649,6839,810,2021-01-01,zipcode,Celina
ZCTA5 75010,48,30129,91657,1473,351300,24860,5742,21599,1199,3182,6023,7537,3658,12910,11912,998,11912,5988,5924,2021-01-01,zipcode,Carrollton
ZCTA5 75013,48,44807,145220,1588,436000,33967,8339,29828,1114,3095,7330,10248,8041,16646,15596,1050,15596,10453,5143,2021-01-01,zipcode,Allen
ZCTA5 75019,48,44324,124652,1526,431500,33966,8626,29968,700,2535,5802,11610,9321,17303,16834,469,16834,11136,5698,2021-01-01,zipcode,Coppell
ZCTA5 75020,48,23184,58252,955,129700,18143,7418,15651,1335,4782,6343,2022,1169,10414,9179,1235,9179,5540,3639,2021-01-01,zipcode,Denison
ZCTA5 75021,48,9327,57172,854,146500,7398,2896,6516,813,2481,2240,664,318,3915,3462,453,3462,2732,730,2021-01-01,zipcode,Denison
ZCTA5 75022,48,26543,165000,1885,468700,20225,6011,16860,538,1880,3572,6846,4024,8981,8756,225,8756,7604,1152,2021-01-01,zipcode,Flower mound
ZCTA5 75023,48,48586,91883,1579,315300,39752,11645,34512,2103,4710,9574,12606,5519,19014,18162,852,18162,11298,6864,2021-01-01,zipcode,Plano
ZCTA5 75024,48,43331,107948,1578,458900,34540,9392,29746,702,2714,5224,12172,8934,19191,17539,1652,17539,6718,10821,2021-01-01,zipcode,Plano
ZCTA5 75025,48,52881,127282,1713,375200,41778,12578,35992,1462,4162,6774,12945,10649,19058,18342,716,18342,12324,6018,2021-01-01,zipcode,Plano
ZCTA5 75028,48,46934,138221,1851,361400,36074,9732,31795,662,3581,7787,13447,6318,17458,16938,520,16938,14042,2896,2021-01-01,zipcode,Flower mound
ZCTA5 75032,48,35056,123199,1524,361900,27239,8650,22908,1454,4004,6162,7052,4236,12218,11621,597,11621,9723,1898,2021-01-01,zipcode,Rockwall
ZCTA5 75034,48,45759,94134,1432,554700,36681,10235,30573,1440,3078,6589,11488,7978,20773,19088,1685,19088,8192,10896,2021-01-01,zipcode,Frisco
ZCTA5 75035,48,81512,142995,1943,422200,59624,16172,51319,2004,4413,10660,19283,14959,27536,26190,1346,26190,20006,6184,2021-01-01,zipcode,Frisco
ZCTA5 75038,48,32128,64678,1230,290600,24849,5494,22061,1403,4822,6161,5831,3844,14643,13540,1103,13540,2430,11110,2021-01-01,zipcode,Irving
ZCTA5 75039,48,22046,99156,1607,477800,18346,3098,17079,136,915,2948,7294,5786,12134,11027,1107,11027,1679,9348,2021-01-01,zipcode,Irving
ZCTA5 75040,48,64565,65141,1401,183300,49699,15892,41615,10365,10871,12257,5273,2849,20995,20033,962,20033,13860,6173,2021-01-01,zipcode,Garland
ZCTA5 75041,48,31451,58945,1116,168500,23417,7499,18729,6326,4941,4994,1734,734,10435,9799,636,9799,5990,3809,2021-01-01,zipcode,Garland
ZCTA5 75042,48,38184,53919,1086,166300,28365,9010,23079,7208,5609,6637,2409,1216,12080,11552,528,11552,6583,4969,2021-01-01,zipcode,Garland
ZCTA5 75043,48,64845,66211,1252,194400,49913,15168,41062,6909,9917,14351,6433,3452,22985,21955,1030,21955,13229,8726,2021-01-01,zipcode,Garland
ZCTA5 75044,48,45895,78701,1402,240200,36070,10836,30736,3056,6563,9430,7533,4154,16397,15958,439,15958,10347,5611,2021-01-01,zipcode,Garland
ZCTA5 75048,48,26956,114256,1632,282900,21687,5986,18678,1170,4113,5602,5306,2487,9631,9387,244,9387,8511,876,2021-01-01,zipcode,Sachse
ZCTA5 75050,48,43422,64435,1191,165100,33838,9531,27790,5774,8787,7816,3568,1845,16886,15559,1327,15559,6876,8683,2021-01-01,zipcode,Grand prairie
ZCTA5 75051,48,39783,42675,1045,138400,29123,11037,23679,7631,8125,5151,1925,847,14153,13150,1003,13150,6181,6969,2021-01-01,zipcode,Grand prairie
ZCTA5 75052,48,95745,82395,1443,215700,72324,20760,60358,8307,14581,19238,12871,5361,31791,30366,1425,30366,20497,9869,2021-01-01,zipcode,Grand prairie
ZCTA5 75054,48,15820,145375,1872,364700,10827,3156,9386,404,896,2948,3133,2005,4824,4789,35,4789,4349,440,2021-01-01,zipcode,Grand prairie
ZCTA5 75056,48,64243,100568,1489,331100,50936,11560,45599,2161,7307,13141,15737,7253,27248,25494,1754,25494,15184,10310,2021-01-01,zipcode,The colony
ZCTA5 75057,48,16855,73837,1400,134100,12610,2853,10777,2228,2541,2926,2296,786,6845,6198,647,6198,2373,3825,2021-01-01,zipcode,Lewisville
ZCTA5 75058,48,3369,113542,1373,381000,2533,852,2006,210,411,570,595,220,1091,984,107,984,799,185,2021-01-01,zipcode,Gunter
ZCTA5 75060,48,49473,61964,1193,168000,36487,11646,29567,10749,7357,6088,3824,1549,15344,14542,802,14542,9178,5364,2021-01-01,zipcode,Irving
ZCTA5 75061,48,56959,52446,1086,168000,41923,11770,34086,12245,8929,7464,3791,1657,19931,18502,1429,18502,7352,11150,2021-01-01,zipcode,Irving
ZCTA5 75062,48,51846,63151,1168,196500,39527,10878,32121,7897,6378,7711,7212,2923,18408,17490,918,17490,7275,10215,2021-01-01,zipcode,Irving
ZCTA5 75063,48,43705,97704,1403,393300,32905,8709,29347,1077,2664,4911,11125,9570,18255,17190,1065,17190,6362,10828,2021-01-01,zipcode,Irving
ZCTA5 75065,48,12549,81271,1302,245100,10156,2609,8490,948,2026,2582,2054,880,4888,4693,195,4693,3378,1315,2021-01-01,zipcode,Lake dallas
ZCTA5 75067,48,67837,68923,1287,249600,53780,12022,46723,5739,10394,14483,11493,4614,28850,27002,1848,27002,9814,17188,2021-01-01,zipcode,Lewisville
ZCTA5 75068,48,65880,113053,1742,292700,47232,11851,41562,3436,7329,12625,11992,6180,21128,20531,597,20531,16968,3563,2021-01-01,zipcode,Little elm
ZCTA5 75069,48,37479,66086,1245,322200,29745,11207,24514,3822,5463,6395,5961,2873,15919,14537,1382,14537,7490,7047,2021-01-01,zipcode,Mckinney
ZCTA5 75070,48,54444,94510,1495,342900,40838,10301,35120,653,4430,10013,13819,6205,21791,20576,1215,20576,11473,9103,2021-01-01,zipcode,Mckinney
ZCTA5 75071,48,63828,118900,1807,355900,47225,14047,41590,2462,6842,11991,13409,6886,21818,20893,925,20893,15513,5380,2021-01-01,zipcode,Mckinney
ZCTA5 75074,48,51820,73291,1425,267400,40026,11953,33130,6061,5467,8632,8375,4595,18451,17678,773,17678,9736,7942,2021-01-01,zipcode,Plano
ZCTA5 75075,48,36221,86731,1437,319100,30309,9946,26482,1793,4141,7441,8280,4827,15446,14473,973,14473,8855,5618,2021-01-01,zipcode,Plano
ZCTA5 75076,48,8592,67500,1194,180300,7280,2525,6535,317,2349,2523,979,367,4463,3384,1079,3384,2705,679,2021-01-01,zipcode,Pottsboro
ZCTA5 75077,48,39125,114916,1468,351000,31399,10196,26685,800,4481,8702,9225,3477,13859,13420,439,13420,10913,2507,2021-01-01,zipcode,Lewisville
ZCTA5 75078,48,35939,160403,1842,486700,24709,6964,21565,588,2266,4900,9058,4753,11262,10613,649,10613,9420,1193,2021-01-01,zipcode,Prosper
ZCTA5 75080,48,52420,80294,1531,337900,41473,13960,32130,2935,4201,7454,10284,7256,20258,18861,1397,18861,10280,8581,2021-01-01,zipcode,Richardson
ZCTA5 75081,48,36683,83551,1457,273000,29059,8663,25166,2812,3145,8338,7169,3702,14507,13677,830,13677,7292,6385,2021-01-01,zipcode,Richardson
ZCTA5 75082,48,26801,100239,1695,383200,23017,6403,19744,460,1709,4475,7282,5818,11895,11054,841,11054,5971,5083,2021-01-01,zipcode,Richardson
ZCTA5 75087,48,39202,112777,1373,314100,29913,9169,25453,1216,3141,8163,8306,4627,14190,13795,395,13795,11237,2558,2021-01-01,zipcode,Rockwall
ZCTA5 75088,48,26363,96279,1697,246500,21228,6094,18639,1079,4713,6594,4237,2016,9517,9261,256,9261,7588,1673,2021-01-01,zipcode,Rowlett
ZCTA5 75089,48,35203,106758,1634,263700,27109,7370,23494,1442,4790,8459,6326,2477,11789,11218,571,11218,9198,2020,2021-01-01,zipcode,Rowlett
ZCTA5 75090,48,24866,50290,885,110500,18644,7431,15688,2528,5337,5687,1350,786,9769,8466,1303,8466,5507,2959,2021-01-01,zipcode,Sherman
ZCTA5 75092,48,26794,59019,1074,187700,21777,7572,18498,1256,4179,7641,3508,1914,12341,11395,946,11395,6360,5035,2021-01-01,zipcode,Sherman
ZCTA5 75093,48,46868,114318,1555,491700,38072,12862,34103,705,2894,6344,13881,10279,20630,19245,1385,19245,11617,7628,2021-01-01,zipcode,Plano
ZCTA5 75094,48,23345,146773,2244,386900,16980,5302,14237,836,2134,3797,4286,3184,6407,6377,30,6377,5760,617,2021-01-01,zipcode,Plano
ZCTA5 75098,48,64326,101460,1731,276800,48534,12597,40235,3747,8566,13033,10422,4467,21204,20326,878,20326,15616,4710,2021-01-01,zipcode,Wylie
ZCTA5 75101,48,679,46571,980,77000,517,206,439,159,171,85,15,9,244,222,22,222,117,105,2021-01-01,zipcode,Bardwell
ZCTA5 75102,48,1795,54621,898,109000,1439,598,1324,280,379,496,127,42,797,596,201,596,506,90,2021-01-01,zipcode,Barry
ZCTA5 75103,48,15900,65517,1029,176300,13118,6311,11866,1210,3657,4575,1698,726,7078,6220,858,6220,5158,1062,2021-01-01,zipcode,Canton
ZCTA5 75104,48,49566,78259,1583,206600,37096,11405,30934,3200,6985,11496,5850,3403,17002,16342,660,16342,11582,4760,2021-01-01,zipcode,Cedar hill
ZCTA5 75105,48,207,44196,-666666666,167200,142,45,64,4,33,14,13,0,60,37,23,37,34,3,2021-01-01,zipcode,Chatfield
ZCTA5 75109,48,4288,62895,1163,124900,3495,1624,3171,309,1039,1007,530,286,1940,1626,314,1626,1367,259,2021-01-01,zipcode,Corsicana
ZCTA5 75110,48,30555,46752,858,118900,23125,8504,19174,4337,5344,6586,1865,1042,11577,10160,1417,10160,6208,3952,2021-01-01,zipcode,Corsicana
ZCTA5 75114,48,6438,80703,1174,201800,4768,1721,3992,614,1174,1570,460,174,2212,1996,216,1996,1732,264,2021-01-01,zipcode,Crandall
ZCTA5 75115,48,55879,79805,1303,215500,44365,13313,37800,3457,8595,14946,6503,4299,20974,19906,1068,19906,13587,6319,2021-01-01,zipcode,Desoto
ZCTA5 75116,48,21105,51765,1248,161700,15777,6203,13177,2496,4122,4298,1440,821,7476,7030,446,7030,4135,2895,2021-01-01,zipcode,Duncanville
ZCTA5 75117,48,4753,84926,1059,162600,3445,1213,2810,142,898,1374,318,78,1847,1543,304,1543,1179,364,2021-01-01,zipcode,Edgewood
ZCTA5 75119,48,28765,65034,1055,166700,22143,6928,18130,3505,5186,5986,2578,875,10854,9900,954,9900,6812,3088,2021-01-01,zipcode,Ennis
ZCTA5 75124,48,5205,66429,864,132100,4057,2240,3506,432,1276,1112,465,221,2250,1776,474,1776,1444,332,2021-01-01,zipcode,Eustace
ZCTA5 75125,48,7198,71719,1007,132200,5239,1739,4547,1688,1089,1309,321,140,2301,2210,91,2210,1741,469,2021-01-01,zipcode,Ferris
ZCTA5 75126,48,60232,93908,1714,253900,43633,11525,36645,2405,8114,14323,8531,3272,20005,19298,707,19298,15830,3468,2021-01-01,zipcode,Forney
ZCTA5 75127,48,1854,53387,720,164400,1506,855,1332,368,502,256,120,86,853,762,91,762,627,135,2021-01-01,zipcode,Fruitvale
ZCTA5 75132,48,0,-666666666,-666666666,-666666666,0,0,0,0,0,0,0,0,0,0,0,0,0,0,2021-01-01,zipcode,Fate
ZCTA5 75134,48,19341,59211,1317,160900,14427,4436,12257,2176,3377,4311,1424,969,6883,6653,230,6653,4904,1749,2021-01-01,zipcode,Lancaster
ZCTA5 75135,48,8075,89453,1271,233300,6068,2013,5088,337,1779,1896,729,347,2616,2504,112,2504,2073,431,2021-01-01,zipcode,Caddo mills
ZCTA5 75137,48,19352,78254,1458,198000,15281,5958,13002,1678,3525,3831,2375,1593,7226,6832,394,6832,4770,2062,2021-01-01,zipcode,Duncanville
ZCTA5 75140,48,7365,46677,731,99800,5863,3013,4927,1088,1814,1290,471,264,3124,2589,535,2589,2014,575,2021-01-01,zipcode,Grand saline
ZCTA5 75141,48,3868,37125,1312,83100,2548,1036,1964,564,810,466,83,41,1129,1005,124,1005,530,475,2021-01-01,zipcode,Hutchins
ZCTA5 75142,48,22870,67686,1092,149200,16930,5802,14442,3258,5561,3982,1159,482,7832,7291,541,7291,5475,1816,2021-01-01,zipcode,Kaufman
ZCTA5 75143,48,15270,57157,954,124300,11983,5495,10524,1641,3913,3182,1302,486,7653,5815,1838,5815,4750,1065,2021-01-01,zipcode,Kemp
ZCTA5 75144,48,4030,48214,741,131200,3050,1425,2627,300,826,926,341,234,1592,1326,266,1326,932,394,2021-01-01,zipcode,Kerens
ZCTA5 75146,48,24873,61482,1231,171800,17597,5187,15046,1694,4023,5388,2452,1489,9084,8585,499,8585,5273,3312,2021-01-01,zipcode,Lancaster
ZCTA5 75147,48,6922,43274,794,168300,5722,2462,4723,733,1637,1602,510,241,2985,2621,364,2621,1884,737,2021-01-01,zipcode,Mabank
ZCTA5 75148,48,6237,51500,796,142800,5136,2511,4576,555,1520,1628,674,199,3550,2552,998,2552,1902,650,2021-01-01,zipcode,Malakoff
ZCTA5 75149,48,59225,57136,1190,154600,43944,14777,35673,8555,11488,11211,3101,1318,20429,19362,1067,19362,12810,6552,2021-01-01,zipcode,Mesquite
ZCTA5 75150,48,64817,61423,1206,171200,49291,14788,40532,7927,12069,12807,5507,2222,24264,22642,1622,22642,11121,11521,2021-01-01,zipcode,Mesquite
ZCTA5 75152,48,5686,78750,1352,133000,4279,1250,3444,518,1321,1026,422,157,2017,1871,146,1871,1423,448,2021-01-01,zipcode,Palmer
ZCTA5 75153,48,515,87750,-666666666,137500,412,152,393,118,24,93,122,36,238,146,92,146,93,53,2021-01-01,zipcode,Powell
ZCTA5 75154,48,47111,86783,1265,229700,35711,11103,29577,3615,8134,9414,5575,2839,15491,14798,693,14798,12470,2328,2021-01-01,zipcode,Red oak
ZCTA5 75155,48,3167,51750,836,94600,2208,863,1807,601,631,428,124,23,1069,963,106,963,771,192,2021-01-01,zipcode,Rice
ZCTA5 75156,48,16500,46498,809,152500,13874,7544,12272,2242,4238,4166,1093,533,8994,6734,2260,6734,4945,1789,2021-01-01,zipcode,Mabank
ZCTA5 75157,48,209,-666666666,590,71000,190,62,177,35,75,60,2,5,123,111,12,111,93,18,2021-01-01,zipcode,Rosser
ZCTA5 75158,48,5496,82813,990,232700,4332,1704,3673,534,1178,1221,504,236,1887,1766,121,1766,1552,214,2021-01-01,zipcode,Scurry
ZCTA5 75159,48,22514,63543,1192,166700,16881,7320,14028,3457,4908,4058,1214,391,7007,6356,651,6356,4950,1406,2021-01-01,zipcode,Seagoville
ZCTA5 75160,48,24465,63105,1068,161700,18745,6784,15906,2896,4940,4859,2138,1073,9024,8486,538,8486,5866,2620,2021-01-01,zipcode,Terrell
ZCTA5 75161,48,8040,73521,926,165100,6748,2439,6179,1102,2479,1987,417,194,3027,2869,158,2869,2356,513,2021-01-01,zipcode,Terrell
ZCTA5 75163,48,2450,45000,742,-666666666,2023,1141,1865,446,577,662,128,52,1586,1118,468,1118,951,167,2021-01-01,zipcode,Trinidad
ZCTA5 75164,48,281,47554,-666666666,159200,278,160,245,35,151,59,0,0,151,151,0,151,142,9,2021-01-01,zipcode,Josephine
ZCTA5 75165,48,47183,78254,1191,230300,36384,12343,30379,3257,8626,11115,4860,2521,17432,16267,1165,16267,10342,5925,2021-01-01,zipcode,Waxahachie
ZCTA5 75166,48,5589,105972,1708,266700,4277,958,3629,155,947,1430,776,321,1853,1853,0,1853,1621,232,2021-01-01,zipcode,Lavon
ZCTA5 75167,48,12332,104652,1800,307100,9667,2738,8408,843,1802,2945,1977,841,4113,3984,129,3984,3678,306,2021-01-01,zipcode,Waxahachie
ZCTA5 75169,48,14496,53460,821,131800,11300,4928,9696,1636,3290,3398,998,374,6317,5583,734,5583,4198,1385,2021-01-01,zipcode,Wills point
ZCTA5 75172,48,5248,57895,929,73900,4204,1365,3395,1074,768,1303,222,28,1867,1779,88,1779,1083,696,2021-01-01,zipcode,Wilmer
ZCTA5 75173,48,8298,89402,1144,222400,6402,2131,5521,487,2355,1748,627,304,2875,2488,387,2488,2236,252,2021-01-01,zipcode,Nevada
ZCTA5 75180,48,26560,54670,1114,153100,19050,6066,15526,5072,4789,4692,738,235,8285,7483,802,7483,4795,2688,2021-01-01,zipcode,Balch springs
ZCTA5 75181,48,27336,97061,1697,207500,19534,5582,16040,2393,3714,6278,2276,1379,8161,7865,296,7865,6866,999,2021-01-01,zipcode,Mesquite
ZCTA5 75182,48,7647,137656,1021,409900,5837,1586,5041,219,1103,1209,1486,1024,2686,2569,117,2569,2207,362,2021-01-01,zipcode,Sunnyvale
ZCTA5 75189,48,35243,101552,1518,248500,26266,7896,22769,1840,6664,8145,4256,1864,12203,11731,472,11731,10554,1177,2021-01-01,zipcode,Royse city
ZCTA5 75201,48,17491,95907,1834,636300,16706,2189,14108,329,1265,2433,5930,4151,12358,11165,1193,11165,1196,9969,2021-01-01,zipcode,Dallas
ZCTA5 75202,48,2212,86827,1761,247000,2133,332,1864,31,141,410,747,535,1806,1461,345,1461,455,1006,2021-01-01,zipcode,Dallas
ZCTA5 75203,48,16455,40079,976,111900,12652,4342,10579,3301,3006,2382,1131,759,7084,6229,855,6229,2233,3996,2021-01-01,zipcode,Dallas
ZCTA5 75204,48,31860,83050,1599,386600,29364,4771,24793,1626,1597,4446,9944,7180,21708,18689,3019,18689,3725,14964,2021-01-01,zipcode,Dallas
ZCTA5 75205,48,24804,164409,1865,1211000,20283,7805,14724,180,563,1592,6240,6149,10379,9143,1236,9143,5417,3726,2021-01-01,zipcode,Dallas
ZCTA5 75206,48,38209,79468,1419,459400,33731,6482,29203,1585,2099,4621,13870,7028,24568,20910,3658,20910,6066,14844,2021-01-01,zipcode,Dallas
ZCTA5 75207,48,8163,78393,1665,-666666666,8103,5510,7099,1551,1758,1750,1272,768,2371,2209,162,2209,9,2200,2021-01-01,zipcode,Dallas
ZCTA5 75208,48,29941,68000,1250,346200,23957,6549,20612,5120,3605,3904,4886,3097,12737,11638,1099,11638,6388,5250,2021-01-01,zipcode,Dallas
ZCTA5 75209,48,14205,103130,1512,604200,11950,3344,10853,661,1313,1746,4268,2865,7441,6721,720,6721,4048,2673,2021-01-01,zipcode,Dallas
ZCTA5 75210,48,9270,32852,827,82700,6214,2624,5026,1917,1522,1310,108,169,3290,2855,435,2855,921,1934,2021-01-01,zipcode,Dallas
ZCTA5 75211,48,75213,50368,1027,139900,57150,20623,43820,17472,12596,8094,4027,1631,24187,22504,1683,22504,12042,10462,2021-01-01,zipcode,Dallas
ZCTA5 75212,48,26673,42115,822,124300,19467,8105,15400,6116,4759,2600,1492,433,8653,8099,554,8099,4300,3799,2021-01-01,zipcode,Dallas
ZCTA5 75214,48,33621,104583,1372,562700,26839,6244,24385,1009,2164,3845,10118,7249,16917,15278,1639,15278,8630,6648,2021-01-01,zipcode,Dallas
ZCTA5 75215,48,17960,32077,941,84300,14088,5610,11997,3195,3837,3109,1207,649,8220,7008,1212,7008,2249,4759,2021-01-01,zipcode,Dallas
ZCTA5 75216,48,55108,31063,960,85200,39984,19357,33411,9804,13166,7609,2147,685,20904,18934,1970,18934,9616,9318,2021-01-01,zipcode,Dallas
ZCTA5 75217,48,87767,44384,1026,110500,59829,25217,46506,20247,15313,8816,1644,486,25491,23912,1579,23912,13846,10066,2021-01-01,zipcode,Dallas
ZCTA5 75218,48,21355,95500,1462,386200,17191,5048,16227,1343,2184,3061,5549,4090,10313,9434,879,9434,5991,3443,2021-01-01,zipcode,Dallas
ZCTA5 75219,48,24100,81205,1513,330600,22670,3648,20579,1230,1401,3555,8824,5569,18795,15936,2859,15936,4931,11005,2021-01-01,zipcode,Dallas
ZCTA5 75220,48,40671,51125,987,332400,29980,7819,24953,10607,5562,3667,3243,1874,15733,14009,1724,14009,4339,9670,2021-01-01,zipcode,Dallas
ZCTA5 75223,48,14270,61505,1140,183400,11323,3182,9221,3491,2020,1603,1410,697,5187,4580,607,4580,2075,2505,2021-01-01,zipcode,Dallas
ZCTA5 75224,48,36373,46137,996,158500,27411,10886,21877,7989,6837,4077,2044,930,12426,11712,714,11712,5945,5767,2021-01-01,zipcode,Dallas
ZCTA5 75225,48,21703,169547,1981,1185900,17053,7451,15561,200,562,1603,7649,5547,9724,8869,855,8869,6962,1907,2021-01-01,zipcode,Dallas
ZCTA5 75226,48,5133,60290,1390,79200,4669,1201,4088,943,645,1082,992,426,2609,2381,228,2381,171,2210,2021-01-01,zipcode,Dallas
ZCTA5 75227,48,58395,49744,1045,143600,42561,15879,34103,10260,10986,8511,3163,1183,19481,18465,1016,18465,10531,7934,2021-01-01,zipcode,Dallas
ZCTA5 75228,48,71450,51018,1013,186300,52591,18262,42479,11848,12951,10300,5008,2372,27158,24624,2534,24624,11424,13200,2021-01-01,zipcode,Dallas
ZCTA5 75229,48,32924,107886,1298,459200,25335,6703,22100,4280,3367,3568,6133,4752,12420,11429,991,11429,7799,3630,2021-01-01,zipcode,Dallas
ZCTA5 75230,48,26335,105045,1205,703400,22697,7975,20628,718,1670,4516,7372,6352,14510,12934,1576,12934,8029,4905,2021-01-01,zipcode,Dallas
ZCTA5 75231,48,38823,45052,1025,384400,30140,7047,25551,4710,6164,5821,6144,2712,21011,17536,3475,17536,3001,14535,2021-01-01,zipcode,Dallas
ZCTA5 75232,48,33561,48768,1143,161100,26724,11497,23112,4248,8400,6003,2577,1884,11868,11559,309,11559,7500,4059,2021-01-01,zipcode,Dallas
ZCTA5 75233,48,16743,57018,1092,193800,12279,4406,9752,2772,2576,2350,1187,867,5089,4984,105,4984,2543,2441,2021-01-01,zipcode,Dallas
ZCTA5 75234,48,32728,74932,1418,227600,25931,7227,21892,4348,4580,5440,4942,2582,13304,11789,1515,11789,7353,4436,2021-01-01,zipcode,Dallas
ZCTA5 75235,48,19042,49805,1312,219900,15763,4256,12998,3234,2424,2295,2549,2496,9382,8698,684,8698,2039,6659,2021-01-01,zipcode,Dallas
ZCTA5 75236,48,17545,44462,1036,168500,12613,3205,10257,2268,2714,3425,1199,651,7294,6501,793,6501,1972,4529,2021-01-01,zipcode,Dallas
ZCTA5 75237,48,18823,33740,983,150300,12891,3748,10774,1908,3657,3513,1192,504,8855,7943,912,7943,1065,6878,2021-01-01,zipcode,Dallas
ZCTA5 75238,48,31953,68361,1094,415100,24039,6590,21134,1966,3746,4978,6266,4178,14133,12950,1183,12950,6539,6411,2021-01-01,zipcode,Dallas
ZCTA5 75240,48,26442,49460,1144,259000,19743,4490,15903,4452,3111,3221,3452,1667,11752,10230,1522,10230,2541,7689,2021-01-01,zipcode,Dallas
ZCTA5 75241,48,31749,38792,1047,109700,23451,12537,19780,3931,6919,6222,1874,834,11308,10481,827,10481,6439,4042,2021-01-01,zipcode,Dallas
ZCTA5 75243,48,65118,43673,1046,290200,50527,14798,43519,6474,9453,13717,8446,5429,31129,27814,3315,27814,6930,20884,2021-01-01,zipcode,Dallas
ZCTA5 75244,48,12806,100485,1604,467300,10584,2438,9453,341,866,1666,3836,2744,6483,5701,782,5701,2826,2875,2021-01-01,zipcode,Dallas
ZCTA5 75246,48,2307,42722,897,349000,2005,579,1874,368,446,526,384,150,1519,1250,269,1250,208,1042,2021-01-01,zipcode,Dallas
ZCTA5 75247,48,870,17361,1051,-666666666,809,564,787,226,217,261,50,33,246,229,17,229,0,229,2021-01-01,zipcode,Dallas
ZCTA5 75248,48,36317,91270,1347,440100,30181,8333,27179,1055,2610,5752,10744,7018,18158,16306,1852,16306,8499,7807,2021-01-01,zipcode,Dallas
ZCTA5 75249,48,17629,76345,1683,176100,12777,3287,10966,1288,2880,3923,2112,763,5345,5315,30,5315,4048,1267,2021-01-01,zipcode,Dallas
ZCTA5 75251,48,3804,78245,1458,-666666666,3440,535,2692,55,255,751,1184,447,2793,2292,501,2292,0,2292,2021-01-01,zipcode,Dallas
ZCTA5 75252,48,27310,70191,1160,418200,23128,6891,19735,821,1862,4340,7388,5324,14391,12458,1933,12458,5417,7041,2021-01-01,zipcode,Dallas
ZCTA5 75253,48,24090,46716,1174,91900,15978,5843,12198,4878,3537,2748,747,288,6881,6468,413,6468,4178,2290,2021-01-01,zipcode,Dallas
ZCTA5 75254,48,24047,62569,1276,269800,19159,3444,16231,1742,2645,4265,4934,2645,13609,11285,2324,11285,2327,8958,2021-01-01,zipcode,Dallas
ZCTA5 75270,48,0,-666666666,-666666666,-666666666,0,0,0,0,0,0,0,0,0,0,0,0,0,0,2021-01-01,zipcode,Dallas
ZCTA5 75287,48,51855,57430,1171,355400,43375,9440,38796,1720,6737,12005,12174,6160,29896,26947,2949,26947,6057,20890,2021-01-01,zipcode,Dallas
ZCTA5 75390,48,0,-666666666,-666666666,-666666666,0,0,0,0,0,0,0,0,0,0,0,0,0,0,2021-01-01,zipcode,Dallas
ZCTA5 75401,48,21087,44980,1016,110700,15763,5766,13935,2710,5651,3810,1295,469,8674,7952,722,7952,4104,3848,2021-01-01,zipcode,Greenville
ZCTA5 75402,48,18412,71972,1177,172100,14925,5750,12987,920,4114,4063,2361,1529,7793,6933,860,6933,4648,2285,2021-01-01,zipcode,Greenville
ZCTA5 75407,48,24864,78743,1442,219100,18977,5656,15615,2356,5118,4927,2559,655,8445,7998,447,7998,5980,2018,2021-01-01,zipcode,Princeton
ZCTA5 75409,48,20437,75328,1711,232400,15035,4461,12927,1601,3576,3302,3297,1151,7617,6823,794,6823,5244,1579,2021-01-01,zipcode,Anna
ZCTA5 75410,48,4470,65281,812,144000,3908,2043,3750,744,1548,856,434,168,2502,2029,473,2029,1769,260,2021-01-01,zipcode,Alba
ZCTA5 75411,48,832,-666666666,1331,86400,643,331,572,73,302,111,79,7,477,327,150,327,148,179,2021-01-01,zipcode,Arthur city
ZCTA5 75412,48,562,58750,-666666666,84800,477,204,391,26,71,227,24,43,332,240,92,240,195,45,2021-01-01,zipcode,Bagwell
ZCTA5 75413,48,188,-666666666,1057,59600,159,78,138,72,33,33,0,0,79,70,9,70,47,23,2021-01-01,zipcode,Bailey
ZCTA5 75414,48,2989,73471,775,179000,2165,673,1917,95,569,839,330,84,1327,1116,211,1116,919,197,2021-01-01,zipcode,Bells
ZCTA5 75415,48,317,96786,-666666666,-666666666,280,123,236,23,96,60,49,8,128,122,6,122,112,10,2021-01-01,zipcode,Ben franklin
ZCTA5 75416,48,2890,67974,845,129200,2159,833,1939,165,657,525,456,136,1232,1083,149,1083,897,186,2021-01-01,zipcode,Blossom
ZCTA5 75417,48,2479,42200,1102,117900,1892,962,1615,356,551,472,153,83,1116,878,238,878,676,202,2021-01-01,zipcode,Bogata
ZCTA5 75418,48,14726,52078,871,146400,12499,6903,10817,1715,3874,3324,1190,714,5713,4953,760,4953,3389,1564,2021-01-01,zipcode,Bonham
ZCTA5 75420,48,1384,62548,691,112300,1109,327,906,157,301,243,146,59,648,604,44,604,525,79,2021-01-01,zipcode,Brashear
ZCTA5 75421,48,851,-666666666,777,-666666666,514,191,442,159,181,92,0,10,343,235,108,235,203,32,2021-01-01,zipcode,Brookston
ZCTA5 75422,48,2862,62917,950,144400,2403,1026,2192,322,756,557,374,183,1328,1161,167,1161,894,267,2021-01-01,zipcode,Campbell
ZCTA5 75423,48,3055,50833,863,138700,2430,987,2119,193,881,828,154,63,1327,1146,181,1146,933,213,2021-01-01,zipcode,Celeste
ZCTA5 75424,48,3679,70972,1209,219100,2820,1094,2468,492,816,862,180,118,1364,1282,82,1282,1083,199,2021-01-01,zipcode,Blue ridge
ZCTA5 75426,48,3774,36719,599,58500,3355,1791,3153,319,1434,1010,278,112,2482,1704,778,1704,1219,485,2021-01-01,zipcode,Clarksville
ZCTA5 75428,48,11000,45614,882,109300,8953,3490,5677,491,1829,1859,833,665,4541,3742,799,3742,1887,1855,2021-01-01,zipcode,Commerce
ZCTA5 75431,48,1745,62500,897,69000,1408,662,1244,297,588,304,39,16,676,506,170,506,376,130,2021-01-01,zipcode,Como
ZCTA5 75432,48,3055,56667,804,119200,2269,808,1880,224,552,538,383,183,1334,1082,252,1082,823,259,2021-01-01,zipcode,Cooper
ZCTA5 75433,48,3145,71173,841,132300,2493,1084,2257,283,700,700,430,144,1323,1175,148,1175,897,278,2021-01-01,zipcode,Cumby
ZCTA5 75435,48,1137,38523,536,68800,892,435,841,113,329,243,126,30,650,471,179,471,325,146,2021-01-01,zipcode,Deport
ZCTA5 75436,48,2155,47443,492,156400,1694,787,1412,162,553,492,169,36,954,749,205,749,563,186,2021-01-01,zipcode,Detroit
ZCTA5 75437,48,1094,57083,1031,151900,822,319,740,63,249,309,78,41,531,434,97,434,397,37,2021-01-01,zipcode,Dike
ZCTA5 75438,48,953,92083,1550,117300,774,301,609,64,195,165,149,36,418,350,68,350,260,90,2021-01-01,zipcode,Dodd city
ZCTA5 75439,48,1141,57656,936,91700,832,276,696,123,317,189,35,32,471,417,54,417,213,204,2021-01-01,zipcode,Ector
ZCTA5 75440,48,6665,56637,843,178400,5666,2834,5144,748,1667,1862,502,365,3258,2578,680,2578,2064,514,2021-01-01,zipcode,Emory
ZCTA5 75441,48,134,14114,-666666666,65500,134,117,123,79,27,0,9,8,102,102,0,102,94,8,2021-01-01,zipcode,Enloe
ZCTA5 75442,48,10453,66482,1287,240600,8211,3634,7176,930,2354,2368,1215,309,4264,3843,421,3843,3051,792,2021-01-01,zipcode,Farmersville
ZCTA5 75446,48,3536,53435,775,138100,2627,1363,2372,406,736,659,442,129,1695,1377,318,1377,1033,344,2021-01-01,zipcode,Honey grove
ZCTA5 75447,48,1067,77212,-666666666,172700,794,310,749,116,256,300,52,25,460,423,37,423,388,35,2021-01-01,zipcode,Ivanhoe
ZCTA5 75448,48,919,-666666666,-666666666,118800,674,334,619,51,256,234,72,6,343,343,0,343,317,26,2021-01-01,zipcode,Klondike
ZCTA5 75449,48,1165,52344,753,92400,955,409,760,97,236,319,67,41,608,438,170,438,266,172,2021-01-01,zipcode,Ladonia
ZCTA5 75450,48,309,115954,-666666666,213400,282,63,282,11,63,181,27,0,233,177,56,177,168,9,2021-01-01,zipcode,Lake creek
ZCTA5 75451,48,1475,45375,-666666666,119500,1190,562,1062,120,254,423,227,38,836,541,295,541,496,45,2021-01-01,zipcode,Leesburg
ZCTA5 75452,48,4688,66154,884,179200,3669,1393,2906,387,934,1024,390,171,1714,1484,230,1484,1066,418,2021-01-01,zipcode,Leonard
ZCTA5 75453,48,2757,73013,1047,156700,2012,718,1787,222,616,555,320,74,1190,1046,144,1046,883,163,2021-01-01,zipcode,Lone oak
ZCTA5 75454,48,15341,119535,1922,325800,11230,3359,9317,511,1910,2783,3011,1102,4858,4705,153,4705,4127,578,2021-01-01,zipcode,Melissa
ZCTA5 75455,48,26687,52962,738,113500,19754,7219,16044,3217,5911,4084,2099,733,10198,9116,1082,9116,5881,3235,2021-01-01,zipcode,Mount pleasant
ZCTA5 75457,48,6228,60445,861,166400,4834,1547,4140,485,1284,1248,827,296,2832,1936,896,1936,1389,547,2021-01-01,zipcode,Mount vernon
ZCTA5 75459,48,5709,68649,930,166900,4120,1009,3592,342,1038,1386,548,278,2141,1988,153,1988,1358,630,2021-01-01,zipcode,Howe
ZCTA5 75460,48,24287,37099,766,93800,19421,7496,16426,2420,5700,5813,1689,804,11643,10235,1408,10235,5202,5033,2021-01-01,zipcode,Paris
ZCTA5 75462,48,11232,57014,802,176300,8478,3569,7541,661,2111,2640,1345,784,4606,4294,312,4294,3244,1050,2021-01-01,zipcode,Paris
ZCTA5 75468,48,1068,63101,-666666666,117000,895,462,768,0,211,367,42,148,392,379,13,379,348,31,2021-01-01,zipcode,Pattonville
ZCTA5 75469,48,346,71250,725,180300,320,163,268,42,41,97,78,10,204,142,62,142,128,14,2021-01-01,zipcode,Pecan gap
ZCTA5 75470,48,202,73690,-666666666,57500,202,87,202,15,135,33,8,11,147,108,39,108,83,25,2021-01-01,zipcode,Petty
ZCTA5 75471,48,1932,50240,1071,117000,1381,532,1170,197,504,316,138,15,768,645,123,645,408,237,2021-01-01,zipcode,Pickton
ZCTA5 75472,48,4405,54688,847,131900,3660,1611,3130,336,1247,828,561,158,2050,1623,427,1623,1225,398,2021-01-01,zipcode,Point
ZCTA5 75473,48,3773,75045,-666666666,143500,3113,1335,2910,344,1100,862,443,161,1516,1410,106,1410,1324,86,2021-01-01,zipcode,Powderly
ZCTA5 75474,48,16394,59338,927,130200,13336,5819,11150,2147,3905,3255,1342,501,6968,5969,999,5969,4713,1256,2021-01-01,zipcode,Quinlan
ZCTA5 75475,48,31,38942,-666666666,94200,31,6,20,0,7,13,0,0,32,25,7,25,25,0,2021-01-01,zipcode,Randolph
ZCTA5 75476,48,1072,52266,-666666666,188800,993,481,918,163,386,247,62,60,545,491,54,491,431,60,2021-01-01,zipcode,Ravenna
ZCTA5 75477,48,1100,72917,655,-666666666,877,327,788,94,274,199,158,63,462,380,82,380,261,119,2021-01-01,zipcode,Roxton
ZCTA5 75478,48,825,50125,877,111100,691,338,612,136,177,225,56,18,352,317,35,317,241,76,2021-01-01,zipcode,Saltillo
ZCTA5 75479,48,2122,68355,857,138100,1789,664,1641,135,582,621,198,105,831,730,101,730,584,146,2021-01-01,zipcode,Savoy
ZCTA5 75480,48,1786,63736,-666666666,226300,1508,802,1393,24,275,653,259,182,1291,739,552,739,739,0,2021-01-01,zipcode,Scroggins
ZCTA5 75481,48,401,70417,-666666666,142200,309,147,249,16,123,61,38,11,202,145,57,145,136,9,2021-01-01,zipcode,Sulphur bluff
ZCTA5 75482,48,25220,56711,868,156000,19704,6944,16766,2107,5761,5102,2588,1208,10671,9550,1121,9550,6225,3325,2021-01-01,zipcode,Sulphur springs
ZCTA5 75486,48,2442,81094,829,172000,1949,570,1673,179,691,594,145,64,1015,939,76,939,860,79,2021-01-01,zipcode,Sumner
ZCTA5 75487,48,1534,56635,651,100600,1133,476,930,170,299,286,129,46,621,480,141,480,394,86,2021-01-01,zipcode,Talco
ZCTA5 75488,48,798,60817,883,222900,556,231,507,11,224,198,63,11,408,281,127,281,240,41,2021-01-01,zipcode,Telephone
ZCTA5 75489,48,939,63750,999,161200,704,272,632,65,121,323,95,28,390,368,22,368,203,165,2021-01-01,zipcode,Tom bean
ZCTA5 75490,48,2891,87243,1297,215000,2321,599,2106,155,799,757,260,135,1194,1025,169,1025,870,155,2021-01-01,zipcode,Trenton
ZCTA5 75491,48,4914,72781,696,173600,3996,1580,3339,361,942,1223,595,218,2062,1859,203,1859,1499,360,2021-01-01,zipcode,Whitewright
ZCTA5 75492,48,341,98977,-666666666,155700,236,92,230,33,63,89,36,9,185,129,56,129,114,15,2021-01-01,zipcode,Windom
ZCTA5 75493,48,720,50000,506,50700,459,153,333,156,94,60,19,4,207,180,27,180,107,73,2021-01-01,zipcode,Winfield
ZCTA5 75494,48,10785,60199,860,150700,8397,4124,7357,1046,2176,2577,1131,427,4932,3812,1120,3812,3067,745,2021-01-01,zipcode,Winnsboro
ZCTA5 75495,48,9208,81099,1084,275700,6878,2281,5826,473,1550,2333,1129,341,3423,3043,380,3043,2532,511,2021-01-01,zipcode,Van alstyne
ZCTA5 75496,48,3578,66509,838,148700,2873,1240,2475,232,974,718,343,208,1484,1265,219,1265,1008,257,2021-01-01,zipcode,Wolfe city
ZCTA5 75497,48,3623,62940,768,165900,3221,1752,2884,368,754,1117,554,91,1901,1587,314,1587,1352,235,2021-01-01,zipcode,Yantis
ZCTA5 75501,48,35111,43533,721,115800,27987,13202,24015,2964,8732,8389,2910,1020,15256,13008,2248,13008,7626,5382,2021-01-01,zipcode,Texarkana
ZCTA5 75503,48,27361,73415,1009,184400,21013,8093,18353,984,4038,6497,4232,2602,11173,10214,959,10214,6398,3816,2021-01-01,zipcode,Texarkana
ZCTA5 75550,48,876,61500,475,81900,741,261,644,36,328,153,86,41,383,298,85,298,266,32,2021-01-01,zipcode,Annona
ZCTA5 75551,48,11040,60396,817,126400,8551,3612,7524,768,2827,2269,1105,555,5003,4283,720,4283,3268,1015,2021-01-01,zipcode,Atlanta
ZCTA5 75554,48,2078,41827,667,130900,1740,848,1465,167,772,335,126,65,1067,837,230,837,713,124,2021-01-01,zipcode,Avery
ZCTA5 75555,48,1424,45098,635,75900,1270,760,1129,116,504,364,108,37,905,668,237,668,577,91,2021-01-01,zipcode,Bivins
ZCTA5 75556,48,1162,61786,825,81800,888,335,792,105,394,185,85,23,509,414,95,414,295,119,2021-01-01,zipcode,Bloomburg
ZCTA5 75558,48,1958,82585,-666666666,80300,1640,873,1414,380,695,283,51,5,661,640,21,640,640,0,2021-01-01,zipcode,Cookville
ZCTA5 75559,48,5392,47865,621,97800,4167,2112,3710,335,1687,1132,279,277,2753,2154,599,2154,1494,660,2021-01-01,zipcode,De kalb
ZCTA5 75560,48,1071,45862,1025,49700,864,337,710,206,242,123,78,61,512,432,80,432,347,85,2021-01-01,zipcode,Douglassville
ZCTA5 75561,48,4626,51163,767,92100,3755,1616,3287,425,1344,923,391,204,2380,1932,448,1932,1351,581,2021-01-01,zipcode,Hooks
ZCTA5 75562,48,80,-666666666,-666666666,-666666666,80,37,60,0,53,0,7,0,33,33,0,33,33,0,2021-01-01,zipcode,Kildare
ZCTA5 75563,48,3816,45313,586,100400,3176,1957,2807,353,1125,869,299,161,1929,1570,359,1570,1151,419,2021-01-01,zipcode,Linden
ZCTA5 75565,48,207,16574,-666666666,157500,80,47,43,0,42,1,0,0,37,34,3,34,7,27,2021-01-01,zipcode,Mc leod
ZCTA5 75566,48,631,55417,-666666666,121900,533,343,469,84,161,167,47,10,394,243,151,243,240,3,2021-01-01,zipcode,Marietta
ZCTA5 75567,48,4087,54977,712,109900,3220,1498,2808,165,1396,696,332,219,2008,1601,407,1601,1162,439,2021-01-01,zipcode,Maud
ZCTA5 75568,48,2873,46112,793,95500,2223,919,2017,297,1052,438,123,107,1507,1223,284,1223,851,372,2021-01-01,zipcode,Naples
ZCTA5 75569,48,3478,48750,785,121600,2499,547,1694,49,544,825,45,231,1275,1200,75,1200,701,499,2021-01-01,zipcode,Nash
ZCTA5 75570,48,11162,61563,710,103600,9198,5148,7947,1428,2967,2056,944,552,3792,3166,626,3166,2162,1004,2021-01-01,zipcode,New boston
ZCTA5 75571,48,2367,52443,651,98100,1984,898,1774,139,658,691,125,161,1305,973,332,973,897,76,2021-01-01,zipcode,Omaha
ZCTA5 75572,48,3474,40156,636,57300,2920,1335,2569,412,1251,566,256,84,1803,1458,345,1458,1111,347,2021-01-01,zipcode,Queen city
ZCTA5 75573,48,218,-666666666,907,9999,121,45,117,15,16,79,7,0,87,68,19,68,19,49,2021-01-01,zipcode,Redwater
ZCTA5 75574,48,1157,60100,425,78200,939,500,854,88,352,233,96,85,614,482,132,482,388,94,2021-01-01,zipcode,Simms
ZCTA5 75601,48,15683,54068,825,156700,12341,5414,10631,1363,3107,3620,1700,841,6586,5714,872,5714,3605,2109,2021-01-01,zipcode,Longview
ZCTA5 75602,48,21024,49000,789,88200,15809,5790,12317,2867,3657,3953,1330,510,8498,7272,1226,7272,4839,2433,2021-01-01,zipcode,Longview
ZCTA5 75603,48,6733,55324,862,126800,5247,2073,4459,319,1413,1780,659,288,3135,2632,503,2632,2289,343,2021-01-01,zipcode,Longview
ZCTA5 75604,48,30349,56726,890,151000,22837,8711,19486,2971,5205,7335,2718,1257,12999,11638,1361,11638,6716,4922,2021-01-01,zipcode,Longview
ZCTA5 75605,48,33730,66858,1026,199100,27434,9682,23377,1373,6120,9344,4562,1978,15659,14201,1458,14201,7701,6500,2021-01-01,zipcode,Longview
ZCTA5 75630,48,2306,38618,795,89900,1994,1184,1883,228,755,613,242,45,1504,1028,476,1028,872,156,2021-01-01,zipcode,Avinger
ZCTA5 75631,48,2696,73512,796,108300,2071,840,1825,143,556,817,176,133,1165,897,268,897,702,195,2021-01-01,zipcode,Beckville
ZCTA5 75633,48,12799,58030,721,128700,10194,4211,8596,1489,2412,3330,1067,298,6303,4811,1492,4811,3560,1251,2021-01-01,zipcode,Carthage
ZCTA5 75638,48,5001,46546,648,94300,3977,1806,3310,342,1205,1240,325,198,2295,1939,356,1939,1454,485,2021-01-01,zipcode,Daingerfield
ZCTA5 75639,48,2525,29861,-666666666,116100,2119,1097,1816,433,750,588,23,22,1307,918,389,918,833,85,2021-01-01,zipcode,De berry
ZCTA5 75640,48,5791,73214,881,216900,4398,1492,3672,314,1258,1340,360,400,2174,2000,174,2000,1557,443,2021-01-01,zipcode,Diana
ZCTA5 75641,48,88,41458,-666666666,-666666666,84,52,77,14,33,30,0,0,61,45,16,45,25,20,2021-01-01,zipcode,Easton
ZCTA5 75642,48,53,-666666666,-666666666,-666666666,53,28,53,0,0,53,0,0,25,25,0,25,25,0,2021-01-01,zipcode,Elysian fields
ZCTA5 75643,48,2138,52321,718,125300,1675,801,1508,278,454,569,155,52,1143,867,276,867,707,160,2021-01-01,zipcode,Gary
ZCTA5 75644,48,12594,45769,825,148100,10008,5314,8559,1190,2988,2905,1059,417,5184,4342,842,4342,3065,1277,2021-01-01,zipcode,Gilmer
ZCTA5 75645,48,10125,64870,1040,163200,8219,3571,7279,732,2174,2789,1223,361,4515,3901,614,3901,3402,499,2021-01-01,zipcode,Gilmer
ZCTA5 75647,48,12405,47461,850,130100,9378,3793,8440,1617,2769,2848,906,300,5210,4670,540,4670,3330,1340,2021-01-01,zipcode,Gladewater
ZCTA5 75650,48,9239,72840,1014,165400,6946,2585,6133,592,1651,2096,1081,713,3693,3239,454,3239,2204,1035,2021-01-01,zipcode,Hallsville
ZCTA5 75651,48,2101,60295,868,168300,1728,824,1541,176,722,399,188,56,995,841,154,841,682,159,2021-01-01,zipcode,Harleton
ZCTA5 75652,48,14011,57449,924,165900,11813,6752,9988,1824,3300,3233,1074,557,4916,4015,901,4015,2894,1121,2021-01-01,zipcode,Henderson
ZCTA5 75654,48,12945,61134,878,138100,10091,3764,8566,1498,2739,2635,940,754,5519,4797,722,4797,3747,1050,2021-01-01,zipcode,Henderson
ZCTA5 75656,48,4768,43583,745,96300,3563,1834,3036,493,1365,751,315,112,2012,1649,363,1649,1212,437,2021-01-01,zipcode,Hughes springs
ZCTA5 75657,48,7366,44539,784,96800,6136,2832,5144,680,2164,1505,622,173,4135,3026,1109,3026,2238,788,2021-01-01,zipcode,Jefferson
ZCTA5 75661,48,2482,51896,726,79400,2137,1206,1814,406,621,531,223,33,1723,885,838,885,702,183,2021-01-01,zipcode,Karnack
ZCTA5 75662,48,25153,62407,918,130400,18912,7328,16276,2774,4628,6074,1896,904,9702,8510,1192,8510,6563,1947,2021-01-01,zipcode,Kilgore
ZCTA5 75667,48,1457,48382,891,85900,1205,487,971,238,319,353,39,22,603,528,75,528,417,111,2021-01-01,zipcode,Laneville
ZCTA5 75668,48,2272,43250,821,129800,1904,1103,1594,72,923,506,51,42,1217,967,250,967,626,341,2021-01-01,zipcode,Lone star
ZCTA5 75669,48,1124,75890,-666666666,114100,766,573,668,153,145,307,54,9,341,261,80,261,261,0,2021-01-01,zipcode,Long branch
ZCTA5 75670,48,18855,37478,763,79700,14436,6497,11529,2226,4086,3538,1114,565,7547,6303,1244,6303,3761,2542,2021-01-01,zipcode,Marshall
ZCTA5 75672,48,16700,62876,896,153700,13025,5435,11310,1056,3444,4036,1987,787,7244,5886,1358,5886,4713,1173,2021-01-01,zipcode,Marshall
ZCTA5 75681,48,2563,51734,900,132100,2235,1051,1792,149,649,628,233,133,1280,1059,221,1059,941,118,2021-01-01,zipcode,Mount enterprise
ZCTA5 75682,48,667,55962,-666666666,156900,524,287,479,50,168,183,64,14,278,256,22,256,250,6,2021-01-01,zipcode,New london
ZCTA5 75683,48,3998,44143,1010,100700,3219,1632,2731,497,970,972,267,25,1816,1450,366,1450,1200,250,2021-01-01,zipcode,Ore city
ZCTA5 75684,48,7558,47688,935,116800,5605,2700,4722,788,1838,1539,452,105,2625,2144,481,2144,1802,342,2021-01-01,zipcode,Overton
ZCTA5 75686,48,13396,51239,734,131100,10045,4091,8514,1061,2941,2611,1284,617,5910,4628,1282,4628,3549,1079,2021-01-01,zipcode,Pittsburg
ZCTA5 75691,48,4465,81095,852,141100,3370,1079,3079,260,974,1349,375,121,1985,1500,485,1500,1133,367,2021-01-01,zipcode,Tatum
ZCTA5 75692,48,4698,56097,1144,124000,4050,2090,3703,259,1529,1297,451,167,2232,1813,419,1813,1640,173,2021-01-01,zipcode,Waskom
ZCTA5 75693,48,6353,80063,1066,184600,4637,1615,4101,276,1244,1773,553,255,2405,2146,259,2146,1509,637,2021-01-01,zipcode,White oak
ZCTA5 75701,48,34296,57373,1006,150400,27765,9959,22222,2400,4861,8555,4581,1825,14411,12080,2331,12080,7141,4939,2021-01-01,zipcode,Tyler
ZCTA5 75702,48,28236,44648,792,82600,20978,8117,16553,4727,5282,5414,774,356,10279,8409,1870,8409,4385,4024,2021-01-01,zipcode,Tyler
ZCTA5 75703,48,42414,68483,1082,250300,33821,11824,28252,1356,4952,10412,7627,3905,19112,16830,2282,16830,8998,7832,2021-01-01,zipcode,Tyler
ZCTA5 75704,48,9575,46378,892,124900,7819,3244,6906,1741,1413,2640,812,300,4102,3091,1011,3091,2454,637,2021-01-01,zipcode,Tyler
ZCTA5 75705,48,2722,43333,-666666666,-666666666,2242,1006,2050,196,630,938,235,51,1159,804,355,804,640,164,2021-01-01,zipcode,Tyler
ZCTA5 75706,48,10142,60421,718,95500,7783,2902,6833,1387,2323,2341,609,173,4093,3139,954,3139,2419,720,2021-01-01,zipcode,Tyler
ZCTA5 75707,48,14455,68040,1235,199200,11892,4906,10207,806,2231,3401,2351,1418,6507,5635,872,5635,4378,1257,2021-01-01,zipcode,Tyler
ZCTA5 75708,48,10419,68121,820,127700,7188,2201,5976,2139,1710,1615,253,259,3799,3028,771,3028,2311,717,2021-01-01,zipcode,Tyler
ZCTA5 75709,48,4596,65639,1217,163100,3955,1486,3457,318,659,1191,839,450,2748,2018,730,2018,1157,861,2021-01-01,zipcode,Tyler
ZCTA5 75750,48,3644,66223,863,136400,2964,1300,2645,365,1157,607,309,207,1385,1293,92,1293,975,318,2021-01-01,zipcode,Arp
ZCTA5 75751,48,17098,47813,837,123900,13587,6147,10957,2078,3608,3163,1174,934,6909,5776,1133,5776,3548,2228,2021-01-01,zipcode,Athens
ZCTA5 75752,48,7450,60302,872,145200,5813,2722,5350,594,1372,1954,930,500,3490,2773,717,2773,2453,320,2021-01-01,zipcode,Athens
ZCTA5 75754,48,7961,82415,954,203700,6688,2826,5798,677,1416,2583,742,380,3238,2910,328,2910,2302,608,2021-01-01,zipcode,Ben wheeler
ZCTA5 75755,48,4576,48345,878,124300,3762,1705,3261,764,1243,859,293,102,2330,1762,568,1762,1102,660,2021-01-01,zipcode,Big sandy
ZCTA5 75756,48,4403,71133,1014,122400,3408,1020,2967,328,890,1009,359,381,1928,1599,329,1599,1177,422,2021-01-01,zipcode,Brownsboro
ZCTA5 75757,48,13699,72015,1087,207400,10477,4548,9253,693,2017,3349,1926,1268,5490,4967,523,4967,4212,755,2021-01-01,zipcode,Bullard
ZCTA5 75758,48,9726,54875,878,108400,7936,3962,7010,834,2649,2114,1123,290,4584,3721,863,3721,3019,702,2021-01-01,zipcode,Chandler
ZCTA5 75759,48,110,22917,-666666666,-666666666,89,42,69,8,24,37,0,0,38,33,5,33,31,2,2021-01-01,zipcode,Cuney
ZCTA5 75760,48,2481,67778,585,137900,2002,1044,1837,206,667,564,195,205,1444,1118,326,1118,915,203,2021-01-01,zipcode,Cushing
ZCTA5 75762,48,14609,74650,1103,225000,10841,3997,9725,320,1849,3231,2714,1611,6227,5219,1008,5219,4302,917,2021-01-01,zipcode,Flint
ZCTA5 75763,48,6507,59091,876,104500,5079,2463,4517,520,1698,1638,345,316,2986,2334,652,2334,2047,287,2021-01-01,zipcode,Frankston
ZCTA5 75764,48,208,68250,558,72900,149,33,117,38,35,37,7,0,91,74,17,74,40,34,2021-01-01,zipcode,Gallatin
ZCTA5 75765,48,7705,55082,852,131300,6578,3708,5341,458,1502,1761,914,706,4371,3059,1312,3059,2607,452,2021-01-01,zipcode,Hawkins
ZCTA5 75766,48,25577,47752,776,115700,19160,7591,16029,3740,4803,4579,1869,1038,10814,9562,1252,9562,6702,2860,2021-01-01,zipcode,Jacksonville
ZCTA5 75770,48,2517,81667,1003,185900,2148,1129,1944,232,627,743,219,123,1387,1010,377,1010,879,131,2021-01-01,zipcode,Larue
ZCTA5 75771,48,21260,75315,1124,213500,17092,7247,14447,1092,4192,5346,2539,1278,8969,7680,1289,7680,6352,1328,2021-01-01,zipcode,Lindale
ZCTA5 75773,48,13478,54406,828,159900,11415,5685,9858,1506,3511,3193,830,818,5926,5245,681,5245,3833,1412,2021-01-01,zipcode,Mineola
ZCTA5 75778,48,2443,41111,876,111100,1984,992,1756,143,595,692,260,66,1457,1038,419,1038,772,266,2021-01-01,zipcode,Murchison
ZCTA5 75779,48,0,-666666666,-666666666,-666666666,0,0,0,0,0,0,0,0,0,0,0,0,0,0,2021-01-01,zipcode,Neches
ZCTA5 75780,48,362,85208,821,76400,290,78,220,96,48,40,10,26,188,123,65,123,106,17,2021-01-01,zipcode,New summerfield
ZCTA5 75783,48,8316,57832,820,131500,6485,3239,5798,836,1845,1913,639,565,4069,3293,776,3293,2825,468,2021-01-01,zipcode,Quitman
ZCTA5 75784,48,768,51750,854,118500,610,209,475,49,177,137,55,57,304,217,87,217,191,26,2021-01-01,zipcode,Reklaw
ZCTA5 75785,48,10813,55434,819,120300,8912,4961,7609,1265,2610,2606,932,196,3981,3389,592,3389,2562,827,2021-01-01,zipcode,Rusk
ZCTA5 75788,48,28,-666666666,-666666666,-666666666,28,28,28,0,0,28,0,0,28,28,0,28,0,28,2021-01-01,zipcode,Sacul
ZCTA5 75789,48,8919,73263,1017,165900,6530,2306,5657,794,1731,1841,935,356,3446,3128,318,3128,2430,698,2021-01-01,zipcode,Troup
ZCTA5 75790,48,3383,59531,834,142600,2493,850,2157,204,516,917,348,172,1427,1287,140,1287,944,343,2021-01-01,zipcode,Van
ZCTA5 75791,48,14093,80402,1210,181800,10802,3179,9142,584,1900,3603,2045,1010,5510,5005,505,5005,3589,1416,2021-01-01,zipcode,Whitehouse
ZCTA5 75792,48,3134,45236,1057,120000,2506,1238,2269,203,835,1028,141,62,1325,1046,279,1046,803,243,2021-01-01,zipcode,Winona
ZCTA5 75801,48,15740,48215,868,125300,12144,3841,10592,1266,4080,3335,1402,509,7016,5930,1086,5930,3545,2385,2021-01-01,zipcode,Palestine
ZCTA5 75803,48,21941,46860,856,134900,18661,12681,16470,3486,6381,5069,995,539,7004,5845,1159,5845,4159,1686,2021-01-01,zipcode,Palestine
ZCTA5 75831,48,4981,48385,800,84300,3944,1911,3471,700,1119,1270,240,142,2612,1871,741,1871,1259,612,2021-01-01,zipcode,Buffalo
ZCTA5 75833,48,2223,51172,538,122000,2008,1147,1751,156,568,653,227,147,1647,933,714,933,676,257,2021-01-01,zipcode,Centerville
ZCTA5 75835,48,11597,42919,723,129900,9343,5021,8033,1651,2742,2329,963,348,6099,4411,1688,4411,2935,1476,2021-01-01,zipcode,Crockett
ZCTA5 75838,48,457,49205,-666666666,169100,371,221,324,60,136,88,40,0,314,143,171,143,112,31,2021-01-01,zipcode,Donie
ZCTA5 75839,48,6001,55974,953,99400,4679,2059,3770,434,1405,1328,485,118,2415,1993,422,1993,1574,419,2021-01-01,zipcode,Elkhart
ZCTA5 75840,48,6504,67159,721,157800,4913,2082,4294,794,1376,1420,489,215,3202,2321,881,2321,1717,604,2021-01-01,zipcode,Fairfield
ZCTA5 75844,48,4622,43895,726,113500,3830,1600,3501,469,1217,1142,448,225,2936,1779,1157,1779,1265,514,2021-01-01,zipcode,Grapeland
ZCTA5 75845,48,2105,49766,681,76800,1821,914,1719,444,401,616,211,47,1439,939,500,939,702,237,2021-01-01,zipcode,Groveton
ZCTA5 75846,48,2786,43125,742,167300,2008,877,1766,329,665,461,216,95,1733,1128,605,1128,885,243,2021-01-01,zipcode,Jewett
ZCTA5 75847,48,1635,39947,925,94800,1233,697,1161,158,470,305,141,87,856,554,302,554,418,136,2021-01-01,zipcode,Kennard
ZCTA5 75848,48,90,41563,592,-666666666,87,33,69,3,34,26,6,0,47,35,12,35,21,14,2021-01-01,zipcode,Kirvin
ZCTA5 75849,48,106,28125,825,80800,90,55,77,26,34,12,0,5,56,43,13,43,27,16,2021-01-01,zipcode,Latexo
ZCTA5 75850,48,1544,-666666666,-666666666,161500,1228,658,1137,344,346,220,204,23,596,499,97,499,446,53,2021-01-01,zipcode,Leona
ZCTA5 75851,48,4956,57391,881,122100,4515,3572,4135,1070,1691,1111,152,111,1240,840,400,840,710,130,2021-01-01,zipcode,Lovelady
ZCTA5 75852,48,3306,53244,953,110000,3025,2564,2710,522,1230,755,140,63,626,467,159,467,406,61,2021-01-01,zipcode,Midway
ZCTA5 75853,48,775,59526,-666666666,208300,633,287,565,52,236,181,68,28,573,343,230,343,301,42,2021-01-01,zipcode,Montalba
ZCTA5 75855,48,2862,41823,745,121900,2392,1288,2174,252,880,687,276,79,1707,1160,547,1160,963,197,2021-01-01,zipcode,Oakwood
ZCTA5 75856,48,173,-666666666,-666666666,-666666666,148,45,63,0,25,0,38,0,137,76,61,76,20,56,2021-01-01,zipcode,Pennington
ZCTA5 75858,48,46,-666666666,-666666666,-666666666,37,28,37,22,15,0,0,0,92,31,61,31,17,14,2021-01-01,zipcode,Ratcliff
ZCTA5 75859,48,2125,54722,1218,163400,1893,1069,1713,222,486,468,388,149,1476,948,528,948,732,216,2021-01-01,zipcode,Streetman
ZCTA5 75860,48,6248,54958,736,102300,5097,2901,4481,849,1768,1386,337,141,2361,1665,696,1665,1432,233,2021-01-01,zipcode,Teague
ZCTA5 75861,48,1727,51406,773,84000,1339,483,1249,153,360,470,171,95,992,731,261,731,409,322,2021-01-01,zipcode,Tennessee colony
ZCTA5 75862,48,10245,43447,703,99700,8308,4676,7386,1044,3102,2228,708,304,6089,4365,1724,4365,3113,1252,2021-01-01,zipcode,Trinity
ZCTA5 75901,48,28979,52531,927,127800,22397,8649,18583,3241,5607,5899,2427,1409,11681,10313,1368,10313,6782,3531,2021-01-01,zipcode,Lufkin
ZCTA5 75904,48,34663,54624,906,129700,26007,9791,21964,3059,6584,8122,2784,1415,14428,12687,1741,12687,7649,5038,2021-01-01,zipcode,Lufkin
ZCTA5 75925,48,3446,44192,730,91800,2740,1216,2179,369,695,811,220,84,1575,1316,259,1316,816,500,2021-01-01,zipcode,Alto
ZCTA5 75926,48,1220,53026,691,93000,985,468,808,91,324,286,74,33,701,522,179,522,416,106,2021-01-01,zipcode,Apple springs
ZCTA5 75928,48,1070,21917,-666666666,64100,1037,700,862,157,419,275,11,0,533,420,113,420,376,44,2021-01-01,zipcode,Bon wier
ZCTA5 75929,48,1553,59375,678,145500,1342,717,1112,74,384,589,36,29,1330,603,727,603,442,161,2021-01-01,zipcode,Broaddus
ZCTA5 75930,48,1649,34792,1006,73400,1358,825,1258,259,560,262,142,35,1071,690,381,690,596,94,2021-01-01,zipcode,Bronson
ZCTA5 75931,48,1821,48602,788,154100,1508,811,1404,196,500,412,213,83,1796,824,972,824,693,131,2021-01-01,zipcode,Brookeland
ZCTA5 75932,48,1343,50240,-666666666,91400,1168,683,1018,210,367,358,55,28,1131,527,604,527,508,19,2021-01-01,zipcode,Burkeville
ZCTA5 75933,48,1624,47803,-666666666,60800,1119,487,996,134,425,316,92,29,708,552,156,552,514,38,2021-01-01,zipcode,Call
ZCTA5 75934,48,195,-666666666,-666666666,-666666666,151,58,125,0,40,55,30,0,149,56,93,56,56,0,2021-01-01,zipcode,Camden
ZCTA5 75935,48,12426,49338,837,79900,9603,4148,8038,1721,3045,2228,727,317,5426,4439,987,4439,3362,1077,2021-01-01,zipcode,Center
ZCTA5 75936,48,967,55750,-666666666,146200,759,358,642,121,259,180,46,36,455,291,164,291,258,33,2021-01-01,zipcode,Chester
ZCTA5 75937,48,1298,73125,617,58900,1044,469,929,169,315,284,136,25,594,444,150,444,380,64,2021-01-01,zipcode,Chireno
ZCTA5 75938,48,2217,41273,759,100800,1834,935,1703,239,675,506,222,61,1627,944,683,944,761,183,2021-01-01,zipcode,Colmesneil
ZCTA5 75939,48,5440,42028,599,77900,4454,1773,3588,710,1652,862,281,83,2102,1604,498,1604,1117,487,2021-01-01,zipcode,Corrigan
ZCTA5 75941,48,8470,52816,-666666666,89300,6578,3387,5641,1268,1738,1813,594,228,2853,2484,369,2484,1959,525,2021-01-01,zipcode,Diboll
ZCTA5 75942,48,171,-666666666,-666666666,-666666666,171,107,171,107,64,0,0,0,73,39,34,39,0,39,2021-01-01,zipcode,Doucette
ZCTA5 75943,48,1171,62604,1184,154200,877,353,727,43,176,275,174,59,515,421,94,421,359,62,2021-01-01,zipcode,Douglass
ZCTA5 75944,48,904,48304,809,81900,767,426,703,85,212,280,89,37,689,421,268,421,391,30,2021-01-01,zipcode,Etoile
ZCTA5 75946,48,3714,58833,690,125400,3051,1464,2610,247,886,984,394,99,1738,1466,272,1466,1076,390,2021-01-01,zipcode,Garrison
ZCTA5 75948,48,5595,40938,724,136800,4898,3070,4575,558,1456,1572,548,441,4779,2570,2209,2570,2243,327,2021-01-01,zipcode,Hemphill
ZCTA5 75949,48,8469,43954,708,75100,6838,3247,6014,711,2539,2162,490,112,4059,3290,769,3290,2330,960,2021-01-01,zipcode,Huntington
ZCTA5 75951,48,15026,41003,825,104200,11927,5460,10360,1480,4381,2896,1018,585,7201,5691,1510,5691,4277,1414,2021-01-01,zipcode,Jasper
ZCTA5 75954,48,2550,41636,679,77900,2019,915,1790,404,583,514,186,103,1447,1006,441,1006,763,243,2021-01-01,zipcode,Joaquin
ZCTA5 75956,48,8275,42904,718,123500,6506,3090,5515,924,2573,1434,207,377,3668,3167,501,3167,2514,653,2021-01-01,zipcode,Kirbyville
ZCTA5 75959,48,742,57240,-666666666,134200,523,263,479,86,164,140,58,31,614,245,369,245,215,30,2021-01-01,zipcode,Milam
ZCTA5 75960,48,606,54969,-666666666,115500,444,118,374,170,75,122,7,0,374,205,169,205,198,7,2021-01-01,zipcode,Moscow
ZCTA5 75961,48,14909,37540,819,122400,11641,3710,9178,1353,3316,2977,1077,455,7741,6276,1465,6276,2979,3297,2021-01-01,zipcode,Nacogdoches
ZCTA5 75962,48,3149,-666666666,-666666666,-666666666,3149,1929,39,0,0,23,16,0,0,0,0,0,0,0,2021-01-01,zipcode,
ZCTA5 75964,48,19889,52825,818,96700,14379,5906,12212,2941,3980,3170,1251,870,7813,6775,1038,6775,4331,2444,2021-01-01,zipcode,Nacogdoches
ZCTA5 75965,48,18231,48527,808,195800,15130,5755,10103,551,2206,2962,2628,1756,8755,7619,1136,7619,3898,3721,2021-01-01,zipcode,Nacogdoches
ZCTA5 75966,48,4462,39310,759,87200,3576,1552,2989,426,1375,874,248,66,2046,1540,506,1540,1055,485,2021-01-01,zipcode,Newton
ZCTA5 75968,48,2235,41410,568,78600,1731,868,1465,254,562,516,46,87,1067,855,212,855,673,182,2021-01-01,zipcode,Pineland
ZCTA5 75969,48,3719,69286,1132,141600,3189,1331,2885,594,925,786,374,206,1572,1434,138,1434,1187,247,2021-01-01,zipcode,Pollok
ZCTA5 75972,48,6190,42279,644,70200,5098,2669,4464,877,2077,851,414,245,3389,2492,897,2492,1825,667,2021-01-01,zipcode,San augustine
ZCTA5 75973,48,2809,47474,874,101300,2231,1038,1911,273,676,618,281,63,1554,1111,443,1111,927,184,2021-01-01,zipcode,Shelbyville
ZCTA5 75974,48,3296,35972,430,82000,2257,1083,2024,497,635,610,239,43,1509,1194,315,1194,841,353,2021-01-01,zipcode,Tenaha
ZCTA5 75975,48,3868,52547,714,124300,2971,1164,2497,290,712,1208,219,68,1791,1319,472,1319,971,348,2021-01-01,zipcode,Timpson
ZCTA5 75976,48,1239,57639,678,52900,817,326,665,171,151,217,60,66,410,347,63,347,216,131,2021-01-01,zipcode,Wells
ZCTA5 75977,48,378,19194,843,62600,250,107,248,63,115,70,0,0,283,158,125,158,121,37,2021-01-01,zipcode,Wiergate
ZCTA5 75979,48,12023,44014,826,86800,9960,5699,8546,1924,3405,2147,773,297,5052,3519,1533,3519,2702,817,2021-01-01,zipcode,Woodville
ZCTA5 75980,48,2407,32425,869,72700,1981,1004,1675,305,532,675,127,36,1984,1009,975,1009,862,147,2021-01-01,zipcode,Zavalla
ZCTA5 76001,48,37134,90368,1593,252600,27451,8753,22299,2239,4070,6971,6270,2749,11558,11238,320,11238,8883,2355,2021-01-01,zipcode,Arlington
ZCTA5 76002,48,34402,93948,1873,229400,25976,6666,21298,2376,4882,7301,4354,2385,9840,9625,215,9625,8121,1504,2021-01-01,zipcode,Arlington
ZCTA5 76006,48,24547,51033,1131,259400,20433,4366,16883,1372,3261,5594,4243,2413,13660,12127,1533,12127,2946,9181,2021-01-01,zipcode,Arlington
ZCTA5 76008,48,22091,138417,1461,365700,16117,4837,14332,403,2315,3719,4833,3062,7450,7224,226,7224,6633,591,2021-01-01,zipcode,Aledo
ZCTA5 76009,48,20751,63424,1070,136200,15687,6421,13422,3296,5195,3218,1183,530,7566,6814,752,6814,5251,1563,2021-01-01,zipcode,Alvarado
ZCTA5 76010,48,57448,38419,1045,142000,40876,14306,30531,11892,9202,6229,2316,892,20178,17995,2183,17995,5966,12029,2021-01-01,zipcode,Arlington
ZCTA5 76011,48,21701,45224,1084,174700,17162,4532,14599,2681,3150,4753,2598,1417,11293,9863,1430,9863,1972,7891,2021-01-01,zipcode,Arlington
ZCTA5 76012,48,28750,73261,1155,241900,22565,7672,19550,1292,3996,5825,5642,2795,11551,10905,646,10905,6870,4035,2021-01-01,zipcode,Arlington
ZCTA5 76013,48,34457,61912,1083,231800,28059,9111,22244,1907,4842,6295,6043,3157,14195,13098,1097,13098,6415,6683,2021-01-01,zipcode,Arlington
ZCTA5 76014,48,32460,55764,1265,158100,24472,7963,20136,4970,6274,5524,2740,628,11451,10639,812,10639,5065,5574,2021-01-01,zipcode,Arlington
ZCTA5 76015,48,17629,63609,1296,179800,13933,4304,11398,1169,2788,3924,2211,1306,6964,6226,738,6226,2975,3251,2021-01-01,zipcode,Arlington
ZCTA5 76016,48,31008,94593,1698,238400,25100,8908,21848,979,4822,7448,5732,2867,11474,11043,431,11043,8965,2078,2021-01-01,zipcode,Arlington
ZCTA5 76017,48,45429,83362,1258,215500,36795,10733,30638,2354,6745,10537,7613,3389,16884,15906,978,15906,10682,5224,2021-01-01,zipcode,Arlington
ZCTA5 76018,48,28553,75962,1650,177500,21863,5306,17064,2831,4641,5220,2729,1643,8682,8375,307,8375,6237,2138,2021-01-01,zipcode,Arlington
ZCTA5 76020,48,32443,80840,1032,200700,25616,9582,22765,2406,7198,8661,3332,1168,13248,11697,1551,11697,9294,2403,2021-01-01,zipcode,Azle
ZCTA5 76021,48,35401,81356,1216,279400,28473,8611,25083,1269,4144,8476,7957,3237,15207,14596,611,14596,7890,6706,2021-01-01,zipcode,Bedford
ZCTA5 76022,48,14224,67489,1247,202700,11440,3469,9625,531,2303,4109,2008,674,6199,5717,482,5717,2834,2883,2021-01-01,zipcode,Bedford
ZCTA5 76023,48,7203,78726,1101,220200,5807,1999,5001,693,1859,1593,683,173,2602,2430,172,2430,2100,330,2021-01-01,zipcode,Boyd
ZCTA5 76028,48,74217,87884,1476,230800,56449,18731,48636,3618,14171,16856,9137,4854,26602,25330,1272,25330,19229,6101,2021-01-01,zipcode,Burleson
ZCTA5 76031,48,18996,65048,965,150600,14409,5942,12229,2403,4752,3064,1486,524,6626,6163,463,6163,4748,1415,2021-01-01,zipcode,Cleburne
ZCTA5 76033,48,26174,59869,1102,161700,20447,8314,17412,2284,6565,5214,2268,1081,10403,9925,478,9925,6511,3414,2021-01-01,zipcode,Cleburne
ZCTA5 76034,48,25717,180584,2549,586200,20173,7026,18126,204,1299,4156,7560,4907,9194,9002,192,9002,8563,439,2021-01-01,zipcode,Colleyville
ZCTA5 76035,48,2844,104965,1192,282900,2090,645,1766,115,510,578,344,219,1133,897,236,897,715,182,2021-01-01,zipcode,Cresson
ZCTA5 76036,48,29594,83069,1528,215100,22136,7195,18749,1455,5620,6390,3564,1720,10369,9607,762,9607,7114,2493,2021-01-01,zipcode,Crowley
ZCTA5 76039,48,40657,73216,1428,250700,32645,7164,28121,1971,5851,9409,7193,3697,18088,17165,923,17165,6656,10509,2021-01-01,zipcode,Euless
ZCTA5 76040,48,30787,57770,1007,224000,23778,6702,20365,2505,4980,6978,4344,1558,12636,11623,1013,11623,4868,6755,2021-01-01,zipcode,Euless
ZCTA5 76041,48,370,111583,-666666666,111000,335,149,323,22,51,174,76,0,184,173,11,173,173,0,2021-01-01,zipcode,Forreston
ZCTA5 76043,48,7094,88091,686,231900,5726,2281,5097,626,1695,1479,996,301,2720,2410,310,2410,1903,507,2021-01-01,zipcode,Glen rose
ZCTA5 76044,48,6466,82018,965,305100,5080,1876,4336,181,1934,1454,546,221,2467,2331,136,2331,2017,314,2021-01-01,zipcode,Godley
ZCTA5 76048,48,25691,57213,1036,165200,20511,9192,18006,1987,5947,5698,2911,1463,12746,10566,2180,10566,7428,3138,2021-01-01,zipcode,Granbury
ZCTA5 76049,48,29154,92492,1251,245800,24457,10690,22390,1225,5293,7759,5422,2691,13174,11845,1329,11845,10485,1360,2021-01-01,zipcode,Granbury
ZCTA5 76050,48,6760,72004,1058,183700,5395,1964,4712,536,1585,1721,681,189,2682,2483,199,2483,1967,516,2021-01-01,zipcode,Grandview
ZCTA5 76051,48,50066,99000,1590,368000,40342,9236,34961,2007,5547,9033,12268,6106,21487,20488,999,20488,10638,9850,2021-01-01,zipcode,Grapevine
ZCTA5 76052,48,26240,131226,1723,307900,19374,4999,16763,861,2390,5163,5910,2439,8341,8180,161,8180,7450,730,2021-01-01,zipcode,Haslet
ZCTA5 76053,48,31513,58256,1169,189700,23464,7661,20294,2745,5251,6412,4215,1671,12316,11202,1114,11202,6132,5070,2021-01-01,zipcode,Hurst
ZCTA5 76054,48,11989,102763,1315,281700,9824,3103,8852,301,1395,2842,2878,1436,4816,4650,166,4650,3822,828,2021-01-01,zipcode,Hurst
ZCTA5 76055,48,3255,61481,846,126400,2621,1114,2174,290,720,843,148,173,1306,1126,180,1126,858,268,2021-01-01,zipcode,Itasca
ZCTA5 76058,48,20702,62810,1126,147100,15955,5783,12814,2038,4631,4123,1339,683,7602,7054,548,7054,5142,1912,2021-01-01,zipcode,Joshua
ZCTA5 76059,48,4982,44455,855,142200,3806,1471,2677,597,686,749,461,184,1803,1589,214,1589,609,980,2021-01-01,zipcode,Keene
ZCTA5 76060,48,8183,102806,1114,269900,6683,2017,5874,879,1516,1634,1257,588,3188,2908,280,2908,2121,787,2021-01-01,zipcode,Kennedale
ZCTA5 76061,48,262,-666666666,-666666666,-666666666,155,0,155,0,53,102,0,0,79,79,0,79,79,0,2021-01-01,zipcode,Lillian
ZCTA5 76063,48,76867,102370,1474,302200,58497,18266,48648,3426,10059,16591,11879,6693,25961,24778,1183,24778,18833,5945,2021-01-01,zipcode,Mansfield
ZCTA5 76064,48,1999,65500,1294,199500,1490,537,1421,253,379,374,189,226,737,702,35,702,411,291,2021-01-01,zipcode,Maypearl
ZCTA5 76065,48,40814,110205,1371,295700,30347,8934,26245,1619,6627,8874,6352,2773,14059,13446,613,13446,11106,2340,2021-01-01,zipcode,Midlothian
ZCTA5 76066,48,5030,85824,-666666666,311000,3370,1579,2885,408,842,774,357,504,1886,1547,339,1547,1266,281,2021-01-01,zipcode,Millsap
ZCTA5 76067,48,20420,57923,849,119600,15655,6340,13307,1857,5305,4448,1231,466,8434,7037,1397,7037,4820,2217,2021-01-01,zipcode,Mineral wells
ZCTA5 76070,48,814,120750,-666666666,-666666666,536,53,401,0,138,169,94,0,327,307,20,307,307,0,2021-01-01,zipcode,Nemo
ZCTA5 76071,48,4242,84730,961,214300,3211,1015,2587,388,1016,814,289,80,1471,1346,125,1346,1069,277,2021-01-01,zipcode,Newark
ZCTA5 76073,48,6443,97850,1033,192200,5289,1771,4543,585,1742,1239,825,152,2398,2231,167,2231,1892,339,2021-01-01,zipcode,Paradise
ZCTA5 76077,48,491,-666666666,-666666666,196500,491,321,424,11,117,141,62,93,299,183,116,183,183,0,2021-01-01,zipcode,Rainbow
ZCTA5 76078,48,8753,83263,1255,207800,6662,2225,6015,605,1998,2243,961,208,3273,2974,299,2974,2446,528,2021-01-01,zipcode,Rhome
ZCTA5 76082,48,22082,75728,1068,184000,16916,6388,14380,2016,5122,5147,1512,583,8318,7281,1037,7281,6088,1193,2021-01-01,zipcode,Springtown
ZCTA5 76084,48,10375,75444,971,178200,8028,3427,6763,952,2876,1928,607,400,3194,2967,227,2967,2615,352,2021-01-01,zipcode,Venus
ZCTA5 76085,48,11143,84339,1305,266100,9303,3514,7969,1066,2386,3008,1054,455,4037,3695,342,3695,3272,423,2021-01-01,zipcode,Weatherford
ZCTA5 76086,48,21054,57253,1107,164800,16649,6184,13988,1823,4653,4936,1771,805,9052,8301,751,8301,4420,3881,2021-01-01,zipcode,Weatherford
ZCTA5 76087,48,28779,94639,1255,284300,23090,8712,20426,1713,4105,6674,5533,2401,12393,10920,1473,10920,9835,1085,2021-01-01,zipcode,Weatherford
ZCTA5 76088,48,14669,81625,1068,277600,11643,4355,10239,971,3544,3274,1791,659,5394,5154,240,5154,4296,858,2021-01-01,zipcode,Weatherford
ZCTA5 76092,48,31276,240694,1497,725300,22315,8361,19583,236,1558,3491,8119,6179,9802,9454,348,9454,9030,424,2021-01-01,zipcode,Southlake
ZCTA5 76093,48,3239,47764,992,88600,2539,890,2295,516,599,850,228,102,1355,1291,64,1291,922,369,2021-01-01,zipcode,Rio vista
ZCTA5 76102,48,10650,73415,1422,276700,9878,5729,8350,1429,2097,1876,1512,1436,4730,3897,833,3897,961,2936,2021-01-01,zipcode,Fort worth
ZCTA5 76103,48,17363,52738,990,143500,13140,4389,10345,3242,2855,2281,1170,797,5962,5364,598,5364,3322,2042,2021-01-01,zipcode,Fort worth
ZCTA5 76104,48,18956,41863,1109,102600,14357,5879,12081,3522,3554,2680,1428,897,8756,7178,1578,7178,2898,4280,2021-01-01,zipcode,Fort worth
ZCTA5 76105,48,24277,40680,940,84500,17755,7443,13171,5673,4340,2458,490,210,7863,6934,929,6934,3741,3193,2021-01-01,zipcode,Fort worth
ZCTA5 76106,48,37437,48905,1025,98200,26689,8549,21596,9744,6925,3555,1134,238,11462,10809,653,10809,5154,5655,2021-01-01,zipcode,Fort worth
ZCTA5 76107,48,29929,73102,1265,346400,25928,8136,22626,2502,3218,4540,7629,4737,17067,15053,2014,15053,7058,7995,2021-01-01,zipcode,Fort worth
ZCTA5 76108,48,44125,70625,1221,180000,34085,11643,29146,2985,8523,10290,4852,2496,17531,16071,1460,16071,10934,5137,2021-01-01,zipcode,Fort worth
ZCTA5 76109,48,24606,89477,1365,526500,20149,7304,14686,442,1165,2842,5983,4254,10830,9528,1302,9528,5025,4503,2021-01-01,zipcode,Fort worth
ZCTA5 76110,48,33505,56611,1094,168000,25462,9001,20357,6949,3775,3948,3581,2104,12652,11280,1372,11280,6718,4562,2021-01-01,zipcode,Fort worth
ZCTA5 76111,48,21591,50212,1070,126200,16408,5353,13164,4668,4376,2364,1432,324,8106,7298,808,7298,4222,3076,2021-01-01,zipcode,Fort worth
ZCTA5 76112,48,42404,50435,1044,154300,33070,10894,27828,4513,7718,9477,4338,1782,19342,17012,2330,17012,8226,8786,2021-01-01,zipcode,Fort worth
ZCTA5 76114,48,27683,58003,1040,131600,21847,8130,17766,4529,6238,4549,1758,692,10531,9572,959,9572,5359,4213,2021-01-01,zipcode,Fort worth
ZCTA5 76115,48,21824,43211,980,95100,15423,5993,12165,5714,2858,1770,857,966,6669,6125,544,6125,2880,3245,2021-01-01,zipcode,Fort worth
ZCTA5 76116,48,49319,50459,1056,250700,38731,13063,32958,4239,8209,9745,7148,3617,25243,22075,3168,22075,7624,14451,2021-01-01,zipcode,Fort worth
ZCTA5 76117,48,32438,48522,1026,141400,24095,8543,20319,5809,8013,4577,1353,567,11648,10991,657,10991,5927,5064,2021-01-01,zipcode,Haltom city
ZCTA5 76118,48,16674,81006,1226,217100,13387,3679,11472,1150,3012,4033,2132,1145,6327,5740,587,5740,4066,1674,2021-01-01,zipcode,Fort worth
ZCTA5 76119,48,51037,41368,1050,98200,37020,15775,30514,10257,10703,7108,1728,718,16432,14645,1787,14645,7593,7052,2021-01-01,zipcode,Fort worth
ZCTA5 76120,48,20518,69969,1134,219000,15624,3973,13088,1217,3153,4651,2695,1372,8586,7592,994,7592,3852,3740,2021-01-01,zipcode,Fort worth
ZCTA5 76123,48,38575,87956,1856,206800,28562,8291,23689,2667,6748,6359,5045,2870,12324,11887,437,11887,8963,2924,2021-01-01,zipcode,Fort worth
ZCTA5 76126,48,24946,97407,1395,251900,18792,6359,16616,884,3246,5121,4603,2762,10047,8922,1125,8922,7343,1579,2021-01-01,zipcode,Fort worth
ZCTA5 76127,48,1781,96544,1809,-666666666,1759,1271,1290,291,484,458,24,33,45,45,0,45,0,45,2021-01-01,zipcode,Naval air station jrb
ZCTA5 76129,48,1700,-666666666,-666666666,-666666666,1700,1232,18,0,0,6,12,0,0,0,0,0,0,0,2021-01-01,zipcode,Fort worth
ZCTA5 76131,48,47569,94361,1556,240700,34494,9684,29920,2604,6517,9827,7882,3090,15682,15471,211,15471,11931,3540,2021-01-01,zipcode,Fort worth
ZCTA5 76132,48,26437,58113,1158,325800,21599,6961,18309,767,4162,4666,5219,3495,13784,12615,1169,12615,3991,8624,2021-01-01,zipcode,Fort worth
ZCTA5 76133,48,54186,64083,1214,168500,40073,14118,34061,4525,9164,10396,5790,4186,20223,19012,1211,19012,11572,7440,2021-01-01,zipcode,Fort worth
ZCTA5 76134,48,29208,60294,1107,156200,22069,7047,17860,3138,6409,5078,1912,1323,10531,9800,731,9800,5742,4058,2021-01-01,zipcode,Fort worth
ZCTA5 76135,48,18939,65315,1067,188500,15554,5237,13060,1372,4012,4250,2402,1024,8254,7682,572,7682,5203,2479,2021-01-01,zipcode,Fort worth
ZCTA5 76137,48,59273,82961,1429,218800,46776,11220,38212,3470,9004,13716,8706,3316,22904,21343,1561,21343,12900,8443,2021-01-01,zipcode,Fort worth
ZCTA5 76140,48,31703,61921,1194,147200,23451,8210,19027,4171,6468,5861,1635,892,10620,9767,853,9767,6598,3169,2021-01-01,zipcode,Fort worth
ZCTA5 76148,48,24578,78479,1576,165500,19267,5683,16605,1751,5691,5769,2797,597,8183,7965,218,7965,6418,1547,2021-01-01,zipcode,Fort worth
ZCTA5 76155,48,6427,61402,1197,-666666666,5303,653,4785,279,563,1543,1484,916,3718,3354,364,3354,37,3317,2021-01-01,zipcode,Fort worth
ZCTA5 76164,48,14081,50410,987,95000,11281,4166,9092,4800,2581,1188,408,115,4734,4283,451,4283,2458,1825,2021-01-01,zipcode,Fort worth
ZCTA5 76177,48,19320,91074,1557,265800,14948,2766,12450,198,1973,4281,4141,1857,8601,7730,871,7730,3925,3805,2021-01-01,zipcode,Fort worth
ZCTA5 76179,48,70425,97046,1639,242300,51584,13221,44894,3220,12168,15150,10446,3910,24528,23515,1013,23515,18079,5436,2021-01-01,zipcode,Fort worth
ZCTA5 76180,48,36974,67384,1238,221900,30181,8983,25663,2608,6053,8906,5589,2507,15688,14909,779,14909,7508,7401,2021-01-01,zipcode,North richland hills
ZCTA5 76182,48,30911,102414,1423,287000,24379,7783,21654,1051,4414,7397,6410,2382,11714,11294,420,11294,9484,1810,2021-01-01,zipcode,North richland hills
ZCTA5 76201,48,28415,32372,989,207200,26415,9077,12587,950,1977,4299,3340,2021,12688,11076,1612,11076,2160,8916,2021-01-01,zipcode,Denton
ZCTA5 76205,48,20365,56331,1150,251800,17906,5641,12596,1295,2473,3619,3553,1656,8505,7612,893,7612,2816,4796,2021-01-01,zipcode,Denton
ZCTA5 76207,48,15961,79413,1317,284800,13554,5747,11359,863,2073,3562,3179,1682,6639,6254,385,6254,3981,2273,2021-01-01,zipcode,Denton
ZCTA5 76208,48,26598,85625,1361,285200,19465,6398,16504,1670,3530,5183,3989,2132,8902,8281,621,8281,5483,2798,2021-01-01,zipcode,Denton
ZCTA5 76209,48,26660,63179,1206,204100,21481,5942,16813,2066,3398,5213,3796,2340,11132,10316,816,10316,4617,5699,2021-01-01,zipcode,Denton
ZCTA5 76210,48,44367,100962,1553,276300,36214,10884,29895,2331,5479,9297,8176,4612,16082,15670,412,15670,11834,3836,2021-01-01,zipcode,Denton
ZCTA5 76225,48,3193,75417,851,199800,2701,817,2392,142,825,895,302,228,1357,1271,86,1271,1054,217,2021-01-01,zipcode,Alvord
ZCTA5 76226,48,34829,145582,2356,435000,26634,9088,23056,386,2781,5572,10009,4308,11785,11659,126,11659,10860,799,2021-01-01,zipcode,Argyle
ZCTA5 76227,48,43088,99424,1656,280500,31009,6927,28034,1000,5130,9836,8639,3429,15962,15459,503,15459,12086,3373,2021-01-01,zipcode,Aubrey
ZCTA5 76228,48,1210,63125,914,87700,1004,467,887,78,330,282,155,42,575,488,87,488,395,93,2021-01-01,zipcode,Bellevue
ZCTA5 76230,48,9921,62614,886,148700,7716,3388,6849,930,2538,2178,812,391,5057,3972,1085,3972,3169,803,2021-01-01,zipcode,Bowie
ZCTA5 76233,48,3535,80858,984,186300,2771,996,2362,199,753,756,504,150,1325,1257,68,1257,923,334,2021-01-01,zipcode,Collinsville
ZCTA5 76234,48,19147,80106,1181,245800,14930,5131,12514,1606,3327,4641,1864,1076,7579,6671,908,6671,5190,1481,2021-01-01,zipcode,Decatur
ZCTA5 76238,48,332,81250,-666666666,108800,276,90,251,13,107,79,37,15,138,124,14,124,103,21,2021-01-01,zipcode,Era
ZCTA5 76239,48,1080,57313,736,184600,932,433,817,19,284,360,101,53,576,483,93,483,357,126,2021-01-01,zipcode,Forestburg
ZCTA5 76240,48,29209,56114,1016,155800,22626,8017,19156,2678,5792,6829,2498,1359,12418,11487,931,11487,7256,4231,2021-01-01,zipcode,Gainesville
ZCTA5 76244,48,74884,111289,1646,276400,54111,14076,46329,2025,8727,14525,15163,5889,25136,23997,1139,23997,18217,5780,2021-01-01,zipcode,Keller
ZCTA5 76245,48,1731,32404,716,117000,1472,938,1441,248,368,599,135,91,1287,808,479,808,609,199,2021-01-01,zipcode,Gordonville
ZCTA5 76247,48,16511,104752,1692,250000,12593,3493,10712,449,2274,4707,2351,931,5692,5496,196,5496,4703,793,2021-01-01,zipcode,Justin
ZCTA5 76248,48,40553,149016,1763,419700,31074,9955,26798,1079,3201,6809,10187,5522,14577,14267,310,14267,11576,2691,2021-01-01,zipcode,Keller
ZCTA5 76249,48,9235,81039,1324,218300,7376,2001,6270,468,1503,2148,1624,527,3337,3256,81,3256,2784,472,2021-01-01,zipcode,Krum
ZCTA5 76250,48,1026,91458,1057,198000,841,356,747,34,171,299,162,81,426,418,8,418,373,45,2021-01-01,zipcode,Lindsay
ZCTA5 76251,48,700,60625,1238,164800,559,298,507,46,182,164,102,13,302,241,61,241,198,43,2021-01-01,zipcode,Montague
ZCTA5 76252,48,2424,91058,958,219400,2002,637,1721,105,471,473,443,229,1109,935,174,935,751,184,2021-01-01,zipcode,Muenster
ZCTA5 76253,48,348,57917,-666666666,-666666666,294,125,222,30,134,55,3,0,115,105,10,105,98,7,2021-01-01,zipcode,Myra
ZCTA5 76255,48,5514,48676,676,122500,4296,1985,3886,607,1315,1334,450,180,3032,2174,858,2174,1515,659,2021-01-01,zipcode,Nocona
ZCTA5 76258,48,7056,78533,994,281100,5949,2180,4738,1045,924,1328,1057,384,2695,2650,45,2650,1926,724,2021-01-01,zipcode,Pilot point
ZCTA5 76259,48,5469,80316,1051,230400,4287,1193,3895,578,978,1163,714,462,2118,2078,40,2078,1681,397,2021-01-01,zipcode,Ponder
ZCTA5 76261,48,244,61250,-666666666,51000,195,95,181,41,82,18,33,7,138,90,48,90,61,29,2021-01-01,zipcode,Ringgold
ZCTA5 76262,48,40159,119517,1403,410100,29814,8086,26103,1203,3144,6905,9795,5056,14718,14188,530,14188,10420,3768,2021-01-01,zipcode,Roanoke
ZCTA5 76263,48,14,-666666666,-666666666,-666666666,14,8,14,0,0,0,7,7,4,4,0,4,4,0,2021-01-01,zipcode,Rosston
ZCTA5 76264,48,1203,73958,773,164300,1004,336,963,39,298,405,186,35,674,539,135,539,425,114,2021-01-01,zipcode,Sadler
ZCTA5 76265,48,1529,68277,736,120300,1183,476,1048,64,378,354,197,55,881,609,272,609,459,150,2021-01-01,zipcode,Saint jo
ZCTA5 76266,48,17658,83987,1298,245100,14365,4279,12692,1451,3621,4169,2287,1164,6704,6339,365,6339,5107,1232,2021-01-01,zipcode,Sanger
ZCTA5 76268,48,131,64531,-666666666,-666666666,95,56,95,16,32,35,6,6,58,49,9,49,36,13,2021-01-01,zipcode,Southmayd
ZCTA5 76270,48,1697,85156,-666666666,212800,1533,623,1378,219,596,343,170,50,917,682,235,682,658,24,2021-01-01,zipcode,Sunset
ZCTA5 76271,48,1873,85938,1554,278400,1500,472,1253,128,362,370,284,109,718,652,66,652,526,126,2021-01-01,zipcode,Tioga
ZCTA5 76272,48,4799,87241,706,232800,3927,1526,3719,361,1373,1124,681,180,2034,1788,246,1788,1580,208,2021-01-01,zipcode,Valley view
ZCTA5 76273,48,9922,74298,1012,195100,7988,3114,6897,647,2729,2281,593,647,3990,3814,176,3814,2815,999,2021-01-01,zipcode,Whitesboro
ZCTA5 76301,48,15062,30914,706,57100,11929,5253,9974,2048,4049,2766,571,540,7636,6060,1576,6060,3036,3024,2021-01-01,zipcode,Wichita falls
ZCTA5 76302,48,11423,47562,893,112700,8844,3210,7555,927,2255,2529,1347,497,5256,4893,363,4893,2925,1968,2021-01-01,zipcode,Wichita falls
ZCTA5 76305,48,4639,69645,715,134100,3864,1712,3519,312,1188,1183,596,240,2292,1923,369,1923,1522,401,2021-01-01,zipcode,Wichita falls
ZCTA5 76306,48,14781,44057,813,86100,10832,4262,9335,1285,3670,2947,937,496,6687,5634,1053,5634,3098,2536,2021-01-01,zipcode,Wichita falls
ZCTA5 76308,48,20028,61729,922,157500,16388,5285,12225,621,2931,4445,2617,1611,9499,8327,1172,8327,4658,3669,2021-01-01,zipcode,Wichita falls
ZCTA5 76309,48,14082,50569,861,98300,10888,3757,9159,924,3029,2960,1554,692,6591,5617,974,5617,3414,2203,2021-01-01,zipcode,Wichita falls
ZCTA5 76310,48,19279,73929,965,153600,14947,4603,13168,1036,3383,4943,2538,1268,8312,7514,798,7514,5597,1917,2021-01-01,zipcode,Wichita falls
ZCTA5 76311,48,8037,82708,1307,-666666666,7307,635,1940,10,361,820,440,309,663,636,27,636,6,630,2021-01-01,zipcode,Sheppard afb
ZCTA5 76351,48,1895,50972,560,88500,1482,629,1255,128,485,319,251,72,899,790,109,790,575,215,2021-01-01,zipcode,Archer city
ZCTA5 76354,48,11825,57621,816,117800,9706,4016,8455,764,3228,2567,1167,729,5439,4823,616,4823,3156,1667,2021-01-01,zipcode,Burkburnett
ZCTA5 76357,48,466,57083,738,83800,370,143,331,31,140,77,56,27,314,191,123,191,156,35,2021-01-01,zipcode,Byers
ZCTA5 76360,48,2805,40893,540,48600,2260,1070,2046,250,759,656,322,59,1603,1205,398,1205,876,329,2021-01-01,zipcode,Electra
ZCTA5 76363,48,294,31250,-666666666,-666666666,243,111,194,37,80,63,13,1,154,105,49,105,99,6,2021-01-01,zipcode,Goree
ZCTA5 76364,48,217,56250,1575,62500,167,43,149,7,59,31,28,24,121,89,32,89,48,41,2021-01-01,zipcode,Harrold
ZCTA5 76365,48,4491,62500,672,113100,3579,1591,3130,264,936,1099,572,259,2273,1822,451,1822,1414,408,2021-01-01,zipcode,Henrietta
ZCTA5 76366,48,2036,46579,827,119800,1586,657,1351,175,583,337,181,75,961,804,157,804,657,147,2021-01-01,zipcode,Holliday
ZCTA5 76367,48,13471,60324,1125,113000,11110,6149,10186,1938,3860,2736,1142,510,4282,3918,364,3918,3340,578,2021-01-01,zipcode,Iowa park
ZCTA5 76370,48,447,79167,-666666666,55000,349,116,321,57,188,17,21,38,226,158,68,158,133,25,2021-01-01,zipcode,Megargel
ZCTA5 76371,48,1568,57685,-666666666,49100,1170,445,1052,217,362,319,94,60,762,562,200,562,497,65,2021-01-01,zipcode,Munday
ZCTA5 76372,48,1051,59896,555,65000,773,372,654,127,289,126,85,27,499,397,102,397,285,112,2021-01-01,zipcode,Newcastle
ZCTA5 76373,48,185,72566,-666666666,-666666666,177,84,138,66,31,10,31,0,61,61,0,61,54,7,2021-01-01,zipcode,Oklaunion
ZCTA5 76374,48,3595,39018,658,72500,2778,1212,2539,305,801,774,485,174,1897,1607,290,1607,1075,532,2021-01-01,zipcode,Olney
ZCTA5 76377,48,399,39250,575,68400,347,198,324,47,144,101,22,10,305,206,99,206,173,33,2021-01-01,zipcode,Petrolia
ZCTA5 76379,48,580,76389,905,108000,463,117,359,35,131,129,57,7,206,186,20,186,137,49,2021-01-01,zipcode,Scotland
ZCTA5 76380,48,3517,43909,529,73500,2818,1374,2507,412,938,669,382,106,2278,1518,760,1518,1040,478,2021-01-01,zipcode,Seymour
ZCTA5 76384,48,12304,44775,745,77200,9853,3842,8340,1794,2764,2562,920,300,5585,4354,1231,4354,2728,1626,2021-01-01,zipcode,Vernon
ZCTA5 76388,48,234,44545,788,52500,200,60,165,29,52,53,28,3,112,88,24,88,65,23,2021-01-01,zipcode,Weinert
ZCTA5 76389,48,1528,96359,678,153700,1183,364,942,103,467,191,146,35,597,511,86,511,438,73,2021-01-01,zipcode,Windthorst
ZCTA5 76401,48,29724,54431,1009,186900,24042,9300,16875,1798,4153,5089,3841,1994,13094,10806,2288,10806,5994,4812,2021-01-01,zipcode,Stephenville
ZCTA5 76402,48,606,-666666666,-666666666,-666666666,606,319,0,0,0,0,0,0,0,0,0,0,0,0,2021-01-01,zipcode,Stephenville
ZCTA5 76424,48,8552,46652,751,76900,6617,2928,5734,929,1924,1818,785,278,4177,3081,1096,3081,2363,718,2021-01-01,zipcode,Breckenridge
ZCTA5 76426,48,11350,66633,937,169500,9058,3442,7775,1500,2369,2452,969,485,4547,3864,683,3864,2782,1082,2021-01-01,zipcode,Bridgeport
ZCTA5 76427,48,1018,65406,850,100600,755,359,604,66,287,176,71,4,405,348,57,348,201,147,2021-01-01,zipcode,Bryson
ZCTA5 76429,48,106,2499,-666666666,166700,106,66,106,0,49,17,40,0,148,78,70,78,78,0,2021-01-01,zipcode,Caddo
ZCTA5 76430,48,2340,58125,-666666666,148800,1873,720,1568,148,389,548,327,156,1153,944,209,944,794,150,2021-01-01,zipcode,Albany
ZCTA5 76431,48,4376,62399,1132,150500,3182,1337,2844,646,1120,790,223,65,1798,1577,221,1577,1353,224,2021-01-01,zipcode,Chico
ZCTA5 76432,48,1086,45658,708,103800,851,374,770,147,280,251,63,29,641,430,211,430,393,37,2021-01-01,zipcode,Blanket
ZCTA5 76433,48,1934,90481,1196,322000,1586,716,1399,31,436,333,353,246,837,691,146,691,609,82,2021-01-01,zipcode,Bluff dale
ZCTA5 76435,48,451,43750,950,81300,391,199,351,63,163,81,37,7,348,188,160,188,173,15,2021-01-01,zipcode,Carbon
ZCTA5 76436,48,114,52083,-666666666,-666666666,105,46,79,0,33,19,22,5,121,54,67,54,47,7,2021-01-01,zipcode,Carlton
ZCTA5 76437,48,5593,57006,679,101500,4605,2016,3528,360,761,1459,682,266,2627,2005,622,2005,1603,402,2021-01-01,zipcode,Cisco
ZCTA5 76442,48,7697,57704,610,111600,5923,2443,5205,662,1653,1884,667,339,3758,2825,933,2825,2374,451,2021-01-01,zipcode,Comanche
ZCTA5 76443,48,2019,44625,495,98600,1486,743,1355,134,447,430,300,44,976,809,167,809,571,238,2021-01-01,zipcode,Cross plains
ZCTA5 76444,48,3477,49324,494,75700,2899,1083,2556,516,884,696,362,98,1698,1366,332,1366,1059,307,2021-01-01,zipcode,De leon
ZCTA5 76445,48,229,-666666666,-666666666,-666666666,184,61,159,9,38,55,0,57,189,73,116,73,73,0,2021-01-01,zipcode,Desdemona
ZCTA5 76446,48,8876,56029,870,140800,7093,2537,5842,1240,2013,1493,825,271,3980,3113,867,3113,2637,476,2021-01-01,zipcode,Dublin
ZCTA5 76448,48,4991,43716,708,150100,4282,2383,4071,494,1325,1141,623,488,3086,2058,1028,2058,1482,576,2021-01-01,zipcode,Eastland
ZCTA5 76449,48,2339,65625,736,203000,2052,927,1887,154,569,744,264,156,2903,1029,1874,1029,887,142,2021-01-01,zipcode,Graford
ZCTA5 76450,48,13090,57650,755,158400,10398,4434,9231,1197,2878,2807,1603,746,6502,5399,1103,5399,4031,1368,2021-01-01,zipcode,Graham
ZCTA5 76452,48,111,182716,-666666666,1021600,111,33,111,0,10,86,15,0,92,53,39,53,53,0,2021-01-01,zipcode,Energy
ZCTA5 76453,48,1515,80000,891,250900,1227,617,1202,108,386,266,236,206,959,680,279,680,585,95,2021-01-01,zipcode,Gordon
ZCTA5 76454,48,1856,37000,586,74700,1463,774,1222,255,357,490,99,21,887,664,223,664,411,253,2021-01-01,zipcode,Gorman
ZCTA5 76455,48,847,50000,660,86100,691,268,594,103,209,147,119,16,470,332,138,332,304,28,2021-01-01,zipcode,Gustine
ZCTA5 76457,48,4194,52439,818,137700,3179,1412,2791,166,1206,910,380,129,2133,1478,655,1478,1134,344,2021-01-01,zipcode,Hico
ZCTA5 76458,48,5930,53180,753,98800,4911,2754,4174,823,1564,1114,449,224,2559,2003,556,2003,1433,570,2021-01-01,zipcode,Jacksboro
ZCTA5 76459,48,166,-666666666,-666666666,70600,141,57,119,15,58,36,0,10,84,52,32,52,52,0,2021-01-01,zipcode,Jermyn
ZCTA5 76460,48,391,63500,-666666666,123000,373,156,258,0,42,99,83,34,236,144,92,144,101,43,2021-01-01,zipcode,Loving
ZCTA5 76462,48,4914,89063,1289,200000,3549,1177,2983,284,867,863,547,422,1691,1557,134,1557,1360,197,2021-01-01,zipcode,Lipan
ZCTA5 76463,48,575,46944,715,68800,515,241,470,67,165,160,70,8,290,204,86,204,172,32,2021-01-01,zipcode,Mingus
ZCTA5 76464,48,381,42813,808,91300,361,179,337,49,89,55,95,49,343,197,146,197,171,26,2021-01-01,zipcode,Moran
ZCTA5 76466,48,523,114952,-666666666,-666666666,309,46,236,26,95,34,81,0,99,99,0,99,75,24,2021-01-01,zipcode,Olden
ZCTA5 76469,48,86,37000,-666666666,60000,80,62,72,19,27,25,1,0,71,40,31,40,40,0,2021-01-01,zipcode,Putnam
ZCTA5 76470,48,3432,36473,755,52400,2646,1144,2185,497,587,866,149,86,1769,1379,390,1379,913,466,2021-01-01,zipcode,Ranger
ZCTA5 76471,48,1500,37400,577,56300,1217,575,1087,135,363,391,146,52,1021,646,375,646,494,152,2021-01-01,zipcode,Rising star
ZCTA5 76472,48,1305,79010,876,125000,1085,372,966,92,297,213,284,80,550,474,76,474,372,102,2021-01-01,zipcode,Santo
ZCTA5 76474,48,286,-666666666,-666666666,319600,218,106,203,3,13,135,33,19,125,104,21,104,100,4,2021-01-01,zipcode,Sidney
ZCTA5 76475,48,1031,42813,663,78500,784,410,746,120,212,273,94,47,858,391,467,391,294,97,2021-01-01,zipcode,Strawn
ZCTA5 76476,48,3406,75833,996,168300,2517,997,2190,214,757,821,267,131,1266,1166,100,1166,980,186,2021-01-01,zipcode,Tolar
ZCTA5 76481,48,233,-666666666,-666666666,-666666666,133,70,115,43,41,0,17,14,104,70,34,70,56,14,2021-01-01,zipcode,South bend
ZCTA5 76483,48,868,49063,-666666666,57800,763,274,630,72,190,206,111,51,586,383,203,383,275,108,2021-01-01,zipcode,Throckmorton
ZCTA5 76484,48,699,68438,717,161200,665,410,546,50,203,182,62,49,465,281,184,281,260,21,2021-01-01,zipcode,Palo pinto
ZCTA5 76486,48,1018,61250,589,268400,840,262,733,69,205,339,91,29,619,431,188,431,359,72,2021-01-01,zipcode,Perrin
ZCTA5 76487,48,2833,70738,2121,157500,2141,769,1743,200,648,635,153,107,1243,931,312,931,794,137,2021-01-01,zipcode,Poolville
ZCTA5 76490,48,54,-666666666,-666666666,-666666666,54,0,36,0,16,11,4,5,31,31,0,31,15,16,2021-01-01,zipcode,Whitt
ZCTA5 76491,48,482,58750,721,85200,345,119,299,16,127,97,48,11,236,185,51,185,140,45,2021-01-01,zipcode,Woodson
ZCTA5 76501,48,17357,48146,773,120400,13393,6156,11160,1619,3487,3960,1510,584,7260,6595,665,6595,4117,2478,2021-01-01,zipcode,Temple
ZCTA5 76502,48,45515,71517,1174,183700,33270,12440,29172,1741,6464,10159,6186,4622,17663,16488,1175,16488,11066,5422,2021-01-01,zipcode,Temple
ZCTA5 76504,48,23916,42793,929,114400,18986,7387,15973,2429,4705,5369,2121,1349,10758,9722,1036,9722,3255,6467,2021-01-01,zipcode,Temple
ZCTA5 76511,48,2497,54286,689,120600,1992,861,1815,327,710,587,120,71,1029,872,157,872,684,188,2021-01-01,zipcode,Bartlett
ZCTA5 76513,48,42610,71858,993,189700,32299,11890,26128,3052,6075,8701,5088,3212,15555,14535,1020,14535,9580,4955,2021-01-01,zipcode,Belton
ZCTA5 76518,48,1536,50000,615,145000,1227,668,962,124,434,306,82,16,631,522,109,522,390,132,2021-01-01,zipcode,Buckholts
ZCTA5 76519,48,250,-666666666,-666666666,-666666666,221,93,221,29,67,75,40,10,313,127,186,127,127,0,2021-01-01,zipcode,Burlington
ZCTA5 76520,48,7692,54267,805,113300,5737,2626,4956,936,1896,1349,542,233,3441,2815,626,2815,1928,887,2021-01-01,zipcode,Cameron
ZCTA5 76522,48,40050,60382,913,132400,30320,11000,26045,1514,7394,11610,3841,1686,15952,14682,1270,14682,9063,5619,2021-01-01,zipcode,Copperas cove
ZCTA5 76523,48,397,52550,-666666666,157100,269,104,230,14,155,61,0,0,111,111,0,111,104,7,2021-01-01,zipcode,Davilla
ZCTA5 76524,48,3813,75000,1124,162400,3036,1234,2626,343,880,891,226,286,1351,1292,59,1292,1026,266,2021-01-01,zipcode,Eddy
ZCTA5 76525,48,1160,68750,691,115000,958,467,837,102,206,274,143,112,594,461,133,461,348,113,2021-01-01,zipcode,Evant
ZCTA5 76527,48,4262,65245,779,306900,3235,1250,2765,295,809,1215,301,145,1671,1583,88,1583,1047,536,2021-01-01,zipcode,Florence
ZCTA5 76528,48,19355,56442,765,134400,15518,7696,14124,2045,4068,5768,1502,741,7836,6762,1074,6762,4816,1946,2021-01-01,zipcode,Gatesville
ZCTA5 76530,48,2277,66563,775,171900,2021,841,1828,208,815,549,155,101,1072,966,106,966,782,184,2021-01-01,zipcode,Granger
ZCTA5 76531,48,4516,41875,766,129300,3761,1796,3097,539,1073,857,490,138,2271,1461,810,1461,1192,269,2021-01-01,zipcode,Hamilton
ZCTA5 76534,48,2953,71250,890,168900,2356,999,2148,302,629,706,327,184,1276,1108,168,1108,887,221,2021-01-01,zipcode,Holland
ZCTA5 76537,48,10273,83401,1492,205600,7825,1974,6631,950,1910,2323,984,464,3667,3474,193,3474,2820,654,2021-01-01,zipcode,Jarrell
ZCTA5 76538,48,1119,60375,-666666666,125800,995,495,904,47,299,318,185,55,578,471,107,471,410,61,2021-01-01,zipcode,Jonesboro
ZCTA5 76539,48,8665,74949,830,200900,7124,3675,6332,363,1882,2978,681,428,3651,3189,462,3189,2895,294,2021-01-01,zipcode,Kempner
ZCTA5 76541,48,18521,31804,741,76400,14680,5733,11831,2166,3547,4940,986,192,9989,7908,2081,7908,1959,5949,2021-01-01,zipcode,Killeen
ZCTA5 76542,48,50527,65433,1150,170500,37931,12190,30815,1652,7251,13381,5999,2532,19714,18486,1228,18486,10823,7663,2021-01-01,zipcode,Killeen
ZCTA5 76543,48,33350,45723,938,102400,24728,7771,20068,2027,6016,8818,2281,926,14571,12893,1678,12893,4932,7961,2021-01-01,zipcode,Killeen
ZCTA5 76544,48,24872,48589,1195,-666666666,20115,3147,6624,126,1205,3791,1137,365,7293,3291,4002,3291,43,3248,2021-01-01,zipcode,Fort hood
ZCTA5 76548,48,31759,73142,965,206300,23812,7656,19978,1652,4810,7031,4552,1933,12196,11250,946,11250,6249,5001,2021-01-01,zipcode,Harker heights
ZCTA5 76549,48,53138,56777,1167,161200,37585,12072,30447,1603,7884,13579,4914,2467,20660,18619,2041,18619,9235,9384,2021-01-01,zipcode,Killeen
ZCTA5 76550,48,13789,65876,792,167200,10886,4631,9745,936,3226,3862,1151,570,6070,5097,973,5097,3783,1314,2021-01-01,zipcode,Lampasas
ZCTA5 76554,48,2360,65109,984,145600,1697,462,1442,195,460,523,202,62,937,840,97,840,612,228,2021-01-01,zipcode,Little river academy
ZCTA5 76556,48,1863,62778,439,104000,1446,542,1202,137,469,378,110,108,912,716,196,716,641,75,2021-01-01,zipcode,Milano
ZCTA5 76557,48,6063,67813,915,161800,5008,1854,4067,368,1321,1407,666,305,2296,2089,207,2089,1623,466,2021-01-01,zipcode,Moody
ZCTA5 76559,48,6260,67263,1020,153100,4643,1276,3894,226,1004,1445,629,590,2746,2369,377,2369,1537,832,2021-01-01,zipcode,Nolanville
ZCTA5 76561,48,1259,70345,834,111100,961,385,844,103,290,267,122,62,525,442,83,442,329,113,2021-01-01,zipcode,Oglesby
ZCTA5 76565,48,115,-666666666,-666666666,266700,115,74,69,10,20,21,0,18,52,52,0,52,52,0,2021-01-01,zipcode,Pottsville
ZCTA5 76566,48,345,130208,-666666666,235000,261,127,244,42,58,71,68,5,180,125,55,125,121,4,2021-01-01,zipcode,Purmela
ZCTA5 76567,48,8790,46058,793,128200,7310,2898,6211,915,2760,1667,584,285,4086,3717,369,3717,2637,1080,2021-01-01,zipcode,Rockdale
ZCTA5 76569,48,3174,74324,1025,94700,2466,955,1857,89,694,717,248,109,1027,894,133,894,782,112,2021-01-01,zipcode,Rogers
ZCTA5 76570,48,2661,35673,642,69500,1981,1029,1656,288,640,490,196,42,1278,904,374,904,714,190,2021-01-01,zipcode,Rosebud
ZCTA5 76571,48,9384,87425,1064,295500,7371,2988,6560,292,1618,1982,1736,932,3743,3394,349,3394,2882,512,2021-01-01,zipcode,Salado
ZCTA5 76573,48,32,-666666666,-666666666,-666666666,26,19,18,13,5,0,0,0,12,12,0,12,12,0,2021-01-01,zipcode,Schwertner
ZCTA5 76574,48,19126,62831,942,192500,15389,5905,13546,2378,4678,4010,1627,853,8147,7438,709,7438,5370,2068,2021-01-01,zipcode,Taylor
ZCTA5 76577,48,3120,71639,826,144700,2521,976,2240,155,824,695,433,133,1466,1255,211,1255,969,286,2021-01-01,zipcode,Thorndale
ZCTA5 76578,48,1453,76944,966,209700,1151,452,1039,136,348,347,161,47,616,544,72,544,425,119,2021-01-01,zipcode,Thrall
ZCTA5 76579,48,7068,69022,873,146500,4718,1772,4139,403,1324,1442,717,253,2178,2086,92,2086,1383,703,2021-01-01,zipcode,Troy
ZCTA5 76596,48,1271,-666666666,-666666666,-666666666,1271,1271,1191,263,312,558,51,7,0,0,0,0,0,0,2021-01-01,zipcode,Gatesville
ZCTA5 76597,48,3304,-666666666,-666666666,-666666666,3304,3304,3133,953,1187,907,45,41,0,0,0,0,0,0,2021-01-01,zipcode,Gatesville
ZCTA5 76598,48,570,-666666666,-666666666,-666666666,570,570,517,106,189,213,6,3,0,0,0,0,0,0,2021-01-01,zipcode,Gatesville
ZCTA5 76599,48,1681,-666666666,-666666666,-666666666,1681,1681,1609,398,515,640,51,5,0,0,0,0,0,0,2021-01-01,zipcode,Gatesville
ZCTA5 76621,48,1025,87727,1063,205400,724,188,666,18,181,244,150,73,489,366,123,366,347,19,2021-01-01,zipcode,Abbott
ZCTA5 76622,48,1734,68333,800,165800,1257,419,1059,77,339,436,146,61,665,546,119,546,463,83,2021-01-01,zipcode,Aquilla
ZCTA5 76623,48,223,46875,-666666666,-666666666,169,45,158,79,26,45,8,0,76,69,7,69,52,17,2021-01-01,zipcode,Avalon
ZCTA5 76624,48,2522,67972,767,129300,2081,947,1581,298,452,668,123,40,1098,876,222,876,773,103,2021-01-01,zipcode,Axtell
ZCTA5 76626,48,1309,82019,1022,110100,1009,388,841,81,256,392,101,11,692,491,201,491,373,118,2021-01-01,zipcode,Blooming grove
ZCTA5 76627,48,1499,71250,1068,96500,1257,368,987,197,369,314,87,20,689,572,117,572,511,61,2021-01-01,zipcode,Blum
ZCTA5 76628,48,110,-666666666,-666666666,-666666666,85,26,64,27,15,17,5,0,43,33,10,33,33,0,2021-01-01,zipcode,Brandon
ZCTA5 76629,48,1781,52250,797,113500,1488,856,1359,209,567,467,88,28,1038,758,280,758,585,173,2021-01-01,zipcode,Bremond
ZCTA5 76630,48,1683,62500,874,205400,1326,568,1233,162,353,614,84,20,712,664,48,664,589,75,2021-01-01,zipcode,Bruceville
ZCTA5 76631,48,636,68750,935,101800,483,166,370,53,134,109,35,39,210,170,40,170,128,42,2021-01-01,zipcode,Bynum
ZCTA5 76632,48,1627,42689,-666666666,87700,1283,585,1178,378,304,355,90,51,733,534,199,534,424,110,2021-01-01,zipcode,Chilton
ZCTA5 76633,48,6286,106010,914,250400,4793,1863,4152,202,1220,1548,717,465,2016,1989,27,1989,1884,105,2021-01-01,zipcode,China spring
ZCTA5 76634,48,7207,62451,822,148400,5808,2604,5260,463,1374,2143,911,369,3817,2838,979,2838,2199,639,2021-01-01,zipcode,Clifton
ZCTA5 76635,48,1498,50882,693,91900,976,401,856,104,212,256,110,174,623,498,125,498,373,125,2021-01-01,zipcode,Coolidge
ZCTA5 76636,48,1507,61923,628,177200,1203,456,1028,147,340,359,159,23,605,540,65,540,470,70,2021-01-01,zipcode,Covington
ZCTA5 76637,48,369,60625,488,240000,318,187,280,32,99,83,42,24,226,181,45,181,126,55,2021-01-01,zipcode,Cranfills gap
ZCTA5 76638,48,3095,103710,1154,264400,2289,919,2072,66,539,768,432,267,1195,1066,129,1066,983,83,2021-01-01,zipcode,Crawford
ZCTA5 76639,48,1638,44737,541,100600,1325,588,1169,96,473,434,133,33,876,676,200,676,431,245,2021-01-01,zipcode,Dawson
ZCTA5 76640,48,3140,50304,908,125400,2354,1038,2098,264,907,663,211,53,1272,1136,136,1136,829,307,2021-01-01,zipcode,Elm mott
ZCTA5 76641,48,1768,52250,690,112200,1430,712,1193,252,408,403,78,52,741,602,139,602,515,87,2021-01-01,zipcode,Frost
ZCTA5 76642,48,5917,52628,704,164400,4676,2422,4123,667,1266,1397,638,155,2655,2105,550,2105,1520,585,2021-01-01,zipcode,Groesbeck
ZCTA5 76643,48,15707,72395,1293,188700,12357,4317,10477,563,1945,4122,2484,1363,5840,5655,185,5655,3840,1815,2021-01-01,zipcode,Hewitt
ZCTA5 76645,48,10762,53894,840,104800,8491,3374,7040,1312,2276,2204,802,446,4360,3859,501,3859,2332,1527,2021-01-01,zipcode,Hillsboro
ZCTA5 76648,48,2554,43482,761,88200,2060,1012,1858,241,661,650,227,79,1333,997,336,997,724,273,2021-01-01,zipcode,Hubbard
ZCTA5 76649,48,596,46750,930,125600,501,250,463,30,209,155,65,4,375,276,99,276,229,47,2021-01-01,zipcode,Iredell
ZCTA5 76650,48,160,58000,-666666666,103600,102,31,102,20,36,44,2,0,70,48,22,48,42,6,2021-01-01,zipcode,Irene
ZCTA5 76651,48,3984,58798,965,154300,3108,1259,2540,271,957,894,250,168,1638,1467,171,1467,1013,454,2021-01-01,zipcode,Italy
ZCTA5 76652,48,1169,59276,686,158700,939,484,851,51,469,241,71,19,588,449,139,449,386,63,2021-01-01,zipcode,Kopperl
ZCTA5 76653,48,1409,59792,-666666666,133700,1190,525,1006,114,464,363,52,13,671,533,138,533,427,106,2021-01-01,zipcode,Kosse
ZCTA5 76654,48,184,58750,-666666666,142900,164,62,130,16,32,47,20,15,94,82,12,82,66,16,2021-01-01,zipcode,Leroy
ZCTA5 76655,48,8616,106012,1149,224400,6810,2001,5778,177,1367,2245,1513,476,3184,2946,238,2946,2580,366,2021-01-01,zipcode,Lorena
ZCTA5 76656,48,2671,72727,808,102100,2103,789,1766,186,516,616,336,112,1063,860,203,860,658,202,2021-01-01,zipcode,Lott
ZCTA5 76657,48,11723,79921,1152,306500,9129,3086,7826,744,2029,2390,1776,887,4384,4013,371,4013,2997,1016,2021-01-01,zipcode,Mc gregor
ZCTA5 76660,48,663,42500,845,100000,433,233,339,66,99,110,55,9,280,200,80,200,146,54,2021-01-01,zipcode,Malone
ZCTA5 76661,48,7388,28283,452,48400,6086,3923,5491,1473,1636,1990,220,172,3160,2145,1015,2145,1337,808,2021-01-01,zipcode,Marlin
ZCTA5 76664,48,4015,58409,909,106100,2994,1395,2482,373,830,942,294,43,1438,1280,158,1280,934,346,2021-01-01,zipcode,Mart
ZCTA5 76665,48,2838,60285,600,111900,2352,1041,2044,229,670,814,210,121,1426,1117,309,1117,699,418,2021-01-01,zipcode,Meridian
ZCTA5 76666,48,171,39375,-666666666,85000,143,56,117,17,44,44,4,8,91,66,25,66,42,24,2021-01-01,zipcode,Mertens
ZCTA5 76667,48,10385,46330,692,88400,8419,4108,7094,1262,2602,2374,548,308,4649,3701,948,3701,2685,1016,2021-01-01,zipcode,Mexia
ZCTA5 76670,48,1815,53229,867,114500,1443,500,1274,237,447,521,23,46,614,538,76,538,386,152,2021-01-01,zipcode,Milford
ZCTA5 76671,48,1635,61402,688,158100,1424,780,1281,143,478,462,135,63,973,647,326,647,543,104,2021-01-01,zipcode,Morgan
ZCTA5 76673,48,1253,49196,795,108700,897,349,743,138,220,284,82,19,519,377,142,377,312,65,2021-01-01,zipcode,Mount calm
ZCTA5 76676,48,260,56250,-666666666,116100,188,78,182,21,63,50,42,6,125,104,21,104,99,5,2021-01-01,zipcode,Penelope
ZCTA5 76678,48,77,43194,-666666666,95500,77,52,66,0,13,40,10,3,57,43,14,43,43,0,2021-01-01,zipcode,Prairie hill
ZCTA5 76679,48,1067,66667,-666666666,113600,784,255,672,101,265,174,120,12,471,330,141,330,323,7,2021-01-01,zipcode,Purdon
ZCTA5 76680,48,165,-666666666,-666666666,-666666666,165,104,137,0,84,38,0,15,94,34,60,34,34,0,2021-01-01,zipcode,Reagan
ZCTA5 76681,48,550,26849,1115,91400,436,165,403,42,191,131,38,1,349,211,138,211,154,57,2021-01-01,zipcode,Richland
ZCTA5 76682,48,3182,71250,997,111800,2280,777,1890,225,641,621,318,85,1265,1077,188,1077,889,188,2021-01-01,zipcode,Riesel
ZCTA5 76685,48,43,-666666666,-666666666,-666666666,43,32,43,16,27,0,0,0,56,28,28,28,28,0,2021-01-01,zipcode,Satin
ZCTA5 76686,48,222,51250,894,91300,184,99,175,3,59,71,36,6,129,104,25,104,75,29,2021-01-01,zipcode,Tehuacana
ZCTA5 76687,48,1915,62617,919,228500,1730,1056,1604,120,679,520,226,59,1283,827,456,827,713,114,2021-01-01,zipcode,Thornton
ZCTA5 76689,48,3878,54817,978,149100,3000,958,2585,281,855,1004,269,176,1749,1446,303,1446,1129,317,2021-01-01,zipcode,Valley mills
ZCTA5 76690,48,1200,40568,892,102300,839,367,758,148,373,125,56,56,668,413,255,413,318,95,2021-01-01,zipcode,Walnut springs
ZCTA5 76691,48,6357,65625,890,158400,4931,1845,4383,578,1428,1490,624,263,2751,2427,324,2427,1904,523,2021-01-01,zipcode,West
ZCTA5 76692,48,9508,57015,739,112100,7934,3629,7222,897,2734,2299,962,330,5282,3839,1443,3839,2981,858,2021-01-01,zipcode,Whitney
ZCTA5 76693,48,2170,48684,699,133800,1775,1067,1580,282,319,622,300,57,1013,808,205,808,580,228,2021-01-01,zipcode,Wortham
ZCTA5 76701,48,1953,36625,1195,115000,1734,743,1364,246,368,332,211,207,943,759,184,759,148,611,2021-01-01,zipcode,Waco
ZCTA5 76704,48,7791,19338,696,106900,5379,2366,4312,780,1797,1443,125,167,3722,3287,435,3287,1037,2250,2021-01-01,zipcode,Waco
ZCTA5 76705,48,31902,45572,784,125900,25588,11797,20112,4084,5893,6798,2180,1157,12290,11109,1181,11109,6232,4877,2021-01-01,zipcode,Waco
ZCTA5 76706,48,39488,35387,903,137900,31934,12314,17865,3207,5471,5381,2389,1417,16081,14079,2002,14079,5575,8504,2021-01-01,zipcode,Waco
ZCTA5 76707,48,16430,31598,929,85600,12068,4636,9400,2476,3093,2418,920,493,6735,5808,927,5808,3013,2795,2021-01-01,zipcode,Waco
ZCTA5 76708,48,26155,57349,925,154500,19547,6292,16295,2644,4048,5816,2357,1430,10580,9508,1072,9508,5967,3541,2021-01-01,zipcode,Waco
ZCTA5 76710,48,23385,45137,919,171700,18931,7140,16337,1343,4427,5413,3195,1959,12190,10705,1485,10705,5287,5418,2021-01-01,zipcode,Waco
ZCTA5 76711,48,10237,48333,1180,78700,8085,2544,6502,1712,2030,1878,462,420,4288,3894,394,3894,2030,1864,2021-01-01,zipcode,Waco
ZCTA5 76712,48,27310,84390,1164,231800,20391,7094,18365,878,2763,5647,5385,3692,11182,10264,918,10264,7056,3208,2021-01-01,zipcode,Woodway
ZCTA5 76798,48,2966,-666666666,-666666666,-666666666,2966,2271,40,0,0,0,40,0,0,0,0,0,0,0,2021-01-01,zipcode,Waco
ZCTA5 76801,48,25081,47638,826,104800,20358,8419,17079,2425,5994,5474,2195,991,11806,9477,2329,9477,6196,3281,2021-01-01,zipcode,Brownwood
ZCTA5 76802,48,5727,60125,963,142400,4477,1650,3907,354,1284,1316,841,112,2444,2141,303,2141,1719,422,2021-01-01,zipcode,Early
ZCTA5 76820,48,119,162969,-666666666,329200,119,57,110,0,24,39,34,13,133,61,72,61,50,11,2021-01-01,zipcode,Art
ZCTA5 76821,48,4430,51934,925,81400,3584,1552,3214,481,1076,1119,322,216,2252,1759,493,1759,1306,453,2021-01-01,zipcode,Ballinger
ZCTA5 76823,48,2698,53029,611,91400,2262,1063,1981,189,771,632,311,78,1274,993,281,993,792,201,2021-01-01,zipcode,Bangs
ZCTA5 76824,48,0,-666666666,-666666666,-666666666,0,0,0,0,0,0,0,0,0,0,0,0,0,0,2021-01-01,zipcode,Bend
ZCTA5 76825,48,6539,45671,812,79900,5255,2028,4566,959,1439,1517,444,207,3390,2610,780,2610,1744,866,2021-01-01,zipcode,Brady
ZCTA5 76827,48,601,-666666666,675,157300,527,333,473,112,115,207,31,8,367,283,84,283,261,22,2021-01-01,zipcode,Brookesmith
ZCTA5 76828,48,202,65368,-666666666,-666666666,182,134,182,10,30,103,39,0,166,99,67,99,99,0,2021-01-01,zipcode,Burkett
ZCTA5 76831,48,0,-666666666,-666666666,-666666666,0,0,0,0,0,0,0,0,15,0,15,0,0,0,2021-01-01,zipcode,Castell
ZCTA5 76832,48,678,38646,1033,112500,540,244,426,117,165,95,46,3,322,194,128,194,114,80,2021-01-01,zipcode,Cherokee
ZCTA5 76834,48,4995,45619,719,80700,4062,1714,3592,604,1195,1182,472,139,3007,2103,904,2103,1485,618,2021-01-01,zipcode,Coleman
ZCTA5 76836,48,5,-666666666,-666666666,-666666666,5,1,5,0,3,1,1,0,35,2,33,2,2,0,2021-01-01,zipcode,Doole
ZCTA5 76837,48,2001,36295,721,75300,1750,1329,1605,531,564,340,92,78,646,417,229,417,313,104,2021-01-01,zipcode,Eden
ZCTA5 76841,48,175,-666666666,-666666666,-666666666,58,25,33,0,0,0,12,21,80,12,68,12,0,12,2021-01-01,zipcode,Fort mc kavett
ZCTA5 76842,48,170,48750,-666666666,152500,165,113,157,60,9,35,40,13,184,89,95,89,89,0,2021-01-01,zipcode,Fredonia
ZCTA5 76844,48,3243,54340,625,146700,2658,1192,2351,377,710,691,370,203,1868,1227,641,1227,1032,195,2021-01-01,zipcode,Goldthwaite
ZCTA5 76845,48,263,75156,-666666666,259500,217,98,215,7,65,53,74,16,147,101,46,101,86,15,2021-01-01,zipcode,Gouldbusk
ZCTA5 76848,48,78,-666666666,-666666666,1055000,78,53,78,0,9,69,0,0,74,39,35,39,39,0,2021-01-01,zipcode,Hext
ZCTA5 76849,48,3641,54471,636,124500,2987,1097,2657,387,777,799,425,269,2196,1465,731,1465,1131,334,2021-01-01,zipcode,Junction
ZCTA5 76852,48,304,60625,631,191300,252,140,232,17,81,89,22,23,226,136,90,136,114,22,2021-01-01,zipcode,Lohn
ZCTA5 76853,48,1492,56364,850,164800,1268,617,1126,155,325,366,209,71,884,538,346,538,404,134,2021-01-01,zipcode,Lometa
ZCTA5 76854,48,288,-666666666,-666666666,-666666666,240,92,212,86,55,19,39,13,264,110,154,110,23,87,2021-01-01,zipcode,London
ZCTA5 76856,48,3570,72054,594,229500,2827,1232,2408,437,511,649,641,170,1936,1307,629,1307,1029,278,2021-01-01,zipcode,Mason
ZCTA5 76857,48,1984,43367,1319,-666666666,1719,1007,1586,175,554,568,216,73,1805,926,879,926,655,271,2021-01-01,zipcode,May
ZCTA5 76858,48,264,51875,-666666666,65000,216,114,194,67,22,73,24,8,172,112,60,112,102,10,2021-01-01,zipcode,Melvin
ZCTA5 76859,48,1773,39329,593,85100,1571,719,1457,258,366,420,257,156,1495,934,561,934,676,258,2021-01-01,zipcode,Menard
ZCTA5 76861,48,2053,77188,803,132900,1483,496,1284,184,440,340,238,82,759,654,105,654,504,150,2021-01-01,zipcode,Miles
ZCTA5 76862,48,184,57813,-666666666,-666666666,143,81,139,3,64,52,16,4,250,83,167,83,81,2,2021-01-01,zipcode,Millersview
ZCTA5 76864,48,812,41452,675,232000,719,387,670,92,253,190,98,37,554,314,240,314,289,25,2021-01-01,zipcode,Mullin
ZCTA5 76865,48,199,-666666666,-666666666,92400,199,65,188,3,97,79,2,7,160,86,74,86,81,5,2021-01-01,zipcode,Norton
ZCTA5 76866,48,838,58906,859,134100,660,269,634,62,287,197,76,12,397,208,189,208,184,24,2021-01-01,zipcode,Paint rock
ZCTA5 76869,48,218,-666666666,-666666666,-666666666,70,38,60,0,6,41,0,13,86,41,45,41,41,0,2021-01-01,zipcode,Pontotoc
ZCTA5 76870,48,72,120625,-666666666,257100,63,18,62,0,16,16,14,16,45,20,25,20,16,4,2021-01-01,zipcode,Priddy
ZCTA5 76871,48,704,75500,1075,157700,589,312,422,33,145,154,71,19,455,230,225,230,183,47,2021-01-01,zipcode,Richland springs
ZCTA5 76872,48,611,48036,729,136300,511,267,491,30,235,142,33,51,471,287,184,287,231,56,2021-01-01,zipcode,Rochelle
ZCTA5 76873,48,148,64052,-666666666,826600,115,77,105,19,33,1,18,34,79,50,29,50,43,7,2021-01-01,zipcode,Rockwood
ZCTA5 76874,48,0,-666666666,-666666666,-666666666,0,0,0,0,0,0,0,0,51,0,51,0,0,0,2021-01-01,zipcode,Roosevelt
ZCTA5 76875,48,489,51563,863,138300,399,140,375,19,176,98,68,14,314,249,65,249,216,33,2021-01-01,zipcode,Rowena
ZCTA5 76877,48,4303,46494,782,117200,3562,1909,2987,551,1172,800,390,74,1971,1467,504,1467,1091,376,2021-01-01,zipcode,San saba
ZCTA5 76878,48,1642,56971,438,64700,1361,595,1215,129,383,491,144,68,906,607,299,607,443,164,2021-01-01,zipcode,Santa anna
ZCTA5 76882,48,257,53095,-666666666,214000,203,92,192,8,36,95,38,15,168,96,72,96,80,16,2021-01-01,zipcode,Talpa
ZCTA5 76884,48,55,-666666666,-666666666,-666666666,48,25,48,17,9,21,0,1,34,18,16,18,14,4,2021-01-01,zipcode,Valera
ZCTA5 76885,48,97,-666666666,-666666666,86100,84,69,69,0,7,25,16,21,120,52,68,52,33,19,2021-01-01,zipcode,Valley spring
ZCTA5 76887,48,63,-666666666,-666666666,-666666666,63,23,63,0,40,0,0,23,78,53,25,53,43,10,2021-01-01,zipcode,Voca
ZCTA5 76888,48,136,24427,-666666666,-666666666,116,60,113,5,6,74,19,9,218,75,143,75,45,30,2021-01-01,zipcode,Voss
ZCTA5 76890,48,884,51776,721,116100,756,394,650,71,235,239,64,41,449,357,92,357,295,62,2021-01-01,zipcode,Zephyr
ZCTA5 76901,48,32419,64923,981,141300,25140,7965,21103,2215,6975,6739,3366,1808,13453,12181,1272,12181,8772,3409,2021-01-01,zipcode,San angelo
ZCTA5 76903,48,30312,43844,810,90100,24423,9969,21028,5081,7088,5885,2200,774,14053,11805,2248,11805,7323,4482,2021-01-01,zipcode,San angelo
ZCTA5 76904,48,36132,74188,920,211300,28551,8758,23252,1295,4999,8628,5409,2921,16403,14828,1575,14828,9175,5653,2021-01-01,zipcode,San angelo
ZCTA5 76905,48,13052,71613,1181,142300,9232,3329,7930,838,2652,2741,1295,404,5349,4606,743,4606,3152,1454,2021-01-01,zipcode,San angelo
ZCTA5 76908,48,2319,-666666666,-666666666,-666666666,2319,37,366,0,38,213,115,0,8,0,8,0,0,0,2021-01-01,zipcode,Goodfellow afb
ZCTA5 76930,48,72,26477,-666666666,84500,59,23,59,9,17,33,0,0,47,33,14,33,33,0,2021-01-01,zipcode,Barnhart
ZCTA5 76932,48,3349,62179,914,100400,2349,712,1914,286,835,542,148,103,1250,1055,195,1055,722,333,2021-01-01,zipcode,Big lake
ZCTA5 76933,48,1365,55750,782,107600,1048,442,866,142,329,262,82,51,623,492,131,492,350,142,2021-01-01,zipcode,Bronte
ZCTA5 76934,48,947,47083,860,66400,726,463,571,58,246,166,42,59,419,295,124,295,259,36,2021-01-01,zipcode,Carlsbad
ZCTA5 76935,48,1916,75000,-666666666,273400,1456,730,1315,40,250,477,438,110,856,666,190,666,666,0,2021-01-01,zipcode,Christoval
ZCTA5 76936,48,2547,61094,489,89300,2014,845,1718,259,486,685,214,74,1250,883,367,883,746,137,2021-01-01,zipcode,Eldorado
ZCTA5 76937,48,66,-666666666,-666666666,108800,60,26,48,14,6,0,28,0,42,37,5,37,35,2,2021-01-01,zipcode,Eola
ZCTA5 76939,48,0,-666666666,-666666666,-666666666,0,0,0,0,0,0,0,0,8,0,8,0,0,0,2021-01-01,zipcode,Knickerbocker
ZCTA5 76940,48,15,-666666666,-666666666,-666666666,15,10,11,2,5,2,1,1,0,0,0,0,0,0,2021-01-01,zipcode,Mereta
ZCTA5 76941,48,1410,43472,995,111200,1050,456,937,112,259,388,160,18,736,599,137,599,488,111,2021-01-01,zipcode,Mertzon
ZCTA5 76943,48,2867,52646,547,122000,2376,824,2182,453,909,508,225,87,1803,1274,529,1274,792,482,2021-01-01,zipcode,Ozona
ZCTA5 76945,48,1715,37237,339,63600,1418,671,1233,195,393,335,201,109,1206,780,426,780,540,240,2021-01-01,zipcode,Robert lee
ZCTA5 76950,48,3473,61923,659,130100,2475,900,2201,495,730,545,279,152,1748,1128,620,1128,769,359,2021-01-01,zipcode,Sonora
ZCTA5 76951,48,1391,55481,906,78900,911,328,805,61,375,218,94,57,545,397,148,397,357,40,2021-01-01,zipcode,Sterling city
ZCTA5 76953,48,67,39375,-666666666,-666666666,67,43,67,0,30,37,0,0,63,35,28,35,26,9,2021-01-01,zipcode,Tennyson
ZCTA5 76955,48,278,72438,-666666666,177500,182,85,157,27,59,29,31,11,132,89,43,89,80,9,2021-01-01,zipcode,Vancourt
ZCTA5 76957,48,185,-666666666,-666666666,-666666666,89,46,89,0,36,34,0,19,46,46,0,46,10,36,2021-01-01,zipcode,Wall
ZCTA5 76958,48,238,-666666666,-666666666,187500,176,105,165,0,91,43,31,0,113,91,22,91,86,5,2021-01-01,zipcode,Water valley
ZCTA5 77002,48,18892,70992,1601,236200,18658,12025,15945,2472,4725,3265,3296,2187,7385,5971,1414,5971,672,5299,2021-01-01,zipcode,Houston
ZCTA5 77003,48,9992,81895,1439,308800,9045,1760,7627,994,843,1801,2120,1869,5871,5140,731,5140,2278,2862,2021-01-01,zipcode,Houston
ZCTA5 77004,48,34197,57078,1119,334700,28859,11115,22589,1381,3626,4816,6198,6568,17501,14740,2761,14740,5095,9645,2021-01-01,zipcode,Houston
ZCTA5 77005,48,28310,196233,1845,1155700,22064,8998,17307,301,398,1494,6122,8992,10597,9973,624,9973,7075,2898,2021-01-01,zipcode,Houston
ZCTA5 77006,48,22678,88670,1512,525300,21051,4323,17921,372,823,2939,6687,7100,15621,13345,2276,13345,4741,8604,2021-01-01,zipcode,Houston
ZCTA5 77007,48,40653,134394,1780,443800,35971,5194,32594,706,1666,4006,14986,11230,23684,21209,2475,21209,10877,10332,2021-01-01,zipcode,Houston
ZCTA5 77008,48,37097,132500,1341,474500,31298,6028,29323,1608,2408,4511,11882,8914,18812,17500,1312,17500,11046,6454,2021-01-01,zipcode,Houston
ZCTA5 77009,48,37654,68587,995,321000,30615,9665,27287,6902,5940,4767,5522,4156,17017,14745,2272,14745,8365,6380,2021-01-01,zipcode,Houston
ZCTA5 77010,48,802,231406,3293,-666666666,793,191,785,0,18,153,330,284,732,536,196,536,25,511,2021-01-01,zipcode,Houston
ZCTA5 77011,48,17060,37943,749,137900,13783,5643,11660,5335,2823,2293,937,272,7221,6152,1069,6152,3079,3073,2021-01-01,zipcode,Houston
ZCTA5 77012,48,17932,39094,822,92100,13223,5261,10940,4512,3699,1749,673,307,6947,5942,1005,5942,2186,3756,2021-01-01,zipcode,Houston
ZCTA5 77013,48,19296,39575,1003,110700,14626,6579,11593,4373,3677,2443,901,199,6998,5978,1020,5978,2529,3449,2021-01-01,zipcode,Houston
ZCTA5 77014,48,37471,53614,1048,163300,28037,9498,22573,4374,6224,7317,3251,1407,12911,11862,1049,11862,6081,5781,2021-01-01,zipcode,Houston
ZCTA5 77015,48,58276,52623,1035,124800,42207,14154,33771,9472,10901,9535,3007,856,19985,18110,1875,18110,9514,8596,2021-01-01,zipcode,Houston
ZCTA5 77016,48,30252,39266,993,85500,23038,10435,19011,5650,7035,4518,1192,616,10988,9790,1198,9790,6083,3707,2021-01-01,zipcode,Houston
ZCTA5 77017,48,33627,53003,968,113500,25256,9201,20509,8359,5740,4336,1432,642,11394,10440,954,10440,5125,5315,2021-01-01,zipcode,Houston
ZCTA5 77018,48,28403,94870,1034,442100,22225,6965,20262,1712,3546,4055,6206,4743,12965,11641,1324,11641,8011,3630,2021-01-01,zipcode,Houston
ZCTA5 77019,48,22475,121118,1722,663200,19365,4855,17137,383,1302,2608,6722,6122,12877,11326,1551,11326,5197,6129,2021-01-01,zipcode,Houston
ZCTA5 77020,48,26252,41952,812,95500,20263,8388,16924,5967,5296,3444,1613,604,9996,8885,1111,8885,4413,4472,2021-01-01,zipcode,Houston
ZCTA5 77021,48,26287,40444,1037,129100,20827,8527,17236,2422,5373,4213,2877,2351,12265,10542,1723,10542,3906,6636,2021-01-01,zipcode,Houston
ZCTA5 77022,48,26476,39295,878,144700,20456,7688,16769,6893,4524,3354,1481,517,10643,9097,1546,9097,4278,4819,2021-01-01,zipcode,Houston
ZCTA5 77023,48,27676,41873,917,171800,21679,8448,17897,5659,4783,3490,2442,1523,11729,10306,1423,10306,4705,5601,2021-01-01,zipcode,Houston
ZCTA5 77024,48,37694,122979,1601,1080300,30154,11570,26463,396,1702,4144,11618,8603,18162,15846,2316,15846,9386,6460,2021-01-01,zipcode,Houston
ZCTA5 77025,48,29539,80051,1378,462600,23615,7646,21134,1355,1762,2893,6039,9085,15435,13601,1834,13601,5478,8123,2021-01-01,zipcode,Houston
ZCTA5 77026,48,21412,31744,777,76700,16841,7701,14170,4712,5280,2973,847,358,9483,7898,1585,7898,3410,4488,2021-01-01,zipcode,Houston
ZCTA5 77027,48,19386,96834,1623,780200,17428,4330,15694,288,516,2715,6602,5573,13080,10887,2193,10887,3199,7688,2021-01-01,zipcode,Houston
ZCTA5 77028,48,19506,29478,982,81100,13969,5939,11223,3185,4165,3047,625,201,7150,6288,862,6288,3520,2768,2021-01-01,zipcode,Houston
ZCTA5 77029,48,16223,44102,892,85500,12533,5230,10510,4284,3202,2293,535,196,6286,5461,825,5461,3763,1698,2021-01-01,zipcode,Houston
ZCTA5 77030,48,11787,81821,1500,639800,9518,3328,8221,175,244,903,2816,4083,6524,5358,1166,5358,2177,3181,2021-01-01,zipcode,Houston
ZCTA5 77031,48,16710,40234,973,178600,12780,4377,10328,3255,2528,2606,1301,638,6756,5959,797,5959,2579,3380,2021-01-01,zipcode,Houston
ZCTA5 77032,48,13887,38269,1017,91700,9922,3624,7653,2367,2300,2116,665,205,4679,4336,343,4336,1705,2631,2021-01-01,zipcode,Houston
ZCTA5 77033,48,28669,36750,1035,72700,20750,9745,16902,5073,6266,4114,921,528,10187,9253,934,9253,5530,3723,2021-01-01,zipcode,Houston
ZCTA5 77034,48,38875,55150,1062,136300,29440,10361,22932,6089,6890,7090,2192,671,13922,12243,1679,12243,5809,6434,2021-01-01,zipcode,Houston
ZCTA5 77035,48,35335,48939,959,233800,27002,9420,22662,4905,5252,5748,4124,2633,15625,13788,1837,13788,5836,7952,2021-01-01,zipcode,Houston
ZCTA5 77036,48,68797,37228,892,171200,52049,14031,43761,17598,10961,7435,5809,1958,30770,25658,5112,25658,4645,21013,2021-01-01,zipcode,Houston
ZCTA5 77037,48,18106,42731,901,114600,13456,5440,10905,5664,3261,1489,305,186,5458,5149,309,5149,3695,1454,2021-01-01,zipcode,Houston
ZCTA5 77038,48,32275,44145,1094,140000,22750,8777,18309,6680,5541,4313,1049,726,9245,8897,348,8897,5013,3884,2021-01-01,zipcode,Houston
ZCTA5 77039,48,27501,38229,998,109900,20189,8259,16044,7202,5118,2915,709,100,8614,7931,683,7931,4445,3486,2021-01-01,zipcode,Houston
ZCTA5 77040,48,50192,61528,1177,175100,39542,12335,33360,6771,7283,10225,6340,2741,19423,18537,886,18537,9660,8877,2021-01-01,zipcode,Houston
ZCTA5 77041,48,33053,87773,1557,223000,26863,9361,22578,4000,5452,4967,5456,2703,11806,10984,822,10984,8072,2912,2021-01-01,zipcode,Houston
ZCTA5 77042,48,40861,48801,1103,296900,31956,7791,27999,2236,5237,7887,8120,4519,21077,18836,2241,18836,5091,13745,2021-01-01,zipcode,Houston
ZCTA5 77043,48,25122,71089,1240,304300,19822,6206,17074,2691,3175,3979,4814,2415,10736,9804,932,9804,5616,4188,2021-01-01,zipcode,Houston
ZCTA5 77044,48,53753,85300,1632,223600,38091,11542,31685,4998,7811,8709,6847,3320,16781,15712,1069,15712,12184,3528,2021-01-01,zipcode,Houston
ZCTA5 77045,48,32627,62795,1187,106500,25033,9321,20256,5077,6558,4838,2269,1514,10566,10053,513,10053,6079,3974,2021-01-01,zipcode,Houston
ZCTA5 77046,48,1002,135614,1746,-666666666,1002,307,940,0,57,282,293,308,917,751,166,751,371,380,2021-01-01,zipcode,Houston
ZCTA5 77047,48,33199,68806,1379,167200,24549,6162,21445,2389,4272,7881,4293,2610,12450,11891,559,11891,8611,3280,2021-01-01,zipcode,Houston
ZCTA5 77048,48,19413,45671,1072,114200,14209,4730,12148,1363,4096,4309,1550,830,7173,6561,612,6561,3526,3035,2021-01-01,zipcode,Houston
ZCTA5 77049,48,39514,65872,1258,165500,28230,8363,22219,5374,6668,7366,2066,745,12369,11422,947,11422,7924,3498,2021-01-01,zipcode,Houston
ZCTA5 77050,48,5745,33542,952,85100,4142,1735,3393,1639,946,681,86,41,1774,1663,111,1663,965,698,2021-01-01,zipcode,Houston
ZCTA5 77051,48,19077,35760,950,112500,13697,6132,10921,2337,3409,3225,1438,512,7548,6570,978,6570,2963,3607,2021-01-01,zipcode,Houston
ZCTA5 77053,48,30642,57214,1389,113600,23992,8845,19113,6519,5848,4331,1513,902,9414,9175,239,9175,6498,2677,2021-01-01,zipcode,Houston
ZCTA5 77054,48,23699,53177,1270,149900,21722,5592,18066,279,2065,4436,5335,5951,17085,14448,2637,14448,1672,12776,2021-01-01,zipcode,Houston
ZCTA5 77055,48,43780,64277,1092,494500,33521,10207,28520,6695,5728,5079,6846,4172,17279,15758,1521,15758,7199,8559,2021-01-01,zipcode,Houston
ZCTA5 77056,48,22062,101563,1731,721700,19525,5907,17710,358,912,2741,7618,6081,14647,11805,2842,11805,4497,7308,2021-01-01,zipcode,Houston
ZCTA5 77057,48,44056,60927,1184,313400,35191,8869,31200,4387,3930,6335,9845,6703,24203,20858,3345,20858,6677,14181,2021-01-01,zipcode,Houston
ZCTA5 77058,48,17651,58199,1145,202700,14945,4304,12758,811,1982,4299,3288,2378,10486,9265,1221,9265,2777,6488,2021-01-01,zipcode,Houston
ZCTA5 77059,48,18020,144391,1408,322200,14409,5890,12348,526,1369,2567,4302,3584,6420,6239,181,6239,5719,520,2021-01-01,zipcode,Houston
ZCTA5 77060,48,47349,34195,895,109400,31746,10846,25617,11126,7911,5033,1130,417,16753,14720,2033,14720,3426,11294,2021-01-01,zipcode,Houston
ZCTA5 77061,48,25485,41066,846,164600,18965,6102,15348,5132,4889,3176,1505,646,10196,9147,1049,9147,3410,5737,2021-01-01,zipcode,Houston
ZCTA5 77062,48,24761,98193,1160,231800,19659,6693,17401,1445,2949,4328,5212,3467,9926,9442,484,9442,7205,2237,2021-01-01,zipcode,Houston
ZCTA5 77063,48,39855,44745,1180,239400,33759,9629,29323,2871,4626,8280,8957,4589,22159,19672,2487,19672,4561,15111,2021-01-01,zipcode,Houston
ZCTA5 77064,48,49305,75489,1316,187400,37947,10988,31532,6000,7514,9538,6407,2073,16927,15654,1273,15654,9746,5908,2021-01-01,zipcode,Houston
ZCTA5 77065,48,40140,65738,1184,203600,31615,9266,27052,3154,6588,9856,4834,2620,16952,15937,1015,15937,7039,8898,2021-01-01,zipcode,Houston
ZCTA5 77066,48,40053,69865,1347,173400,30187,10592,25023,5735,6058,7514,4231,1485,12195,11855,340,11855,8612,3243,2021-01-01,zipcode,Houston
ZCTA5 77067,48,33420,48080,977,141000,23608,8120,19435,5747,5851,5363,1591,883,11075,10005,1070,10005,4425,5580,2021-01-01,zipcode,Houston
ZCTA5 77068,48,11031,78493,1124,232500,8645,2565,7124,969,1418,2358,1707,672,4170,3747,423,3747,2629,1118,2021-01-01,zipcode,Houston
ZCTA5 77069,48,19054,65620,1225,283800,14943,4890,13059,500,2181,4525,3736,2117,8921,8313,608,8313,4939,3374,2021-01-01,zipcode,Houston
ZCTA5 77070,48,58462,70297,1369,212700,44111,12458,37916,3163,8901,11349,9701,4802,23136,21474,1662,21474,10377,11097,2021-01-01,zipcode,Houston
ZCTA5 77071,48,27221,53406,977,173300,20926,7380,17719,2949,3904,4878,3687,2301,10940,9903,1037,9903,5162,4741,2021-01-01,zipcode,Houston
ZCTA5 77072,48,63585,46376,1094,133200,48727,17344,39007,11993,10707,10067,4665,1575,20516,18997,1519,18997,8431,10566,2021-01-01,zipcode,Houston
ZCTA5 77073,48,38857,63194,1108,159100,29429,7992,23906,4492,7554,8776,2430,654,14252,13288,964,13288,8286,5002,2021-01-01,zipcode,Houston
ZCTA5 77074,48,39088,42599,955,156700,28071,9310,23762,8921,5469,4283,3747,1342,15147,12941,2206,12941,4314,8627,2021-01-01,zipcode,Houston
ZCTA5 77075,48,42736,65442,1101,175500,31203,9090,25556,8245,6694,7167,2586,864,13011,12287,724,12287,7235,5052,2021-01-01,zipcode,Houston
ZCTA5 77076,48,33171,37258,1022,111900,23734,9431,18637,8589,6202,3081,578,187,10643,9801,842,9801,4832,4969,2021-01-01,zipcode,Houston
ZCTA5 77077,48,63168,64904,1264,314600,50516,14263,44370,2013,5004,12237,15438,9678,32519,29031,3488,29031,10274,18757,2021-01-01,zipcode,Houston
ZCTA5 77078,48,13738,38341,1076,102900,10021,4168,8794,2569,3034,2116,777,298,5308,4625,683,4625,2800,1825,2021-01-01,zipcode,Houston
ZCTA5 77079,48,34633,82657,1405,557900,25749,7920,22622,1604,1385,4974,8959,5700,15810,13372,2438,13372,7206,6166,2021-01-01,zipcode,Houston
ZCTA5 77080,48,45391,56301,1111,262700,34403,10292,28703,8849,6580,5759,5079,2436,16986,15248,1738,15248,7138,8110,2021-01-01,zipcode,Houston
ZCTA5 77081,48,51374,37594,895,335800,37387,9690,30063,12317,6580,4690,4154,2322,20911,18515,2396,18515,1197,17318,2021-01-01,zipcode,Houston
ZCTA5 77082,48,52827,54686,1168,181300,42852,12296,36980,4702,8423,10418,8682,4755,23822,21398,2424,21398,8012,13386,2021-01-01,zipcode,Houston
ZCTA5 77083,48,77663,55961,1190,171400,61098,20758,48946,11136,12030,14154,7952,3674,23879,23129,750,23129,14852,8277,2021-01-01,zipcode,Houston
ZCTA5 77084,48,107864,69857,1330,183900,81158,23829,66899,11561,14843,20986,14062,5447,37978,34699,3279,34699,21208,13491,2021-01-01,zipcode,Houston
ZCTA5 77085,48,17101,60580,1146,139200,13767,4775,11288,3518,3140,2811,1251,568,5637,5500,137,5500,3729,1771,2021-01-01,zipcode,Houston
ZCTA5 77086,48,30071,51523,1051,144900,22412,7044,17965,5675,6058,4406,1419,407,9364,8660,704,8660,4910,3750,2021-01-01,zipcode,Houston
ZCTA5 77087,48,36710,46478,844,108200,26968,10831,22340,8946,6715,4305,1641,733,12423,11344,1079,11344,6228,5116,2021-01-01,zipcode,Houston
ZCTA5 77088,48,54601,45869,1019,129300,40881,15892,33645,9300,11080,8910,3125,1230,18563,17164,1399,17164,11072,6092,2021-01-01,zipcode,Houston
ZCTA5 77089,48,59042,77960,1250,183100,45442,15463,36969,6607,8569,12320,6597,2876,19152,18118,1034,18118,12662,5456,2021-01-01,zipcode,Houston
ZCTA5 77090,48,39478,41086,1067,170000,29952,8397,23509,2605,6598,8752,3661,1893,18731,16174,2557,16174,3978,12196,2021-01-01,zipcode,Houston
ZCTA5 77091,48,30008,32441,923,146900,22902,8929,19896,5877,5690,4979,2452,898,12793,11113,1680,11113,4036,7077,2021-01-01,zipcode,Houston
ZCTA5 77092,48,35822,47453,1035,199600,29226,8730,24950,6541,5867,6329,4122,2091,15699,14368,1331,14368,5467,8901,2021-01-01,zipcode,Houston
ZCTA5 77093,48,47417,33035,907,92100,34524,15708,28290,13928,8248,4856,1019,239,14629,13476,1153,13476,7920,5556,2021-01-01,zipcode,Houston
ZCTA5 77094,48,11139,168078,1623,394700,8533,3366,7874,176,874,1260,3782,1782,4344,3977,367,3977,3314,663,2021-01-01,zipcode,Houston
ZCTA5 77095,48,71138,87960,1419,233600,56375,16213,47663,3981,8666,15832,13720,5464,26099,24622,1477,24622,17813,6809,2021-01-01,zipcode,Houston
ZCTA5 77096,48,32744,71930,1079,364900,24908,8253,22395,2046,3131,5078,6769,5371,15087,12819,2268,12819,6381,6438,2021-01-01,zipcode,Houston
ZCTA5 77098,48,15414,110454,1743,656200,13593,3153,11905,61,528,1139,4588,5589,9719,8541,1178,8541,2754,5787,2021-01-01,zipcode,Houston
ZCTA5 77099,48,50113,40710,1061,139000,37099,12892,30469,8898,8295,8059,4114,1103,17520,16046,1474,16046,5742,10304,2021-01-01,zipcode,Houston
ZCTA5 77301,48,33409,55719,1060,143500,24967,9528,20469,6116,6146,4600,2368,1239,11474,10473,1001,10473,5965,4508,2021-01-01,zipcode,Conroe
ZCTA5 77302,48,19165,80581,1250,209200,14256,5323,12354,1416,4265,4168,1863,642,6864,6394,470,6394,5172,1222,2021-01-01,zipcode,Conroe
ZCTA5 77303,48,22502,68673,1117,168000,16663,4927,13871,1957,5570,4568,1031,745,8254,7595,659,7595,5619,1976,2021-01-01,zipcode,Conroe
ZCTA5 77304,48,36700,70533,1195,249300,29050,8859,23581,1790,4757,7749,6011,3274,15705,14903,802,14903,8901,6002,2021-01-01,zipcode,Conroe
ZCTA5 77306,48,16650,58213,777,129800,12231,5016,9482,3808,2570,1965,812,327,5639,5069,570,5069,4328,741,2021-01-01,zipcode,Conroe
ZCTA5 77316,48,29191,112917,1271,351700,21903,7559,19175,918,4757,5995,5599,1906,10569,9754,815,9754,8742,1012,2021-01-01,zipcode,Montgomery
ZCTA5 77318,48,18348,80820,987,231000,15522,6635,13857,1357,5224,3950,2186,1140,8117,6994,1123,6994,5588,1406,2021-01-01,zipcode,Willis
ZCTA5 77320,48,38572,48550,960,165400,33622,21686,27664,4769,11574,6952,3246,1123,12188,9813,2375,9813,6095,3718,2021-01-01,zipcode,Huntsville
ZCTA5 77326,48,82,-666666666,-666666666,157500,82,74,82,26,45,11,0,0,116,63,53,63,63,0,2021-01-01,zipcode,Ace
ZCTA5 77327,48,29710,49173,813,113800,21529,9742,17523,4436,6532,4743,1314,498,11275,9334,1941,9334,7393,1941,2021-01-01,zipcode,Cleveland
ZCTA5 77328,48,18297,51635,960,126300,13698,6600,11760,2401,4437,3721,866,335,6877,5891,986,5891,4307,1584,2021-01-01,zipcode,Cleveland
ZCTA5 77331,48,7114,44572,812,169300,6146,3036,5490,737,2090,1699,556,408,4531,2930,1601,2930,2435,495,2021-01-01,zipcode,Coldspring
ZCTA5 77334,48,23,-666666666,-666666666,-666666666,23,23,23,0,0,23,0,0,23,23,0,23,0,23,2021-01-01,zipcode,Dodge
ZCTA5 77335,48,2799,46944,825,103900,2256,824,1777,360,670,575,148,24,1296,906,390,906,786,120,2021-01-01,zipcode,Goodrich
ZCTA5 77336,48,12249,74423,1138,219100,9183,3746,7439,1039,2015,2818,1063,504,4846,4142,704,4142,3201,941,2021-01-01,zipcode,Huffman
ZCTA5 77338,48,46780,61135,1135,165200,34609,10353,29690,3742,8368,12638,3857,1085,17184,16315,869,16315,8652,7663,2021-01-01,zipcode,Humble
ZCTA5 77339,48,42652,79016,1470,222800,33301,11397,29161,1196,5990,10597,7332,4046,18560,17063,1497,17063,10014,7049,2021-01-01,zipcode,Kingwood
ZCTA5 77340,48,32826,39133,899,175500,28601,13171,18599,1849,6386,5334,3066,1964,13677,11979,1698,11979,5050,6929,2021-01-01,zipcode,Huntsville
ZCTA5 77342,48,0,-666666666,-666666666,-666666666,0,0,0,0,0,0,0,0,0,0,0,0,0,0,2021-01-01,zipcode,Huntsville
ZCTA5 77345,48,27274,148402,1694,311500,20729,8027,17716,477,1562,4369,7002,4306,9867,9209,658,9209,8155,1054,2021-01-01,zipcode,Kingwood
ZCTA5 77346,48,67587,111111,1482,228900,50575,15242,43410,1940,8574,14058,12996,5842,23345,22385,960,22385,18876,3509,2021-01-01,zipcode,Humble
ZCTA5 77350,48,119,-666666666,-666666666,-666666666,99,30,99,27,31,32,5,4,78,40,38,40,29,11,2021-01-01,zipcode,Leggett
ZCTA5 77351,48,34047,53724,879,140800,28340,15203,25260,4998,9137,7444,2481,1200,16854,11726,5128,11726,9137,2589,2021-01-01,zipcode,Livingston
ZCTA5 77354,48,38505,99533,1339,287800,29106,10252,25753,1959,6319,7554,6951,2970,14293,12789,1504,12789,10185,2604,2021-01-01,zipcode,Magnolia
ZCTA5 77355,48,31164,97440,1220,260500,24272,8498,20383,2144,6059,6513,4320,1347,10522,10032,490,10032,8636,1396,2021-01-01,zipcode,Magnolia
ZCTA5 77356,48,28689,105825,1432,292700,23300,9525,21121,1131,3839,6896,6673,2582,14073,12040,2033,12040,10250,1790,2021-01-01,zipcode,Montgomery
ZCTA5 77357,48,29992,72093,1076,148200,22275,7359,17114,3562,5603,5734,1580,635,10823,9258,1565,9258,7050,2208,2021-01-01,zipcode,New caney
ZCTA5 77358,48,5324,67011,596,159400,4094,1772,3514,440,1523,1190,212,149,2558,1963,595,1963,1547,416,2021-01-01,zipcode,New waverly
ZCTA5 77359,48,142,42381,-666666666,-666666666,142,72,142,34,76,32,0,0,122,82,40,82,27,55,2021-01-01,zipcode,Oakhurst
ZCTA5 77360,48,5805,53750,940,103300,4499,2291,4149,668,1567,1527,306,81,3556,2350,1206,2350,1878,472,2021-01-01,zipcode,Onalaska
ZCTA5 77362,48,6361,83011,1249,189800,5044,2076,4169,264,1411,1263,971,260,2316,2156,160,2156,1902,254,2021-01-01,zipcode,Pinehurst
ZCTA5 77363,48,3042,57147,985,229200,2449,1237,2220,256,555,612,694,103,1512,1227,285,1227,1053,174,2021-01-01,zipcode,Plantersville
ZCTA5 77364,48,2272,48083,819,123300,1970,1116,1919,194,586,664,283,192,1556,1048,508,1048,934,114,2021-01-01,zipcode,Pointblank
ZCTA5 77365,48,36802,88820,1169,222200,27790,9789,23266,4141,5829,7529,3931,1836,13441,12145,1296,12145,10345,1800,2021-01-01,zipcode,Porter
ZCTA5 77367,48,264,66630,1352,203200,262,138,257,0,29,123,35,70,255,176,79,176,106,70,2021-01-01,zipcode,Riverside
ZCTA5 77368,48,0,-666666666,-666666666,-666666666,0,0,0,0,0,0,0,0,0,0,0,0,0,0,2021-01-01,zipcode,Romayor
ZCTA5 77369,48,478,21016,-666666666,-666666666,431,314,431,254,77,100,0,0,384,215,169,215,166,49,2021-01-01,zipcode,Rye
ZCTA5 77371,48,7291,50791,811,89900,5661,2763,4765,808,2146,1437,243,131,2922,2154,768,2154,1597,557,2021-01-01,zipcode,Shepherd
ZCTA5 77372,48,14103,69279,1141,154200,10170,3552,8599,1760,3060,3006,609,164,4756,4157,599,4157,3574,583,2021-01-01,zipcode,Splendora
ZCTA5 77373,48,63296,78422,1545,170100,48196,14146,41255,4991,11967,14424,7138,2735,22423,21156,1267,21156,15118,6038,2021-01-01,zipcode,Spring
ZCTA5 77374,48,449,-666666666,-666666666,48200,373,208,275,22,192,30,31,0,268,199,69,199,179,20,2021-01-01,zipcode,Thicket
ZCTA5 77375,48,62970,87574,1294,228600,45808,13437,39398,3676,7992,11761,10951,5018,22869,22022,847,22022,15584,6438,2021-01-01,zipcode,Tomball
ZCTA5 77376,48,561,27083,-666666666,-666666666,545,219,414,28,304,82,0,0,309,309,0,309,303,6,2021-01-01,zipcode,Votaw
ZCTA5 77377,48,38689,108958,1551,277600,29413,9817,25260,1711,5189,7543,7208,3609,13105,12618,487,12618,10509,2109,2021-01-01,zipcode,Tomball
ZCTA5 77378,48,17549,63395,1121,150900,13953,4881,11813,2622,3973,3355,1599,264,6059,5538,521,5538,4338,1200,2021-01-01,zipcode,Willis
ZCTA5 77379,48,82125,105799,1370,271700,61485,20546,53633,2045,9757,15562,18095,8174,29070,27746,1324,27746,21549,6197,2021-01-01,zipcode,Spring
ZCTA5 77380,48,29095,74371,1395,297700,24810,7711,21547,859,3280,6327,7195,3886,15497,13980,1517,13980,4852,9128,2021-01-01,zipcode,Spring
ZCTA5 77381,48,36080,125185,1564,359100,28794,12033,25045,627,3387,5670,9511,5850,13884,13441,443,13441,10556,2885,2021-01-01,zipcode,Spring
ZCTA5 77382,48,41233,149849,1794,446200,30460,10639,25510,399,2475,5548,10529,6559,13568,13149,419,13149,10459,2690,2021-01-01,zipcode,Spring
ZCTA5 77384,48,21259,92026,1250,342500,17175,6418,15414,403,2139,4114,5428,3330,10419,9135,1284,9135,5209,3926,2021-01-01,zipcode,Conroe
ZCTA5 77385,48,24771,95725,1476,235700,19004,5695,15792,1277,3267,5623,3854,1771,9100,8464,636,8464,6754,1710,2021-01-01,zipcode,Conroe
ZCTA5 77386,48,64460,117500,1663,266200,46070,12643,39838,2342,5227,13321,12505,6443,20783,20228,555,20228,15970,4258,2021-01-01,zipcode,Spring
ZCTA5 77388,48,53498,92211,1647,218400,40567,12274,34060,2806,7378,11886,8215,3775,18204,17511,693,17511,12468,5043,2021-01-01,zipcode,Spring
ZCTA5 77389,48,41982,133418,1723,325200,30037,10238,25627,916,4364,6011,8960,5376,14090,13448,642,13448,10790,2658,2021-01-01,zipcode,Spring
ZCTA5 77396,48,61720,70623,1308,173000,46441,15309,38346,6567,11959,10196,5288,4336,20660,19482,1178,19482,12884,6598,2021-01-01,zipcode,Humble
ZCTA5 77401,48,17362,210577,2175,855600,13539,5159,12186,241,656,1449,4251,5589,6954,6256,698,6256,5557,699,2021-01-01,zipcode,Bellaire
ZCTA5 77406,48,58998,128878,1549,323400,45145,15777,40269,1857,7326,11980,11351,7755,20158,19349,809,19349,16468,2881,2021-01-01,zipcode,Richmond
ZCTA5 77407,48,73084,97189,1585,281600,52251,14229,44106,3794,8231,9988,13445,8648,21363,20776,587,20776,16141,4635,2021-01-01,zipcode,Richmond
ZCTA5 77412,48,0,-666666666,-666666666,-666666666,0,0,0,0,0,0,0,0,0,0,0,0,0,0,2021-01-01,zipcode,Altair
ZCTA5 77414,48,24345,49680,923,143700,18393,8026,15610,2534,4799,4830,2200,1247,12161,9279,2882,9279,5885,3394,2021-01-01,zipcode,Bay city
ZCTA5 77415,48,390,64919,-666666666,117900,278,160,211,40,105,66,0,0,133,110,23,110,70,40,2021-01-01,zipcode,Cedar lane
ZCTA5 77417,48,2892,39956,859,88200,1785,790,1690,526,798,282,63,21,856,780,76,780,489,291,2021-01-01,zipcode,Beasley
ZCTA5 77418,48,10220,66445,725,264300,8042,3206,6771,770,1848,1920,1549,684,4296,3814,482,3814,2840,974,2021-01-01,zipcode,Bellville
ZCTA5 77419,48,823,50000,-666666666,122800,526,174,458,166,104,113,75,0,404,294,110,294,278,16,2021-01-01,zipcode,Blessing
ZCTA5 77420,48,2365,54671,857,160400,1936,864,1699,204,391,734,314,56,984,835,149,835,613,222,2021-01-01,zipcode,Boling
ZCTA5 77422,48,14042,66227,1028,166300,11908,6792,10325,1560,3655,3724,1078,308,6415,4955,1460,4955,4248,707,2021-01-01,zipcode,Brazoria
ZCTA5 77423,48,14470,74273,1078,236800,10801,4116,8616,1663,2040,2607,1396,910,4582,4177,405,4177,3414,763,2021-01-01,zipcode,Brookshire
ZCTA5 77426,48,2019,82500,1309,293800,1685,658,1430,129,432,475,243,151,996,788,208,788,559,229,2021-01-01,zipcode,Chappell hill
ZCTA5 77428,48,0,-666666666,-666666666,-666666666,0,0,0,0,0,0,0,0,0,0,0,0,0,0,2021-01-01,zipcode,Collegeport
ZCTA5 77429,48,88375,111290,1416,275000,65443,18870,57331,3349,8533,17468,19549,8432,31263,29886,1377,29886,25162,4724,2021-01-01,zipcode,Cypress
ZCTA5 77430,48,1780,86750,-666666666,210100,1359,612,1195,119,344,248,276,208,801,665,136,665,643,22,2021-01-01,zipcode,Damon
ZCTA5 77432,48,0,-666666666,-666666666,-666666666,0,0,0,0,0,0,0,0,15,0,15,0,0,0,2021-01-01,zipcode,Danevang
ZCTA5 77433,48,103070,120819,1680,318000,70495,20929,60650,3400,10826,16584,19868,9972,31730,30506,1224,30506,24570,5936,2021-01-01,zipcode,Cypress
ZCTA5 77434,48,4128,44020,812,58200,3163,1557,2358,474,855,720,205,104,1738,1256,482,1256,1007,249,2021-01-01,zipcode,Eagle lake
ZCTA5 77435,48,3727,56250,933,207200,2913,1273,2603,372,1013,641,403,174,1793,1484,309,1484,1207,277,2021-01-01,zipcode,East bernard
ZCTA5 77436,48,0,-666666666,-666666666,-666666666,0,0,0,0,0,0,0,0,22,0,22,0,0,0,2021-01-01,zipcode,Egypt
ZCTA5 77437,48,18529,53976,845,155100,13714,5253,11509,2509,3346,3367,1580,707,7235,6580,655,6580,4202,2378,2021-01-01,zipcode,El campo
ZCTA5 77440,48,131,-666666666,-666666666,-666666666,78,0,78,35,0,27,16,0,51,51,0,51,16,35,2021-01-01,zipcode,Elmaton
ZCTA5 77441,48,22665,174545,1739,453700,16925,6415,14267,419,1219,2667,6075,3887,7655,7108,547,7108,6745,363,2021-01-01,zipcode,Fulshear
ZCTA5 77442,48,1343,41563,663,156700,725,299,568,105,259,148,44,12,382,252,130,252,167,85,2021-01-01,zipcode,Garwood
ZCTA5 77443,48,132,-666666666,-666666666,-666666666,132,70,132,0,0,70,0,62,118,62,56,62,0,62,2021-01-01,zipcode,Glen flora
ZCTA5 77444,48,785,-666666666,-666666666,-666666666,612,328,533,130,140,193,22,48,453,309,144,309,276,33,2021-01-01,zipcode,Guy
ZCTA5 77445,48,14595,53398,989,203600,10582,4370,8350,1014,2937,2936,1042,421,6181,5398,783,5398,3201,2197,2021-01-01,zipcode,Hempstead
ZCTA5 77446,48,5121,23833,967,226600,4959,2738,432,22,123,123,79,85,767,650,117,650,83,567,2021-01-01,zipcode,Prairie view
ZCTA5 77447,48,18145,82352,1354,235700,13045,3808,11254,1291,3702,3617,1944,700,6294,5964,330,5964,5195,769,2021-01-01,zipcode,Hockley
ZCTA5 77448,48,148,-666666666,-666666666,-666666666,112,20,112,60,5,15,32,0,122,72,50,72,16,56,2021-01-01,zipcode,Hungerford
ZCTA5 77449,48,119994,77171,1616,180200,86798,21386,74106,11237,17461,24869,14058,6481,38390,37043,1347,37043,25936,11107,2021-01-01,zipcode,Katy
ZCTA5 77450,48,72197,95698,1445,275200,54627,17778,47223,2680,6605,13060,15667,9211,26002,24737,1265,24737,17443,7294,2021-01-01,zipcode,Katy
ZCTA5 77451,48,588,51106,950,103600,372,156,348,38,165,96,22,27,262,193,69,193,145,48,2021-01-01,zipcode,Kendleton
ZCTA5 77453,48,168,-666666666,-666666666,-666666666,69,19,69,0,50,19,0,0,74,50,24,50,0,50,2021-01-01,zipcode,Lane city
ZCTA5 77454,48,0,-666666666,-666666666,-666666666,0,0,0,0,0,0,0,0,0,0,0,0,0,0,2021-01-01,zipcode,Lissie
ZCTA5 77455,48,2014,56844,936,154400,1557,624,1229,339,346,325,181,38,823,679,144,679,578,101,2021-01-01,zipcode,Louise
ZCTA5 77456,48,1063,44219,850,137700,835,467,700,144,240,224,79,13,462,366,96,366,290,76,2021-01-01,zipcode,Markham
ZCTA5 77457,48,471,26641,694,-666666666,435,219,411,106,82,193,30,0,903,257,646,257,209,48,2021-01-01,zipcode,Matagorda
ZCTA5 77458,48,58,-666666666,-666666666,-666666666,58,12,34,0,0,22,12,0,90,36,54,36,12,24,2021-01-01,zipcode,Midfield
ZCTA5 77459,48,77722,120418,1874,310900,59249,18569,50493,2669,7336,11944,16456,12088,25900,24974,926,24974,20989,3985,2021-01-01,zipcode,Missouri city
ZCTA5 77460,48,177,-666666666,-666666666,-666666666,140,106,140,31,45,64,0,0,41,33,8,33,33,0,2021-01-01,zipcode,Nada
ZCTA5 77461,48,11824,78187,1042,230400,8727,3273,7474,1201,2368,2056,1337,512,4103,3878,225,3878,2905,973,2021-01-01,zipcode,Needville
ZCTA5 77464,48,366,52824,1080,146200,293,168,284,71,57,135,5,16,184,164,20,164,80,84,2021-01-01,zipcode,Orchard
ZCTA5 77465,48,7227,55268,685,113700,5732,2444,5010,1241,1409,1498,505,357,3740,2638,1102,2638,2069,569,2021-01-01,zipcode,Palacios
ZCTA5 77466,48,360,45172,-666666666,214900,319,109,274,7,96,112,55,4,209,190,19,190,136,54,2021-01-01,zipcode,Pattison
ZCTA5 77467,48,0,-666666666,-666666666,-666666666,0,0,0,0,0,0,0,0,0,0,0,0,0,0,2021-01-01,zipcode,Pierce
ZCTA5 77468,48,0,-666666666,-666666666,-666666666,0,0,0,0,0,0,0,0,0,0,0,0,0,0,2021-01-01,zipcode,Pledger
ZCTA5 77469,48,57228,90534,1199,248300,44087,14258,37820,3848,8906,10866,9174,5026,19977,19346,631,19346,15570,3776,2021-01-01,zipcode,Richmond
ZCTA5 77470,48,458,44020,-666666666,-666666666,343,79,274,84,74,97,8,11,311,178,133,178,143,35,2021-01-01,zipcode,Rock island
ZCTA5 77471,48,41723,62568,1153,186800,31676,11098,26048,4876,7712,8057,3922,1481,16300,14862,1438,14862,8258,6604,2021-01-01,zipcode,Rosenberg
ZCTA5 77473,48,38,-666666666,-666666666,-666666666,38,13,38,6,20,12,0,0,19,13,6,13,13,0,2021-01-01,zipcode,San felipe
ZCTA5 77474,48,14048,73220,1031,190700,10899,3488,9469,1275,3467,2943,1239,545,6113,5607,506,5607,4682,925,2021-01-01,zipcode,Sealy
ZCTA5 77475,48,699,53607,-666666666,184300,631,357,559,44,317,129,31,38,642,331,311,331,310,21,2021-01-01,zipcode,Sheridan
ZCTA5 77476,48,281,60662,-666666666,327000,214,129,214,22,39,89,37,27,169,99,70,99,83,16,2021-01-01,zipcode,Simonton
ZCTA5 77477,48,33844,63977,1321,189900,27036,7515,22867,2869,4968,6267,6523,2240,13782,12850,932,12850,5500,7350,2021-01-01,zipcode,Stafford
ZCTA5 77478,48,23276,102440,1630,331000,20197,7854,17665,1222,2630,4219,5901,3693,9131,8777,354,8777,6613,2164,2021-01-01,zipcode,Sugar land
ZCTA5 77479,48,90084,142073,1944,391500,69659,23624,60420,3138,5814,11527,20977,18964,29523,28515,1008,28515,23935,4580,2021-01-01,zipcode,Sugar land
ZCTA5 77480,48,8243,70477,952,143100,6136,2926,5287,590,1882,1996,693,126,3600,2851,749,2851,2361,490,2021-01-01,zipcode,Sweeny
ZCTA5 77481,48,152,-666666666,-666666666,257500,142,107,137,4,90,20,15,8,125,116,9,116,27,89,2021-01-01,zipcode,Thompsons
ZCTA5 77482,48,1307,55110,-666666666,152000,1119,435,963,102,205,515,115,26,728,498,230,498,414,84,2021-01-01,zipcode,Van vleck
ZCTA5 77483,48,334,-666666666,-666666666,144600,199,0,199,29,62,108,0,0,275,133,142,133,133,0,2021-01-01,zipcode,Wadsworth
ZCTA5 77484,48,12914,71765,1033,230100,10584,3304,8172,1029,2582,3019,1194,348,5043,4524,519,4524,3147,1377,2021-01-01,zipcode,Waller
ZCTA5 77485,48,3933,44643,842,155300,3054,1272,2642,379,1106,826,243,88,1745,1464,281,1464,1002,462,2021-01-01,zipcode,Wallis
ZCTA5 77486,48,7227,79294,1129,182200,5783,2384,4778,694,1146,2250,360,328,3110,2682,428,2682,1901,781,2021-01-01,zipcode,West columbia
ZCTA5 77488,48,14721,51789,825,152900,11608,4869,9569,1753,2794,3570,959,493,6125,5241,884,5241,3308,1933,2021-01-01,zipcode,Wharton
ZCTA5 77489,48,38593,67251,1534,150700,30766,9571,25384,3066,7490,8743,4144,1941,13262,12720,542,12720,9567,3153,2021-01-01,zipcode,Missouri city
ZCTA5 77493,48,48117,102007,1533,252000,34863,9650,29572,1365,6939,9508,7818,3942,15811,14876,935,14876,12216,2660,2021-01-01,zipcode,Katy
ZCTA5 77494,48,129165,137275,1833,367600,90273,31415,79083,2976,6978,16291,29701,23137,42002,40280,1722,40280,29747,10533,2021-01-01,zipcode,Katy
ZCTA5 77498,48,52947,87669,1614,227200,40860,12591,32614,3740,6711,9353,7514,5296,17744,16423,1321,16423,11545,4878,2021-01-01,zipcode,Sugar land
ZCTA5 77502,48,37665,57980,1054,126100,26435,8691,21207,8152,6583,4962,1149,361,11619,10845,774,10845,6957,3888,2021-01-01,zipcode,Pasadena
ZCTA5 77503,48,24582,63132,1014,118100,18118,5766,14840,4229,5084,3910,1310,307,8783,8005,778,8005,4131,3874,2021-01-01,zipcode,Pasadena
ZCTA5 77504,48,25748,47908,1060,160200,19416,6480,15960,3336,5788,4322,1785,729,10218,9064,1154,9064,3728,5336,2021-01-01,zipcode,Pasadena
ZCTA5 77505,48,22548,91250,1345,221300,17331,5530,14442,1365,4318,5138,2218,1403,8588,7848,740,7848,5438,2410,2021-01-01,zipcode,Pasadena
ZCTA5 77506,48,37141,46847,932,89300,25824,8827,20564,8655,6959,3839,915,196,12101,10434,1667,10434,3971,6463,2021-01-01,zipcode,Pasadena
ZCTA5 77507,48,403,65318,1446,-666666666,387,53,283,0,110,53,94,26,348,240,108,240,0,240,2021-01-01,zipcode,Pasadena
ZCTA5 77510,48,13124,86145,929,222000,11335,4657,9609,1162,2989,3700,1431,327,5905,5214,691,5214,4387,827,2021-01-01,zipcode,Santa fe
ZCTA5 77511,48,49600,68226,1142,168900,37920,14124,31568,4989,9103,11894,4280,1302,19187,16869,2318,16869,11600,5269,2021-01-01,zipcode,Alvin
ZCTA5 77514,48,5818,56780,1045,139600,4492,2113,4175,1070,1351,1372,187,195,2650,2106,544,2106,1746,360,2021-01-01,zipcode,Anahuac
ZCTA5 77515,48,33491,76282,1023,164900,27486,12566,23944,3017,8686,8144,2686,1411,12864,11596,1268,11596,8163,3433,2021-01-01,zipcode,Angleton
ZCTA5 77517,48,6118,82928,-666666666,221400,5081,2279,4297,541,1744,1589,319,104,2177,2126,51,2126,1976,150,2021-01-01,zipcode,Santa fe
ZCTA5 77518,48,10567,64886,1069,146900,7762,2575,6431,1328,2113,1940,817,233,3903,3544,359,3544,2127,1417,2021-01-01,zipcode,Bacliff
ZCTA5 77519,48,596,71860,-666666666,51500,542,280,471,92,259,28,76,16,251,232,19,232,208,24,2021-01-01,zipcode,Batson
ZCTA5 77520,48,36054,48956,1016,108500,27604,10703,23065,6867,6642,6986,1462,1108,14639,12833,1806,12833,7213,5620,2021-01-01,zipcode,Baytown
ZCTA5 77521,48,63309,70436,1145,175500,46011,16049,38235,6146,10040,14895,5178,1976,23161,21895,1266,21895,13350,8545,2021-01-01,zipcode,Baytown
ZCTA5 77523,48,26370,121446,1160,304300,19274,5555,16364,1110,3635,7011,3108,1500,9102,8554,548,8554,7032,1522,2021-01-01,zipcode,Baytown
ZCTA5 77530,48,30880,66731,953,126000,21913,7798,17306,5235,5693,4417,1382,579,10058,9052,1006,9052,6447,2605,2021-01-01,zipcode,Channelview
ZCTA5 77531,48,15956,66367,1128,168800,12228,3625,9974,1753,2976,3066,1689,490,7033,6005,1028,6005,3429,2576,2021-01-01,zipcode,Clute
ZCTA5 77532,48,30108,82342,1006,195500,23472,7949,19943,1733,7215,7648,2139,1208,11626,10710,916,10710,8722,1988,2021-01-01,zipcode,Crosby
ZCTA5 77533,48,1135,55607,865,81700,939,440,718,73,422,151,42,30,470,379,91,379,287,92,2021-01-01,zipcode,Daisetta
ZCTA5 77534,48,3125,103261,1051,192000,2200,701,1732,179,381,769,316,87,1059,902,157,902,827,75,2021-01-01,zipcode,Danbury
ZCTA5 77535,48,37418,66529,947,161700,29134,14751,25056,5144,9566,7697,2162,487,11776,10551,1225,10551,9002,1549,2021-01-01,zipcode,Dayton
ZCTA5 77536,48,33291,83128,1190,190800,26691,9285,21443,2269,6078,8518,3390,1188,11873,11485,388,11485,8818,2667,2021-01-01,zipcode,Deer park
ZCTA5 77538,48,864,63542,-666666666,142000,650,282,567,74,257,168,51,17,340,276,64,276,249,27,2021-01-01,zipcode,Devers
ZCTA5 77539,48,45901,78825,1217,194600,35082,11639,30209,3891,7350,10584,5969,2415,18830,16961,1869,16961,12842,4119,2021-01-01,zipcode,Dickinson
ZCTA5 77541,48,17989,52529,1016,113700,13595,5603,11389,2212,3909,4217,848,203,9087,6523,2564,6523,4370,2153,2021-01-01,zipcode,Freeport
ZCTA5 77545,48,25755,82293,1817,209100,19993,5695,16567,2869,4378,4288,3565,1467,8562,8199,363,8199,6766,1433,2021-01-01,zipcode,Fresno
ZCTA5 77546,48,54405,111537,1574,282400,41640,13947,34997,1996,5616,11397,10329,5659,19561,18608,953,18608,14004,4604,2021-01-01,zipcode,Friendswood
ZCTA5 77547,48,9702,44330,1033,83300,6842,2698,5336,2011,1757,1152,358,58,2843,2671,172,2671,1859,812,2021-01-01,zipcode,Galena park
ZCTA5 77550,48,22421,42081,971,195100,19592,7957,16292,2372,3746,5162,3027,1985,15318,10940,4378,10940,4598,6342,2021-01-01,zipcode,Galveston
ZCTA5 77551,48,23686,54375,1131,202400,19601,8431,16825,2712,4645,4917,2923,1628,10876,9311,1565,9311,4374,4937,2021-01-01,zipcode,Galveston
ZCTA5 77554,48,9001,81058,1251,316000,8284,3330,6887,361,1359,2189,1832,1146,10231,4212,6019,4212,2810,1402,2021-01-01,zipcode,Galveston
ZCTA5 77560,48,708,88417,-666666666,-666666666,579,209,554,21,153,261,99,20,360,339,21,339,309,30,2021-01-01,zipcode,Hankamer
ZCTA5 77561,48,27,-666666666,-666666666,-666666666,27,18,27,0,27,0,0,0,15,8,7,8,8,0,2021-01-01,zipcode,Hardin
ZCTA5 77562,48,10292,60477,881,158100,7876,3456,6674,1533,2028,2359,450,304,4081,3565,516,3565,2734,831,2021-01-01,zipcode,Highlands
ZCTA5 77563,48,10223,70668,1047,179700,8146,3212,7276,898,2071,2846,1154,307,4823,4162,661,4162,3088,1074,2021-01-01,zipcode,Hitchcock
ZCTA5 77564,48,1737,76853,-666666666,110400,1310,771,1158,240,360,370,156,32,832,634,198,634,611,23,2021-01-01,zipcode,Hull
ZCTA5 77565,48,6555,85625,1415,290800,5497,1994,4774,266,886,1760,1195,667,3317,2948,369,2948,1753,1195,2021-01-01,zipcode,Kemah
ZCTA5 77566,48,30327,89434,1326,216300,23194,7494,19939,1214,5067,7017,4697,1944,12220,11295,925,11295,7384,3911,2021-01-01,zipcode,Lake jackson
ZCTA5 77568,48,19819,64106,1017,149600,15284,5268,13438,1935,3795,5050,1532,1126,8213,7287,926,7287,5470,1817,2021-01-01,zipcode,La marque
ZCTA5 77571,48,37298,80179,1200,168200,29070,10218,24930,2935,7834,9740,3035,1386,13875,13157,718,13157,9560,3597,2021-01-01,zipcode,La porte
ZCTA5 77573,48,95111,115979,1510,280800,72000,22365,62391,2156,10617,18472,20506,10640,35480,34240,1240,34240,25918,8322,2021-01-01,zipcode,League city
ZCTA5 77575,48,15796,46893,781,145300,11972,5719,10171,1897,4057,2969,810,438,6667,5602,1065,5602,4248,1354,2021-01-01,zipcode,Liberty
ZCTA5 77577,48,1303,59375,850,201800,1049,526,950,256,285,311,70,28,620,480,140,480,447,33,2021-01-01,zipcode,Liverpool
ZCTA5 77578,48,23444,113854,1325,293800,18020,5459,15353,1193,3078,5735,3003,2344,8888,8103,785,8103,6615,1488,2021-01-01,zipcode,Manvel
ZCTA5 77580,48,0,-666666666,-666666666,-666666666,0,0,0,0,0,0,0,0,0,0,0,0,0,0,2021-01-01,zipcode,Mont belvieu
ZCTA5 77581,48,50733,102333,1324,260600,38250,12047,32189,1805,7136,11384,7462,4402,18250,17078,1172,17078,13355,3723,2021-01-01,zipcode,Pearland
ZCTA5 77583,48,41232,99471,994,232600,32362,14037,27697,5325,7624,6731,4607,3410,12178,10883,1295,10883,9746,1137,2021-01-01,zipcode,Rosharon
ZCTA5 77584,48,89358,112815,1564,277900,66545,19289,57716,3404,6690,16085,19219,12318,31313,29822,1491,29822,22336,7486,2021-01-01,zipcode,Pearland
ZCTA5 77585,48,1152,-666666666,-666666666,-666666666,924,459,805,100,475,149,81,0,485,422,63,422,383,39,2021-01-01,zipcode,Saratoga
ZCTA5 77586,48,23364,102286,1342,270800,18660,6239,16002,955,2324,6102,4526,2095,9858,9040,818,9040,6073,2967,2021-01-01,zipcode,Seabrook
ZCTA5 77587,48,16381,51000,1048,129900,11895,4059,9220,3455,2916,1950,755,144,5519,4880,639,4880,2635,2245,2021-01-01,zipcode,South houston
ZCTA5 77590,48,33272,52210,1035,132800,25624,9606,21635,3757,7448,7101,2508,821,14069,12764,1305,12764,6619,6145,2021-01-01,zipcode,Texas city
ZCTA5 77591,48,14961,59531,1088,152000,11496,4235,9615,1014,3218,3376,1470,537,6483,5687,796,5687,2982,2705,2021-01-01,zipcode,Texas city
ZCTA5 77597,48,408,-666666666,-666666666,-666666666,354,110,321,23,66,91,98,43,279,174,105,174,148,26,2021-01-01,zipcode,Wallisville
ZCTA5 77598,48,27184,55310,1153,172500,21345,4930,17921,2522,3923,6281,3647,1548,13273,12214,1059,12214,2513,9701,2021-01-01,zipcode,Webster
ZCTA5 77611,48,9829,93852,874,166000,7377,2228,6200,737,1850,1988,1192,433,4017,3375,642,3375,2571,804,2021-01-01,zipcode,Bridge city
ZCTA5 77612,48,9490,60625,600,88400,7449,3369,6587,1153,2851,1950,448,185,4299,3591,708,3591,3190,401,2021-01-01,zipcode,Buna
ZCTA5 77613,48,896,88875,1034,158600,742,347,700,93,221,295,42,49,416,385,31,385,333,52,2021-01-01,zipcode,China
ZCTA5 77614,48,519,25450,-666666666,111500,446,225,412,46,237,101,28,0,388,247,141,247,186,61,2021-01-01,zipcode,Deweyville
ZCTA5 77615,48,365,-666666666,1025,81400,307,88,256,25,158,63,10,0,160,133,27,133,100,33,2021-01-01,zipcode,Evadale
ZCTA5 77616,48,269,81716,-666666666,-666666666,228,107,228,0,197,15,16,0,189,84,105,84,84,0,2021-01-01,zipcode,Fred
ZCTA5 77617,48,46,-666666666,-666666666,-666666666,46,41,46,9,8,21,8,0,147,32,115,32,24,8,2021-01-01,zipcode,
ZCTA5 77619,48,17078,60880,1054,126600,13679,5319,12199,1436,4169,5129,967,498,6631,5964,667,5964,4425,1539,2021-01-01,zipcode,Groves
ZCTA5 77622,48,1685,107649,-666666666,181100,1313,417,872,46,306,254,231,35,600,509,91,509,455,54,2021-01-01,zipcode,Hamshire
ZCTA5 77623,48,689,64333,-666666666,80500,616,239,575,32,263,177,43,60,363,290,73,290,269,21,2021-01-01,zipcode,High island
ZCTA5 77624,48,658,-666666666,-666666666,136800,580,324,564,17,313,156,63,15,262,238,24,238,230,8,2021-01-01,zipcode,Hillister
ZCTA5 77625,48,7773,59844,872,89300,6417,3332,5442,1031,2353,1401,461,196,3793,3014,779,3014,2462,552,2021-01-01,zipcode,Kountze
ZCTA5 77627,48,21896,77679,1128,152400,16846,5872,14502,896,4126,5814,2659,1007,9721,8654,1067,8654,6387,2267,2021-01-01,zipcode,Nederland
ZCTA5 77629,48,782,54079,-666666666,114200,693,291,657,107,241,208,62,39,382,336,46,336,323,13,2021-01-01,zipcode,Nome
ZCTA5 77630,48,29480,58607,904,129600,22681,9250,19309,2113,7114,7204,2134,744,12809,10432,2377,10432,7131,3301,2021-01-01,zipcode,Orange
ZCTA5 77632,48,21657,77500,922,148300,16902,6772,14975,1488,5312,5226,2181,768,9493,8034,1459,8034,6439,1595,2021-01-01,zipcode,Orange
ZCTA5 77640,48,17579,45341,972,71300,13873,7033,11627,2137,4439,3808,840,403,8930,6716,2214,6716,4456,2260,2021-01-01,zipcode,Port arthur
ZCTA5 77642,48,37881,40227,815,82500,28150,12708,23425,5790,8374,6687,1786,788,16057,13526,2531,13526,7047,6479,2021-01-01,zipcode,Port arthur
ZCTA5 77650,48,2094,61603,-666666666,279600,1963,1220,1925,102,816,680,246,81,2567,1116,1451,1116,985,131,2021-01-01,zipcode,Port bolivar
ZCTA5 77651,48,13534,78467,1035,183700,10517,3876,8997,552,2404,3667,1413,961,5465,4900,565,4900,3813,1087,2021-01-01,zipcode,Port neches
ZCTA5 77655,48,307,66518,-666666666,120700,288,123,275,30,132,85,10,18,195,163,32,163,152,11,2021-01-01,zipcode,Sabine pass
ZCTA5 77656,48,16795,60708,841,104100,13411,6076,11761,1227,4961,3643,1558,372,7460,6102,1358,6102,4868,1234,2021-01-01,zipcode,Silsbee
ZCTA5 77657,48,21551,79871,872,185100,16485,6287,14553,1219,5014,4851,2626,843,8718,7951,767,7951,6626,1325,2021-01-01,zipcode,Lumberton
ZCTA5 77659,48,6230,78750,944,163000,4384,1790,3520,504,1156,1011,582,267,2125,1901,224,1901,1615,286,2021-01-01,zipcode,Sour lake
ZCTA5 77660,48,1342,49972,-666666666,123200,1229,726,933,162,208,422,120,21,562,419,143,419,377,42,2021-01-01,zipcode,Spurger
ZCTA5 77661,48,363,-666666666,-666666666,-666666666,220,133,182,0,52,77,0,53,139,139,0,139,86,53,2021-01-01,zipcode,Stowell
ZCTA5 77662,48,25789,63830,774,107000,20758,8576,17850,2320,6835,6501,1639,555,11644,9543,2101,9543,7910,1633,2021-01-01,zipcode,Vidor
ZCTA5 77663,48,854,46061,-666666666,190800,641,415,565,10,243,283,29,0,545,386,159,386,234,152,2021-01-01,zipcode,Village mills
ZCTA5 77664,48,2368,60353,482,147200,1932,1079,1539,123,593,398,271,154,1263,912,351,912,792,120,2021-01-01,zipcode,Warren
ZCTA5 77665,48,6499,61549,847,147600,4954,1855,4113,474,1421,1525,479,214,2589,2008,581,2008,1604,404,2021-01-01,zipcode,Winnie
ZCTA5 77701,48,12930,40912,836,59400,9849,4357,8648,2527,3492,1881,453,295,5956,4610,1346,4610,2329,2281,2021-01-01,zipcode,Beaumont
ZCTA5 77702,48,3368,55682,910,142500,2566,723,2142,331,451,740,330,290,1678,1470,208,1470,819,651,2021-01-01,zipcode,Beaumont
ZCTA5 77703,48,12069,28202,784,78000,8516,4340,7090,1840,2914,1757,426,153,5324,4333,991,4333,2135,2198,2021-01-01,zipcode,Beaumont
ZCTA5 77705,48,40947,46751,726,102700,35138,21901,29095,5338,10784,10257,1941,775,12693,10760,1933,10760,6231,4529,2021-01-01,zipcode,Beaumont
ZCTA5 77706,48,29195,66829,960,193100,22970,8701,19938,869,3718,6246,6024,3081,14168,12857,1311,12857,7354,5503,2021-01-01,zipcode,Beaumont
ZCTA5 77707,48,18214,57114,973,135500,13456,4640,11342,1785,3013,3769,1838,937,7134,6293,841,6293,4453,1840,2021-01-01,zipcode,Beaumont
ZCTA5 77708,48,12979,51850,909,138200,10135,3536,8692,996,3188,2855,1175,478,5750,5256,494,5256,2620,2636,2021-01-01,zipcode,Beaumont
ZCTA5 77713,48,14136,72674,1173,172100,10778,3937,9413,918,2419,3566,1828,682,6728,5620,1108,5620,3481,2139,2021-01-01,zipcode,Beaumont
ZCTA5 77801,48,14585,27969,883,124000,11046,3849,6824,1122,1961,2001,942,798,7163,5879,1284,5879,775,5104,2021-01-01,zipcode,Bryan
ZCTA5 77802,48,24571,59488,1106,189000,20404,7100,17263,1121,3967,4095,4811,3269,11933,10993,940,10993,5838,5155,2021-01-01,zipcode,Bryan
ZCTA5 77803,48,33233,44750,972,103000,24559,9776,20066,6192,6707,5382,1164,621,10571,9635,936,9635,5819,3816,2021-01-01,zipcode,Bryan
ZCTA5 77807,48,12677,65534,1144,193900,10392,4476,8806,1618,2496,2132,1408,1152,5133,4332,801,4332,2667,1665,2021-01-01,zipcode,Bryan
ZCTA5 77808,48,14684,73738,1041,278400,11841,4407,10567,970,2799,3316,2315,1167,5955,5531,424,5531,5166,365,2021-01-01,zipcode,Bryan
ZCTA5 77830,48,3122,100910,856,299300,2453,799,2035,160,619,677,304,275,1378,1125,253,1125,959,166,2021-01-01,zipcode,Anderson
ZCTA5 77831,48,3137,48125,833,79100,2507,1221,2250,176,860,869,191,154,1822,1134,688,1134,964,170,2021-01-01,zipcode,Bedias
ZCTA5 77833,48,28417,61409,1023,198100,23173,9785,18519,2183,5446,5642,3594,1654,12617,10945,1672,10945,7698,3247,2021-01-01,zipcode,Brenham
ZCTA5 77835,48,3589,77833,1319,285200,2686,884,2413,149,911,675,409,269,1930,1318,612,1318,1094,224,2021-01-01,zipcode,Burton
ZCTA5 77836,48,11584,66800,719,154800,9340,3995,8158,1451,2985,2133,1108,481,5727,4696,1031,4696,3702,994,2021-01-01,zipcode,Caldwell
ZCTA5 77837,48,1580,58750,832,95500,1191,591,1028,177,352,245,131,123,855,596,259,596,430,166,2021-01-01,zipcode,Calvert
ZCTA5 77840,48,50047,27953,964,210800,45186,17356,18443,1560,3050,4899,4670,4264,24523,19972,4551,19972,2247,17725,2021-01-01,zipcode,College station
ZCTA5 77845,48,72886,83361,1211,285700,56407,18601,42931,1695,4956,10075,13656,12549,29606,27033,2573,27033,17911,9122,2021-01-01,zipcode,College station
ZCTA5 77853,48,1091,44946,738,109500,947,444,859,181,374,183,78,43,636,471,165,471,384,87,2021-01-01,zipcode,Dime box
ZCTA5 77855,48,34,-666666666,-666666666,-666666666,34,34,34,13,21,0,0,0,21,21,0,21,21,0,2021-01-01,zipcode,Flynn
ZCTA5 77856,48,4526,61284,794,203500,3566,1626,3112,288,1310,966,390,158,2686,1608,1078,1608,1225,383,2021-01-01,zipcode,Franklin
ZCTA5 77857,48,903,49464,1050,233300,734,370,667,61,253,259,50,44,498,401,97,401,352,49,2021-01-01,zipcode,Gause
ZCTA5 77859,48,7368,46233,696,107200,5880,2511,4840,775,1930,1310,510,315,3229,2839,390,2839,2049,790,2021-01-01,zipcode,Hearne
ZCTA5 77861,48,2171,66453,775,207600,1778,785,1550,153,616,464,222,95,1081,841,240,841,724,117,2021-01-01,zipcode,Iola
ZCTA5 77864,48,7158,60509,716,114300,5601,2318,4681,1270,1547,1244,447,173,3176,2535,641,2535,1872,663,2021-01-01,zipcode,Madisonville
ZCTA5 77865,48,2274,57215,1098,120500,1686,847,1326,107,521,506,140,52,1084,704,380,704,577,127,2021-01-01,zipcode,Marquez
ZCTA5 77867,48,302,-666666666,-666666666,9999,191,145,185,45,111,9,20,0,119,97,22,97,93,4,2021-01-01,zipcode,Mumford
ZCTA5 77868,48,18302,54442,736,166600,14533,7930,12482,2810,4320,3717,875,760,6367,5467,900,5467,3632,1835,2021-01-01,zipcode,Navasota
ZCTA5 77871,48,2757,56029,667,163200,2349,1099,2218,275,890,488,207,358,1552,1188,364,1188,890,298,2021-01-01,zipcode,Normangee
ZCTA5 77872,48,2416,66205,911,139800,1805,965,1461,183,640,444,154,40,980,755,225,755,620,135,2021-01-01,zipcode,North zulch
ZCTA5 77873,48,1270,57159,486,159200,1054,361,843,30,286,281,199,47,677,515,162,515,479,36,2021-01-01,zipcode,Richards
ZCTA5 77876,48,167,-666666666,-666666666,-666666666,130,73,130,0,44,57,0,29,55,55,0,55,55,0,2021-01-01,zipcode,Shiro
ZCTA5 77878,48,564,42833,638,-666666666,539,251,452,155,115,98,76,8,287,236,51,236,144,92,2021-01-01,zipcode,Snook
ZCTA5 77879,48,5162,60807,787,101800,4292,1976,3734,536,1106,1202,704,186,3234,2197,1037,2197,1684,513,2021-01-01,zipcode,Somerville
ZCTA5 77880,48,1816,80268,-666666666,253500,1569,577,1559,126,871,143,151,268,1365,905,460,905,831,74,2021-01-01,zipcode,Washington
ZCTA5 77901,48,40742,47375,951,112500,30918,11223,25092,5915,8262,7399,2546,970,17368,14916,2452,14916,8275,6641,2021-01-01,zipcode,Victoria
ZCTA5 77904,48,29064,81540,1075,203600,22464,8164,19981,1611,5071,7733,3767,1799,12142,11118,1024,11118,7859,3259,2021-01-01,zipcode,Victoria
ZCTA5 77905,48,16570,68193,1106,152900,13075,5202,11360,1709,3646,4089,1439,477,7019,6307,712,6307,5112,1195,2021-01-01,zipcode,Victoria
ZCTA5 77950,48,132,52083,-666666666,82000,132,66,122,11,51,41,13,6,142,73,69,73,60,13,2021-01-01,zipcode,Austwell
ZCTA5 77951,48,1361,30494,633,52200,1139,606,1016,309,514,184,9,0,714,564,150,564,413,151,2021-01-01,zipcode,Bloomington
ZCTA5 77954,48,10801,57038,852,156500,8858,4524,7848,1397,3322,2141,664,324,4549,3348,1201,3348,2152,1196,2021-01-01,zipcode,Cuero
ZCTA5 77957,48,8710,59701,854,100500,6817,3053,5863,998,2018,1788,787,272,3889,3070,819,3070,2208,862,2021-01-01,zipcode,Edna
ZCTA5 77960,48,37,-666666666,-666666666,-666666666,37,0,37,0,0,37,0,0,37,37,0,37,37,0,2021-01-01,zipcode,Fannin
ZCTA5 77961,48,165,-666666666,-666666666,-666666666,165,71,165,41,32,92,0,0,133,133,0,133,71,62,2021-01-01,zipcode,Francitas
ZCTA5 77962,48,3262,68482,797,159300,2604,1072,2186,465,635,808,227,51,1396,1124,272,1124,783,341,2021-01-01,zipcode,Ganado
ZCTA5 77963,48,5188,50804,646,151100,4141,2009,3590,617,1033,1270,471,199,2560,1888,672,1888,1474,414,2021-01-01,zipcode,Goliad
ZCTA5 77964,48,7850,56541,832,202100,6169,2381,5349,689,1933,1685,726,316,4289,3165,1124,3165,2209,956,2021-01-01,zipcode,Hallettsville
ZCTA5 77968,48,3057,67292,736,255400,2158,782,1889,57,573,693,403,163,1246,1117,129,1117,947,170,2021-01-01,zipcode,Inez
ZCTA5 77969,48,157,71500,-666666666,-666666666,147,84,134,61,37,36,0,0,78,60,18,60,60,0,2021-01-01,zipcode,La salle
ZCTA5 77970,48,377,66458,777,59500,299,134,218,86,47,37,15,33,199,111,88,111,69,42,2021-01-01,zipcode,La ward
ZCTA5 77971,48,1137,51617,-666666666,178200,834,369,748,202,353,153,40,0,435,297,138,297,226,71,2021-01-01,zipcode,Lolita
ZCTA5 77973,48,30,-666666666,-666666666,-666666666,30,9,20,11,9,0,0,0,11,11,0,11,0,11,2021-01-01,zipcode,Mcfaddin
ZCTA5 77974,48,562,-666666666,1106,158100,396,164,334,8,89,205,23,9,206,190,16,190,125,65,2021-01-01,zipcode,Meyersville
ZCTA5 77975,48,1540,62500,841,160300,1227,418,1164,122,473,337,149,83,1002,646,356,646,458,188,2021-01-01,zipcode,Moulton
ZCTA5 77976,48,41,-666666666,-666666666,177500,41,14,41,0,15,13,9,4,19,19,0,19,19,0,2021-01-01,zipcode,Nursery
ZCTA5 77977,48,467,22171,-666666666,46700,458,196,449,164,217,50,18,0,320,273,47,273,250,23,2021-01-01,zipcode,Placedo
ZCTA5 77978,48,495,78235,971,79800,403,154,351,23,148,144,23,13,246,188,58,188,97,91,2021-01-01,zipcode,Point comfort
ZCTA5 77979,48,16577,62054,795,120100,13218,4675,11175,2017,3561,3565,1449,583,7600,6237,1363,6237,4674,1563,2021-01-01,zipcode,Port lavaca
ZCTA5 77982,48,1084,60344,-666666666,215500,911,486,768,21,216,492,26,13,1409,433,976,433,337,96,2021-01-01,zipcode,Port o connor
ZCTA5 77983,48,2251,67993,1073,116500,1582,665,1346,271,407,408,188,72,1297,877,420,877,708,169,2021-01-01,zipcode,Seadrift
ZCTA5 77984,48,4134,77644,825,175700,3350,1333,3027,194,1112,958,625,138,2146,1625,521,1625,1403,222,2021-01-01,zipcode,Shiner
ZCTA5 77987,48,230,105481,-666666666,-666666666,144,27,140,11,77,30,12,10,103,79,24,79,70,9,2021-01-01,zipcode,Sweet home
ZCTA5 77988,48,100,57778,-666666666,36900,100,18,100,18,51,13,18,0,86,44,42,44,44,0,2021-01-01,zipcode,Telferner
ZCTA5 77990,48,913,54543,950,75600,768,379,713,98,308,197,76,34,515,331,184,331,279,52,2021-01-01,zipcode,Tivoli
ZCTA5 77991,48,492,108879,-666666666,116800,225,38,197,16,43,80,58,0,172,90,82,90,71,19,2021-01-01,zipcode,Vanderbilt
ZCTA5 77993,48,233,-666666666,-666666666,-666666666,133,94,133,30,29,35,39,0,81,42,39,42,42,0,2021-01-01,zipcode,Weesatche
ZCTA5 77994,48,376,76875,-666666666,-666666666,271,134,265,11,83,105,44,22,267,132,135,132,105,27,2021-01-01,zipcode,Westhoff
ZCTA5 77995,48,11065,52953,769,138000,8358,3616,7055,1458,2928,1813,710,146,4832,3887,945,3887,2928,959,2021-01-01,zipcode,Yoakum
ZCTA5 78001,48,0,-666666666,-666666666,-666666666,0,0,0,0,0,0,0,0,0,0,0,0,0,0,2021-01-01,zipcode,Artesia wells
ZCTA5 78002,48,8776,61250,985,123400,6803,2801,5199,1578,1784,1508,262,67,2664,2447,217,2447,1787,660,2021-01-01,zipcode,Atascosa
ZCTA5 78003,48,9325,63064,947,205700,7247,3461,6635,733,2045,2256,909,692,5026,3679,1347,3679,3154,525,2021-01-01,zipcode,Bandera
ZCTA5 78004,48,391,122227,-666666666,460900,375,168,363,0,74,78,128,83,177,177,0,177,153,24,2021-01-01,zipcode,Bergheim
ZCTA5 78005,48,1942,60943,-666666666,312100,1893,490,1852,962,509,168,61,152,847,828,19,828,454,374,2021-01-01,zipcode,Bigfoot
ZCTA5 78006,48,39830,103068,1377,397000,31375,12423,27370,1599,3709,8537,8052,5473,15893,14831,1062,14831,11052,3779,2021-01-01,zipcode,Boerne
ZCTA5 78007,48,204,-666666666,675,-666666666,110,56,110,5,65,36,4,0,115,42,73,42,33,9,2021-01-01,zipcode,Calliham
ZCTA5 78008,48,284,-666666666,-666666666,-666666666,256,154,256,135,85,19,0,17,266,121,145,121,75,46,2021-01-01,zipcode,Campbellton
ZCTA5 78009,48,7901,80685,1045,223000,6343,2529,5279,683,1234,1976,804,582,3023,2653,370,2653,2249,404,2021-01-01,zipcode,Castroville
ZCTA5 78010,48,3948,68951,-666666666,185300,3246,955,2755,560,796,714,471,214,1837,1535,302,1535,1149,386,2021-01-01,zipcode,Center point
ZCTA5 78011,48,1639,34362,-666666666,49100,1260,527,998,388,323,230,57,0,773,578,195,578,537,41,2021-01-01,zipcode,Charlotte
ZCTA5 78012,48,250,48750,-666666666,76900,219,105,171,56,72,23,0,20,173,109,64,109,73,36,2021-01-01,zipcode,Christine
ZCTA5 78013,48,5333,68767,917,285400,4412,1451,3987,394,910,1464,808,411,2600,2156,444,2156,1798,358,2021-01-01,zipcode,Comfort
ZCTA5 78014,48,5230,63045,906,79700,4139,2081,3534,994,1631,613,246,50,1928,1531,397,1531,1142,389,2021-01-01,zipcode,Cotulla
ZCTA5 78015,48,20928,132815,1411,428700,15631,5734,13643,365,1672,3250,5911,2445,7660,7364,296,7364,6822,542,2021-01-01,zipcode,Boerne
ZCTA5 78016,48,10156,48052,763,128400,8001,3088,6992,1065,2548,1923,873,583,4112,3508,604,3508,2475,1033,2021-01-01,zipcode,Devine
ZCTA5 78017,48,5340,67524,492,92700,4015,2524,2942,753,1176,590,116,307,1531,941,590,941,656,285,2021-01-01,zipcode,Dilley
ZCTA5 78019,48,1802,49750,-666666666,90900,1654,1013,1185,451,467,150,92,25,569,420,149,420,377,43,2021-01-01,zipcode,Encinal
ZCTA5 78021,48,66,-666666666,-666666666,-666666666,26,23,26,0,23,0,3,0,52,3,49,3,3,0,2021-01-01,zipcode,Fowlerton
ZCTA5 78022,48,4636,59194,807,123400,3764,1920,3305,1027,855,1005,268,150,2329,1576,753,1576,1214,362,2021-01-01,zipcode,George west
ZCTA5 78023,48,28750,122712,1651,326600,22533,7274,19370,556,2525,5680,6348,4261,9680,9465,215,9465,8498,967,2021-01-01,zipcode,Helotes
ZCTA5 78024,48,1222,62833,851,430600,1083,541,1042,50,183,369,248,192,940,514,426,514,387,127,2021-01-01,zipcode,Hunt
ZCTA5 78025,48,5217,58766,896,162400,4193,1702,3704,421,1268,1022,813,180,2660,2143,517,2143,1594,549,2021-01-01,zipcode,Ingram
ZCTA5 78026,48,6634,67981,862,113200,5101,2129,4370,831,1995,645,821,78,3044,2520,524,2520,1661,859,2021-01-01,zipcode,Jourdanton
ZCTA5 78027,48,445,95458,-666666666,229700,423,151,414,0,13,205,169,27,258,169,89,169,169,0,2021-01-01,zipcode,Kendalia
ZCTA5 78028,48,40081,59802,1002,213700,33576,15694,29131,2599,8194,9651,5550,3137,18491,16905,1586,16905,11108,5797,2021-01-01,zipcode,Kerrville
ZCTA5 78029,48,0,-666666666,-666666666,-666666666,0,0,0,0,0,0,0,0,0,0,0,0,0,0,2021-01-01,zipcode,Kerrville
ZCTA5 78039,48,2730,69683,875,67000,2146,764,1935,189,952,472,201,121,969,875,94,875,765,110,2021-01-01,zipcode,La coste
ZCTA5 78040,48,37136,29836,780,85400,26298,12035,21003,10485,4193,4774,1095,456,13546,11316,2230,11316,4894,6422,2021-01-01,zipcode,Laredo
ZCTA5 78041,48,46751,55311,867,169400,34774,12794,27596,7491,6109,6890,5042,2064,15948,14740,1208,14740,7570,7170,2021-01-01,zipcode,Laredo
ZCTA5 78043,48,45703,50190,890,117700,32786,12694,25591,8999,6573,6890,2222,907,14063,12728,1335,12728,6782,5946,2021-01-01,zipcode,Laredo
ZCTA5 78044,48,350,-666666666,-666666666,217600,263,155,252,71,141,40,0,0,222,134,88,134,104,30,2021-01-01,zipcode,Laredo
ZCTA5 78045,48,67730,78478,1197,188500,48281,16176,38858,6158,7785,11408,9453,4054,21015,19986,1029,19986,15235,4751,2021-01-01,zipcode,Laredo
ZCTA5 78046,48,68418,46845,895,108700,46189,18639,35546,13346,10199,8343,2640,1018,18528,16935,1593,16935,12883,4052,2021-01-01,zipcode,Laredo
ZCTA5 78050,48,471,82375,-666666666,75000,367,184,308,101,66,118,23,0,200,173,27,173,136,37,2021-01-01,zipcode,Leming
ZCTA5 78052,48,6000,61957,940,112800,5010,2163,4148,614,1525,1402,400,207,2314,1998,316,1998,1710,288,2021-01-01,zipcode,Lytle
ZCTA5 78055,48,1899,61566,-666666666,242900,1630,865,1466,114,632,412,161,147,1162,754,408,754,682,72,2021-01-01,zipcode,Medina
ZCTA5 78056,48,2250,119250,-666666666,434900,1882,912,1696,54,183,597,372,490,1022,862,160,862,785,77,2021-01-01,zipcode,Mico
ZCTA5 78057,48,560,-666666666,-666666666,635300,560,438,560,237,45,275,0,3,823,496,327,496,496,0,2021-01-01,zipcode,Moore
ZCTA5 78058,48,827,111406,-666666666,338100,706,364,658,17,142,215,173,111,640,387,253,387,350,37,2021-01-01,zipcode,Mountain home
ZCTA5 78059,48,5699,69189,843,156900,4907,2221,3965,1051,1286,968,473,187,2259,1996,263,1996,1830,166,2021-01-01,zipcode,Natalia
ZCTA5 78061,48,10781,57596,830,85400,8478,4392,6766,2163,2838,1337,313,115,3185,2588,597,2588,1623,965,2021-01-01,zipcode,Pearsall
ZCTA5 78063,48,9282,70009,1283,219500,8176,3532,7262,578,1706,2684,1499,795,4683,3749,934,3749,3407,342,2021-01-01,zipcode,Pipe creek
ZCTA5 78064,48,16049,69537,1071,164300,11519,4842,9826,1522,3823,2604,1312,565,5920,5190,730,5190,3884,1306,2021-01-01,zipcode,Pleasanton
ZCTA5 78065,48,10824,54079,788,100200,8441,3528,7250,1490,3114,1798,610,238,4081,3583,498,3583,2823,760,2021-01-01,zipcode,Poteet
ZCTA5 78066,48,582,80012,-666666666,171300,505,391,505,0,196,132,103,74,264,245,19,245,233,12,2021-01-01,zipcode,Rio medina
ZCTA5 78067,48,679,-666666666,-666666666,81900,555,310,476,173,188,59,56,0,480,186,294,186,186,0,2021-01-01,zipcode,San ygnacio
ZCTA5 78069,48,6542,65256,753,118500,5344,2434,4097,711,1639,1208,452,87,2212,1897,315,1897,1623,274,2021-01-01,zipcode,Somerset
ZCTA5 78070,48,17300,89508,1146,335600,14534,5778,12964,856,3393,4077,3021,1617,7439,6718,721,6718,6231,487,2021-01-01,zipcode,Spring branch
ZCTA5 78071,48,3730,44659,794,141200,3135,2156,2694,687,926,766,247,68,1486,1008,478,1008,728,280,2021-01-01,zipcode,Three rivers
ZCTA5 78072,48,488,61667,1250,83000,383,157,339,44,142,88,34,31,201,122,79,122,102,20,2021-01-01,zipcode,Tilden
ZCTA5 78073,48,10297,67563,933,106100,7877,2795,6408,1780,2518,1480,442,188,3178,2770,408,2770,2214,556,2021-01-01,zipcode,Von ormy
ZCTA5 78075,48,199,-666666666,-666666666,109400,131,35,99,16,48,14,21,0,101,94,7,94,62,32,2021-01-01,zipcode,Whitsett
ZCTA5 78076,48,13224,34789,506,83000,9104,4036,7377,2329,2372,1793,770,113,5559,4191,1368,4191,3060,1131,2021-01-01,zipcode,Zapata
ZCTA5 78101,48,9082,81215,704,223800,7138,2919,6103,967,1943,1866,825,502,3369,3188,181,3188,2902,286,2021-01-01,zipcode,Adkins
ZCTA5 78102,48,27271,49731,900,100800,22457,13084,18814,4058,6233,6414,1243,866,8655,7087,1568,7087,4696,2391,2021-01-01,zipcode,Beeville
ZCTA5 78104,48,96,70156,855,-666666666,62,13,49,2,12,35,0,0,40,31,9,31,0,31,2021-01-01,zipcode,Beeville
ZCTA5 78107,48,397,61103,-666666666,63700,340,172,312,27,91,165,29,0,256,220,36,220,153,67,2021-01-01,zipcode,Berclair
ZCTA5 78108,48,44734,102602,1815,247200,33150,12643,27136,1486,6103,9354,6321,3872,14574,13889,685,13889,11801,2088,2021-01-01,zipcode,Cibolo
ZCTA5 78109,48,48745,76783,1376,183500,35595,10649,29817,2497,7101,11281,5918,3020,17007,16409,598,16409,12200,4209,2021-01-01,zipcode,Converse
ZCTA5 78112,48,10087,49990,1057,104200,7520,3014,6531,1642,2133,2212,388,156,3277,3151,126,3151,2795,356,2021-01-01,zipcode,Elmendorf
ZCTA5 78113,48,2759,79821,927,217100,2123,844,1795,213,700,451,362,69,1192,1095,97,1095,882,213,2021-01-01,zipcode,Falls city
ZCTA5 78114,48,22948,78389,965,218100,18269,7219,15874,1753,5669,4899,2569,984,8727,8002,725,8002,6684,1318,2021-01-01,zipcode,Floresville
ZCTA5 78116,48,234,196429,-666666666,278600,234,177,234,0,162,52,0,20,215,116,99,116,116,0,2021-01-01,zipcode,Gillett
ZCTA5 78117,48,676,-666666666,-666666666,311400,505,280,466,34,163,137,123,9,365,301,64,301,279,22,2021-01-01,zipcode,Hobson
ZCTA5 78118,48,4280,54425,789,87800,3613,2080,2954,864,1112,509,394,75,1646,1241,405,1241,898,343,2021-01-01,zipcode,Karnes city
ZCTA5 78119,48,7068,35370,825,91300,5691,3705,5070,1330,1761,1327,411,241,2553,1822,731,1822,1127,695,2021-01-01,zipcode,Kenedy
ZCTA5 78121,48,13730,112715,1111,278500,10570,3404,9344,441,2759,3382,1970,792,5233,4755,478,4755,4304,451,2021-01-01,zipcode,La vernia
ZCTA5 78122,48,250,117284,-666666666,181300,250,101,241,58,109,25,9,40,184,157,27,157,144,13,2021-01-01,zipcode,Leesville
ZCTA5 78123,48,2528,88365,921,190100,1997,658,1835,126,843,510,195,161,1500,1028,472,1028,925,103,2021-01-01,zipcode,Mc queeney
ZCTA5 78124,48,7286,74050,1034,197200,5968,2404,5186,718,1675,1846,678,269,2793,2574,219,2574,2350,224,2021-01-01,zipcode,Marion
ZCTA5 78125,48,17,-666666666,-666666666,-666666666,14,9,14,6,4,4,0,0,26,10,16,10,10,0,2021-01-01,zipcode,Mineral
ZCTA5 78130,48,84510,73662,1302,232200,65731,21846,55818,5241,15534,16273,13117,5653,35639,32258,3381,32258,20333,11925,2021-01-01,zipcode,New braunfels
ZCTA5 78132,48,36475,113004,1249,425500,27958,10886,24578,1071,4417,6875,7776,4439,13670,12813,857,12813,10938,1875,2021-01-01,zipcode,New braunfels
ZCTA5 78133,48,20835,70949,1061,232200,17431,7727,15876,928,4986,5578,2641,1743,10983,8912,2071,8912,7643,1269,2021-01-01,zipcode,Canyon lake
ZCTA5 78140,48,3601,60476,854,81000,2529,878,2161,722,972,329,114,24,1408,1240,168,1240,857,383,2021-01-01,zipcode,Nixon
ZCTA5 78141,48,853,43063,850,67100,755,447,693,68,346,214,44,21,505,347,158,347,286,61,2021-01-01,zipcode,Nordheim
ZCTA5 78142,48,99,-666666666,-666666666,-666666666,88,62,62,3,13,10,9,27,51,34,17,34,29,5,2021-01-01,zipcode,Normanna
ZCTA5 78143,48,219,72629,-666666666,151300,172,93,154,15,52,14,73,0,68,55,13,55,55,0,2021-01-01,zipcode,Pandora
ZCTA5 78144,48,18,-666666666,-666666666,-666666666,18,18,18,0,18,0,0,0,18,18,0,18,0,18,2021-01-01,zipcode,Panna maria
ZCTA5 78145,48,85,42750,-666666666,24400,57,30,47,10,35,2,0,0,34,26,8,26,16,10,2021-01-01,zipcode,Pawnee
ZCTA5 78146,48,797,60052,937,122500,530,254,420,67,175,147,24,7,284,211,73,211,99,112,2021-01-01,zipcode,Pettus
ZCTA5 78147,48,1691,61579,955,144600,1250,452,966,119,375,324,126,22,645,546,99,546,340,206,2021-01-01,zipcode,Poth
ZCTA5 78148,48,22580,65256,1126,197700,16805,5131,14206,702,3977,4935,2798,1794,8429,8170,259,8170,4097,4073,2021-01-01,zipcode,Universal city
ZCTA5 78150,48,0,-666666666,-666666666,-666666666,0,0,0,0,0,0,0,0,0,0,0,0,0,0,2021-01-01,zipcode,Jbsa randolph
ZCTA5 78151,48,1495,40875,-666666666,95200,1106,525,872,255,239,178,102,98,749,612,137,612,382,230,2021-01-01,zipcode,Runge
ZCTA5 78152,48,2380,96570,1375,247100,2090,874,1692,82,618,476,303,213,961,926,35,926,905,21,2021-01-01,zipcode,Saint hedwig
ZCTA5 78154,48,39718,84962,1417,232500,31519,9444,27452,1189,5758,9433,6795,4277,15237,14512,725,14512,10114,4398,2021-01-01,zipcode,Schertz
ZCTA5 78155,48,51656,62243,998,179200,41279,16061,35167,5685,13676,9131,4691,1984,20472,18594,1878,18594,13242,5352,2021-01-01,zipcode,Seguin
ZCTA5 78159,48,860,50000,788,49900,613,334,424,101,181,99,39,4,395,306,89,306,234,72,2021-01-01,zipcode,Smiley
ZCTA5 78160,48,5246,72974,921,165600,4219,1803,3417,670,964,1213,319,251,2029,1775,254,1775,1539,236,2021-01-01,zipcode,Stockdale
ZCTA5 78161,48,621,36786,-666666666,-666666666,494,212,339,39,167,85,41,7,271,196,75,196,185,11,2021-01-01,zipcode,Sutherland springs
ZCTA5 78162,48,341,39500,-666666666,159800,312,175,187,51,18,94,23,1,195,132,63,132,83,49,2021-01-01,zipcode,Tuleta
ZCTA5 78163,48,14531,113924,1380,357700,11557,5085,10231,371,1922,3224,3296,1418,5500,5141,359,5141,4903,238,2021-01-01,zipcode,Bulverde
ZCTA5 78164,48,3592,66607,791,173600,2902,1524,2544,424,993,809,190,128,1899,1390,509,1390,1133,257,2021-01-01,zipcode,Yorktown
ZCTA5 78201,48,45767,38363,907,137000,37454,15499,31397,8566,9349,8169,2866,2447,19156,17249,1907,17249,8056,9193,2021-01-01,zipcode,San antonio
ZCTA5 78202,48,10390,34542,891,116300,8553,3590,7339,1987,2395,1569,816,572,4989,4245,744,4245,2044,2201,2021-01-01,zipcode,San antonio
ZCTA5 78203,48,6034,34533,808,98000,4662,1581,3971,1177,1089,1197,333,175,2738,2285,453,2285,1145,1140,2021-01-01,zipcode,San antonio
ZCTA5 78204,48,11832,40605,1165,98500,9514,3582,8044,2016,2089,2274,762,903,5860,4727,1133,4727,2204,2523,2021-01-01,zipcode,San antonio
ZCTA5 78205,48,1521,43696,1081,554100,1448,665,1174,246,124,197,319,288,1730,1118,612,1118,58,1060,2021-01-01,zipcode,San antonio
ZCTA5 78207,48,51062,26650,731,72100,37828,19231,31594,13181,10165,6469,1200,579,18665,16488,2177,16488,7311,9177,2021-01-01,zipcode,San antonio
ZCTA5 78208,48,4175,20677,792,109100,3152,1542,2701,822,921,737,146,75,2214,1817,397,1817,607,1210,2021-01-01,zipcode,San antonio
ZCTA5 78209,48,42474,74042,1188,404000,34324,10869,28942,1185,3769,6540,9249,8199,21817,19257,2560,19257,9308,9949,2021-01-01,zipcode,San antonio
ZCTA5 78210,48,34005,44279,955,119200,26510,10735,22476,5846,7174,6339,1808,1309,14412,12187,2225,12187,6988,5199,2021-01-01,zipcode,San antonio
ZCTA5 78211,48,30556,45008,930,82200,24155,9755,20808,7921,7152,4574,853,308,10705,9702,1003,9702,6187,3515,2021-01-01,zipcode,San antonio
ZCTA5 78212,48,27020,52783,948,227300,23566,8486,18733,2730,3841,4951,3804,3407,13532,11670,1862,11670,5212,6458,2021-01-01,zipcode,San antonio
ZCTA5 78213,48,42767,49050,1006,159900,33599,11101,28196,5290,7173,9186,4279,2268,18294,16940,1354,16940,8215,8725,2021-01-01,zipcode,San antonio
ZCTA5 78214,48,23077,36633,851,91500,17711,8300,14604,4689,5071,3795,754,295,8679,8174,505,8174,4732,3442,2021-01-01,zipcode,San antonio
ZCTA5 78215,48,3151,74159,1624,-666666666,3019,523,2495,128,149,544,741,933,2569,2121,448,2121,154,1967,2021-01-01,zipcode,San antonio
ZCTA5 78216,48,43073,50362,1048,231700,35253,10329,29169,3026,5999,9803,6150,4191,22077,19294,2783,19294,6525,12769,2021-01-01,zipcode,San antonio
ZCTA5 78217,48,33130,47122,1032,161200,26724,8704,22562,2727,5897,8315,3484,2139,16069,14597,1472,14597,6180,8417,2021-01-01,zipcode,San antonio
ZCTA5 78218,48,36334,45884,1007,135300,28098,9608,23936,4396,7192,8067,2819,1462,14544,13630,914,13630,6472,7158,2021-01-01,zipcode,San antonio
ZCTA5 78219,48,16304,40967,975,112300,11694,4921,9973,2465,3091,3382,758,277,6121,5524,597,5524,2849,2675,2021-01-01,zipcode,San antonio
ZCTA5 78220,48,15808,36652,1025,89600,11859,5590,9572,2298,3477,2762,793,242,6230,5635,595,5635,3173,2462,2021-01-01,zipcode,San antonio
ZCTA5 78221,48,41964,51115,969,107600,31959,11718,25945,7601,9371,6667,1541,765,14398,13185,1213,13185,8669,4516,2021-01-01,zipcode,San antonio
ZCTA5 78222,48,23652,58407,1085,147600,18135,7302,15280,2587,5491,4666,1737,799,8781,7884,897,7884,5393,2491,2021-01-01,zipcode,San antonio
ZCTA5 78223,48,54438,44338,910,115500,40785,16711,34835,7957,12637,10490,2726,1025,21371,19398,1973,19398,11023,8375,2021-01-01,zipcode,San antonio
ZCTA5 78224,48,20306,50242,974,110400,14547,4990,11971,2844,4030,3581,1261,255,6649,6231,418,6231,3428,2803,2021-01-01,zipcode,San antonio
ZCTA5 78225,48,14115,39205,892,87400,11044,4002,9080,2576,3064,2430,620,390,5566,5173,393,5173,3518,1655,2021-01-01,zipcode,San antonio
ZCTA5 78226,48,7109,28247,838,89500,5527,2579,4345,1675,1495,974,156,45,2895,2324,571,2324,887,1437,2021-01-01,zipcode,San antonio
ZCTA5 78227,48,46350,42083,947,109300,34046,12665,27860,6777,9890,8564,1901,728,16317,15192,1125,15192,8642,6550,2021-01-01,zipcode,San antonio
ZCTA5 78228,48,56781,43422,889,118600,44936,19358,36346,10753,11720,9501,3131,1241,21506,19593,1913,19593,11355,8238,2021-01-01,zipcode,San antonio
ZCTA5 78229,48,34633,41128,1088,151200,28394,8799,22629,2672,4753,7490,4396,3318,19102,16492,2610,16492,2463,14029,2021-01-01,zipcode,San antonio
ZCTA5 78230,48,42892,62854,1134,281100,35869,11354,30217,1821,5495,8213,8704,5984,20703,19217,1486,19217,9225,9992,2021-01-01,zipcode,San antonio
ZCTA5 78231,48,10109,103504,1146,333200,8068,2798,7063,327,1085,1606,1871,2174,3968,3841,127,3841,2634,1207,2021-01-01,zipcode,San antonio
ZCTA5 78232,48,36825,78320,1286,276800,29505,9345,25937,1175,4234,7985,7776,4767,15887,15202,685,15202,8723,6479,2021-01-01,zipcode,San antonio
ZCTA5 78233,48,46281,63814,1300,158700,35867,12016,30160,2815,9228,11590,4340,2187,18358,17579,779,17579,10625,6954,2021-01-01,zipcode,San antonio
ZCTA5 78234,48,4655,82466,1838,-666666666,3028,698,1819,28,173,706,577,335,1047,945,102,945,3,942,2021-01-01,zipcode,Jbsa ft sam houston
ZCTA5 78235,48,2362,49079,1238,-666666666,1869,442,1475,82,426,496,296,175,1273,1156,117,1156,0,1156,2021-01-01,zipcode,San antonio
ZCTA5 78236,48,8521,82727,1812,-666666666,7726,530,1897,137,147,899,574,140,576,470,106,470,0,470,2021-01-01,zipcode,Jbsa lackland
ZCTA5 78237,48,38772,34266,849,77600,28902,12758,24100,9057,8376,5452,903,312,13396,12450,946,12450,7850,4600,2021-01-01,zipcode,San antonio
ZCTA5 78238,48,25737,51589,993,153800,20273,7023,16983,2266,5488,6110,2185,934,11352,10306,1046,10306,4955,5351,2021-01-01,zipcode,San antonio
ZCTA5 78239,48,30482,64398,1175,163200,24028,10108,20008,2417,5841,6616,3295,1839,10683,9892,791,9892,7115,2777,2021-01-01,zipcode,San antonio
ZCTA5 78240,48,56810,56864,1160,194000,44256,13451,37122,2880,6991,12425,9113,5713,26856,24089,2767,24089,8633,15456,2021-01-01,zipcode,San antonio
ZCTA5 78242,48,34084,43073,985,92200,23852,9415,18766,6617,6055,4683,1133,278,10794,10105,689,10105,5447,4658,2021-01-01,zipcode,San antonio
ZCTA5 78243,48,383,-666666666,-666666666,-666666666,383,0,53,0,0,53,0,0,0,0,0,0,0,0,2021-01-01,zipcode,San antonio
ZCTA5 78244,48,36233,61392,1357,150500,27484,8409,23584,3315,6118,8829,3655,1667,12503,11958,545,11958,8543,3415,2021-01-01,zipcode,San antonio
ZCTA5 78245,48,90956,77468,1326,183800,66300,19869,54807,5163,14094,21028,9967,4555,30306,28417,1889,28417,20544,7873,2021-01-01,zipcode,San antonio
ZCTA5 78247,48,50588,79177,1297,197000,40006,11939,33872,2036,7111,12570,8537,3618,19160,18466,694,18466,14112,4354,2021-01-01,zipcode,San antonio
ZCTA5 78248,48,13840,122986,1227,375300,11193,3474,10060,173,915,2847,3319,2806,5831,5717,114,5717,3972,1745,2021-01-01,zipcode,San antonio
ZCTA5 78249,48,59035,73875,1292,223200,49745,12624,33960,1371,5101,10931,10157,6400,23328,21969,1359,21969,11278,10691,2021-01-01,zipcode,San antonio
ZCTA5 78250,48,60101,73957,1307,174100,46590,12867,39692,2677,9085,14701,8878,4351,20491,19931,560,19931,14672,5259,2021-01-01,zipcode,San antonio
ZCTA5 78251,48,61970,69346,1194,193500,47343,11802,38451,3296,9177,14340,7360,4278,22601,21540,1061,21540,11127,10413,2021-01-01,zipcode,San antonio
ZCTA5 78252,48,14832,71028,1384,172200,11215,4315,9692,2161,2641,3129,1162,599,4299,4121,178,4121,3481,640,2021-01-01,zipcode,San antonio
ZCTA5 78253,48,59752,106343,1297,268600,43499,12747,36697,2105,6363,12369,9394,6466,20705,19330,1375,19330,15340,3990,2021-01-01,zipcode,San antonio
ZCTA5 78254,48,74490,106984,1488,232700,52983,12791,45641,2542,7894,15862,13155,6188,23288,22486,802,22486,18529,3957,2021-01-01,zipcode,San antonio
ZCTA5 78255,48,17545,134941,1446,382200,13353,4609,11404,507,1135,3184,3612,2966,6437,6020,417,6020,5135,885,2021-01-01,zipcode,San antonio
ZCTA5 78256,48,11554,84040,1356,446200,9517,2704,6630,202,393,1891,2028,2116,5664,4799,865,4799,1491,3308,2021-01-01,zipcode,San antonio
ZCTA5 78257,48,9201,66094,1475,436000,7720,1873,6519,170,993,1914,2081,1361,5634,4881,753,4881,1914,2967,2021-01-01,zipcode,San antonio
ZCTA5 78258,48,47072,103092,1440,365600,36155,11451,31630,1105,3045,8608,11433,7439,19151,18077,1074,18077,10956,7121,2021-01-01,zipcode,San antonio
ZCTA5 78259,48,25691,99365,1293,295100,20224,6403,17885,883,2494,5776,4998,3734,10574,9940,634,9940,6787,3153,2021-01-01,zipcode,San antonio
ZCTA5 78260,48,34038,123918,1905,360000,25315,8024,22171,804,2813,5849,8011,4694,11799,11365,434,11365,10170,1195,2021-01-01,zipcode,San antonio
ZCTA5 78261,48,23992,118042,1416,338300,18118,5167,15907,353,2052,4448,5046,4008,9037,8515,522,8515,7039,1476,2021-01-01,zipcode,San antonio
ZCTA5 78263,48,4806,67417,1116,217800,4133,1588,3527,299,1371,996,538,323,1905,1877,28,1877,1589,288,2021-01-01,zipcode,San antonio
ZCTA5 78264,48,12899,44870,1050,111000,9875,4400,8365,2566,2792,2271,566,170,4495,3926,569,3926,3265,661,2021-01-01,zipcode,San antonio
ZCTA5 78266,48,6962,129911,2214,440600,5870,2398,5110,141,765,978,1710,1516,2901,2706,195,2706,2576,130,2021-01-01,zipcode,San antonio
ZCTA5 78330,48,597,49375,1042,78400,440,224,401,93,165,90,30,23,250,216,34,216,193,23,2021-01-01,zipcode,Agua dulce
ZCTA5 78332,48,27274,47456,797,78500,20418,8816,17159,3489,6675,4780,1642,573,10842,8913,1929,8913,5922,2991,2021-01-01,zipcode,Alice
ZCTA5 78336,48,12365,55153,943,146900,9700,4520,8306,1289,4028,1926,733,330,6459,4533,1926,4533,3036,1497,2021-01-01,zipcode,Aransas pass
ZCTA5 78338,48,0,-666666666,-666666666,-666666666,0,0,0,0,0,0,0,0,0,0,0,0,0,0,2021-01-01,zipcode,Armstrong
ZCTA5 78339,48,348,-666666666,-666666666,65200,293,153,293,185,0,46,24,38,190,135,55,135,135,0,2021-01-01,zipcode,Banquete
ZCTA5 78340,48,383,47740,1125,131300,344,147,326,58,107,93,41,27,302,189,113,189,168,21,2021-01-01,zipcode,Bayside
ZCTA5 78341,48,1365,50272,840,66000,964,511,771,124,215,316,80,36,776,383,393,383,241,142,2021-01-01,zipcode,Benavides
ZCTA5 78342,48,226,-666666666,-666666666,-666666666,177,80,159,72,51,36,0,0,80,74,6,74,39,35,2021-01-01,zipcode,Ben bolt
ZCTA5 78343,48,4594,54615,855,94100,3666,1759,3242,704,1002,909,466,161,2057,1632,425,1632,1404,228,2021-01-01,zipcode,Bishop
ZCTA5 78344,48,415,64554,-666666666,77300,341,151,276,4,183,82,7,0,186,139,47,139,125,14,2021-01-01,zipcode,Bruni
ZCTA5 78349,48,768,31250,-666666666,89500,484,383,408,254,75,64,15,0,305,161,144,161,159,2,2021-01-01,zipcode,Concepcion
ZCTA5 78351,48,705,33098,936,67500,436,186,313,67,173,28,36,9,233,183,50,183,59,124,2021-01-01,zipcode,Driscoll
ZCTA5 78352,48,290,46250,-666666666,45000,156,75,145,51,94,0,0,0,87,51,36,51,51,0,2021-01-01,zipcode,Edroy
ZCTA5 78353,48,320,24292,-666666666,-666666666,293,176,293,150,37,17,89,0,323,175,148,175,79,96,2021-01-01,zipcode,Encino
ZCTA5 78355,48,7102,27556,409,71700,5540,2732,4643,1394,1275,1168,557,249,3252,2345,907,2345,1540,805,2021-01-01,zipcode,Falfurrias
ZCTA5 78357,48,2819,61017,725,80000,2244,853,1864,282,763,546,112,161,1188,878,310,878,630,248,2021-01-01,zipcode,Freer
ZCTA5 78358,48,987,45114,-666666666,-666666666,926,836,851,213,139,224,131,144,650,493,157,493,409,84,2021-01-01,zipcode,Fulton
ZCTA5 78359,48,2231,35761,599,82800,1581,692,1267,356,480,358,55,18,754,634,120,634,394,240,2021-01-01,zipcode,Gregory
ZCTA5 78361,48,4864,37342,647,88000,3483,1180,2551,693,930,591,249,88,2233,1423,810,1423,958,465,2021-01-01,zipcode,Hebbronville
ZCTA5 78362,48,10789,67852,1217,157100,8150,3080,7030,1062,2511,2328,742,387,4341,3805,536,3805,2663,1142,2021-01-01,zipcode,Ingleside
ZCTA5 78363,48,29415,49590,912,98400,23014,9515,16402,3188,5398,4091,2510,1215,12989,10901,2088,10901,5796,5105,2021-01-01,zipcode,Kingsville
ZCTA5 78368,48,8586,38211,602,77800,7045,3675,5994,1582,1807,1992,450,163,4722,3534,1188,3534,2789,745,2021-01-01,zipcode,Mathis
ZCTA5 78369,48,189,-666666666,-666666666,18300,153,76,122,39,38,30,15,0,151,77,74,77,57,20,2021-01-01,zipcode,Mirando city
ZCTA5 78370,48,4857,56172,1001,132700,3798,1721,3326,770,971,1060,285,240,1961,1635,326,1635,1211,424,2021-01-01,zipcode,Odem
ZCTA5 78371,48,108,34464,-666666666,-666666666,101,46,62,0,28,34,0,0,121,49,72,49,42,7,2021-01-01,zipcode,Oilton
ZCTA5 78372,48,5261,47721,818,98000,3383,1765,2986,717,1250,702,266,51,2160,1577,583,1577,1233,344,2021-01-01,zipcode,Orange grove
ZCTA5 78373,48,3271,62833,1593,405500,2887,1404,2702,99,720,875,669,339,5101,1552,3549,1552,1167,385,2021-01-01,zipcode,Port aransas
ZCTA5 78374,48,19737,82124,1597,185200,14920,5140,12598,991,3496,4728,2195,1188,7979,6811,1168,6811,4327,2484,2021-01-01,zipcode,Portland
ZCTA5 78375,48,3015,41842,692,71000,2529,1017,1956,554,763,370,214,55,1452,1067,385,1067,712,355,2021-01-01,zipcode,Premont
ZCTA5 78376,48,273,48542,1094,65500,214,107,204,61,96,35,11,1,242,93,149,93,65,28,2021-01-01,zipcode,Realitos
ZCTA5 78377,48,3272,48125,616,87000,2506,1219,2102,292,986,712,71,41,1463,946,517,946,634,312,2021-01-01,zipcode,Refugio
ZCTA5 78379,48,1578,60270,1259,92400,1353,598,1088,205,356,237,170,120,877,649,228,649,568,81,2021-01-01,zipcode,Riviera
ZCTA5 78380,48,24014,54596,967,119400,18819,8304,16138,3550,5505,4905,1406,772,9550,8442,1108,8442,6353,2089,2021-01-01,zipcode,Robstown
ZCTA5 78382,48,18702,52705,1014,185600,15768,7559,14273,1495,3878,4882,2747,1271,12425,8306,4119,8306,6679,1627,2021-01-01,zipcode,Rockport
ZCTA5 78383,48,5057,60946,794,143500,3874,1943,3666,476,1065,910,960,255,2580,1715,865,1715,1471,244,2021-01-01,zipcode,Sandia
ZCTA5 78384,48,5264,38171,488,70100,4054,1833,3412,1068,999,1093,203,49,2295,1481,814,1481,1123,358,2021-01-01,zipcode,San diego
ZCTA5 78385,48,169,42778,-666666666,-666666666,103,39,103,84,15,0,2,2,100,48,52,48,5,43,2021-01-01,zipcode,Sarita
ZCTA5 78387,48,9791,45076,706,86500,7389,3250,6132,1362,2048,2059,387,276,3882,3247,635,3247,2019,1228,2021-01-01,zipcode,Sinton
ZCTA5 78389,48,1888,35189,868,51400,1517,716,1284,217,253,605,67,142,923,694,229,694,584,110,2021-01-01,zipcode,Skidmore
ZCTA5 78390,48,5737,55182,1044,90400,4334,2053,3696,1041,1238,1060,315,42,2398,1895,503,1895,1227,668,2021-01-01,zipcode,Taft
ZCTA5 78391,48,156,63333,-666666666,-666666666,95,13,88,36,37,15,0,0,62,50,12,50,19,31,2021-01-01,zipcode,Tynan
ZCTA5 78393,48,2194,51014,715,82400,1733,829,1534,428,517,407,142,40,973,686,287,686,549,137,2021-01-01,zipcode,Woodsboro
ZCTA5 78401,48,4660,30625,804,62300,4338,2999,3948,1005,1388,1049,382,124,2189,1573,616,1573,257,1316,2021-01-01,zipcode,Corpus christi
ZCTA5 78402,48,233,45000,-666666666,180300,171,110,171,0,37,25,94,15,449,116,333,116,86,30,2021-01-01,zipcode,Corpus christi
ZCTA5 78404,48,15650,49473,1025,127100,12836,5076,11233,2233,3057,3590,1416,937,7458,6009,1449,6009,2995,3014,2021-01-01,zipcode,Corpus christi
ZCTA5 78405,48,14194,31660,782,60900,11245,5062,9392,3706,3502,1829,280,75,6117,5216,901,5216,2933,2283,2021-01-01,zipcode,Corpus christi
ZCTA5 78406,48,2328,-666666666,1352,-666666666,1761,1170,1338,399,520,370,38,11,396,370,26,370,139,231,2021-01-01,zipcode,Corpus christi
ZCTA5 78407,48,2033,45060,1099,117500,1542,478,1260,373,613,160,67,47,979,625,354,625,347,278,2021-01-01,zipcode,Corpus christi
ZCTA5 78408,48,10294,37488,770,74100,7644,3910,6421,2003,2081,1860,339,138,4690,3953,737,3953,2139,1814,2021-01-01,zipcode,Corpus christi
ZCTA5 78409,48,2312,59605,773,106300,1835,710,1578,412,482,543,99,42,977,854,123,854,456,398,2021-01-01,zipcode,Corpus christi
ZCTA5 78410,48,27623,78057,1147,178300,20109,6926,16814,1921,4904,6612,2527,850,10468,9418,1050,9418,6312,3106,2021-01-01,zipcode,Corpus christi
ZCTA5 78411,48,24194,55357,1094,144400,20504,7720,17166,2229,4941,5917,2217,1862,10485,9118,1367,9118,5686,3432,2021-01-01,zipcode,Corpus christi
ZCTA5 78412,48,41071,51280,1093,149700,33415,12221,24217,2383,7177,7829,4592,2236,16829,15606,1223,15606,7270,8336,2021-01-01,zipcode,Corpus christi
ZCTA5 78413,48,36989,73859,1181,187600,29162,9228,24039,1587,6417,8640,4567,2828,15501,14357,1144,14357,8001,6356,2021-01-01,zipcode,Corpus christi
ZCTA5 78414,48,46133,87231,1343,218200,35145,10533,29911,1546,5666,12274,6505,3920,18431,17224,1207,17224,10996,6228,2021-01-01,zipcode,Corpus christi
ZCTA5 78415,48,41583,49255,1055,113000,30736,11621,26309,6191,10154,7351,1895,718,15475,14095,1380,14095,7891,6204,2021-01-01,zipcode,Corpus christi
ZCTA5 78416,48,15030,40981,940,79900,11725,5288,9991,3195,3428,2640,519,209,5787,5329,458,5329,2996,2333,2021-01-01,zipcode,Corpus christi
ZCTA5 78417,48,4400,58500,1136,124600,3506,1174,2963,881,1054,771,183,74,1536,1392,144,1392,888,504,2021-01-01,zipcode,Corpus christi
ZCTA5 78418,48,30015,80906,1154,224700,23702,8454,21075,2004,4887,7385,4478,2321,15296,12068,3228,12068,7644,4424,2021-01-01,zipcode,Corpus christi
ZCTA5 78419,48,544,73333,1656,-666666666,305,90,275,11,66,92,72,34,190,176,14,176,0,176,2021-01-01,zipcode,Corpus christi
ZCTA5 78501,48,60855,43679,807,121800,47160,18812,39834,10404,8627,9772,7791,3240,24854,21666,3188,21666,11034,10632,2021-01-01,zipcode,Mcallen
ZCTA5 78503,48,20444,40012,974,113900,14972,6023,11984,4591,1829,2534,2112,918,7736,6254,1482,6254,3822,2432,2021-01-01,zipcode,Mcallen
ZCTA5 78504,48,60740,68024,1003,156600,44662,15510,35786,5307,6965,10265,8375,4874,20487,18738,1749,18738,12677,6061,2021-01-01,zipcode,Mcallen
ZCTA5 78516,48,33963,40583,678,68900,24128,10567,19208,8334,4786,3850,1836,402,12053,10016,2037,10016,7677,2339,2021-01-01,zipcode,Alamo
ZCTA5 78520,48,60592,42484,732,95900,46473,20214,36309,12339,8943,7741,4880,2406,21461,18844,2617,18844,10677,8167,2021-01-01,zipcode,Brownsville
ZCTA5 78521,48,88791,35318,763,74100,65585,29129,50650,20780,12888,10146,5084,1752,28760,26194,2566,26194,15497,10697,2021-01-01,zipcode,Brownsville
ZCTA5 78526,48,58713,62912,936,123600,41633,14744,33526,7575,6707,9583,7148,2513,17389,16374,1015,16374,11441,4933,2021-01-01,zipcode,Brownsville
ZCTA5 78535,48,713,39821,725,67600,614,241,476,161,178,100,29,8,286,253,33,253,190,63,2021-01-01,zipcode,Combes
ZCTA5 78536,48,353,-666666666,-666666666,113600,325,129,258,44,91,72,44,7,193,134,59,134,123,11,2021-01-01,zipcode,Delmita
ZCTA5 78537,48,51216,32155,650,60900,33599,15490,26362,11779,6506,5419,1986,672,16297,13667,2630,13667,10101,3566,2021-01-01,zipcode,Donna
ZCTA5 78538,48,10557,38750,529,67100,7491,3045,5962,2339,1841,1184,385,213,3294,2840,454,2840,2258,582,2021-01-01,zipcode,Edcouch
ZCTA5 78539,48,36531,62730,881,157200,27962,9863,22502,3461,4404,6721,4574,3342,14429,13310,1119,13310,7257,6053,2021-01-01,zipcode,Edinburg
ZCTA5 78541,48,45675,39352,810,109000,32776,12143,25578,7638,6343,6328,3821,1448,15909,14304,1605,14304,7533,6771,2021-01-01,zipcode,Edinburg
ZCTA5 78542,48,84606,49985,785,89700,57432,24363,44062,16169,12195,9750,4549,1399,23369,21034,2335,21034,15920,5114,2021-01-01,zipcode,Edinburg
ZCTA5 78543,48,8421,44804,638,67000,6364,2840,5051,1162,1853,1486,337,213,2800,2566,234,2566,1965,601,2021-01-01,zipcode,Elsa
ZCTA5 78545,48,407,18364,-666666666,35700,334,241,270,164,41,44,0,21,384,205,179,205,199,6,2021-01-01,zipcode,Falcon heights
ZCTA5 78548,48,1412,36538,670,47500,992,367,825,331,265,203,26,0,601,456,145,456,388,68,2021-01-01,zipcode,Grulla
ZCTA5 78549,48,1109,16205,-666666666,49500,694,520,549,374,114,49,0,12,404,295,109,295,249,46,2021-01-01,zipcode,Hargill
ZCTA5 78550,48,54486,41961,770,93000,40022,16490,33081,8555,9141,8857,4596,1932,21440,18778,2662,18778,9848,8930,2021-01-01,zipcode,Harlingen
ZCTA5 78552,48,41382,54586,886,105700,29457,11782,25555,5398,7215,7769,3347,1826,15825,13416,2409,13416,10169,3247,2021-01-01,zipcode,Harlingen
ZCTA5 78557,48,13939,39504,756,111300,10096,3347,7924,2775,1445,2138,1363,203,3977,3746,231,3746,2856,890,2021-01-01,zipcode,Hidalgo
ZCTA5 78558,48,430,-666666666,-666666666,-666666666,430,129,412,139,197,62,14,0,218,187,31,187,157,30,2021-01-01,zipcode,La blanca
ZCTA5 78559,48,12819,38975,868,78500,9143,4305,7815,2062,2449,2088,787,429,4895,4185,710,4185,3163,1022,2021-01-01,zipcode,La feria
ZCTA5 78560,48,4417,-666666666,601,86800,3293,1514,2573,860,900,359,277,177,1660,1359,301,1359,784,575,2021-01-01,zipcode,La joya
ZCTA5 78561,48,694,22639,-666666666,60000,588,314,454,230,106,89,21,8,221,213,8,213,162,51,2021-01-01,zipcode,Lasara
ZCTA5 78562,48,2950,50417,371,84800,2545,1741,2109,1055,524,373,144,13,608,513,95,513,381,132,2021-01-01,zipcode,La villa
ZCTA5 78563,48,102,60045,-666666666,-666666666,102,84,102,17,68,0,4,13,94,55,39,55,55,0,2021-01-01,zipcode,Linn
ZCTA5 78564,48,42,-666666666,-666666666,-666666666,26,13,26,0,13,13,0,0,88,13,75,13,0,13,2021-01-01,zipcode,Lopeno
ZCTA5 78565,48,61,-666666666,-666666666,-666666666,61,51,61,61,0,0,0,0,129,52,77,52,42,10,2021-01-01,zipcode,Los ebanos
ZCTA5 78566,48,24551,46660,778,111200,16885,7103,13425,4224,3485,3383,1758,575,8032,6934,1098,6934,4989,1945,2021-01-01,zipcode,Los fresnos
ZCTA5 78567,48,318,31000,-666666666,44200,217,91,174,66,51,41,8,8,125,100,25,100,71,29,2021-01-01,zipcode,Los indios
ZCTA5 78569,48,4370,50434,532,88100,3693,1842,3085,935,1225,519,235,171,1504,1247,257,1247,1001,246,2021-01-01,zipcode,Lyford
ZCTA5 78570,48,33221,34651,565,69200,23684,10412,18558,7385,4500,4465,1379,829,10984,9137,1847,9137,6726,2411,2021-01-01,zipcode,Mercedes
ZCTA5 78572,48,76645,48288,814,95800,58064,27643,47718,13466,11956,11209,7501,3586,30704,24561,6143,24561,17820,6741,2021-01-01,zipcode,Mission
ZCTA5 78573,48,42523,42279,760,116600,29483,10983,22587,8627,5559,5198,2430,773,12565,11363,1202,11363,7861,3502,2021-01-01,zipcode,Mission
ZCTA5 78574,48,63660,39413,741,89000,43502,18352,33649,14991,7348,6234,3583,1493,17862,16238,1624,16238,12379,3859,2021-01-01,zipcode,Mission
ZCTA5 78575,48,5077,63866,965,157000,3928,1639,3205,652,596,721,776,460,1938,1665,273,1665,1125,540,2021-01-01,zipcode,Olmito
ZCTA5 78576,48,12748,31132,583,87900,7623,3819,5390,2371,1888,787,255,89,3399,3048,351,3048,2315,733,2021-01-01,zipcode,Penitas
ZCTA5 78577,48,79128,39490,830,85700,55072,22666,43927,13860,12092,10335,5659,1981,26553,23279,3274,23279,13534,9745,2021-01-01,zipcode,Pharr
ZCTA5 78578,48,10551,41838,653,147500,8208,4590,7456,1790,2532,1631,876,627,6405,4038,2367,4038,2775,1263,2021-01-01,zipcode,Port isabel
ZCTA5 78579,48,3176,-666666666,549,-666666666,2532,732,1938,876,443,327,109,183,1032,902,130,902,798,104,2021-01-01,zipcode,Progreso
ZCTA5 78580,48,13429,39800,769,60200,10181,4283,8258,2620,3179,1793,452,214,4063,3305,758,3305,1987,1318,2021-01-01,zipcode,Raymondville
ZCTA5 78582,48,44583,38495,608,89400,31368,12305,24214,9726,6418,5050,2302,718,14255,12139,2116,12139,9166,2973,2021-01-01,zipcode,Rio grande city
ZCTA5 78583,48,5952,44023,725,122100,4627,2552,4013,1069,1356,907,523,158,2926,2035,891,2035,1708,327,2021-01-01,zipcode,Rio hondo
ZCTA5 78584,48,18128,26684,587,69000,12857,6013,10356,4613,2706,1801,877,359,6535,5253,1282,5253,3575,1678,2021-01-01,zipcode,Roma
ZCTA5 78585,48,0,-666666666,-666666666,-666666666,0,0,0,0,0,0,0,0,0,0,0,0,0,0,2021-01-01,zipcode,Salineno
ZCTA5 78586,48,48726,38489,749,68100,35348,16580,27602,9737,7988,6470,2199,1208,16354,14410,1944,14410,11123,3287,2021-01-01,zipcode,San benito
ZCTA5 78588,48,121,37708,-666666666,19200,95,77,95,15,24,40,5,11,100,48,52,48,37,11,2021-01-01,zipcode,San isidro
ZCTA5 78589,48,39881,44246,811,92200,27945,10983,21977,8329,5853,4683,2445,667,12035,10970,1065,10970,8376,2594,2021-01-01,zipcode,San juan
ZCTA5 78590,48,622,31250,-666666666,41000,489,247,329,147,85,57,40,0,182,127,55,127,93,34,2021-01-01,zipcode,San perlita
ZCTA5 78591,48,274,57500,-666666666,-666666666,192,72,191,1,73,56,50,11,259,146,113,146,141,5,2021-01-01,zipcode,Santa elena
ZCTA5 78592,48,618,29850,631,33800,511,295,411,248,72,78,13,0,201,173,28,173,149,24,2021-01-01,zipcode,Santa maria
ZCTA5 78593,48,4857,36424,726,51000,3592,1599,2792,939,1016,646,121,70,1528,1407,121,1407,1012,395,2021-01-01,zipcode,Santa rosa
ZCTA5 78594,48,1446,22330,247,48500,1227,678,1005,328,354,257,60,6,607,516,91,516,395,121,2021-01-01,zipcode,Sebastian
ZCTA5 78595,48,7272,36940,519,70900,4834,1827,3796,1799,836,983,152,26,2212,1999,213,1999,1720,279,2021-01-01,zipcode,Sullivan city
ZCTA5 78596,48,36852,47597,785,79900,26879,12047,22002,5808,5264,6267,3287,1376,15318,11323,3995,11323,7413,3910,2021-01-01,zipcode,Weslaco
ZCTA5 78597,48,2138,60688,1313,411800,1991,651,1831,134,92,598,562,445,6165,1118,5047,1118,739,379,2021-01-01,zipcode,South padre island
ZCTA5 78598,48,132,-666666666,-666666666,176700,123,80,123,21,50,13,22,17,393,70,323,70,62,8,2021-01-01,zipcode,Port mansfield
ZCTA5 78602,48,32646,81101,1196,221700,26798,11305,22502,2973,7318,6283,4115,1813,12456,11077,1379,11077,8295,2782,2021-01-01,zipcode,Bastrop
ZCTA5 78605,48,6955,79265,1060,173000,5738,1931,4882,776,1543,1595,509,459,2765,2588,177,2588,2350,238,2021-01-01,zipcode,Bertram
ZCTA5 78606,48,6890,74599,773,303400,5562,2250,5118,562,1280,1809,1087,380,3311,2621,690,2621,2043,578,2021-01-01,zipcode,Blanco
ZCTA5 78607,48,186,57574,-666666666,336800,174,141,165,0,78,57,30,0,202,67,135,67,59,8,2021-01-01,zipcode,Bluffton
ZCTA5 78608,48,325,111087,-666666666,222700,295,133,261,18,103,104,20,16,213,114,99,114,114,0,2021-01-01,zipcode,Briggs
ZCTA5 78609,48,1966,61977,866,189000,1642,902,1568,64,527,591,199,187,1337,841,496,841,679,162,2021-01-01,zipcode,Buchanan dam
ZCTA5 78610,48,41681,89473,1404,284100,31839,9219,27408,2180,6568,7763,7701,3196,15375,14937,438,14937,11824,3113,2021-01-01,zipcode,Buda
ZCTA5 78611,48,12938,69747,974,214000,10432,4793,9242,699,3362,2950,1407,824,6813,4728,2085,4728,3801,927,2021-01-01,zipcode,Burnet
ZCTA5 78612,48,20508,77135,1195,195400,14042,5706,11397,2506,3334,2967,1651,939,6188,5655,533,5655,4761,894,2021-01-01,zipcode,Cedar creek
ZCTA5 78613,48,86066,108937,1487,339400,66648,18754,57449,1948,9034,16592,20243,9632,32983,32007,976,32007,21325,10682,2021-01-01,zipcode,Cedar park
ZCTA5 78614,48,426,48295,-666666666,262500,350,107,307,32,56,96,101,22,270,184,86,184,139,45,2021-01-01,zipcode,Cost
ZCTA5 78615,48,1674,65903,1029,213000,1097,381,943,119,387,258,104,75,560,523,37,523,386,137,2021-01-01,zipcode,Coupland
ZCTA5 78616,48,8551,64423,1036,158200,6222,2465,5043,1717,1401,1271,494,160,2847,2462,385,2462,1977,485,2021-01-01,zipcode,Dale
ZCTA5 78617,48,28690,68069,1253,189700,22189,7285,17807,5636,5871,3812,2007,481,8090,7662,428,7662,6315,1347,2021-01-01,zipcode,Del valle
ZCTA5 78618,48,264,76875,1021,328200,225,153,221,4,59,57,43,58,337,129,208,129,108,21,2021-01-01,zipcode,Doss
ZCTA5 78619,48,6274,153438,1311,572800,4732,1196,4406,140,661,1388,1333,884,2231,2159,72,2159,1952,207,2021-01-01,zipcode,Driftwood
ZCTA5 78620,48,18564,118145,1381,467300,14592,4462,12440,589,2222,3024,4488,2117,7037,6538,499,6538,5583,955,2021-01-01,zipcode,Dripping springs
ZCTA5 78621,48,24919,85262,1127,203700,18564,5686,16475,2562,5265,5085,2254,1309,9039,8103,936,8103,6628,1475,2021-01-01,zipcode,Elgin
ZCTA5 78622,48,326,-666666666,1344,88600,242,103,226,23,104,41,52,6,175,134,41,134,112,22,2021-01-01,zipcode,Fentress
ZCTA5 78623,48,1132,89500,-666666666,354500,1044,508,1023,0,253,408,174,188,656,564,92,564,518,46,2021-01-01,zipcode,Fischer
ZCTA5 78624,48,23084,65496,1082,329800,19035,7978,16876,1632,4455,4756,3955,2078,11994,9794,2200,9794,6828,2966,2021-01-01,zipcode,Fredericksburg
ZCTA5 78626,48,37235,84850,1393,265500,29025,8923,23184,2170,5965,6843,4910,3296,13291,12337,954,12337,7988,4349,2021-01-01,zipcode,Georgetown
ZCTA5 78628,48,39391,102782,1297,355200,30595,11076,27249,1232,4591,7568,8663,5195,14820,14334,486,14334,10992,3342,2021-01-01,zipcode,Georgetown
ZCTA5 78629,48,12011,56433,889,144900,8833,3675,7633,1655,3303,1494,853,328,5272,4518,754,4518,2865,1653,2021-01-01,zipcode,Gonzales
ZCTA5 78631,48,3020,62813,1317,233800,2241,923,2025,128,632,805,239,221,1433,1018,415,1018,854,164,2021-01-01,zipcode,Harper
ZCTA5 78632,48,1350,95845,-666666666,168200,1208,606,1040,63,396,473,42,66,643,559,84,559,500,59,2021-01-01,zipcode,Harwood
ZCTA5 78633,48,26507,86929,1622,353400,24316,16220,23318,540,3281,7001,7322,5174,13331,12911,420,12911,11904,1007,2021-01-01,zipcode,Georgetown
ZCTA5 78634,48,38529,93667,1717,237800,30004,7724,25670,1667,7175,8211,6308,2309,13651,13271,380,13271,10698,2573,2021-01-01,zipcode,Hutto
ZCTA5 78635,48,205,78750,-666666666,-666666666,205,53,99,0,45,54,0,0,149,104,45,104,54,50,2021-01-01,zipcode,Hye
ZCTA5 78636,48,3338,61938,939,288400,2947,1284,2679,249,864,816,627,123,2108,1613,495,1613,1137,476,2021-01-01,zipcode,Johnson city
ZCTA5 78638,48,1978,49886,1098,162200,1576,737,1383,108,516,458,202,99,929,769,160,769,708,61,2021-01-01,zipcode,Kingsbury
ZCTA5 78639,48,7999,53503,852,198300,6925,3549,6259,1238,1550,1830,1084,557,4847,3291,1556,3291,2526,765,2021-01-01,zipcode,Kingsland
ZCTA5 78640,48,63902,77550,1416,212300,47727,14435,39389,6014,11209,11906,6933,3327,21999,21074,925,21074,14976,6098,2021-01-01,zipcode,Kyle
ZCTA5 78641,48,81311,112267,1618,311600,60065,16380,52452,3396,8838,17304,15417,7497,28264,26921,1343,26921,21800,5121,2021-01-01,zipcode,Leander
ZCTA5 78642,48,18347,109939,1119,385600,13727,3658,11854,1194,2688,3118,3531,1323,6250,6010,240,6010,5048,962,2021-01-01,zipcode,Liberty hill
ZCTA5 78643,48,6584,64636,829,248700,5511,2381,4877,391,1453,1568,1066,399,3994,2714,1280,2714,2090,624,2021-01-01,zipcode,Llano
ZCTA5 78644,48,20119,67134,1059,184500,16083,7269,13847,2097,5749,3399,1777,825,7126,6381,745,6381,4530,1851,2021-01-01,zipcode,Lockhart
ZCTA5 78645,48,14360,90743,1014,312800,12322,5561,11619,504,2805,4042,2895,1373,7168,6099,1069,6099,5270,829,2021-01-01,zipcode,Leander
ZCTA5 78648,48,7803,52429,974,136900,6425,2706,5638,1240,2356,1408,434,200,3342,2980,362,2980,1907,1073,2021-01-01,zipcode,Luling
ZCTA5 78650,48,2539,56375,1014,222000,1817,672,1613,132,722,519,129,111,992,781,211,781,692,89,2021-01-01,zipcode,Mc dade
ZCTA5 78652,48,5014,127500,2023,355400,3942,1097,3678,253,810,772,1155,688,1724,1632,92,1632,1440,192,2021-01-01,zipcode,Manchaca
ZCTA5 78653,48,30955,86678,1606,221400,21065,5440,18329,3165,4940,5370,3514,1340,9427,8868,559,8868,7793,1075,2021-01-01,zipcode,Manor
ZCTA5 78654,48,18833,61386,1142,243800,15664,6918,13724,1891,3371,4130,2799,1533,9478,7242,2236,7242,5192,2050,2021-01-01,zipcode,Marble falls
ZCTA5 78655,48,3696,43333,1075,161200,3018,838,2558,668,673,814,283,120,1461,1336,125,1336,911,425,2021-01-01,zipcode,Martindale
ZCTA5 78656,48,2624,49564,949,80500,2142,611,1678,370,408,680,157,63,902,883,19,883,527,356,2021-01-01,zipcode,Maxwell
ZCTA5 78657,48,6810,79672,1288,329500,5988,3007,5583,433,1224,1565,1800,561,5251,3018,2233,3018,2616,402,2021-01-01,zipcode,Horseshoe bay
ZCTA5 78659,48,2855,70250,-666666666,221600,2373,840,2119,39,757,729,518,76,1416,1151,265,1151,1066,85,2021-01-01,zipcode,Paige
ZCTA5 78660,48,110569,98610,1518,276400,83683,19122,72411,5963,16459,21603,20019,8367,39226,37699,1527,37699,27468,10231,2021-01-01,zipcode,Pflugerville
ZCTA5 78661,48,336,-666666666,-666666666,98600,271,140,205,18,137,19,28,3,117,104,13,104,99,5,2021-01-01,zipcode,Prairie lea
ZCTA5 78662,48,2552,91090,878,192900,2122,732,1928,132,450,1135,152,59,1233,1074,159,1074,824,250,2021-01-01,zipcode,Red rock
ZCTA5 78663,48,696,97031,-666666666,255400,616,187,566,20,147,279,66,54,362,291,71,291,274,17,2021-01-01,zipcode,Round mountain
ZCTA5 78664,48,60152,80403,1371,240700,47884,11505,39539,3836,8978,13927,9020,3778,23207,22089,1118,22089,12166,9923,2021-01-01,zipcode,Round rock
ZCTA5 78665,48,59935,105407,1522,324000,44342,11414,38566,1397,6361,11911,12171,6726,22701,21317,1384,21317,14305,7012,2021-01-01,zipcode,Round rock
ZCTA5 78666,48,83858,44914,1159,202500,72849,25547,44789,5412,11815,13217,8838,5507,34573,31811,2762,31811,11253,20558,2021-01-01,zipcode,San marcos
ZCTA5 78669,48,10730,110573,873,460100,8531,3460,7928,258,1402,2014,2752,1502,5479,4097,1382,4097,3650,447,2021-01-01,zipcode,Spicewood
ZCTA5 78670,48,169,76000,1288,278800,124,47,117,12,20,44,39,2,68,64,4,64,43,21,2021-01-01,zipcode,Staples
ZCTA5 78671,48,703,-666666666,777,160800,679,281,573,191,138,107,111,26,400,334,66,334,213,121,2021-01-01,zipcode,Stonewall
ZCTA5 78672,48,825,49471,-666666666,169400,769,505,757,95,212,327,96,27,919,455,464,455,432,23,2021-01-01,zipcode,Tow
ZCTA5 78675,48,209,34167,-666666666,-666666666,199,65,196,66,57,18,39,16,135,92,43,92,78,14,2021-01-01,zipcode,Willow city
ZCTA5 78676,48,15241,74003,1173,359800,12835,5463,11439,872,1610,3780,3200,1977,7342,6473,869,6473,5181,1292,2021-01-01,zipcode,Wimberley
ZCTA5 78677,48,7,-666666666,-666666666,-666666666,7,7,7,0,7,0,0,0,0,0,0,0,0,0,2021-01-01,zipcode,Wrightsboro
ZCTA5 78681,48,57451,112020,1573,346200,43260,12307,36596,1662,4351,10847,12775,6961,20408,19661,747,19661,14626,5035,2021-01-01,zipcode,Round rock
ZCTA5 78701,48,9560,136486,2121,517300,9372,1985,8254,327,414,907,3559,3047,6955,6096,859,6096,2848,3248,2021-01-01,zipcode,Austin
ZCTA5 78702,48,24830,82176,1558,470900,21642,5935,19697,2274,2720,4133,6444,4126,12283,11093,1190,11093,4829,6264,2021-01-01,zipcode,Austin
ZCTA5 78703,48,22111,125448,1993,1023800,19113,4430,17670,174,652,1786,8352,6706,12411,10865,1546,10865,5428,5437,2021-01-01,zipcode,Austin
ZCTA5 78704,48,49854,82641,1532,632100,44734,8213,38003,2312,3509,6645,16399,9138,29084,26619,2465,26619,8358,18261,2021-01-01,zipcode,Austin
ZCTA5 78705,48,32506,23750,1435,432300,32031,16552,6729,359,670,1076,2866,1758,10796,8910,1886,8910,812,8098,2021-01-01,zipcode,Austin
ZCTA5 78712,48,206,-666666666,-666666666,-666666666,206,168,29,0,0,20,0,9,0,0,0,0,0,0,2021-01-01,zipcode,Austin
ZCTA5 78717,48,34087,120027,1486,425500,25065,6153,22224,645,2195,5072,8087,6225,13188,12736,452,12736,7268,5468,2021-01-01,zipcode,Austin
ZCTA5 78719,48,1856,49671,859,117500,1601,537,1338,497,465,264,77,35,658,588,70,588,505,83,2021-01-01,zipcode,Austin
ZCTA5 78721,48,10728,61462,1405,348100,8836,2632,7580,1557,1415,1283,2382,943,4467,4130,337,4130,2213,1917,2021-01-01,zipcode,Austin
ZCTA5 78722,48,5938,85137,1470,488900,5359,999,4948,188,416,784,2295,1265,3256,3048,208,3048,1461,1587,2021-01-01,zipcode,Austin
ZCTA5 78723,48,36114,76535,1270,387400,28487,7127,26089,3410,4071,5355,7669,5584,15711,14496,1215,14496,7060,7436,2021-01-01,zipcode,Austin
ZCTA5 78724,48,25936,58631,1325,162000,18348,5605,15247,4500,4421,3256,1992,1078,7872,7611,261,7611,5099,2512,2021-01-01,zipcode,Austin
ZCTA5 78725,48,9082,78420,1898,208800,7247,1892,6843,1250,1413,1897,1248,1035,3555,3503,52,3503,3074,429,2021-01-01,zipcode,Austin
ZCTA5 78726,48,13414,84105,1460,497400,11002,2973,9548,64,740,2407,3805,2532,6070,5769,301,5769,2582,3187,2021-01-01,zipcode,Austin
ZCTA5 78727,48,29991,91375,1584,340900,24953,6128,23104,1257,2605,5102,8144,5996,14207,13304,903,13304,6071,7233,2021-01-01,zipcode,Austin
ZCTA5 78728,48,25359,64054,1267,304600,20989,4190,18978,986,3834,5569,5885,2704,13524,12665,859,12665,3567,9098,2021-01-01,zipcode,Austin
ZCTA5 78729,48,30907,76615,1392,334600,25667,5684,22736,539,2640,6110,8596,4851,15695,14329,1366,14329,6085,8244,2021-01-01,zipcode,Austin
ZCTA5 78730,48,9455,122243,1412,805400,7623,2300,6874,123,480,1043,2815,2413,4314,3997,317,3997,2518,1479,2021-01-01,zipcode,Austin
ZCTA5 78731,48,26506,92641,1396,674600,22308,7382,19922,207,795,2814,8047,8059,14029,13148,881,13148,7085,6063,2021-01-01,zipcode,Austin
ZCTA5 78732,48,19653,180518,1482,570500,14973,4492,12034,87,487,2263,5125,4072,7276,7102,174,7102,5200,1902,2021-01-01,zipcode,Austin
ZCTA5 78733,48,9500,187778,2132,719100,6769,2332,6068,26,315,997,2342,2388,3211,3076,135,3076,2767,309,2021-01-01,zipcode,Austin
ZCTA5 78734,48,21625,116955,1828,467100,17737,6804,16360,683,1722,4133,6527,3295,10182,9164,1018,9164,7436,1728,2021-01-01,zipcode,Austin
ZCTA5 78735,48,19152,105132,1726,632800,15268,4034,13713,699,947,2425,5536,4106,9463,8644,819,8644,4213,4431,2021-01-01,zipcode,Austin
ZCTA5 78736,48,9481,92976,1664,394600,7983,2527,6971,133,1194,2041,2589,1014,3885,3854,31,3854,2672,1182,2021-01-01,zipcode,Austin
ZCTA5 78737,48,24783,139869,1829,515300,16784,5399,15177,305,1745,3852,5723,3552,7755,7610,145,7610,6794,816,2021-01-01,zipcode,Austin
ZCTA5 78738,48,26806,143639,1759,595500,20289,7594,18877,367,1212,3303,8650,5345,11137,10467,670,10467,8112,2355,2021-01-01,zipcode,Austin
ZCTA5 78739,48,19898,178614,2818,538600,14388,4388,13052,166,480,1910,5414,5082,6749,6574,175,6574,6092,482,2021-01-01,zipcode,Austin
ZCTA5 78741,48,46147,54422,1240,271000,39996,7564,31036,5379,5686,6412,10205,3354,23065,21432,1633,21432,3946,17486,2021-01-01,zipcode,Austin
ZCTA5 78742,48,1099,63750,1091,-666666666,735,231,588,189,166,167,41,25,325,307,18,307,202,105,2021-01-01,zipcode,Austin
ZCTA5 78744,48,48524,65262,1320,213600,36931,8095,30926,7685,8006,7265,6042,1928,17791,17126,665,17126,8545,8581,2021-01-01,zipcode,Austin
ZCTA5 78745,48,62277,72439,1435,339100,53204,13072,48544,3881,8798,12524,16368,6973,29985,28447,1538,28447,13477,14970,2021-01-01,zipcode,Austin
ZCTA5 78746,48,28017,166415,1774,1016800,22184,8151,19331,245,880,2150,8596,7460,11474,10661,813,10661,7252,3409,2021-01-01,zipcode,Austin
ZCTA5 78747,48,20698,86862,1698,257200,16574,4144,14273,1781,3238,4038,3634,1582,7348,7143,205,7143,5736,1407,2021-01-01,zipcode,Austin
ZCTA5 78748,48,53501,89480,1558,325200,43221,9841,39061,2055,5970,10678,14537,5821,23587,22407,1180,22407,12506,9901,2021-01-01,zipcode,Austin
ZCTA5 78749,48,35933,112813,1599,394500,29212,8023,26962,910,2493,5145,10346,8068,16101,15372,729,15372,9818,5554,2021-01-01,zipcode,Austin
ZCTA5 78750,48,29559,108686,1612,440800,23686,6042,21322,858,2315,4864,8434,4851,12059,11634,425,11634,7262,4372,2021-01-01,zipcode,Austin
ZCTA5 78751,48,15856,67552,1458,525000,14809,2288,12307,127,985,2028,5206,3961,9520,8550,970,8550,1944,6606,2021-01-01,zipcode,Austin
ZCTA5 78752,48,21178,51630,1230,275200,17915,4026,15192,2331,3049,3911,4020,1881,10236,9755,481,9755,2020,7735,2021-01-01,zipcode,Austin
ZCTA5 78753,48,58805,55132,1221,242800,45949,12263,39017,8601,9662,9190,8096,3468,23590,22306,1284,22306,7786,14520,2021-01-01,zipcode,Austin
ZCTA5 78754,48,29690,83043,1382,247000,22468,5345,19883,2558,3985,4995,5063,3282,11415,10990,425,10990,6829,4161,2021-01-01,zipcode,Austin
ZCTA5 78756,48,9314,87985,1185,599500,8318,2066,7060,137,594,1478,2774,2077,4638,4389,249,4389,1948,2441,2021-01-01,zipcode,Austin
ZCTA5 78757,48,25547,87434,1346,481100,20203,5399,18788,1299,2821,3200,6907,4561,11606,11082,524,11082,6594,4488,2021-01-01,zipcode,Austin
ZCTA5 78758,48,50717,63283,1340,295700,40623,9102,35219,5411,7043,7517,9994,5254,24715,22641,2074,22641,5939,16702,2021-01-01,zipcode,Austin
ZCTA5 78759,48,44978,90246,1394,485800,37866,9711,33894,866,2950,6693,13480,9905,22796,21605,1191,21605,10142,11463,2021-01-01,zipcode,Austin
ZCTA5 78801,48,21435,51414,886,99200,16355,6926,13141,3499,3795,3504,1814,529,8265,7092,1173,7092,4981,2111,2021-01-01,zipcode,Uvalde
ZCTA5 78802,48,0,-666666666,-666666666,-666666666,0,0,0,0,0,0,0,0,0,0,0,0,0,0,2021-01-01,zipcode,Uvalde
ZCTA5 78827,48,919,25167,505,78300,710,335,646,227,206,159,28,26,503,382,121,382,278,104,2021-01-01,zipcode,Asherton
ZCTA5 78828,48,97,78049,-666666666,-666666666,97,73,97,0,11,65,10,11,188,64,124,64,64,0,2021-01-01,zipcode,Barksdale
ZCTA5 78829,48,1090,-666666666,1081,37800,735,287,516,146,231,89,50,0,416,272,144,272,187,85,2021-01-01,zipcode,Batesville
ZCTA5 78830,48,521,26761,631,44400,434,251,385,157,99,94,21,14,331,197,134,197,163,34,2021-01-01,zipcode,Big wells
ZCTA5 78832,48,3199,58925,693,98800,2708,1541,2451,367,630,1045,218,191,1495,1039,456,1039,774,265,2021-01-01,zipcode,Brackettville
ZCTA5 78833,48,1346,31875,798,67200,1156,833,978,128,509,285,23,33,597,367,230,367,204,163,2021-01-01,zipcode,Camp wood
ZCTA5 78834,48,7316,23979,647,55200,5376,3240,4411,1295,1477,1009,385,245,3062,2293,769,2293,1373,920,2021-01-01,zipcode,Carrizo springs
ZCTA5 78836,48,84,61591,-666666666,-666666666,77,48,77,55,11,11,0,0,49,30,19,30,19,11,2021-01-01,zipcode,Catarina
ZCTA5 78837,48,159,-666666666,-666666666,-666666666,154,80,146,70,18,13,19,26,171,88,83,88,88,0,2021-01-01,zipcode,Comstock
ZCTA5 78838,48,91,-666666666,-666666666,365600,91,71,91,2,39,13,32,5,244,60,184,60,60,0,2021-01-01,zipcode,Concan
ZCTA5 78839,48,7796,48833,630,65800,6045,2521,4878,1107,1529,1483,453,306,3176,2830,346,2830,2018,812,2021-01-01,zipcode,Crystal city
ZCTA5 78840,48,46970,52296,827,114200,34804,13621,28502,8317,7315,7299,3394,2177,18141,15985,2156,15985,10402,5583,2021-01-01,zipcode,Del rio
ZCTA5 78843,48,527,-666666666,-666666666,-666666666,527,0,83,0,0,69,14,0,15,15,0,15,0,15,2021-01-01,zipcode,Laughlin afb
ZCTA5 78850,48,1181,78169,768,-666666666,907,496,636,94,87,304,81,70,441,287,154,287,243,44,2021-01-01,zipcode,D hanis
ZCTA5 78851,48,45,-666666666,-666666666,-666666666,45,38,45,0,0,0,45,0,51,45,6,45,45,0,2021-01-01,zipcode,Dryden
ZCTA5 78852,48,56746,45029,715,106600,40874,17485,32143,11452,8543,6920,4067,1161,19332,17349,1983,17349,11481,5868,2021-01-01,zipcode,Eagle pass
ZCTA5 78860,48,0,-666666666,-666666666,-666666666,0,0,0,0,0,0,0,0,107,0,107,0,0,0,2021-01-01,zipcode,El indio
ZCTA5 78861,48,13272,54852,1011,148500,10948,5600,9214,1325,3324,2964,987,614,5081,4448,633,4448,3264,1184,2021-01-01,zipcode,Hondo
ZCTA5 78870,48,968,65147,-666666666,150000,730,202,570,80,164,178,115,33,333,280,53,280,218,62,2021-01-01,zipcode,Knippa
ZCTA5 78871,48,25,-666666666,-666666666,-666666666,14,0,14,0,0,9,5,0,36,9,27,9,9,0,2021-01-01,zipcode,Langtry
ZCTA5 78872,48,1014,33636,-666666666,51900,705,354,489,184,84,161,24,36,400,292,108,292,199,93,2021-01-01,zipcode,La pryor
ZCTA5 78873,48,1324,57750,725,232500,1006,510,872,110,231,342,122,67,984,470,514,470,426,44,2021-01-01,zipcode,Leakey
ZCTA5 78877,48,1023,42150,-666666666,-666666666,845,427,845,571,141,84,25,24,412,341,71,341,293,48,2021-01-01,zipcode,Quemado
ZCTA5 78879,48,271,65403,-666666666,-666666666,226,133,163,0,0,99,64,0,244,70,174,70,50,20,2021-01-01,zipcode,Rio frio
ZCTA5 78880,48,1159,35550,623,71300,938,371,709,173,174,211,112,39,917,475,442,475,369,106,2021-01-01,zipcode,Rocksprings
ZCTA5 78881,48,1549,31731,585,68200,1205,588,1019,225,430,197,101,66,830,592,238,592,448,144,2021-01-01,zipcode,Sabinal
ZCTA5 78883,48,308,68850,-666666666,275000,283,181,232,0,29,80,86,37,281,135,146,135,121,14,2021-01-01,zipcode,Tarpley
ZCTA5 78884,48,1233,70750,793,168500,931,373,874,96,235,339,131,73,758,461,297,461,367,94,2021-01-01,zipcode,Utopia
ZCTA5 78885,48,101,86667,-666666666,322200,101,55,77,0,19,36,7,15,137,38,99,38,34,4,2021-01-01,zipcode,Vanderpool
ZCTA5 78886,48,534,144583,-666666666,-666666666,461,197,300,50,117,107,16,10,221,138,83,138,138,0,2021-01-01,zipcode,Yancey
ZCTA5 78931,48,184,-666666666,-666666666,-666666666,159,84,146,8,49,57,32,0,153,83,70,83,83,0,2021-01-01,zipcode,Bleiblerville
ZCTA5 78932,48,529,82188,850,169600,452,235,401,48,70,117,152,14,389,181,208,181,165,16,2021-01-01,zipcode,Carmine
ZCTA5 78933,48,1357,63984,-666666666,156900,1077,492,1070,182,316,259,178,135,720,597,123,597,460,137,2021-01-01,zipcode,Cat spring
ZCTA5 78934,48,6626,61573,832,178900,5203,2193,4707,637,1573,1362,844,291,3396,2234,1162,2234,1848,386,2021-01-01,zipcode,Columbus
ZCTA5 78935,48,753,-666666666,-666666666,-666666666,693,321,659,6,189,221,160,83,516,388,128,388,388,0,2021-01-01,zipcode,Alleyton
ZCTA5 78938,48,193,58942,-666666666,216700,171,67,171,9,83,47,19,13,129,88,41,88,74,14,2021-01-01,zipcode,Ellinger
ZCTA5 78940,48,2164,71985,743,200300,1876,827,1767,83,744,560,285,95,1335,821,514,821,755,66,2021-01-01,zipcode,Fayetteville
ZCTA5 78941,48,3076,67083,822,202500,2519,1198,2199,247,1048,531,297,76,1611,1073,538,1073,895,178,2021-01-01,zipcode,Flatonia
ZCTA5 78942,48,9627,59232,978,168700,7729,2956,6723,1018,2827,1920,793,165,4130,3245,885,3245,2366,879,2021-01-01,zipcode,Giddings
ZCTA5 78943,48,415,-666666666,-666666666,22700,415,137,415,226,27,162,0,0,191,191,0,191,118,73,2021-01-01,zipcode,Glidden
ZCTA5 78944,48,751,110938,-666666666,364300,635,290,584,60,146,183,171,24,362,295,67,295,295,0,2021-01-01,zipcode,Industry
ZCTA5 78945,48,10570,60966,755,222200,8767,3944,7951,1022,3171,1902,1346,510,5467,4019,1448,4019,3310,709,2021-01-01,zipcode,La grange
ZCTA5 78946,48,955,46821,1094,176100,866,405,739,85,259,320,70,5,578,381,197,381,303,78,2021-01-01,zipcode,Ledbetter
ZCTA5 78947,48,4589,70438,938,224700,3606,1536,3137,110,1324,1222,267,214,2111,1683,428,1683,1482,201,2021-01-01,zipcode,Lexington
ZCTA5 78948,48,735,-666666666,-666666666,269800,537,211,523,125,218,127,36,17,386,262,124,262,186,76,2021-01-01,zipcode,Lincoln
ZCTA5 78949,48,604,79329,-666666666,176600,594,450,401,54,79,128,124,16,391,184,207,184,177,7,2021-01-01,zipcode,Muldoon
ZCTA5 78950,48,2166,79531,1047,245800,1794,609,1648,147,703,356,393,49,1276,871,405,871,790,81,2021-01-01,zipcode,New ulm
ZCTA5 78951,48,0,-666666666,-666666666,-666666666,0,0,0,0,0,0,0,0,0,0,0,0,0,0,2021-01-01,zipcode,Oakland
ZCTA5 78953,48,930,79684,1313,-666666666,898,342,831,75,279,299,117,61,572,508,64,508,322,186,2021-01-01,zipcode,Rosanky
ZCTA5 78954,48,1245,89457,1679,297800,1077,517,1010,38,379,272,192,129,952,506,446,506,474,32,2021-01-01,zipcode,Round top
ZCTA5 78956,48,5436,64602,1039,189000,4171,1644,3660,491,1282,1147,512,228,2730,1784,946,1784,1304,480,2021-01-01,zipcode,Schulenburg
ZCTA5 78957,48,9685,64063,1009,210500,7642,2670,6918,630,2056,2567,1250,415,4682,3747,935,3747,2896,851,2021-01-01,zipcode,Smithville
ZCTA5 78959,48,1584,47400,541,86400,1407,666,1183,349,482,253,31,68,913,674,239,674,541,133,2021-01-01,zipcode,Waelder
ZCTA5 78962,48,4801,65752,637,204900,4006,1518,3398,451,1213,902,603,229,2412,1756,656,1756,1444,312,2021-01-01,zipcode,Weimar
ZCTA5 78963,48,750,66250,-666666666,224300,582,247,495,8,242,133,95,17,280,215,65,215,209,6,2021-01-01,zipcode,West point
ZCTA5 79001,48,162,77500,-666666666,111100,123,53,117,11,42,32,27,5,104,54,50,54,38,16,2021-01-01,zipcode,Adrian
ZCTA5 79003,48,241,82321,-666666666,72200,219,112,181,46,58,42,25,10,107,75,32,75,44,31,2021-01-01,zipcode,Allison
ZCTA5 79005,48,1671,62667,782,118900,1203,341,960,177,300,268,167,48,721,604,117,604,464,140,2021-01-01,zipcode,Booker
ZCTA5 79007,48,13915,52500,799,83100,10620,3992,8799,1387,2911,2910,1168,423,6558,4520,2038,4520,3536,984,2021-01-01,zipcode,Borger
ZCTA5 79009,48,1825,38881,755,100300,1455,555,1156,399,310,298,109,40,659,562,97,562,358,204,2021-01-01,zipcode,Bovina
ZCTA5 79010,48,693,93750,-666666666,-666666666,243,147,111,0,5,9,84,13,84,61,23,61,18,43,2021-01-01,zipcode,Boys ranch
ZCTA5 79011,48,200,64167,840,157500,160,48,145,10,61,33,27,14,150,88,62,88,61,27,2021-01-01,zipcode,Briscoe
ZCTA5 79012,48,0,-666666666,-666666666,-666666666,0,0,0,0,0,0,0,0,0,0,0,0,0,0,2021-01-01,zipcode,Bushland
ZCTA5 79013,48,3043,39493,625,52500,2223,632,1749,1301,315,118,0,15,1104,981,123,981,399,582,2021-01-01,zipcode,Cactus
ZCTA5 79014,48,3285,54707,866,192300,2479,828,2176,325,813,595,372,71,1625,1337,288,1337,975,362,2021-01-01,zipcode,Canadian
ZCTA5 79015,48,22493,76896,857,226100,17972,5926,13435,399,2931,4548,3508,2049,8905,7923,982,7923,5611,2312,2021-01-01,zipcode,Canyon
ZCTA5 79016,48,359,-666666666,-666666666,-666666666,359,237,0,0,0,0,0,0,0,0,0,0,0,0,2021-01-01,zipcode,Canyon
ZCTA5 79018,48,361,47917,696,87800,287,124,271,15,58,103,67,28,201,136,65,136,71,65,2021-01-01,zipcode,Channing
ZCTA5 79019,48,1914,70000,917,153700,1463,611,1256,102,352,480,213,109,802,680,122,680,579,101,2021-01-01,zipcode,Claude
ZCTA5 79021,48,102,56250,958,75000,75,31,58,14,6,22,10,6,45,32,13,32,7,25,2021-01-01,zipcode,Cotton center
ZCTA5 79022,48,11076,62863,986,121200,8154,3062,7331,1594,2473,1878,967,419,4082,3415,667,3415,2452,963,2021-01-01,zipcode,Dalhart
ZCTA5 79024,48,338,61875,713,101100,274,87,227,27,90,53,37,20,172,135,37,135,91,44,2021-01-01,zipcode,Darrouzett
ZCTA5 79025,48,12,-666666666,-666666666,-666666666,12,4,12,4,8,0,0,0,13,4,9,4,4,0,2021-01-01,zipcode,Dawn
ZCTA5 79027,48,4667,55872,745,88100,3572,1094,2903,630,964,600,535,174,1934,1534,400,1534,860,674,2021-01-01,zipcode,Dimmitt
ZCTA5 79029,48,15875,58845,898,128500,11083,3756,9091,2305,3092,2405,922,367,5801,4942,859,4942,3309,1633,2021-01-01,zipcode,Dumas
ZCTA5 79031,48,1217,41176,696,80700,943,450,832,230,297,187,100,18,624,460,164,460,345,115,2021-01-01,zipcode,Earth
ZCTA5 79032,48,112,45357,-666666666,85000,79,26,66,19,19,25,3,0,59,44,15,44,28,16,2021-01-01,zipcode,Edmonson
ZCTA5 79033,48,25,-666666666,-666666666,-666666666,25,10,25,0,0,15,10,0,22,22,0,22,7,15,2021-01-01,zipcode,Farnsworth
ZCTA5 79034,48,478,70208,688,106300,361,127,328,33,52,145,80,18,286,181,105,181,135,46,2021-01-01,zipcode,Follett
ZCTA5 79035,48,5434,75000,847,106600,4290,1288,3699,940,872,1144,507,236,2100,1906,194,1906,1330,576,2021-01-01,zipcode,Friona
ZCTA5 79036,48,5035,64730,783,96000,4161,1665,3858,377,1398,1572,435,76,2483,1781,702,1781,1669,112,2021-01-01,zipcode,Fritch
ZCTA5 79039,48,762,49712,929,117900,561,218,534,72,185,182,71,24,389,308,81,308,249,59,2021-01-01,zipcode,Groom
ZCTA5 79040,48,2232,55938,877,118200,1675,652,1351,473,312,204,306,56,809,642,167,642,488,154,2021-01-01,zipcode,Gruver
ZCTA5 79041,48,2821,42128,617,86800,2350,1197,1946,571,627,515,180,53,1325,1102,223,1102,843,259,2021-01-01,zipcode,Hale center
ZCTA5 79042,48,1203,49342,794,88500,816,266,676,35,184,239,190,28,634,440,194,440,336,104,2021-01-01,zipcode,Happy
ZCTA5 79043,48,1650,44554,723,53600,1097,420,922,317,303,219,70,13,598,500,98,500,270,230,2021-01-01,zipcode,Hart
ZCTA5 79044,48,514,44676,1172,159400,420,204,334,82,125,60,14,53,327,259,68,259,134,125,2021-01-01,zipcode,Hartley
ZCTA5 79045,48,18634,50072,759,90300,13278,4328,10863,2901,4263,2457,883,359,6963,6031,932,6031,3951,2080,2021-01-01,zipcode,Hereford
ZCTA5 79046,48,692,95500,1579,108100,473,217,408,30,122,138,85,33,307,222,85,222,181,41,2021-01-01,zipcode,Higgins
ZCTA5 79051,48,0,-666666666,-666666666,-666666666,0,0,0,0,0,0,0,0,0,0,0,0,0,0,2021-01-01,zipcode,Kerrick
ZCTA5 79052,48,1334,44921,769,88600,1031,369,909,199,351,220,113,26,634,498,136,498,397,101,2021-01-01,zipcode,Kress
ZCTA5 79053,48,27,36719,-666666666,81700,16,8,13,0,7,6,0,0,29,11,18,11,11,0,2021-01-01,zipcode,Lazbuddie
ZCTA5 79054,48,605,48500,819,40200,428,207,374,32,131,138,64,9,262,190,72,190,143,47,2021-01-01,zipcode,Lefors
ZCTA5 79056,48,74,67875,-666666666,79500,55,36,52,1,7,15,24,5,46,37,9,37,37,0,2021-01-01,zipcode,Lipscomb
ZCTA5 79057,48,1316,61087,833,49200,979,389,828,98,310,275,113,32,691,480,211,480,332,148,2021-01-01,zipcode,Mclean
ZCTA5 79058,48,0,-666666666,-666666666,-666666666,0,0,0,0,0,0,0,0,29,0,29,0,0,0,2021-01-01,zipcode,Masterson
ZCTA5 79059,48,562,56786,517,95800,482,180,428,36,161,146,63,22,340,264,76,264,236,28,2021-01-01,zipcode,Miami
ZCTA5 79061,48,281,68125,542,83200,200,75,194,17,76,87,11,3,137,101,36,101,95,6,2021-01-01,zipcode,Mobeetie
ZCTA5 79062,48,348,57917,663,68800,250,68,162,9,63,33,42,15,132,97,35,97,80,17,2021-01-01,zipcode,Morse
ZCTA5 79063,48,692,76667,558,183000,551,231,490,14,156,191,103,26,270,248,22,248,214,34,2021-01-01,zipcode,Nazareth
ZCTA5 79064,48,2442,57583,652,71700,1793,837,1526,418,541,401,129,37,992,788,204,788,564,224,2021-01-01,zipcode,Olton
ZCTA5 79065,48,19538,50077,785,86000,15258,6319,12982,2556,4223,4267,1435,501,9087,7219,1868,7219,5268,1951,2021-01-01,zipcode,Pampa
ZCTA5 79068,48,3253,80598,905,117100,2665,824,2261,112,689,760,482,218,1456,1261,195,1261,984,277,2021-01-01,zipcode,Panhandle
ZCTA5 79070,48,9812,57081,895,106400,7212,2278,5831,1364,1972,1411,717,367,4129,3489,640,3489,2546,943,2021-01-01,zipcode,Perryton
ZCTA5 79072,48,25831,48699,709,82700,19374,7649,15523,4009,4978,4036,1566,934,10207,8396,1811,8396,4955,3441,2021-01-01,zipcode,Plainview
ZCTA5 79078,48,126,16759,-666666666,44400,79,64,77,8,46,23,0,0,138,50,88,50,46,4,2021-01-01,zipcode,Sanford
ZCTA5 79079,48,2509,43977,841,67000,2035,709,1652,348,544,489,228,43,1441,1011,430,1011,717,294,2021-01-01,zipcode,Shamrock
ZCTA5 79080,48,396,42232,-666666666,34100,317,194,279,37,109,106,24,3,333,159,174,159,152,7,2021-01-01,zipcode,Skellytown
ZCTA5 79081,48,3276,45188,738,106100,2404,922,2027,522,604,486,343,72,1576,1166,410,1166,853,313,2021-01-01,zipcode,Spearman
ZCTA5 79082,48,184,40000,-666666666,45000,150,77,136,47,21,41,22,5,167,82,85,82,75,7,2021-01-01,zipcode,Springlake
ZCTA5 79083,48,2118,52287,734,81600,1612,841,1277,133,339,566,187,52,1176,714,462,714,576,138,2021-01-01,zipcode,Stinnett
ZCTA5 79084,48,1441,45429,695,95000,1111,388,971,236,188,351,129,67,715,530,185,530,424,106,2021-01-01,zipcode,Stratford
ZCTA5 79085,48,0,-666666666,-666666666,-666666666,0,0,0,0,0,0,0,0,14,0,14,0,0,0,2021-01-01,zipcode,Summerfield
ZCTA5 79086,48,3023,62656,906,97300,2365,935,1998,596,553,435,318,96,1400,1105,295,1105,840,265,2021-01-01,zipcode,Sunray
ZCTA5 79087,48,732,58553,820,102800,597,244,539,169,151,111,91,17,366,286,80,286,196,90,2021-01-01,zipcode,Texline
ZCTA5 79088,48,5213,37921,653,79600,4188,2250,3509,1040,1176,720,456,117,2125,1793,332,1793,1213,580,2021-01-01,zipcode,Tulia
ZCTA5 79091,48,72,-666666666,-666666666,-666666666,32,0,32,17,0,15,0,0,38,17,21,17,17,0,2021-01-01,zipcode,Umbarger
ZCTA5 79092,48,1339,70417,900,115600,1130,396,991,138,329,351,121,52,544,481,63,481,415,66,2021-01-01,zipcode,Vega
ZCTA5 79093,48,114,-666666666,-666666666,-666666666,71,38,71,43,17,0,3,8,85,39,46,39,39,0,2021-01-01,zipcode,Waka
ZCTA5 79094,48,12,-666666666,-666666666,-666666666,12,4,12,0,0,8,4,0,26,8,18,8,8,0,2021-01-01,zipcode,Wayside
ZCTA5 79095,48,2710,41884,534,67200,2072,702,1697,405,419,487,306,80,1303,976,327,976,737,239,2021-01-01,zipcode,Wellington
ZCTA5 79096,48,1988,62256,845,123200,1486,570,1326,220,418,416,222,50,905,714,191,714,533,181,2021-01-01,zipcode,Wheeler
ZCTA5 79097,48,1072,106705,-666666666,116600,820,270,693,61,231,271,83,47,494,413,81,413,378,35,2021-01-01,zipcode,White deer
ZCTA5 79098,48,389,35905,1106,132900,363,229,328,26,189,69,28,16,218,177,41,177,150,27,2021-01-01,zipcode,Wildorado
ZCTA5 79101,48,2335,32135,786,77000,2211,1404,1902,257,779,432,322,112,1462,1195,267,1195,70,1125,2021-01-01,zipcode,Amarillo
ZCTA5 79102,48,9898,47020,855,122700,7475,2922,6181,1327,1871,1837,906,240,4557,4206,351,4206,2107,2099,2021-01-01,zipcode,Amarillo
ZCTA5 79103,48,10758,49381,968,99400,7664,2490,6298,1403,1877,2231,596,191,3873,3731,142,3731,2543,1188,2021-01-01,zipcode,Amarillo
ZCTA5 79104,48,6705,52500,826,65700,4816,1662,4371,1090,1870,1151,221,39,2669,2288,381,2288,1229,1059,2021-01-01,zipcode,Amarillo
ZCTA5 79106,48,27668,46250,875,135300,21122,7594,17558,2554,4867,5852,2618,1667,13298,11800,1498,11800,5727,6073,2021-01-01,zipcode,Amarillo
ZCTA5 79107,48,39829,35468,896,71600,29274,15208,24263,9501,8381,4875,1233,273,12585,10960,1625,10960,6208,4752,2021-01-01,zipcode,Amarillo
ZCTA5 79108,48,10549,55827,1017,120100,8590,3509,7294,1162,2649,2492,846,145,4990,4350,640,4350,3337,1013,2021-01-01,zipcode,Amarillo
ZCTA5 79109,48,43167,61570,862,173000,34182,11020,29628,2272,6795,11314,6409,2838,20580,18539,2041,18539,10912,7627,2021-01-01,zipcode,Amarillo
ZCTA5 79110,48,19235,58101,1111,117400,14305,4410,11457,931,3760,5044,1284,438,7668,6949,719,6949,4641,2308,2021-01-01,zipcode,Amarillo
ZCTA5 79111,48,2046,60660,1132,-666666666,1413,712,1157,157,409,540,44,7,517,457,60,457,11,446,2021-01-01,zipcode,Amarillo
ZCTA5 79118,48,25963,78465,1131,183900,20328,6348,17654,1674,4570,7221,3060,1129,10774,9883,891,9883,8029,1854,2021-01-01,zipcode,Amarillo
ZCTA5 79119,48,20387,82032,1086,262300,15893,4329,14164,213,2624,4675,4406,2246,9110,8402,708,8402,5352,3050,2021-01-01,zipcode,Amarillo
ZCTA5 79121,48,5388,69750,895,208500,4642,1851,4291,143,546,1630,1144,828,2857,2511,346,2511,1853,658,2021-01-01,zipcode,Amarillo
ZCTA5 79124,48,10847,94188,1014,276000,8421,3126,7502,441,1445,2953,1677,986,4476,4189,287,4189,3666,523,2021-01-01,zipcode,Amarillo
ZCTA5 79201,48,6817,53213,780,99300,5761,2599,5017,856,1834,1407,711,209,2847,2091,756,2091,1280,811,2021-01-01,zipcode,Childress
ZCTA5 79220,48,184,42283,-666666666,102600,150,47,128,37,41,27,12,11,114,62,52,62,38,24,2021-01-01,zipcode,Afton
ZCTA5 79225,48,880,63958,727,62500,682,214,522,144,119,132,79,48,445,283,162,283,219,64,2021-01-01,zipcode,Chillicothe
ZCTA5 79226,48,2677,49338,700,67700,2141,1024,1618,245,538,590,172,73,1622,968,654,968,670,298,2021-01-01,zipcode,Clarendon
ZCTA5 79227,48,1131,37898,533,51800,970,420,858,205,206,305,107,35,765,495,270,495,371,124,2021-01-01,zipcode,Crowell
ZCTA5 79229,48,281,39625,-666666666,41500,236,130,222,41,66,93,22,0,226,123,103,123,117,6,2021-01-01,zipcode,Dickens
ZCTA5 79230,48,151,37143,-666666666,-666666666,111,53,109,57,15,3,24,10,57,36,21,36,34,2,2021-01-01,zipcode,Dodson
ZCTA5 79231,48,0,-666666666,-666666666,-666666666,0,0,0,0,0,0,0,0,0,0,0,0,0,0,2021-01-01,zipcode,Dougherty
ZCTA5 79233,48,98,21000,-666666666,-666666666,70,22,59,11,18,25,5,0,89,40,49,40,19,21,2021-01-01,zipcode,Estelline
ZCTA5 79234,48,80,71167,-666666666,225000,66,5,66,0,4,37,25,0,39,30,9,30,19,11,2021-01-01,zipcode,Flomot
ZCTA5 79235,48,3257,49926,680,73300,2285,924,2021,600,478,659,196,88,1647,1151,496,1151,801,350,2021-01-01,zipcode,Floydada
ZCTA5 79236,48,200,41875,-666666666,22800,156,65,154,31,57,25,35,6,121,75,46,75,27,48,2021-01-01,zipcode,Guthrie
ZCTA5 79237,48,463,73250,638,80500,412,133,393,44,105,190,36,18,323,204,119,204,179,25,2021-01-01,zipcode,Hedley
ZCTA5 79239,48,124,28359,-666666666,86200,114,72,114,14,57,14,23,6,148,63,85,63,57,6,2021-01-01,zipcode,Lakeview
ZCTA5 79240,48,131,103333,-666666666,91700,98,33,87,0,40,29,13,5,33,26,7,26,20,6,2021-01-01,zipcode,Lelia lake
ZCTA5 79241,48,2025,56354,761,79600,1688,702,1420,336,521,341,161,61,911,688,223,688,560,128,2021-01-01,zipcode,Lockney
ZCTA5 79243,48,19,26250,-666666666,-666666666,19,15,19,5,0,7,7,0,18,9,9,9,4,5,2021-01-01,zipcode,Mcadoo
ZCTA5 79244,48,861,66042,661,59600,634,193,565,73,126,247,92,27,485,293,192,293,198,95,2021-01-01,zipcode,Matador
ZCTA5 79245,48,2304,42310,555,64100,1803,762,1564,262,517,517,173,95,1170,895,275,895,637,258,2021-01-01,zipcode,Memphis
ZCTA5 79247,48,35,-666666666,-666666666,-666666666,26,18,26,4,14,8,0,0,28,20,8,20,18,2,2021-01-01,zipcode,Odell
ZCTA5 79248,48,1455,40900,425,47200,1090,395,920,145,268,318,124,65,964,610,354,610,361,249,2021-01-01,zipcode,Paducah
ZCTA5 79250,48,1188,38864,581,56600,972,415,867,191,293,267,90,26,669,466,203,466,339,127,2021-01-01,zipcode,Petersburg
ZCTA5 79251,48,41,-666666666,-666666666,117000,41,5,41,16,0,12,9,4,33,17,16,17,17,0,2021-01-01,zipcode,Quail
ZCTA5 79252,48,2768,55938,583,57500,2218,723,2017,215,806,717,204,75,1383,979,404,979,622,357,2021-01-01,zipcode,Quanah
ZCTA5 79255,48,472,47708,758,99600,387,191,328,39,113,93,69,14,361,213,148,213,139,74,2021-01-01,zipcode,Quitaque
ZCTA5 79256,48,288,36058,685,49000,263,135,251,41,115,47,37,11,164,115,49,115,83,32,2021-01-01,zipcode,Roaring springs
ZCTA5 79257,48,820,35000,-666666666,67200,696,290,642,113,233,230,35,31,573,346,227,346,263,83,2021-01-01,zipcode,Silverton
ZCTA5 79258,48,74,70739,-666666666,-666666666,74,49,62,0,47,8,7,0,31,31,0,31,31,0,2021-01-01,zipcode,South plains
ZCTA5 79259,48,49,-666666666,-666666666,-666666666,49,12,49,0,3,0,46,0,44,14,30,14,14,0,2021-01-01,zipcode,Tell
ZCTA5 79261,48,313,51250,525,39600,283,120,220,60,60,48,43,9,340,122,218,122,77,45,2021-01-01,zipcode,Turkey
ZCTA5 79311,48,3767,57734,677,114100,2844,1184,2264,313,849,519,422,161,1559,1402,157,1402,1054,348,2021-01-01,zipcode,Abernathy
ZCTA5 79312,48,1235,56141,593,50600,956,468,805,201,363,181,40,20,396,319,77,319,259,60,2021-01-01,zipcode,Amherst
ZCTA5 79313,48,1457,51111,895,57400,1114,474,981,248,283,322,101,27,740,574,166,574,411,163,2021-01-01,zipcode,Anton
ZCTA5 79314,48,132,21776,-666666666,-666666666,73,37,73,43,15,15,0,0,67,39,28,39,14,25,2021-01-01,zipcode,Bledsoe
ZCTA5 79316,48,10180,46175,732,82800,7740,3218,6471,1790,2107,1824,488,262,4260,3655,605,3655,2293,1362,2021-01-01,zipcode,Brownfield
ZCTA5 79322,48,1802,44561,450,58800,1416,624,1234,305,463,279,160,27,858,671,187,671,480,191,2021-01-01,zipcode,Crosbyton
ZCTA5 79323,48,7003,70908,701,162300,4963,1745,3932,1017,1296,1295,274,50,2660,2475,185,2475,1660,815,2021-01-01,zipcode,Denver city
ZCTA5 79324,48,36,-666666666,-666666666,-666666666,26,12,16,0,5,11,0,0,23,12,11,12,12,0,2021-01-01,zipcode,Enochs
ZCTA5 79325,48,2218,52130,948,128300,1303,503,1146,233,405,311,180,17,799,596,203,596,392,204,2021-01-01,zipcode,Farwell
ZCTA5 79326,48,34,-666666666,-666666666,-666666666,25,22,6,0,3,3,0,0,3,3,0,3,3,0,2021-01-01,zipcode,Fieldton
ZCTA5 79329,48,3086,62949,693,156400,2372,902,2102,363,602,671,356,110,1505,1227,278,1227,921,306,2021-01-01,zipcode,Idalou
ZCTA5 79330,48,73,110625,-666666666,158300,73,40,73,0,40,10,13,10,339,41,298,41,36,5,2021-01-01,zipcode,Justiceburg
ZCTA5 79331,48,11726,40479,757,83500,9068,4639,7382,2116,2470,1821,824,151,4623,3998,625,3998,2781,1217,2021-01-01,zipcode,Lamesa
ZCTA5 79336,48,15785,47717,737,108300,12242,4818,9867,2381,2474,3350,1116,546,6825,5917,908,5917,4143,1774,2021-01-01,zipcode,Levelland
ZCTA5 79339,48,6694,45917,777,63700,4955,1925,4166,963,1440,1220,407,136,2991,2373,618,2373,1713,660,2021-01-01,zipcode,Littlefield
ZCTA5 79342,48,332,64583,-666666666,95000,273,129,237,104,77,32,13,11,150,121,29,121,114,7,2021-01-01,zipcode,Loop
ZCTA5 79343,48,1695,54219,638,88700,1337,453,1044,206,293,312,211,22,689,567,122,567,453,114,2021-01-01,zipcode,Lorenzo
ZCTA5 79344,48,0,-666666666,-666666666,-666666666,0,0,0,0,0,0,0,0,0,0,0,0,0,0,2021-01-01,zipcode,Maple
ZCTA5 79345,48,1166,62727,713,80000,863,330,651,130,164,297,47,13,346,304,42,304,216,88,2021-01-01,zipcode,Meadow
ZCTA5 79346,48,2062,40592,717,43000,1514,552,1346,395,457,324,144,26,1033,811,222,811,537,274,2021-01-01,zipcode,Morton
ZCTA5 79347,48,6933,64945,628,94600,5188,2204,4256,1283,1366,948,437,222,2518,1941,577,1941,1418,523,2021-01-01,zipcode,Muleshoe
ZCTA5 79350,48,508,83143,-666666666,57400,444,114,419,79,157,176,7,0,258,218,40,218,209,9,2021-01-01,zipcode,New deal
ZCTA5 79351,48,1268,63750,846,81700,918,338,861,208,247,266,115,25,637,498,139,498,352,146,2021-01-01,zipcode,Odonnell
ZCTA5 79353,48,24,103750,-666666666,-666666666,16,6,13,0,0,6,7,0,8,8,0,8,8,0,2021-01-01,zipcode,Pep
ZCTA5 79355,48,1613,71181,734,80000,1183,374,1043,347,159,369,161,7,770,624,146,624,380,244,2021-01-01,zipcode,Plains
ZCTA5 79356,48,5602,63664,897,79500,4943,3150,4159,1431,1332,949,268,179,1875,1649,226,1649,1193,456,2021-01-01,zipcode,Post
ZCTA5 79357,48,1944,49485,673,60700,1518,512,1306,296,526,315,113,56,947,757,190,757,559,198,2021-01-01,zipcode,Ralls
ZCTA5 79358,48,1365,60764,836,140300,923,312,776,152,163,274,150,37,471,445,26,445,337,108,2021-01-01,zipcode,Ropesville
ZCTA5 79359,48,3500,55294,602,56800,2561,1130,2110,654,741,553,139,23,1468,1238,230,1238,915,323,2021-01-01,zipcode,Seagraves
ZCTA5 79360,48,16584,75697,791,152900,10985,4305,8798,3537,2832,1385,801,243,5444,5013,431,5013,3917,1096,2021-01-01,zipcode,Seminole
ZCTA5 79363,48,5827,65588,966,171600,4534,1536,3978,528,1176,1161,690,423,2329,2137,192,2137,1775,362,2021-01-01,zipcode,Shallowater
ZCTA5 79364,48,7638,49780,883,88600,5732,2208,5064,702,1746,1639,643,334,3128,2785,343,2785,1867,918,2021-01-01,zipcode,Slaton
ZCTA5 79366,48,1107,119009,1390,243600,998,348,816,25,174,226,203,188,530,457,73,457,438,19,2021-01-01,zipcode,Ransom canyon
ZCTA5 79367,48,638,41806,810,74500,458,128,368,125,91,100,40,12,254,231,23,231,126,105,2021-01-01,zipcode,Smyer
ZCTA5 79369,48,65,-666666666,-666666666,-666666666,65,45,65,0,28,17,0,20,38,38,0,38,38,0,2021-01-01,zipcode,Spade
ZCTA5 79370,48,1236,41198,581,60600,1045,580,937,132,322,277,132,74,1005,525,480,525,401,124,2021-01-01,zipcode,Spur
ZCTA5 79371,48,1600,63315,655,95200,1295,433,1099,148,492,309,129,21,783,630,153,630,515,115,2021-01-01,zipcode,Sudan
ZCTA5 79372,48,1400,50086,788,81000,1098,406,893,180,337,232,84,60,566,504,62,504,377,127,2021-01-01,zipcode,Sundown
ZCTA5 79373,48,2816,45729,908,89400,2175,743,1899,404,595,471,302,127,1328,1080,248,1080,753,327,2021-01-01,zipcode,Tahoka
ZCTA5 79376,48,95,34875,-666666666,-666666666,33,23,33,21,0,0,11,1,54,19,35,19,9,10,2021-01-01,zipcode,Tokio
ZCTA5 79377,48,242,52500,-666666666,88300,172,99,136,74,28,22,12,0,124,78,46,78,55,23,2021-01-01,zipcode,Welch
ZCTA5 79378,48,257,79500,485,102100,169,56,150,38,60,23,15,14,113,74,39,74,51,23,2021-01-01,zipcode,Wellman
ZCTA5 79379,48,605,48906,661,67200,487,228,386,113,108,112,38,15,220,181,39,181,150,31,2021-01-01,zipcode,Whiteface
ZCTA5 79380,48,73,45938,-666666666,-666666666,60,32,53,13,15,17,8,0,35,23,12,23,19,4,2021-01-01,zipcode,Whitharral
ZCTA5 79381,48,1425,59048,835,165000,1043,409,827,119,189,241,214,64,553,504,49,504,398,106,2021-01-01,zipcode,Wilson
ZCTA5 79382,48,9355,75088,1058,210200,6385,1812,5233,521,1293,2084,938,397,3261,3115,146,3115,2385,730,2021-01-01,zipcode,Wolfforth
ZCTA5 79401,48,9045,18585,968,105400,8543,3879,3705,694,1126,1053,445,387,4788,3782,1006,3782,377,3405,2021-01-01,zipcode,Lubbock
ZCTA5 79403,48,16001,39333,827,67000,12177,4963,9884,2472,4031,2495,531,355,6441,5783,658,5783,3348,2435,2021-01-01,zipcode,Lubbock
ZCTA5 79404,48,9312,40110,810,64700,7455,3506,6605,1631,2328,1840,517,289,4206,3375,831,3375,2192,1183,2021-01-01,zipcode,Lubbock
ZCTA5 79406,48,7341,-666666666,-666666666,-666666666,7341,5320,0,0,0,0,0,0,0,0,0,0,0,0,2021-01-01,zipcode,Lubbock
ZCTA5 79407,48,21211,53963,981,146200,17231,4967,13018,1198,3319,4063,2805,1633,10563,9340,1223,9340,4202,5138,2021-01-01,zipcode,Lubbock
ZCTA5 79410,48,10570,39913,1177,157900,8418,2726,5874,720,932,1576,1253,1393,4580,4345,235,4345,1512,2833,2021-01-01,zipcode,Lubbock
ZCTA5 79411,48,6623,34253,823,103800,5739,1945,3948,1091,1128,971,349,409,3592,3076,516,3076,1130,1946,2021-01-01,zipcode,Lubbock
ZCTA5 79412,48,15719,36722,834,86300,11531,4178,9124,2014,3459,2452,769,430,6389,5732,657,5732,2870,2862,2021-01-01,zipcode,Lubbock
ZCTA5 79413,48,23265,61868,1146,163300,17338,5431,14195,1505,3865,4006,3035,1784,9485,8756,729,8756,5026,3730,2021-01-01,zipcode,Lubbock
ZCTA5 79414,48,18081,43279,979,119400,14892,4485,10378,1131,2699,3638,1739,1171,9106,8436,670,8436,3065,5371,2021-01-01,zipcode,Lubbock
ZCTA5 79415,48,17048,33112,910,69500,13404,5445,9047,2048,3097,2254,970,678,7081,6285,796,6285,2439,3846,2021-01-01,zipcode,Lubbock
ZCTA5 79416,48,34864,61627,1106,156500,27867,9601,19436,1572,4153,5676,4885,3150,15302,13587,1715,13587,6729,6858,2021-01-01,zipcode,Lubbock
ZCTA5 79423,48,41950,76865,1170,174500,31648,9128,27259,1918,6351,8822,6198,3970,16933,15931,1002,15931,11397,4534,2021-01-01,zipcode,Lubbock
ZCTA5 79424,48,49721,87476,983,226700,38506,11243,32675,1938,5623,9828,10107,5179,21669,20086,1583,20086,13881,6205,2021-01-01,zipcode,Lubbock
ZCTA5 79501,48,2686,51545,781,71500,2184,1083,1958,278,534,903,190,53,1592,1193,399,1193,939,254,2021-01-01,zipcode,Anson
ZCTA5 79502,48,1208,62738,546,56100,897,308,710,124,278,216,59,33,600,414,186,414,333,81,2021-01-01,zipcode,Aspermont
ZCTA5 79503,48,128,82917,-666666666,94800,120,33,120,12,21,46,30,11,102,79,23,79,57,22,2021-01-01,zipcode,Avoca
ZCTA5 79504,48,3147,63009,623,73000,2706,985,2401,355,743,743,450,110,1455,1103,352,1103,875,228,2021-01-01,zipcode,Baird
ZCTA5 79505,48,288,36625,473,44600,193,85,180,16,40,110,14,0,175,81,94,81,59,22,2021-01-01,zipcode,Benjamin
ZCTA5 79506,48,544,54479,540,61800,492,266,492,70,131,176,76,39,577,288,289,288,230,58,2021-01-01,zipcode,Blackwell
ZCTA5 79508,48,1061,53917,886,163500,865,369,803,77,320,239,120,47,537,445,92,445,378,67,2021-01-01,zipcode,Buffalo gap
ZCTA5 79510,48,7673,53727,848,117400,6112,2563,5232,435,1927,1800,762,308,3605,2906,699,2906,2420,486,2021-01-01,zipcode,Clyde
ZCTA5 79511,48,1165,66518,1046,123600,821,311,733,70,175,328,122,38,599,415,184,415,347,68,2021-01-01,zipcode,Coahoma
ZCTA5 79512,48,7758,44920,711,69900,6442,3500,4675,846,1994,1379,382,74,3291,1964,1327,1964,1560,404,2021-01-01,zipcode,Colorado city
ZCTA5 79517,48,139,58621,-666666666,-666666666,139,13,139,77,9,41,12,0,66,66,0,66,55,11,2021-01-01,zipcode,Fluvanna
ZCTA5 79518,48,64,125000,-666666666,-666666666,47,20,42,0,17,9,1,15,61,22,39,22,22,0,2021-01-01,zipcode,Girard
ZCTA5 79519,48,67,140100,-666666666,188400,67,19,67,0,23,8,36,0,65,48,17,48,48,0,2021-01-01,zipcode,Goldsboro
ZCTA5 79520,48,2393,60100,792,60400,1714,614,1354,161,513,495,147,38,1263,986,277,986,706,280,2021-01-01,zipcode,Hamlin
ZCTA5 79521,48,3412,54408,588,60500,2875,1383,2413,500,952,536,168,257,1959,1238,721,1238,823,415,2021-01-01,zipcode,Haskell
ZCTA5 79525,48,2481,61058,807,115000,2006,679,1602,130,631,526,275,40,1116,1068,48,1068,1009,59,2021-01-01,zipcode,Hawley
ZCTA5 79526,48,868,52679,923,113900,673,347,623,100,193,179,109,42,496,360,136,360,311,49,2021-01-01,zipcode,Hermleigh
ZCTA5 79527,48,233,62813,-666666666,82500,184,79,179,21,79,55,16,8,181,103,78,103,97,6,2021-01-01,zipcode,Ira
ZCTA5 79528,48,584,63415,823,65200,409,227,381,48,103,109,63,58,333,214,119,214,171,43,2021-01-01,zipcode,Jayton
ZCTA5 79529,48,1164,35446,922,44300,973,468,809,147,216,287,95,64,634,470,164,470,352,118,2021-01-01,zipcode,Knox city
ZCTA5 79530,48,476,44375,694,49000,415,168,378,67,168,83,57,3,332,220,112,220,175,45,2021-01-01,zipcode,Lawn
ZCTA5 79532,48,852,55125,563,63400,589,194,516,98,220,131,54,13,370,233,137,233,195,38,2021-01-01,zipcode,Loraine
ZCTA5 79533,48,457,37065,-666666666,26200,359,164,324,58,97,103,62,4,276,218,58,218,160,58,2021-01-01,zipcode,Lueders
ZCTA5 79534,48,161,105417,-666666666,114600,151,58,147,22,18,30,34,43,88,73,15,73,73,0,2021-01-01,zipcode,Mc caulley
ZCTA5 79535,48,155,58125,-666666666,60000,148,93,121,8,38,57,12,6,93,70,23,70,66,4,2021-01-01,zipcode,Maryneal
ZCTA5 79536,48,5703,63399,889,109400,4137,1677,3547,377,1657,1067,356,90,2393,1937,456,1937,1631,306,2021-01-01,zipcode,Merkel
ZCTA5 79537,48,55,-666666666,-666666666,-666666666,55,48,38,6,31,0,1,0,34,21,13,21,11,10,2021-01-01,zipcode,Nolan
ZCTA5 79538,48,181,-666666666,-666666666,-666666666,164,86,142,11,71,34,19,7,118,66,52,66,65,1,2021-01-01,zipcode,Novice
ZCTA5 79539,48,230,59375,733,95000,203,88,146,37,39,17,39,14,121,82,39,82,64,18,2021-01-01,zipcode,O brien
ZCTA5 79540,48,54,77750,-666666666,12300,43,3,35,0,9,21,5,0,35,21,14,21,21,0,2021-01-01,zipcode,Old glory
ZCTA5 79541,48,1077,54696,-666666666,-666666666,845,269,762,0,353,242,34,133,516,453,63,453,353,100,2021-01-01,zipcode,Ovalo
ZCTA5 79543,48,1295,62500,680,64900,980,263,836,64,359,280,96,37,608,490,118,490,385,105,2021-01-01,zipcode,Roby
ZCTA5 79544,48,546,41389,817,56300,430,181,334,73,126,118,13,4,232,170,62,170,134,36,2021-01-01,zipcode,Rochester
ZCTA5 79545,48,1855,49000,822,78900,1428,579,1200,200,388,344,201,67,935,742,193,742,649,93,2021-01-01,zipcode,Roscoe
ZCTA5 79546,48,1639,45833,434,60700,1321,507,1154,207,343,367,168,69,980,696,284,696,464,232,2021-01-01,zipcode,Rotan
ZCTA5 79547,48,757,28450,1068,53900,607,353,568,144,202,124,86,12,514,345,169,345,273,72,2021-01-01,zipcode,Rule
ZCTA5 79548,48,135,48750,-666666666,79100,108,49,103,22,45,5,28,3,108,62,46,62,54,8,2021-01-01,zipcode,Rule
ZCTA5 79549,48,15814,53097,794,94700,12394,6031,10135,1888,3340,3355,1154,398,6326,5500,826,5500,4331,1169,2021-01-01,zipcode,Snyder
ZCTA5 79553,48,3256,46955,748,62900,2357,1174,2062,306,842,464,357,93,1516,1322,194,1322,1020,302,2021-01-01,zipcode,Stamford
ZCTA5 79556,48,12687,42403,807,79900,9712,3986,8126,1463,2712,2699,836,416,6038,4698,1340,4698,2894,1804,2021-01-01,zipcode,Sweetwater
ZCTA5 79560,48,138,-666666666,-666666666,96100,102,27,97,42,29,10,8,8,91,54,37,54,27,27,2021-01-01,zipcode,Sylvester
ZCTA5 79561,48,626,78750,950,68600,527,211,478,64,154,190,58,12,311,252,59,252,208,44,2021-01-01,zipcode,Trent
ZCTA5 79562,48,4150,103269,1131,235800,3245,1479,2924,102,717,961,724,420,1526,1450,76,1450,1322,128,2021-01-01,zipcode,Tuscola
ZCTA5 79563,48,1149,49643,854,57800,913,465,780,167,359,193,47,14,528,424,104,424,347,77,2021-01-01,zipcode,Tye
ZCTA5 79565,48,349,102188,-666666666,71700,227,126,173,4,97,51,21,0,96,75,21,75,68,7,2021-01-01,zipcode,Westbrook
ZCTA5 79566,48,188,38571,-666666666,212500,112,58,112,10,43,38,17,4,123,72,51,72,55,17,2021-01-01,zipcode,Wingate
ZCTA5 79567,48,3112,42306,608,58400,2317,923,1980,486,690,508,254,42,1593,1101,492,1101,817,284,2021-01-01,zipcode,Winters
ZCTA5 79601,48,27033,48306,831,141300,23357,12518,16110,2816,5357,4705,2076,1156,9451,7748,1703,7748,3738,4010,2021-01-01,zipcode,Abilene
ZCTA5 79602,48,26933,71173,972,182900,20820,7226,18089,1844,4427,5516,3680,2622,10518,9454,1064,9454,7150,2304,2021-01-01,zipcode,Abilene
ZCTA5 79603,48,23956,48614,844,90800,18036,6324,14627,2705,5203,4319,1924,476,10067,8755,1312,8755,5183,3572,2021-01-01,zipcode,Abilene
ZCTA5 79605,48,28611,51676,955,126300,22098,6827,17956,2200,5866,5676,2821,1393,12928,11493,1435,11493,6263,5230,2021-01-01,zipcode,Abilene
ZCTA5 79606,48,26810,70246,1038,207400,20961,6620,17166,762,4209,5943,3532,2720,12200,11330,870,11330,6171,5159,2021-01-01,zipcode,Abilene
ZCTA5 79607,48,3888,54816,1226,445200,2703,352,1428,9,149,823,284,163,924,883,41,883,57,826,2021-01-01,zipcode,Dyess afb
ZCTA5 79699,48,121,-666666666,-666666666,-666666666,121,49,0,0,0,0,0,0,49,0,49,0,0,0,2021-01-01,zipcode,Abilene
ZCTA5 79701,48,30348,52409,1089,151200,21330,7302,17566,5459,4283,4820,2105,899,11922,10769,1153,10769,6840,3929,2021-01-01,zipcode,Midland
ZCTA5 79703,48,22257,86542,1443,182000,16315,4043,13283,3009,3901,4302,1589,482,8480,8071,409,8071,5238,2833,2021-01-01,zipcode,Midland
ZCTA5 79705,48,40134,100243,1349,280200,30543,8159,26630,2927,5230,8144,7818,2511,18165,16635,1530,16635,11599,5036,2021-01-01,zipcode,Midland
ZCTA5 79706,48,31088,101284,1207,237000,21585,6790,18148,2232,4913,7090,2470,1443,11422,10450,972,10450,8391,2059,2021-01-01,zipcode,Midland
ZCTA5 79707,48,36167,96146,1258,325100,28063,7435,23825,1923,5600,6916,6303,3083,15428,14786,642,14786,9017,5769,2021-01-01,zipcode,Midland
ZCTA5 79713,48,853,73214,532,138100,618,265,511,93,97,164,108,49,314,272,42,272,193,79,2021-01-01,zipcode,Ackerly
ZCTA5 79714,48,18184,80518,1229,156500,13270,3987,10992,2631,3441,2851,1531,538,6870,6263,607,6263,4570,1693,2021-01-01,zipcode,Andrews
ZCTA5 79718,48,659,43462,1046,-666666666,570,181,467,78,320,57,12,0,361,194,167,194,148,46,2021-01-01,zipcode,Balmorhea
ZCTA5 79719,48,321,26083,780,-666666666,244,121,208,66,101,36,4,1,202,135,67,135,111,24,2021-01-01,zipcode,Barstow
ZCTA5 79720,48,32431,60122,891,122200,26105,11982,22067,4132,7622,7237,2065,1011,13267,11564,1703,11564,7736,3828,2021-01-01,zipcode,Big spring
ZCTA5 79730,48,180,56103,-666666666,34400,88,28,74,40,30,4,0,0,87,47,40,47,47,0,2021-01-01,zipcode,Coyanosa
ZCTA5 79731,48,4473,68057,869,106100,3255,1248,2776,689,1045,631,323,88,1734,1557,177,1557,1328,229,2021-01-01,zipcode,Crane
ZCTA5 79733,48,401,80913,332,-666666666,282,73,274,8,97,137,21,11,123,123,0,123,64,59,2021-01-01,zipcode,Forsan
ZCTA5 79734,48,1918,39878,1076,155300,1592,945,1428,189,274,583,132,250,1639,946,693,946,853,93,2021-01-01,zipcode,Fort davis
ZCTA5 79735,48,13267,54051,787,112900,10408,5188,9015,2360,3513,2209,539,394,4931,4359,572,4359,3031,1328,2021-01-01,zipcode,Fort stockton
ZCTA5 79738,48,213,59196,-666666666,133300,164,90,138,10,39,21,53,15,101,71,30,71,46,25,2021-01-01,zipcode,Gail
ZCTA5 79739,48,1052,82031,569,199000,876,365,735,191,131,190,176,47,414,372,42,372,231,141,2021-01-01,zipcode,Garden city
ZCTA5 79741,48,295,76250,-666666666,150000,228,112,208,31,45,95,27,10,132,113,19,113,94,19,2021-01-01,zipcode,Goldsmith
ZCTA5 79742,48,584,74107,630,84200,399,130,298,73,103,33,59,30,261,230,31,230,180,50,2021-01-01,zipcode,Grandfalls
ZCTA5 79743,48,253,-666666666,365,75000,214,63,185,14,50,57,46,18,159,96,63,96,52,44,2021-01-01,zipcode,Imperial
ZCTA5 79744,48,1531,54688,1005,126000,1139,479,869,122,201,357,123,66,576,489,87,489,312,177,2021-01-01,zipcode,Iraan
ZCTA5 79745,48,6559,65036,907,84500,4887,2009,3966,1285,1145,1182,280,74,2715,2334,381,2334,1825,509,2021-01-01,zipcode,Kermit
ZCTA5 79748,48,310,50000,-666666666,-666666666,234,111,146,65,53,11,17,0,120,72,48,72,45,27,2021-01-01,zipcode,Knott
ZCTA5 79749,48,553,88409,817,143100,411,198,314,45,78,105,63,23,182,168,14,168,129,39,2021-01-01,zipcode,Lenorah
ZCTA5 79752,48,2014,51379,841,78000,1527,670,1341,319,568,316,51,87,1061,828,233,828,599,229,2021-01-01,zipcode,Mc camey
ZCTA5 79754,48,83,-666666666,-666666666,-666666666,52,26,52,3,9,40,0,0,50,33,17,33,16,17,2021-01-01,zipcode,Mentone
ZCTA5 79755,48,69,97188,-666666666,-666666666,56,4,56,0,12,23,21,0,51,37,14,37,4,33,2021-01-01,zipcode,Midkiff
ZCTA5 79756,48,9477,71558,1026,113200,7073,2493,5995,1308,1919,2136,522,110,4177,3533,644,3533,2695,838,2021-01-01,zipcode,Monahans
ZCTA5 79758,48,2286,113469,1543,365000,1737,639,1574,46,602,741,185,0,911,823,88,823,739,84,2021-01-01,zipcode,Gardendale
ZCTA5 79759,48,0,-666666666,-666666666,-666666666,0,0,0,0,0,0,0,0,0,0,0,0,0,0,2021-01-01,zipcode,Notrees
ZCTA5 79761,48,31566,59538,1104,119900,23275,7158,18410,4941,4886,5835,2076,672,13572,12448,1124,12448,7097,5351,2021-01-01,zipcode,Odessa
ZCTA5 79762,48,40728,68281,1211,182200,29826,8520,24147,2967,7543,8624,3613,1400,16841,15322,1519,15322,8716,6606,2021-01-01,zipcode,Odessa
ZCTA5 79763,48,35900,51659,1066,105600,25999,10642,21866,7540,6709,5596,1488,533,14808,12967,1841,12967,9209,3758,2021-01-01,zipcode,Odessa
ZCTA5 79764,48,25871,73276,750,136800,18955,5357,15283,4004,4559,3894,1482,1344,9876,9088,788,9088,6532,2556,2021-01-01,zipcode,Odessa
ZCTA5 79765,48,20155,90852,1425,256300,14779,3685,12596,888,3518,4502,2472,1216,8302,7788,514,7788,5200,2588,2021-01-01,zipcode,Odessa
ZCTA5 79766,48,10755,66588,1112,136600,7287,3353,6095,2892,1758,1121,275,49,3215,3165,50,3165,2551,614,2021-01-01,zipcode,Odessa
ZCTA5 79770,48,0,-666666666,-666666666,-666666666,0,0,0,0,0,0,0,0,28,0,28,0,0,0,2021-01-01,zipcode,Orla
ZCTA5 79772,48,13843,53669,836,100100,10972,4394,9171,2758,3405,2093,662,253,4516,3868,648,3868,2930,938,2021-01-01,zipcode,Pecos
ZCTA5 79777,48,152,93250,-666666666,175000,106,27,97,12,44,11,13,17,81,55,26,55,44,11,2021-01-01,zipcode,Pyote
ZCTA5 79778,48,1223,61138,-666666666,93600,985,416,795,195,227,276,92,5,584,537,47,537,411,126,2021-01-01,zipcode,Rankin
ZCTA5 79780,48,11,-666666666,-666666666,-666666666,11,0,11,0,11,0,0,0,38,11,27,11,0,11,2021-01-01,zipcode,Saragosa
ZCTA5 79781,48,89,61042,-666666666,-666666666,89,43,89,0,43,22,9,15,76,57,19,57,57,0,2021-01-01,zipcode,Sheffield
ZCTA5 79782,48,4782,70862,627,138100,3251,1108,2743,495,1110,700,217,221,1855,1608,247,1608,1073,535,2021-01-01,zipcode,Stanton
ZCTA5 79783,48,228,147969,-666666666,542600,181,35,165,24,28,91,5,17,104,94,10,94,73,21,2021-01-01,zipcode,Tarzan
ZCTA5 79785,48,87,55750,-666666666,45800,87,27,79,31,7,41,0,0,46,13,33,13,13,0,2021-01-01,zipcode,Toyah
ZCTA5 79788,48,825,65613,633,68700,580,199,509,57,326,107,18,1,359,330,29,330,309,21,2021-01-01,zipcode,Wickett
ZCTA5 79789,48,1070,105188,769,114600,770,211,664,24,254,270,107,9,471,389,82,389,314,75,2021-01-01,zipcode,Wink
ZCTA5 79821,48,6645,46950,828,97800,5415,2911,4414,1165,1255,1477,363,154,1912,1716,196,1716,1408,308,2021-01-01,zipcode,Anthony
ZCTA5 79830,48,7948,49414,743,191300,6585,2321,5884,728,969,1425,1514,1248,4664,3887,777,3887,2393,1494,2021-01-01,zipcode,Alpine
ZCTA5 79834,48,236,42286,727,-666666666,226,35,221,17,1,17,154,32,182,163,19,163,5,158,2021-01-01,zipcode,Big bend national park
ZCTA5 79835,48,12231,33984,812,81600,9031,4126,7577,2535,2003,2109,453,477,4552,4001,551,4001,2949,1052,2021-01-01,zipcode,Canutillo
ZCTA5 79836,48,8042,42083,801,94000,5601,2249,4485,1387,1294,1159,493,152,2596,2405,191,2405,1848,557,2021-01-01,zipcode,Clint
ZCTA5 79837,48,175,-666666666,-666666666,22100,162,39,162,48,12,36,66,0,188,84,104,84,40,44,2021-01-01,zipcode,Dell city
ZCTA5 79838,48,5687,30374,583,67100,4355,2237,3550,1799,1023,633,32,63,2330,1992,338,1992,1392,600,2021-01-01,zipcode,Fabens
ZCTA5 79839,48,1174,32051,669,51400,844,506,678,425,180,70,3,0,564,454,110,454,336,118,2021-01-01,zipcode,Fort hancock
ZCTA5 79842,48,453,47989,427,96100,408,164,389,55,66,141,66,61,491,289,202,289,197,92,2021-01-01,zipcode,Marathon
ZCTA5 79843,48,2461,39146,634,175800,2272,617,1828,517,261,592,252,206,1570,1064,506,1064,658,406,2021-01-01,zipcode,Marfa
ZCTA5 79845,48,3824,20610,425,46800,2692,1491,2174,1378,262,273,226,35,1690,1104,586,1104,696,408,2021-01-01,zipcode,Presidio
ZCTA5 79846,48,43,-666666666,-666666666,-666666666,43,16,43,43,0,0,0,0,56,27,29,27,0,27,2021-01-01,zipcode,Redford
ZCTA5 79847,48,95,-666666666,-666666666,-666666666,50,36,50,0,31,13,6,0,60,30,30,30,24,6,2021-01-01,zipcode,Salt flat
ZCTA5 79848,48,934,48315,-666666666,87800,809,481,765,110,221,312,86,36,617,381,236,381,360,21,2021-01-01,zipcode,Sanderson
ZCTA5 79849,48,13183,41599,747,82300,9464,3965,7243,3026,2404,1243,517,53,4341,3840,501,3840,2659,1181,2021-01-01,zipcode,San elizario
ZCTA5 79851,48,1573,-666666666,769,-666666666,1366,1213,1145,650,272,166,57,0,180,136,44,136,111,25,2021-01-01,zipcode,Sierra blanca
ZCTA5 79852,48,628,42118,508,98200,560,267,547,60,137,242,57,51,450,307,143,307,219,88,2021-01-01,zipcode,Terlingua
ZCTA5 79853,48,2858,56892,854,78400,2326,1029,1849,880,403,387,166,13,956,880,76,880,839,41,2021-01-01,zipcode,Tornillo
ZCTA5 79854,48,103,27826,-666666666,73000,103,54,103,16,0,52,35,0,110,64,46,64,56,8,2021-01-01,zipcode,Valentine
ZCTA5 79855,48,2134,33315,808,66100,1662,812,1497,554,581,105,243,14,891,617,274,617,461,156,2021-01-01,zipcode,Van horn
ZCTA5 79901,48,8518,13510,464,72600,7040,4192,6038,3368,1198,1139,288,45,4400,3516,884,3516,266,3250,2021-01-01,zipcode,El paso
ZCTA5 79902,48,19984,38274,694,190400,17121,7231,13897,2740,2086,3842,3095,2134,9951,8724,1227,8724,3455,5269,2021-01-01,zipcode,El paso
ZCTA5 79903,48,15849,33372,797,101600,12935,5821,10903,2894,2366,3807,1253,583,6873,6125,748,6125,3705,2420,2021-01-01,zipcode,El paso
ZCTA5 79904,48,32148,33984,878,98300,23643,10043,18644,4530,5370,6081,1783,880,13070,11609,1461,11609,4712,6897,2021-01-01,zipcode,El paso
ZCTA5 79905,48,21953,23060,584,86000,16894,8881,13623,6201,2825,3483,830,284,9114,7866,1248,7866,3776,4090,2021-01-01,zipcode,El paso
ZCTA5 79906,48,5839,51675,1380,-666666666,3764,1029,2317,33,309,996,628,351,1831,1569,262,1569,0,1569,2021-01-01,zipcode,El paso
ZCTA5 79907,48,50696,36438,798,90900,39522,17292,31916,9713,10298,8219,2857,829,17478,16389,1089,16389,9704,6685,2021-01-01,zipcode,El paso
ZCTA5 79908,48,4753,60714,1617,-666666666,2467,956,2145,56,427,1168,354,140,1152,1098,54,1098,0,1098,2021-01-01,zipcode,El paso
ZCTA5 79911,48,7668,104145,1341,242000,5814,1925,5057,152,735,1103,1927,1140,2997,2854,143,2854,2256,598,2021-01-01,zipcode,El paso
ZCTA5 79912,48,78470,66742,1051,199200,60669,19191,51409,4310,8796,13211,15060,10032,33163,29596,3567,29596,16463,13133,2021-01-01,zipcode,El paso
ZCTA5 79915,48,36505,32259,685,93700,28646,13656,24065,8466,6888,5995,2292,424,14303,13119,1184,13119,7603,5516,2021-01-01,zipcode,El paso
ZCTA5 79916,48,4526,-666666666,-666666666,-666666666,4526,327,1309,11,244,647,326,81,0,0,0,0,0,0,2021-01-01,zipcode,Fort bliss
ZCTA5 79920,48,7,-666666666,-666666666,-666666666,7,0,0,0,0,0,0,0,0,0,0,0,0,0,2021-01-01,zipcode,
ZCTA5 79922,48,7210,103906,1181,259600,5954,2271,5074,445,831,1166,1698,934,3068,2686,382,2686,2366,320,2021-01-01,zipcode,El paso
ZCTA5 79924,48,59420,47778,902,106000,45865,18526,37517,7382,10458,12910,4806,1961,22505,20922,1583,20922,12983,7939,2021-01-01,zipcode,El paso
ZCTA5 79925,48,38947,49391,890,143600,30798,10844,25404,3710,5497,9077,4577,2543,16067,14788,1279,14788,7898,6890,2021-01-01,zipcode,El paso
ZCTA5 79927,48,42140,41526,854,97600,32692,12481,26687,8578,8577,7156,1825,551,13447,12952,495,12952,10408,2544,2021-01-01,zipcode,El paso
ZCTA5 79928,48,76392,62471,1018,141500,52577,16294,42140,7497,10621,14453,7204,2365,22876,21374,1502,21374,18688,2686,2021-01-01,zipcode,El paso
ZCTA5 79930,48,26787,38007,798,101500,21715,7944,17133,4649,3941,5385,2078,1080,12114,10479,1635,10479,4959,5520,2021-01-01,zipcode,El paso
ZCTA5 79932,48,28594,75709,926,194900,21863,7282,17888,1962,3148,5600,4617,2561,10728,9682,1046,9682,6768,2914,2021-01-01,zipcode,El paso
ZCTA5 79934,48,26916,74314,1226,156400,20243,5742,16148,921,2884,6242,3908,2193,10668,9565,1103,9565,6404,3161,2021-01-01,zipcode,El paso
ZCTA5 79935,48,19073,59585,911,165400,15218,5772,12466,1964,3023,3902,2597,980,6906,6466,440,6466,3346,3120,2021-01-01,zipcode,El paso
ZCTA5 79936,48,107579,58096,1051,135700,84779,29325,68805,9324,17009,24405,12649,5418,37103,35736,1367,35736,24329,11407,2021-01-01,zipcode,El paso
ZCTA5 79938,48,91575,64239,1216,158500,62424,19789,51123,7770,10327,19235,9320,4471,27863,26423,1440,26423,20745,5678,2021-01-01,zipcode,El paso
ZCTA5 07001,34,17211,84549,1722,326700,14030,6623,12627,1483,5000,2618,1963,1563,5536,5394,142,5394,2801,2593,2022-01-01,zipcode,Avenel
ZCTA5 07002,34,70497,80044,1474,413100,55874,19281,49185,5017,14344,10945,13355,5524,29180,27198,1982,27198,10654,16544,2022-01-01,zipcode,Bayonne
ZCTA5 07003,34,52594,92223,1702,425100,42949,11689,36762,2805,8458,7931,11536,6032,21467,20573,894,20573,10583,9990,2022-01-01,zipcode,Bloomfield
ZCTA5 07004,34,7723,110703,2568,621400,6198,2127,5737,193,1342,1251,1887,1064,2990,2951,39,2951,2410,541,2022-01-01,zipcode,Fairfield
ZCTA5 07005,34,15106,120783,1699,552300,12172,3873,10492,420,2404,2116,3345,2207,5935,5589,346,5589,3896,1693,2022-01-01,zipcode,Boonton
ZCTA5 07006,34,26449,144142,1908,642300,21383,6621,18840,703,2570,3108,6652,5807,10301,9997,304,9997,7557,2440,2022-01-01,zipcode,Caldwell
ZCTA5 07008,34,25170,79081,1833,337200,19857,7142,16650,2709,5663,3697,3303,1278,8731,8162,569,8162,4444,3718,2022-01-01,zipcode,Carteret
ZCTA5 07009,34,13225,152813,1557,583600,10954,4134,9552,349,1757,1960,3329,2157,5010,4888,122,4888,4097,791,2022-01-01,zipcode,Cedar grove
ZCTA5 07010,34,25546,96734,1743,520800,21486,7733,18636,2350,3797,4232,5139,3118,11297,10526,771,10526,5084,5442,2022-01-01,zipcode,Cliffside park
ZCTA5 07011,34,40042,71489,1578,383200,32692,9833,28222,4344,10541,7172,4840,1325,14312,13784,528,13784,6033,7751,2022-01-01,zipcode,Clifton
ZCTA5 07012,34,14870,94615,1691,423900,11195,3561,9962,654,2487,2272,2600,1949,5488,5389,99,5389,2916,2473,2022-01-01,zipcode,Clifton
ZCTA5 07013,34,29725,113991,1658,450400,25304,8323,22719,1930,6509,4557,6612,3111,11793,11514,279,11514,8369,3145,2022-01-01,zipcode,Clifton
ZCTA5 07014,34,4098,110625,1773,417600,3534,1032,3203,126,1056,560,992,469,2064,1783,281,1783,1306,477,2022-01-01,zipcode,Clifton
ZCTA5 07016,34,23838,152941,1952,608700,19389,6309,16871,456,3220,2484,6428,4283,9453,9164,289,9164,7192,1972,2022-01-01,zipcode,Cranford
ZCTA5 07017,34,39557,60137,1284,290300,30928,10456,27536,3709,10204,8082,4035,1506,16148,15026,1122,15026,4609,10417,2022-01-01,zipcode,East orange
ZCTA5 07018,34,29216,57482,1404,270900,22887,7345,19495,2702,6022,6238,3160,1373,12707,11276,1431,11276,2780,8496,2022-01-01,zipcode,East orange
ZCTA5 07020,34,14394,136806,2580,750200,12444,3342,11533,267,1202,1493,4730,3841,7638,7024,614,7024,2969,4055,2022-01-01,zipcode,Edgewater
ZCTA5 07021,34,2290,247000,3501,945500,1624,580,1454,22,114,155,542,621,798,726,72,726,707,19,2022-01-01,zipcode,Essex fells
ZCTA5 07022,34,14935,59359,1517,475600,12852,4335,10735,2637,3153,2335,1668,942,5964,5823,141,5823,1895,3928,2022-01-01,zipcode,Fairview
ZCTA5 07023,34,7723,177727,2254,588100,6086,1779,5437,128,666,728,2302,1613,2808,2808,0,2808,2438,370,2022-01-01,zipcode,Fanwood
ZCTA5 07024,34,39781,101603,2161,393200,33652,12753,31118,1454,5190,4937,10664,8873,19626,18304,1322,18304,10694,7610,2022-01-01,zipcode,Fort lee
ZCTA5 07026,34,32472,72026,1491,430500,26718,9178,22798,3371,9132,5225,3239,1831,12130,11544,586,11544,5375,6169,2022-01-01,zipcode,Garfield
ZCTA5 07027,34,4542,107823,1575,469800,3881,1163,3460,127,961,1007,869,496,1972,1956,16,1956,1000,956,2022-01-01,zipcode,Garwood
ZCTA5 07028,34,7970,239192,2042,693100,5894,1775,4938,28,441,442,2016,2011,2540,2540,0,2540,2419,121,2022-01-01,zipcode,Glen ridge
ZCTA5 07029,34,21935,71750,1934,422100,18072,5158,16130,2136,4253,2666,3381,3694,9933,9377,556,9377,2146,7231,2022-01-01,zipcode,Harrison
ZCTA5 07030,34,58754,168137,2648,859300,50500,10094,44236,1801,3363,3246,21549,14277,30211,27879,2332,27879,9589,18290,2022-01-01,zipcode,Hoboken
ZCTA5 07031,34,16352,96869,1656,442700,13722,4273,12385,833,3704,3349,2812,1687,6953,6634,319,6634,3116,3518,2022-01-01,zipcode,North arlington
ZCTA5 07032,34,41157,81307,1557,404000,33730,10954,29402,4742,9585,6656,5773,2646,15362,14703,659,14703,6933,7770,2022-01-01,zipcode,Kearny
ZCTA5 07033,34,8345,97600,1884,462100,6181,1682,5533,534,1501,1858,1052,588,2904,2802,102,2802,1844,958,2022-01-01,zipcode,Kenilworth
ZCTA5 07034,34,10064,95673,1402,390400,8474,2629,7413,559,1795,1229,2697,1133,4296,4158,138,4158,2480,1678,2022-01-01,zipcode,Lake hiawatha
ZCTA5 07035,34,10922,112579,1658,408200,9540,3116,8409,612,2294,1611,2523,1369,4264,4136,128,4136,3197,939,2022-01-01,zipcode,Lincoln park
ZCTA5 07036,34,44996,85748,1541,355300,36605,10994,31767,4478,10941,9156,4796,2396,16812,15976,836,15976,9337,6639,2022-01-01,zipcode,Linden
ZCTA5 07039,34,31091,202619,2818,709800,23988,8440,20918,871,2235,2349,7446,8017,10655,10378,277,10378,9037,1341,2022-01-01,zipcode,Livingston
ZCTA5 07040,34,25384,165681,1990,638000,19331,5054,16490,744,1582,2923,5954,5287,8751,8401,350,8401,6467,1934,2022-01-01,zipcode,Maplewood
ZCTA5 07041,34,7412,199602,1933,941800,5530,1637,4973,171,418,299,1783,2302,2838,2589,249,2589,1786,803,2022-01-01,zipcode,Millburn
ZCTA5 07042,34,26945,130329,1956,673900,21594,5715,19175,491,2597,3481,6591,6015,11683,10925,758,10925,5592,5333,2022-01-01,zipcode,Montclair
ZCTA5 07043,34,13425,231214,2294,883400,10278,3224,8527,146,346,1041,2832,4162,4606,4284,322,4284,3585,699,2022-01-01,zipcode,Montclair
ZCTA5 07044,34,14438,153236,1939,577100,11350,3653,10360,211,1645,1448,3910,3146,5976,5821,155,5821,4644,1177,2022-01-01,zipcode,Verona
ZCTA5 07045,34,10240,163047,2250,649900,8776,3053,7750,270,1374,864,2828,2414,3832,3720,112,3720,3664,56,2022-01-01,zipcode,Montville
ZCTA5 07046,34,4499,250001,3501,869800,3202,1054,2692,60,260,205,1109,1058,1486,1430,56,1430,1376,54,2022-01-01,zipcode,Mountain lakes
ZCTA5 07047,34,62066,76053,1630,446200,50826,16879,44727,8295,11144,10800,8800,5688,25210,23959,1251,23959,10296,13663,2022-01-01,zipcode,North bergen
ZCTA5 07050,34,33523,50498,1410,304300,25896,9495,21662,4165,7930,5367,2799,1401,13225,12306,919,12306,2740,9566,2022-01-01,zipcode,Orange
ZCTA5 07052,34,48399,127931,1729,472300,39422,12330,34304,2727,6314,7127,10275,7861,18343,17344,999,17344,12464,4880,2022-01-01,zipcode,West orange
ZCTA5 07054,34,30392,105434,1646,558400,25485,7688,22068,1444,3569,3488,7736,5831,12368,11963,405,11963,5958,6005,2022-01-01,zipcode,Parsippany
ZCTA5 07055,34,70048,57832,1341,379800,50611,16875,39814,12961,15009,5446,4145,2253,20884,20182,702,20182,4446,15736,2022-01-01,zipcode,Passaic
ZCTA5 07057,34,11838,79270,1454,452200,9846,3313,8821,709,2735,2196,2295,886,5241,4994,247,4994,1720,3274,2022-01-01,zipcode,Wallington
ZCTA5 07058,34,6052,152422,2249,678600,4885,1541,4304,16,406,1228,1438,1216,2208,2208,0,2208,1441,767,2022-01-01,zipcode,Pine brook
ZCTA5 07059,34,16208,196122,2032,862800,12790,4102,11199,308,1790,1613,3838,3650,5824,5554,270,5554,4922,632,2022-01-01,zipcode,Warren
ZCTA5 07060,34,47883,66761,1489,339400,37171,10462,30338,6982,8661,7440,4919,2336,16432,15678,754,15678,6140,9538,2022-01-01,zipcode,Plainfield
ZCTA5 07062,34,14253,90477,1674,348700,11107,3192,9405,1377,2663,2322,2102,941,4786,4593,193,4593,2912,1681,2022-01-01,zipcode,Plainfield
ZCTA5 07063,34,14849,82188,1669,345600,11012,2722,9344,2296,2859,2243,1304,642,4329,4237,92,4237,2655,1582,2022-01-01,zipcode,Plainfield
ZCTA5 07064,34,4031,140104,1307,399100,3195,827,2796,211,935,760,673,217,1302,1210,92,1210,1122,88,2022-01-01,zipcode,Port reading
ZCTA5 07065,34,29664,86557,1646,343200,24037,7721,21122,1951,6655,5319,4457,2740,12774,12079,695,12079,6655,5424,2022-01-01,zipcode,Rahway
ZCTA5 07066,34,15415,120882,1734,546800,12454,4114,11121,504,3074,2444,2871,2228,6049,5902,147,5902,4526,1376,2022-01-01,zipcode,Clark
ZCTA5 07067,34,18581,129122,1835,439800,15040,5208,13471,1014,3110,3384,3946,2017,6345,6220,125,6220,5558,662,2022-01-01,zipcode,Colonia
ZCTA5 07068,34,6221,135451,3092,614300,4962,1650,4725,127,845,795,1582,1376,2466,2451,15,2451,1884,567,2022-01-01,zipcode,Roseland
ZCTA5 07069,34,6651,152168,2302,788800,5444,1731,4926,222,735,1101,1676,1192,2392,2324,68,2324,2033,291,2022-01-01,zipcode,Watchung
ZCTA5 07070,34,18754,128576,1700,572300,15759,5184,13006,664,2418,2665,4382,2877,6931,6755,176,6755,4211,2544,2022-01-01,zipcode,Rutherford
ZCTA5 07071,34,22332,104338,1705,477100,18577,5852,16270,1763,4626,3749,3952,2180,9505,9055,450,9055,5227,3828,2022-01-01,zipcode,Lyndhurst
ZCTA5 07072,34,6341,89669,1493,517200,5569,1758,4602,268,1777,1082,898,577,2762,2586,176,2586,1543,1043,2022-01-01,zipcode,Carlstadt
ZCTA5 07073,34,10020,92536,1712,446900,8484,2584,7393,810,1524,1859,2223,977,4539,4258,281,4258,1444,2814,2022-01-01,zipcode,East rutherford
ZCTA5 07074,34,3093,90263,1111,416400,2330,679,2051,172,638,599,410,232,1006,950,56,950,668,282,2022-01-01,zipcode,Moonachie
ZCTA5 07075,34,9978,132901,1764,499700,8375,2136,7250,230,1126,1853,2345,1696,3961,3851,110,3851,2432,1419,2022-01-01,zipcode,Wood ridge
ZCTA5 07076,34,24727,179531,1790,663700,19318,5898,17016,598,2288,2638,6538,4954,8975,8823,152,8823,7352,1471,2022-01-01,zipcode,Scotch plains
ZCTA5 07077,34,2695,107887,1387,360300,2211,634,2080,205,891,435,275,274,1136,1084,52,1084,786,298,2022-01-01,zipcode,Sewaren
ZCTA5 07078,34,14287,250001,3501,1566500,10334,3594,8830,88,287,572,2636,5247,4513,4513,0,4513,3932,581,2022-01-01,zipcode,Short hills
ZCTA5 07079,34,18648,173012,2186,769100,15025,5123,11192,267,1093,1336,4048,4448,6084,5863,221,5863,3842,2021,2022-01-01,zipcode,South orange
ZCTA5 07080,34,24256,123516,1881,417500,19914,6047,17723,1328,4269,4514,4517,3095,8389,8139,250,8139,6950,1189,2022-01-01,zipcode,South plainfield
ZCTA5 07081,34,17011,141759,2089,552400,14017,3288,12135,659,1723,1857,4979,2917,6942,6610,332,6610,4082,2528,2022-01-01,zipcode,Springfield
ZCTA5 07082,34,5612,153977,1848,633300,4445,1474,3760,62,588,464,1608,1038,2039,1968,71,1968,1871,97,2022-01-01,zipcode,Towaco
ZCTA5 07083,34,56900,114938,1879,404400,48268,14641,41358,4290,10133,10077,11359,5499,20577,19742,835,19742,14742,5000,2022-01-01,zipcode,Union
ZCTA5 07086,34,16790,120395,2314,770600,14108,3145,13449,1104,2169,1639,4613,3924,9042,7862,1180,7862,2719,5143,2022-01-01,zipcode,Weehawken
ZCTA5 07087,34,67258,59967,1415,448000,53847,17131,45032,10691,15251,7553,7798,3739,27258,25610,1648,25610,5048,20562,2022-01-01,zipcode,Union city
ZCTA5 07088,34,3056,86556,1825,333600,2536,971,2102,238,568,612,483,201,1171,1145,26,1145,673,472,2022-01-01,zipcode,Vauxhall
ZCTA5 07090,34,30852,202450,2179,889400,22926,7298,20018,281,1948,2329,8100,7360,10861,10439,422,10439,8331,2108,2022-01-01,zipcode,Westfield
ZCTA5 07092,34,6991,162531,3501,719000,5588,2370,5024,188,755,826,1485,1770,2588,2537,51,2537,2141,396,2022-01-01,zipcode,Mountainside
ZCTA5 07093,34,64203,70683,1595,388200,52683,15867,46223,10446,11763,7520,9893,6601,27482,25581,1901,25581,6895,18686,2022-01-01,zipcode,West new york
ZCTA5 07094,34,21470,129348,2154,557800,17779,5833,16365,830,3049,2591,5404,4491,9202,8607,595,8607,4369,4238,2022-01-01,zipcode,Secaucus
ZCTA5 07095,34,20927,103481,1973,344200,16836,5157,14668,1064,3900,4404,3231,2069,8299,7812,487,7812,4187,3625,2022-01-01,zipcode,Woodbridge
ZCTA5 07102,34,13506,35515,1159,368400,11646,5324,9035,1753,2876,1820,1508,1078,6620,6288,332,6288,400,5888,2022-01-01,zipcode,Newark
ZCTA5 07103,34,35318,40653,1216,238900,27337,11846,21124,4392,6676,5479,2789,1788,13994,12793,1201,12793,2949,9844,2022-01-01,zipcode,Newark
ZCTA5 07104,34,55412,51511,1280,330000,43332,15968,35720,9979,11255,7864,4607,2015,21331,20197,1134,20197,5475,14722,2022-01-01,zipcode,Newark
ZCTA5 07105,34,56696,51927,1520,430000,45114,14612,38416,11028,17647,4234,4136,1371,20467,19484,983,19484,3380,16104,2022-01-01,zipcode,Newark
ZCTA5 07106,34,36538,48983,1163,282800,28724,9849,24646,3142,9392,7855,2961,1296,13898,12682,1216,12682,4319,8363,2022-01-01,zipcode,Newark
ZCTA5 07107,34,41907,46916,1239,317400,32401,12089,27097,6666,10852,6402,2172,1005,16022,15112,910,15112,4664,10448,2022-01-01,zipcode,Newark
ZCTA5 07108,34,27830,32739,1055,298200,20134,7964,16734,2722,5887,5202,2210,713,12657,11130,1527,11130,1850,9280,2022-01-01,zipcode,Newark
ZCTA5 07109,34,37893,85374,1551,360700,31306,9847,26730,3684,8332,6720,5659,2335,14591,13715,876,13715,7403,6312,2022-01-01,zipcode,Belleville
ZCTA5 07110,34,29695,112318,1622,462500,24324,7309,21493,1021,5346,4224,6428,4474,12120,11676,444,11676,7926,3750,2022-01-01,zipcode,Nutley
ZCTA5 07111,34,60268,57293,1273,258900,47602,15120,39815,5182,14753,10989,5800,3091,24586,22178,2408,22178,6593,15585,2022-01-01,zipcode,Irvington
ZCTA5 07112,34,27122,49966,1301,291200,21371,6912,17644,2198,6476,5697,2529,744,12042,10823,1219,10823,3029,7794,2022-01-01,zipcode,Newark
ZCTA5 07114,34,13154,32591,625,409300,11088,6575,9708,2643,3888,2127,827,223,4900,4205,695,4205,870,3335,2022-01-01,zipcode,Newark
ZCTA5 07201,34,27996,60377,1414,363800,21154,6422,18482,4325,6999,4339,2131,688,10600,9545,1055,9545,2157,7388,2022-01-01,zipcode,Elizabeth
ZCTA5 07202,34,44673,63032,1407,328600,34926,12527,29431,7032,11983,6916,2307,1193,15591,14985,606,14985,3694,11291,2022-01-01,zipcode,Elizabeth
ZCTA5 07203,34,22500,75264,1367,293300,18781,5561,15645,1855,5389,4540,2524,1337,8554,8223,331,8223,4391,3832,2022-01-01,zipcode,Roselle
ZCTA5 07204,34,13964,97769,1455,359400,11295,2714,10129,862,3012,2400,2563,1292,5252,5100,152,5100,3069,2031,2022-01-01,zipcode,Roselle park
ZCTA5 07205,34,22262,89804,1596,339700,17748,4966,15070,2148,4703,3828,2981,1410,7749,7248,501,7248,5066,2182,2022-01-01,zipcode,Hillside
ZCTA5 07206,34,30364,54206,1457,296300,22797,9070,18283,6747,6967,3376,706,487,9520,8839,681,8839,2350,6489,2022-01-01,zipcode,Elizabethport
ZCTA5 07208,34,32632,59085,1309,408700,26053,7561,21820,4495,7850,4593,3312,1570,13020,12119,901,12119,3238,8881,2022-01-01,zipcode,Elizabeth
ZCTA5 07302,34,53237,165235,2792,862800,45727,8141,43574,1582,4027,3699,17156,17110,28503,26529,1974,26529,6595,19934,2022-01-01,zipcode,Jersey city
ZCTA5 07304,34,50805,65504,1500,466000,39126,13224,33843,3626,9751,6889,8475,5102,20664,19122,1542,19122,5494,13628,2022-01-01,zipcode,Jersey city
ZCTA5 07305,34,70738,73735,1523,400600,55019,19772,47259,5894,14473,11502,10054,5336,27736,25628,2108,25628,10968,14660,2022-01-01,zipcode,Jersey city
ZCTA5 07306,34,54779,74610,1522,477600,45076,16401,38848,4806,7997,6635,11871,7539,24342,22582,1760,22582,5292,17290,2022-01-01,zipcode,Jersey city
ZCTA5 07307,34,42184,76664,1591,546600,34731,10669,30792,4599,7460,5236,8236,5261,18688,17132,1556,17132,5748,11384,2022-01-01,zipcode,Jersey city
ZCTA5 07310,34,14371,191912,3327,859300,13117,2364,11590,137,690,752,3481,6530,7909,7122,787,7122,785,6337,2022-01-01,zipcode,Jersey city
ZCTA5 07311,34,1785,175795,3501,-666666666,1614,120,1540,25,0,30,700,785,1242,1163,79,1163,0,1163,2022-01-01,zipcode,Jersey city
ZCTA5 07401,34,6817,163875,2589,731300,5174,2084,4549,123,354,793,1816,1463,2419,2271,148,2271,1817,454,2022-01-01,zipcode,Allendale
ZCTA5 07403,34,7726,125865,1795,364200,6667,2087,5409,469,1448,1407,1247,838,3018,2949,69,2949,1935,1014,2022-01-01,zipcode,Bloomingdale
ZCTA5 07405,34,17993,125896,1563,521900,15051,4532,12781,449,2682,2492,4893,2265,6940,6810,130,6810,5448,1362,2022-01-01,zipcode,Butler
ZCTA5 07407,34,21261,84578,1979,434900,17173,5599,14760,1386,4933,3675,3199,1567,7464,7220,244,7220,3892,3328,2022-01-01,zipcode,Elmwood park
ZCTA5 07410,34,34948,141540,1836,488300,27252,8687,24074,813,3864,4466,8162,6769,12621,12309,312,12309,9755,2554,2022-01-01,zipcode,Fair lawn
ZCTA5 07416,34,5736,88557,1136,236400,4887,1783,4395,338,1853,1263,671,270,2815,2576,239,2576,1635,941,2022-01-01,zipcode,Franklin
ZCTA5 07417,34,11010,204833,3043,1135700,8686,3838,7471,76,723,896,3102,2674,3879,3770,109,3770,3316,454,2022-01-01,zipcode,Franklin lakes
ZCTA5 07418,34,2473,178750,-666666666,309600,1992,580,1701,51,504,422,263,461,909,900,9,900,887,13,2022-01-01,zipcode,Glenwood
ZCTA5 07419,34,9927,112555,1711,273300,8105,2515,7209,311,2138,2420,1537,803,4339,4057,282,4057,3138,919,2022-01-01,zipcode,Hamburg
ZCTA5 07420,34,5185,99375,1714,332900,4358,1482,3935,272,1657,769,889,348,1898,1857,41,1857,1311,546,2022-01-01,zipcode,Haskell
ZCTA5 07421,34,7312,134179,2192,354300,6067,1517,5357,120,2018,1145,1519,555,3191,2803,388,2803,2563,240,2022-01-01,zipcode,Hewitt
ZCTA5 07422,34,5401,106741,1660,270700,4672,1338,4068,166,1185,1201,1127,389,2570,2149,421,2149,2066,83,2022-01-01,zipcode,Highland lakes
ZCTA5 07423,34,4234,250001,1914,949800,3092,945,2618,49,127,275,1059,1108,1561,1409,152,1409,1299,110,2022-01-01,zipcode,Ho ho kus
ZCTA5 07424,34,27474,106107,1720,449700,23639,7470,19217,1218,5069,4426,5790,2714,11133,10925,208,10925,7353,3572,2022-01-01,zipcode,Little falls
ZCTA5 07430,34,25471,120618,2186,565900,21755,7896,16807,721,2597,3558,6101,3830,9873,9644,229,9644,7759,1885,2022-01-01,zipcode,Mahwah
ZCTA5 07432,34,7011,135909,1750,559200,5801,1901,5120,236,1129,1023,1705,1027,2966,2882,84,2882,1968,914,2022-01-01,zipcode,Midland park
ZCTA5 07435,34,2453,136600,2527,455400,2101,648,1880,5,496,592,544,243,1411,1030,381,1030,787,243,2022-01-01,zipcode,Newfoundland
ZCTA5 07436,34,12731,162910,1536,535900,10354,3079,8905,275,1834,1968,2962,1866,4702,4378,324,4378,3989,389,2022-01-01,zipcode,Oakland
ZCTA5 07438,34,11209,120242,1377,385300,9191,2790,8076,460,2098,2098,2259,1161,4703,4346,357,4346,3920,426,2022-01-01,zipcode,Oak ridge
ZCTA5 07439,34,2215,107569,1538,277100,1874,482,1661,91,581,550,355,84,952,827,125,827,767,60,2022-01-01,zipcode,Ogdensburg
ZCTA5 07440,34,4620,154038,921,493800,3660,1028,3232,189,847,753,832,611,1540,1506,34,1506,1343,163,2022-01-01,zipcode,Pequannock
ZCTA5 07442,34,11052,113781,1716,373900,8848,2319,7714,404,2341,1816,2186,967,4311,4227,84,4227,3301,926,2022-01-01,zipcode,Pompton lakes
ZCTA5 07444,34,10941,111503,3370,484600,9602,4244,8309,238,1834,1975,2190,2072,4902,4704,198,4704,3843,861,2022-01-01,zipcode,Pompton plains
ZCTA5 07446,34,14739,160589,2134,657400,11585,4075,9652,348,1212,1576,4094,2422,5285,5221,64,5221,4400,821,2022-01-01,zipcode,Ramsey
ZCTA5 07450,34,26054,211154,2349,858300,19672,6743,16729,348,1400,1823,7169,5989,9119,8703,416,8703,7228,1475,2022-01-01,zipcode,Ridgewood
ZCTA5 07452,34,12086,202586,1909,786300,8542,2594,7123,177,684,959,2674,2629,3802,3652,150,3652,3298,354,2022-01-01,zipcode,Glen rock
ZCTA5 07456,34,11692,141800,2178,417500,9694,2841,8514,232,2274,1875,2768,1365,4375,4256,119,4256,4038,218,2022-01-01,zipcode,Ringwood
ZCTA5 07457,34,4081,103214,2568,383000,3434,1145,3070,89,889,738,805,549,1954,1904,50,1904,1334,570,2022-01-01,zipcode,Riverdale
ZCTA5 07458,34,11676,233669,2871,1156400,9331,3381,7982,263,801,1086,3235,2597,4046,3924,122,3924,3441,483,2022-01-01,zipcode,Saddle river
ZCTA5 07460,34,3131,105787,2220,333500,2551,810,2218,224,448,693,528,325,1391,1329,62,1329,1215,114,2022-01-01,zipcode,Stockholm
ZCTA5 07461,34,18275,103389,1467,326100,15367,4947,13013,812,4232,3993,2697,1279,7873,6980,893,6980,5802,1178,2022-01-01,zipcode,Sussex
ZCTA5 07462,34,6712,92596,1563,240300,5966,1515,5130,136,2147,1287,1123,437,3544,3042,502,3042,2453,589,2022-01-01,zipcode,Vernon
ZCTA5 07463,34,10068,150861,1964,546200,7617,2078,6920,365,1397,1388,2456,1314,3423,3423,0,3423,3104,319,2022-01-01,zipcode,Waldwick
ZCTA5 07465,34,6032,112366,2058,360200,5140,1713,4527,243,1170,1186,1439,489,2530,2420,110,2420,1972,448,2022-01-01,zipcode,Wanaque
ZCTA5 07470,34,54557,147740,2038,565700,44596,15596,36942,1608,7782,6784,12505,8263,19513,18907,606,18907,14738,4169,2022-01-01,zipcode,Wayne
ZCTA5 07480,34,14884,111786,1384,338200,12390,4006,10770,450,2828,3407,2346,1739,6333,5924,409,5924,5233,691,2022-01-01,zipcode,West milford
ZCTA5 07481,34,16802,184458,2175,885400,13224,4917,11723,411,1679,2122,4213,3298,6220,5837,383,5837,5307,530,2022-01-01,zipcode,Wyckoff
ZCTA5 07501,34,35492,38776,1353,283300,26035,10884,21223,6377,8819,4189,1580,258,13018,12172,846,12172,1648,10524,2022-01-01,zipcode,Paterson
ZCTA5 07502,34,17328,72036,1418,329700,12824,3882,10373,2181,4035,2334,1552,271,4681,4561,120,4561,2526,2035,2022-01-01,zipcode,Paterson
ZCTA5 07503,34,19625,60431,1525,313500,15381,5595,12399,2632,5458,2673,1249,387,6557,6291,266,6291,1814,4477,2022-01-01,zipcode,Paterson
ZCTA5 07504,34,13781,64810,1441,359900,10832,4087,9014,1529,3509,2132,1395,449,4349,4163,186,4163,1492,2671,2022-01-01,zipcode,Paterson
ZCTA5 07505,34,4592,23780,1009,375000,3720,2086,3261,1040,1510,347,292,72,1613,1552,61,1552,54,1498,2022-01-01,zipcode,Paterson
ZCTA5 07506,34,19456,105168,1746,481500,16287,4510,14867,818,3728,3517,4559,2245,7887,7585,302,7585,5148,2437,2022-01-01,zipcode,Hawthorne
ZCTA5 07508,34,23631,95711,1693,412500,19069,6687,16702,1872,6158,3760,3330,1582,8361,8064,297,8064,5102,2962,2022-01-01,zipcode,Haledon
ZCTA5 07512,34,10975,112097,1620,470700,8728,2878,7869,550,2438,2079,1978,824,3860,3781,79,3781,2929,852,2022-01-01,zipcode,Totowa
ZCTA5 07513,34,11069,71023,1524,344200,8430,2621,7410,1605,3125,1833,596,251,3253,3161,92,3161,1000,2161,2022-01-01,zipcode,Paterson
ZCTA5 07514,34,18461,56686,1406,271200,13952,4735,12171,2606,5047,3070,1108,340,6817,6167,650,6167,1912,4255,2022-01-01,zipcode,Paterson
ZCTA5 07522,34,22377,46711,1368,209400,16481,5731,13304,2839,6173,2888,1094,310,7613,7140,473,7140,1498,5642,2022-01-01,zipcode,Paterson
ZCTA5 07524,34,15139,47889,1377,353200,11216,3848,9304,2208,4416,1434,1001,245,4740,4471,269,4471,1120,3351,2022-01-01,zipcode,Paterson
ZCTA5 07601,34,45758,79133,1750,353000,39348,11978,35651,4868,8683,7573,8993,5534,20883,19770,1113,19770,7214,12556,2022-01-01,zipcode,Hackensack
ZCTA5 07603,34,8940,113260,1771,429100,7296,2265,6409,683,1386,1942,1260,1138,3316,3199,117,3199,2155,1044,2022-01-01,zipcode,Bogota
ZCTA5 07604,34,12080,114219,1587,488700,9930,2982,8513,558,2239,2134,2152,1430,4540,4283,257,4283,3049,1234,2022-01-01,zipcode,Hasbrouck heights
ZCTA5 07605,34,9291,110583,1947,619700,7597,2524,6611,475,731,1361,2575,1469,3579,3441,138,3441,2310,1131,2022-01-01,zipcode,Leonia
ZCTA5 07606,34,2820,87813,1801,447000,2299,730,1973,256,730,427,425,135,975,918,57,918,458,460,2022-01-01,zipcode,South hackensack
ZCTA5 07607,34,10040,119057,1880,470100,8498,2929,7430,520,1821,1896,1886,1307,3848,3702,146,3702,2593,1109,2022-01-01,zipcode,Maywood
ZCTA5 07608,34,91,-666666666,1783,-666666666,71,31,62,14,14,16,13,5,27,27,0,27,0,27,2022-01-01,zipcode,Teterboro
ZCTA5 07620,34,1449,228194,2750,2000001,1152,515,1018,30,86,99,454,349,594,515,79,515,480,35,2022-01-01,zipcode,Alpine
ZCTA5 07621,34,28223,121738,1651,437700,22836,7154,19458,1574,4802,4245,6574,2263,9580,9306,274,9306,6473,2833,2022-01-01,zipcode,Bergenfield
ZCTA5 07624,34,8555,181652,2558,774100,6527,1903,5666,273,783,831,2050,1729,2881,2721,160,2721,2194,527,2022-01-01,zipcode,Closter
ZCTA5 07626,34,9105,162430,2075,722000,7123,2526,6214,272,999,1350,2077,1516,3136,3060,76,3060,2461,599,2022-01-01,zipcode,Cresskill
ZCTA5 07627,34,4930,165119,3501,938700,3639,1310,3284,25,214,561,1247,1237,1743,1690,53,1690,1437,253,2022-01-01,zipcode,Demarest
ZCTA5 07628,34,18014,116708,1710,439800,15150,4649,12754,703,3369,3002,3534,2146,6815,6593,222,6593,4760,1833,2022-01-01,zipcode,Dumont
ZCTA5 07630,34,7281,141908,2024,610800,5988,2011,5322,159,1018,1516,1800,829,2664,2626,38,2626,2321,305,2022-01-01,zipcode,Emerson
ZCTA5 07631,34,29109,93134,1729,453200,23982,7500,21014,1871,4637,5244,4724,4538,12277,11317,960,11317,6178,5139,2022-01-01,zipcode,Englewood
ZCTA5 07632,34,5347,213261,3501,1231400,4373,1530,3905,142,387,424,1302,1650,2049,1860,189,1860,1539,321,2022-01-01,zipcode,Englewood cliffs
ZCTA5 07640,34,4826,183138,3501,689900,3806,1391,3344,59,355,588,1548,794,1819,1737,82,1737,1696,41,2022-01-01,zipcode,Harrington park
ZCTA5 07641,34,3342,215972,-666666666,777400,2498,853,2139,64,248,338,719,770,1184,1069,115,1069,993,76,2022-01-01,zipcode,Haworth
ZCTA5 07642,34,10125,175802,1755,636600,8335,2345,6852,259,998,1288,2465,1842,3515,3416,99,3416,3102,314,2022-01-01,zipcode,Hillsdale
ZCTA5 07643,34,10954,72722,1705,389800,9500,2826,8148,821,2408,2164,1923,832,4466,4334,132,4334,1742,2592,2022-01-01,zipcode,Little ferry
ZCTA5 07644,34,25969,80044,1596,423900,21233,6956,18116,2768,5582,4672,3188,1906,9826,9279,547,9279,4112,5167,2022-01-01,zipcode,Lodi
ZCTA5 07645,34,8413,175179,2038,673700,6888,2552,6036,325,1023,1426,1884,1378,3123,3066,57,3066,2576,490,2022-01-01,zipcode,Montvale
ZCTA5 07646,34,16888,107976,1669,480000,13277,3683,11815,721,2332,3004,3815,1943,6360,6170,190,6170,3920,2250,2022-01-01,zipcode,New milford
ZCTA5 07647,34,5336,122222,1697,554300,4395,1879,3754,212,868,627,1405,642,1719,1704,15,1704,1341,363,2022-01-01,zipcode,Northvale
ZCTA5 07648,34,5657,156630,2121,633800,4638,1831,3957,144,809,670,1428,906,2028,1964,64,1964,1667,297,2022-01-01,zipcode,Norwood
ZCTA5 07649,34,8208,196023,1917,692200,6495,2136,5353,76,702,782,2155,1638,2780,2733,47,2733,2460,273,2022-01-01,zipcode,Oradell
ZCTA5 07650,34,20231,93250,1897,671400,17713,5715,15450,1352,3189,2448,6601,1860,7413,7119,294,7119,2669,4450,2022-01-01,zipcode,Palisades park
ZCTA5 07652,34,26582,136824,2648,684800,22387,9186,19461,1047,4481,4148,6322,3463,8900,8410,490,8410,6853,1557,2022-01-01,zipcode,Paramus
ZCTA5 07656,34,9098,164241,1887,661300,7744,2568,6475,286,1240,1384,2191,1374,3441,3203,238,3203,2629,574,2022-01-01,zipcode,Park ridge
ZCTA5 07657,34,11465,105609,1782,556000,9790,3217,8444,644,2069,1820,2618,1293,4120,4028,92,4028,1859,2169,2022-01-01,zipcode,Ridgefield
ZCTA5 07660,34,13161,94047,1598,444600,10533,2757,9292,804,2615,2694,2013,1166,5453,5070,383,5070,2775,2295,2022-01-01,zipcode,Ridgefield park
ZCTA5 07661,34,12022,150073,1789,625000,9642,2976,8341,174,636,1525,3748,2258,4468,4369,99,4369,3414,955,2022-01-01,zipcode,River edge
ZCTA5 07662,34,5790,110944,1683,455400,5107,1745,4388,401,1156,882,1489,460,2446,2376,70,2376,1876,500,2022-01-01,zipcode,Rochelle park
ZCTA5 07663,34,14320,123238,1912,440800,11639,3394,10327,765,2798,3150,2498,1116,5458,5321,137,5321,3572,1749,2022-01-01,zipcode,Saddle brook
ZCTA5 07666,34,41427,130080,1721,479700,33183,10914,27263,1574,5316,5518,7476,7379,13770,13333,437,13333,10376,2957,2022-01-01,zipcode,Teaneck
ZCTA5 07670,34,15299,207652,3053,951100,11039,3615,9746,108,604,1093,3509,4432,5247,5076,171,5076,3772,1304,2022-01-01,zipcode,Tenafly
ZCTA5 07675,34,26989,168662,2143,655400,21514,6824,18582,833,2723,3524,6508,4994,10084,9609,475,9609,7390,2219,2022-01-01,zipcode,Westwood
ZCTA5 07676,34,9268,155930,2057,616800,7496,2775,6772,203,1122,1405,2927,1115,3425,3362,63,3362,3200,162,2022-01-01,zipcode,Township of washington
ZCTA5 07677,34,6096,227500,2120,891300,4820,1847,4226,87,605,395,1830,1309,2174,2120,54,2120,1878,242,2022-01-01,zipcode,Woodcliff lake
ZCTA5 07701,34,25253,109911,1900,489600,21046,6938,19062,1011,4009,4017,6055,3970,11474,11091,383,11091,7343,3748,2022-01-01,zipcode,Red bank
ZCTA5 07702,34,4138,158065,3501,698900,3135,1295,2708,76,420,439,1008,765,1399,1388,11,1388,1201,187,2022-01-01,zipcode,Shrewsbury
ZCTA5 07703,34,0,-666666666,-666666666,-666666666,0,0,0,0,0,0,0,0,76,0,76,0,0,0,2022-01-01,zipcode,Fort monmouth
ZCTA5 07704,34,6221,229643,3501,898200,4486,1339,3937,115,212,496,1964,1150,2116,2106,10,2106,1954,152,2022-01-01,zipcode,Fair haven
ZCTA5 07711,34,1811,125750,1567,921200,1393,529,1267,13,167,207,453,427,905,637,268,637,534,103,2022-01-01,zipcode,Allenhurst
ZCTA5 07712,34,39271,91275,1437,504100,32664,9817,29308,2164,6229,6584,8614,5717,18928,17324,1604,17324,8746,8578,2022-01-01,zipcode,Asbury park
ZCTA5 07716,34,8279,111611,1795,572700,7117,2447,6469,341,1585,1619,2048,876,3816,3661,155,3661,2438,1223,2022-01-01,zipcode,Atlantic highlands
ZCTA5 07717,34,1792,106563,1628,1168500,1599,642,1425,34,198,179,581,433,1260,868,392,868,594,274,2022-01-01,zipcode,Avon by the sea
ZCTA5 07718,34,6667,160154,1542,460600,5193,1376,4697,205,1082,1393,1600,417,2451,2411,40,2411,2288,123,2022-01-01,zipcode,Belford
ZCTA5 07719,34,21994,116116,1695,589600,18833,6316,16394,627,3387,3967,5738,2675,10698,9034,1664,9034,6651,2383,2022-01-01,zipcode,Belmar
ZCTA5 07720,34,4151,89967,1678,830400,3629,1341,3301,322,444,534,1063,938,2670,1923,747,1923,878,1045,2022-01-01,zipcode,Bradley beach
ZCTA5 07721,34,3958,105302,1912,337500,3189,904,2538,305,573,553,649,458,1503,1466,37,1466,746,720,2022-01-01,zipcode,Cliffwood
ZCTA5 07722,34,10014,185417,2475,847000,8056,2622,6839,142,692,1507,2199,2299,3697,3546,151,3546,3260,286,2022-01-01,zipcode,Colts neck
ZCTA5 07723,34,728,73796,1345,1382600,623,285,462,35,145,125,84,73,1230,296,934,296,163,133,2022-01-01,zipcode,Deal
ZCTA5 07724,34,23739,96794,1557,438000,20053,6374,17243,1246,4072,4497,4313,3115,10136,9848,288,9848,6994,2854,2022-01-01,zipcode,Eatontown
ZCTA5 07726,34,44707,144470,1798,568200,36106,12117,31851,982,6132,7238,10763,6736,16887,16290,597,16290,14179,2111,2022-01-01,zipcode,Englishtown
ZCTA5 07727,34,6982,129857,1436,578000,5662,2035,5020,108,1344,1147,1538,883,2842,2588,254,2588,2171,417,2022-01-01,zipcode,Farmingdale
ZCTA5 07728,34,56896,104417,1768,454400,45600,15258,38971,3470,8446,9100,11060,6895,21505,20738,767,20738,16046,4692,2022-01-01,zipcode,Freehold
ZCTA5 07730,34,16720,118034,1188,434400,14220,4694,12382,619,4541,3133,2799,1290,6449,6370,79,6370,5796,574,2022-01-01,zipcode,Hazlet
ZCTA5 07731,34,39684,129501,2164,418700,31531,9315,26539,1531,7444,6732,6966,3866,13666,13289,377,13289,11966,1323,2022-01-01,zipcode,Howell
ZCTA5 07732,34,4740,87039,1725,398200,4131,1403,3949,346,656,966,1041,940,2963,2536,427,2536,1705,831,2022-01-01,zipcode,Highlands
ZCTA5 07733,34,17130,171071,3115,801100,13786,5499,11858,326,1445,2221,4334,3532,6158,6026,132,6026,5443,583,2022-01-01,zipcode,Holmdel
ZCTA5 07734,34,13540,84508,1558,283200,11129,4057,9542,1351,3719,2668,1454,350,5715,5101,614,5101,3079,2022,2022-01-01,zipcode,Keansburg
ZCTA5 07735,34,19369,93839,1328,342000,16341,5003,14569,1229,4220,4572,2856,1692,8455,7895,560,7895,6095,1800,2022-01-01,zipcode,Keyport
ZCTA5 07737,34,4181,126136,1440,433800,3367,881,2741,54,753,613,1021,300,1641,1490,151,1490,1332,158,2022-01-01,zipcode,Leonardo
ZCTA5 07738,34,6793,186875,871,674300,5368,1925,4686,59,713,881,1802,1231,2407,2324,83,2324,2119,205,2022-01-01,zipcode,Lincroft
ZCTA5 07739,34,6104,216974,3501,817200,4791,1452,4282,46,337,574,1879,1446,2338,2248,90,2248,2162,86,2022-01-01,zipcode,Little silver
ZCTA5 07740,34,32091,72520,1646,450400,25941,9012,21071,3361,6066,4390,4058,3196,15111,12876,2235,12876,5520,7356,2022-01-01,zipcode,Long branch
ZCTA5 07746,34,18230,179102,2736,609200,14463,5307,12188,284,1719,1917,4266,4002,6051,5984,67,5984,5715,269,2022-01-01,zipcode,Marlboro
ZCTA5 07747,34,32749,123183,1894,438200,27137,7856,24469,1018,5649,5674,7949,4179,13544,13137,407,13137,10019,3118,2022-01-01,zipcode,Matawan
ZCTA5 07748,34,28112,141241,1512,523400,22765,7228,19214,634,4468,4375,6391,3346,10403,10117,286,10117,8582,1535,2022-01-01,zipcode,Middletown
ZCTA5 07750,34,3199,144792,2097,912700,2852,1147,2614,30,346,453,961,824,1913,1520,393,1520,1183,337,2022-01-01,zipcode,Monmouth beach
ZCTA5 07751,34,21311,168351,2443,658800,16877,5818,14000,484,2008,2559,4461,4488,7546,7231,315,7231,6548,683,2022-01-01,zipcode,Morganville
ZCTA5 07753,34,37243,85352,1639,370200,31532,11234,26962,1771,6818,8430,6816,3127,16639,15885,754,15885,10723,5162,2022-01-01,zipcode,Neptune
ZCTA5 07755,34,6495,126397,2331,592200,5016,1771,3984,161,1039,1144,1050,590,2378,2027,351,2027,1635,392,2022-01-01,zipcode,Oakhurst
ZCTA5 07756,34,3246,72500,1324,771700,3158,1391,3096,225,312,480,1134,945,2853,1838,1015,1838,942,896,2022-01-01,zipcode,Ocean grove
ZCTA5 07757,34,6119,132723,-666666666,644200,5250,2093,4409,168,788,1311,1382,760,2618,2459,159,2459,2277,182,2022-01-01,zipcode,Oceanport
ZCTA5 07758,34,4462,116927,1191,431300,3754,1211,3060,137,979,973,627,344,1737,1641,96,1641,1306,335,2022-01-01,zipcode,Port monmouth
ZCTA5 07760,34,9613,201534,1891,1178200,7693,2981,6310,60,442,1070,2747,1991,3901,3471,430,3471,3018,453,2022-01-01,zipcode,Rumson
ZCTA5 07762,34,8196,111366,1693,746000,7147,3085,6507,139,907,1174,2413,1874,5004,4018,986,4018,2667,1351,2022-01-01,zipcode,Spring lake
ZCTA5 07764,34,8547,114036,1862,611600,7090,2564,4993,463,1047,1244,1439,800,3034,2747,287,2747,2008,739,2022-01-01,zipcode,West long branch
ZCTA5 07801,34,26548,70942,1714,342100,21256,6186,18200,3881,5560,4633,2905,1221,9278,8899,379,8899,4247,4652,2022-01-01,zipcode,Dover
ZCTA5 07803,34,3990,110208,1807,363600,3245,967,2779,144,746,799,864,226,1463,1396,67,1396,1269,127,2022-01-01,zipcode,Mine hill
ZCTA5 07820,34,1,-666666666,-666666666,-666666666,1,0,1,0,1,0,0,0,0,0,0,0,0,0,2022-01-01,zipcode,Allamuchy
ZCTA5 07821,34,9571,143477,1622,380300,8060,2527,6587,213,1231,1691,2068,1384,3893,3567,326,3567,3237,330,2022-01-01,zipcode,Andover
ZCTA5 07822,34,947,105882,-666666666,424300,719,262,579,8,145,170,177,79,350,322,28,322,322,0,2022-01-01,zipcode,Augusta
ZCTA5 07823,34,7644,75104,866,292300,6744,2881,6096,358,2377,1772,962,627,3669,3558,111,3558,2321,1237,2022-01-01,zipcode,Belvidere
ZCTA5 07825,34,9723,120436,1479,400800,8229,3258,7122,501,2045,1818,2066,692,3769,3519,250,3519,3131,388,2022-01-01,zipcode,Blairstown
ZCTA5 07826,34,5529,112277,1669,341900,4703,1590,4137,179,1381,1085,1016,476,2699,2171,528,2171,1917,254,2022-01-01,zipcode,Branchville
ZCTA5 07827,34,4117,103594,1350,277900,3358,1262,3031,73,939,956,716,347,1940,1626,314,1626,1492,134,2022-01-01,zipcode,Montague
ZCTA5 07828,34,14083,90120,1443,386000,11330,2500,10147,615,2569,2641,2566,1756,5899,5697,202,5697,3050,2647,2022-01-01,zipcode,Budd lake
ZCTA5 07830,34,7748,168900,1614,609800,6365,2152,5799,126,870,1139,1725,1939,2884,2863,21,2863,2703,160,2022-01-01,zipcode,Califon
ZCTA5 07832,34,3175,110250,1676,321100,2550,896,2339,170,585,725,611,248,1412,1256,156,1256,1136,120,2022-01-01,zipcode,Columbia
ZCTA5 07833,34,112,56875,-666666666,243800,112,40,112,0,40,50,6,16,61,61,0,61,61,0,2022-01-01,zipcode,Delaware
ZCTA5 07834,34,18048,155356,1777,512700,14863,4828,13008,318,2073,2717,4603,3297,7318,6773,545,6773,5746,1027,2022-01-01,zipcode,Denville
ZCTA5 07836,34,12034,141646,1822,482300,9708,2751,8393,521,1518,2294,2298,1762,4793,4638,155,4638,3174,1464,2022-01-01,zipcode,Flanders
ZCTA5 07838,34,3190,108810,1777,363600,2787,824,2321,84,682,568,769,218,1303,1234,69,1234,1082,152,2022-01-01,zipcode,Great meadows
ZCTA5 07840,34,32952,104664,1417,353500,27184,8857,22968,1059,5381,5459,7351,3718,13001,12790,211,12790,9062,3728,2022-01-01,zipcode,Hackettstown
ZCTA5 07842,34,0,-666666666,-666666666,-666666666,0,0,0,0,0,0,0,0,0,0,0,0,0,0,2022-01-01,zipcode,Hibernia
ZCTA5 07843,34,11102,105262,1608,286500,9194,2416,8327,330,2677,2503,1823,994,4977,4399,578,4399,3770,629,2022-01-01,zipcode,Hopatcong
ZCTA5 07846,34,22,-666666666,-666666666,-666666666,22,8,16,0,4,8,4,0,8,8,0,8,8,0,2022-01-01,zipcode,Johnsonburg
ZCTA5 07847,34,1685,77519,2062,325700,1359,511,1296,96,427,458,213,102,709,701,8,701,573,128,2022-01-01,zipcode,Kenvil
ZCTA5 07848,34,4425,107500,1407,406000,3790,1664,3615,305,1147,803,931,429,1650,1550,100,1550,1333,217,2022-01-01,zipcode,Lafayette
ZCTA5 07849,34,8573,115670,1537,407900,7073,2360,6243,313,1618,1656,1605,1051,3610,3308,302,3308,2963,345,2022-01-01,zipcode,Lake hopatcong
ZCTA5 07850,34,7266,95739,1667,351300,5937,1878,4755,193,1209,1585,1149,619,2629,2475,154,2475,1894,581,2022-01-01,zipcode,Landing
ZCTA5 07851,34,363,100556,-666666666,316000,282,108,260,16,22,74,131,17,175,160,15,160,144,16,2022-01-01,zipcode,Layton
ZCTA5 07852,34,4095,92115,1547,426600,3646,1209,2790,135,354,634,1241,426,1622,1578,44,1578,1315,263,2022-01-01,zipcode,Ledgewood
ZCTA5 07853,34,12548,196011,1760,561300,10213,3476,8426,166,1180,1510,2995,2575,4468,4266,202,4266,4089,177,2022-01-01,zipcode,Long valley
ZCTA5 07856,34,4429,95398,2299,381600,3752,1265,3274,148,794,947,955,430,2377,1915,462,1915,1267,648,2022-01-01,zipcode,Mount arlington
ZCTA5 07857,34,3564,84375,1383,332600,3072,914,2752,237,752,708,877,178,2018,1894,124,1894,978,916,2022-01-01,zipcode,Netcong
ZCTA5 07860,34,26507,103876,1396,319100,22331,8009,19767,1051,5755,5443,4630,2888,11630,10347,1283,10347,8272,2075,2022-01-01,zipcode,Newton
ZCTA5 07863,34,3582,87841,1341,263600,3267,1231,2851,195,1207,567,613,269,1536,1506,30,1506,1303,203,2022-01-01,zipcode,Oxford
ZCTA5 07865,34,2533,128558,1943,418100,1891,566,1532,157,401,392,402,180,792,755,37,755,594,161,2022-01-01,zipcode,Port murray
ZCTA5 07866,34,22383,123710,1600,409900,18230,5562,15733,592,2643,4002,5343,3153,8471,8381,90,8381,6982,1399,2022-01-01,zipcode,Rockaway
ZCTA5 07869,34,26058,166618,1739,618400,20320,6558,17379,720,1783,3167,6513,5196,9267,9086,181,9086,6834,2252,2022-01-01,zipcode,Randolph
ZCTA5 07870,34,29,-666666666,-666666666,-666666666,29,3,29,13,3,0,13,0,13,13,0,13,13,0,2022-01-01,zipcode,Schooleys mountain
ZCTA5 07871,34,21020,159924,1800,454900,16592,5018,14377,234,2279,3126,5287,3451,8222,7675,547,7675,6899,776,2022-01-01,zipcode,Sparta
ZCTA5 07874,34,8534,125732,1859,302900,6997,1568,5942,287,1664,1685,1673,633,3206,3124,82,3124,2835,289,2022-01-01,zipcode,Stanhope
ZCTA5 07876,34,9527,162895,2105,467900,7887,2378,6954,192,1756,1705,2098,1203,3369,3232,137,3232,2997,235,2022-01-01,zipcode,Succasunna
ZCTA5 07878,34,740,99684,-666666666,406600,650,310,560,0,247,106,135,72,311,311,0,311,311,0,2022-01-01,zipcode,Mount tabor
ZCTA5 07880,34,357,107235,-666666666,378600,278,66,237,20,54,141,7,15,101,101,0,101,87,14,2022-01-01,zipcode,Vienna
ZCTA5 07881,34,8,-666666666,-666666666,-666666666,8,4,8,0,0,8,0,0,6,4,2,4,4,0,2022-01-01,zipcode,
ZCTA5 07882,34,14670,89130,1252,312700,11885,3847,10165,579,3778,2529,2372,907,6273,5892,381,5892,3932,1960,2022-01-01,zipcode,Washington
ZCTA5 07885,34,11673,102578,1878,324600,9515,2796,8537,441,2851,2065,2316,864,5000,4580,420,4580,2956,1624,2022-01-01,zipcode,Wharton
ZCTA5 07901,34,24281,170275,2146,904500,19028,5752,16346,749,1893,2028,5564,6112,9251,8727,524,8727,5919,2808,2022-01-01,zipcode,Summit
ZCTA5 07920,34,28460,174754,2262,732900,23011,8895,19418,706,2119,2345,6742,7506,10753,10400,353,10400,8709,1691,2022-01-01,zipcode,Basking ridge
ZCTA5 07921,34,7573,125893,2164,419100,6586,1967,5935,92,770,1276,2081,1716,3907,3845,62,3845,3003,842,2022-01-01,zipcode,Bedminster
ZCTA5 07922,34,12078,195162,-666666666,684600,9769,3641,8552,215,1032,1133,3103,3069,4322,4153,169,4153,3965,188,2022-01-01,zipcode,Berkeley heights
ZCTA5 07924,34,7746,218971,2003,712900,6008,1974,5240,359,737,562,2084,1498,2702,2630,72,2630,2333,297,2022-01-01,zipcode,Bernardsville
ZCTA5 07926,34,69,-666666666,-666666666,-666666666,39,0,39,0,0,15,24,0,24,24,0,24,11,13,2022-01-01,zipcode,Brookside
ZCTA5 07927,34,4181,138304,2846,592400,3382,866,3024,335,671,319,943,756,1783,1713,70,1713,1018,695,2022-01-01,zipcode,Cedar knolls
ZCTA5 07928,34,19559,223547,2277,976200,14458,5162,12408,119,969,1203,4953,5164,6833,6635,198,6635,5541,1094,2022-01-01,zipcode,Chatham
ZCTA5 07930,34,8138,208750,1674,738100,6536,2338,5392,62,645,908,1958,1819,2854,2758,96,2758,2539,219,2022-01-01,zipcode,Chester
ZCTA5 07931,34,3399,155703,2625,986000,2878,1296,2445,32,459,367,760,827,1387,1237,150,1237,1081,156,2022-01-01,zipcode,Far hills
ZCTA5 07932,34,10941,140602,2891,699000,9414,3430,8117,136,1079,1403,2698,2801,4724,4476,248,4476,3094,1382,2022-01-01,zipcode,Florham park
ZCTA5 07933,34,2661,129141,-666666666,594000,2304,759,2088,104,211,393,908,472,996,996,0,996,931,65,2022-01-01,zipcode,Gillette
ZCTA5 07934,34,1575,211250,2136,778100,1224,427,1116,13,84,215,443,361,629,629,0,629,520,109,2022-01-01,zipcode,Gladstone
ZCTA5 07935,34,472,143250,-666666666,763700,415,189,374,0,91,24,145,114,196,186,10,186,186,0,2022-01-01,zipcode,Green village
ZCTA5 07936,34,11102,143365,3033,669000,9377,3196,8067,425,2123,1148,2436,1935,4015,3908,107,3908,3677,231,2022-01-01,zipcode,East hanover
ZCTA5 07939,34,330,-666666666,-666666666,-666666666,330,330,322,17,155,88,35,27,17,17,0,17,0,17,2022-01-01,zipcode,Lyons
ZCTA5 07940,34,17798,163643,2168,845500,14480,4571,10565,306,1561,1182,4118,3398,5769,5541,228,5541,3529,2012,2022-01-01,zipcode,Madison
ZCTA5 07945,34,9698,234150,2833,883100,7822,2743,6675,76,629,895,2592,2483,3458,3390,68,3390,3054,336,2022-01-01,zipcode,Mendham
ZCTA5 07946,34,2991,203393,-666666666,741700,2477,894,2241,64,437,350,788,602,1029,971,58,971,939,32,2022-01-01,zipcode,Millington
ZCTA5 07950,34,21738,146903,2516,556400,17963,5926,16113,663,2228,2401,5239,5582,8349,8176,173,8176,6287,1889,2022-01-01,zipcode,Morris plains
ZCTA5 07960,34,46560,146024,2154,678700,39025,12505,33996,1458,5054,4277,12528,10679,19133,18499,634,18499,11570,6929,2022-01-01,zipcode,Morristown
ZCTA5 07961,34,343,-666666666,-666666666,-666666666,343,120,30,0,10,5,2,13,0,0,0,0,0,0,2022-01-01,zipcode,Convent station
ZCTA5 07970,34,257,-666666666,-666666666,-666666666,171,63,139,0,0,0,114,25,71,71,0,71,71,0,2022-01-01,zipcode,Mount freedom
ZCTA5 07974,34,12911,170386,1974,698100,9804,3700,8721,231,1298,974,3008,3210,4881,4615,266,4615,3915,700,2022-01-01,zipcode,New providence
ZCTA5 07976,34,355,-666666666,-666666666,2000001,303,195,303,0,54,101,100,48,158,158,0,158,87,71,2022-01-01,zipcode,New vernon
ZCTA5 07977,34,689,-666666666,1719,1020800,578,248,411,13,144,48,156,50,247,213,34,213,110,103,2022-01-01,zipcode,Peapack
ZCTA5 07979,34,246,-666666666,-666666666,-666666666,215,28,162,0,6,0,98,58,82,82,0,82,82,0,2022-01-01,zipcode,Pottersville
ZCTA5 07980,34,2978,140313,1736,622700,2217,702,1997,26,300,431,683,557,908,908,0,908,681,227,2022-01-01,zipcode,Stirling
ZCTA5 07981,34,8938,144573,2620,604900,7542,2588,6566,128,1456,1305,2129,1548,3807,3726,81,3726,3324,402,2022-01-01,zipcode,Whippany
ZCTA5 08001,34,835,129375,1578,292200,789,260,615,0,214,271,91,39,339,308,31,308,254,54,2022-01-01,zipcode,Alloway
ZCTA5 08002,34,23630,103031,1773,280900,19428,6343,17142,1522,3814,4289,4165,3352,10060,9304,756,9304,6350,2954,2022-01-01,zipcode,Cherry hill
ZCTA5 08003,34,31434,145590,1717,385100,25451,8844,22674,934,3499,3563,7353,7325,12060,11485,575,11485,9869,1616,2022-01-01,zipcode,Cherry hill
ZCTA5 08004,34,10966,97821,1396,244000,9541,3198,8563,1068,3027,2337,1631,500,4136,4014,122,4014,3315,699,2022-01-01,zipcode,Atco
ZCTA5 08005,34,25578,84425,1770,315300,22121,10292,19502,1311,7451,4848,3646,2246,11694,10385,1309,10385,9306,1079,2022-01-01,zipcode,Barnegat
ZCTA5 08006,34,435,93958,-666666666,921900,372,239,351,4,32,58,153,104,1264,201,1063,201,188,13,2022-01-01,zipcode,Barnegat light
ZCTA5 08007,34,5560,87761,1146,222100,4769,1538,4263,233,1366,1170,1067,427,2600,2528,72,2528,1435,1093,2022-01-01,zipcode,Barrington
ZCTA5 08008,34,6995,110568,1719,964000,6512,3393,6090,188,1027,1040,2248,1587,17264,3421,13843,3421,3129,292,2022-01-01,zipcode,Beach haven
ZCTA5 08009,34,14483,94351,1459,274200,11814,3843,9990,618,3035,3046,2260,1031,5762,5523,239,5523,4306,1217,2022-01-01,zipcode,Berlin
ZCTA5 08010,34,11458,80663,1404,216300,9379,3179,8107,573,2897,2532,1492,613,4775,4229,546,4229,3076,1153,2022-01-01,zipcode,Beverly
ZCTA5 08011,34,53,-666666666,-666666666,-666666666,53,9,29,9,9,0,11,0,9,9,0,9,9,0,2022-01-01,zipcode,Birmingham
ZCTA5 08012,34,40320,86872,1461,253800,32832,10353,28248,1727,9115,8147,6689,2570,16282,15487,795,15487,10448,5039,2022-01-01,zipcode,Blackwood
ZCTA5 08014,34,294,-666666666,-666666666,212500,261,116,227,0,154,73,0,0,156,91,65,91,91,0,2022-01-01,zipcode,Bridgeport
ZCTA5 08015,34,19164,75040,1164,199800,15967,5698,13413,2067,4900,3965,1603,878,7841,7131,710,7131,5971,1160,2022-01-01,zipcode,Browns mills
ZCTA5 08016,34,34710,88691,1220,286600,28077,8986,24345,2207,6639,7453,5600,2446,13896,12907,989,12907,9519,3388,2022-01-01,zipcode,Burlington
ZCTA5 08019,34,946,150938,2219,358100,755,186,691,47,277,183,147,37,393,355,38,355,310,45,2022-01-01,zipcode,Chatsworth
ZCTA5 08020,34,2834,120357,-666666666,327400,2208,905,2187,90,782,641,485,189,1100,1100,0,1100,1038,62,2022-01-01,zipcode,Clarksboro
ZCTA5 08021,34,47946,63881,1194,178800,38453,12437,34265,3594,12477,9855,5866,2473,21850,20321,1529,20321,10106,10215,2022-01-01,zipcode,Clementon
ZCTA5 08022,34,9124,113224,1348,380200,7897,3339,6876,299,1690,1888,1685,1314,3745,3636,109,3636,3473,163,2022-01-01,zipcode,Columbus
ZCTA5 08023,34,282,50833,1682,153800,261,91,221,6,105,104,0,6,139,98,41,98,70,28,2022-01-01,zipcode,Deepwater
ZCTA5 08026,34,2278,93103,-666666666,264800,1809,801,1586,116,621,431,276,142,830,782,48,782,711,71,2022-01-01,zipcode,Gibbsboro
ZCTA5 08027,34,4921,90345,1320,217600,4149,1682,3742,321,1447,904,704,366,2033,1958,75,1958,1642,316,2022-01-01,zipcode,Gibbstown
ZCTA5 08028,34,24360,79810,1465,259300,21346,8440,13612,955,3545,3620,3558,1934,8828,7921,907,7921,4955,2966,2022-01-01,zipcode,Glassboro
ZCTA5 08029,34,5850,83857,783,201000,5037,1657,4265,319,2124,945,538,339,2414,2307,107,2307,1681,626,2022-01-01,zipcode,Glendora
ZCTA5 08030,34,13251,68325,1413,158000,9914,3446,8449,1045,3738,2234,907,525,5401,4868,533,4868,3087,1781,2022-01-01,zipcode,Gloucester city
ZCTA5 08031,34,11677,71935,1081,199600,9500,3524,8419,1031,3314,2245,1330,499,5154,4834,320,4834,2976,1858,2022-01-01,zipcode,Bellmawr
ZCTA5 08033,34,17110,148542,1377,519600,12845,3655,11531,158,1061,1651,4254,4407,6850,6466,384,6466,4850,1616,2022-01-01,zipcode,Haddonfield
ZCTA5 08034,34,19870,108458,1644,301400,16270,5658,14633,924,2895,3205,4507,3102,8071,7861,210,7861,6273,1588,2022-01-01,zipcode,Cherry hill
ZCTA5 08035,34,7570,115804,1192,341200,5991,1750,5410,212,945,1370,1917,966,3342,3184,158,3184,2457,727,2022-01-01,zipcode,Haddon heights
ZCTA5 08036,34,6024,123018,1147,388100,5072,1982,4450,109,1204,1171,1313,653,2574,2459,115,2459,2256,203,2022-01-01,zipcode,Hainesport
ZCTA5 08037,34,23392,79671,1287,280300,19667,6816,17275,1780,6344,4528,3196,1427,9980,9163,817,9163,7184,1979,2022-01-01,zipcode,Hammonton
ZCTA5 08038,34,380,87083,1405,159300,285,48,234,20,117,90,7,0,165,157,8,157,86,71,2022-01-01,zipcode,Hancocks bridge
ZCTA5 08039,34,17,-666666666,-666666666,-666666666,17,7,17,7,0,5,0,5,5,5,0,5,5,0,2022-01-01,zipcode,Harrisonville
ZCTA5 08041,34,832,139000,-666666666,475500,723,208,657,40,158,189,158,112,415,382,33,382,369,13,2022-01-01,zipcode,Jobstown
ZCTA5 08042,34,33,-666666666,-666666666,243800,29,21,29,0,20,9,0,0,19,19,0,19,19,0,2022-01-01,zipcode,Juliustown
ZCTA5 08043,34,30876,108518,1664,380400,25265,8944,21838,1204,3800,4113,6822,5899,12487,12002,485,12002,7729,4273,2022-01-01,zipcode,Voorhees
ZCTA5 08045,34,3059,74250,1087,209800,2558,1011,2313,182,850,683,195,403,1208,1146,62,1146,780,366,2022-01-01,zipcode,Lawnside
ZCTA5 08046,34,31812,88552,1923,218300,26055,8073,22706,1494,7366,7990,4086,1770,11593,10679,914,10679,8631,2048,2022-01-01,zipcode,Willingboro
ZCTA5 08048,34,12786,112540,1546,395900,10701,3154,9238,547,1860,2901,2267,1663,5089,4812,277,4812,3626,1186,2022-01-01,zipcode,Lumberton
ZCTA5 08049,34,5216,83528,1157,205400,4278,1097,3751,234,1499,859,850,309,2270,2117,153,2117,1597,520,2022-01-01,zipcode,Magnolia
ZCTA5 08050,34,27097,103030,1686,346700,22998,7988,20245,1162,6505,5254,4747,2577,13890,10697,3193,10697,9378,1319,2022-01-01,zipcode,Manahawkin
ZCTA5 08051,34,12107,95577,1653,240200,10073,3074,8662,441,3290,1989,2132,810,4562,4406,156,4406,3406,1000,2022-01-01,zipcode,Mantua
ZCTA5 08052,34,19885,71748,1452,220300,15976,5261,14066,587,5133,3818,3118,1410,9300,8680,620,8680,3978,4702,2022-01-01,zipcode,Maple shade
ZCTA5 08053,34,47200,111893,1826,349700,38665,12112,33885,1002,7215,8320,11490,5858,19900,19097,803,19097,13819,5278,2022-01-01,zipcode,Marlton
ZCTA5 08054,34,44929,111272,1872,314800,37222,11825,32841,1268,6264,7199,10979,7131,19594,18904,690,18904,14449,4455,2022-01-01,zipcode,Mount laurel
ZCTA5 08055,34,28651,152849,1552,432900,23833,8169,20876,374,3052,4462,8329,4659,10917,10534,383,10534,9249,1285,2022-01-01,zipcode,Medford
ZCTA5 08056,34,5427,141855,-666666666,401100,4045,1156,3506,69,869,712,1072,784,1798,1698,100,1698,1642,56,2022-01-01,zipcode,Mickleton
ZCTA5 08057,34,20942,159596,1400,588100,16842,5894,14635,413,1917,2494,4971,4840,8220,7633,587,7633,6545,1088,2022-01-01,zipcode,Moorestown
ZCTA5 08059,34,5521,85313,1234,203800,4510,1296,3997,228,1611,1256,629,273,2370,2231,139,2231,1440,791,2022-01-01,zipcode,Mount ephraim
ZCTA5 08060,34,25516,104377,1458,273900,21306,6120,18460,807,5024,5942,4670,2017,10243,9658,585,9658,6984,2674,2022-01-01,zipcode,Mount holly
ZCTA5 08061,34,3517,132102,-666666666,334600,2782,780,2474,53,837,659,536,389,1383,1337,46,1337,1314,23,2022-01-01,zipcode,Mount royal
ZCTA5 08062,34,17907,153047,999,439200,13812,4560,11642,561,2532,2080,3758,2711,5921,5691,230,5691,5320,371,2022-01-01,zipcode,Mullica hill
ZCTA5 08063,34,3070,82639,1168,179700,2596,908,2153,164,907,703,279,100,1121,1062,59,1062,931,131,2022-01-01,zipcode,National park
ZCTA5 08064,34,60,-666666666,-666666666,-666666666,60,45,60,0,0,29,15,16,44,44,0,44,44,0,2022-01-01,zipcode,New lisbon
ZCTA5 08065,34,7437,84866,1637,203100,6281,1673,5383,325,1762,1613,1354,329,3413,3200,213,3200,2389,811,2022-01-01,zipcode,Palmyra
ZCTA5 08066,34,7859,55147,1152,161900,6525,2453,5766,668,2036,2005,764,293,4092,3416,676,3416,2236,1180,2022-01-01,zipcode,Paulsboro
ZCTA5 08067,34,1646,105694,1609,300400,1265,419,1105,62,350,344,256,93,593,545,48,545,475,70,2022-01-01,zipcode,Pedricktown
ZCTA5 08068,34,7033,79741,1148,242600,5912,2191,5161,339,1738,1778,889,417,2930,2711,219,2711,1642,1069,2022-01-01,zipcode,Pemberton
ZCTA5 08069,34,13402,62911,1175,161000,10567,4313,9024,1237,3880,2479,1070,358,5926,5229,697,5229,2941,2288,2022-01-01,zipcode,Penns grove
ZCTA5 08070,34,12468,74518,1183,180800,10045,3805,8799,645,3559,2924,1071,600,5721,5121,600,5121,3973,1148,2022-01-01,zipcode,Pennsville
ZCTA5 08071,34,9356,92067,1336,235800,7899,2623,6919,251,1891,1826,2024,927,4084,3825,259,3825,2777,1048,2022-01-01,zipcode,Pitman
ZCTA5 08072,34,249,62738,-666666666,114800,176,62,158,13,18,37,27,63,122,104,18,104,79,25,2022-01-01,zipcode,Quinton
ZCTA5 08073,34,0,-666666666,-666666666,-666666666,0,0,0,0,0,0,0,0,0,0,0,0,0,0,2022-01-01,zipcode,Rancocas
ZCTA5 08074,34,0,-666666666,-666666666,-666666666,0,0,0,0,0,0,0,0,0,0,0,0,0,0,2022-01-01,zipcode,Richwood
ZCTA5 08075,34,30359,85504,1386,269100,24818,7734,21129,1946,6593,4955,5046,2589,12525,11810,715,11810,7930,3880,2022-01-01,zipcode,Riverside
ZCTA5 08077,34,20456,129163,1795,331600,16457,5089,14447,505,3650,3663,4241,2388,7590,7299,291,7299,6262,1037,2022-01-01,zipcode,Riverton
ZCTA5 08078,34,8005,82750,1316,184800,6407,1934,5419,333,2085,1662,1014,325,3345,3061,284,3061,2086,975,2022-01-01,zipcode,Runnemede
ZCTA5 08079,34,10426,50975,1033,169100,8172,3438,7241,958,3046,1963,838,436,5108,4168,940,4168,2381,1787,2022-01-01,zipcode,Salem
ZCTA5 08080,34,38215,114725,1676,311900,30868,10171,27069,1019,7025,7510,8244,3271,14258,13882,376,13882,12133,1749,2022-01-01,zipcode,Sewell
ZCTA5 08081,34,50604,97931,1459,236800,39706,11937,33287,2049,9388,10744,7047,4059,18534,17361,1173,17361,14359,3002,2022-01-01,zipcode,Sicklerville
ZCTA5 08083,34,9464,89964,1187,233700,7845,2349,6861,401,2118,2294,1253,795,4001,3843,158,3843,2977,866,2022-01-01,zipcode,Somerdale
ZCTA5 08084,34,6962,89200,1109,219900,5735,1830,5061,394,1672,1117,1341,537,2644,2612,32,2612,1960,652,2022-01-01,zipcode,Stratford
ZCTA5 08085,34,21364,134806,1780,329800,16393,4529,13566,878,3212,3359,3807,2310,7350,7075,275,7075,5901,1174,2022-01-01,zipcode,Swedesboro
ZCTA5 08086,34,8121,85305,1690,237600,6783,2228,5922,317,1469,2052,1281,803,3790,3556,234,3556,2437,1119,2022-01-01,zipcode,Thorofare
ZCTA5 08087,34,25057,83224,1631,289700,21363,8828,19211,996,7212,5686,3553,1764,13025,10560,2465,10560,8916,1644,2022-01-01,zipcode,Tuckerton
ZCTA5 08088,34,23988,102377,2093,323900,20417,8805,17896,1195,5599,4561,4320,2221,9799,9364,435,9364,8964,400,2022-01-01,zipcode,Vincentown
ZCTA5 08089,34,4152,104100,933,230300,3608,1146,3101,315,1063,1174,388,161,1517,1398,119,1398,1310,88,2022-01-01,zipcode,Waterford works
ZCTA5 08090,34,9843,111058,1156,247200,7517,2308,6334,310,2000,1800,1295,929,3189,3089,100,3089,2778,311,2022-01-01,zipcode,Wenonah
ZCTA5 08091,34,5881,87593,1339,239200,4964,1465,4414,473,1640,1218,872,211,2364,2266,98,2266,1527,739,2022-01-01,zipcode,West berlin
ZCTA5 08092,34,3098,94574,1159,424800,2572,787,2234,103,736,577,523,295,1412,1184,228,1184,964,220,2022-01-01,zipcode,West creek
ZCTA5 08093,34,9690,65283,1236,178800,7996,2452,6898,517,2842,2018,904,617,4706,4304,402,4304,2356,1948,2022-01-01,zipcode,Westville
ZCTA5 08094,34,41089,96741,1376,243600,32956,10611,28076,2173,9191,8878,5202,2632,15597,14910,687,14910,12504,2406,2022-01-01,zipcode,Williamstown
ZCTA5 08095,34,0,-666666666,-666666666,-666666666,0,0,0,0,0,0,0,0,0,0,0,0,0,0,2022-01-01,zipcode,Winslow
ZCTA5 08096,34,35573,91275,1368,233600,29493,9684,25462,2061,8823,6889,5236,2453,14807,13660,1147,13660,10141,3519,2022-01-01,zipcode,Woodbury
ZCTA5 08097,34,3244,110694,1328,230300,2760,991,2399,122,780,770,460,267,1179,1164,15,1164,1105,59,2022-01-01,zipcode,Woodbury heights
ZCTA5 08098,34,9475,111950,1262,294100,8044,3475,7036,711,2078,1657,1645,945,3674,3373,301,3373,2515,858,2022-01-01,zipcode,Woodstown
ZCTA5 08102,34,8418,30679,1062,83600,6810,3558,4810,1636,1453,998,305,418,3531,3058,473,3058,653,2405,2022-01-01,zipcode,Camden
ZCTA5 08103,34,12682,34434,1119,89100,10302,5476,8489,2490,3298,1912,459,330,5139,4179,960,4179,1542,2637,2022-01-01,zipcode,Camden
ZCTA5 08104,34,21656,32637,1044,79900,15144,6150,12980,2787,5005,3911,671,606,9856,8272,1584,8272,2646,5626,2022-01-01,zipcode,Camden
ZCTA5 08105,34,26615,41742,1146,105900,19547,7403,15351,5724,4852,3671,846,258,8663,8200,463,8200,3725,4475,2022-01-01,zipcode,Camden
ZCTA5 08106,34,9726,93670,1046,279500,7770,2186,6921,260,2117,1749,1776,1019,4057,3872,185,3872,2468,1404,2022-01-01,zipcode,Audubon
ZCTA5 08107,34,13568,68627,1209,238400,11030,3121,9473,914,2826,2499,2181,1053,6191,5740,451,5740,2981,2759,2022-01-01,zipcode,Oaklyn
ZCTA5 08108,34,18970,102491,1492,326400,15683,4365,14023,452,2430,3393,4125,3623,9153,8753,400,8753,5642,3111,2022-01-01,zipcode,Collingswood
ZCTA5 08109,34,23747,80527,1137,210600,19248,6396,16459,2096,5578,4358,2888,1539,9260,8796,464,8796,6380,2416,2022-01-01,zipcode,Merchantville
ZCTA5 08110,34,19465,77585,1160,175100,14919,4713,12257,3025,4072,3114,1632,414,6672,6162,510,6162,4557,1605,2022-01-01,zipcode,Pennsauken
ZCTA5 08201,34,10078,67100,1699,224900,8140,3078,7282,475,2416,2069,1883,439,4277,4086,191,4086,2641,1445,2022-01-01,zipcode,Absecon
ZCTA5 08202,34,1625,152670,1625,1468800,1531,917,1397,21,206,226,595,349,5619,816,4803,816,790,26,2022-01-01,zipcode,Avalon
ZCTA5 08203,34,7784,91307,1481,423000,7083,2835,6538,599,1522,1571,1786,1060,9191,3748,5443,3748,2696,1052,2022-01-01,zipcode,Brigantine
ZCTA5 08204,34,17392,76624,1180,345900,14519,5923,12889,708,3964,3593,3296,1328,12902,7787,5115,7787,6059,1728,2022-01-01,zipcode,Cape may
ZCTA5 08205,34,28491,83247,1509,247400,23860,8730,20747,1690,6231,5829,4347,2650,11849,11068,781,11068,8812,2256,2022-01-01,zipcode,Absecon
ZCTA5 08210,34,17377,86366,1469,311800,14364,5613,12644,941,4223,3711,2567,1202,8202,7285,917,7285,5776,1509,2022-01-01,zipcode,Cape may court house
ZCTA5 08212,34,155,82679,-666666666,984000,155,105,155,0,18,33,47,57,676,85,591,85,85,0,2022-01-01,zipcode,Cape may point
ZCTA5 08215,34,13789,74838,1163,246300,11483,4485,9914,966,3962,2718,1392,876,5827,5482,345,5482,3960,1522,2022-01-01,zipcode,Egg harbor city
ZCTA5 08217,34,0,-666666666,-666666666,-666666666,0,0,0,0,0,0,0,0,0,0,0,0,0,0,2022-01-01,zipcode,Elwood
ZCTA5 08221,34,6952,133487,1780,338700,5674,1989,5015,258,822,1047,1567,1321,2887,2655,232,2655,2394,261,2022-01-01,zipcode,Linwood
ZCTA5 08223,34,4230,98125,1565,324600,3409,1171,3226,65,664,899,865,733,2427,1893,534,1893,1640,253,2022-01-01,zipcode,Marmora
ZCTA5 08224,34,189,134464,-666666666,296700,142,38,114,0,27,32,51,4,84,57,27,57,57,0,2022-01-01,zipcode,New gretna
ZCTA5 08225,34,8432,103977,1543,252200,6937,2420,5999,406,1362,1568,1678,985,3291,3159,132,3159,2783,376,2022-01-01,zipcode,Northfield
ZCTA5 08226,34,11260,98576,1404,664100,9907,4625,8971,349,2040,1656,2827,2099,20831,5521,15310,5521,3980,1541,2022-01-01,zipcode,Ocean city
ZCTA5 08230,34,6139,109046,1801,393000,4883,1799,4239,85,1177,1080,1124,773,2700,2289,411,2289,2185,104,2022-01-01,zipcode,Ocean view
ZCTA5 08232,34,20241,49701,1127,159100,15526,5748,13235,3337,5213,3261,1036,388,7170,6438,732,6438,3216,3222,2022-01-01,zipcode,Pleasantville
ZCTA5 08234,34,46462,92681,1519,266500,36421,11038,31495,2477,10518,7432,7898,3170,17234,16186,1048,16186,13503,2683,2022-01-01,zipcode,Egg harbor township
ZCTA5 08240,34,2842,-666666666,-666666666,-666666666,2842,1503,131,0,15,39,68,9,4,4,0,4,4,0,2022-01-01,zipcode,Pomona
ZCTA5 08241,34,980,128611,-666666666,359800,873,354,817,20,237,270,186,104,464,434,30,434,423,11,2022-01-01,zipcode,Port republic
ZCTA5 08242,34,3726,88853,1704,314700,3072,1446,2904,357,993,795,309,450,2123,1754,369,1754,1296,458,2022-01-01,zipcode,Rio grande
ZCTA5 08243,34,2047,90703,1210,903100,1982,1252,1879,42,448,532,505,352,6740,1127,5613,1127,1046,81,2022-01-01,zipcode,Sea isle city
ZCTA5 08244,34,10631,67300,1218,251200,8809,2823,7701,852,2589,2168,1203,889,5870,4791,1079,4791,2457,2334,2022-01-01,zipcode,Somers point
ZCTA5 08246,34,60,-666666666,-666666666,-666666666,60,30,60,0,30,0,0,30,148,30,118,30,30,0,2022-01-01,zipcode,South seaville
ZCTA5 08247,34,977,136250,1625,1622300,953,548,861,13,132,136,363,217,3276,532,2744,532,464,68,2022-01-01,zipcode,Stone harbor
ZCTA5 08248,34,121,102162,-666666666,966200,121,45,121,0,0,51,8,62,513,64,449,64,64,0,2022-01-01,zipcode,Strathmere
ZCTA5 08251,34,10308,76018,1396,247500,8395,3352,7553,511,2887,2405,1285,465,6588,4573,2015,4573,3879,694,2022-01-01,zipcode,Villas
ZCTA5 08260,34,12680,63460,1167,416200,11500,5815,10373,692,4141,2748,1633,1159,23357,6626,16731,6626,4296,2330,2022-01-01,zipcode,Wildwood
ZCTA5 08270,34,8231,90000,1146,292100,6696,2566,5825,670,2158,1552,993,452,3740,3186,554,3186,2607,579,2022-01-01,zipcode,Woodbine
ZCTA5 08302,34,47487,58185,1229,190400,35671,15594,30255,6921,13301,6113,2619,1301,15872,14417,1455,14417,8312,6105,2022-01-01,zipcode,Bridgeton
ZCTA5 08310,34,979,43143,1098,109500,979,617,873,200,445,189,0,39,602,516,86,516,395,121,2022-01-01,zipcode,Buena
ZCTA5 08311,34,1601,72083,1250,199500,1295,588,1153,146,569,318,82,38,660,549,111,549,467,82,2022-01-01,zipcode,Cedarville
ZCTA5 08312,34,8460,88963,1180,233500,6823,2532,5941,522,2421,1803,809,386,3461,3080,381,3080,2236,844,2022-01-01,zipcode,Clayton
ZCTA5 08314,34,587,-666666666,-666666666,191700,510,187,415,47,267,42,19,40,217,217,0,217,202,15,2022-01-01,zipcode,Delmont
ZCTA5 08316,34,163,35217,-666666666,138000,151,116,144,0,20,83,7,34,163,96,67,96,60,36,2022-01-01,zipcode,Dorchester
ZCTA5 08317,34,1184,78992,-666666666,281600,1067,568,987,77,453,256,137,64,628,569,59,569,473,96,2022-01-01,zipcode,Dorothy
ZCTA5 08318,34,12069,83227,1228,244900,9960,3776,8260,639,3566,1876,1335,844,4627,4372,255,4372,3607,765,2022-01-01,zipcode,Elmer
ZCTA5 08319,34,1343,115781,-666666666,280500,1040,370,889,29,358,196,205,101,556,463,93,463,455,8,2022-01-01,zipcode,Estell manor
ZCTA5 08320,34,1053,-666666666,-666666666,-666666666,1053,1053,1032,211,601,205,15,0,0,0,0,0,0,0,2022-01-01,zipcode,Fairton
ZCTA5 08321,34,95,39583,-666666666,170800,95,56,95,13,55,0,16,11,283,57,226,57,57,0,2022-01-01,zipcode,Fortescue
ZCTA5 08322,34,10355,102243,1509,252900,8334,2605,7131,707,2924,1956,1015,529,3688,3483,205,3483,3122,361,2022-01-01,zipcode,Franklinville
ZCTA5 08323,34,683,95875,1063,255300,601,270,518,31,145,166,90,86,321,271,50,271,232,39,2022-01-01,zipcode,Greenwich
ZCTA5 08324,34,327,71196,1193,211000,259,159,192,40,88,28,36,0,130,118,12,118,53,65,2022-01-01,zipcode,Heislerville
ZCTA5 08326,34,1063,92778,1660,200900,802,276,695,62,331,139,126,37,428,370,58,370,275,95,2022-01-01,zipcode,Landisville
ZCTA5 08327,34,3836,76190,-666666666,-666666666,3832,3602,3697,738,2215,575,142,27,234,198,36,198,166,32,2022-01-01,zipcode,Leesburg
ZCTA5 08328,34,1528,93313,-666666666,201700,1280,509,1058,122,494,340,70,32,606,577,29,577,475,102,2022-01-01,zipcode,Malaga
ZCTA5 08329,34,321,61221,-666666666,302500,254,200,254,0,69,74,94,17,144,144,0,144,144,0,2022-01-01,zipcode,Mauricetown
ZCTA5 08330,34,29895,83663,1552,225900,24515,9008,21106,1439,6958,6282,4614,1813,12683,11768,915,11768,8593,3175,2022-01-01,zipcode,Mays landing
ZCTA5 08332,34,35292,64973,1223,185300,28333,10488,24826,3494,9618,7276,3101,1337,15512,14498,1014,14498,9859,4639,2022-01-01,zipcode,Millville
ZCTA5 08340,34,939,70536,1247,245300,695,335,632,41,140,284,127,40,385,385,0,385,300,85,2022-01-01,zipcode,Milmay
ZCTA5 08341,34,2286,73750,1057,190800,1804,573,1380,234,446,451,148,101,832,811,21,811,365,446,2022-01-01,zipcode,Minotola
ZCTA5 08343,34,4882,134327,2529,311300,3954,1545,3253,315,1104,695,800,339,1668,1531,137,1531,1439,92,2022-01-01,zipcode,Monroeville
ZCTA5 08344,34,4752,69449,1427,201200,4083,1510,3429,284,1474,822,550,299,2231,1887,344,1887,1780,107,2022-01-01,zipcode,Newfield
ZCTA5 08345,34,709,60268,1313,174200,578,262,541,86,284,75,69,27,438,337,101,337,310,27,2022-01-01,zipcode,Newport
ZCTA5 08346,34,430,76938,-666666666,215400,354,71,325,22,123,110,70,0,225,185,40,185,185,0,2022-01-01,zipcode,Newtonville
ZCTA5 08348,34,196,215329,-666666666,219800,185,154,175,18,97,60,0,0,66,66,0,66,58,8,2022-01-01,zipcode,Port elizabeth
ZCTA5 08349,34,2450,57050,1683,139900,1809,741,1496,144,700,569,80,3,1084,845,239,845,531,314,2022-01-01,zipcode,Port norris
ZCTA5 08350,34,518,-666666666,-666666666,234200,456,99,422,82,183,114,43,0,213,156,57,156,156,0,2022-01-01,zipcode,Richland
ZCTA5 08352,34,388,79226,1889,-666666666,204,47,157,0,47,52,40,18,85,85,0,85,35,50,2022-01-01,zipcode,Rosenhayn
ZCTA5 08353,34,305,87917,1142,192300,249,89,222,32,91,56,34,9,128,115,13,115,90,25,2022-01-01,zipcode,Shiloh
ZCTA5 08360,34,43784,61484,1146,186000,34315,13054,29429,6264,10741,7514,3539,1371,16316,15527,789,15527,10149,5378,2022-01-01,zipcode,Vineland
ZCTA5 08361,34,18886,90815,1294,260200,15108,6647,12805,1759,3012,3452,2631,1951,6928,6544,384,6544,5204,1340,2022-01-01,zipcode,Vineland
ZCTA5 08401,34,38726,35279,1059,174400,30515,12649,25366,6545,8510,5434,3305,1572,20682,16514,4168,16514,5082,11432,2022-01-01,zipcode,Atlantic city
ZCTA5 08402,34,5331,112661,1298,572100,4642,2050,4150,146,676,987,1068,1273,6846,2584,4262,2584,2319,265,2022-01-01,zipcode,Margate city
ZCTA5 08403,34,946,108750,2229,981300,876,521,836,10,202,189,224,211,1598,495,1103,495,445,50,2022-01-01,zipcode,Longport
ZCTA5 08406,34,9046,71639,1488,319900,8143,3403,7340,586,2155,1920,1579,1100,7719,4307,3412,4307,2741,1566,2022-01-01,zipcode,Ventnor city
ZCTA5 08501,34,6417,135370,1543,507800,5488,2286,4534,184,738,887,1567,1158,2514,2460,54,2460,2251,209,2022-01-01,zipcode,Allentown
ZCTA5 08502,34,11603,229272,2290,735700,9034,2581,7740,89,551,989,2771,3340,3827,3827,0,3827,3164,663,2022-01-01,zipcode,Belle mead
ZCTA5 08505,34,18067,106986,1463,341600,14471,4057,12789,500,3280,3505,3413,2091,7619,7216,403,7216,5147,2069,2022-01-01,zipcode,Bordentown
ZCTA5 08510,34,5520,190379,2204,618200,4785,1617,3740,209,699,739,1545,548,1958,1928,30,1928,1848,80,2022-01-01,zipcode,Millstone township
ZCTA5 08511,34,880,76094,1138,334000,674,129,590,116,184,125,88,77,337,329,8,329,214,115,2022-01-01,zipcode,Cookstown
ZCTA5 08512,34,12519,115000,1620,605700,10430,3626,9108,574,1805,1561,2757,2411,5019,4812,207,4812,3022,1790,2022-01-01,zipcode,Cranbury
ZCTA5 08514,34,5597,120811,1425,485900,4430,1628,3750,219,1154,882,1133,362,2266,2071,195,2071,1917,154,2022-01-01,zipcode,Cream ridge
ZCTA5 08515,34,7857,189353,2165,501900,6008,1736,5042,201,1035,737,1846,1223,2401,2333,68,2333,2217,116,2022-01-01,zipcode,Chesterfield
ZCTA5 08518,34,5660,102548,1231,266500,4418,868,3996,403,1127,1367,829,270,2221,2123,98,2123,1447,676,2022-01-01,zipcode,Florence
ZCTA5 08520,34,29296,115931,1533,339600,23664,7175,20401,1561,5027,4014,5942,3857,11090,10480,610,10480,7377,3103,2022-01-01,zipcode,Hightstown
ZCTA5 08525,34,4554,150278,1809,496500,3846,816,3393,120,576,546,1217,934,2019,1928,91,1928,1611,317,2022-01-01,zipcode,Hopewell
ZCTA5 08527,34,57943,108039,1673,440600,45240,15489,39368,2116,11282,10647,10395,4928,21772,20767,1005,20767,17973,2794,2022-01-01,zipcode,Jackson
ZCTA5 08528,34,163,-666666666,-666666666,-666666666,163,139,163,0,0,0,24,139,151,151,0,151,151,0,2022-01-01,zipcode,Kingston
ZCTA5 08530,34,8114,120112,1705,541200,7114,2393,6418,390,1305,1284,1660,1779,3697,3330,367,3330,2577,753,2022-01-01,zipcode,Lambertville
ZCTA5 08533,34,6140,104154,1457,448700,5027,1469,4193,323,1273,1285,901,411,2481,2346,135,2346,1730,616,2022-01-01,zipcode,New egypt
ZCTA5 08534,34,12990,179516,1828,545500,9970,3620,8727,238,871,1240,3039,3339,4993,4688,305,4688,3967,721,2022-01-01,zipcode,Pennington
ZCTA5 08535,34,4851,191184,2219,645700,4111,1239,3429,116,603,755,1255,700,1729,1646,83,1646,1430,216,2022-01-01,zipcode,Millstone township
ZCTA5 08536,34,20693,122254,1849,603100,16385,4501,14630,243,1025,1907,5197,6258,8789,8395,394,8395,3720,4675,2022-01-01,zipcode,Plainsboro
ZCTA5 08540,34,48513,161018,2060,708700,38660,13237,32222,891,1793,2823,10521,16194,18966,17578,1388,17578,11247,6331,2022-01-01,zipcode,Princeton
ZCTA5 08542,34,2595,157336,2652,686000,2310,411,2182,129,174,233,633,1013,1335,1139,196,1139,512,627,2022-01-01,zipcode,Princeton
ZCTA5 08550,34,20954,196053,2688,714400,16635,4944,14926,189,1006,1435,4735,7561,7879,7658,221,7658,5890,1768,2022-01-01,zipcode,Princeton junction
ZCTA5 08551,34,5746,148513,2241,543200,5117,1808,4018,123,742,651,1655,847,2164,2057,107,2057,1861,196,2022-01-01,zipcode,Ringoes
ZCTA5 08553,34,794,126250,1521,587000,653,233,540,7,63,56,202,212,306,295,11,295,254,41,2022-01-01,zipcode,Rocky hill
ZCTA5 08554,34,4184,95078,1495,188400,3239,916,2640,135,900,843,613,149,1555,1533,22,1533,1335,198,2022-01-01,zipcode,Roebling
ZCTA5 08555,34,1037,101339,2540,346500,726,250,631,13,138,180,176,124,347,335,12,335,274,61,2022-01-01,zipcode,Roosevelt
ZCTA5 08558,34,7515,233865,1636,774900,6183,2425,5235,131,604,637,1651,2212,2793,2643,150,2643,2297,346,2022-01-01,zipcode,Skillman
ZCTA5 08559,34,4902,165354,2000,560600,4564,1762,3925,126,513,837,1441,1008,2257,2045,212,2045,1849,196,2022-01-01,zipcode,Stockton
ZCTA5 08560,34,3689,123534,2231,414800,3200,1299,2671,114,806,447,668,636,1488,1426,62,1426,1295,131,2022-01-01,zipcode,Titusville
ZCTA5 08561,34,328,54318,-666666666,430900,284,141,217,8,54,90,42,23,138,138,0,138,63,75,2022-01-01,zipcode,Windsor
ZCTA5 08562,34,3976,86797,1118,230600,3069,1308,2735,396,889,677,578,195,1710,1527,183,1527,1142,385,2022-01-01,zipcode,Wrightstown
ZCTA5 08608,34,786,-666666666,1024,-666666666,622,245,618,116,132,235,59,76,581,460,121,460,51,409,2022-01-01,zipcode,Trenton
ZCTA5 08609,34,12799,46849,1129,90700,10012,4447,8578,2258,3687,1798,677,158,5408,4607,801,4607,1442,3165,2022-01-01,zipcode,Trenton
ZCTA5 08610,34,32324,82945,1412,230000,26071,8729,22438,3156,8613,5628,3572,1469,12030,11672,358,11672,7759,3913,2022-01-01,zipcode,Trenton
ZCTA5 08611,34,31660,48542,1283,117300,23354,9152,20362,5925,6889,4116,2502,930,11719,10738,981,10738,4231,6507,2022-01-01,zipcode,Trenton
ZCTA5 08618,34,39047,45334,1084,185400,30992,13133,23249,3546,8972,5739,3154,1838,15585,13813,1772,13813,5487,8326,2022-01-01,zipcode,Trenton
ZCTA5 08619,34,23446,97161,1600,297700,19608,6593,17263,820,4531,4294,5092,2526,9967,9470,497,9470,6516,2954,2022-01-01,zipcode,Trenton
ZCTA5 08620,34,12913,111141,1370,316300,11220,4938,9534,840,3045,2867,2205,577,4397,4265,132,4265,3462,803,2022-01-01,zipcode,Trenton
ZCTA5 08628,34,9107,102600,1458,331700,7896,3068,7252,259,1466,1188,2511,1828,4420,4070,350,4070,2629,1441,2022-01-01,zipcode,Trenton
ZCTA5 08629,34,13075,79724,1232,131800,10885,3800,9286,2280,3174,2665,760,407,4425,4260,165,4260,3119,1141,2022-01-01,zipcode,Trenton
ZCTA5 08638,34,23804,66194,1507,209800,19885,7932,15782,1849,5665,3833,2860,1575,9960,8698,1262,8698,5088,3610,2022-01-01,zipcode,Trenton
ZCTA5 08640,34,7781,91250,2374,-666666666,6631,4793,5663,1084,2555,1178,664,182,981,891,90,891,2,889,2022-01-01,zipcode,Joint base mdl
ZCTA5 08641,34,4886,82480,2404,-666666666,3081,717,2360,14,366,1084,489,407,1539,1433,106,1433,27,1406,2022-01-01,zipcode,Joint base mdl
ZCTA5 08648,34,31626,119151,1914,383700,26644,8978,21121,1369,3730,3462,6496,6064,12189,11517,672,11517,7827,3690,2022-01-01,zipcode,Lawrence township
ZCTA5 08690,34,19959,114181,1602,334700,17236,6810,15559,763,3749,4362,4603,2082,8179,7962,217,7962,6703,1259,2022-01-01,zipcode,Trenton
ZCTA5 08691,34,16935,126628,1851,479000,13411,4177,11932,413,2100,1995,4008,3416,7177,6857,320,6857,5467,1390,2022-01-01,zipcode,Trenton
ZCTA5 08701,34,134008,58949,1623,412600,72656,32961,56016,5581,17144,15088,10338,7865,33283,30816,2467,30816,15914,14902,2022-01-01,zipcode,Lakewood
ZCTA5 08720,34,644,138636,-666666666,632800,571,226,475,35,55,134,183,68,244,214,30,214,178,36,2022-01-01,zipcode,Allenwood
ZCTA5 08721,34,22217,103534,1474,334200,17686,5828,15548,1369,5477,4533,2911,1258,9190,8016,1174,8016,6830,1186,2022-01-01,zipcode,Bayville
ZCTA5 08722,34,10933,99099,2067,280800,8972,2558,7739,419,2363,2795,1578,584,4196,3935,261,3935,3541,394,2022-01-01,zipcode,Beachwood
ZCTA5 08723,34,32430,100596,1531,359100,27383,8751,23716,1526,8450,6791,4759,2190,13868,12891,977,12891,10183,2708,2022-01-01,zipcode,Brick
ZCTA5 08724,34,40560,87644,1758,348300,34181,11841,29974,1396,9536,8369,7241,3432,17539,16199,1340,16199,13294,2905,2022-01-01,zipcode,Brick
ZCTA5 08730,34,4957,160845,2543,771800,3831,1226,3335,124,420,589,1321,881,2149,1846,303,1846,1731,115,2022-01-01,zipcode,Brielle
ZCTA5 08731,34,21164,91815,2016,330600,17792,6744,15300,1112,5102,4571,3328,1187,9468,8454,1014,8454,7155,1299,2022-01-01,zipcode,Forked river
ZCTA5 08732,34,1449,106339,1600,469900,1264,509,1146,29,250,277,357,233,795,685,110,685,624,61,2022-01-01,zipcode,Island heights
ZCTA5 08733,34,2855,79025,1559,198200,2333,831,1986,262,875,445,271,133,1118,1033,85,1033,615,418,2022-01-01,zipcode,Lakehurst
ZCTA5 08734,34,7715,115040,1625,370500,6572,2237,5486,362,1785,1239,1276,824,2931,2597,334,2597,2414,183,2022-01-01,zipcode,Lanoka harbor
ZCTA5 08735,34,3732,71709,1494,805600,3426,1840,3230,99,840,730,976,585,7246,2087,5159,2087,1730,357,2022-01-01,zipcode,Lavallette
ZCTA5 08736,34,13234,159533,1590,778000,11041,3357,9529,102,1061,1942,3969,2455,6232,5266,966,5266,4723,543,2022-01-01,zipcode,Manasquan
ZCTA5 08738,34,1411,190625,1946,1422400,1210,546,1062,19,121,198,420,304,1771,595,1176,595,525,70,2022-01-01,zipcode,Mantoloking
ZCTA5 08740,34,1682,67788,1779,323000,1380,552,1203,92,515,228,288,80,1242,743,499,743,594,149,2022-01-01,zipcode,Ocean gate
ZCTA5 08741,34,2798,127250,1156,376800,2411,806,2130,65,448,626,665,326,1224,1079,145,1079,1039,40,2022-01-01,zipcode,Pine beach
ZCTA5 08742,34,25193,107113,1836,517000,21369,6398,18944,887,4074,4567,6467,2949,12382,10303,2079,10303,8182,2121,2022-01-01,zipcode,Point pleasant beach
ZCTA5 08750,34,3612,154130,2061,1009800,3134,1419,2818,13,251,541,1215,798,2009,1540,469,1540,1304,236,2022-01-01,zipcode,Sea girt
ZCTA5 08751,34,3609,77641,1321,547900,3225,1726,2941,340,787,658,710,446,5271,1877,3394,1877,1136,741,2022-01-01,zipcode,Seaside heights
ZCTA5 08752,34,2333,78295,1418,747000,2205,1137,2084,38,511,460,590,485,4184,1269,2915,1269,1019,250,2022-01-01,zipcode,Seaside park
ZCTA5 08753,34,64313,97153,1620,357200,53371,17600,46130,2668,14226,12252,11615,5369,27587,24808,2779,24808,20006,4802,2022-01-01,zipcode,Toms river
ZCTA5 08755,34,28586,76355,1519,352300,22181,9428,19356,1637,7381,4789,3627,1922,11223,10400,823,10400,8363,2037,2022-01-01,zipcode,Toms river
ZCTA5 08757,34,35419,53877,1707,232100,32279,18376,30049,3030,13233,8180,3902,1704,19529,18015,1514,18015,15517,2498,2022-01-01,zipcode,Toms river
ZCTA5 08758,34,7954,98584,1536,427300,6912,3444,6196,218,1922,1942,1311,803,3794,3221,573,3221,2786,435,2022-01-01,zipcode,Waretown
ZCTA5 08759,34,33979,49455,1290,162000,32348,21873,31627,2362,13406,8571,4367,2921,22348,19956,2392,19956,17412,2544,2022-01-01,zipcode,Manchester township
ZCTA5 08801,34,7665,151375,1914,500800,6696,3073,5415,169,925,1077,1803,1441,2769,2669,100,2669,2242,427,2022-01-01,zipcode,Annandale
ZCTA5 08802,34,4380,120769,2338,414400,3713,1299,3146,27,849,841,1008,421,1537,1478,59,1478,1423,55,2022-01-01,zipcode,Asbury
ZCTA5 08804,34,3116,97167,972,403900,2680,1036,2256,81,661,591,669,254,1233,1168,65,1168,885,283,2022-01-01,zipcode,Bloomsbury
ZCTA5 08805,34,14173,82200,1731,376000,11451,3158,10057,1177,2867,2619,2024,1370,5584,5374,210,5374,2686,2688,2022-01-01,zipcode,Bound brook
ZCTA5 08807,34,38585,153743,1879,542900,31454,10524,27149,1383,4983,4341,8746,7696,14359,13811,548,13811,11593,2218,2022-01-01,zipcode,Bridgewater
ZCTA5 08809,34,6838,122024,1558,422800,5590,2029,4681,363,1027,894,1422,975,2404,2334,70,2334,1763,571,2022-01-01,zipcode,Clinton
ZCTA5 08810,34,8361,136130,1975,466800,6677,2061,5686,165,659,825,2481,1556,2873,2804,69,2804,2462,342,2022-01-01,zipcode,Dayton
ZCTA5 08812,34,14054,115481,1518,413100,11634,3907,9343,829,2925,1637,2805,1147,5009,4530,479,4530,3456,1074,2022-01-01,zipcode,Dunellen
ZCTA5 08816,34,49027,138166,1873,462600,38595,12601,33998,1959,5663,6472,10647,9257,17530,16822,708,16822,13943,2879,2022-01-01,zipcode,East brunswick
ZCTA5 08817,34,48140,105419,1878,379000,37560,11878,33343,2895,7558,6955,9659,6276,17104,16297,807,16297,8746,7551,2022-01-01,zipcode,Edison
ZCTA5 08820,34,39565,157114,1883,584900,31110,10792,27255,2083,3171,2931,9683,9387,13330,13067,263,13067,9803,3264,2022-01-01,zipcode,Edison
ZCTA5 08821,34,514,118333,-666666666,472600,377,96,334,14,108,89,78,45,194,166,28,166,166,0,2022-01-01,zipcode,Flagtown
ZCTA5 08822,34,31330,136851,1612,493200,25232,7483,22045,1324,3837,4187,7438,5259,12040,11704,336,11704,9249,2455,2022-01-01,zipcode,Flemington
ZCTA5 08823,34,9024,104314,2219,264300,7310,1666,6440,445,861,1292,2124,1718,3556,3508,48,3508,2472,1036,2022-01-01,zipcode,Franklin park
ZCTA5 08824,34,13297,178567,1966,574300,10833,3364,9266,399,1171,1620,3509,2567,4611,4447,164,4447,3884,563,2022-01-01,zipcode,Kendall park
ZCTA5 08825,34,4556,102336,1628,447000,3810,1228,3384,172,830,817,863,702,1995,1916,79,1916,1474,442,2022-01-01,zipcode,Frenchtown
ZCTA5 08826,34,5186,121513,1388,418200,4422,1419,3826,148,945,1073,934,726,2187,2083,104,2083,1784,299,2022-01-01,zipcode,Glen gardner
ZCTA5 08827,34,3710,117128,1167,392000,3153,1188,2834,106,679,769,849,431,1629,1553,76,1553,1376,177,2022-01-01,zipcode,Hampton
ZCTA5 08828,34,2302,104500,1869,303000,1916,505,1696,73,488,461,502,172,993,968,25,968,677,291,2022-01-01,zipcode,Helmetta
ZCTA5 08829,34,3564,106111,1476,296600,2970,1000,2416,109,632,536,707,432,1466,1436,30,1436,1108,328,2022-01-01,zipcode,High bridge
ZCTA5 08830,34,18511,109646,1999,369700,15483,5547,13573,1337,3080,1924,3771,3461,6806,6444,362,6444,4428,2016,2022-01-01,zipcode,Iselin
ZCTA5 08831,34,54229,108626,1739,451000,45118,20402,41888,2107,10343,8545,12500,8393,24411,23193,1218,23193,20774,2419,2022-01-01,zipcode,Monroe township
ZCTA5 08832,34,2745,61200,1657,356000,2117,584,1485,353,638,225,150,119,928,892,36,892,147,745,2022-01-01,zipcode,Keasbey
ZCTA5 08833,34,9057,155714,1811,536100,7644,2762,6856,206,1254,1413,2280,1703,3841,3606,235,3606,3140,466,2022-01-01,zipcode,Lebanon
ZCTA5 08835,34,10892,85925,1673,301300,9177,2855,7774,506,3104,1937,1470,757,4613,4391,222,4391,3327,1064,2022-01-01,zipcode,Manville
ZCTA5 08836,34,4023,214375,-666666666,722100,2908,865,2592,1,286,438,1101,766,1302,1278,24,1278,1251,27,2022-01-01,zipcode,Martinsville
ZCTA5 08837,34,19544,98728,1715,392800,14883,4448,13656,872,2631,3155,3845,3153,7423,7102,321,7102,3423,3679,2022-01-01,zipcode,Edison
ZCTA5 08840,34,18075,148735,1922,488300,13792,3980,12430,652,2011,2459,3953,3355,6490,6221,269,6221,4820,1401,2022-01-01,zipcode,Metuchen
ZCTA5 08844,34,43077,153091,2188,504400,35089,9560,30885,1268,5050,5647,10360,8560,15976,15582,394,15582,12892,2690,2022-01-01,zipcode,Hillsborough
ZCTA5 08846,34,14525,101868,1471,390200,11900,3681,10675,1066,2910,2925,2546,1228,5764,5580,184,5580,4196,1384,2022-01-01,zipcode,Middlesex
ZCTA5 08848,34,8295,126705,1581,375600,6659,2498,5815,197,1445,1483,1817,873,3124,3043,81,3043,2826,217,2022-01-01,zipcode,Milford
ZCTA5 08850,34,8410,127089,1715,419100,6744,1824,6158,241,1357,1791,1941,828,3105,3015,90,3015,2504,511,2022-01-01,zipcode,Milltown
ZCTA5 08852,34,18068,117411,1799,447900,14411,4105,12660,736,1675,1707,4947,3595,7151,7073,78,7073,4765,2308,2022-01-01,zipcode,Monmouth junction
ZCTA5 08853,34,5349,206020,1666,626800,4569,1126,3636,103,377,512,1448,1196,1988,1963,25,1963,1608,355,2022-01-01,zipcode,Neshanic station
ZCTA5 08854,34,60233,123236,1846,403100,50905,16522,36767,2918,7420,8237,11226,6966,17728,17079,649,17079,11237,5842,2022-01-01,zipcode,Piscataway
ZCTA5 08857,34,40430,102039,1433,438800,34046,10370,29847,2056,8809,7533,7591,3858,16024,15633,391,15633,10396,5237,2022-01-01,zipcode,Old bridge
ZCTA5 08858,34,0,-666666666,-666666666,-666666666,0,0,0,0,0,0,0,0,0,0,0,0,0,0,2022-01-01,zipcode,Oldwick
ZCTA5 08859,34,24487,93601,1547,376900,19662,5755,17152,1129,4453,4751,4898,1921,9016,8790,226,8790,5192,3598,2022-01-01,zipcode,Parlin
ZCTA5 08861,34,58136,58221,1556,329600,46853,16465,38730,10969,12980,9015,4230,1536,20357,19610,747,19610,7185,12425,2022-01-01,zipcode,Perth amboy
ZCTA5 08863,34,12663,110643,1870,382900,10492,3665,8880,893,2213,2429,2264,1081,4655,4438,217,4438,3073,1365,2022-01-01,zipcode,Fords
ZCTA5 08865,34,30561,73519,1226,225600,25517,8835,22839,1749,8354,6186,4151,2399,14225,13261,964,13261,8911,4350,2022-01-01,zipcode,Phillipsburg
ZCTA5 08867,34,5819,188429,-666666666,564700,4836,1343,3956,131,500,882,1402,1041,2129,2035,94,2035,1904,131,2022-01-01,zipcode,Pittstown
ZCTA5 08869,34,8301,99928,1810,435800,7198,1684,6141,622,1613,1612,1303,991,3376,3262,114,3262,1857,1405,2022-01-01,zipcode,Raritan
ZCTA5 08872,34,19613,91596,1437,377000,15538,4772,13639,1202,3909,3429,3536,1563,7768,7415,353,7415,4519,2896,2022-01-01,zipcode,Sayreville
ZCTA5 08873,34,55342,110396,1924,410800,44589,14502,39231,2747,6879,7991,12043,9571,22204,21244,960,21244,14426,6818,2022-01-01,zipcode,Somerset
ZCTA5 08876,34,22531,117153,1682,447500,18862,5259,16319,1080,3024,3035,5767,3413,9236,8984,252,8984,5843,3141,2022-01-01,zipcode,Somerville
ZCTA5 08879,34,22514,93243,1641,355600,18810,5947,16980,1462,5754,4425,3444,1895,9727,9209,518,9209,5435,3774,2022-01-01,zipcode,South amboy
ZCTA5 08880,34,4838,92625,1598,316600,3966,947,3426,290,982,1223,675,256,1990,1951,39,1951,1145,806,2022-01-01,zipcode,South bound brook
ZCTA5 08882,34,16081,95981,1615,360800,12743,3964,11185,1751,3560,2849,1960,1065,5769,5555,214,5555,3624,1931,2022-01-01,zipcode,South river
ZCTA5 08884,34,8152,100365,1124,354900,6812,2287,6050,634,1898,1604,1227,687,3202,3202,0,3202,2677,525,2022-01-01,zipcode,Spotswood
ZCTA5 08886,34,6963,151500,1591,402900,5631,1590,4655,148,1005,1186,1489,827,2419,2414,5,2414,2217,197,2022-01-01,zipcode,Stewartsville
ZCTA5 08887,34,1411,106477,1703,244600,1228,431,1004,227,163,191,242,181,621,581,40,581,329,252,2022-01-01,zipcode,Three bridges
ZCTA5 08889,34,10383,134352,1827,490500,8784,3682,7628,114,1492,1445,2543,2034,4265,4212,53,4212,3799,413,2022-01-01,zipcode,Whitehouse station
ZCTA5 08890,34,74,-666666666,-666666666,-666666666,74,30,15,0,8,0,7,0,48,8,40,8,0,8,2022-01-01,zipcode,
ZCTA5 08901,34,56870,57138,1754,289800,46787,18694,27064,8997,7338,4141,3635,2953,16887,15626,1261,15626,3156,12470,2022-01-01,zipcode,New brunswick
ZCTA5 08902,34,43037,110195,1906,377300,34383,10369,30827,3681,6264,6216,8364,6302,16191,15824,367,15824,9260,6564,2022-01-01,zipcode,North brunswick
ZCTA5 08904,34,14996,93927,1755,420900,12633,3487,10883,438,1256,1539,3259,4391,6942,6547,395,6547,2512,4035,2022-01-01,zipcode,Highland park
ZCTA5 32003,12,29810,117414,1909,355200,25078,10331,21538,646,3779,6706,5905,4502,11996,11291,705,11291,9616,1675,2022-01-01,zipcode,Fleming island
ZCTA5 32008,12,6338,45118,822,142300,4899,2466,4399,679,2166,995,412,147,3375,2554,821,2554,2051,503,2022-01-01,zipcode,Branford
ZCTA5 32009,12,3582,74098,908,196300,3058,1121,2360,287,927,808,234,104,1458,1413,45,1413,1223,190,2022-01-01,zipcode,Bryceville
ZCTA5 32011,12,15006,70215,892,217800,12320,5390,10672,1601,4251,3534,773,513,6182,5681,501,5681,4723,958,2022-01-01,zipcode,Callahan
ZCTA5 32024,12,20155,63013,954,179600,16219,6987,14330,1786,5396,4713,1697,738,8435,7747,688,7747,6679,1068,2022-01-01,zipcode,Lake city
ZCTA5 32025,12,23193,51081,944,165100,18969,9581,15685,2218,5574,5376,1754,763,9088,8229,859,8229,4648,3581,2022-01-01,zipcode,Lake city
ZCTA5 32026,12,2269,-666666666,-666666666,-666666666,2269,2269,2137,822,825,408,63,19,0,0,0,0,0,0,2022-01-01,zipcode,Raiford
ZCTA5 32033,12,4704,81160,1610,271800,4404,1878,3904,270,1251,1658,415,310,2288,2027,261,2027,1813,214,2022-01-01,zipcode,Elkton
ZCTA5 32034,12,40026,95869,1209,427700,34132,15711,31896,1146,6024,8886,9868,5972,21421,17262,4159,17262,14797,2465,2022-01-01,zipcode,Fernandina beach
ZCTA5 32038,12,10208,50098,825,157200,8430,3977,7677,1016,2675,2804,831,351,4872,3934,938,3934,3406,528,2022-01-01,zipcode,Fort white
ZCTA5 32040,12,8235,66182,1015,173500,6414,2394,5484,715,2553,1686,385,145,3068,2841,227,2841,2442,399,2022-01-01,zipcode,Glen saint mary
ZCTA5 32043,12,31705,76405,1270,263200,24866,9946,21460,1724,6244,7359,4683,1450,12808,11697,1111,11697,9445,2252,2022-01-01,zipcode,Green cove springs
ZCTA5 32044,12,2026,42693,1089,80900,1553,898,1341,309,458,498,73,3,823,749,74,749,464,285,2022-01-01,zipcode,Hampton
ZCTA5 32046,12,11042,69153,808,213500,8542,3596,7569,933,3582,2197,643,214,4139,3717,422,3717,2785,932,2022-01-01,zipcode,Hilliard
ZCTA5 32052,12,8053,50284,694,106000,6832,4729,6243,1692,2858,1255,376,62,2880,2210,670,2210,1595,615,2022-01-01,zipcode,Jasper
ZCTA5 32053,12,3706,37965,852,94600,2814,1444,2487,459,986,719,177,146,1880,1358,522,1358,1075,283,2022-01-01,zipcode,Jennings
ZCTA5 32054,12,12598,65893,765,154800,10045,6035,8732,1837,3454,2469,597,375,4078,3662,416,3662,2660,1002,2022-01-01,zipcode,Lake butler
ZCTA5 32055,12,16175,50461,871,155400,12436,5759,10661,1693,4025,3222,1027,694,7374,6305,1069,6305,4061,2244,2022-01-01,zipcode,Lake city
ZCTA5 32058,12,4607,57716,945,161400,3833,1670,3225,744,1412,912,104,53,1566,1397,169,1397,1091,306,2022-01-01,zipcode,Lawtey
ZCTA5 32059,12,2641,48362,842,90700,2332,1205,2049,471,625,756,122,75,1354,1068,286,1068,755,313,2022-01-01,zipcode,Lee
ZCTA5 32060,12,22505,52463,685,137600,18617,9330,16337,2901,6285,4071,1641,1439,9423,7820,1603,7820,6314,1506,2022-01-01,zipcode,Live oak
ZCTA5 32061,12,59,-666666666,-666666666,-666666666,59,37,59,0,22,37,0,0,19,19,0,19,5,14,2022-01-01,zipcode,Lulu
ZCTA5 32062,12,1783,41200,-666666666,186400,1379,771,1058,214,500,220,72,52,991,636,355,636,492,144,2022-01-01,zipcode,Mc alpin
ZCTA5 32063,12,14289,68750,998,207000,11148,4554,9266,1258,3491,2589,1090,838,5208,4759,449,4759,3658,1101,2022-01-01,zipcode,Macclenny
ZCTA5 32064,12,7641,39931,834,156300,6107,2651,5301,490,2143,1881,529,258,3500,2835,665,2835,1382,1453,2022-01-01,zipcode,Live oak
ZCTA5 32065,12,40035,91770,1556,259800,30459,10665,25896,2059,6467,10148,5247,1975,14389,13601,788,13601,10391,3210,2022-01-01,zipcode,Orange park
ZCTA5 32066,12,6875,58845,855,119800,5939,3133,5006,1060,2471,1069,295,111,2445,2026,419,2026,1626,400,2022-01-01,zipcode,Mayo
ZCTA5 32068,12,57372,81030,1303,233100,45639,15455,38979,2920,13458,14651,5850,2100,21501,20307,1194,20307,16032,4275,2022-01-01,zipcode,Middleburg
ZCTA5 32071,12,3219,43510,525,139300,2841,1711,2248,336,741,821,247,103,1565,1295,270,1295,1100,195,2022-01-01,zipcode,O brien
ZCTA5 32072,12,37,-666666666,-666666666,-666666666,37,15,37,0,0,22,9,6,22,22,0,22,22,0,2022-01-01,zipcode,
ZCTA5 32073,12,42135,70975,1322,234300,34763,12268,30789,2632,7579,12676,5237,2665,16788,16087,701,16087,10121,5966,2022-01-01,zipcode,Orange park
ZCTA5 32079,12,439,56250,1689,-666666666,439,421,439,106,79,57,92,105,195,180,15,180,0,180,2022-01-01,zipcode,Penney farms
ZCTA5 32080,12,21167,87285,1448,456200,19163,9324,17698,662,3061,5057,5746,3172,16526,10086,6440,10086,8203,1883,2022-01-01,zipcode,Saint augustine
ZCTA5 32081,12,24368,129875,3501,518000,17877,7759,16503,392,1916,3168,6439,4588,9051,8250,801,8250,7122,1128,2022-01-01,zipcode,Ponte vedra
ZCTA5 32082,12,28697,121484,1739,676300,24351,10787,21892,527,2290,4339,9043,5693,14765,12160,2605,12160,10035,2125,2022-01-01,zipcode,Ponte vedra beach
ZCTA5 32083,12,2392,58438,950,119600,2034,1569,1939,445,693,639,87,75,674,541,133,541,354,187,2022-01-01,zipcode,Raiford
ZCTA5 32084,12,36129,67727,1267,266800,31343,13227,27127,2362,8533,7642,5410,3180,17037,13780,3257,13780,9369,4411,2022-01-01,zipcode,Saint augustine
ZCTA5 32086,12,33817,70571,1417,300600,29194,12296,26461,1834,6961,9556,4874,3236,15194,13441,1753,13441,10211,3230,2022-01-01,zipcode,Saint augustine
ZCTA5 32087,12,5240,66056,783,206900,4272,2841,3872,802,1837,1080,85,68,1513,1303,210,1303,993,310,2022-01-01,zipcode,Sanderson
ZCTA5 32091,12,16729,51890,849,130700,13605,6424,11961,1730,4930,3724,988,589,6959,5714,1245,5714,3539,2175,2022-01-01,zipcode,Starke
ZCTA5 32092,12,45098,113589,1976,417800,35611,12590,30321,2077,6189,7421,9581,5053,16975,15283,1692,15283,13526,1757,2022-01-01,zipcode,Saint augustine
ZCTA5 32094,12,3718,64559,866,118600,3049,1542,2742,373,1356,730,149,134,1274,1074,200,1074,834,240,2022-01-01,zipcode,Wellborn
ZCTA5 32095,12,16419,111084,1281,461900,12575,4247,11132,394,2329,2817,2867,2725,6177,5791,386,5791,5246,545,2022-01-01,zipcode,Saint augustine
ZCTA5 32096,12,2875,46875,715,101300,2236,1270,2018,453,774,624,121,46,1363,1169,194,1169,971,198,2022-01-01,zipcode,White springs
ZCTA5 32097,12,21778,83933,1585,266400,17466,6102,15255,1565,5053,5269,2312,1056,8850,8210,640,8210,6466,1744,2022-01-01,zipcode,Yulee
ZCTA5 32102,12,2224,52415,975,152700,1929,1103,1792,450,703,423,173,43,1736,1086,650,1086,947,139,2022-01-01,zipcode,Astor
ZCTA5 32110,12,9424,50528,1048,171800,7898,3842,6871,824,3336,1782,586,343,4050,3478,572,3478,2408,1070,2022-01-01,zipcode,Bunnell
ZCTA5 32112,12,8002,42459,787,121500,6545,3340,5417,1777,1878,1203,395,164,3771,2861,910,2861,2058,803,2022-01-01,zipcode,Crescent city
ZCTA5 32113,12,5386,41750,-666666666,134200,4479,2297,3838,472,1500,1353,281,232,2702,2238,464,2238,1843,395,2022-01-01,zipcode,Citra
ZCTA5 32114,12,35583,40726,1139,157800,30852,15098,22787,2773,7994,7464,3009,1547,17118,14562,2556,14562,4739,9823,2022-01-01,zipcode,Daytona beach
ZCTA5 32117,12,29720,49848,1308,158200,24620,10383,21733,2230,7577,7528,3154,1244,14243,12440,1803,12440,6293,6147,2022-01-01,zipcode,Daytona beach
ZCTA5 32118,12,18141,52765,1172,305800,16402,8436,15485,1168,4586,4983,2753,1995,16421,9885,6536,9885,6090,3795,2022-01-01,zipcode,Daytona beach
ZCTA5 32119,12,22935,51484,1276,189900,19950,9273,17526,1643,5233,6220,2714,1716,12325,10750,1575,10750,6663,4087,2022-01-01,zipcode,Daytona beach
ZCTA5 32124,12,7992,83354,1596,348400,7346,4702,6855,672,2314,1802,1251,816,3018,2726,292,2726,2375,351,2022-01-01,zipcode,Daytona beach
ZCTA5 32127,12,27908,65230,1253,276200,24221,11441,22311,1428,6322,7887,4048,2626,15921,12874,3047,12874,9967,2907,2022-01-01,zipcode,Port orange
ZCTA5 32128,12,21829,77589,1532,345400,18480,9160,16021,839,3264,5527,4298,2093,9928,9297,631,9297,7550,1747,2022-01-01,zipcode,Port orange
ZCTA5 32129,12,23543,60390,1363,226500,20748,8424,17734,1431,5655,6527,2703,1418,11955,10688,1267,10688,7529,3159,2022-01-01,zipcode,Port orange
ZCTA5 32130,12,5561,56579,1498,238400,4449,2057,3900,456,1574,1208,452,210,2038,1888,150,1888,1573,315,2022-01-01,zipcode,De leon springs
ZCTA5 32131,12,4381,60850,957,217600,3796,2020,3548,638,1310,995,419,186,2085,1732,353,1732,1360,372,2022-01-01,zipcode,East palatka
ZCTA5 32132,12,8012,48925,1100,210700,7113,3400,6521,489,2293,2591,721,427,4094,3776,318,3776,3145,631,2022-01-01,zipcode,Edgewater
ZCTA5 32133,12,732,134187,-666666666,582400,732,189,576,0,44,21,212,299,361,305,56,305,305,0,2022-01-01,zipcode,Eastlake weir
ZCTA5 32134,12,7076,42788,664,108300,6366,3856,5718,886,2582,1722,371,157,5711,3202,2509,3202,2875,327,2022-01-01,zipcode,Fort mc coy
ZCTA5 32136,12,8349,65772,1362,392300,7623,4699,7172,249,2038,2416,1451,1018,5498,3900,1598,3900,3310,590,2022-01-01,zipcode,Flagler beach
ZCTA5 32137,12,46970,73689,1679,324700,40707,21043,37036,2291,10372,11288,8485,4600,24087,19504,4583,19504,16701,2803,2022-01-01,zipcode,Palm coast
ZCTA5 32139,12,791,58385,-666666666,143400,712,558,685,54,379,112,98,42,428,284,144,284,267,17,2022-01-01,zipcode,Georgetown
ZCTA5 32140,12,1727,-666666666,1076,87000,1396,707,1097,148,441,452,50,6,815,623,192,623,511,112,2022-01-01,zipcode,Florahome
ZCTA5 32141,12,18683,61456,1355,223900,16119,7392,14992,1000,5198,5865,2030,899,9402,8396,1006,8396,7618,778,2022-01-01,zipcode,Edgewater
ZCTA5 32145,12,5553,64868,1038,195400,4288,1665,3852,615,1398,1239,492,108,2433,2108,325,2108,1687,421,2022-01-01,zipcode,Hastings
ZCTA5 32147,12,1427,29671,-666666666,91700,1121,285,976,63,623,132,158,0,686,686,0,686,610,76,2022-01-01,zipcode,Hollister
ZCTA5 32148,12,10923,43891,753,83800,8749,5089,7680,1296,3750,1620,859,155,5318,4333,985,4333,3609,724,2022-01-01,zipcode,Interlachen
ZCTA5 32157,12,876,36042,953,122900,751,357,702,136,300,219,47,0,455,350,105,350,272,78,2022-01-01,zipcode,
ZCTA5 32159,12,30111,55244,1285,251600,27886,19467,26735,1719,8078,9638,3839,3461,19340,16184,3156,16184,13242,2942,2022-01-01,zipcode,Lady lake
ZCTA5 32162,12,52752,71894,1682,330200,52481,46650,52428,1229,12965,16130,13104,9000,36989,30880,6109,30880,28894,1986,2022-01-01,zipcode,The villages
ZCTA5 32164,12,50721,70064,1589,275000,42235,19473,37960,3602,11929,13757,5895,2777,21640,19649,1991,19649,14327,5322,2022-01-01,zipcode,Palm coast
ZCTA5 32168,12,30074,68964,1541,283800,26490,12855,24176,1781,7428,7703,5178,2086,15924,13727,2197,13727,10356,3371,2022-01-01,zipcode,New smyrna beach
ZCTA5 32169,12,10383,86670,1589,444900,9710,5800,9447,225,1778,3128,2357,1959,12333,5813,6520,5813,4900,913,2022-01-01,zipcode,New smyrna beach
ZCTA5 32174,12,52140,65503,1185,288800,44420,22202,40476,3013,10375,14167,8763,4158,25735,23205,2530,23205,18583,4622,2022-01-01,zipcode,Ormond beach
ZCTA5 32176,12,13882,63975,1391,328100,12654,6397,11641,582,2791,3881,2601,1786,10397,6880,3517,6880,5443,1437,2022-01-01,zipcode,Ormond beach
ZCTA5 32177,12,26290,45455,840,150700,20498,10293,18132,2704,8104,5153,1419,752,11563,10440,1123,10440,6646,3794,2022-01-01,zipcode,Palatka
ZCTA5 32179,12,8523,48108,953,147900,7440,3762,6626,1005,2463,2160,516,482,5166,3858,1308,3858,3195,663,2022-01-01,zipcode,Ocklawaha
ZCTA5 32180,12,5000,68236,882,212500,3643,1704,3067,850,939,977,151,150,1547,1369,178,1369,1039,330,2022-01-01,zipcode,Pierson
ZCTA5 32181,12,3163,38851,776,93300,2379,1104,1853,388,850,479,86,50,1376,1148,228,1148,720,428,2022-01-01,zipcode,Pomona park
ZCTA5 32187,12,1221,40111,-666666666,119000,1146,669,983,124,439,291,100,29,695,695,0,695,614,81,2022-01-01,zipcode,San mateo
ZCTA5 32189,12,5108,42212,735,112300,4535,2588,4178,959,1321,1354,468,76,3314,2394,920,2394,1504,890,2022-01-01,zipcode,Satsuma
ZCTA5 32190,12,1774,69186,-666666666,-666666666,1379,681,1116,78,499,316,109,114,642,528,114,528,486,42,2022-01-01,zipcode,Seville
ZCTA5 32193,12,1122,47237,937,256500,989,677,881,133,413,179,100,56,939,616,323,616,516,100,2022-01-01,zipcode,Welaka
ZCTA5 32195,12,3183,85396,-666666666,184700,2869,1336,2518,448,985,811,200,74,1360,1169,191,1169,1108,61,2022-01-01,zipcode,Weirsdale
ZCTA5 32202,12,6393,38042,935,230200,5997,4129,5279,1278,1543,1497,631,330,2763,2204,559,2204,239,1965,2022-01-01,zipcode,Jacksonville
ZCTA5 32204,12,8270,61609,1174,346400,7363,2206,6586,648,1257,1698,1977,1006,5134,4359,775,4359,1120,3239,2022-01-01,zipcode,Jacksonville
ZCTA5 32205,12,30913,57758,1097,243200,25464,8045,23006,2461,5749,6778,4921,3097,16277,14491,1786,14491,7848,6643,2022-01-01,zipcode,Jacksonville
ZCTA5 32206,12,16210,35313,834,123600,12641,5016,11018,2079,3774,3155,1298,712,9266,7027,2239,7027,3206,3821,2022-01-01,zipcode,Jacksonville
ZCTA5 32207,12,35392,59883,1082,229800,28491,9304,25241,3291,6041,6669,5628,3612,18592,15907,2685,15907,8145,7762,2022-01-01,zipcode,Jacksonville
ZCTA5 32208,12,31368,39511,1125,124600,24967,11498,21891,3797,7665,7506,1791,1132,15415,13531,1884,13531,7480,6051,2022-01-01,zipcode,Jacksonville
ZCTA5 32209,12,36062,28534,956,82100,27674,13608,23485,4685,9538,6873,1708,681,17834,14492,3342,14492,6775,7717,2022-01-01,zipcode,Jacksonville
ZCTA5 32210,12,67110,55910,1142,185600,52154,16865,45102,5446,15535,14091,6912,3118,29003,26800,2203,26800,14180,12620,2022-01-01,zipcode,Jacksonville
ZCTA5 32211,12,35863,54058,1090,185200,27385,9061,23684,2642,8523,8043,3278,1198,15038,13533,1505,13533,7306,6227,2022-01-01,zipcode,Jacksonville
ZCTA5 32212,12,1872,45366,1845,-666666666,1528,114,464,9,87,240,42,86,222,222,0,222,2,220,2022-01-01,zipcode,Jacksonville
ZCTA5 32216,12,41010,61536,1228,226600,33315,11866,29441,3247,8789,8034,6426,2945,19510,17684,1826,17684,8390,9294,2022-01-01,zipcode,Jacksonville
ZCTA5 32217,12,20219,58975,1063,272600,16631,5631,14767,870,3577,4376,4053,1891,9487,8820,667,8820,4965,3855,2022-01-01,zipcode,Jacksonville
ZCTA5 32218,12,68996,64298,1364,235500,52647,18480,45029,4431,13711,15467,7659,3761,26939,24313,2626,24313,15485,8828,2022-01-01,zipcode,Jacksonville
ZCTA5 32219,12,14145,60100,1017,193700,10711,4435,9361,1076,3587,3111,1160,427,5365,4945,420,4945,4237,708,2022-01-01,zipcode,Jacksonville
ZCTA5 32220,12,12078,77038,1167,189500,9798,3360,8866,781,3847,2806,810,622,4965,4590,375,4590,3913,677,2022-01-01,zipcode,Jacksonville
ZCTA5 32221,12,30597,75865,1554,223700,24043,9126,20472,2222,7359,6533,2915,1443,11478,10732,746,10732,8248,2484,2022-01-01,zipcode,Jacksonville
ZCTA5 32222,12,16869,81045,1635,277300,13717,3461,12313,948,3267,5333,1974,791,6807,6327,480,6327,4512,1815,2022-01-01,zipcode,Jacksonville
ZCTA5 32223,12,25604,90833,1444,358400,21355,8540,19167,748,4167,6377,4773,3102,10673,10348,325,10348,8400,1948,2022-01-01,zipcode,Jacksonville
ZCTA5 32224,12,41919,82055,1557,383200,35538,13040,25767,1001,4954,6482,8644,4686,16855,15579,1276,15579,8595,6984,2022-01-01,zipcode,Jacksonville
ZCTA5 32225,12,54073,83324,1500,296100,43463,13681,37831,1373,8757,11773,10751,5177,23005,21391,1614,21391,14458,6933,2022-01-01,zipcode,Jacksonville
ZCTA5 32226,12,18892,97625,2069,310600,14716,5709,13150,1153,3626,4163,2682,1526,7263,6618,645,6618,6027,591,2022-01-01,zipcode,Jacksonville
ZCTA5 32227,12,3497,79375,1818,-666666666,2615,339,1198,26,317,621,131,103,654,561,93,561,0,561,2022-01-01,zipcode,Jacksonville
ZCTA5 32228,12,224,-666666666,-666666666,-666666666,224,0,45,0,0,36,9,0,0,0,0,0,0,0,2022-01-01,zipcode,Jacksonville
ZCTA5 32233,12,24041,79363,1462,384700,20086,6844,17188,1340,3942,4694,4827,2385,11141,9802,1339,9802,5769,4033,2022-01-01,zipcode,Atlantic beach
ZCTA5 32234,12,8692,78997,912,205000,6409,2202,5519,684,2535,1461,680,159,3265,3055,210,3055,2527,528,2022-01-01,zipcode,Jacksonville
ZCTA5 32244,12,65499,59848,1321,201100,50189,15877,44088,3952,15222,15054,7568,2292,25827,24400,1427,24400,13581,10819,2022-01-01,zipcode,Jacksonville
ZCTA5 32246,12,58684,74401,1552,265200,47253,13269,40209,2892,9317,12557,11346,4097,25424,23275,2149,23275,13069,10206,2022-01-01,zipcode,Jacksonville
ZCTA5 32250,12,28619,104943,1753,474800,24577,7882,21658,1090,4034,4868,6754,4912,14572,12654,1918,12654,8547,4107,2022-01-01,zipcode,Jacksonville beach
ZCTA5 32254,12,14338,35295,1016,76700,10875,4665,8971,2500,3683,2127,552,109,6204,5265,939,5265,2705,2560,2022-01-01,zipcode,Jacksonville
ZCTA5 32256,12,51638,69895,1446,323300,43256,12671,36662,1230,6373,9434,12659,6966,26255,24284,1971,24284,9292,14992,2022-01-01,zipcode,Jacksonville
ZCTA5 32257,12,42271,80644,1323,282300,34509,11252,30444,2318,7479,9259,7398,3990,18394,17305,1089,17305,10629,6676,2022-01-01,zipcode,Jacksonville
ZCTA5 32258,12,41595,95926,1816,311700,32280,9822,27460,910,5489,8886,8318,3857,15897,15436,461,15436,9918,5518,2022-01-01,zipcode,Jacksonville
ZCTA5 32259,12,66518,142263,2198,440400,49844,16427,42645,804,7738,11273,13936,8894,21918,20520,1398,20520,18014,2506,2022-01-01,zipcode,Saint johns
ZCTA5 32266,12,6743,109375,1459,559300,5866,1538,5205,156,674,1274,2077,1024,3473,3020,453,3020,2114,906,2022-01-01,zipcode,Neptune beach
ZCTA5 32277,12,34880,53931,1194,233300,27739,9767,21856,2278,7381,6983,3635,1579,13962,12792,1170,12792,6137,6655,2022-01-01,zipcode,Jacksonville
ZCTA5 32301,12,33803,47222,1137,189700,28219,9589,20447,1919,3864,5764,5251,3649,16893,14465,2428,14465,4191,10274,2022-01-01,zipcode,Tallahassee
ZCTA5 32303,12,49824,58592,1190,192300,41617,11566,31051,1721,6611,8810,8105,5804,24304,21661,2643,21661,10779,10882,2022-01-01,zipcode,Tallahassee
ZCTA5 32304,12,48568,27876,1070,139200,45650,17453,16390,1934,3694,5057,3194,2511,22793,18685,4108,18685,2545,16140,2022-01-01,zipcode,Tallahassee
ZCTA5 32305,12,20265,49093,918,139100,15621,5759,12948,2341,4185,4002,1337,1083,8614,7513,1101,7513,4555,2958,2022-01-01,zipcode,Tallahassee
ZCTA5 32308,12,23125,72383,1273,279800,19663,7211,17081,615,3113,3996,4903,4454,11875,11014,861,11014,5762,5252,2022-01-01,zipcode,Tallahassee
ZCTA5 32309,12,33675,96879,1228,325400,26319,9394,22417,568,3050,5617,7700,5482,13607,13023,584,13023,10310,2713,2022-01-01,zipcode,Tallahassee
ZCTA5 32310,12,14407,37675,949,105100,11598,4759,8398,1255,2970,2258,1249,666,7552,5793,1759,5793,2795,2998,2022-01-01,zipcode,Tallahassee
ZCTA5 32311,12,20442,82392,1449,268400,16497,4359,14264,446,2418,3171,4321,3908,9727,8913,814,8913,5686,3227,2022-01-01,zipcode,Tallahassee
ZCTA5 32312,12,32244,113131,1438,377800,25436,9104,21823,537,2044,5395,7607,6240,13140,12408,732,12408,10426,1982,2022-01-01,zipcode,Tallahassee
ZCTA5 32317,12,14515,113973,1373,334400,11987,4698,10244,419,1607,2497,2969,2752,5602,5280,322,5280,4848,432,2022-01-01,zipcode,Tallahassee
ZCTA5 32320,12,3707,60528,1404,225400,3168,1534,3017,663,867,800,394,293,2084,1652,432,1652,1210,442,2022-01-01,zipcode,Apalachicola
ZCTA5 32321,12,5995,47963,887,117200,5098,3119,4363,917,1808,872,454,312,2309,1774,535,1774,1396,378,2022-01-01,zipcode,Bristol
ZCTA5 32322,12,4253,45625,1113,202200,3618,2612,3355,925,1365,713,196,156,2081,1186,895,1186,972,214,2022-01-01,zipcode,Carrabelle
ZCTA5 32323,12,104,-666666666,-666666666,-666666666,104,104,104,0,24,43,19,18,324,61,263,61,33,28,2022-01-01,zipcode,
ZCTA5 32324,12,4981,41418,693,72300,4484,3161,4072,957,1825,960,186,144,2102,1647,455,1647,1164,483,2022-01-01,zipcode,Chattahoochee
ZCTA5 32327,12,30090,73829,1007,199000,24613,10028,21350,2298,7885,6958,2481,1728,11509,10507,1002,10507,8503,2004,2022-01-01,zipcode,Crawfordville
ZCTA5 32328,12,3716,57500,852,253300,3096,1314,2771,309,761,925,382,394,3084,1578,1506,1578,1352,226,2022-01-01,zipcode,Eastpoint
ZCTA5 32330,12,757,43648,800,138300,554,289,467,234,122,83,28,0,336,283,53,283,107,176,2022-01-01,zipcode,Greensboro
ZCTA5 32331,12,4830,51678,868,79800,3917,2330,3577,559,1685,1061,257,15,2221,1767,454,1767,1504,263,2022-01-01,zipcode,Greenville
ZCTA5 32332,12,1097,27256,671,79000,963,556,817,265,309,117,89,37,594,487,107,487,196,291,2022-01-01,zipcode,Gretna
ZCTA5 32333,12,11688,58169,904,200700,9749,4363,8967,1212,2287,2481,2129,858,5226,4677,549,4677,3843,834,2022-01-01,zipcode,Havana
ZCTA5 32334,12,1611,54828,868,109900,1338,580,1055,94,435,363,64,99,748,612,136,612,516,96,2022-01-01,zipcode,Hosford
ZCTA5 32336,12,1370,34840,1012,73800,1096,707,924,130,393,261,73,67,756,521,235,521,408,113,2022-01-01,zipcode,Lamont
ZCTA5 32340,12,10213,36795,825,105200,8666,5037,7835,1609,2826,2351,631,418,4560,3675,885,3675,2432,1243,2022-01-01,zipcode,Madison
ZCTA5 32343,12,3517,58393,1097,183400,2345,753,1858,231,523,704,227,173,1177,1103,74,1103,978,125,2022-01-01,zipcode,Midway
ZCTA5 32344,12,12335,49785,710,174500,10509,5066,9354,1440,3492,2503,1271,648,5812,4771,1041,4771,3547,1224,2022-01-01,zipcode,Monticello
ZCTA5 32346,12,2326,56176,1489,225400,1965,1116,1863,342,641,517,238,125,1739,938,801,938,802,136,2022-01-01,zipcode,Panacea
ZCTA5 32347,12,7052,62411,810,106900,5536,2361,4735,490,1715,1623,725,182,3352,2589,763,2589,1903,686,2022-01-01,zipcode,Perry
ZCTA5 32348,12,12827,46157,961,88100,10843,7207,9709,2099,4425,1999,733,453,5384,3973,1411,3973,3003,970,2022-01-01,zipcode,Perry
ZCTA5 32350,12,1563,47946,-666666666,80000,1339,769,1259,137,363,444,261,54,821,690,131,690,552,138,2022-01-01,zipcode,Pinetta
ZCTA5 32351,12,16563,38955,758,110800,12893,6838,10956,2366,4263,2577,992,758,6889,5537,1352,5537,3699,1838,2022-01-01,zipcode,Quincy
ZCTA5 32352,12,5143,47070,1020,134300,3991,1802,3430,755,1421,863,205,186,2622,2151,471,2151,1741,410,2022-01-01,zipcode,Quincy
ZCTA5 32355,12,291,47500,1022,210000,283,193,263,14,98,139,12,0,244,148,96,148,114,34,2022-01-01,zipcode,Saint marks
ZCTA5 32356,12,79,-666666666,-666666666,-666666666,79,77,79,0,75,0,4,0,75,75,0,75,75,0,2022-01-01,zipcode,Salem
ZCTA5 32358,12,1521,94583,1551,220700,1350,699,1269,166,392,318,315,78,1193,623,570,623,541,82,2022-01-01,zipcode,Sopchoppy
ZCTA5 32359,12,1007,45500,-666666666,84700,949,600,875,41,377,308,114,35,2018,538,1480,538,508,30,2022-01-01,zipcode,Steinhatchee
ZCTA5 32361,12,297,112969,911,110900,265,121,249,44,60,113,32,0,162,162,0,162,128,34,2022-01-01,zipcode,Wacissa
ZCTA5 32399,12,0,-666666666,-666666666,-666666666,0,0,0,0,0,0,0,0,0,0,0,0,0,0,2022-01-01,zipcode,Tallahassee
ZCTA5 32401,12,18120,46603,1055,172200,15257,6486,13440,2081,4560,4193,1617,989,9945,8613,1332,8613,4880,3733,2022-01-01,zipcode,Panama city
ZCTA5 32403,12,746,90104,1712,-666666666,606,83,201,0,18,97,62,24,225,133,92,133,0,133,2022-01-01,zipcode,Panama city
ZCTA5 32404,12,40969,66230,1259,211100,32933,12861,28849,3796,9762,9877,3569,1845,17389,15041,2348,15041,10813,4228,2022-01-01,zipcode,Panama city
ZCTA5 32405,12,29661,68070,1320,232400,23454,8604,20167,1623,5330,7543,3283,2388,13396,12043,1353,12043,7571,4472,2022-01-01,zipcode,Panama city
ZCTA5 32407,12,14710,75093,1750,334000,12334,4012,10836,650,2205,4123,2356,1502,11893,6459,5434,6459,3789,2670,2022-01-01,zipcode,Panama city beach
ZCTA5 32408,12,18594,64561,1295,318200,15850,5734,14864,690,3078,5391,3718,1987,17115,8949,8166,8949,6277,2672,2022-01-01,zipcode,Panama city
ZCTA5 32409,12,10518,56276,1255,173800,8337,3823,7400,936,2511,2356,1061,536,4328,3835,493,3835,3421,414,2022-01-01,zipcode,Panama city
ZCTA5 32410,12,412,60152,1434,308300,394,183,394,6,74,187,76,51,748,242,506,242,185,57,2022-01-01,zipcode,Mexico beach
ZCTA5 32413,12,14820,75970,1460,348600,13460,5246,11993,778,2856,4261,2648,1450,15546,7164,8382,7164,5218,1946,2022-01-01,zipcode,Panama city beach
ZCTA5 32420,12,2712,46703,632,115700,2239,986,2073,292,840,739,181,21,1566,1275,291,1275,1180,95,2022-01-01,zipcode,Alford
ZCTA5 32421,12,3929,41923,755,110800,3068,1595,2806,572,1045,928,217,44,1655,1310,345,1310,1074,236,2022-01-01,zipcode,Altha
ZCTA5 32423,12,872,53016,642,169700,820,518,760,23,340,243,146,8,637,475,162,475,454,21,2022-01-01,zipcode,Bascom
ZCTA5 32424,12,7516,41400,582,123100,6459,4101,5582,1204,2449,1310,422,197,2818,2252,566,2252,1612,640,2022-01-01,zipcode,Blountstown
ZCTA5 32425,12,13970,41658,812,100900,11586,6484,10131,2010,4831,2470,554,266,6014,4978,1036,4978,3688,1290,2022-01-01,zipcode,Bonifay
ZCTA5 32426,12,826,37396,950,86000,719,512,631,248,247,109,20,7,357,269,88,269,253,16,2022-01-01,zipcode,Campbellton
ZCTA5 32427,12,1111,39500,874,95600,957,392,752,197,353,122,33,47,500,466,34,466,238,228,2022-01-01,zipcode,Caryville
ZCTA5 32428,12,17801,48984,915,141000,14416,8077,12866,2052,5142,3877,1078,717,7283,6165,1118,6165,4860,1305,2022-01-01,zipcode,Chipley
ZCTA5 32430,12,732,58860,-666666666,114900,581,176,557,79,259,157,6,56,321,313,8,313,266,47,2022-01-01,zipcode,Clarksville
ZCTA5 32431,12,4515,54821,759,113000,3768,1927,3390,394,1653,831,331,181,2245,1852,393,1852,1465,387,2022-01-01,zipcode,Cottondale
ZCTA5 32432,12,0,-666666666,-666666666,-666666666,0,0,0,0,0,0,0,0,0,0,0,0,0,0,2022-01-01,zipcode,Cypress
ZCTA5 32433,12,18387,50424,983,111300,14337,6611,13070,2157,5470,3688,1185,570,7992,6833,1159,6833,5065,1768,2022-01-01,zipcode,Defuniak springs
ZCTA5 32435,12,6525,68208,823,168800,5282,2177,4611,425,1595,1395,791,405,3003,2595,408,2595,2097,498,2022-01-01,zipcode,Defuniak springs
ZCTA5 32437,12,620,47176,800,-666666666,531,174,502,48,223,215,16,0,344,311,33,311,239,72,2022-01-01,zipcode,Ebro
ZCTA5 32438,12,4858,40526,818,119600,3874,1897,3096,668,1119,966,277,66,2158,1856,302,1856,1559,297,2022-01-01,zipcode,Fountain
ZCTA5 32439,12,14572,71685,1454,311700,11284,4426,9953,505,2475,3972,2153,848,6523,5661,862,5661,4517,1144,2022-01-01,zipcode,Freeport
ZCTA5 32440,12,8239,52979,766,95300,7174,4166,6049,1231,2436,1527,552,303,2601,2300,301,2300,1520,780,2022-01-01,zipcode,Graceville
ZCTA5 32442,12,3795,46964,729,122600,3068,1526,2605,290,1210,791,181,133,1769,1442,327,1442,996,446,2022-01-01,zipcode,Grand ridge
ZCTA5 32443,12,2850,46274,736,115200,2327,1273,1961,310,629,660,229,133,1222,1004,218,1004,831,173,2022-01-01,zipcode,Greenwood
ZCTA5 32444,12,21564,84893,1436,270100,16441,5283,13878,844,3327,5271,3148,1288,8934,8027,907,8027,5747,2280,2022-01-01,zipcode,Lynn haven
ZCTA5 32445,12,2415,55032,724,99700,2122,1684,1964,600,748,509,63,44,538,457,81,457,275,182,2022-01-01,zipcode,Malone
ZCTA5 32446,12,10676,50185,827,138600,8926,4278,7730,682,2837,2681,761,769,4500,3824,676,3824,2752,1072,2022-01-01,zipcode,Marianna
ZCTA5 32448,12,7561,31427,750,99200,5708,3401,4906,652,2082,1579,429,164,3752,3255,497,3255,2230,1025,2022-01-01,zipcode,Marianna
ZCTA5 32449,12,1037,29297,-666666666,-666666666,708,359,661,181,261,119,88,12,545,351,194,351,266,85,2022-01-01,zipcode,Wewahitchka
ZCTA5 32455,12,4239,47547,679,99600,3520,1599,3154,534,1616,684,250,70,2109,1728,381,1728,1371,357,2022-01-01,zipcode,Ponce de leon
ZCTA5 32456,12,7775,67922,1293,289000,6633,3187,6129,340,1644,2036,1197,912,6248,3551,2697,3551,2788,763,2022-01-01,zipcode,Port saint joe
ZCTA5 32459,12,20558,99081,1932,499900,17048,5857,15247,728,2986,4376,5023,2134,16626,8638,7988,8638,6846,1792,2022-01-01,zipcode,Santa rosa beach
ZCTA5 32460,12,5488,48000,750,104700,4998,3562,4520,964,1552,1521,241,242,1980,1628,352,1628,1248,380,2022-01-01,zipcode,Sneads
ZCTA5 32461,12,2589,154750,2392,844300,2239,1162,2211,65,292,613,869,372,5419,1152,4267,1152,971,181,2022-01-01,zipcode,Inlet beach
ZCTA5 32462,12,3417,36827,747,122400,2976,1886,2657,565,1346,536,93,117,1648,1291,357,1291,1030,261,2022-01-01,zipcode,Vernon
ZCTA5 32463,12,158,-666666666,743,-666666666,137,36,104,17,42,40,0,5,78,69,9,69,34,35,2022-01-01,zipcode,Wausau
ZCTA5 32464,12,3461,54816,792,122400,2849,1229,2556,337,884,880,284,171,1856,1457,399,1457,1338,119,2022-01-01,zipcode,Westville
ZCTA5 32465,12,7846,44781,854,113500,6995,4645,6261,1386,2512,1730,441,192,3352,2426,926,2426,1908,518,2022-01-01,zipcode,Wewahitchka
ZCTA5 32466,12,6167,64424,1090,158300,4732,2095,4233,395,1666,1774,294,104,2490,2187,303,2187,1675,512,2022-01-01,zipcode,Youngstown
ZCTA5 32501,12,10908,35344,906,253500,8887,4474,7613,1227,2312,2107,1137,830,5580,4647,933,4647,2192,2455,2022-01-01,zipcode,Pensacola
ZCTA5 32502,12,3887,65713,1173,233900,3385,1108,2878,261,607,959,594,457,2403,1883,520,1883,979,904,2022-01-01,zipcode,Pensacola
ZCTA5 32503,12,33875,64857,1141,236800,28382,10035,21111,1240,4758,6745,4824,3544,14735,13196,1539,13196,8813,4383,2022-01-01,zipcode,Pensacola
ZCTA5 32504,12,21710,69017,1194,229300,17755,6955,15340,1137,2930,5326,3397,2550,10192,9590,602,9590,5824,3766,2022-01-01,zipcode,Pensacola
ZCTA5 32505,12,28055,39672,1035,100900,21196,9799,18360,3031,6803,6237,1325,964,12698,10858,1840,10858,5229,5629,2022-01-01,zipcode,Pensacola
ZCTA5 32506,12,36066,57302,1180,177400,29666,11399,25124,3019,7166,9073,4254,1612,16535,14547,1988,14547,8724,5823,2022-01-01,zipcode,Pensacola
ZCTA5 32507,12,32766,64269,1166,240600,26698,10360,22753,2104,5228,8407,4646,2368,18742,13620,5122,13620,8653,4967,2022-01-01,zipcode,Pensacola
ZCTA5 32508,12,5015,61094,1721,-666666666,4551,401,1364,10,230,435,523,166,601,533,68,533,0,533,2022-01-01,zipcode,Pensacola
ZCTA5 32509,12,428,-666666666,-666666666,-666666666,428,428,428,135,142,139,0,12,0,0,0,0,0,0,2022-01-01,zipcode,Pensacola
ZCTA5 32511,12,1145,-666666666,-666666666,-666666666,1145,65,142,0,12,69,61,0,0,0,0,0,0,0,2022-01-01,zipcode,Pensacola
ZCTA5 32514,12,43940,64431,1271,203300,35786,13095,28922,2098,7588,9563,5379,4294,19149,17638,1511,17638,8548,9090,2022-01-01,zipcode,Pensacola
ZCTA5 32526,12,41522,69533,1298,202100,33447,13618,29763,2025,8788,11882,4870,2198,17351,16120,1231,16120,12592,3528,2022-01-01,zipcode,Pensacola
ZCTA5 32530,12,38,-666666666,-666666666,-666666666,21,0,21,0,0,21,0,0,8,8,0,8,8,0,2022-01-01,zipcode,Bagdad
ZCTA5 32531,12,7235,79258,874,266900,5563,2373,5217,252,1953,1695,814,503,3343,2983,360,2983,2531,452,2022-01-01,zipcode,Baker
ZCTA5 32533,12,29975,83099,998,237300,23682,9388,20947,1791,5942,7571,3921,1722,11600,10796,804,10796,9196,1600,2022-01-01,zipcode,Cantonment
ZCTA5 32534,12,15448,56517,1213,164900,12802,4570,11302,767,3453,4675,1639,768,7522,6928,594,6928,4130,2798,2022-01-01,zipcode,Pensacola
ZCTA5 32535,12,5510,39828,814,88000,4794,3048,4088,847,1937,1034,179,91,2067,1667,400,1667,1105,562,2022-01-01,zipcode,Century
ZCTA5 32536,12,25210,77864,1285,251000,19376,6707,15477,1276,4155,5854,2368,1824,9348,8786,562,8786,6102,2684,2022-01-01,zipcode,Crestview
ZCTA5 32539,12,31392,68183,1210,241300,24572,10042,21083,1795,5940,8755,3161,1432,12011,11076,935,11076,8597,2479,2022-01-01,zipcode,Crestview
ZCTA5 32541,12,18784,89826,1830,476400,15668,5112,14446,775,2405,4462,4616,2188,16246,8442,7804,8442,5560,2882,2022-01-01,zipcode,Destin
ZCTA5 32542,12,3841,66100,1839,-666666666,2868,340,1475,69,212,674,365,155,1082,911,171,911,0,911,2022-01-01,zipcode,Eglin afb
ZCTA5 32544,12,2315,39068,1781,-666666666,1576,267,929,0,161,350,384,34,627,533,94,533,0,533,2022-01-01,zipcode,Hurlburt field
ZCTA5 32547,12,34124,61407,1279,272100,27998,9321,24471,2608,6287,9270,4456,1850,16188,14883,1305,14883,8429,6454,2022-01-01,zipcode,Fort walton beach
ZCTA5 32548,12,23575,61037,1225,270500,19311,6346,16990,1262,4795,5767,3270,1896,14148,10239,3909,10239,5984,4255,2022-01-01,zipcode,Fort walton beach
ZCTA5 32550,12,8722,80000,2108,557700,8049,3911,7298,100,1219,1954,2531,1494,14345,4236,10109,4236,3077,1159,2022-01-01,zipcode,Miramar beach
ZCTA5 32561,12,9495,118074,1609,526300,7848,3358,7193,140,785,1847,2407,2014,6526,4111,2415,4111,3272,839,2022-01-01,zipcode,Gulf breeze
ZCTA5 32563,12,28511,94175,1600,340400,23556,9089,20419,792,4321,7168,5380,2758,12361,11030,1331,11030,9010,2020,2022-01-01,zipcode,Gulf breeze
ZCTA5 32564,12,2350,65750,885,119300,2075,1032,1725,202,539,759,136,89,962,900,62,900,741,159,2022-01-01,zipcode,Holt
ZCTA5 32565,12,5515,77553,1032,182000,4296,1728,3728,405,1400,1192,595,136,2492,2082,410,2082,1645,437,2022-01-01,zipcode,Jay
ZCTA5 32566,12,42878,98065,1695,327700,33492,12606,29229,1385,6414,12065,5649,3716,17575,15663,1912,15663,12416,3247,2022-01-01,zipcode,Navarre
ZCTA5 32567,12,4837,71205,-666666666,212600,3507,1619,2915,360,936,1230,241,148,2032,1705,327,1705,1470,235,2022-01-01,zipcode,Laurel hill
ZCTA5 32568,12,3610,65296,1041,201800,2966,1225,2597,247,944,980,224,202,1491,1347,144,1347,1171,176,2022-01-01,zipcode,Mc david
ZCTA5 32569,12,12936,70426,1371,272800,11116,3368,9449,543,2381,2714,2713,1098,5517,5106,411,5106,3546,1560,2022-01-01,zipcode,Mary esther
ZCTA5 32570,12,34755,70335,1201,220100,28966,11571,24869,1942,8492,8897,4018,1520,15505,13957,1548,13957,9225,4732,2022-01-01,zipcode,Milton
ZCTA5 32571,12,39756,84287,1133,246800,30468,12625,26363,1924,7260,8826,5444,2909,14748,13914,834,13914,11707,2207,2022-01-01,zipcode,Milton
ZCTA5 32577,12,4313,68269,903,190400,3479,1223,3009,177,1029,895,787,121,1901,1724,177,1724,1529,195,2022-01-01,zipcode,Molino
ZCTA5 32578,12,34022,101422,1682,386300,26994,10198,23689,730,5118,7598,5060,5183,14477,13065,1412,13065,9957,3108,2022-01-01,zipcode,Niceville
ZCTA5 32579,12,10596,92344,1449,389100,8932,3568,7823,417,1520,2123,1893,1870,5084,4483,601,4483,3197,1286,2022-01-01,zipcode,Shalimar
ZCTA5 32580,12,4038,79643,1213,328300,3113,982,2723,85,476,1159,708,295,1914,1630,284,1630,1005,625,2022-01-01,zipcode,Valparaiso
ZCTA5 32583,12,30534,82416,1265,219100,26233,12629,23344,3269,7809,7440,3035,1791,10698,9979,719,9979,8245,1734,2022-01-01,zipcode,Milton
ZCTA5 32601,12,22544,29059,1031,231800,20585,9129,8947,275,1514,2119,2574,2465,10364,9015,1349,9015,2175,6840,2022-01-01,zipcode,Gainesville
ZCTA5 32603,12,6855,12894,1138,284100,6675,3968,1095,59,59,187,268,522,2689,2043,646,2043,168,1875,2022-01-01,zipcode,Gainesville
ZCTA5 32605,12,26313,80939,1382,247600,21990,7658,18964,783,2023,4732,6216,5210,11467,10758,709,10758,8068,2690,2022-01-01,zipcode,Gainesville
ZCTA5 32606,12,23317,77733,1576,294900,19360,7285,16278,317,2682,3691,4278,5310,11456,10266,1190,10266,4850,5416,2022-01-01,zipcode,Gainesville
ZCTA5 32607,12,30306,48656,1178,276400,26211,8529,16756,842,3053,4023,4354,4484,15998,13077,2921,13077,4589,8488,2022-01-01,zipcode,Gainesville
ZCTA5 32608,12,53301,57249,1285,321200,46069,16154,32067,1662,4378,7386,8784,9857,25653,22032,3621,22032,8920,13112,2022-01-01,zipcode,Gainesville
ZCTA5 32609,12,18983,45301,1046,155000,15740,6334,13586,1876,3645,4256,2463,1346,8326,7486,840,7486,4083,3403,2022-01-01,zipcode,Gainesville
ZCTA5 32612,12,8795,-666666666,-666666666,-666666666,8795,6975,16,0,4,9,3,0,0,0,0,0,0,0,2022-01-01,zipcode,Gainesville
ZCTA5 32615,12,15295,71984,1100,274300,11967,4527,10711,574,2915,2910,2703,1609,6720,5993,727,5993,4549,1444,2022-01-01,zipcode,Alachua
ZCTA5 32616,12,123,-666666666,-666666666,-666666666,100,52,100,48,51,0,1,0,71,71,0,71,0,71,2022-01-01,zipcode,
ZCTA5 32617,12,4525,45931,818,185400,4025,2368,3620,290,1674,924,611,121,1763,1473,290,1473,1239,234,2022-01-01,zipcode,Anthony
ZCTA5 32618,12,8111,57674,950,175800,6694,2549,6086,583,2006,2058,666,773,3700,3441,259,3441,2832,609,2022-01-01,zipcode,Archer
ZCTA5 32619,12,5004,56019,615,146300,4320,1841,3572,545,1475,1128,311,113,2141,2023,118,2023,1712,311,2022-01-01,zipcode,Bell
ZCTA5 32621,12,5332,49980,721,124100,4430,2137,3936,592,1641,1201,417,85,2341,2238,103,2238,1819,419,2022-01-01,zipcode,Bronson
ZCTA5 32622,12,1712,66563,678,214900,1343,494,1197,175,378,361,165,118,636,624,12,624,372,252,2022-01-01,zipcode,Brooker
ZCTA5 32625,12,1628,66938,872,241900,1422,743,1224,88,351,345,209,231,1300,725,575,725,579,146,2022-01-01,zipcode,Cedar key
ZCTA5 32626,12,8552,45311,828,142300,6844,3656,6115,731,2805,1816,554,209,4321,3528,793,3528,2608,920,2022-01-01,zipcode,Chiefland
ZCTA5 32628,12,5235,39835,814,91200,4354,2815,3811,779,1810,863,310,49,1984,1602,382,1602,1263,339,2022-01-01,zipcode,Cross city
ZCTA5 32631,12,370,38836,-666666666,163400,312,145,312,0,95,81,136,0,188,172,16,172,172,0,2022-01-01,zipcode,Earleton
ZCTA5 32639,12,261,39727,-666666666,-666666666,178,119,178,0,115,0,32,31,179,119,60,119,119,0,2022-01-01,zipcode,Gulf hammock
ZCTA5 32640,12,10360,54162,1012,151700,8522,4404,7876,1298,2796,2637,671,474,5103,4148,955,4148,3493,655,2022-01-01,zipcode,Hawthorne
ZCTA5 32641,12,16898,37083,955,121800,12461,5874,10693,1695,3861,3392,1186,559,6247,5406,841,5406,3158,2248,2022-01-01,zipcode,Gainesville
ZCTA5 32643,12,11590,67923,1237,218000,8752,3808,7737,750,2239,2957,1175,616,4564,4122,442,4122,3460,662,2022-01-01,zipcode,High springs
ZCTA5 32648,12,316,61346,-666666666,187500,229,110,174,67,60,47,0,0,540,100,440,100,100,0,2022-01-01,zipcode,Horseshoe beach
ZCTA5 32653,12,15524,86508,1081,251900,12214,5019,11042,267,1899,3080,2623,3173,6755,6344,411,6344,5198,1146,2022-01-01,zipcode,Gainesville
ZCTA5 32656,12,14702,63707,973,180100,11604,4892,9983,1154,3224,3651,1107,847,6419,5350,1069,5350,4351,999,2022-01-01,zipcode,Keystone heights
ZCTA5 32658,12,354,78796,-666666666,77400,349,141,224,0,87,129,8,0,63,60,3,60,52,8,2022-01-01,zipcode,La crosse
ZCTA5 32664,12,285,57279,-666666666,266700,218,141,218,0,63,68,64,23,168,137,31,137,102,35,2022-01-01,zipcode,Mc intosh
ZCTA5 32666,12,6313,63395,629,175300,5529,2569,5111,263,1907,1677,550,714,3689,2681,1008,2681,2349,332,2022-01-01,zipcode,Melrose
ZCTA5 32667,12,4334,72179,1023,256800,3882,1774,3313,161,657,1122,551,822,2171,1816,355,1816,1370,446,2022-01-01,zipcode,Micanopy
ZCTA5 32668,12,5115,51843,629,188200,4378,2162,3977,577,1698,1159,319,224,2409,2175,234,2175,1846,329,2022-01-01,zipcode,Morriston
ZCTA5 32669,12,16100,97639,1341,283800,12346,4162,10429,301,2084,3576,2148,2320,6371,5857,514,5857,5162,695,2022-01-01,zipcode,Newberry
ZCTA5 32680,12,10622,45182,796,92800,9046,5112,8062,1497,3966,2098,250,251,5796,4199,1597,4199,3491,708,2022-01-01,zipcode,Old town
ZCTA5 32681,12,288,51061,-666666666,-666666666,288,187,288,72,194,22,0,0,131,83,48,83,72,11,2022-01-01,zipcode,Orange lake
ZCTA5 32683,12,310,60984,-666666666,-666666666,203,117,155,27,97,24,7,0,136,111,25,111,59,52,2022-01-01,zipcode,Otter creek
ZCTA5 32686,12,5273,55641,762,309800,4523,2008,3791,374,1032,1647,357,381,2666,2238,428,2238,1459,779,2022-01-01,zipcode,Reddick
ZCTA5 32692,12,88,-666666666,-666666666,168800,88,88,88,24,43,0,21,0,634,63,571,63,63,0,2022-01-01,zipcode,Suwannee
ZCTA5 32693,12,11426,58095,882,160800,9651,4759,8282,1124,3041,2840,798,479,4851,4221,630,4221,3502,719,2022-01-01,zipcode,Trenton
ZCTA5 32694,12,1992,50854,672,115200,1716,657,1539,230,696,307,191,115,1334,1064,270,1064,704,360,2022-01-01,zipcode,Waldo
ZCTA5 32696,12,13915,54688,792,186900,11150,5266,9916,1259,3765,2924,1522,446,5956,5485,471,5485,4351,1134,2022-01-01,zipcode,Williston
ZCTA5 32697,12,185,82083,990,93600,125,45,93,19,21,38,10,5,122,71,51,71,25,46,2022-01-01,zipcode,Worthington springs
ZCTA5 32701,12,24551,61404,1415,253200,20776,6524,18635,1315,3517,7308,4762,1733,12149,11206,943,11206,5560,5646,2022-01-01,zipcode,Altamonte springs
ZCTA5 32702,12,2490,47179,3501,79400,2199,1428,1986,237,856,489,213,191,1551,1235,316,1235,686,549,2022-01-01,zipcode,Altoona
ZCTA5 32703,12,57046,63693,1410,276900,45036,16014,39484,5376,11717,11284,8092,3015,21589,20148,1441,20148,13418,6730,2022-01-01,zipcode,Apopka
ZCTA5 32707,12,38868,64381,1426,276800,31815,10324,28299,2389,6844,9192,6727,3147,16912,16207,705,16207,10914,5293,2022-01-01,zipcode,Casselberry
ZCTA5 32708,12,47437,84952,1596,318200,40092,12485,34643,1405,5597,11064,10964,5613,20252,19430,822,19430,14220,5210,2022-01-01,zipcode,Winter springs
ZCTA5 32709,12,1545,92550,-666666666,332300,1351,411,1197,158,285,369,313,72,686,633,53,633,524,109,2022-01-01,zipcode,Christmas
ZCTA5 32712,12,49738,97718,1841,361100,39894,13686,34562,3449,8567,10238,7810,4498,17267,15927,1340,15927,13172,2755,2022-01-01,zipcode,Apopka
ZCTA5 32713,12,22430,83468,1461,281700,18856,7539,16446,871,5010,6038,3341,1186,9482,8894,588,8894,7539,1355,2022-01-01,zipcode,Debary
ZCTA5 32714,12,38306,62581,1528,265600,31174,8565,27270,2320,5802,9308,7060,2780,17010,15747,1263,15747,7575,8172,2022-01-01,zipcode,Altamonte springs
ZCTA5 32720,12,33876,67102,1107,262400,28501,12521,23890,2885,7815,7421,3459,2310,13858,12592,1266,12592,8542,4050,2022-01-01,zipcode,Deland
ZCTA5 32724,12,42326,69060,1194,260000,34872,16402,29426,2273,8648,9383,5722,3400,18000,16443,1557,16443,12021,4422,2022-01-01,zipcode,Deland
ZCTA5 32725,12,50825,67131,1448,230400,40758,17138,35947,3581,11950,12993,5158,2265,19163,18290,873,18290,14465,3825,2022-01-01,zipcode,Deltona
ZCTA5 32726,12,23661,57583,909,210500,18957,7350,16473,1995,6301,4987,2227,963,10802,9506,1296,9506,6542,2964,2022-01-01,zipcode,Eustis
ZCTA5 32730,12,6410,45169,1330,256700,5308,1569,4876,313,1375,1884,983,321,3149,2883,266,2883,1136,1747,2022-01-01,zipcode,Casselberry
ZCTA5 32732,12,5104,109625,-666666666,457300,4241,1350,3686,81,1016,1021,881,687,1998,1774,224,1774,1695,79,2022-01-01,zipcode,Geneva
ZCTA5 32735,12,5190,69316,1396,231000,4386,2212,3967,298,1619,1215,598,237,2569,2213,356,2213,1813,400,2022-01-01,zipcode,Grand island
ZCTA5 32736,12,11925,84043,1160,337300,9904,3344,8605,769,2594,3157,1558,527,4585,4186,399,4186,3796,390,2022-01-01,zipcode,Eustis
ZCTA5 32738,12,47917,72044,1393,227000,37887,13503,32666,2789,12268,12168,4072,1369,16659,15887,772,15887,13052,2835,2022-01-01,zipcode,Deltona
ZCTA5 32744,12,3544,91556,1110,290600,2790,1188,2581,351,762,821,420,227,1361,1224,137,1224,1073,151,2022-01-01,zipcode,Lake helen
ZCTA5 32746,12,45331,103941,1780,378100,38003,12684,33262,1155,5289,9471,10770,6577,19909,18575,1334,18575,12026,6549,2022-01-01,zipcode,Lake mary
ZCTA5 32750,12,25176,81799,1563,318100,20515,6691,18787,1194,4557,6097,4615,2324,10295,9610,685,9610,7255,2355,2022-01-01,zipcode,Longwood
ZCTA5 32751,12,22815,88599,1629,402700,19165,5636,16731,600,2447,4533,5463,3688,10652,9792,860,9792,6067,3725,2022-01-01,zipcode,Maitland
ZCTA5 32754,12,11399,64855,1016,231900,9892,5418,8891,941,3083,3051,1320,496,5643,4432,1211,4432,4092,340,2022-01-01,zipcode,Mims
ZCTA5 32757,12,31758,70044,1386,313800,26043,12095,23569,1697,6694,7105,4669,3404,14481,12777,1704,12777,9561,3216,2022-01-01,zipcode,Mount dora
ZCTA5 32759,12,2683,59250,1040,254000,2281,1277,2145,233,888,621,242,161,1415,1031,384,1031,868,163,2022-01-01,zipcode,Oak hill
ZCTA5 32763,12,24852,61447,1366,207500,20915,8499,18220,1789,5776,6758,2604,1293,11452,10443,1009,10443,6484,3959,2022-01-01,zipcode,Orange city
ZCTA5 32764,12,2642,80675,-666666666,307300,2298,1086,2032,227,805,523,408,69,1266,1053,213,1053,971,82,2022-01-01,zipcode,Osteen
ZCTA5 32765,12,63210,98584,1832,384900,50975,16839,40341,1385,6391,11172,14011,7382,23170,21886,1284,21886,15860,6026,2022-01-01,zipcode,Oviedo
ZCTA5 32766,12,16425,134831,1972,473100,12559,4012,10616,493,2079,2851,2724,2469,5064,5059,5,5059,4478,581,2022-01-01,zipcode,Oviedo
ZCTA5 32767,12,3040,64539,1059,114000,2562,1176,2326,418,1011,847,50,0,1317,1061,256,1061,914,147,2022-01-01,zipcode,Paisley
ZCTA5 32771,12,59134,70388,1441,308100,47610,16336,40422,3975,10577,12191,8488,5191,23221,21732,1489,21732,13286,8446,2022-01-01,zipcode,Sanford
ZCTA5 32773,12,32342,61004,1407,228300,25625,8615,22701,2262,8097,6871,3877,1594,13134,12310,824,12310,7118,5192,2022-01-01,zipcode,Sanford
ZCTA5 32776,12,11681,96136,898,359700,9608,2930,8879,600,1937,4306,1177,859,4874,4324,550,4324,3850,474,2022-01-01,zipcode,Sorrento
ZCTA5 32778,12,24317,57071,1203,209600,20815,11502,19059,2389,5379,6610,3234,1447,12637,10820,1817,10820,8353,2467,2022-01-01,zipcode,Tavares
ZCTA5 32779,12,29111,107727,1787,418200,23984,9051,21405,664,3337,5936,6832,4636,11612,11108,504,11108,8922,2186,2022-01-01,zipcode,Longwood
ZCTA5 32780,12,38552,58940,1163,223300,32778,15366,28737,2434,8018,10706,5026,2553,20114,16185,3929,16185,11602,4583,2022-01-01,zipcode,Titusville
ZCTA5 32784,12,10545,67931,855,207900,8903,3778,7768,906,3104,2761,509,488,5285,4284,1001,4284,3476,808,2022-01-01,zipcode,Umatilla
ZCTA5 32789,12,26741,101113,1623,625700,23056,9515,19340,523,2692,3830,6679,5616,12718,11413,1305,11413,7454,3959,2022-01-01,zipcode,Winter park
ZCTA5 32792,12,52120,63365,1470,318300,43783,14506,35619,2829,7487,10578,8735,5990,23870,21924,1946,21924,10268,11656,2022-01-01,zipcode,Winter park
ZCTA5 32796,12,20757,59880,1111,210000,17401,8523,15707,1502,5648,4773,2425,1359,9812,8447,1365,8447,6957,1490,2022-01-01,zipcode,Titusville
ZCTA5 32798,12,2437,53782,985,150900,2311,1341,2277,113,839,1087,187,51,1523,1274,249,1274,1208,66,2022-01-01,zipcode,Zellwood
ZCTA5 32801,12,14778,75646,1629,394500,13791,4094,12500,700,2210,1800,4662,3128,11336,9246,2090,9246,2638,6608,2022-01-01,zipcode,Orlando
ZCTA5 32803,12,22067,92557,1719,379700,19620,4816,18322,640,2890,4266,6644,3882,11532,10563,969,10563,5530,5033,2022-01-01,zipcode,Orlando
ZCTA5 32804,12,20542,108662,1586,484200,17828,4942,15857,499,2590,3134,5602,4032,9998,8855,1143,8855,5838,3017,2022-01-01,zipcode,Orlando
ZCTA5 32805,12,17791,38885,969,220000,15109,5858,13798,2846,5271,3203,1675,803,9350,6846,2504,6846,3262,3584,2022-01-01,zipcode,Orlando
ZCTA5 32806,12,26927,89102,1412,394100,22777,6054,20730,1071,3507,4940,6596,4616,12498,11430,1068,11430,7326,4104,2022-01-01,zipcode,Orlando
ZCTA5 32807,12,35479,57039,1376,221800,29212,8510,25173,4121,7642,7754,3756,1900,13710,12760,950,12760,6231,6529,2022-01-01,zipcode,Orlando
ZCTA5 32808,12,62827,43726,1311,193300,46410,15590,38710,8941,13866,11245,3283,1375,21248,19816,1432,19816,8256,11560,2022-01-01,zipcode,Orlando
ZCTA5 32809,12,29207,50220,1216,243300,23458,8982,20602,4266,7439,4568,2919,1410,10775,9352,1423,9352,5149,4203,2022-01-01,zipcode,Orlando
ZCTA5 32810,12,37755,60104,1460,240700,29806,8772,26205,3558,6844,8264,5465,2074,14733,13560,1173,13560,6936,6624,2022-01-01,zipcode,Orlando
ZCTA5 32811,12,40191,46772,1371,164300,31802,9912,26612,3492,8569,7524,5048,1979,18310,13958,4352,13958,4286,9672,2022-01-01,zipcode,Orlando
ZCTA5 32812,12,35822,66774,1390,315900,29169,9587,25552,2348,6318,7805,6501,2580,15192,13958,1234,13958,8118,5840,2022-01-01,zipcode,Orlando
ZCTA5 32814,12,9500,123635,2168,723600,7780,1864,6894,18,374,884,2499,3119,4456,4156,300,4156,1480,2676,2022-01-01,zipcode,Orlando
ZCTA5 32817,12,36808,76402,1610,292300,31803,12124,22265,1705,5643,7091,4814,3012,13551,11611,1940,11611,6785,4826,2022-01-01,zipcode,Orlando
ZCTA5 32818,12,62566,54178,1367,250600,47524,14095,40098,7893,11865,12303,5623,2414,18760,17803,957,17803,9956,7847,2022-01-01,zipcode,Orlando
ZCTA5 32819,12,27826,86306,1777,421300,23726,8929,20772,1528,3728,5326,6534,3656,14590,10445,4145,10445,6171,4274,2022-01-01,zipcode,Orlando
ZCTA5 32820,12,10927,105912,1647,365200,8544,2305,7024,564,1698,1674,1685,1403,3433,3190,243,3190,2582,608,2022-01-01,zipcode,Orlando
ZCTA5 32821,12,20034,57098,1686,274600,17025,4623,14128,588,2837,4510,4807,1386,15208,8654,6554,8654,2932,5722,2022-01-01,zipcode,Orlando
ZCTA5 32822,12,68321,51555,1507,205300,56540,19780,48437,5919,15800,14327,8662,3729,26887,23943,2944,23943,10044,13899,2022-01-01,zipcode,Orlando
ZCTA5 32824,12,56484,75125,1716,313600,44330,12788,38859,4251,11209,11752,7775,3872,19619,15895,3724,15895,11935,3960,2022-01-01,zipcode,Orlando
ZCTA5 32825,12,63056,78321,1652,298100,52063,15511,42562,3973,9599,14795,9387,4808,21992,20263,1729,20263,13380,6883,2022-01-01,zipcode,Orlando
ZCTA5 32826,12,28428,59358,1399,221700,25667,11151,15015,1359,4052,4515,2931,2158,10259,9314,945,9314,4524,4790,2022-01-01,zipcode,Orlando
ZCTA5 32827,12,17918,111725,2091,516500,13612,4774,11364,202,2095,2752,3241,3074,7161,5827,1334,5827,3889,1938,2022-01-01,zipcode,Orlando
ZCTA5 32828,12,69778,95943,1766,370700,55598,16811,45378,2682,8667,11152,15289,7588,25204,23957,1247,23957,15036,8921,2022-01-01,zipcode,Orlando
ZCTA5 32829,12,19353,90174,1821,316800,15324,4901,13181,1266,2582,4169,3539,1625,7448,6317,1131,6317,4576,1741,2022-01-01,zipcode,Orlando
ZCTA5 32830,12,49,118839,-666666666,110400,48,8,48,0,5,19,21,3,35,25,10,25,25,0,2022-01-01,zipcode,Orlando
ZCTA5 32831,12,2414,-666666666,-666666666,-666666666,2414,2390,2162,1005,870,228,46,13,45,24,21,24,14,10,2022-01-01,zipcode,Orlando
ZCTA5 32832,12,31143,110885,2097,398900,23676,6070,21141,864,2174,5820,7509,4774,12352,10788,1564,10788,7469,3319,2022-01-01,zipcode,Orlando
ZCTA5 32833,12,10995,88200,1344,348500,8721,3448,7675,822,2157,2089,1842,765,3798,3516,282,3516,2747,769,2022-01-01,zipcode,Orlando
ZCTA5 32835,12,49890,66970,1662,304000,40350,11853,33709,2844,7467,10368,8489,4541,19076,17642,1434,17642,7746,9896,2022-01-01,zipcode,Orlando
ZCTA5 32836,12,23708,112822,1897,602400,19062,6186,16666,563,2364,3846,5988,3905,10122,8436,1686,8436,5178,3258,2022-01-01,zipcode,Orlando
ZCTA5 32837,12,48762,81926,1782,334300,40654,13230,35035,3182,7747,10369,8686,5051,20927,15780,5147,15780,9534,6246,2022-01-01,zipcode,Orlando
ZCTA5 32839,12,49304,51516,1323,214300,40691,14002,33482,5691,11160,9733,4645,2253,24118,17422,6696,17422,4602,12820,2022-01-01,zipcode,Orlando
ZCTA5 32901,12,27574,47115,1209,222900,24380,12518,19437,1910,5151,6740,3588,2048,13064,11148,1916,11148,5484,5664,2022-01-01,zipcode,Melbourne
ZCTA5 32903,12,14604,96438,1618,454900,12084,5165,10985,352,1838,3148,2994,2653,7417,6090,1327,6090,5118,972,2022-01-01,zipcode,Indialantic
ZCTA5 32904,12,36556,85618,1619,306400,29844,11619,25352,1662,5768,8146,6223,3553,14910,13516,1394,13516,10816,2700,2022-01-01,zipcode,Melbourne
ZCTA5 32905,12,24971,54145,1249,180700,20764,9426,18691,1638,6001,6067,3619,1366,12707,10492,2215,10492,6053,4439,2022-01-01,zipcode,Palm bay
ZCTA5 32907,12,47823,67002,1481,230300,39472,17137,34644,3738,10883,13035,4480,2508,17547,16352,1195,16352,14155,2197,2022-01-01,zipcode,Palm bay
ZCTA5 32908,12,14172,63043,1681,228200,11084,3676,9456,1184,2953,3486,1146,687,4846,4608,238,4608,4159,449,2022-01-01,zipcode,Palm bay
ZCTA5 32909,12,36725,71783,1383,239100,28710,10685,24464,2140,7355,9133,3565,2271,13488,12321,1167,12321,10154,2167,2022-01-01,zipcode,Palm bay
ZCTA5 32920,12,9961,68642,1050,322500,9403,4019,9010,478,2323,2926,2136,1147,8833,5765,3068,5765,3547,2218,2022-01-01,zipcode,Cape canaveral
ZCTA5 32922,12,15198,44898,975,147000,12065,4353,10826,1493,3458,3704,1530,641,8402,6574,1828,6574,3418,3156,2022-01-01,zipcode,Cocoa
ZCTA5 32925,12,1606,76667,1809,-666666666,1200,444,828,52,94,283,245,154,517,516,1,516,0,516,2022-01-01,zipcode,Patrick afb
ZCTA5 32926,12,22379,63391,1201,230600,19976,8911,18402,2413,5981,6059,2707,1242,10785,9436,1349,9436,7497,1939,2022-01-01,zipcode,Cocoa
ZCTA5 32927,12,27570,76843,1229,233100,23371,9276,20914,1938,6275,8079,3098,1524,11681,10267,1414,10267,9143,1124,2022-01-01,zipcode,Cocoa
ZCTA5 32931,12,13762,83195,1437,436200,12865,6492,12048,354,1916,3521,3391,2866,10932,7422,3510,7422,5568,1854,2022-01-01,zipcode,Cocoa beach
ZCTA5 32934,12,18030,99758,1716,362200,15751,7812,14055,803,3027,4403,3425,2397,7801,7438,363,7438,6634,804,2022-01-01,zipcode,Melbourne
ZCTA5 32935,12,41342,61069,1309,221700,34671,12208,30676,2161,8801,11303,5517,2894,19964,17764,2200,17764,10572,7192,2022-01-01,zipcode,Melbourne
ZCTA5 32937,12,27611,90344,1611,391600,22739,9848,19999,314,2981,6295,5616,4793,13332,11335,1997,11335,9100,2235,2022-01-01,zipcode,Satellite beach
ZCTA5 32940,12,47030,100792,1796,395000,38394,17568,34806,1318,5776,10026,9342,8344,20748,19248,1500,19248,16262,2986,2022-01-01,zipcode,Melbourne
ZCTA5 32948,12,6032,48657,864,153400,4508,1586,3927,1103,1468,904,416,36,1956,1600,356,1600,1186,414,2022-01-01,zipcode,Fellsmere
ZCTA5 32949,12,2609,108050,-666666666,437700,2409,1322,2262,188,785,589,417,283,1155,987,168,987,952,35,2022-01-01,zipcode,Grant
ZCTA5 32950,12,4666,105938,1830,410200,4120,1697,3657,110,1029,1358,709,451,1945,1885,60,1885,1744,141,2022-01-01,zipcode,Malabar
ZCTA5 32951,12,11516,80411,1493,453900,10415,6297,9974,377,1530,2946,3123,1998,7643,5751,1892,5751,4913,838,2022-01-01,zipcode,Melbourne beach
ZCTA5 32952,12,20666,87148,1221,376300,17361,7936,15458,620,3268,4700,4066,2804,10050,8287,1763,8287,7085,1202,2022-01-01,zipcode,Merritt island
ZCTA5 32953,12,24924,80537,1165,356100,20897,9107,18496,905,4683,6174,4211,2523,11537,9655,1882,9655,7200,2455,2022-01-01,zipcode,Merritt island
ZCTA5 32955,12,39745,82969,1452,305800,33544,12663,29549,1841,7270,9469,6403,4566,18652,15799,2853,15799,12233,3566,2022-01-01,zipcode,Rockledge
ZCTA5 32958,12,28729,64698,1249,254500,25706,13662,24177,1692,7255,7804,4303,3123,15077,12749,2328,12749,10651,2098,2022-01-01,zipcode,Sebastian
ZCTA5 32960,12,23961,49634,1103,233200,20507,8623,18158,2083,5134,6538,2962,1441,11925,9756,2169,9756,5819,3937,2022-01-01,zipcode,Vero beach
ZCTA5 32962,12,26904,60649,1116,207600,22749,10713,19653,2370,5645,7293,3267,1078,12642,9734,2908,9734,8084,1650,2022-01-01,zipcode,Vero beach
ZCTA5 32963,12,15117,143438,1765,818500,14381,9760,14018,133,1669,2613,4942,4661,12379,7672,4707,7672,7289,383,2022-01-01,zipcode,Vero beach
ZCTA5 32966,12,19419,65923,1328,251100,17295,10411,16323,719,4482,5993,3293,1836,11441,9192,2249,9192,7059,2133,2022-01-01,zipcode,Vero beach
ZCTA5 32967,12,25116,66438,1212,350100,20766,11352,18140,2179,4962,5235,3387,2377,11904,9497,2407,9497,7449,2048,2022-01-01,zipcode,Vero beach
ZCTA5 32968,12,15456,90058,1597,343300,13331,5704,11290,489,2908,3906,2415,1572,6425,5483,942,5483,5153,330,2022-01-01,zipcode,Vero beach
ZCTA5 32970,12,252,53929,-666666666,-666666666,252,63,252,17,92,38,105,0,52,52,0,52,14,38,2022-01-01,zipcode,Wabasso
ZCTA5 32976,12,9310,46760,1298,144300,8897,6084,8592,489,3216,3299,1181,407,6948,5089,1859,5089,4804,285,2022-01-01,zipcode,Sebastian
ZCTA5 33001,12,340,59545,1932,622300,332,221,332,16,168,68,74,6,718,172,546,172,111,61,2022-01-01,zipcode,Long key
ZCTA5 33004,12,16449,45836,1558,278100,13932,5045,12665,1167,3727,3561,3033,1177,9109,7391,1718,7391,3205,4186,2022-01-01,zipcode,Dania
ZCTA5 33009,12,43893,44949,1448,237100,37204,14571,33773,4157,9561,8262,6920,4873,31149,20753,10396,20753,11252,9501,2022-01-01,zipcode,Hallandale
ZCTA5 33010,12,42081,41053,1240,324400,36482,15293,32549,10583,10860,4830,4451,1825,16273,15709,564,15709,4799,10910,2022-01-01,zipcode,Hialeah
ZCTA5 33012,12,71088,41921,1470,313600,60985,25295,54154,15438,18374,10928,6511,2903,25795,25048,747,25048,12205,12843,2022-01-01,zipcode,Hialeah
ZCTA5 33013,12,29830,54842,1457,362700,26303,10227,22408,6012,8105,4483,2627,1181,9668,9356,312,9356,5673,3683,2022-01-01,zipcode,Hialeah
ZCTA5 33014,12,40739,69586,1574,371000,33674,10473,29734,5048,7906,8663,4902,3215,15027,14420,607,14420,6554,7866,2022-01-01,zipcode,Hialeah
ZCTA5 33015,12,68517,69169,1720,358400,55961,16682,47266,6422,13122,13998,9429,4295,23919,23157,762,23157,12221,10936,2022-01-01,zipcode,Hialeah
ZCTA5 33016,12,45620,53180,1652,273100,37833,13769,32697,5951,10414,7801,5825,2706,16055,15621,434,15621,7760,7861,2022-01-01,zipcode,Hialeah
ZCTA5 33018,12,55241,83468,1850,379200,45794,13829,39620,6434,11899,10492,7467,3328,17452,16961,491,16961,12555,4406,2022-01-01,zipcode,Hialeah
ZCTA5 33019,12,13503,90748,1752,607400,12074,5166,10852,460,1268,2861,3096,3167,12455,6331,6124,6331,4783,1548,2022-01-01,zipcode,Hollywood
ZCTA5 33020,12,44914,50339,1358,278100,38057,10368,33096,4244,9480,9406,6117,3849,22888,20012,2876,20012,6455,13557,2022-01-01,zipcode,Hollywood
ZCTA5 33021,12,50300,66515,1618,365400,40721,13750,35269,3393,8491,10375,7699,5311,21594,19302,2292,19302,12560,6742,2022-01-01,zipcode,Hollywood
ZCTA5 33023,12,71749,66834,1531,315100,56680,17491,48835,7793,16156,15984,5904,2998,22499,21052,1447,21052,13761,7291,2022-01-01,zipcode,Hollywood
ZCTA5 33024,12,73405,72394,1600,338200,57941,18246,49904,5418,14458,17206,9005,3817,26232,24650,1582,24650,15948,8702,2022-01-01,zipcode,Hollywood
ZCTA5 33025,12,72684,66156,1786,311300,58887,16952,51795,3804,20686,13721,8370,5214,29658,27473,2185,27473,12856,14617,2022-01-01,zipcode,Hollywood
ZCTA5 33026,12,30868,84007,1829,361500,25356,9191,22930,1627,5673,6885,5530,3215,12513,12108,405,12108,9760,2348,2022-01-01,zipcode,Hollywood
ZCTA5 33027,12,63474,67015,1705,371200,54480,23098,48165,3277,15001,11475,11322,7090,25953,24914,1039,24914,19624,5290,2022-01-01,zipcode,Hollywood
ZCTA5 33028,12,27583,109393,2291,486000,21923,5957,18481,888,3676,4327,5554,4036,9082,8792,290,8792,6760,2032,2022-01-01,zipcode,Pembroke pines
ZCTA5 33029,12,44876,139461,2405,500100,35412,10530,29314,1206,7305,7810,8035,4958,13867,13443,424,13443,12181,1262,2022-01-01,zipcode,Hollywood
ZCTA5 33030,12,36405,37740,1237,342900,25472,9880,21482,8468,6274,4023,1909,808,11164,10582,582,10582,4036,6546,2022-01-01,zipcode,Homestead
ZCTA5 33031,12,7692,107448,1471,441700,6395,2962,5325,500,2039,1707,642,437,2437,2419,18,2419,2177,242,2022-01-01,zipcode,Homestead
ZCTA5 33032,12,57327,70706,1520,340000,43044,12757,36454,6719,10596,10702,6277,2160,17806,17014,792,17014,10075,6939,2022-01-01,zipcode,Homestead
ZCTA5 33033,12,68121,61800,1571,332300,49850,16830,40891,8813,11375,11017,6547,3139,20659,19948,711,19948,11177,8771,2022-01-01,zipcode,Homestead
ZCTA5 33034,12,23774,43015,1273,195700,16265,8364,13355,4768,3737,3539,905,406,6453,5930,523,5930,1825,4105,2022-01-01,zipcode,Homestead
ZCTA5 33035,12,16788,68881,1781,248900,12755,4313,11144,1468,2582,3741,2547,806,5991,5474,517,5474,2850,2624,2022-01-01,zipcode,Homestead
ZCTA5 33036,12,3620,91932,2033,916900,3099,1470,2945,104,769,911,678,483,3480,1681,1799,1681,1344,337,2022-01-01,zipcode,Islamorada
ZCTA5 33037,12,13265,73724,1848,632000,11769,5307,10798,873,2993,2681,2485,1766,10406,5613,4793,5613,4415,1198,2022-01-01,zipcode,Key largo
ZCTA5 33039,12,0,-666666666,-666666666,-666666666,0,0,0,0,0,0,0,0,0,0,0,0,0,0,2022-01-01,zipcode,Homestead
ZCTA5 33040,12,36379,80069,2044,766700,31059,9256,27815,2203,8013,7425,6207,3967,18919,14911,4008,14911,7112,7799,2022-01-01,zipcode,Key west
ZCTA5 33042,12,6990,104325,2193,703100,6190,2636,5664,211,1371,1672,1444,966,4748,3023,1725,3023,2386,637,2022-01-01,zipcode,Summerland key
ZCTA5 33043,12,4547,75455,2013,460000,3790,1606,3517,275,984,1277,644,337,2852,1918,934,1918,1588,330,2022-01-01,zipcode,Big pine key
ZCTA5 33050,12,10520,74487,1498,668700,8943,2974,8043,935,2446,2121,1573,968,7199,4256,2943,4256,2316,1940,2022-01-01,zipcode,Marathon
ZCTA5 33051,12,650,103096,1797,828800,641,375,635,24,126,182,215,88,1191,367,824,367,268,99,2022-01-01,zipcode,Key colony beach
ZCTA5 33054,12,31590,38952,1244,267300,25435,11159,21319,5297,8531,5398,1541,552,10788,10281,507,10281,4939,5342,2022-01-01,zipcode,Opa locka
ZCTA5 33055,12,37977,54869,1546,307100,31769,13782,27766,6882,10127,6309,3302,1146,12218,11898,320,11898,8916,2982,2022-01-01,zipcode,Opa locka
ZCTA5 33056,12,37274,58160,1560,288000,29817,11852,25485,4045,9795,7182,2785,1678,12053,11593,460,11593,7522,4071,2022-01-01,zipcode,Miami gardens
ZCTA5 33060,12,37522,55733,1337,324500,30255,10730,26522,4876,7806,7564,4160,2116,15887,14079,1808,14079,7061,7018,2022-01-01,zipcode,Pompano beach
ZCTA5 33062,12,24805,78267,1754,465000,23072,10767,21684,1195,4676,5743,5913,4157,22196,13541,8655,13541,9267,4274,2022-01-01,zipcode,Pompano beach
ZCTA5 33063,12,55143,58340,1642,246900,47455,16603,43441,4282,13765,13154,8677,3563,27649,25161,2488,25161,18566,6595,2022-01-01,zipcode,Pompano beach
ZCTA5 33064,12,60009,62808,1607,274000,49716,14870,44226,8284,12981,10683,8302,3976,26017,22837,3180,22837,14284,8553,2022-01-01,zipcode,Pompano beach
ZCTA5 33065,12,60600,65145,1740,373400,46316,14071,38739,3011,11384,12485,7834,4025,21282,20071,1211,20071,9417,10654,2022-01-01,zipcode,Coral springs
ZCTA5 33066,12,16316,53460,1632,184000,14375,6804,13481,953,3923,3987,2656,1962,10487,8420,2067,8420,7090,1330,2022-01-01,zipcode,Pompano beach
ZCTA5 33067,12,24696,118825,1896,588200,19326,6268,16712,642,2635,4222,5339,3874,8794,8227,567,8227,6279,1948,2022-01-01,zipcode,Pompano beach
ZCTA5 33068,12,52792,60649,1806,248500,42396,11487,35011,5606,11965,10428,4587,2425,19770,18532,1238,18532,11374,7158,2022-01-01,zipcode,Pompano beach
ZCTA5 33069,12,29228,57614,1589,231100,24031,10522,21326,2891,5697,5847,4280,2611,15945,11719,4226,11719,5447,6272,2022-01-01,zipcode,Pompano beach
ZCTA5 33070,12,5717,73885,1746,674400,5041,1968,4482,347,1282,1412,795,646,4517,2443,2074,2443,1847,596,2022-01-01,zipcode,Tavernier
ZCTA5 33071,12,39677,98722,1899,470800,31187,8796,26288,1143,5296,8800,7244,3805,13999,13301,698,13301,8662,4639,2022-01-01,zipcode,Coral springs
ZCTA5 33073,12,33691,94775,2017,410100,26632,7775,22681,1640,5634,6897,5934,2576,12496,11669,827,11669,6551,5118,2022-01-01,zipcode,Pompano beach
ZCTA5 33076,12,43660,164389,3032,676100,32094,10509,26899,596,4970,5151,7807,8375,13764,13069,695,13069,11187,1882,2022-01-01,zipcode,Pompano beach
ZCTA5 33101,12,0,-666666666,-666666666,-666666666,0,0,0,0,0,0,0,0,0,0,0,0,0,0,2022-01-01,zipcode,Miami
ZCTA5 33109,12,792,250001,-666666666,2000001,695,385,695,0,97,90,170,338,726,328,398,328,307,21,2022-01-01,zipcode,Miami beach
ZCTA5 33122,12,1873,84329,2370,1335900,1508,410,1219,180,79,232,392,336,1013,816,197,816,76,740,2022-01-01,zipcode,Miami
ZCTA5 33125,12,54873,37370,1238,339300,47376,19084,42169,13333,13062,7499,5470,2805,22255,21227,1028,21227,5080,16147,2022-01-01,zipcode,Miami
ZCTA5 33126,12,46798,51733,1546,287100,40671,14351,36005,8166,9603,8570,7057,2609,19530,18073,1457,18073,7104,10969,2022-01-01,zipcode,Miami
ZCTA5 33127,12,28306,39690,1283,346000,22224,9553,18787,5948,6071,4196,1737,835,11396,9661,1735,9661,2819,6842,2022-01-01,zipcode,Miami
ZCTA5 33128,12,8989,33697,1191,292400,7655,2635,7014,2577,2095,1075,959,308,4298,3907,391,3907,123,3784,2022-01-01,zipcode,Miami
ZCTA5 33129,12,15184,93343,2153,526800,13452,3935,12113,447,1760,1860,4814,3232,8352,7267,1085,7267,3393,3874,2022-01-01,zipcode,Miami
ZCTA5 33130,12,32946,55285,1553,436000,29545,8479,26504,5177,5977,4766,6105,4479,19910,16915,2995,16915,2120,14795,2022-01-01,zipcode,Miami
ZCTA5 33131,12,22540,121730,2649,599100,20059,3075,18473,285,1244,2547,7467,6930,18627,12552,6075,12552,4132,8420,2022-01-01,zipcode,Miami
ZCTA5 33132,12,17136,101518,2373,535900,15989,3878,14513,979,1536,3198,4510,4290,11690,8969,2721,8969,2226,6743,2022-01-01,zipcode,Miami
ZCTA5 33133,12,34500,87924,1824,825100,27780,8352,25858,1572,4473,4372,8389,7052,16982,14479,2503,14479,7487,6992,2022-01-01,zipcode,Miami
ZCTA5 33134,12,37958,82925,1719,637300,32162,11982,28861,2658,5269,5501,8020,7413,18350,16251,2099,16251,8937,7314,2022-01-01,zipcode,Miami
ZCTA5 33135,12,34742,35185,1221,367100,30258,11521,27057,8334,7921,5427,3817,1558,15635,14513,1122,14513,3050,11463,2022-01-01,zipcode,Miami
ZCTA5 33136,12,16854,35129,1177,290500,14489,5549,13095,3663,3531,2969,1943,989,7772,6894,878,6894,834,6060,2022-01-01,zipcode,Miami
ZCTA5 33137,12,25283,71348,2142,462200,21315,5616,19347,2148,3461,3887,5472,4379,14313,11498,2815,11498,3020,8478,2022-01-01,zipcode,Miami
ZCTA5 33138,12,28609,58990,1390,604300,23625,7708,21047,2834,3932,4627,5269,4385,14223,12701,1522,12701,6193,6508,2022-01-01,zipcode,Miami
ZCTA5 33139,12,35100,60971,1680,476000,31258,9463,28913,3045,4789,6080,8427,6572,30347,20113,10234,20113,6338,13775,2022-01-01,zipcode,Miami beach
ZCTA5 33140,12,19785,98935,1912,837700,15993,5463,14569,1111,1528,2964,4606,4360,16290,8579,7711,8579,4878,3701,2022-01-01,zipcode,Miami beach
ZCTA5 33141,12,35967,61205,1634,419900,31860,9268,28951,2686,6077,7833,7742,4613,21704,16685,5019,16685,5675,11010,2022-01-01,zipcode,Miami beach
ZCTA5 33142,12,59121,35589,1189,277600,47064,18733,40166,14296,13234,7760,3544,1332,21855,20178,1677,20178,5729,14449,2022-01-01,zipcode,Miami
ZCTA5 33143,12,31688,78525,1709,711800,26054,9311,22930,1301,3637,4285,7518,6189,14805,13337,1468,13337,7356,5981,2022-01-01,zipcode,Miami
ZCTA5 33144,12,26596,58382,1611,410200,23062,9042,21086,3474,6492,5108,4285,1727,9760,9296,464,9296,5195,4101,2022-01-01,zipcode,Miami
ZCTA5 33145,12,29240,68717,1694,480100,25137,8931,22565,3456,4777,4843,5768,3721,12777,11809,968,11809,5921,5888,2022-01-01,zipcode,Miami
ZCTA5 33146,12,17962,125720,2571,1119100,15687,7575,8163,119,546,1281,2518,3699,6341,5357,984,5357,3500,1857,2022-01-01,zipcode,Miami
ZCTA5 33147,12,47065,45092,1279,234100,37131,15877,32224,7260,11957,7818,3613,1576,15999,14613,1386,14613,7389,7224,2022-01-01,zipcode,Miami
ZCTA5 33149,12,14639,169792,3501,1321200,10861,4635,9119,296,792,1365,3290,3376,7421,4676,2745,4676,3043,1633,2022-01-01,zipcode,Key biscayne
ZCTA5 33150,12,31807,33629,1094,317200,23805,10187,20804,5607,7261,5070,2027,839,12101,10910,1191,10910,2995,7915,2022-01-01,zipcode,Miami
ZCTA5 33154,12,14557,75540,2080,716600,10748,3956,9499,158,1893,2013,2808,2627,10170,5666,4504,5666,3337,2329,2022-01-01,zipcode,Miami beach
ZCTA5 33155,12,43702,82321,1889,464900,36968,12777,32758,4533,8281,7971,7843,4130,15935,14905,1030,14905,10072,4833,2022-01-01,zipcode,Miami
ZCTA5 33156,12,32582,133862,1918,972000,25458,9411,22045,861,2725,3844,6722,7893,13123,11862,1261,11862,8607,3255,2022-01-01,zipcode,Miami
ZCTA5 33157,12,69152,77994,1414,433200,55347,19491,47851,5935,13606,11946,10610,5754,22536,21103,1433,21103,13824,7279,2022-01-01,zipcode,Miami
ZCTA5 33158,12,6536,177917,3321,890100,4995,2008,4336,38,351,599,1634,1714,2338,2166,172,2166,2058,108,2022-01-01,zipcode,Miami
ZCTA5 33160,12,42058,58174,1856,324100,35978,15614,32757,2056,5485,9021,9325,6870,35247,19954,15293,19954,11664,8290,2022-01-01,zipcode,North miami beach
ZCTA5 33161,12,52824,49159,1394,355300,42235,15103,35287,6622,13418,8211,4583,2453,18676,17162,1514,17162,6995,10167,2022-01-01,zipcode,Miami
ZCTA5 33162,12,48326,54884,1417,310700,37053,13023,31447,5699,11082,7979,4627,2060,16341,14978,1363,14978,7640,7338,2022-01-01,zipcode,Miami
ZCTA5 33165,12,52047,77482,1704,440700,45503,17644,40082,7201,12963,9223,6821,3874,17820,17306,514,17306,12508,4798,2022-01-01,zipcode,Miami
ZCTA5 33166,12,26364,74819,1655,466500,22282,7305,19162,3534,3408,4274,4677,3269,10478,9834,644,9834,4820,5014,2022-01-01,zipcode,Miami
ZCTA5 33167,12,22823,56044,1337,292300,17953,7352,14895,3456,5637,3357,1715,730,7058,6639,419,6639,3963,2676,2022-01-01,zipcode,Miami
ZCTA5 33168,12,23458,55866,1485,293800,18829,7483,15932,3625,6068,3856,1733,650,6791,6486,305,6486,4892,1594,2022-01-01,zipcode,Miami
ZCTA5 33169,12,42156,56415,1480,321100,32606,11102,28020,4479,9194,8100,4302,1945,14458,13254,1204,13254,6892,6362,2022-01-01,zipcode,Miami
ZCTA5 33170,12,14477,62001,1525,381000,11416,4245,9903,2248,3120,2434,1195,906,4856,4433,423,4433,2706,1727,2022-01-01,zipcode,Miami
ZCTA5 33172,12,40278,59228,1826,235800,34298,10766,30146,7144,6905,6768,6200,3129,16136,14485,1651,14485,6631,7854,2022-01-01,zipcode,Miami
ZCTA5 33173,12,33026,84644,1840,417500,27975,10681,24538,2036,4449,7459,6483,4111,12310,11749,561,11749,8071,3678,2022-01-01,zipcode,Miami
ZCTA5 33174,12,34335,55230,1667,357400,30257,12571,23777,6906,5783,4256,4724,2108,11454,11050,404,11050,5579,5471,2022-01-01,zipcode,Miami
ZCTA5 33175,12,50233,71621,1844,421400,43818,16628,38862,6923,10829,9005,7889,4216,17508,17115,393,17115,13043,4072,2022-01-01,zipcode,Miami
ZCTA5 33176,12,52719,80612,1605,541600,43381,14778,37802,3374,8179,10572,10016,5661,20048,18847,1201,18847,11835,7012,2022-01-01,zipcode,Miami
ZCTA5 33177,12,56791,74193,1961,362100,46891,18501,40720,6645,13974,10971,6363,2767,16708,16240,468,16240,12196,4044,2022-01-01,zipcode,Miami
ZCTA5 33178,12,64751,87817,2466,464100,50292,17423,42316,5440,5218,8660,12956,10042,22091,19718,2373,19718,9573,10145,2022-01-01,zipcode,Miami
ZCTA5 33179,12,48196,59920,1627,239900,39942,12991,34700,3059,9926,10273,6284,5158,20581,18433,2148,18433,10437,7996,2022-01-01,zipcode,Miami
ZCTA5 33180,12,32881,84490,2323,448300,27283,11263,24598,1325,3411,6128,7841,5893,22320,14456,7864,14456,9314,5142,2022-01-01,zipcode,Miami
ZCTA5 33181,12,20448,54618,1530,296800,16472,5300,13558,1377,3619,3424,3012,2126,9428,8384,1044,8384,3444,4940,2022-01-01,zipcode,Miami
ZCTA5 33182,12,13163,94129,2264,439900,11482,4009,9819,1100,2314,2202,3139,1064,4321,4240,81,4240,3508,732,2022-01-01,zipcode,Miami
ZCTA5 33183,12,34057,64714,1778,346600,29809,12104,25332,3941,7466,6693,4904,2328,12647,12349,298,12349,8144,4205,2022-01-01,zipcode,Miami
ZCTA5 33184,12,20850,72172,1976,364200,18094,6335,15785,4264,3839,2904,3255,1523,6852,6548,304,6548,4572,1976,2022-01-01,zipcode,Miami
ZCTA5 33185,12,29530,103401,2642,459800,23724,8785,20526,2970,4406,5191,5091,2868,9159,8974,185,8974,7262,1712,2022-01-01,zipcode,Miami
ZCTA5 33186,12,68750,81599,1961,391500,55969,19925,48658,4146,12353,15232,11255,5672,24148,23284,864,23284,15675,7609,2022-01-01,zipcode,Miami
ZCTA5 33187,12,19346,111525,2269,467900,15803,5676,13496,1676,3490,3876,3330,1124,5833,5656,177,5656,4953,703,2022-01-01,zipcode,Miami
ZCTA5 33189,12,24575,63250,1496,357200,19610,7173,17250,2794,5375,4669,2995,1417,8822,8431,391,8431,4972,3459,2022-01-01,zipcode,Miami
ZCTA5 33190,12,16909,71020,1663,339000,12793,3975,11107,1505,2718,3805,2262,817,5464,5373,91,5373,2450,2923,2022-01-01,zipcode,Miami
ZCTA5 33193,12,47116,72155,1697,384600,40366,14120,34455,7345,9151,7235,7384,3340,16095,15643,452,15643,9277,6366,2022-01-01,zipcode,Miami
ZCTA5 33194,12,8617,126910,2363,439500,7308,3408,6406,933,1193,1739,1634,907,1962,1962,0,1962,1576,386,2022-01-01,zipcode,Miami
ZCTA5 33196,12,54187,89326,2011,428400,43516,15493,37116,3418,9398,9851,9821,4628,17334,16980,354,16980,11447,5533,2022-01-01,zipcode,Miami
ZCTA5 33301,12,17069,115161,2252,701800,16066,4803,14756,665,1753,3343,5318,3677,13378,10017,3361,10017,3781,6236,2022-01-01,zipcode,Fort lauderdale
ZCTA5 33304,12,18923,81266,1577,543500,16894,5571,15636,1491,2671,3534,5201,2739,12554,9566,2988,9566,3909,5657,2022-01-01,zipcode,Fort lauderdale
ZCTA5 33305,12,12633,85246,1656,479000,11287,4032,10767,554,1633,2651,3208,2721,8074,6726,1348,6726,4625,2101,2022-01-01,zipcode,Fort lauderdale
ZCTA5 33306,12,2767,74385,1201,466200,2613,899,2542,75,531,808,628,500,2157,1647,510,1647,1187,460,2022-01-01,zipcode,Fort lauderdale
ZCTA5 33308,12,28406,80445,1759,489800,25905,11275,24288,1117,3847,6047,7446,5831,23595,15678,7917,15678,10807,4871,2022-01-01,zipcode,Fort lauderdale
ZCTA5 33309,12,37829,68274,1724,273600,30622,7891,26229,3946,8493,7168,4458,2164,14888,13810,1078,13810,7841,5969,2022-01-01,zipcode,Fort lauderdale
ZCTA5 33311,12,75435,48020,1297,246600,55667,22465,46899,9349,16481,13023,5287,2759,27466,24694,2772,24694,11390,13304,2022-01-01,zipcode,Fort lauderdale
ZCTA5 33312,12,53409,72955,1524,361800,43670,15128,37796,5175,10831,10523,6765,4502,21687,18849,2838,18849,11838,7011,2022-01-01,zipcode,Fort lauderdale
ZCTA5 33313,12,62232,43282,1479,220400,47803,16349,40392,6060,16607,11792,4217,1716,24893,21950,2943,21950,9388,12562,2022-01-01,zipcode,Fort lauderdale
ZCTA5 33314,12,28978,59765,1844,285400,23643,7456,19163,2717,5889,4609,4044,1904,11906,10687,1219,10687,3757,6930,2022-01-01,zipcode,Fort lauderdale
ZCTA5 33315,12,13253,88034,1676,416900,11529,3645,10400,618,3535,2357,2228,1662,6979,5832,1147,5832,3241,2591,2022-01-01,zipcode,Fort lauderdale
ZCTA5 33316,12,11304,93063,1776,736400,10108,3695,9469,313,1407,2366,3392,1991,8842,5884,2958,5884,3355,2529,2022-01-01,zipcode,Fort lauderdale
ZCTA5 33317,12,36322,79511,1839,406200,29341,9270,25970,2375,6932,7104,6185,3374,13430,12755,675,12755,9554,3201,2022-01-01,zipcode,Fort lauderdale
ZCTA5 33319,12,52000,53705,1512,210500,42528,14245,37867,4857,11550,11529,6429,3502,25008,20966,4042,20966,13754,7212,2022-01-01,zipcode,Fort lauderdale
ZCTA5 33321,12,50307,60113,1756,236800,43048,18029,38571,4537,10613,12505,6720,4196,23917,21766,2151,21766,16192,5574,2022-01-01,zipcode,Fort lauderdale
ZCTA5 33322,12,40738,59066,1931,238500,35221,14578,32445,2796,8457,10413,7139,3640,21347,18730,2617,18730,15440,3290,2022-01-01,zipcode,Fort lauderdale
ZCTA5 33323,12,22506,110395,2363,417700,18839,5221,16281,991,2824,4807,5051,2608,9285,8334,951,8334,6095,2239,2022-01-01,zipcode,Fort lauderdale
ZCTA5 33324,12,49994,80348,1993,313500,40794,12942,36039,2250,6683,11460,9777,5869,22134,19860,2274,19860,11217,8643,2022-01-01,zipcode,Fort lauderdale
ZCTA5 33325,12,31546,93060,1923,380000,25131,6616,21157,2230,4626,6263,5278,2760,11199,10487,712,10487,7981,2506,2022-01-01,zipcode,Fort lauderdale
ZCTA5 33326,12,31514,107899,2250,474100,24518,7933,21141,776,2716,5350,6932,5367,12757,10800,1957,10800,7589,3211,2022-01-01,zipcode,Fort lauderdale
ZCTA5 33327,12,23734,158184,2942,674200,17016,6256,14009,265,1666,2372,4924,4782,6640,6584,56,6584,5107,1477,2022-01-01,zipcode,Fort lauderdale
ZCTA5 33328,12,29544,120195,1982,476100,23951,7127,19805,1036,3783,5619,5783,3584,10896,10261,635,10261,8257,2004,2022-01-01,zipcode,Fort lauderdale
ZCTA5 33330,12,13619,136839,2600,646000,10977,3679,9436,585,1255,2307,2658,2631,4788,4446,342,4446,4219,227,2022-01-01,zipcode,Fort lauderdale
ZCTA5 33331,12,25418,136734,2838,620200,20542,7834,16820,746,2123,4388,5671,3892,7831,7630,201,7630,6478,1152,2022-01-01,zipcode,Fort lauderdale
ZCTA5 33332,12,11809,154652,3247,784500,9214,3154,7646,275,821,1568,2264,2718,3524,3461,63,3461,3019,442,2022-01-01,zipcode,Fort lauderdale
ZCTA5 33334,12,31047,65379,1450,404600,25928,7303,22663,2666,6390,6393,4412,2802,14150,12877,1273,12877,7291,5586,2022-01-01,zipcode,Fort lauderdale
ZCTA5 33351,12,35082,66611,1748,311500,28534,7565,25471,2228,6911,8763,5058,2511,13908,12891,1017,12891,7454,5437,2022-01-01,zipcode,Fort lauderdale
ZCTA5 33401,12,31625,55238,1679,354900,27323,10432,22870,2589,4335,6282,5774,3890,18383,14332,4051,14332,5189,9143,2022-01-01,zipcode,West palm beach
ZCTA5 33403,12,13698,63481,1337,299100,11353,3978,9919,1329,3304,2758,1465,1063,6078,5117,961,5117,2327,2790,2022-01-01,zipcode,West palm beach
ZCTA5 33404,12,31034,56667,1408,257100,25005,9876,21857,2786,7071,6095,3763,2142,16322,11674,4648,11674,6482,5192,2022-01-01,zipcode,West palm beach
ZCTA5 33405,12,20377,77583,1274,346400,16988,5549,15061,2664,3069,4502,2964,1862,9299,8341,958,8341,5021,3320,2022-01-01,zipcode,West palm beach
ZCTA5 33406,12,26093,66531,1530,285900,21408,7786,17324,3156,5897,4385,2719,1167,9361,8587,774,8587,5618,2969,2022-01-01,zipcode,West palm beach
ZCTA5 33407,12,32904,52160,1449,253800,26496,9531,23356,4610,6687,6227,3786,2046,14783,12343,2440,12343,5714,6629,2022-01-01,zipcode,West palm beach
ZCTA5 33408,12,18839,89299,1757,472900,17102,8605,15887,447,3019,4052,5376,2993,13466,9707,3759,9707,7568,2139,2022-01-01,zipcode,North palm beach
ZCTA5 33409,12,33372,60484,1557,245900,26471,8092,21591,4369,5228,6147,4007,1840,13471,11753,1718,11753,5273,6480,2022-01-01,zipcode,West palm beach
ZCTA5 33410,12,36277,93643,1885,426200,30586,11456,27576,1306,5462,7696,8217,4895,17816,15222,2594,15222,10801,4421,2022-01-01,zipcode,Palm beach gardens
ZCTA5 33411,12,73919,83770,1792,363900,60388,21421,53155,5371,11945,15409,12696,7734,29358,27200,2158,27200,20563,6637,2022-01-01,zipcode,West palm beach
ZCTA5 33412,12,15001,123934,1893,482200,12689,4777,11426,514,2442,3456,2880,2134,6431,5513,918,5513,4705,808,2022-01-01,zipcode,West palm beach
ZCTA5 33413,12,18125,77928,1942,344700,13908,4207,11623,1563,3021,4003,1906,1130,6093,5517,576,5517,3544,1973,2022-01-01,zipcode,West palm beach
ZCTA5 33414,12,58842,103525,2161,473300,45253,14994,38722,2581,6488,11950,10278,7425,22107,19761,2346,19761,14805,4956,2022-01-01,zipcode,Wellington
ZCTA5 33415,12,51874,53496,1467,204000,41318,14460,35612,7768,11706,9657,4559,1922,20293,18334,1959,18334,10392,7942,2022-01-01,zipcode,West palm beach
ZCTA5 33417,12,35555,47293,1419,140700,30239,12441,27905,5180,8160,7674,4782,2109,20256,16131,4125,16131,9277,6854,2022-01-01,zipcode,West palm beach
ZCTA5 33418,12,42997,119156,2197,538900,36096,16212,32979,1164,4533,8266,10181,8835,21701,18339,3362,18339,14216,4123,2022-01-01,zipcode,Palm beach gardens
ZCTA5 33426,12,23781,74073,1854,275400,20850,6821,18518,1948,4976,5869,3849,1876,11879,10302,1577,10302,6412,3890,2022-01-01,zipcode,Boynton beach
ZCTA5 33428,12,45694,77322,2108,389700,35906,12463,30889,3165,7004,8001,8199,4520,17645,15922,1723,15922,10859,5063,2022-01-01,zipcode,Boca raton
ZCTA5 33430,12,20503,42968,772,133500,15110,6253,12843,4230,4376,2716,1070,451,7241,6273,968,6273,2235,4038,2022-01-01,zipcode,Belle glade
ZCTA5 33431,12,22488,101291,2115,496000,18895,8328,12855,754,1864,2913,4484,2840,9027,7462,1565,7462,5266,2196,2022-01-01,zipcode,Boca raton
ZCTA5 33432,12,21270,87634,2076,822200,19355,7795,17114,617,2201,4215,5851,4230,14923,10877,4046,10877,6233,4644,2022-01-01,zipcode,Boca raton
ZCTA5 33433,12,45580,77733,2198,382700,37695,17734,34207,1119,6369,8303,10511,7905,23300,20017,3283,20017,14069,5948,2022-01-01,zipcode,Boca raton
ZCTA5 33434,12,21214,68342,1448,329100,18832,11402,17947,911,2976,4227,5204,4629,13650,10683,2967,10683,8321,2362,2022-01-01,zipcode,Boca raton
ZCTA5 33435,12,37533,63691,1750,273600,31960,11869,27782,4162,8373,7377,5599,2271,19888,14535,5353,14535,8815,5720,2022-01-01,zipcode,Boynton beach
ZCTA5 33436,12,47606,72164,1790,309900,39760,15542,35813,3424,8679,11258,8420,4032,23438,19472,3966,19472,14646,4826,2022-01-01,zipcode,Boynton beach
ZCTA5 33437,12,38178,73502,1780,362500,35303,21485,32783,1145,7221,9556,8081,6780,21928,18288,3640,18288,15816,2472,2022-01-01,zipcode,Boynton beach
ZCTA5 33438,12,609,70577,-666666666,87100,530,196,455,112,185,86,28,44,271,196,75,196,139,57,2022-01-01,zipcode,Canal point
ZCTA5 33440,12,19800,54938,849,136400,15859,6120,13024,3804,4793,3218,904,305,7961,6978,983,6978,4892,2086,2022-01-01,zipcode,Clewiston
ZCTA5 33441,12,29576,53080,1406,335600,24639,8884,21635,3031,6559,6876,3422,1747,15440,12499,2941,12499,6706,5793,2022-01-01,zipcode,Deerfield beach
ZCTA5 33442,12,32076,51778,1845,202400,27432,12509,25603,2036,6510,8346,5996,2715,21663,15439,6224,15439,10329,5110,2022-01-01,zipcode,Deerfield beach
ZCTA5 33444,12,23569,72869,1627,378300,19784,6465,17555,2869,4496,4762,3542,1886,10103,8822,1281,8822,4740,4082,2022-01-01,zipcode,Delray beach
ZCTA5 33445,12,31283,67500,1826,261600,27747,11622,25151,2966,6220,6294,6116,3555,17407,13660,3747,13660,9640,4020,2022-01-01,zipcode,Delray beach
ZCTA5 33446,12,27774,67273,1564,352700,25192,16225,24023,894,4655,6710,6172,5592,18194,14150,4044,14150,12643,1507,2022-01-01,zipcode,Delray beach
ZCTA5 33449,12,9301,145952,3059,584600,7739,3369,6608,233,1268,1699,1825,1583,3603,3164,439,3164,2947,217,2022-01-01,zipcode,Lake worth
ZCTA5 33455,12,20936,72735,1196,365000,18260,9484,16950,1199,4455,5424,4020,1852,11579,9411,2168,9411,7946,1465,2022-01-01,zipcode,Hobe sound
ZCTA5 33458,12,56799,104146,1945,487400,45868,14633,39538,3050,7146,10318,11761,7263,22915,21091,1824,21091,15734,5357,2022-01-01,zipcode,Jupiter
ZCTA5 33460,12,36578,58624,1324,292500,28978,8967,24205,6549,6249,5931,3555,1921,14394,12767,1627,12767,5488,7279,2022-01-01,zipcode,Lake worth
ZCTA5 33461,12,48575,57762,1466,229600,38835,11924,33308,8940,11034,7339,3668,2327,18288,15820,2468,15820,7757,8063,2022-01-01,zipcode,Lake worth
ZCTA5 33462,12,32232,67916,1590,287000,27638,8911,24617,3793,7381,6776,4200,2467,15605,12602,3003,12602,8143,4459,2022-01-01,zipcode,Lake worth
ZCTA5 33463,12,65766,66830,1646,284700,52251,16194,44154,8251,13424,11849,7109,3521,22679,20462,2217,20462,14547,5915,2022-01-01,zipcode,Lake worth
ZCTA5 33467,12,55101,83238,1760,376700,46711,20501,41845,2994,10073,12250,10468,6060,25214,21865,3349,21865,18787,3078,2022-01-01,zipcode,Lake worth
ZCTA5 33469,12,14639,96460,1788,471400,12757,6472,11784,260,2425,3358,3390,2351,8692,6876,1816,6876,6057,819,2022-01-01,zipcode,Jupiter
ZCTA5 33470,12,31165,108906,2520,464100,25821,8562,22429,2310,5815,7765,4491,2048,10505,10002,503,10002,9237,765,2022-01-01,zipcode,Loxahatchee
ZCTA5 33471,12,6759,36043,781,85000,5974,4071,5352,1587,1837,1249,433,246,3399,2492,907,2492,1777,715,2022-01-01,zipcode,Moore haven
ZCTA5 33472,12,18881,85238,1914,374500,17085,9544,15615,669,3377,5032,3701,2836,8946,8106,840,8106,7692,414,2022-01-01,zipcode,Boynton beach
ZCTA5 33473,12,11107,157646,-666666666,662400,8982,4518,8309,51,921,2059,2146,3132,4713,4160,553,4160,4070,90,2022-01-01,zipcode,Boynton beach
ZCTA5 33476,12,6999,25521,702,115400,5254,2603,4255,1353,1462,799,526,115,2370,2069,301,2069,801,1268,2022-01-01,zipcode,Pahokee
ZCTA5 33477,12,11524,104531,2389,551500,11067,6807,10549,322,1675,2589,3422,2541,11015,6517,4498,6517,5544,973,2022-01-01,zipcode,Jupiter
ZCTA5 33478,12,14845,137282,1921,578400,11921,4397,10833,361,2146,3396,3232,1698,5529,5040,489,5040,4875,165,2022-01-01,zipcode,Jupiter
ZCTA5 33480,12,10853,163929,1758,1173700,10318,6839,10167,219,1002,2367,3470,3109,12258,6364,5894,6364,5385,979,2022-01-01,zipcode,Palm beach
ZCTA5 33483,12,12639,112262,2316,703700,11860,5457,11078,500,1392,2709,3793,2684,9449,6512,2937,6512,4525,1987,2022-01-01,zipcode,Delray beach
ZCTA5 33484,12,26262,51036,1627,198300,24545,14903,23348,1293,6169,6795,4947,4144,19147,14463,4684,14463,11745,2718,2022-01-01,zipcode,Delray beach
ZCTA5 33486,12,22991,106343,2049,578500,18336,6652,15913,562,2630,4281,5453,2987,9855,8955,900,8955,6402,2553,2022-01-01,zipcode,Boca raton
ZCTA5 33487,12,21504,87266,2142,520500,18811,8936,17002,597,2221,4028,5896,4260,13595,10172,3423,10172,7397,2775,2022-01-01,zipcode,Boca raton
ZCTA5 33493,12,5035,48080,1058,117300,4395,3340,4128,1704,1405,721,231,67,828,733,95,733,430,303,2022-01-01,zipcode,South bay
ZCTA5 33496,12,23549,98843,2430,448100,20165,10745,18288,867,2455,3772,6854,4340,12121,10306,1815,10306,8509,1797,2022-01-01,zipcode,Boca raton
ZCTA5 33498,12,16866,124403,3501,519900,13195,5201,11339,691,1394,2622,3647,2985,5848,5543,305,5543,4997,546,2022-01-01,zipcode,Boca raton
ZCTA5 33503,12,401,-666666666,-666666666,388300,401,101,271,147,27,47,50,0,104,104,0,104,85,19,2022-01-01,zipcode,Balm
ZCTA5 33510,12,30103,68487,1270,251900,25018,8992,21460,2044,7115,6733,4179,1389,12078,11482,596,11482,7144,4338,2022-01-01,zipcode,Brandon
ZCTA5 33511,12,58987,70696,1582,284400,47608,17037,40873,3391,10053,12911,9976,4542,24358,22550,1808,22550,12333,10217,2022-01-01,zipcode,Brandon
ZCTA5 33513,12,12882,57634,999,191300,10660,6552,9424,1808,3679,2723,803,411,5254,4250,1004,4250,3357,893,2022-01-01,zipcode,Bushnell
ZCTA5 33514,12,2582,71000,907,172700,2059,927,1855,537,789,331,110,88,887,808,79,808,508,300,2022-01-01,zipcode,Center hill
ZCTA5 33521,12,788,57031,885,106500,627,241,533,88,269,159,10,7,369,259,110,259,203,56,2022-01-01,zipcode,Coleman
ZCTA5 33523,12,18867,56896,891,207300,15612,6480,12838,2487,4617,3040,1798,896,7875,6683,1192,6683,5144,1539,2022-01-01,zipcode,Dade city
ZCTA5 33525,12,19186,65501,918,216800,15709,7745,13769,1381,4838,3743,2574,1233,8380,7369,1011,7369,5592,1777,2022-01-01,zipcode,Dade city
ZCTA5 33527,12,16342,68713,839,288500,13309,5225,10891,2032,3787,2932,1432,708,5631,5293,338,5293,3886,1407,2022-01-01,zipcode,Dover
ZCTA5 33534,12,17479,68875,1292,241800,12618,3822,10673,1934,3511,3181,1401,646,6199,5689,510,5689,3751,1938,2022-01-01,zipcode,Gibsonton
ZCTA5 33538,12,5599,47306,949,160600,4656,2175,4167,780,1537,1204,446,200,3280,2528,752,2528,1910,618,2022-01-01,zipcode,Lake panasoffkee
ZCTA5 33540,12,10282,46233,996,114100,8943,5220,8235,1195,3273,2575,804,388,5353,4504,849,4504,3737,767,2022-01-01,zipcode,Zephyrhills
ZCTA5 33541,12,23224,51246,1186,102200,20552,12967,18945,2235,7092,6451,2284,883,13856,10077,3779,10077,8695,1382,2022-01-01,zipcode,Zephyrhills
ZCTA5 33542,12,24573,45099,1016,119700,20884,12135,18603,2190,7327,6393,1793,900,13655,10668,2987,10668,7447,3221,2022-01-01,zipcode,Zephyrhills
ZCTA5 33543,12,35187,101000,1898,322600,27456,9458,23619,1382,4114,6762,6501,4860,13392,12306,1086,12306,10452,1854,2022-01-01,zipcode,Wesley chapel
ZCTA5 33544,12,28472,98177,1840,362100,21667,5954,18704,1471,3648,5332,4723,3530,10069,9606,463,9606,6798,2808,2022-01-01,zipcode,Wesley chapel
ZCTA5 33545,12,25721,100031,1971,315800,19853,5337,16548,841,4037,5375,4193,2102,8296,7897,399,7897,6199,1698,2022-01-01,zipcode,Wesley chapel
ZCTA5 33547,12,30431,116464,2155,435400,21904,7371,19070,1013,4348,5205,5026,3478,9911,9337,574,9337,7502,1835,2022-01-01,zipcode,Lithia
ZCTA5 33548,12,7639,119705,1814,458500,5967,2024,5288,120,696,1466,1600,1406,2859,2766,93,2766,2369,397,2022-01-01,zipcode,Lutz
ZCTA5 33549,12,18016,74094,1351,295200,15118,6127,13651,731,3128,4619,3156,2017,7655,7314,341,7314,5679,1635,2022-01-01,zipcode,Lutz
ZCTA5 33556,12,30386,142738,1530,531600,23620,8176,20849,498,3502,5271,6886,4692,11231,10546,685,10546,9094,1452,2022-01-01,zipcode,Odessa
ZCTA5 33558,12,29098,102821,1310,442800,22633,7820,19456,447,3390,4744,6324,4551,11093,10638,455,10638,7955,2683,2022-01-01,zipcode,Lutz
ZCTA5 33559,12,19226,81715,1372,295300,15695,4612,11758,997,3344,3250,2732,1435,7041,6659,382,6659,4009,2650,2022-01-01,zipcode,Lutz
ZCTA5 33563,12,26874,53068,1161,179800,21185,7382,17910,4219,5789,5040,2055,807,10773,9808,965,9808,5719,4089,2022-01-01,zipcode,Plant city
ZCTA5 33565,12,17767,66210,1075,214500,14141,6130,12529,2125,4088,3647,1718,951,6864,6281,583,6281,5357,924,2022-01-01,zipcode,Plant city
ZCTA5 33566,12,22842,69712,1234,271600,17887,6172,15464,1920,5740,3870,2778,1156,8126,7825,301,7825,5515,2310,2022-01-01,zipcode,Plant city
ZCTA5 33567,12,12499,84237,1232,251200,10328,3262,8504,1877,2825,2092,1236,474,4157,3877,280,3877,3133,744,2022-01-01,zipcode,Plant city
ZCTA5 33569,12,26189,91154,1729,302700,20477,6680,18048,1217,4715,6014,3964,2138,10150,9504,646,9504,7987,1517,2022-01-01,zipcode,Riverview
ZCTA5 33570,12,32620,67149,1143,222100,25074,9400,21126,2750,6891,7012,2981,1492,13274,11058,2216,11058,8204,2854,2022-01-01,zipcode,Ruskin
ZCTA5 33572,12,23846,110558,1935,381100,19193,6913,17415,503,3585,5433,4624,3270,9853,9120,733,9120,7605,1515,2022-01-01,zipcode,Apollo beach
ZCTA5 33573,12,28491,61635,1846,239100,26363,18920,25329,1442,7068,7984,5616,3219,16479,14479,2000,14479,11844,2635,2022-01-01,zipcode,Sun city center
ZCTA5 33576,12,6076,78114,933,292600,5418,3259,5017,171,1158,1879,1155,654,2978,2770,208,2770,2552,218,2022-01-01,zipcode,San antonio
ZCTA5 33578,12,55724,75582,1625,267800,44008,11853,38246,2408,10274,11965,9118,4481,24704,22572,2132,22572,12989,9583,2022-01-01,zipcode,Riverview
ZCTA5 33579,12,42456,102109,2050,307800,32172,8879,28006,3049,6257,9513,6253,2934,14126,13456,670,13456,10277,3179,2022-01-01,zipcode,Riverview
ZCTA5 33584,12,27863,64993,1309,256500,22372,8858,19391,2532,6324,5582,3379,1574,10668,9985,683,9985,7396,2589,2022-01-01,zipcode,Seffner
ZCTA5 33585,12,1352,59909,970,240700,1067,533,947,85,315,417,76,54,604,461,143,461,343,118,2022-01-01,zipcode,Sumterville
ZCTA5 33592,12,11275,56600,1053,185100,9433,4146,8198,1553,2972,1863,980,830,4735,4064,671,4064,2749,1315,2022-01-01,zipcode,Thonotosassa
ZCTA5 33594,12,35824,87241,1650,270600,30099,9794,25658,2225,7016,8136,5602,2679,13859,13126,733,13126,10278,2848,2022-01-01,zipcode,Valrico
ZCTA5 33596,12,28558,108963,2215,360300,23542,7929,20365,1148,3992,5680,6619,2926,10488,9982,506,9982,8184,1798,2022-01-01,zipcode,Valrico
ZCTA5 33597,12,8759,57981,904,172300,7622,3423,6591,998,2588,2222,712,71,4136,3457,679,3457,2958,499,2022-01-01,zipcode,Webster
ZCTA5 33598,12,27978,88231,1164,328800,20280,9121,17649,3547,5032,4240,2832,1998,8930,8355,575,8355,7051,1304,2022-01-01,zipcode,Wimauma
ZCTA5 33602,12,17631,88878,2010,464000,15725,4252,14004,1146,1952,2552,5130,3224,11063,9754,1309,9754,3142,6612,2022-01-01,zipcode,Tampa
ZCTA5 33603,12,19545,60324,1205,293200,16257,4324,14447,1625,3380,3795,3617,2030,9381,8428,953,8428,5032,3396,2022-01-01,zipcode,Tampa
ZCTA5 33604,12,40328,51918,1206,241100,31891,10581,28061,3759,9155,8219,4906,2022,16909,15621,1288,15621,8966,6655,2022-01-01,zipcode,Tampa
ZCTA5 33605,12,16166,32381,1075,214100,13076,5520,11529,2601,3963,2769,1480,716,8737,7255,1482,7255,2688,4567,2022-01-01,zipcode,Tampa
ZCTA5 33606,12,22546,106640,1770,740100,20108,7010,13049,285,1070,1988,5606,4100,10477,9110,1367,9110,3905,5205,2022-01-01,zipcode,Tampa
ZCTA5 33607,12,24257,57581,1678,251600,21330,7186,19026,2840,5618,4269,4134,2165,12926,11163,1763,11163,4596,6567,2022-01-01,zipcode,Tampa
ZCTA5 33609,12,18411,105761,1654,477600,15313,4407,13721,908,1531,2637,4777,3868,9165,8462,703,8462,5357,3105,2022-01-01,zipcode,Tampa
ZCTA5 33610,12,45622,47591,1217,188200,34232,12742,28858,5586,9637,8369,3177,2089,17877,16487,1390,16487,8044,8443,2022-01-01,zipcode,Tampa
ZCTA5 33611,12,34877,75718,1471,393300,28856,8985,26254,1242,5055,5863,8313,5781,18071,16728,1343,16728,9117,7611,2022-01-01,zipcode,Tampa
ZCTA5 33612,12,50697,41984,1159,225000,39251,15971,32131,7173,10860,8067,4368,1663,20912,18908,2004,18908,6778,12130,2022-01-01,zipcode,Tampa
ZCTA5 33613,12,37354,41841,1107,214700,32085,11314,22008,3115,6548,5925,3839,2581,18029,16138,1891,16138,4931,11207,2022-01-01,zipcode,Tampa
ZCTA5 33614,12,46844,50168,1232,259400,40451,12757,35204,7637,11737,7484,6240,2106,19739,18644,1095,18644,7828,10816,2022-01-01,zipcode,Tampa
ZCTA5 33615,12,48849,61761,1446,262100,39962,11325,35648,3982,12122,9170,7411,2963,20427,18681,1746,18681,10244,8437,2022-01-01,zipcode,Tampa
ZCTA5 33616,12,14918,78176,1638,329300,12078,3082,10523,506,2487,2905,2417,2208,6772,6270,502,6270,3100,3170,2022-01-01,zipcode,Tampa
ZCTA5 33617,12,48987,45719,1251,243000,40309,13084,31426,4056,9448,8905,5884,3133,21285,19942,1343,19942,8365,11577,2022-01-01,zipcode,Tampa
ZCTA5 33618,12,28416,74016,1289,355200,23680,8233,21301,1100,4766,5886,6262,3287,12814,12184,630,12184,8215,3969,2022-01-01,zipcode,Tampa
ZCTA5 33619,12,39272,55610,1426,178600,30963,11528,25937,4342,9009,7091,3427,2068,15184,14141,1043,14141,7401,6740,2022-01-01,zipcode,Tampa
ZCTA5 33620,12,6451,-666666666,-666666666,-666666666,6451,4566,25,0,0,25,0,0,0,0,0,0,0,0,2022-01-01,zipcode,Tampa
ZCTA5 33621,12,2309,93393,2432,-666666666,1481,413,918,0,238,301,208,171,579,475,104,475,0,475,2022-01-01,zipcode,Tampa
ZCTA5 33624,12,41661,81241,1553,319000,33940,10355,30123,2132,6692,8642,8513,4144,16084,15656,428,15656,10269,5387,2022-01-01,zipcode,Tampa
ZCTA5 33625,12,28818,80681,1631,322500,24427,8424,21206,1563,5060,6137,5280,3166,12022,11369,653,11369,7666,3703,2022-01-01,zipcode,Tampa
ZCTA5 33626,12,30736,120240,1937,450800,24396,7970,21284,1054,2507,4452,8035,5236,12306,11799,507,11799,7985,3814,2022-01-01,zipcode,Tampa
ZCTA5 33629,12,26625,152044,1663,726300,20131,6520,18030,385,1169,2781,6737,6958,11192,10275,917,10275,8163,2112,2022-01-01,zipcode,Tampa
ZCTA5 33634,12,22927,64830,1625,268100,18905,5808,16231,1671,4951,5143,3222,1244,8336,7984,352,7984,4466,3518,2022-01-01,zipcode,Tampa
ZCTA5 33635,12,19917,80653,1693,261300,16172,5023,14349,1258,3597,4049,3666,1779,8156,7547,609,7547,4750,2797,2022-01-01,zipcode,Tampa
ZCTA5 33637,12,17507,55748,1390,207900,14283,4352,12123,1272,2801,3767,2616,1667,8123,7572,551,7572,3375,4197,2022-01-01,zipcode,Tampa
ZCTA5 33647,12,72323,103918,1676,394800,56168,17114,48064,1938,6715,10737,16078,12596,27190,25717,1473,25717,15433,10284,2022-01-01,zipcode,Tampa
ZCTA5 33701,12,17464,65058,1360,499900,15819,5890,14321,603,2305,3648,4398,3367,13092,9613,3479,9613,3713,5900,2022-01-01,zipcode,Saint petersburg
ZCTA5 33702,12,31119,62271,1226,266700,26862,9784,24094,2260,5255,7578,6297,2704,16450,14135,2315,14135,9227,4908,2022-01-01,zipcode,Saint petersburg
ZCTA5 33703,12,25900,98289,1539,373600,21593,7206,19388,715,2941,5642,5594,4496,12162,11011,1151,11011,8719,2292,2022-01-01,zipcode,Saint petersburg
ZCTA5 33704,12,16275,96986,1242,581700,14147,4517,13144,280,2227,2959,4154,3524,9025,7829,1196,7829,5441,2388,2022-01-01,zipcode,Saint petersburg
ZCTA5 33705,12,27426,68821,1346,272800,23481,9028,20721,1523,6018,5949,4671,2560,15447,11400,4047,11400,6776,4624,2022-01-01,zipcode,Saint petersburg
ZCTA5 33706,12,15433,103695,1480,573000,14755,7557,14105,506,2299,3949,4513,2838,14010,8193,5817,8193,6205,1988,2022-01-01,zipcode,Saint petersburg
ZCTA5 33707,12,25059,61988,1367,305300,23425,12340,21752,1050,5518,6963,5050,3171,16811,12745,4066,12745,8982,3763,2022-01-01,zipcode,Saint petersburg
ZCTA5 33708,12,15222,76684,1758,443700,14188,7311,13432,546,2881,4261,3369,2375,13471,7977,5494,7977,5966,2011,2022-01-01,zipcode,Saint petersburg
ZCTA5 33709,12,24120,48049,1236,178300,21097,9661,19285,2550,7035,5899,2644,1157,13988,10850,3138,10850,8217,2633,2022-01-01,zipcode,Saint petersburg
ZCTA5 33710,12,34102,72029,1417,267900,28837,10443,25919,1816,7095,7627,6626,2755,16392,14261,2131,14261,11431,2830,2022-01-01,zipcode,Saint petersburg
ZCTA5 33711,12,17984,61488,1601,234200,15448,7058,11728,513,3881,3824,2243,1267,9297,6284,3013,6284,4287,1997,2022-01-01,zipcode,Saint petersburg
ZCTA5 33712,12,25178,58137,1301,253600,20313,8198,17472,1235,4993,5636,3749,1859,12685,9436,3249,9436,5508,3928,2022-01-01,zipcode,Saint petersburg
ZCTA5 33713,12,32713,68022,1302,245500,27908,8548,25358,2258,6546,7805,6262,2487,15924,14341,1583,14341,9989,4352,2022-01-01,zipcode,Saint petersburg
ZCTA5 33714,12,20370,45820,1170,153400,16994,6856,15226,1930,6016,4629,1891,760,9904,8241,1663,8241,5288,2953,2022-01-01,zipcode,Saint petersburg
ZCTA5 33715,12,7876,103612,2746,461900,7061,3967,6756,115,933,2045,1623,2040,7098,3865,3233,3865,3502,363,2022-01-01,zipcode,Saint petersburg
ZCTA5 33716,12,18987,68488,1656,148000,16815,3295,14395,721,2294,4503,4562,2315,11375,10056,1319,10056,1868,8188,2022-01-01,zipcode,Saint petersburg
ZCTA5 33744,12,71,-666666666,-666666666,-666666666,71,71,71,12,59,0,0,0,0,0,0,0,0,0,2022-01-01,zipcode,Bay pines
ZCTA5 33755,12,27279,50866,1122,262800,22525,8150,19919,2372,6957,6025,3074,1491,11855,10562,1293,10562,5907,4655,2022-01-01,zipcode,Clearwater
ZCTA5 33756,12,32615,58059,1235,284800,27233,11942,24728,2277,8200,7240,4733,2278,15355,13241,2114,13241,7983,5258,2022-01-01,zipcode,Clearwater
ZCTA5 33759,12,17607,60781,1699,272300,14449,6493,12847,952,3277,3995,3011,1612,8791,7598,1193,7598,3985,3613,2022-01-01,zipcode,Clearwater
ZCTA5 33760,12,20401,56173,1313,194100,17632,6730,15309,2126,4677,4643,2498,1365,8595,7543,1052,7543,3506,4037,2022-01-01,zipcode,Clearwater
ZCTA5 33761,12,18558,66438,1614,249100,15955,7509,14781,870,3769,4788,3128,2226,9771,8576,1195,8576,6781,1795,2022-01-01,zipcode,Clearwater
ZCTA5 33762,12,5103,85472,1638,294700,4621,1493,4388,128,896,1172,1431,761,3153,2623,530,2623,2038,585,2022-01-01,zipcode,Clearwater
ZCTA5 33763,12,21272,50295,1272,182000,18322,9349,16992,1178,5543,5323,3050,1898,11573,9970,1603,9970,7110,2860,2022-01-01,zipcode,Clearwater
ZCTA5 33764,12,27681,61278,1457,274300,24022,9928,21719,1499,6269,7102,4367,2482,15183,12469,2714,12469,8579,3890,2022-01-01,zipcode,Clearwater
ZCTA5 33765,12,14578,59965,1438,271800,12312,4368,11087,1383,3076,3231,2201,1196,6844,6246,598,6246,3446,2800,2022-01-01,zipcode,Clearwater
ZCTA5 33767,12,7458,97500,1771,648300,6990,4372,6658,197,1284,1585,2004,1588,8848,3990,4858,3990,3276,714,2022-01-01,zipcode,Clearwater beach
ZCTA5 33770,12,25811,53456,1289,221700,22596,9548,19611,2179,6332,6304,3017,1779,13486,11410,2076,11410,6906,4504,2022-01-01,zipcode,Largo
ZCTA5 33771,12,28412,56275,1302,134500,24810,10969,22586,2040,7409,7445,4083,1609,16856,13248,3608,13248,8067,5181,2022-01-01,zipcode,Largo
ZCTA5 33772,12,23664,71464,1422,288200,20322,8374,18199,1506,4735,6127,4162,1669,12146,9988,2158,9988,7215,2773,2022-01-01,zipcode,Seminole
ZCTA5 33773,12,16272,69285,1314,252300,14259,5042,12824,1240,3632,4017,3138,797,8145,6829,1316,6829,5098,1731,2022-01-01,zipcode,Largo
ZCTA5 33774,12,19629,72022,1280,291900,16335,6841,14602,924,3572,5894,2649,1563,10511,8277,2234,8277,6547,1730,2022-01-01,zipcode,Largo
ZCTA5 33776,12,13304,98886,1972,387000,10895,4668,9778,317,2229,2579,2818,1835,5482,5042,440,5042,4579,463,2022-01-01,zipcode,Seminole
ZCTA5 33777,12,17860,83602,1645,271600,15061,5294,13705,736,3782,4098,3282,1807,8375,7335,1040,7335,6203,1132,2022-01-01,zipcode,Seminole
ZCTA5 33778,12,15651,62369,1488,244300,13456,5326,12327,1144,3674,4309,1867,1333,8021,6421,1600,6421,5297,1124,2022-01-01,zipcode,Largo
ZCTA5 33781,12,26315,51958,1090,228500,22372,8608,20035,4042,6088,5658,2934,1313,12122,10300,1822,10300,6696,3604,2022-01-01,zipcode,Pinellas park
ZCTA5 33782,12,23723,66824,1571,228900,19905,8373,17898,2028,5388,5664,3275,1543,10799,9387,1412,9387,7062,2325,2022-01-01,zipcode,Pinellas park
ZCTA5 33785,12,4871,94638,1491,645400,4650,2069,4207,142,655,1415,1266,729,5874,2423,3451,2423,1870,553,2022-01-01,zipcode,Indian rocks beach
ZCTA5 33786,12,1579,133750,2933,987000,1434,747,1373,51,159,334,468,361,1211,708,503,708,657,51,2022-01-01,zipcode,Belleair beach
ZCTA5 33801,12,33861,45932,1024,123300,27619,13307,20347,3195,8263,5732,1897,1260,15252,11696,3556,11696,5667,6029,2022-01-01,zipcode,Lakeland
ZCTA5 33803,12,30230,62701,1238,215600,24987,10307,21573,1585,6068,6517,4372,3031,14976,12370,2606,12370,7610,4760,2022-01-01,zipcode,Lakeland
ZCTA5 33805,12,26064,51006,1118,150600,21005,9726,18221,3341,7156,4908,1872,944,11291,9707,1584,9707,4501,5206,2022-01-01,zipcode,Lakeland
ZCTA5 33809,12,30897,61911,1391,221800,25331,10621,21850,2212,7258,7221,3352,1807,12502,11397,1105,11397,7449,3948,2022-01-01,zipcode,Lakeland
ZCTA5 33810,12,51427,66045,1371,217000,42235,18003,36520,4766,12627,12747,4394,1986,21562,19229,2333,19229,14600,4629,2022-01-01,zipcode,Lakeland
ZCTA5 33811,12,25886,83043,1185,260900,20859,7403,17937,1668,4880,5789,4152,1448,10180,9353,827,9353,7287,2066,2022-01-01,zipcode,Lakeland
ZCTA5 33812,12,14736,95031,1440,286100,11756,3794,9720,565,2722,2982,1976,1475,5420,4741,679,4741,3659,1082,2022-01-01,zipcode,Lakeland
ZCTA5 33813,12,37582,93306,1560,301600,29090,10500,25337,1565,5588,8493,6512,3179,14511,13560,951,13560,10685,2875,2022-01-01,zipcode,Lakeland
ZCTA5 33815,12,13644,33540,996,29700,10821,5924,9472,1997,3739,2750,704,282,7304,5738,1566,5738,3237,2501,2022-01-01,zipcode,Lakeland
ZCTA5 33823,12,37082,61190,955,207600,29850,12160,26036,4051,10186,7283,3321,1195,14650,12752,1898,12752,9021,3731,2022-01-01,zipcode,Auburndale
ZCTA5 33825,12,25393,46017,865,123600,21428,12290,18560,3395,6841,5808,1634,882,12154,10047,2107,10047,7362,2685,2022-01-01,zipcode,Avon park
ZCTA5 33827,12,2513,62466,1588,221400,2201,1183,1632,210,528,584,192,118,1211,881,330,881,766,115,2022-01-01,zipcode,Babson park
ZCTA5 33830,12,30396,57904,980,192200,24356,9274,20673,2759,7643,6228,2938,1105,11747,10499,1248,10499,6947,3552,2022-01-01,zipcode,Bartow
ZCTA5 33834,12,6371,51154,947,104200,5073,3090,4248,917,2085,833,226,187,2060,1544,516,1544,999,545,2022-01-01,zipcode,Bowling green
ZCTA5 33837,12,39979,71529,1642,271300,31179,12833,27043,2882,8625,8815,4719,2002,17361,13314,4047,13314,11096,2218,2022-01-01,zipcode,Davenport
ZCTA5 33838,12,5226,49118,1167,200800,3927,1727,3448,922,1436,892,150,48,1957,1556,401,1556,1112,444,2022-01-01,zipcode,Dundee
ZCTA5 33839,12,3649,75972,1283,172000,2786,977,2358,458,787,720,268,125,1444,1146,298,1146,871,275,2022-01-01,zipcode,Eagle lake
ZCTA5 33841,12,8440,38466,816,133800,6918,3780,5842,1139,2757,1432,273,241,3954,3141,813,3141,2256,885,2022-01-01,zipcode,Fort meade
ZCTA5 33843,12,10790,49812,832,94700,9468,5593,8268,1687,3125,2356,600,500,5824,4004,1820,4004,3363,641,2022-01-01,zipcode,Frostproof
ZCTA5 33844,12,45765,58242,1150,191600,36495,15927,31304,4783,11585,9848,3462,1626,20750,15616,5134,15616,10896,4720,2022-01-01,zipcode,Haines city
ZCTA5 33847,12,374,65391,753,153900,290,136,234,13,72,125,18,6,125,125,0,125,77,48,2022-01-01,zipcode,Homeland
ZCTA5 33848,12,549,51700,1152,-666666666,422,272,361,72,156,104,0,29,215,148,67,148,66,82,2022-01-01,zipcode,Intercession city
ZCTA5 33849,12,713,53646,-666666666,216700,639,376,513,129,297,74,0,13,248,221,27,221,168,53,2022-01-01,zipcode,Kathleen
ZCTA5 33850,12,8876,49801,1114,188800,7472,3195,6846,855,2821,1764,787,619,4375,3378,997,3378,2367,1011,2022-01-01,zipcode,Lake alfred
ZCTA5 33851,12,988,56938,-666666666,174000,778,407,672,168,259,191,39,15,355,283,72,283,255,28,2022-01-01,zipcode,Lake hamilton
ZCTA5 33852,12,21394,54055,1033,172700,17988,9888,16686,2476,6229,4911,1820,1250,13099,9361,3738,9361,7515,1846,2022-01-01,zipcode,Lake placid
ZCTA5 33853,12,12241,42397,949,177200,9502,4407,8393,1367,2952,2398,1096,580,5540,4719,821,4719,2573,2146,2022-01-01,zipcode,Lake wales
ZCTA5 33854,12,446,32438,672,83200,443,355,413,101,70,148,61,33,643,241,402,241,111,130,2022-01-01,zipcode,Lakeshore
ZCTA5 33855,12,126,56302,-666666666,276000,126,80,126,32,77,17,0,0,41,41,0,41,41,0,2022-01-01,zipcode,Indian lake estates
ZCTA5 33856,12,297,30208,609,-666666666,297,203,297,30,90,149,28,0,520,219,301,219,6,213,2022-01-01,zipcode,Nalcrest
ZCTA5 33857,12,1160,39659,-666666666,138200,1043,659,1037,116,454,297,157,13,1176,595,581,595,504,91,2022-01-01,zipcode,Lorida
ZCTA5 33859,12,11081,61815,1104,181100,9555,5437,8267,1103,2547,2730,1270,617,5854,4441,1413,4441,3441,1000,2022-01-01,zipcode,Lake wales
ZCTA5 33860,12,26658,62429,1137,189400,20326,7316,16896,2799,5930,5599,1812,756,9613,8565,1048,8565,5815,2750,2022-01-01,zipcode,Mulberry
ZCTA5 33865,12,866,62689,-666666666,-666666666,722,223,629,73,352,102,82,20,276,276,0,276,117,159,2022-01-01,zipcode,Ona
ZCTA5 33867,12,76,-666666666,-666666666,163500,76,76,76,13,36,27,0,0,109,40,69,40,40,0,2022-01-01,zipcode,River ranch
ZCTA5 33868,12,13404,67579,1051,190800,10810,5597,9632,1365,3568,2929,1239,531,5226,4210,1016,4210,3715,495,2022-01-01,zipcode,Polk city
ZCTA5 33870,12,25314,43915,891,133800,21492,12128,19069,3149,6941,5961,1995,1023,13857,11070,2787,11070,7703,3367,2022-01-01,zipcode,Sebring
ZCTA5 33872,12,12696,67576,1070,165800,11379,7178,10554,874,3253,3694,1858,875,7834,5981,1853,5981,5407,574,2022-01-01,zipcode,Sebring
ZCTA5 33873,12,13678,40625,911,120200,10369,4961,8720,1932,4003,1939,649,197,5653,4880,773,4880,3144,1736,2022-01-01,zipcode,Wauchula
ZCTA5 33875,12,11129,73243,913,198600,9275,4757,8710,771,2884,3006,1268,781,5505,4681,824,4681,3898,783,2022-01-01,zipcode,Sebring
ZCTA5 33876,12,6188,53388,887,152500,5535,3480,5231,586,1964,1878,626,177,3171,2523,648,2523,2207,316,2022-01-01,zipcode,Sebring
ZCTA5 33877,12,269,-666666666,-666666666,188800,269,107,269,0,132,137,0,0,211,211,0,211,211,0,2022-01-01,zipcode,Waverly
ZCTA5 33880,12,43732,53569,1038,178400,34065,13882,28996,5670,10954,8382,2859,1131,17358,15169,2189,15169,9937,5232,2022-01-01,zipcode,Winter haven
ZCTA5 33881,12,38946,51685,1085,157400,31440,15643,27697,3667,10262,9096,3186,1486,17619,14359,3260,14359,10152,4207,2022-01-01,zipcode,Winter haven
ZCTA5 33884,12,36058,68638,1374,245300,30159,13805,26127,2130,7895,9000,4709,2393,15587,13554,2033,13554,10365,3189,2022-01-01,zipcode,Winter haven
ZCTA5 33890,12,4821,49219,856,129300,3709,1680,3078,736,1419,561,217,145,1905,1469,436,1469,1166,303,2022-01-01,zipcode,Zolfo springs
ZCTA5 33896,12,20528,67999,1823,277800,17015,4874,14011,870,3146,5142,3192,1661,10737,7503,3234,7503,3452,4051,2022-01-01,zipcode,Davenport
ZCTA5 33897,12,28083,68857,1764,246700,22650,7270,19973,1416,6328,7104,3831,1294,13396,9688,3708,9688,6673,3015,2022-01-01,zipcode,Davenport
ZCTA5 33898,12,17066,53717,1095,147500,13825,7118,12533,1955,4748,3824,1482,524,9798,6884,2914,6884,5678,1206,2022-01-01,zipcode,Lake wales
ZCTA5 33901,12,24284,46903,1195,274300,19451,9016,17028,2929,5578,3932,2609,1980,11657,9551,2106,9551,4141,5410,2022-01-01,zipcode,Fort myers
ZCTA5 33903,12,22430,55596,1096,117200,20293,12045,18991,2381,5981,6433,2741,1455,15240,11482,3758,11482,9380,2102,2022-01-01,zipcode,North fort myers
ZCTA5 33904,12,32345,62177,1520,301700,28951,14668,27475,1567,9795,8802,4872,2439,20296,14612,5684,14612,11161,3451,2022-01-01,zipcode,Cape coral
ZCTA5 33905,12,39247,68335,1458,221200,32050,14084,27531,5469,8538,7703,3686,2135,16479,14053,2426,14053,8941,5112,2022-01-01,zipcode,Fort myers
ZCTA5 33907,12,25828,51122,1360,213800,21933,8574,19366,2350,6067,5588,3325,2036,14105,11244,2861,11244,4745,6499,2022-01-01,zipcode,Fort myers
ZCTA5 33908,12,38844,68445,1729,300200,35953,21361,33772,1422,9181,8901,8052,6216,31714,20062,11652,20062,14156,5906,2022-01-01,zipcode,Fort myers
ZCTA5 33909,12,36172,73851,1653,260800,28818,9908,24579,1536,9507,7891,3610,2035,13768,12681,1087,12681,9228,3453,2022-01-01,zipcode,Cape coral
ZCTA5 33912,12,19370,98293,1695,335200,17425,9534,16010,440,3440,4439,4557,3134,12033,8637,3396,8637,7361,1276,2022-01-01,zipcode,Fort myers
ZCTA5 33913,12,27056,104877,1847,380700,23393,12093,19867,997,4106,5472,5219,4073,15159,10612,4547,10612,9545,1067,2022-01-01,zipcode,Fort myers
ZCTA5 33914,12,43289,72662,1590,369400,38742,17233,35716,1797,11640,12444,5984,3851,22594,17707,4887,17707,14325,3382,2022-01-01,zipcode,Cape coral
ZCTA5 33916,12,26153,46342,1219,209400,21006,8226,17913,3620,6329,4175,2594,1195,12366,10054,2312,10054,3403,6651,2022-01-01,zipcode,Fort myers
ZCTA5 33917,12,30512,51070,1140,155500,27634,15360,25423,2775,9457,8428,3073,1690,18365,14385,3980,14385,11978,2407,2022-01-01,zipcode,North fort myers
ZCTA5 33919,12,28483,67788,1470,265200,25520,12792,23710,1124,5098,7507,5707,4274,19210,14231,4979,14231,10996,3235,2022-01-01,zipcode,Fort myers
ZCTA5 33920,12,7250,84065,986,319300,5942,2679,5334,343,1508,1869,1068,546,3020,2683,337,2683,2507,176,2022-01-01,zipcode,Alva
ZCTA5 33921,12,726,117240,-666666666,2000001,723,529,711,28,121,182,212,168,1688,362,1326,362,362,0,2022-01-01,zipcode,Boca grande
ZCTA5 33922,12,4235,64461,1120,278100,3616,2151,3353,414,893,896,670,480,2959,1784,1175,1784,1519,265,2022-01-01,zipcode,Bokeelia
ZCTA5 33924,12,161,-666666666,-666666666,-666666666,161,105,131,31,18,18,58,6,1748,40,1708,40,40,0,2022-01-01,zipcode,Captiva
ZCTA5 33928,12,29948,95979,1928,378800,26717,14857,25163,787,5158,7549,6776,4893,19881,13675,6206,13675,11470,2205,2022-01-01,zipcode,Estero
ZCTA5 33930,12,993,75152,-666666666,-666666666,720,213,549,197,282,70,0,0,315,264,51,264,214,50,2022-01-01,zipcode,Felda
ZCTA5 33931,12,9150,74838,1453,426000,8867,6259,8568,300,2546,2523,1702,1497,14785,4825,9960,4825,4359,466,2022-01-01,zipcode,Fort myers beach
ZCTA5 33935,12,22521,47027,912,159200,17332,6544,14570,4406,4859,3197,1623,485,8648,7437,1211,7437,5358,2079,2022-01-01,zipcode,Labelle
ZCTA5 33936,12,26537,43640,1152,182700,21704,9762,18485,3710,6938,4964,2063,810,10684,9756,928,9756,6382,3374,2022-01-01,zipcode,Lehigh acres
ZCTA5 33944,12,186,36203,-666666666,75200,186,95,186,0,100,80,0,6,152,95,57,95,95,0,2022-01-01,zipcode,Palmdale
ZCTA5 33946,12,2704,82358,785,565500,2578,1528,2462,63,707,677,497,518,3072,1315,1757,1315,1198,117,2022-01-01,zipcode,Placida
ZCTA5 33947,12,9927,60984,1265,312700,9327,6083,8959,631,2710,3065,1670,883,6555,4912,1643,4912,3953,959,2022-01-01,zipcode,Rotonda west
ZCTA5 33948,12,18440,59861,1265,249500,16755,9182,15837,1309,5425,5895,2156,1052,9386,7839,1547,7839,6758,1081,2022-01-01,zipcode,Port charlotte
ZCTA5 33950,12,24702,71357,1153,372900,22356,14580,20763,877,4941,7640,4391,2914,16514,12055,4459,12055,9959,2096,2022-01-01,zipcode,Punta gorda
ZCTA5 33952,12,34731,52312,1161,201500,30071,15340,26920,2994,10219,8464,3515,1728,17516,14697,2819,14697,11143,3554,2022-01-01,zipcode,Port charlotte
ZCTA5 33953,12,7347,73294,1568,292100,6782,4221,6018,359,1806,1986,1187,680,4109,2976,1133,2976,2887,89,2022-01-01,zipcode,Port charlotte
ZCTA5 33954,12,10393,74221,1580,289400,8887,3843,8083,546,2367,3152,1382,636,4541,4183,358,4183,3268,915,2022-01-01,zipcode,Port charlotte
ZCTA5 33955,12,10397,73523,1531,302600,9777,6298,9263,1100,2830,2616,1689,1028,6751,4894,1857,4894,4523,371,2022-01-01,zipcode,Punta gorda
ZCTA5 33956,12,3494,62415,2191,251600,3346,2093,3248,239,1021,1196,412,380,3629,1773,1856,1773,1648,125,2022-01-01,zipcode,Saint james city
ZCTA5 33957,12,6420,111683,1003,844500,6288,4203,6126,37,1316,1149,1904,1720,8475,3491,4984,3491,3133,358,2022-01-01,zipcode,Sanibel
ZCTA5 33960,12,581,37500,1083,205000,474,229,468,56,154,171,57,30,444,310,134,310,270,40,2022-01-01,zipcode,Venus
ZCTA5 33965,12,3793,25179,1365,-666666666,3793,1891,54,0,10,40,4,0,33,33,0,33,0,33,2022-01-01,zipcode,Fort myers
ZCTA5 33966,12,11236,79172,1557,326900,9509,3864,8945,314,1879,2806,2543,1403,6768,5130,1638,5130,3407,1723,2022-01-01,zipcode,Fort myers
ZCTA5 33967,12,27887,82732,1634,293300,22695,6995,18515,1847,4600,6112,3823,2133,11241,9734,1507,9734,6963,2771,2022-01-01,zipcode,Fort myers
ZCTA5 33971,12,28712,69061,1566,240900,21441,6951,17563,3055,6413,5475,1813,807,8561,8176,385,8176,6523,1653,2022-01-01,zipcode,Lehigh acres
ZCTA5 33972,12,15218,66643,1434,260000,11841,4842,9980,1353,3820,3011,1280,516,5131,4617,514,4617,3644,973,2022-01-01,zipcode,Lehigh acres
ZCTA5 33973,12,14585,58989,1342,289300,10036,3411,7887,1667,2887,2363,667,303,4257,3992,265,3992,895,3097,2022-01-01,zipcode,Lehigh acres
ZCTA5 33974,12,19218,60617,1595,237600,14501,5304,11985,1903,4658,3444,1478,502,5726,5277,449,5277,3539,1738,2022-01-01,zipcode,Lehigh acres
ZCTA5 33976,12,17874,63992,1633,234600,13030,4170,10791,2451,3336,3074,1581,349,5189,4977,212,4977,3606,1371,2022-01-01,zipcode,Lehigh acres
ZCTA5 33980,12,13071,58919,1151,201500,11450,7186,10825,820,4351,3243,1384,1027,8096,6062,2034,6062,4570,1492,2022-01-01,zipcode,Punta gorda
ZCTA5 33981,12,14330,66708,1385,319400,12736,7094,12168,865,4164,4050,1824,1265,7473,6121,1352,6121,5464,657,2022-01-01,zipcode,Port charlotte
ZCTA5 33982,12,11067,56518,993,246200,9803,6018,9334,1203,3388,2695,1112,936,5485,4262,1223,4262,3685,577,2022-01-01,zipcode,Punta gorda
ZCTA5 33983,12,16637,63213,1190,291300,14623,7650,13186,850,4891,4325,2079,1041,8650,7201,1449,7201,5857,1344,2022-01-01,zipcode,Punta gorda
ZCTA5 33990,12,34275,67030,1498,289100,29186,12128,26339,2955,9961,7351,4322,1750,15394,13125,2269,13125,9468,3657,2022-01-01,zipcode,Cape coral
ZCTA5 33991,12,24993,76996,1735,317800,20205,8451,18131,938,6340,6358,3350,1145,11043,9452,1591,9452,7508,1944,2022-01-01,zipcode,Cape coral
ZCTA5 33993,12,30572,86117,1859,289900,24870,9521,21401,2288,7530,6966,2890,1727,11698,10411,1287,10411,8810,1601,2022-01-01,zipcode,Cape coral
ZCTA5 34101,12,0,-666666666,-666666666,-666666666,0,0,0,0,0,0,0,0,0,0,0,0,0,0,2022-01-01,zipcode,Naples
ZCTA5 34102,12,10767,111742,1306,1207200,9663,5697,9155,486,1398,2007,2991,2273,9616,5385,4231,5385,4013,1372,2022-01-01,zipcode,Naples
ZCTA5 34103,12,11214,99615,1823,876500,10221,5459,9273,290,1727,2087,3062,2107,10351,5390,4961,5390,4548,842,2022-01-01,zipcode,Naples
ZCTA5 34104,12,24269,67932,1531,312200,20143,9850,18732,1599,5454,5544,3841,2294,15670,11060,4610,11060,7584,3476,2022-01-01,zipcode,Naples
ZCTA5 34105,12,16462,101282,1896,496900,14589,7518,13538,442,2369,3647,4000,3080,11540,7721,3819,7721,5106,2615,2022-01-01,zipcode,Naples
ZCTA5 34108,12,16401,115182,1843,903100,15467,9718,14874,481,2252,3265,5154,3722,15030,8412,6618,8412,7198,1214,2022-01-01,zipcode,Naples
ZCTA5 34109,12,25845,88203,1766,531600,21669,11316,19983,744,4167,5000,5817,4255,15744,11765,3979,11765,8204,3561,2022-01-01,zipcode,Naples
ZCTA5 34110,12,24584,90006,1945,472800,22219,13066,20810,774,3782,5295,6745,4214,17976,12641,5335,12641,9252,3389,2022-01-01,zipcode,Naples
ZCTA5 34112,12,26597,66692,1373,271200,24711,13417,22568,2144,6651,6110,4450,3213,20323,12975,7348,12975,9921,3054,2022-01-01,zipcode,Naples
ZCTA5 34113,12,24413,72688,1723,399700,21216,10883,19270,2359,5347,4303,4447,2814,16095,10424,5671,10424,7399,3025,2022-01-01,zipcode,Naples
ZCTA5 34114,12,20716,79130,1767,383700,18519,10355,17353,1854,4214,4712,3740,2833,15213,9360,5853,9360,7834,1526,2022-01-01,zipcode,Naples
ZCTA5 34116,12,35710,66302,1483,344100,28257,7832,23485,4443,9540,5488,2653,1361,11439,10832,607,10832,6066,4766,2022-01-01,zipcode,Naples
ZCTA5 34117,12,19218,101392,1488,379500,15937,5099,13690,1749,4634,4263,2081,963,5813,5433,380,5433,4650,783,2022-01-01,zipcode,Naples
ZCTA5 34119,12,33017,105263,1641,599800,27137,13730,24816,1032,4937,6166,7032,5649,17758,14047,3711,14047,11658,2389,2022-01-01,zipcode,Naples
ZCTA5 34120,12,38191,83636,2022,408600,31790,10931,27883,3469,9228,6634,4992,3560,16805,13401,3404,13401,11619,1782,2022-01-01,zipcode,Naples
ZCTA5 34134,12,15859,121713,1736,605800,15152,10223,14773,299,2322,3904,4277,3971,14616,8305,6311,8305,6752,1553,2022-01-01,zipcode,Bonita springs
ZCTA5 34135,12,45781,81024,1662,380600,40273,21100,37207,4362,8010,10391,8780,5664,29780,19810,9970,19810,15648,4162,2022-01-01,zipcode,Bonita springs
ZCTA5 34137,12,369,81228,-666666666,162300,194,29,194,0,138,56,0,0,115,115,0,115,115,0,2022-01-01,zipcode,
ZCTA5 34138,12,1061,91080,-666666666,213000,762,372,762,0,333,368,61,0,676,364,312,364,315,49,2022-01-01,zipcode,Chokoloskee
ZCTA5 34139,12,143,-666666666,-666666666,394100,127,51,127,0,36,55,17,19,486,72,414,72,68,4,2022-01-01,zipcode,Everglades city
ZCTA5 34140,12,155,-666666666,-666666666,-666666666,113,86,86,0,27,33,26,0,220,53,167,53,26,27,2022-01-01,zipcode,Goodland
ZCTA5 34141,12,74,-666666666,-666666666,-666666666,43,28,34,5,24,5,0,0,4,4,0,4,4,0,2022-01-01,zipcode,Ochopee
ZCTA5 34142,12,34411,55225,926,246600,26125,9734,20264,8072,6285,3447,1531,929,10005,8577,1428,8577,3975,4602,2022-01-01,zipcode,Immokalee
ZCTA5 34145,12,15942,105315,1870,808800,14924,10056,14409,616,3049,4014,3667,3063,18135,8276,9859,8276,7487,789,2022-01-01,zipcode,Marco island
ZCTA5 34201,12,3912,123105,1820,587700,3698,2369,3483,88,406,598,1415,976,2481,1801,680,1801,1712,89,2022-01-01,zipcode,Bradenton
ZCTA5 34202,12,26762,114234,1941,550300,22209,11065,19829,663,3035,5327,5876,4928,12099,10395,1704,10395,8123,2272,2022-01-01,zipcode,Bradenton
ZCTA5 34203,12,39757,66580,1243,276600,34025,15289,30623,3644,11450,7934,4720,2875,20687,16637,4050,16637,12218,4419,2022-01-01,zipcode,Bradenton
ZCTA5 34205,12,30966,48859,1192,215000,26220,10837,22981,3526,7581,6593,3490,1791,16302,12978,3324,12978,7750,5228,2022-01-01,zipcode,Bradenton
ZCTA5 34207,12,34437,47711,1168,116100,29389,12996,25609,4186,10541,7056,2737,1089,19419,14675,4744,14675,9358,5317,2022-01-01,zipcode,Bradenton
ZCTA5 34208,12,41521,55576,1352,259500,31950,13396,27761,5900,8939,6918,3923,2081,16280,13815,2465,13815,7977,5838,2022-01-01,zipcode,Bradenton
ZCTA5 34209,12,34089,75739,1595,323300,29868,15237,27734,1680,7907,8291,5786,4070,18900,14797,4103,14797,11691,3106,2022-01-01,zipcode,Bradenton
ZCTA5 34210,12,16461,56799,1336,263300,14829,7847,13112,945,4050,3625,2694,1798,11648,7701,3947,7701,4857,2844,2022-01-01,zipcode,Bradenton
ZCTA5 34211,12,16508,119663,1851,535600,13918,6130,12488,569,1860,3721,3800,2538,8451,6209,2242,6209,5292,917,2022-01-01,zipcode,Bradenton
ZCTA5 34212,12,23754,107699,1764,441800,19606,8418,17728,502,2999,5768,5187,3272,10884,8892,1992,8892,7452,1440,2022-01-01,zipcode,Bradenton
ZCTA5 34215,12,683,-666666666,-666666666,796900,683,434,665,0,101,307,174,83,551,322,229,322,300,22,2022-01-01,zipcode,Cortez
ZCTA5 34216,12,924,95694,-666666666,1108600,923,680,912,23,100,235,371,183,1840,558,1282,558,536,22,2022-01-01,zipcode,Anna maria
ZCTA5 34217,12,3719,85896,1770,607300,3371,2097,3299,72,557,736,1086,848,5811,1962,3849,1962,1650,312,2022-01-01,zipcode,Bradenton beach
ZCTA5 34219,12,27838,103000,1901,376200,23084,9431,20744,510,5549,6538,5421,2726,11554,10390,1164,10390,9399,991,2022-01-01,zipcode,Parrish
ZCTA5 34221,12,52882,71679,1365,271200,44151,19191,39411,3926,13117,11919,6665,3784,23685,19085,4600,19085,15010,4075,2022-01-01,zipcode,Palmetto
ZCTA5 34222,12,13975,63142,1388,166400,11883,6149,10652,727,3888,3744,1303,990,7838,6060,1778,6060,4803,1257,2022-01-01,zipcode,Ellenton
ZCTA5 34223,12,19116,66268,1256,340600,17894,11839,17080,548,5050,4904,3825,2753,14336,9930,4406,9930,8482,1448,2022-01-01,zipcode,Englewood
ZCTA5 34224,12,15263,52129,1143,229200,14404,8963,13237,1038,4750,4382,2006,1061,11277,7688,3589,7688,6148,1540,2022-01-01,zipcode,Englewood
ZCTA5 34228,12,7479,141250,2469,909700,7456,5952,7432,169,897,1415,2303,2648,9708,4171,5537,4171,3909,262,2022-01-01,zipcode,Longboat key
ZCTA5 34229,12,7575,94496,2200,620800,6879,4423,6505,170,1165,1274,2101,1795,4626,3548,1078,3548,3196,352,2022-01-01,zipcode,Osprey
ZCTA5 34231,12,32413,67543,1483,337400,27732,13100,25671,1465,7100,7604,5679,3823,18854,15180,3674,15180,9962,5218,2022-01-01,zipcode,Sarasota
ZCTA5 34232,12,34324,79806,1697,296300,29164,10068,26078,1917,7944,7772,5402,3043,16967,14870,2097,14870,10254,4616,2022-01-01,zipcode,Sarasota
ZCTA5 34233,12,19179,74365,1652,321100,16284,6636,14837,706,4189,4322,3906,1714,9455,8403,1052,8403,6078,2325,2022-01-01,zipcode,Sarasota
ZCTA5 34234,12,21621,54669,1321,196000,18020,8223,15609,2630,5229,3715,2461,1574,10256,8828,1428,8828,5318,3510,2022-01-01,zipcode,Sarasota
ZCTA5 34235,12,14760,69623,1619,301500,13418,6636,12180,631,3631,3280,2816,1822,8201,7045,1156,7045,5157,1888,2022-01-01,zipcode,Sarasota
ZCTA5 34236,12,13347,95231,1852,867000,12842,8296,12409,553,1814,2252,3758,4032,11436,7608,3828,7608,4446,3162,2022-01-01,zipcode,Sarasota
ZCTA5 34237,12,17877,61556,1409,224500,15042,4825,13128,1535,4576,3928,2104,985,9028,7227,1801,7227,3182,4045,2022-01-01,zipcode,Sarasota
ZCTA5 34238,12,22426,91936,1833,479400,20383,12001,19145,317,3804,4762,4739,5523,13715,11100,2615,11100,8355,2745,2022-01-01,zipcode,Sarasota
ZCTA5 34239,12,14812,72079,1523,376900,12867,5415,11638,899,2650,3240,2999,1850,7997,6871,1126,6871,5107,1764,2022-01-01,zipcode,Sarasota
ZCTA5 34240,12,14400,120581,2014,531900,11835,5219,10648,223,2302,3018,3199,1906,6917,5629,1288,5629,4941,688,2022-01-01,zipcode,Sarasota
ZCTA5 34241,12,15608,105794,1854,461600,13012,5297,11450,451,2509,3161,3361,1968,6738,5957,781,5957,5197,760,2022-01-01,zipcode,Sarasota
ZCTA5 34242,12,7602,121006,2169,877400,7162,4694,6913,218,751,1470,2330,2144,10419,4053,6366,4053,3538,515,2022-01-01,zipcode,Sarasota
ZCTA5 34243,12,31656,77236,1826,365300,27933,12810,24872,1158,6236,7201,5386,4891,16052,13411,2641,13411,10453,2958,2022-01-01,zipcode,Sarasota
ZCTA5 34251,12,7324,82926,951,457700,5957,2335,4947,455,2045,1631,574,242,2335,2204,131,2204,2000,204,2022-01-01,zipcode,Myakka city
ZCTA5 34266,12,28420,41328,857,131500,23588,11923,20415,6122,7896,4322,1303,772,12147,9972,2175,9972,6636,3336,2022-01-01,zipcode,Arcadia
ZCTA5 34268,12,508,-666666666,-666666666,-666666666,508,284,341,128,112,21,80,0,165,96,69,96,92,4,2022-01-01,zipcode,Nocatee
ZCTA5 34269,12,5274,52473,1039,168200,4639,2807,4210,470,1921,1074,577,168,3226,2243,983,2243,2027,216,2022-01-01,zipcode,Arcadia
ZCTA5 34275,12,20692,78532,1641,375000,18839,10821,17634,601,4766,4921,4019,3327,12490,10329,2161,10329,8876,1453,2022-01-01,zipcode,Nokomis
ZCTA5 34285,12,18791,61531,1363,280000,18030,12006,17278,730,4544,5008,3862,3134,15940,10360,5580,10360,8229,2131,2022-01-01,zipcode,Venice
ZCTA5 34286,12,20571,67867,1734,273600,17392,8148,15047,1403,4188,5650,2287,1519,8447,7783,664,7783,6236,1547,2022-01-01,zipcode,North port
ZCTA5 34287,12,26721,63657,1235,209200,22583,12680,20781,1710,6993,7590,2763,1725,15469,11330,4139,11330,8711,2619,2022-01-01,zipcode,North port
ZCTA5 34288,12,14412,77440,1515,266200,11788,5115,9552,745,2606,3506,1841,854,5723,5400,323,5400,4370,1030,2022-01-01,zipcode,North port
ZCTA5 34289,12,4692,112576,1644,302300,3991,1513,3316,327,806,1195,668,320,1908,1491,417,1491,874,617,2022-01-01,zipcode,North port
ZCTA5 34291,12,8104,87529,1719,295800,7063,2536,6161,282,2793,2224,572,290,3143,3060,83,3060,2688,372,2022-01-01,zipcode,North port
ZCTA5 34292,12,16426,80824,1912,389800,15274,10140,14500,545,3591,4036,3501,2827,10329,8215,2114,8215,6511,1704,2022-01-01,zipcode,Venice
ZCTA5 34293,12,46782,84110,1678,335700,41987,23243,39691,1966,9544,13429,7916,6836,27125,22049,5076,22049,19449,2600,2022-01-01,zipcode,Venice
ZCTA5 34420,12,18396,50355,873,160800,14364,6316,12424,1195,4899,4583,1062,685,7949,6953,996,6953,4854,2099,2022-01-01,zipcode,Belleview
ZCTA5 34428,12,9175,50075,813,218800,8074,4327,7139,794,2510,2412,953,470,5028,4099,929,4099,3128,971,2022-01-01,zipcode,Crystal river
ZCTA5 34429,12,9448,55797,940,193500,8406,5432,7931,700,3169,2192,1219,651,5470,4248,1222,4248,3570,678,2022-01-01,zipcode,Crystal river
ZCTA5 34431,12,8448,47632,835,161300,7399,4325,6793,942,2734,2234,703,180,4790,3870,920,3870,3282,588,2022-01-01,zipcode,Dunnellon
ZCTA5 34432,12,13029,45583,941,189400,10977,6500,10340,1051,3920,3292,1298,779,6599,5694,905,5694,5019,675,2022-01-01,zipcode,Dunnellon
ZCTA5 34433,12,8128,68072,1351,202100,6796,3625,5763,683,2421,1567,707,385,3702,3149,553,3149,2894,255,2022-01-01,zipcode,Dunnellon
ZCTA5 34434,12,9981,54202,1213,181400,7686,4054,7160,688,2516,2539,1035,382,4349,3682,667,3682,3238,444,2022-01-01,zipcode,Dunnellon
ZCTA5 34436,12,7846,47580,611,174600,6943,4488,6508,842,2360,2276,598,432,4817,3657,1160,3657,3130,527,2022-01-01,zipcode,Floral city
ZCTA5 34442,12,16674,51216,848,257800,15184,10868,14285,928,4945,4584,1921,1907,9771,7843,1928,7843,6841,1002,2022-01-01,zipcode,Hernando
ZCTA5 34445,12,0,-666666666,-666666666,-666666666,0,0,0,0,0,0,0,0,40,0,40,0,0,0,2022-01-01,zipcode,Holder
ZCTA5 34446,12,18668,57773,883,201600,16711,11113,15397,1668,5613,5481,1404,1231,9513,8336,1177,8336,7811,525,2022-01-01,zipcode,Homosassa
ZCTA5 34448,12,10607,45685,903,124600,9613,5505,8553,1208,3568,2512,1042,223,6200,4661,1539,4661,3949,712,2022-01-01,zipcode,Homosassa
ZCTA5 34449,12,3510,49331,755,125000,3162,1605,2915,390,1368,818,259,80,1937,1521,416,1521,1126,395,2022-01-01,zipcode,Inglis
ZCTA5 34450,12,10005,42815,942,177200,9206,5909,8247,713,2425,3116,1296,697,6624,5004,1620,5004,4003,1001,2022-01-01,zipcode,Inverness
ZCTA5 34452,12,13592,55122,1080,172600,10886,5192,10235,1032,3875,3947,1095,286,6138,5452,686,5452,4552,900,2022-01-01,zipcode,Inverness
ZCTA5 34453,12,10108,50803,983,156100,8757,4949,8158,619,3539,2720,899,381,5455,4405,1050,4405,3816,589,2022-01-01,zipcode,Inverness
ZCTA5 34461,12,12424,55170,997,256300,10727,7055,9705,827,4078,2599,1246,955,5526,4645,881,4645,4097,548,2022-01-01,zipcode,Lecanto
ZCTA5 34465,12,18121,55256,1107,195600,15802,9339,14343,1120,5552,4811,1545,1315,9144,8163,981,8163,6519,1644,2022-01-01,zipcode,Beverly hills
ZCTA5 34470,12,20903,47098,1065,152300,17067,7756,14488,1483,4640,5200,2130,1035,9782,8807,975,8807,5010,3797,2022-01-01,zipcode,Ocala
ZCTA5 34471,12,26614,56382,1126,259000,21589,9602,18696,1256,5072,5814,3509,3045,12011,10884,1127,10884,6576,4308,2022-01-01,zipcode,Ocala
ZCTA5 34472,12,32528,55798,1132,168900,25983,11775,22205,3038,7793,7250,2557,1567,13526,12240,1286,12240,9477,2763,2022-01-01,zipcode,Ocala
ZCTA5 34473,12,22902,68253,1272,207500,18053,7541,16091,2075,5892,5370,1831,923,8756,7953,803,7953,6519,1434,2022-01-01,zipcode,Ocala
ZCTA5 34474,12,19380,58678,1400,168700,15609,6305,13839,1334,4170,4350,2774,1211,8871,7823,1048,7823,3543,4280,2022-01-01,zipcode,Ocala
ZCTA5 34475,12,15084,33817,849,157400,11716,6279,10004,1478,3999,3129,827,571,5597,4615,982,4615,2063,2552,2022-01-01,zipcode,Ocala
ZCTA5 34476,12,25106,62283,1247,234700,21531,12028,19732,1175,6633,6504,3186,2234,12397,11346,1051,11346,10355,991,2022-01-01,zipcode,Ocala
ZCTA5 34479,12,13502,54704,1189,176000,10731,4619,9229,1210,3858,2964,789,408,5964,5389,575,5389,3671,1718,2022-01-01,zipcode,Ocala
ZCTA5 34480,12,22956,71410,1059,237100,18432,6706,15220,1159,5015,5013,2970,1063,9667,8629,1038,8629,6483,2146,2022-01-01,zipcode,Ocala
ZCTA5 34481,12,24113,50822,1158,186800,23002,17686,21872,1517,6984,7200,3943,2228,13555,12644,911,12644,11536,1108,2022-01-01,zipcode,Ocala
ZCTA5 34482,12,22755,64491,861,216200,19616,12203,18186,2832,6880,4768,2468,1238,9543,7871,1672,7871,6613,1258,2022-01-01,zipcode,Ocala
ZCTA5 34484,12,5090,89563,-666666666,355700,4411,1586,3974,641,1216,1008,576,533,2768,2478,290,2478,1524,954,2022-01-01,zipcode,Oxford
ZCTA5 34488,12,11687,44047,1012,82300,9618,4589,8307,952,3178,2514,1241,422,6423,4967,1456,4967,3551,1416,2022-01-01,zipcode,Silver springs
ZCTA5 34491,12,32062,64546,1037,219400,27122,15617,25472,3162,9167,7810,3255,2078,15520,13941,1579,13941,12005,1936,2022-01-01,zipcode,Summerfield
ZCTA5 34498,12,629,49833,977,247700,514,342,475,13,200,111,90,61,531,302,229,302,246,56,2022-01-01,zipcode,Yankeetown
ZCTA5 34601,12,23054,49856,999,120400,19492,10283,17706,2386,6210,5731,2488,891,12210,10305,1905,10305,7281,3024,2022-01-01,zipcode,Brooksville
ZCTA5 34602,12,9024,73355,1103,235300,7431,3140,6736,678,2501,2043,925,589,3675,3198,477,3198,2855,343,2022-01-01,zipcode,Brooksville
ZCTA5 34604,12,13689,79316,1065,244000,11338,5454,9967,1198,3255,3571,1331,612,4830,4463,367,4463,3946,517,2022-01-01,zipcode,Brooksville
ZCTA5 34606,12,27795,52274,1128,201800,23985,13056,21672,2042,7578,7668,3075,1309,13961,12416,1545,12416,9486,2930,2022-01-01,zipcode,Spring hill
ZCTA5 34607,12,9061,58464,1241,304400,7871,3944,7026,425,1954,3033,998,616,4947,3876,1071,3876,3177,699,2022-01-01,zipcode,Spring hill
ZCTA5 34608,12,36398,58194,1169,208000,29763,14006,26548,3128,8692,9878,3223,1627,15256,14256,1000,14256,10929,3327,2022-01-01,zipcode,Spring hill
ZCTA5 34609,12,44696,71303,1358,244700,36712,16615,32360,3001,9730,12870,4541,2218,18086,16734,1352,16734,13638,3096,2022-01-01,zipcode,Spring hill
ZCTA5 34610,12,16620,67042,1178,229200,13150,4905,11637,1810,3632,3807,1942,446,6389,5820,569,5820,4562,1258,2022-01-01,zipcode,Spring hill
ZCTA5 34613,12,18071,53544,1133,154100,16007,9435,15139,1447,4943,5582,2264,903,10367,8480,1887,8480,7396,1084,2022-01-01,zipcode,Brooksville
ZCTA5 34614,12,8794,84875,-666666666,246700,7179,2898,5863,757,1402,2401,698,605,3233,2970,263,2970,2839,131,2022-01-01,zipcode,Brooksville
ZCTA5 34637,12,10784,111053,1531,360200,8308,4281,7111,448,1398,2047,1927,1291,3562,3242,320,3242,3003,239,2022-01-01,zipcode,Land o lakes
ZCTA5 34638,12,33183,113625,2054,341700,24879,7802,21661,1090,4967,6729,5805,3070,11488,10838,650,10838,8752,2086,2022-01-01,zipcode,Land o lakes
ZCTA5 34639,12,29953,98750,1700,327400,23790,7919,20438,1217,4773,6944,5190,2314,10867,10470,397,10470,8534,1936,2022-01-01,zipcode,Land o lakes
ZCTA5 34652,12,25335,48891,1133,169300,22023,10723,19683,2610,7638,5718,2588,1129,14584,11394,3190,11394,7035,4359,2022-01-01,zipcode,New port richey
ZCTA5 34653,12,35319,45795,1176,157800,30198,15691,27484,2556,11603,8538,3092,1695,17612,15409,2203,15409,10030,5379,2022-01-01,zipcode,New port richey
ZCTA5 34654,12,23727,61517,1404,222900,20267,9166,18050,2116,6784,5554,2133,1463,10203,8943,1260,8943,7009,1934,2022-01-01,zipcode,New port richey
ZCTA5 34655,12,45050,76050,1524,321700,37330,15848,33116,1893,8420,10690,7946,4167,20254,18505,1749,18505,14509,3996,2022-01-01,zipcode,New port richey
ZCTA5 34661,12,250,29132,-666666666,180100,216,128,216,36,110,51,19,0,255,153,102,153,83,70,2022-01-01,zipcode,Nobleton
ZCTA5 34667,12,29836,49334,1135,185800,26879,15592,25426,2653,10613,7388,2944,1828,19656,15065,4591,15065,11388,3677,2022-01-01,zipcode,Hudson
ZCTA5 34668,12,49271,43376,1186,142800,40626,20286,35131,4198,15601,10702,3259,1371,23807,20909,2898,20909,12925,7984,2022-01-01,zipcode,Port richey
ZCTA5 34669,12,14563,54698,1178,202100,11836,5717,10653,1162,4960,3059,1121,351,6551,5713,838,5713,4876,837,2022-01-01,zipcode,Hudson
ZCTA5 34677,12,22634,83034,1348,327100,18952,7526,16945,893,4438,4929,4086,2599,9943,8789,1154,8789,6799,1990,2022-01-01,zipcode,Oldsmar
ZCTA5 34679,12,144,33962,-666666666,-666666666,144,119,144,57,62,25,0,0,118,62,56,62,34,28,2022-01-01,zipcode,Aripeka
ZCTA5 34681,12,994,68000,-666666666,528300,785,276,734,36,122,246,259,71,561,452,109,452,407,45,2022-01-01,zipcode,Crystal beach
ZCTA5 34683,12,34031,85956,1442,372900,28506,10152,25786,1531,5713,8270,6741,3531,15602,13792,1810,13792,10935,2857,2022-01-01,zipcode,Palm harbor
ZCTA5 34684,12,27607,62541,1677,258300,24040,11737,22084,1045,6094,7478,4984,2483,14497,12988,1509,12988,9356,3632,2022-01-01,zipcode,Palm harbor
ZCTA5 34685,12,17869,88867,1665,444800,15093,6678,13625,596,2322,4181,4084,2442,7996,7499,497,7499,5634,1865,2022-01-01,zipcode,Palm harbor
ZCTA5 34688,12,9074,110893,1408,461000,7680,3345,6780,222,1357,1876,2060,1265,3614,3408,206,3408,3116,292,2022-01-01,zipcode,Tarpon springs
ZCTA5 34689,12,27076,62669,1048,284300,23895,11684,21834,1491,6553,6761,4705,2324,14056,12099,1957,12099,9638,2461,2022-01-01,zipcode,Tarpon springs
ZCTA5 34690,12,11876,42088,1161,116900,10284,4812,9369,1071,4644,2642,708,304,6953,5419,1534,5419,3344,2075,2022-01-01,zipcode,Holiday
ZCTA5 34691,12,19868,45110,1182,149100,16283,6931,14803,1340,6948,4369,1418,728,12304,9148,3156,9148,5771,3377,2022-01-01,zipcode,Holiday
ZCTA5 34695,12,17853,98494,1644,356200,14843,5642,13503,397,3249,3914,4066,1877,7931,7255,676,7255,6072,1183,2022-01-01,zipcode,Safety harbor
ZCTA5 34698,12,37838,63824,1385,289300,33886,16361,31419,1693,8615,10245,6355,4511,21949,18011,3938,18011,13206,4805,2022-01-01,zipcode,Dunedin
ZCTA5 34705,12,3306,65388,1004,213800,2592,1046,2104,415,719,660,254,56,1240,1131,109,1131,916,215,2022-01-01,zipcode,Astatula
ZCTA5 34711,12,66744,86419,1737,333600,54899,23636,47805,2591,11624,17449,10658,5483,27006,24526,2480,24526,18775,5751,2022-01-01,zipcode,Clermont
ZCTA5 34714,12,25047,75029,1517,291200,20107,6122,17116,975,4796,6306,3526,1513,10877,8755,2122,8755,4352,4403,2022-01-01,zipcode,Clermont
ZCTA5 34715,12,24484,83993,1828,371300,19029,7388,16851,1994,4883,5709,2656,1609,8346,7816,530,7816,5901,1915,2022-01-01,zipcode,Clermont
ZCTA5 34731,12,11911,55379,1103,163700,10100,4430,8975,677,4079,2664,879,676,6324,4866,1458,4866,4009,857,2022-01-01,zipcode,Fruitland park
ZCTA5 34734,12,4502,76017,1974,331400,3093,1041,2666,39,699,903,718,307,1322,1296,26,1296,1105,191,2022-01-01,zipcode,Gotha
ZCTA5 34736,12,26040,74530,1534,303800,20333,8232,17827,2262,4812,5424,3262,2067,10061,9402,659,9402,8393,1009,2022-01-01,zipcode,Groveland
ZCTA5 34737,12,3862,68348,1715,322600,3426,1397,3134,584,641,1030,604,275,1889,1733,156,1733,1552,181,2022-01-01,zipcode,Howey in the hills
ZCTA5 34739,12,782,-666666666,-666666666,174300,676,231,532,132,239,91,20,50,535,361,174,361,247,114,2022-01-01,zipcode,Kenansville
ZCTA5 34741,12,54464,42664,1451,250500,41839,14726,35185,5066,10656,11012,5996,2455,21036,17453,3583,17453,5934,11519,2022-01-01,zipcode,Kissimmee
ZCTA5 34743,12,43330,58871,1606,251500,35215,10419,29216,4265,9594,9565,4293,1499,13287,11942,1345,11942,8571,3371,2022-01-01,zipcode,Kissimmee
ZCTA5 34744,12,60995,63320,1297,291800,49545,16628,41888,6360,12259,12447,7403,3419,21521,19315,2206,19315,13090,6225,2022-01-01,zipcode,Kissimmee
ZCTA5 34746,12,53653,65167,1643,296600,42652,16198,36468,4930,9131,11762,6944,3701,24383,16338,8045,16338,11836,4502,2022-01-01,zipcode,Kissimmee
ZCTA5 34747,12,26021,81019,1710,418600,20625,6083,17738,680,3754,4968,5280,3056,21719,9430,12289,9430,5050,4380,2022-01-01,zipcode,Kissimmee
ZCTA5 34748,12,43915,50953,1077,203900,38348,23637,34950,3339,11844,12040,4694,3033,24579,20021,4558,20021,14642,5379,2022-01-01,zipcode,Leesburg
ZCTA5 34753,12,6985,64896,1227,234100,5132,1659,4339,1204,994,1505,476,160,2120,2069,51,2069,1516,553,2022-01-01,zipcode,Mascotte
ZCTA5 34756,12,4065,109327,1436,463400,3422,1326,2833,228,696,1005,639,265,1485,1391,94,1391,1085,306,2022-01-01,zipcode,Montverde
ZCTA5 34758,12,44793,62858,1607,243300,34775,11972,28650,3676,10665,9468,2985,1856,14110,11574,2536,11574,9052,2522,2022-01-01,zipcode,Kissimmee
ZCTA5 34759,12,39528,61644,1484,251700,32568,15890,27097,3845,6711,9624,4363,2554,16611,13627,2984,13627,10469,3158,2022-01-01,zipcode,Kissimmee
ZCTA5 34760,12,978,116429,1550,311100,840,310,773,32,219,372,105,45,330,310,20,310,264,46,2022-01-01,zipcode,Oakland
ZCTA5 34761,12,46233,86016,1720,318700,35621,10298,30653,5250,7247,9412,5947,2797,14613,14026,587,14026,9937,4089,2022-01-01,zipcode,Ocoee
ZCTA5 34762,12,319,66250,-666666666,-666666666,270,104,230,18,63,117,32,0,311,130,181,130,130,0,2022-01-01,zipcode,Okahumpka
ZCTA5 34769,12,29975,57378,1245,248700,23023,9038,19680,2317,7078,6164,2726,1395,11070,9250,1820,9250,6329,2921,2022-01-01,zipcode,Saint cloud
ZCTA5 34771,12,27537,95450,1644,399400,21667,7733,18133,1658,4599,5051,4673,2152,9840,8286,1554,8286,6922,1364,2022-01-01,zipcode,Saint cloud
ZCTA5 34772,12,32268,81169,1836,320800,25568,10417,21821,1496,6630,7676,4545,1474,10957,9661,1296,9661,7807,1854,2022-01-01,zipcode,Saint cloud
ZCTA5 34773,12,4647,71774,2030,297900,3291,1599,2853,400,651,938,526,338,1605,1384,221,1384,1205,179,2022-01-01,zipcode,Saint cloud
ZCTA5 34785,12,18487,42496,1080,139700,16028,10423,15062,2821,6378,3732,1539,592,6808,5831,977,5831,3677,2154,2022-01-01,zipcode,Wildwood
ZCTA5 34786,12,45914,120117,2238,578400,34666,11086,31175,929,3295,9060,11802,6089,17484,15251,2233,15251,10775,4476,2022-01-01,zipcode,Windermere
ZCTA5 34787,12,86913,108750,1783,440500,65024,19555,56807,4550,11039,14814,16330,10074,30303,28229,2074,28229,20346,7883,2022-01-01,zipcode,Winter garden
ZCTA5 34788,12,22414,53140,1327,154300,19359,9764,17713,1845,6837,5511,2250,1270,11197,9313,1884,9313,7638,1675,2022-01-01,zipcode,Leesburg
ZCTA5 34797,12,1304,123003,-666666666,478300,1139,705,1139,18,270,323,367,161,817,618,199,618,618,0,2022-01-01,zipcode,Yalaha
ZCTA5 34945,12,5608,66917,686,250800,4658,2973,4095,617,1258,1306,606,308,1874,1644,230,1644,1537,107,2022-01-01,zipcode,Fort pierce
ZCTA5 34946,12,5825,37511,895,107800,5101,2555,4371,1359,1450,1073,306,183,3261,2575,686,2575,1534,1041,2022-01-01,zipcode,Fort pierce
ZCTA5 34947,12,12992,39375,1019,181100,9559,4026,7707,1701,2278,2249,522,957,4741,4136,605,4136,1766,2370,2022-01-01,zipcode,Fort pierce
ZCTA5 34949,12,7993,83068,1313,381000,7815,4423,7388,346,1410,2190,1914,1528,8034,4441,3593,4441,3493,948,2022-01-01,zipcode,Fort pierce
ZCTA5 34950,12,17623,30451,1041,146800,14192,7399,11998,3966,3671,2669,1250,442,7873,6725,1148,6725,2458,4267,2022-01-01,zipcode,Fort pierce
ZCTA5 34951,12,16853,56870,1141,199400,14600,7181,13087,1453,4069,5066,1859,640,8301,7136,1165,7136,6036,1100,2022-01-01,zipcode,Fort pierce
ZCTA5 34952,12,41779,57387,1458,221400,35782,16385,32603,2966,10910,11377,5015,2335,21593,17495,4098,17495,12434,5061,2022-01-01,zipcode,Port saint lucie
ZCTA5 34953,12,78558,79777,1783,294200,62444,20916,53545,5560,16651,19533,8331,3470,26978,25550,1428,25550,22046,3504,2022-01-01,zipcode,Port saint lucie
ZCTA5 34956,12,9531,48138,819,119100,7432,3894,6229,1982,1875,1746,486,140,2789,2402,387,2402,1753,649,2022-01-01,zipcode,Indiantown
ZCTA5 34957,12,22523,68110,1448,347100,19988,10872,18399,1165,4553,5557,4437,2687,17093,10779,6314,10779,8126,2653,2022-01-01,zipcode,Jensen beach
ZCTA5 34972,12,19112,54315,1005,165400,15524,7997,13203,3086,4633,3266,1303,915,7101,6035,1066,6035,4082,1953,2022-01-01,zipcode,Okeechobee
ZCTA5 34974,12,23601,48462,942,150000,19516,10067,17599,2978,6627,5300,1974,720,13607,10225,3382,10225,8158,2067,2022-01-01,zipcode,Okeechobee
ZCTA5 34981,12,6703,77713,1288,340800,5105,1931,4453,255,1837,1253,524,584,1974,1844,130,1844,1037,807,2022-01-01,zipcode,Fort pierce
ZCTA5 34982,12,26727,52820,1162,212000,21970,9499,19163,2889,6751,6094,2410,1019,12177,10833,1344,10833,8001,2832,2022-01-01,zipcode,Fort pierce
ZCTA5 34983,12,45943,69031,1641,266300,36932,13599,32948,2613,10816,10568,6128,2823,17147,16114,1033,16114,13634,2480,2022-01-01,zipcode,Port saint lucie
ZCTA5 34984,12,18691,74976,1798,287300,14999,5561,13699,1791,3811,5127,2025,945,6975,6452,523,6452,5425,1027,2022-01-01,zipcode,Port saint lucie
ZCTA5 34986,12,29319,80350,1655,348600,25307,14248,22338,1700,6143,6676,4918,2901,14047,11871,2176,11871,9954,1917,2022-01-01,zipcode,Port saint lucie
ZCTA5 34987,12,14507,80065,1882,351700,12779,7454,11997,465,3107,3567,2881,1977,7128,6360,768,6360,5128,1232,2022-01-01,zipcode,Port saint lucie
ZCTA5 34990,12,30606,114842,1763,517100,25677,11319,23144,872,3787,7348,6973,4164,13688,12144,1544,12144,10818,1326,2022-01-01,zipcode,Palm city
ZCTA5 34994,12,17958,60815,1373,223900,15104,7146,13796,1129,3688,4652,2988,1339,9780,7762,2018,7762,4823,2939,2022-01-01,zipcode,Stuart
ZCTA5 34996,12,10755,82655,1283,394900,9874,5681,9403,348,1923,3022,2198,1912,8712,5620,3092,5620,4768,852,2022-01-01,zipcode,Stuart
ZCTA5 34997,12,45562,72963,1374,317300,39568,18627,35671,2828,10225,12468,6349,3801,21996,18841,3155,18841,15572,3269,2022-01-01,zipcode,Stuart
ZCTA5 35004,01,11737,76683,1254,205300,9340,3657,8536,513,3041,3015,1481,486,4661,4573,88,4573,3486,1087,2022-01-01,zipcode,Moody
ZCTA5 35005,01,8194,55017,1036,126000,6798,2718,6166,956,2567,1620,725,298,3386,2927,459,2927,2455,472,2022-01-01,zipcode,Adamsville
ZCTA5 35006,01,3391,63521,803,111400,2861,1268,2466,339,1285,719,68,55,1657,1232,425,1232,1140,92,2022-01-01,zipcode,Adger
ZCTA5 35007,01,27052,81351,1181,215500,21213,6711,18324,1530,4752,5141,4891,2010,10591,10062,529,10062,8393,1669,2022-01-01,zipcode,Alabaster
ZCTA5 35010,01,20406,46730,650,120000,16313,7683,14259,2712,4602,4393,1505,1047,10546,8149,2397,8149,5762,2387,2022-01-01,zipcode,Alexander city
ZCTA5 35013,01,97,-666666666,-666666666,-666666666,94,8,94,79,0,15,0,0,27,23,4,23,9,14,2022-01-01,zipcode,Allgood
ZCTA5 35014,01,3317,58250,-666666666,107900,2952,1249,2593,628,853,778,212,122,1761,1483,278,1483,1356,127,2022-01-01,zipcode,Alpine
ZCTA5 35016,01,17532,55440,718,172600,13776,6227,11872,1277,3841,4277,1714,763,7391,6712,679,6712,4965,1747,2022-01-01,zipcode,Arab
ZCTA5 35019,01,2233,58518,698,120700,1827,645,1532,228,556,592,127,29,1026,949,77,949,738,211,2022-01-01,zipcode,Baileyton
ZCTA5 35020,01,25713,31257,828,87000,19935,9855,17469,3064,7207,5370,1268,560,12290,10049,2241,10049,5502,4547,2022-01-01,zipcode,Bessemer
ZCTA5 35022,01,23237,74951,999,227400,18789,7217,16602,1112,4339,5663,3163,2325,10030,9188,842,9188,7479,1709,2022-01-01,zipcode,Bessemer
ZCTA5 35023,01,25335,67141,1138,143000,19928,8052,17510,1889,6372,5791,2482,976,9892,8600,1292,8600,6775,1825,2022-01-01,zipcode,Bessemer
ZCTA5 35031,01,7274,55583,682,131600,5849,2574,5007,873,1620,1662,419,433,3166,2613,553,2613,1976,637,2022-01-01,zipcode,Blountsville
ZCTA5 35032,01,39,-666666666,-666666666,69000,32,23,26,14,12,0,0,0,26,17,9,17,13,4,2022-01-01,zipcode,Bon air
ZCTA5 35033,01,3297,47896,1042,136400,2545,1134,2271,408,764,782,183,134,1619,1307,312,1307,1178,129,2022-01-01,zipcode,Bremen
ZCTA5 35034,01,5327,39474,834,125000,4138,2912,3676,1121,1542,623,172,218,1660,1422,238,1422,1002,420,2022-01-01,zipcode,Brent
ZCTA5 35035,01,818,-666666666,-666666666,-666666666,674,274,550,120,213,160,42,15,451,451,0,451,329,122,2022-01-01,zipcode,Brierfield
ZCTA5 35036,01,110,-666666666,-666666666,-666666666,110,110,69,11,48,10,0,0,73,69,4,69,11,58,2022-01-01,zipcode,Brookside
ZCTA5 35040,01,18464,72474,1487,183700,13950,3743,11935,862,2999,4109,2778,1187,7468,6876,592,6876,5506,1370,2022-01-01,zipcode,Calera
ZCTA5 35042,01,6127,52209,470,128300,5315,2406,4839,793,1984,1416,284,362,2725,2204,521,2204,1734,470,2022-01-01,zipcode,Centreville
ZCTA5 35043,01,14564,106660,1348,301200,11010,4151,9600,285,1904,3207,3105,1099,4861,4631,230,4631,4153,478,2022-01-01,zipcode,Chelsea
ZCTA5 35044,01,8389,44964,789,107000,7071,3483,5836,1104,2069,2093,291,279,3932,3494,438,3494,2350,1144,2022-01-01,zipcode,Childersburg
ZCTA5 35045,01,14496,61822,888,179500,11354,5145,10125,1348,4036,2874,901,966,6254,5704,550,5704,3870,1834,2022-01-01,zipcode,Clanton
ZCTA5 35046,01,5172,66371,693,136300,3940,1627,3353,590,1418,919,264,162,2572,1910,662,1910,1537,373,2022-01-01,zipcode,Clanton
ZCTA5 35049,01,4001,52879,924,169100,3136,1094,2688,447,1230,732,167,112,1723,1552,171,1552,1105,447,2022-01-01,zipcode,Cleveland
ZCTA5 35051,01,9879,65563,830,230000,8051,3767,7003,1097,2696,1844,862,504,3542,3292,250,3292,2608,684,2022-01-01,zipcode,Columbiana
ZCTA5 35052,01,257,-666666666,-666666666,-666666666,257,257,257,65,83,52,12,45,24,24,0,24,0,24,2022-01-01,zipcode,Cook springs
ZCTA5 35053,01,3073,61324,932,231800,2343,1214,2228,257,670,764,386,151,2398,1146,1252,1146,1098,48,2022-01-01,zipcode,Crane hill
ZCTA5 35054,01,4649,83315,1311,259000,3690,1542,3103,369,940,1063,402,329,2076,1742,334,1742,1559,183,2022-01-01,zipcode,Cropwell
ZCTA5 35055,01,22521,56769,851,185300,18373,7796,15893,1877,4220,5412,2991,1393,10532,9406,1126,9406,6149,3257,2022-01-01,zipcode,Cullman
ZCTA5 35057,01,15058,73669,856,174700,11916,4318,10150,1527,3280,3650,988,705,6139,5213,926,5213,4316,897,2022-01-01,zipcode,Cullman
ZCTA5 35058,01,10555,58631,874,170100,8590,3076,7577,1190,2778,2499,749,361,4446,3973,473,3973,2960,1013,2022-01-01,zipcode,Cullman
ZCTA5 35060,01,296,-666666666,-666666666,109000,247,67,220,0,111,92,0,17,243,156,87,156,156,0,2022-01-01,zipcode,Docena
ZCTA5 35061,01,1389,59010,1219,172000,1236,473,1049,40,462,409,104,34,587,417,170,417,256,161,2022-01-01,zipcode,Dolomite
ZCTA5 35062,01,8623,64669,725,177700,7060,3269,6150,814,2278,1940,853,265,3699,3235,464,3235,2666,569,2022-01-01,zipcode,Dora
ZCTA5 35063,01,3408,53750,888,85300,2827,1266,2450,522,980,819,83,46,1641,1264,377,1264,1112,152,2022-01-01,zipcode,Empire
ZCTA5 35064,01,9995,45685,998,116500,7907,3583,6195,283,2494,1989,985,444,4858,3792,1066,3792,2139,1653,2022-01-01,zipcode,Fairfield
ZCTA5 35068,01,8016,74066,1104,182900,6292,2153,5600,586,1468,1891,882,773,3704,3564,140,3564,2642,922,2022-01-01,zipcode,Fultondale
ZCTA5 35070,01,122,64196,-666666666,132300,113,81,113,13,48,36,16,0,47,47,0,47,47,0,2022-01-01,zipcode,Garden city
ZCTA5 35071,01,17459,78914,1161,228100,13676,5023,11919,988,3647,3680,2289,1315,7277,6836,441,6836,5231,1605,2022-01-01,zipcode,Gardendale
ZCTA5 35072,01,4508,49464,593,99700,3436,1850,3137,498,1291,871,355,122,2369,1710,659,1710,1363,347,2022-01-01,zipcode,Goodwater
ZCTA5 35073,01,2898,49960,811,110300,2528,974,2209,414,681,684,317,113,1489,1277,212,1277,863,414,2022-01-01,zipcode,Graysville
ZCTA5 35074,01,112,-666666666,-666666666,-666666666,112,0,112,53,0,59,0,0,59,59,0,59,0,59,2022-01-01,zipcode,Green pond
ZCTA5 35077,01,13789,46624,821,144000,11506,5411,10010,2118,3439,3153,755,545,6204,5422,782,5422,3889,1533,2022-01-01,zipcode,Hanceville
ZCTA5 35078,01,2089,71348,778,190500,1650,629,1486,167,443,595,196,85,1027,833,194,833,693,140,2022-01-01,zipcode,Harpersville
ZCTA5 35079,01,9301,73040,893,173500,7522,3228,6405,848,2417,2079,768,293,3681,3217,464,3217,2935,282,2022-01-01,zipcode,Hayden
ZCTA5 35080,01,19561,106660,1483,256100,14716,4327,12589,473,2231,3910,4085,1890,7123,6656,467,6656,6065,591,2022-01-01,zipcode,Helena
ZCTA5 35082,01,0,-666666666,-666666666,-666666666,0,0,0,0,0,0,0,0,0,0,0,0,0,0,2022-01-01,zipcode,Hollins
ZCTA5 35083,01,3922,46146,873,148100,3057,1133,2620,630,832,899,160,99,1494,1397,97,1397,1180,217,2022-01-01,zipcode,Holly pond
ZCTA5 35085,01,9246,66771,846,113900,7435,2831,6053,1448,2627,1190,509,279,3752,3327,425,3327,2738,589,2022-01-01,zipcode,Jemison
ZCTA5 35087,01,2923,60197,903,151600,2306,801,2029,230,442,941,268,148,1102,1102,0,1102,976,126,2022-01-01,zipcode,Joppa
ZCTA5 35089,01,1697,56696,743,93700,1600,742,1375,201,754,372,18,30,799,681,118,681,594,87,2022-01-01,zipcode,Kellyton
ZCTA5 35091,01,3407,106953,1042,263900,2563,691,2286,143,401,1041,330,371,1488,1222,266,1222,1149,73,2022-01-01,zipcode,Kimberly
ZCTA5 35094,01,15406,69548,967,202100,12217,4324,10939,1431,2823,3676,1901,1108,6695,5834,861,5834,4549,1285,2022-01-01,zipcode,Leeds
ZCTA5 35096,01,8586,70780,1002,169600,6775,2644,5820,792,2033,1946,704,345,3866,3148,718,3148,2765,383,2022-01-01,zipcode,Lincoln
ZCTA5 35097,01,1930,72917,1026,124700,1664,791,1451,420,488,381,109,53,871,780,91,780,716,64,2022-01-01,zipcode,Locust fork
ZCTA5 35098,01,1161,60670,739,106700,920,426,763,121,176,385,81,0,582,481,101,481,307,174,2022-01-01,zipcode,Logan
ZCTA5 35111,01,19418,81162,1241,244600,15692,5968,13286,1004,3625,4670,2604,1383,7476,7089,387,7089,6535,554,2022-01-01,zipcode,Mc calla
ZCTA5 35112,01,0,-666666666,-666666666,-666666666,0,0,0,0,0,0,0,0,51,0,51,0,0,0,2022-01-01,zipcode,Margaret
ZCTA5 35114,01,8548,94778,1220,260600,6628,2160,5554,156,1050,1848,1449,1051,3023,2921,102,2921,2572,349,2022-01-01,zipcode,Alabaster
ZCTA5 35115,01,16709,54746,845,155700,13438,5429,10028,1703,3047,2953,1720,605,6237,5764,473,5764,4133,1631,2022-01-01,zipcode,Montevallo
ZCTA5 35116,01,5218,85208,1049,206300,4037,1445,3653,306,1062,1282,733,270,2114,1953,161,1953,1787,166,2022-01-01,zipcode,Morris
ZCTA5 35117,01,6002,94907,1152,195400,4896,1773,4122,309,1179,1711,688,235,2594,2288,306,2288,2187,101,2022-01-01,zipcode,Mount olive
ZCTA5 35118,01,3052,67792,924,143100,2352,1098,2014,218,861,667,171,97,1220,1021,199,1021,816,205,2022-01-01,zipcode,Mulga
ZCTA5 35119,01,0,-666666666,-666666666,-666666666,0,0,0,0,0,0,0,0,0,0,0,0,0,0,2022-01-01,zipcode,New castle
ZCTA5 35120,01,17943,73186,909,180900,13656,4712,11730,1568,4545,3685,1234,698,6810,6289,521,6289,5257,1032,2022-01-01,zipcode,Odenville
ZCTA5 35121,01,16591,51098,703,149400,13264,6895,11448,2577,3499,3538,1128,706,6934,6203,731,6203,4371,1832,2022-01-01,zipcode,Oneonta
ZCTA5 35124,01,24408,91836,1354,263700,19517,5957,17336,884,3272,4871,5088,3221,9581,9286,295,9286,7822,1464,2022-01-01,zipcode,Pelham
ZCTA5 35125,01,10759,61865,1009,173800,8589,3513,7181,1249,2733,2061,785,353,4519,4017,502,4017,2707,1310,2022-01-01,zipcode,Pell city
ZCTA5 35126,01,21612,79723,1095,174600,17411,6053,14736,1355,5323,5470,1992,596,8340,7606,734,7606,6757,849,2022-01-01,zipcode,Pinson
ZCTA5 35127,01,9549,72917,1183,173100,8272,3185,6708,492,1601,3100,940,575,3877,3553,324,3553,2744,809,2022-01-01,zipcode,Pleasant grove
ZCTA5 35128,01,10264,79226,1172,219600,8440,3034,7503,749,2498,2667,1133,456,4511,4009,502,4009,3302,707,2022-01-01,zipcode,Pell city
ZCTA5 35130,01,3171,46000,535,108300,2682,1610,2351,402,1051,721,94,83,1885,1394,491,1394,1133,261,2022-01-01,zipcode,Quinton
ZCTA5 35131,01,3373,42639,746,94600,2779,1445,2494,431,974,627,378,84,1833,1406,427,1406,1144,262,2022-01-01,zipcode,Ragland
ZCTA5 35133,01,2922,56853,796,165000,2378,1124,2211,355,763,895,121,77,1414,1175,239,1175,1064,111,2022-01-01,zipcode,Remlap
ZCTA5 35135,01,1917,56250,1130,251000,1555,615,1387,277,532,273,216,89,855,775,80,775,603,172,2022-01-01,zipcode,Riverside
ZCTA5 35136,01,2009,55221,365,125800,1722,1030,1527,159,582,571,186,29,1238,788,450,788,663,125,2022-01-01,zipcode,Rockford
ZCTA5 35143,01,3122,73788,766,218500,2741,1266,2363,193,848,754,514,54,2029,1296,733,1296,1099,197,2022-01-01,zipcode,Shelby
ZCTA5 35146,01,12908,79200,679,245400,10871,5291,9235,1162,3051,2851,1496,675,4480,4190,290,4190,3635,555,2022-01-01,zipcode,Springville
ZCTA5 35147,01,6465,87788,1594,277200,5090,1576,4307,304,768,1405,1304,526,2377,2274,103,2274,2035,239,2022-01-01,zipcode,Sterrett
ZCTA5 35148,01,2418,52991,638,129900,2083,916,1828,303,624,728,98,75,1212,979,233,979,683,296,2022-01-01,zipcode,Sumiton
ZCTA5 35149,01,77,-666666666,-666666666,-666666666,77,0,77,0,77,0,0,0,77,77,0,77,77,0,2022-01-01,zipcode,Sycamore
ZCTA5 35150,01,17283,41240,707,138300,13495,6303,12016,1909,4321,4200,941,645,8362,7233,1129,7233,4207,3026,2022-01-01,zipcode,Sylacauga
ZCTA5 35151,01,7289,59489,960,146300,5992,2513,5483,768,1716,1694,851,454,3553,2914,639,2914,2562,352,2022-01-01,zipcode,Sylacauga
ZCTA5 35160,01,26649,44852,707,124300,22423,12007,19212,3906,6966,5402,1863,1075,12959,10398,2561,10398,6759,3639,2022-01-01,zipcode,Talladega
ZCTA5 35171,01,3642,66651,-666666666,177100,2979,1551,2638,529,840,900,257,112,1413,1332,81,1332,1036,296,2022-01-01,zipcode,Thorsby
ZCTA5 35172,01,2842,43125,799,97500,2367,1059,2078,276,1089,610,100,3,1248,1069,179,1069,794,275,2022-01-01,zipcode,Trafford
ZCTA5 35173,01,31103,114483,1200,311000,24711,8256,21278,1063,4738,6462,5931,3084,11572,11027,545,11027,9909,1118,2022-01-01,zipcode,Trussville
ZCTA5 35175,01,4986,69419,856,164100,4117,1917,3637,372,1323,1076,476,390,2321,2077,244,2077,1748,329,2022-01-01,zipcode,Union grove
ZCTA5 35176,01,798,28029,817,104300,678,353,625,219,211,130,17,48,357,357,0,357,244,113,2022-01-01,zipcode,Vandiver
ZCTA5 35178,01,2632,36065,821,134700,2176,1133,1968,272,1040,391,177,88,1544,1176,368,1176,969,207,2022-01-01,zipcode,Vincent
ZCTA5 35179,01,8835,62434,800,168300,7260,3372,5889,822,2004,2062,705,296,3610,3042,568,3042,2633,409,2022-01-01,zipcode,Vinemont
ZCTA5 35180,01,14418,74234,860,183300,11137,4877,9455,956,3527,3516,1026,430,5481,4960,521,4960,4163,797,2022-01-01,zipcode,Warrior
ZCTA5 35183,01,1101,71488,-666666666,117000,1036,576,993,226,464,268,9,26,467,365,102,365,297,68,2022-01-01,zipcode,Weogufka
ZCTA5 35184,01,6153,44172,829,105200,4769,2272,4073,810,1892,1153,182,36,2509,1963,546,1963,1516,447,2022-01-01,zipcode,West blocton
ZCTA5 35186,01,5189,89143,1055,272000,4175,1728,3692,336,1013,1304,750,289,2124,1994,130,1994,1669,325,2022-01-01,zipcode,Wilsonville
ZCTA5 35188,01,2701,65996,916,180300,2055,852,1774,293,759,568,106,48,964,775,189,775,682,93,2022-01-01,zipcode,Woodstock
ZCTA5 35203,01,3157,42596,729,284800,2917,1620,2633,480,834,360,490,469,1924,1542,382,1542,381,1161,2022-01-01,zipcode,Birmingham
ZCTA5 35204,01,9343,30414,718,80000,7840,4240,6687,1189,2881,1734,564,319,5411,4140,1271,4140,1774,2366,2022-01-01,zipcode,Birmingham
ZCTA5 35205,01,19047,48681,978,268900,17842,6806,12325,547,1555,3222,3687,3314,11781,9309,2472,9309,2857,6452,2022-01-01,zipcode,Birmingham
ZCTA5 35206,01,16477,38671,966,110700,13670,6011,12107,1750,4428,3974,1360,595,8033,6464,1569,6464,3091,3373,2022-01-01,zipcode,Birmingham
ZCTA5 35207,01,6820,27939,743,71700,5468,2947,4766,1097,1485,1587,364,233,3961,3152,809,3152,1753,1399,2022-01-01,zipcode,Birmingham
ZCTA5 35208,01,14629,34669,938,86100,11798,6192,10096,1234,3792,3443,1204,423,7484,5851,1633,5851,3608,2243,2022-01-01,zipcode,Birmingham
ZCTA5 35209,01,29884,74742,1186,436100,23057,6025,18682,776,2459,3682,6559,5206,15134,12520,2614,12520,6455,6065,2022-01-01,zipcode,Birmingham
ZCTA5 35210,01,13230,70902,1094,205400,11581,4354,10613,643,2640,2914,2642,1774,6859,5919,940,5919,4262,1657,2022-01-01,zipcode,Birmingham
ZCTA5 35211,01,24795,32677,969,89100,19510,8298,16449,2089,5027,5833,2427,1073,14143,11127,3016,11127,4630,6497,2022-01-01,zipcode,Birmingham
ZCTA5 35212,01,10136,28216,688,183000,7130,2621,6467,837,1797,1665,1221,947,5339,4205,1134,4205,1779,2426,2022-01-01,zipcode,Birmingham
ZCTA5 35213,01,15551,137879,1687,664500,12101,3565,10575,63,312,998,5047,4155,6583,6328,255,6328,4902,1426,2022-01-01,zipcode,Birmingham
ZCTA5 35214,01,17507,55703,874,144400,15212,6657,13296,1248,3929,4311,2549,1259,8224,7007,1217,7007,4669,2338,2022-01-01,zipcode,Birmingham
ZCTA5 35215,01,46738,47975,1031,134700,34299,13273,28618,3661,9985,9652,3542,1778,19665,16989,2676,16989,9338,7651,2022-01-01,zipcode,Birmingham
ZCTA5 35216,01,38352,68237,1257,353600,29458,8981,24747,1312,3779,6615,8102,4939,16836,15547,1289,15547,8620,6927,2022-01-01,zipcode,Birmingham
ZCTA5 35217,01,12630,37220,874,106200,10294,4580,8786,1688,3117,3041,577,363,6196,5213,983,5213,2460,2753,2022-01-01,zipcode,Birmingham
ZCTA5 35218,01,6962,32095,883,74700,5701,2941,4958,904,1578,2082,251,143,3447,2586,861,2586,1070,1516,2022-01-01,zipcode,Birmingham
ZCTA5 35221,01,3034,33660,968,71400,2657,1579,2386,498,639,968,233,48,2273,1399,874,1399,887,512,2022-01-01,zipcode,Birmingham
ZCTA5 35222,01,8387,77500,948,367300,6924,2100,6230,370,829,1218,1860,1953,4234,3640,594,3640,2111,1529,2022-01-01,zipcode,Birmingham
ZCTA5 35223,01,11226,151550,1746,697200,8864,3678,8003,58,370,1128,3478,2969,4720,4361,359,4361,3878,483,2022-01-01,zipcode,Birmingham
ZCTA5 35224,01,5483,43551,977,78500,4180,1792,3526,377,1510,1315,236,88,2758,1978,780,1978,1093,885,2022-01-01,zipcode,Birmingham
ZCTA5 35226,01,38079,121975,1455,366300,29457,8715,26086,668,2147,5499,9522,8250,15109,14378,731,14378,11561,2817,2022-01-01,zipcode,Birmingham
ZCTA5 35228,01,10016,46114,978,79900,7871,3277,6809,950,2538,2017,979,325,4334,3688,646,3688,2255,1433,2022-01-01,zipcode,Birmingham
ZCTA5 35229,01,2514,-666666666,-666666666,-666666666,2514,1679,5,0,0,5,0,0,0,0,0,0,0,0,2022-01-01,zipcode,Birmingham
ZCTA5 35233,01,2787,57740,1548,322600,2748,626,1709,26,105,73,361,1144,2268,1880,388,1880,210,1670,2022-01-01,zipcode,Birmingham
ZCTA5 35234,01,4195,23273,723,67400,3701,2210,3488,763,1367,1035,278,45,2478,1713,765,1713,938,775,2022-01-01,zipcode,Birmingham
ZCTA5 35235,01,20043,59476,1171,145300,15670,5852,13546,900,3654,5081,2613,1298,8930,8058,872,8058,5194,2864,2022-01-01,zipcode,Birmingham
ZCTA5 35242,01,56466,115541,1368,433800,47150,16376,40485,1465,4424,8571,16174,9851,24835,23290,1545,23290,17107,6183,2022-01-01,zipcode,Birmingham
ZCTA5 35243,01,18575,102163,1478,458000,15377,5172,13631,211,1500,2406,5394,4120,10226,8927,1299,8927,5094,3833,2022-01-01,zipcode,Birmingham
ZCTA5 35244,01,36783,106338,1381,357000,29037,8836,25354,832,3404,6247,8245,6626,15155,14198,957,14198,9912,4286,2022-01-01,zipcode,Birmingham
ZCTA5 35254,01,1795,-666666666,-666666666,-666666666,1795,1309,0,0,0,0,0,0,0,0,0,0,0,0,2022-01-01,zipcode,Birmingham
ZCTA5 35401,01,39168,27497,885,132400,34882,18596,17364,2538,5853,4400,2718,1855,19315,12671,6644,12671,4144,8527,2022-01-01,zipcode,Tuscaloosa
ZCTA5 35404,01,23373,44676,974,182400,18994,6842,12992,1384,4325,3957,1925,1401,11305,8343,2962,8343,4073,4270,2022-01-01,zipcode,Tuscaloosa
ZCTA5 35405,01,49196,60210,1030,214200,40196,13134,33203,2526,10068,10383,6379,3847,22266,19758,2508,19758,10558,9200,2022-01-01,zipcode,Tuscaloosa
ZCTA5 35406,01,19062,117945,1320,438500,15195,5642,12989,345,1079,2538,4499,4528,8436,7625,811,7625,5792,1833,2022-01-01,zipcode,Tuscaloosa
ZCTA5 35441,01,907,50714,-666666666,73500,726,316,652,97,262,196,45,52,820,332,488,332,317,15,2022-01-01,zipcode,Akron
ZCTA5 35442,01,5450,30509,601,113000,4486,2906,4119,909,1484,1155,349,222,2076,1666,410,1666,900,766,2022-01-01,zipcode,Aliceville
ZCTA5 35443,01,1359,23438,441,53700,1250,761,1192,125,658,325,17,67,1013,513,500,513,410,103,2022-01-01,zipcode,Boligee
ZCTA5 35444,01,4012,58750,856,163000,3394,1281,2931,374,1050,1078,352,77,1807,1574,233,1574,1258,316,2022-01-01,zipcode,Brookwood
ZCTA5 35446,01,2162,50357,783,-666666666,1708,753,1464,262,593,459,125,25,749,738,11,738,617,121,2022-01-01,zipcode,Buhl
ZCTA5 35447,01,3025,40184,596,137500,2650,1459,2371,311,1137,636,175,112,1707,1279,428,1279,975,304,2022-01-01,zipcode,Carrollton
ZCTA5 35452,01,4018,61422,1259,171300,3342,1413,2740,320,939,1041,319,121,1720,1547,173,1547,1355,192,2022-01-01,zipcode,Coker
ZCTA5 35453,01,12130,69949,881,164400,9509,3316,8209,954,3352,2500,802,601,4991,4348,643,4348,3660,688,2022-01-01,zipcode,Cottondale
ZCTA5 35456,01,4639,51325,969,169300,3672,1484,2942,445,1209,1017,128,143,2054,1707,347,1707,1152,555,2022-01-01,zipcode,Duncanville
ZCTA5 35457,01,51,-666666666,-666666666,-666666666,51,0,51,0,51,0,0,0,51,51,0,51,51,0,2022-01-01,zipcode,Echola
ZCTA5 35458,01,912,-666666666,-666666666,-666666666,678,260,451,75,51,167,0,158,276,228,48,228,184,44,2022-01-01,zipcode,Elrod
ZCTA5 35459,01,761,31354,717,-666666666,694,421,527,134,238,99,22,34,457,347,110,347,269,78,2022-01-01,zipcode,Emelle
ZCTA5 35460,01,839,27727,-666666666,118200,715,490,568,19,209,240,100,0,474,414,60,414,366,48,2022-01-01,zipcode,Epes
ZCTA5 35461,01,2006,60461,1138,178000,1727,794,1497,158,602,463,156,118,1078,856,222,856,822,34,2022-01-01,zipcode,Ethelsville
ZCTA5 35462,01,4234,32973,726,99000,3230,1841,3107,716,845,901,413,232,2328,1765,563,1765,1229,536,2022-01-01,zipcode,Eutaw
ZCTA5 35463,01,2130,75559,-666666666,196500,1777,618,1465,238,559,457,143,68,878,699,179,699,637,62,2022-01-01,zipcode,Fosters
ZCTA5 35464,01,563,14722,491,-666666666,440,294,282,26,98,104,54,0,257,166,91,166,63,103,2022-01-01,zipcode,Gainesville
ZCTA5 35466,01,5513,59535,647,110100,4391,1951,3529,388,1242,1229,399,271,2444,2046,398,2046,1748,298,2022-01-01,zipcode,Gordo
ZCTA5 35469,01,271,60182,-666666666,57600,185,121,161,0,12,84,61,4,126,126,0,126,102,24,2022-01-01,zipcode,Knoxville
ZCTA5 35470,01,5045,27441,811,144200,4154,2142,2261,165,657,675,369,395,1880,1482,398,1482,886,596,2022-01-01,zipcode,Livingston
ZCTA5 35473,01,19844,70047,893,232500,15467,5150,12418,1183,2733,3797,3027,1678,8481,8060,421,8060,5109,2951,2022-01-01,zipcode,Northport
ZCTA5 35474,01,8344,73293,857,171800,6681,2152,5096,777,1645,1299,654,721,2943,2578,365,2578,2267,311,2022-01-01,zipcode,Moundville
ZCTA5 35475,01,18908,98313,832,279000,14818,5101,12677,536,3599,4460,2545,1537,7378,6697,681,6697,6217,480,2022-01-01,zipcode,Northport
ZCTA5 35476,01,8240,60347,920,178200,6627,2349,5714,623,1718,2029,827,517,3464,3112,352,3112,1121,1991,2022-01-01,zipcode,Northport
ZCTA5 35477,01,114,-666666666,-666666666,-666666666,47,16,47,0,29,14,4,0,50,32,18,32,32,0,2022-01-01,zipcode,Panola
ZCTA5 35480,01,1828,100000,-666666666,229200,1429,578,992,110,302,391,166,23,584,490,94,490,472,18,2022-01-01,zipcode,Ralph
ZCTA5 35481,01,3171,43950,436,93600,2623,1325,2135,293,1001,641,122,78,1523,1319,204,1319,856,463,2022-01-01,zipcode,Reform
ZCTA5 35490,01,4947,73190,876,165800,4078,1366,3122,510,1252,977,295,88,1893,1652,241,1652,1359,293,2022-01-01,zipcode,Vance
ZCTA5 35501,01,10126,52927,680,164100,7815,3454,6527,996,2128,2320,571,512,4426,3471,955,3471,2171,1300,2022-01-01,zipcode,Jasper
ZCTA5 35503,01,10070,58924,711,150200,8068,3552,7329,1053,2323,2576,969,408,4640,3901,739,3901,3248,653,2022-01-01,zipcode,Jasper
ZCTA5 35504,01,12942,67514,766,174400,10159,4519,8896,1246,2580,2891,1395,784,5730,4961,769,4961,3866,1095,2022-01-01,zipcode,Jasper
ZCTA5 35540,01,2228,47230,608,106200,1635,652,1493,141,693,488,129,42,1095,894,201,894,729,165,2022-01-01,zipcode,Addison
ZCTA5 35541,01,4141,42111,856,164300,3440,1859,3020,517,1045,907,342,209,2621,1555,1066,1555,1266,289,2022-01-01,zipcode,Arley
ZCTA5 35542,01,819,32356,-666666666,87900,663,379,559,81,172,260,44,2,431,373,58,373,354,19,2022-01-01,zipcode,Bankston
ZCTA5 35543,01,1264,26250,609,102400,989,565,802,336,243,148,58,17,604,490,114,490,352,138,2022-01-01,zipcode,Bear creek
ZCTA5 35544,01,991,51270,843,-666666666,946,495,931,245,235,264,137,50,441,407,34,407,295,112,2022-01-01,zipcode,Beaverton
ZCTA5 35545,01,133,52917,-666666666,120000,110,51,95,20,28,42,3,2,48,45,3,45,32,13,2022-01-01,zipcode,Belk
ZCTA5 35546,01,4065,59604,578,118700,3040,1341,2583,373,1160,779,167,104,1706,1369,337,1369,1156,213,2022-01-01,zipcode,Berry
ZCTA5 35548,01,1963,45682,402,81400,1618,745,1398,366,428,459,119,26,928,792,136,792,622,170,2022-01-01,zipcode,Brilliant
ZCTA5 35549,01,3128,43061,534,59600,2616,1293,2266,468,786,909,51,52,1813,1359,454,1359,1064,295,2022-01-01,zipcode,Carbon hill
ZCTA5 35550,01,5288,44516,448,89000,4291,2333,3792,650,1430,1253,278,181,2430,1974,456,1974,1569,405,2022-01-01,zipcode,Cordova
ZCTA5 35552,01,1230,63405,383,83800,1009,297,794,72,313,235,146,28,524,413,111,413,354,59,2022-01-01,zipcode,Detroit
ZCTA5 35553,01,4831,41938,539,80900,3902,1805,3194,691,1422,701,183,197,2333,1823,510,1823,1435,388,2022-01-01,zipcode,Double springs
ZCTA5 35554,01,1246,37388,643,68500,983,476,823,159,298,283,78,5,639,490,149,490,394,96,2022-01-01,zipcode,Eldridge
ZCTA5 35555,01,9953,45787,609,125600,8292,3983,7076,1025,2739,2167,685,460,4935,3698,1237,3698,2520,1178,2022-01-01,zipcode,Fayette
ZCTA5 35559,01,85,25909,-666666666,-666666666,83,18,72,4,57,11,0,0,18,18,0,18,7,11,2022-01-01,zipcode,Glen allen
ZCTA5 35563,01,3733,47095,548,101700,3018,1412,2501,256,965,1016,194,70,1908,1378,530,1378,1040,338,2022-01-01,zipcode,Guin
ZCTA5 35564,01,2090,36929,561,106400,1657,870,1424,277,450,587,82,28,1068,856,212,856,643,213,2022-01-01,zipcode,Hackleburg
ZCTA5 35565,01,10966,48558,671,86500,8952,4403,8076,1908,3208,2153,382,425,5681,4228,1453,4228,3120,1108,2022-01-01,zipcode,Haleyville
ZCTA5 35570,01,10775,52454,571,113700,9157,4868,7791,1591,2895,2225,648,432,5154,4035,1119,4035,2723,1312,2022-01-01,zipcode,Hamilton
ZCTA5 35571,01,772,48977,575,86700,551,269,465,55,225,139,30,16,402,281,121,281,248,33,2022-01-01,zipcode,Hodges
ZCTA5 35572,01,1448,65674,-666666666,312200,1363,654,1203,281,598,180,101,43,1168,652,516,652,634,18,2022-01-01,zipcode,Houston
ZCTA5 35574,01,1346,52386,538,139400,1103,512,1088,176,549,289,36,38,715,559,156,559,486,73,2022-01-01,zipcode,Kennedy
ZCTA5 35575,01,1090,47759,767,76700,869,445,792,133,274,289,45,51,581,440,141,440,360,80,2022-01-01,zipcode,Lynn
ZCTA5 35576,01,3517,64155,520,111900,2781,1160,2435,310,1039,833,174,79,1705,1223,482,1223,1063,160,2022-01-01,zipcode,Millport
ZCTA5 35577,01,4,-666666666,-666666666,-666666666,4,4,4,0,2,2,0,0,4,2,2,2,2,0,2022-01-01,zipcode,Natural bridge
ZCTA5 35578,01,5029,49500,1004,97500,4114,1977,3315,463,1426,1025,221,180,2337,2006,331,2006,1741,265,2022-01-01,zipcode,Nauvoo
ZCTA5 35579,01,3552,43693,544,102100,2937,1763,2672,545,1228,693,170,36,1604,1383,221,1383,1157,226,2022-01-01,zipcode,Oakman
ZCTA5 35580,01,3748,55875,685,102400,3014,1389,2770,678,1046,715,212,119,1834,1364,470,1364,1199,165,2022-01-01,zipcode,Parrish
ZCTA5 35581,01,5904,48025,676,109700,4559,2185,3834,773,1376,1226,286,173,2379,1935,444,1935,1486,449,2022-01-01,zipcode,Phil campbell
ZCTA5 35582,01,4518,37991,489,102700,3638,1530,3306,508,1389,662,605,142,2353,1927,426,1927,1270,657,2022-01-01,zipcode,Red bay
ZCTA5 35584,01,211,23750,-666666666,51300,211,149,181,86,65,26,0,4,132,97,35,97,64,33,2022-01-01,zipcode,Sipsey
ZCTA5 35585,01,1838,64583,-666666666,209500,1221,597,1047,195,169,346,272,65,690,521,169,521,461,60,2022-01-01,zipcode,Spruce pine
ZCTA5 35586,01,3703,44100,498,88300,2690,1210,2273,364,941,753,123,92,1870,1280,590,1280,977,303,2022-01-01,zipcode,Sulligent
ZCTA5 35587,01,734,40288,778,-666666666,620,367,620,222,266,103,0,29,440,314,126,314,238,76,2022-01-01,zipcode,Townley
ZCTA5 35592,01,4196,41343,487,120400,3464,1938,3161,697,1303,896,122,143,2420,1686,734,1686,1069,617,2022-01-01,zipcode,Vernon
ZCTA5 35593,01,1602,58966,646,99600,1413,621,1261,176,652,261,78,94,791,595,196,595,540,55,2022-01-01,zipcode,Vina
ZCTA5 35594,01,7094,53651,669,150500,5869,2581,5338,778,1946,1926,331,357,3330,2696,634,2696,2038,658,2022-01-01,zipcode,Winfield
ZCTA5 35601,01,34817,46276,804,135100,27130,11402,23236,5449,6628,6754,3010,1395,14880,13307,1573,13307,7913,5394,2022-01-01,zipcode,Decatur
ZCTA5 35603,01,32372,71453,790,218800,26368,10526,22734,2147,6483,7366,4487,2251,14610,13731,879,13731,10016,3715,2022-01-01,zipcode,Decatur
ZCTA5 35610,01,1739,66150,-666666666,125700,1568,671,1251,109,491,336,135,180,717,673,44,673,589,84,2022-01-01,zipcode,Anderson
ZCTA5 35611,01,28375,54094,747,169600,23205,9872,20099,3419,5871,6567,2951,1291,13614,11707,1907,11707,7087,4620,2022-01-01,zipcode,Athens
ZCTA5 35613,01,22278,96542,1044,271100,18270,7223,16175,1570,3865,4878,3842,2020,8713,8256,457,8256,7192,1064,2022-01-01,zipcode,Athens
ZCTA5 35614,01,6753,56415,955,170900,5167,2179,4458,683,1731,1191,530,323,3029,2467,562,2467,1900,567,2022-01-01,zipcode,Athens
ZCTA5 35615,01,0,-666666666,-666666666,-666666666,0,0,0,0,0,0,0,0,43,0,43,0,0,0,2022-01-01,zipcode,Belle mina
ZCTA5 35616,01,3599,46992,771,92300,2877,1223,2519,394,1016,800,194,115,1969,1448,521,1448,1027,421,2022-01-01,zipcode,Cherokee
ZCTA5 35618,01,1891,45820,555,100200,1601,854,1397,171,591,436,85,114,970,830,140,830,613,217,2022-01-01,zipcode,Courtland
ZCTA5 35619,01,4739,62750,970,150100,3809,1565,3322,702,1291,942,295,92,2226,1780,446,1780,1501,279,2022-01-01,zipcode,Danville
ZCTA5 35620,01,11648,80145,959,175700,9634,3361,7799,825,2925,3013,585,451,4581,4190,391,4190,3611,579,2022-01-01,zipcode,Elkmont
ZCTA5 35621,01,3242,80938,1054,155200,2206,755,2057,222,456,860,465,54,1107,1052,55,1052,983,69,2022-01-01,zipcode,Eva
ZCTA5 35622,01,6650,54891,846,144400,5278,2516,4705,586,2181,1297,448,193,2849,2450,399,2450,1869,581,2022-01-01,zipcode,Falkville
ZCTA5 35630,01,33252,41174,757,148700,27416,11923,21414,2892,7609,5695,3244,1974,17302,14590,2712,14590,6289,8301,2022-01-01,zipcode,Florence
ZCTA5 35633,01,20720,65385,819,163200,17075,7258,14828,1781,5295,3939,2416,1397,9093,8267,826,8267,6817,1450,2022-01-01,zipcode,Florence
ZCTA5 35634,01,10272,71475,827,252200,8643,3729,7818,401,2399,2462,1640,916,5046,4236,810,4236,3405,831,2022-01-01,zipcode,Florence
ZCTA5 35640,01,26909,69233,788,176900,21768,9081,18530,1912,6547,5475,2872,1724,11258,10194,1064,10194,8203,1991,2022-01-01,zipcode,Hartselle
ZCTA5 35643,01,4008,50966,725,111100,3221,1552,2871,991,917,623,166,174,1749,1559,190,1559,1384,175,2022-01-01,zipcode,Hillsboro
ZCTA5 35645,01,13575,81364,874,211200,10710,3902,9446,737,3203,2871,1620,1015,5676,5042,634,5042,4216,826,2022-01-01,zipcode,Killen
ZCTA5 35646,01,4038,54837,661,109900,3603,1854,3226,690,1478,803,119,136,2188,1719,469,1719,1451,268,2022-01-01,zipcode,Leighton
ZCTA5 35647,01,989,93793,743,184000,731,265,622,83,177,171,140,51,367,334,33,334,320,14,2022-01-01,zipcode,Lester
ZCTA5 35648,01,3184,66897,648,143700,2593,1007,2199,286,801,689,200,223,1315,1178,137,1178,975,203,2022-01-01,zipcode,Lexington
ZCTA5 35649,01,93,-666666666,-666666666,-666666666,81,46,74,1,8,12,37,16,40,36,4,36,36,0,2022-01-01,zipcode,Mooresville
ZCTA5 35650,01,13101,54230,621,143200,10915,5322,9450,1436,3916,2421,1012,665,6000,5201,799,5201,4157,1044,2022-01-01,zipcode,Moulton
ZCTA5 35651,01,1384,72552,-666666666,220600,1179,575,967,132,364,177,275,19,589,461,128,461,400,61,2022-01-01,zipcode,Mount hope
ZCTA5 35652,01,9268,66512,786,165600,7634,2961,6666,854,2327,1880,1051,554,4698,3751,947,3751,3059,692,2022-01-01,zipcode,Rogersville
ZCTA5 35653,01,10956,52648,676,107400,8331,3057,6954,1727,2463,1786,621,357,4508,3559,949,3559,2576,983,2022-01-01,zipcode,Russellville
ZCTA5 35654,01,8314,43327,589,149600,6711,3273,5729,1205,2669,1296,388,171,3699,3111,588,3111,2149,962,2022-01-01,zipcode,Russellville
ZCTA5 35660,01,9433,40357,765,122100,7781,3528,6706,1048,2271,2261,720,406,5224,4380,844,4380,2579,1801,2022-01-01,zipcode,Sheffield
ZCTA5 35661,01,18982,68659,950,176600,15781,6299,14074,1545,4464,5039,1875,1151,8796,7667,1129,7667,5885,1782,2022-01-01,zipcode,Muscle shoals
ZCTA5 35670,01,7181,52284,722,152600,5582,2389,4944,966,1204,1644,833,297,3086,2531,555,2531,1926,605,2022-01-01,zipcode,Somerville
ZCTA5 35671,01,1526,58246,637,96100,1373,577,1309,317,579,220,162,31,642,537,105,537,500,37,2022-01-01,zipcode,Tanner
ZCTA5 35672,01,5387,53204,636,121400,4113,1928,3663,465,1642,1082,277,197,2707,2146,561,2146,1648,498,2022-01-01,zipcode,Town creek
ZCTA5 35673,01,7698,71587,719,176600,5981,2267,5314,599,2245,1664,593,213,3263,2737,526,2737,2144,593,2022-01-01,zipcode,Trinity
ZCTA5 35674,01,20214,56882,765,154100,15870,6797,13606,1743,5453,3840,1632,938,8921,7621,1300,7621,5268,2353,2022-01-01,zipcode,Tuscumbia
ZCTA5 35677,01,1891,41923,688,167200,1624,851,1221,193,495,362,84,87,1042,684,358,684,619,65,2022-01-01,zipcode,Waterloo
ZCTA5 35739,01,5013,60526,778,194300,4252,1755,3723,489,1611,940,379,304,2218,2100,118,2100,1727,373,2022-01-01,zipcode,Ardmore
ZCTA5 35740,01,3342,42012,391,108400,2822,1506,2497,376,1114,718,203,86,1748,1536,212,1536,1000,536,2022-01-01,zipcode,Bridgeport
ZCTA5 35741,01,4206,88979,1090,282200,3884,1357,3417,211,464,562,1554,626,2026,1993,33,1993,1576,417,2022-01-01,zipcode,Brownsboro
ZCTA5 35744,01,2113,44020,746,139600,1923,905,1601,342,711,414,81,53,875,746,129,746,562,184,2022-01-01,zipcode,Dutton
ZCTA5 35745,01,99,22212,-666666666,-666666666,99,78,99,5,82,12,0,0,150,61,89,61,48,13,2022-01-01,zipcode,Estillfork
ZCTA5 35746,01,747,43803,-666666666,117100,680,435,663,161,263,161,38,40,412,339,73,339,329,10,2022-01-01,zipcode,Fackler
ZCTA5 35747,01,6229,80833,778,208300,5061,1942,4359,459,1383,1472,694,351,3310,2452,858,2452,2056,396,2022-01-01,zipcode,Grant
ZCTA5 35748,01,7170,90500,813,320500,6004,2378,5417,522,1313,1173,1357,1052,3183,2924,259,2924,2514,410,2022-01-01,zipcode,Gurley
ZCTA5 35749,01,28121,107188,1202,246000,23279,9287,19977,2003,4531,6053,4290,3100,10221,9618,603,9618,8619,999,2022-01-01,zipcode,Harvest
ZCTA5 35750,01,14255,72052,993,173800,11361,4063,9823,1210,3055,2614,2223,721,5804,5405,399,5405,4231,1174,2022-01-01,zipcode,Hazel green
ZCTA5 35751,01,245,-666666666,-666666666,227500,211,68,151,0,51,39,49,12,94,70,24,70,70,0,2022-01-01,zipcode,Hollytree
ZCTA5 35752,01,2220,41339,904,85700,1854,873,1628,279,706,419,116,108,1135,994,141,994,691,303,2022-01-01,zipcode,Hollywood
ZCTA5 35754,01,5555,90417,750,205700,4743,1928,4083,675,852,1139,836,581,2478,2199,279,2199,1875,324,2022-01-01,zipcode,Laceys spring
ZCTA5 35755,01,404,39471,735,270800,385,231,365,61,106,128,39,31,482,207,275,207,139,68,2022-01-01,zipcode,Langston
ZCTA5 35756,01,23425,124874,1534,321000,17293,5326,14971,482,2168,3506,4960,3855,9087,8412,675,8412,6776,1636,2022-01-01,zipcode,Madison
ZCTA5 35757,01,17622,106897,1336,266800,13663,4206,12168,726,1738,3726,3764,2214,6712,6451,261,6451,5341,1110,2022-01-01,zipcode,Madison
ZCTA5 35758,01,48043,103914,1219,294100,37754,13124,32940,995,4142,7180,11155,9468,20163,19584,579,19584,13743,5841,2022-01-01,zipcode,Madison
ZCTA5 35759,01,11627,96433,1116,241300,9274,2901,8221,821,1968,2132,2219,1081,4476,4360,116,4360,4100,260,2022-01-01,zipcode,Meridianville
ZCTA5 35760,01,4847,67500,889,163300,3503,1162,3199,398,1047,921,641,192,1862,1722,140,1722,1421,301,2022-01-01,zipcode,New hope
ZCTA5 35761,01,13032,72768,978,196300,9842,3474,8657,871,2210,3183,1775,618,5215,4847,368,4847,4007,840,2022-01-01,zipcode,New market
ZCTA5 35763,01,19203,122929,2000,346700,14375,5272,13073,467,1912,2848,4280,3566,7160,7072,88,7072,6481,591,2022-01-01,zipcode,Owens cross roads
ZCTA5 35764,01,523,41061,-666666666,78800,485,269,424,121,230,64,6,3,294,234,60,234,208,26,2022-01-01,zipcode,Paint rock
ZCTA5 35765,01,4582,61146,675,148200,3627,1854,3273,599,1028,975,298,373,2095,1713,382,1713,1442,271,2022-01-01,zipcode,Pisgah
ZCTA5 35766,01,245,77396,-666666666,84700,211,54,198,28,138,21,8,3,120,85,35,85,51,34,2022-01-01,zipcode,Princeton
ZCTA5 35768,01,12328,46386,724,120800,10083,5243,8683,1541,3161,2538,977,466,5394,4657,737,4657,3176,1481,2022-01-01,zipcode,Scottsboro
ZCTA5 35769,01,9832,56136,762,177400,8062,3566,7175,768,2035,2423,1323,626,4850,4066,784,4066,3344,722,2022-01-01,zipcode,Scottsboro
ZCTA5 35771,01,3018,51389,676,91400,2388,1042,2004,389,750,629,128,108,1467,1194,273,1194,960,234,2022-01-01,zipcode,Section
ZCTA5 35772,01,4855,38333,763,123200,3796,2090,3468,890,1324,884,271,99,2320,1890,430,1890,1366,524,2022-01-01,zipcode,Stevenson
ZCTA5 35773,01,13784,62188,1050,172500,11253,4316,10218,1068,3234,3331,1572,1013,5567,5315,252,5315,4519,796,2022-01-01,zipcode,Toney
ZCTA5 35774,01,118,75750,-666666666,96900,118,72,112,0,45,41,6,20,67,45,22,45,45,0,2022-01-01,zipcode,Trenton
ZCTA5 35775,01,555,47905,-666666666,91800,442,248,401,33,191,141,19,17,279,224,55,224,218,6,2022-01-01,zipcode,Valhermoso springs
ZCTA5 35776,01,3651,46875,579,120500,3035,1528,2636,377,1070,747,281,161,1718,1405,313,1405,1173,232,2022-01-01,zipcode,Woodville
ZCTA5 35801,01,24002,97643,1109,367300,20587,8375,18236,1861,2876,3667,5780,4052,11233,10321,912,10321,6943,3378,2022-01-01,zipcode,Huntsville
ZCTA5 35802,01,23508,68352,1038,289600,19815,7354,17418,837,2205,5667,5019,3690,12365,11361,1004,11361,6062,5299,2022-01-01,zipcode,Huntsville
ZCTA5 35803,01,28210,89714,1073,234900,23373,9254,20581,835,3286,5350,6698,4412,12921,12080,841,12080,9767,2313,2022-01-01,zipcode,Huntsville
ZCTA5 35805,01,20907,30365,752,93300,16232,6504,12393,2670,3585,3957,1508,673,10385,9105,1280,9105,2881,6224,2022-01-01,zipcode,Huntsville
ZCTA5 35806,01,27549,75637,1178,286600,23342,6395,18143,857,2068,4580,6170,4468,13987,13203,784,13203,6525,6678,2022-01-01,zipcode,Huntsville
ZCTA5 35808,01,1112,124028,1677,-666666666,931,221,719,4,116,224,173,202,395,385,10,385,13,372,2022-01-01,zipcode,Huntsville
ZCTA5 35810,01,31668,46285,1053,113500,24968,10165,20858,3257,5462,7217,3480,1442,13066,11881,1185,11881,7714,4167,2022-01-01,zipcode,Huntsville
ZCTA5 35811,01,28841,81754,941,229500,24416,9661,19171,1369,4016,7269,4352,2165,12157,11084,1073,11084,8570,2514,2022-01-01,zipcode,Huntsville
ZCTA5 35816,01,15569,36885,832,107100,12802,4363,8671,1062,2201,2945,1532,931,7872,6834,1038,6834,1941,4893,2022-01-01,zipcode,Huntsville
ZCTA5 35824,01,9767,107828,1218,348800,8318,2246,7635,116,766,1880,2237,2636,4692,4401,291,4401,2252,2149,2022-01-01,zipcode,Huntsville
ZCTA5 35896,01,527,-666666666,-666666666,-666666666,527,291,0,0,0,0,0,0,0,0,0,0,0,0,2022-01-01,zipcode,Huntsville
ZCTA5 35901,01,18818,43638,768,167200,14918,6858,12904,1808,3903,4130,1969,1094,8966,7166,1800,7166,4552,2614,2022-01-01,zipcode,Gadsden
ZCTA5 35903,01,17717,51119,787,145900,15048,5474,12601,1993,3657,4999,1220,732,8304,6777,1527,6777,4352,2425,2022-01-01,zipcode,Gadsden
ZCTA5 35904,01,13482,42738,727,94700,10704,5280,9411,1491,3758,3067,655,440,6378,5015,1363,5015,3722,1293,2022-01-01,zipcode,Gadsden
ZCTA5 35905,01,6221,67321,774,166400,4980,2015,4285,265,1431,1726,367,496,2907,2269,638,2269,1918,351,2022-01-01,zipcode,Gadsden
ZCTA5 35906,01,10429,60373,959,188500,8351,3470,7340,802,2174,2456,1224,684,4670,4009,661,4009,2586,1423,2022-01-01,zipcode,Rainbow city
ZCTA5 35907,01,9235,70919,1105,187600,7106,2856,6463,513,2029,2495,877,549,3367,3060,307,3060,2773,287,2022-01-01,zipcode,Gadsden
ZCTA5 35950,01,21156,57867,839,139500,15329,5527,12978,2889,3526,4036,1732,795,7648,7103,545,7103,4948,2155,2022-01-01,zipcode,Albertville
ZCTA5 35951,01,13486,47775,689,145000,10526,4759,8867,2171,2841,2584,901,370,5586,4682,904,4682,3485,1197,2022-01-01,zipcode,Albertville
ZCTA5 35952,01,8948,46002,681,123400,7190,3272,6416,1457,2493,1749,486,231,3871,3379,492,3379,2660,719,2022-01-01,zipcode,Altoona
ZCTA5 35953,01,6557,63802,1006,189100,5747,2984,5202,837,2115,1867,249,134,3316,2572,744,2572,2134,438,2022-01-01,zipcode,Ashville
ZCTA5 35954,01,12594,52313,641,124700,10636,4843,9321,1338,3776,3191,616,400,5919,4919,1000,4919,4033,886,2022-01-01,zipcode,Attalla
ZCTA5 35956,01,8207,56397,786,159500,6484,2921,5540,793,1730,1976,566,475,3819,2994,825,2994,2437,557,2022-01-01,zipcode,Boaz
ZCTA5 35957,01,16269,46799,653,119800,12103,5198,10306,1559,4171,3206,898,472,6820,5912,908,5912,3988,1924,2022-01-01,zipcode,Boaz
ZCTA5 35958,01,3290,41883,770,149000,2508,1259,2285,470,867,522,255,171,1409,1169,240,1169,977,192,2022-01-01,zipcode,Bryant
ZCTA5 35959,01,4234,41275,696,186000,3572,2119,3233,486,1219,1053,252,223,3347,1877,1470,1877,1450,427,2022-01-01,zipcode,Cedar bluff
ZCTA5 35960,01,9101,45925,703,171200,7823,3780,7036,1316,2434,2180,648,458,5464,3693,1771,3693,2829,864,2022-01-01,zipcode,Centre
ZCTA5 35961,01,6271,43063,611,85000,5023,2221,4067,1295,1232,1336,136,68,2594,2048,546,2048,1469,579,2022-01-01,zipcode,Collinsville
ZCTA5 35962,01,8391,56838,801,152700,6851,2768,5785,1644,1803,1623,353,362,3461,2834,627,2834,2186,648,2022-01-01,zipcode,Crossville
ZCTA5 35963,01,1608,66288,563,129500,1397,494,1227,194,429,506,69,29,647,571,76,571,415,156,2022-01-01,zipcode,Dawson
ZCTA5 35966,01,3360,39239,701,132300,2850,1442,2455,685,889,695,167,19,1651,1310,341,1310,1055,255,2022-01-01,zipcode,Flat rock
ZCTA5 35967,01,17257,45639,675,141100,13296,5656,11418,2392,3145,4003,971,907,7790,6720,1070,6720,4666,2054,2022-01-01,zipcode,Fort payne
ZCTA5 35968,01,4870,54766,693,114400,3861,1735,3288,722,1221,837,281,227,1953,1653,300,1653,1268,385,2022-01-01,zipcode,Fort payne
ZCTA5 35971,01,5043,52930,729,111700,4292,2042,3584,767,1513,1082,128,94,1957,1806,151,1806,1240,566,2022-01-01,zipcode,Fyffe
ZCTA5 35972,01,1293,-666666666,-666666666,88500,962,540,869,210,262,265,48,84,691,541,150,541,489,52,2022-01-01,zipcode,Gallant
ZCTA5 35973,01,3336,62204,1000,106300,2717,1221,2258,445,805,724,190,94,1360,1081,279,1081,895,186,2022-01-01,zipcode,Gaylesville
ZCTA5 35974,01,1695,60127,682,148500,1301,426,1172,267,353,337,102,113,649,614,35,614,426,188,2022-01-01,zipcode,Geraldine
ZCTA5 35975,01,1400,43333,719,165800,1116,524,981,62,504,279,62,74,553,522,31,522,475,47,2022-01-01,zipcode,Groveoak
ZCTA5 35976,01,16769,63551,733,235800,13888,6829,12109,1565,3111,3541,2812,1080,7550,6609,941,6609,5123,1486,2022-01-01,zipcode,Guntersville
ZCTA5 35978,01,5877,51276,816,128200,4370,1942,3989,675,1774,1186,178,176,2297,1952,345,1952,1477,475,2022-01-01,zipcode,Henagar
ZCTA5 35979,01,744,30547,-666666666,134400,606,270,511,152,201,136,16,6,420,319,101,319,319,0,2022-01-01,zipcode,Higdon
ZCTA5 35980,01,6420,55720,785,156900,4662,2015,3852,817,1417,944,352,322,2230,2006,224,2006,1630,376,2022-01-01,zipcode,Horton
ZCTA5 35981,01,1806,41620,840,105700,1546,718,1312,270,406,362,256,18,843,602,241,602,480,122,2022-01-01,zipcode,Ider
ZCTA5 35983,01,3426,60639,710,134300,2773,1296,2437,368,769,876,186,238,2102,1356,746,1356,1166,190,2022-01-01,zipcode,Leesburg
ZCTA5 35984,01,1489,41078,785,143400,1383,782,1352,187,420,276,212,257,1508,778,730,778,608,170,2022-01-01,zipcode,Mentone
ZCTA5 35986,01,8415,60755,646,192400,6709,2809,5622,909,1572,1924,820,397,3524,3077,447,3077,2486,591,2022-01-01,zipcode,Rainsville
ZCTA5 35987,01,2599,62039,-666666666,123600,1970,848,1762,349,766,502,92,53,1163,969,194,969,826,143,2022-01-01,zipcode,Steele
ZCTA5 35988,01,2028,41000,624,103100,1564,572,1321,281,409,329,188,114,881,730,151,730,497,233,2022-01-01,zipcode,Sylvania
ZCTA5 35989,01,3590,47138,669,97200,2757,1301,2278,553,594,798,228,105,1493,1237,256,1237,1055,182,2022-01-01,zipcode,Valley head
ZCTA5 35990,01,0,-666666666,-666666666,-666666666,0,0,0,0,0,0,0,0,24,0,24,0,0,0,2022-01-01,zipcode,Walnut grove
ZCTA5 36003,01,2420,31719,425,103800,1924,1020,1623,319,632,512,53,107,1153,1007,146,1007,829,178,2022-01-01,zipcode,Autaugaville
ZCTA5 36005,01,1536,43167,925,109000,1300,590,1078,254,383,249,114,78,921,610,311,610,511,99,2022-01-01,zipcode,Banks
ZCTA5 36006,01,1909,-666666666,1014,193800,1549,805,1467,97,642,608,118,2,866,782,84,782,727,55,2022-01-01,zipcode,Billingsley
ZCTA5 36009,01,2142,42434,602,98600,1777,945,1582,190,748,335,212,97,1199,903,296,903,667,236,2022-01-01,zipcode,Brantley
ZCTA5 36010,01,5209,39071,659,112000,4211,2119,3721,675,1706,775,369,196,2947,2091,856,2091,1427,664,2022-01-01,zipcode,Brundidge
ZCTA5 36013,01,391,176406,-666666666,372500,342,182,283,56,55,89,62,21,159,139,20,139,139,0,2022-01-01,zipcode,Cecil
ZCTA5 36016,01,4429,57734,633,65000,3772,2404,3430,809,1442,980,140,59,1674,1232,442,1232,870,362,2022-01-01,zipcode,Clayton
ZCTA5 36017,01,3211,31167,403,73300,2779,2068,2642,1020,872,556,133,61,977,768,209,768,476,292,2022-01-01,zipcode,Clio
ZCTA5 36020,01,1080,54375,930,154500,850,388,702,87,243,250,82,40,505,414,91,414,337,77,2022-01-01,zipcode,Coosada
ZCTA5 36022,01,16150,81276,956,211300,11923,3873,10371,745,3127,3652,1882,965,5958,5555,403,5555,4778,777,2022-01-01,zipcode,Deatsville
ZCTA5 36024,01,5305,55170,760,218700,4674,2127,4268,429,1713,1381,476,269,3556,2385,1171,2385,1908,477,2022-01-01,zipcode,Eclectic
ZCTA5 36025,01,7120,51875,1052,185600,6066,4112,5507,1467,2121,1048,687,184,1700,1535,165,1535,1151,384,2022-01-01,zipcode,Elmore
ZCTA5 36026,01,1294,86321,1045,293800,1198,606,1078,92,344,377,251,14,923,585,338,585,541,44,2022-01-01,zipcode,Equality
ZCTA5 36027,01,14887,39419,638,118300,11906,6110,9978,1928,3561,2909,825,755,7484,5944,1540,5944,3723,2221,2022-01-01,zipcode,Eufaula
ZCTA5 36028,01,1653,38482,575,120200,1408,817,1203,314,314,331,178,66,923,640,283,640,391,249,2022-01-01,zipcode,Dozier
ZCTA5 36029,01,813,58409,-666666666,-666666666,684,290,639,162,217,123,111,26,409,308,101,308,247,61,2022-01-01,zipcode,Fitzpatrick
ZCTA5 36030,01,316,32768,-666666666,-666666666,272,174,214,0,141,56,11,6,195,105,90,105,83,22,2022-01-01,zipcode,Forest home
ZCTA5 36031,01,23,-666666666,-666666666,-666666666,23,16,23,0,16,7,0,0,25,12,13,12,12,0,2022-01-01,zipcode,Fort davis
ZCTA5 36032,01,2408,31080,430,70000,1918,1127,1578,349,735,333,89,72,1117,921,196,921,670,251,2022-01-01,zipcode,Fort deposit
ZCTA5 36033,01,3513,38500,628,88900,2890,1504,2674,335,1388,576,234,141,2149,1446,703,1446,1137,309,2022-01-01,zipcode,Georgiana
ZCTA5 36034,01,715,39773,786,81400,549,250,496,29,188,164,76,39,351,240,111,240,218,22,2022-01-01,zipcode,Glenwood
ZCTA5 36035,01,2019,48354,947,114200,1591,634,1377,154,579,331,203,110,1117,808,309,808,685,123,2022-01-01,zipcode,Goshen
ZCTA5 36036,01,1904,47500,909,159400,1720,998,1400,256,616,337,113,78,986,720,266,720,575,145,2022-01-01,zipcode,Grady
ZCTA5 36037,01,13177,47707,733,95800,10539,4658,9112,1163,4350,2421,679,499,6498,4873,1625,4873,3236,1637,2022-01-01,zipcode,Greenville
ZCTA5 36038,01,144,9145,-666666666,-666666666,144,40,143,9,20,25,13,76,106,100,6,100,24,76,2022-01-01,zipcode,Gantt
ZCTA5 36039,01,261,49107,-666666666,-666666666,261,128,230,41,81,89,19,0,148,103,45,103,54,49,2022-01-01,zipcode,Hardaway
ZCTA5 36040,01,3748,32438,771,71900,3008,1577,2623,466,1095,605,314,143,1593,1416,177,1416,956,460,2022-01-01,zipcode,Hayneville
ZCTA5 36041,01,1506,42882,672,107700,1137,487,923,168,337,268,123,27,774,565,209,565,491,74,2022-01-01,zipcode,Highland home
ZCTA5 36042,01,1389,81607,-666666666,97800,1070,393,901,128,336,325,77,35,735,443,292,443,408,35,2022-01-01,zipcode,Honoraville
ZCTA5 36043,01,3800,87813,968,228300,3178,1388,2541,320,835,795,314,277,1555,1316,239,1316,1080,236,2022-01-01,zipcode,Hope hull
ZCTA5 36046,01,1358,43289,-666666666,102000,1126,481,948,216,359,239,77,57,587,522,65,522,473,49,2022-01-01,zipcode,Lapine
ZCTA5 36047,01,859,-666666666,-666666666,-666666666,856,336,770,96,235,329,72,38,436,339,97,339,324,15,2022-01-01,zipcode,Letohatchee
ZCTA5 36048,01,1240,24289,760,83700,1019,497,943,222,392,239,48,42,794,583,211,583,412,171,2022-01-01,zipcode,Louisville
ZCTA5 36049,01,5403,51839,587,114800,4342,2140,3853,697,1684,674,512,286,2384,1806,578,1806,1317,489,2022-01-01,zipcode,Luverne
ZCTA5 36051,01,3308,76250,966,91000,2538,806,2323,142,1040,802,127,212,1179,1066,113,1066,926,140,2022-01-01,zipcode,Marbury
ZCTA5 36052,01,674,125000,-666666666,625000,621,245,536,23,88,106,171,148,345,334,11,334,317,17,2022-01-01,zipcode,Mathews
ZCTA5 36053,01,2505,45403,585,103000,2031,1072,1583,257,580,622,39,85,1195,882,313,882,671,211,2022-01-01,zipcode,Midway
ZCTA5 36054,01,15233,53371,976,155200,12096,5204,9882,1191,3269,2975,1714,733,6468,5950,518,5950,4137,1813,2022-01-01,zipcode,Millbrook
ZCTA5 36064,01,13007,122500,1444,359500,9201,2642,8184,321,1300,1962,2661,1940,4799,4364,435,4364,3808,556,2022-01-01,zipcode,Pike road
ZCTA5 36066,01,21626,78271,1298,204300,17901,6310,14534,930,3135,3654,3829,2986,9069,8731,338,8731,5430,3301,2022-01-01,zipcode,Prattville
ZCTA5 36067,01,27436,63836,924,172500,22028,9716,19097,2146,6549,5880,2499,2023,11359,10115,1244,10115,7803,2312,2022-01-01,zipcode,Prattville
ZCTA5 36069,01,1987,44643,813,97400,1660,871,1475,215,508,430,214,108,1293,950,343,950,732,218,2022-01-01,zipcode,Ramer
ZCTA5 36071,01,467,47708,679,97400,360,207,344,64,131,69,63,17,294,198,96,198,164,34,2022-01-01,zipcode,Rutledge
ZCTA5 36075,01,1642,45032,929,96600,1429,837,1292,313,417,413,84,65,802,649,153,649,538,111,2022-01-01,zipcode,Shorter
ZCTA5 36078,01,13398,61574,837,167000,11057,4612,9255,1190,3712,2893,992,468,5814,5220,594,5220,3658,1562,2022-01-01,zipcode,Tallassee
ZCTA5 36079,01,8998,53846,888,142400,7317,3407,6263,800,2047,1591,870,955,4487,3536,951,3536,2743,793,2022-01-01,zipcode,Troy
ZCTA5 36080,01,2551,77866,974,250000,1897,797,1785,342,681,409,201,152,938,838,100,838,630,208,2022-01-01,zipcode,Titus
ZCTA5 36081,01,16008,39133,740,175900,13520,5951,7848,712,2707,1877,1506,1046,7458,5557,1901,5557,2614,2943,2022-01-01,zipcode,Troy
ZCTA5 36082,01,823,-666666666,-666666666,-666666666,823,695,11,0,7,4,0,0,0,0,0,0,0,0,2022-01-01,zipcode,Troy
ZCTA5 36083,01,9385,40295,662,87900,8068,4013,5618,873,1663,1773,573,736,4681,3527,1154,3527,1970,1557,2022-01-01,zipcode,Tuskegee
ZCTA5 36088,01,3451,32885,766,97200,3039,1509,1492,270,296,351,312,263,1912,1172,740,1172,591,581,2022-01-01,zipcode,Tuskegee institute
ZCTA5 36089,01,7740,29275,625,88900,6102,3414,5296,1588,2178,1012,429,89,3325,2525,800,2525,1533,992,2022-01-01,zipcode,Union springs
ZCTA5 36091,01,3887,46236,783,128200,3251,1668,2963,553,1343,821,103,143,2050,1554,496,1554,1181,373,2022-01-01,zipcode,Verbena
ZCTA5 36092,01,21053,74719,974,178600,16996,6641,14878,1428,6246,4585,1884,735,9129,8007,1122,8007,6274,1733,2022-01-01,zipcode,Wetumpka
ZCTA5 36093,01,11769,117243,897,298500,9617,3371,7907,435,1475,2539,1928,1530,4400,4086,314,4086,3849,237,2022-01-01,zipcode,Wetumpka
ZCTA5 36104,01,10132,31231,753,110400,8438,4561,6078,1385,1755,1434,812,692,5071,3825,1246,3825,986,2839,2022-01-01,zipcode,Montgomery
ZCTA5 36105,01,9668,42696,914,83200,8263,3940,7551,1871,2197,2182,820,481,5571,4293,1278,4293,2619,1674,2022-01-01,zipcode,Montgomery
ZCTA5 36106,01,15081,69512,1068,182200,12516,4638,9966,535,1901,2729,2364,2437,7162,6370,792,6370,3558,2812,2022-01-01,zipcode,Montgomery
ZCTA5 36107,01,7464,29922,876,71400,5569,2606,4495,919,1124,1591,494,367,3969,2968,1001,2968,1104,1864,2022-01-01,zipcode,Montgomery
ZCTA5 36108,01,15271,27338,712,68300,12415,6958,11100,2862,3979,2691,931,637,8657,6299,2358,6299,3979,2320,2022-01-01,zipcode,Montgomery
ZCTA5 36109,01,23935,58053,1047,129000,19796,8275,16626,1352,5261,5134,3162,1717,11199,10068,1131,10068,6506,3562,2022-01-01,zipcode,Montgomery
ZCTA5 36110,01,11245,38860,970,74600,8636,4161,7532,1693,2981,2140,441,277,5142,4031,1111,4031,2102,1929,2022-01-01,zipcode,Montgomery
ZCTA5 36111,01,13033,57958,1024,145300,10275,4331,8644,1260,2029,2197,1973,1185,5770,4899,871,4899,2920,1979,2022-01-01,zipcode,Montgomery
ZCTA5 36112,01,239,70625,1125,-666666666,236,113,181,37,77,54,8,5,7,7,0,7,0,7,2022-01-01,zipcode,Montgomery
ZCTA5 36113,01,1444,112321,1833,-666666666,1176,729,1044,195,179,382,136,152,302,255,47,255,0,255,2022-01-01,zipcode,Montgomery
ZCTA5 36115,01,1083,91667,1427,-666666666,624,139,446,0,51,217,111,67,236,228,8,228,0,228,2022-01-01,zipcode,Montgomery
ZCTA5 36116,01,45445,52015,1041,131300,34882,12410,28484,2848,7899,8126,5474,4137,19858,17362,2496,17362,8149,9213,2022-01-01,zipcode,Montgomery
ZCTA5 36117,01,53559,73919,1150,211800,42051,14115,35675,2167,6315,10990,9298,6905,24033,21737,2296,21737,13151,8586,2022-01-01,zipcode,Montgomery
ZCTA5 36201,01,16794,31807,700,72700,14334,7181,11992,2746,5093,3510,407,236,9486,7068,2418,7068,4359,2709,2022-01-01,zipcode,Anniston
ZCTA5 36203,01,18579,61519,891,158600,14934,5643,13149,1956,3431,4601,1748,1413,8013,7306,707,7306,5382,1924,2022-01-01,zipcode,Oxford
ZCTA5 36205,01,1108,25667,816,255700,899,439,758,110,221,318,59,50,564,478,86,478,218,260,2022-01-01,zipcode,Anniston
ZCTA5 36206,01,10730,53895,786,122200,8440,3216,7210,1075,2607,2275,770,483,4750,4133,617,4133,2715,1418,2022-01-01,zipcode,Anniston
ZCTA5 36207,01,19750,66949,942,184700,15893,6789,13608,1336,3718,4302,2544,1708,9396,8008,1388,8008,6091,1917,2022-01-01,zipcode,Anniston
ZCTA5 36250,01,4419,81023,1075,169000,3591,1404,3240,264,1116,1300,305,255,1770,1528,242,1528,1273,255,2022-01-01,zipcode,Alexandria
ZCTA5 36251,01,5291,44970,417,136700,4391,2213,3545,650,1182,1342,314,57,2507,2077,430,2077,1570,507,2022-01-01,zipcode,Ashland
ZCTA5 36255,01,901,60417,-666666666,126800,824,368,651,176,161,226,25,63,504,379,125,379,345,34,2022-01-01,zipcode,Cragford
ZCTA5 36256,01,1376,55500,629,139500,1070,490,951,118,315,374,59,85,720,588,132,588,524,64,2022-01-01,zipcode,Daviston
ZCTA5 36258,01,1609,54227,-666666666,100600,1340,783,1247,170,502,467,98,10,886,690,196,690,627,63,2022-01-01,zipcode,Delta
ZCTA5 36260,01,4602,65440,675,158200,3410,1878,3150,546,1099,912,391,202,1637,1411,226,1411,1136,275,2022-01-01,zipcode,Eastaboga
ZCTA5 36262,01,1752,55375,883,96600,1428,697,1251,343,551,205,128,24,709,589,120,589,530,59,2022-01-01,zipcode,Fruithurst
ZCTA5 36263,01,520,-666666666,-666666666,117300,421,215,342,130,151,45,0,16,265,172,93,172,135,37,2022-01-01,zipcode,Graham
ZCTA5 36264,01,8341,52482,772,148800,6663,3416,5923,1067,2064,1868,615,309,3673,3124,549,3124,2291,833,2022-01-01,zipcode,Heflin
ZCTA5 36265,01,21802,49924,761,159000,18795,8243,13422,1560,4550,4007,1980,1325,9695,8470,1225,8470,5409,3061,2022-01-01,zipcode,Jacksonville
ZCTA5 36266,01,6276,46094,605,168500,4891,2525,4418,707,1994,1151,417,149,3257,2419,838,2419,1817,602,2022-01-01,zipcode,Lineville
ZCTA5 36267,01,222,-666666666,-666666666,-666666666,89,73,89,0,71,18,0,0,16,16,0,16,16,0,2022-01-01,zipcode,Millerville
ZCTA5 36268,01,6424,62466,743,100700,4840,2063,4163,493,1807,1423,146,294,2701,2305,396,2305,2077,228,2022-01-01,zipcode,Munford
ZCTA5 36269,01,1350,41867,909,125400,927,469,894,161,410,181,100,42,672,572,100,572,401,171,2022-01-01,zipcode,Muscadine
ZCTA5 36271,01,6106,63088,739,148700,4866,2191,4245,721,1742,1185,264,333,2717,2228,489,2228,2029,199,2022-01-01,zipcode,Ohatchee
ZCTA5 36272,01,13048,49474,704,111200,10703,4611,9412,1642,3866,2599,794,511,6252,5043,1209,5043,3921,1122,2022-01-01,zipcode,Piedmont
ZCTA5 36273,01,3300,56016,-666666666,137100,2657,1320,2233,333,842,540,313,205,1540,1279,261,1279,1081,198,2022-01-01,zipcode,Ranburne
ZCTA5 36274,01,10162,44100,671,102600,8357,4227,7401,1249,2936,2067,839,310,5239,4162,1077,4162,3177,985,2022-01-01,zipcode,Roanoke
ZCTA5 36276,01,2841,43000,633,105100,2242,1184,1684,260,653,488,225,58,1138,948,190,948,723,225,2022-01-01,zipcode,Wadley
ZCTA5 36277,01,5531,67019,899,131300,4340,1821,3620,572,1027,1194,580,247,2039,1828,211,1828,1476,352,2022-01-01,zipcode,Weaver
ZCTA5 36278,01,4056,44864,654,241300,3445,2040,3217,456,913,1088,443,317,3354,1871,1483,1871,1564,307,2022-01-01,zipcode,Wedowee
ZCTA5 36279,01,2932,67344,1146,156100,2137,927,1940,287,731,629,155,138,1096,979,117,979,854,125,2022-01-01,zipcode,Wellington
ZCTA5 36280,01,4285,77716,833,215100,3391,1422,2869,469,855,771,394,380,2081,1551,530,1551,1302,249,2022-01-01,zipcode,Woodland
ZCTA5 36301,01,38101,47414,835,146800,30001,13049,26315,3826,8762,9096,3001,1630,17674,15172,2502,15172,9094,6078,2022-01-01,zipcode,Dothan
ZCTA5 36303,01,30390,51982,814,166400,24031,10456,20526,2311,5949,6608,3681,1977,14564,11808,2756,11808,7204,4604,2022-01-01,zipcode,Dothan
ZCTA5 36305,01,17309,79618,1068,226000,13755,5182,11833,818,2983,3831,2418,1783,7337,6603,734,6603,4536,2067,2022-01-01,zipcode,Dothan
ZCTA5 36310,01,6071,38514,588,116000,5318,3237,4808,1068,1680,1330,424,306,4248,2594,1654,2594,1929,665,2022-01-01,zipcode,Abbeville
ZCTA5 36311,01,2761,44926,714,111400,2184,977,1818,291,774,570,82,101,1348,1052,296,1052,832,220,2022-01-01,zipcode,Ariton
ZCTA5 36312,01,6066,49643,779,144700,4937,2342,4302,716,1585,1388,447,166,2757,2290,467,2290,1715,575,2022-01-01,zipcode,Ashford
ZCTA5 36313,01,122,-666666666,-666666666,-666666666,122,0,122,42,0,80,0,0,122,122,0,122,80,42,2022-01-01,zipcode,Bellwood
ZCTA5 36314,01,560,55058,568,58200,417,191,409,27,198,163,21,0,260,211,49,211,180,31,2022-01-01,zipcode,Black
ZCTA5 36316,01,2177,87703,900,164000,1824,755,1635,155,385,687,281,127,998,794,204,794,712,82,2022-01-01,zipcode,Chancellor
ZCTA5 36317,01,703,63281,-666666666,105000,607,290,564,70,169,125,103,97,324,281,43,281,276,5,2022-01-01,zipcode,Clopton
ZCTA5 36318,01,1302,61875,719,116000,1033,482,916,136,272,336,109,63,761,526,235,526,463,63,2022-01-01,zipcode,Coffee springs
ZCTA5 36319,01,2404,59375,768,144000,1879,802,1591,179,695,513,146,58,1064,887,177,887,723,164,2022-01-01,zipcode,Columbia
ZCTA5 36320,01,3213,39640,480,115300,2774,1447,2498,465,1078,643,238,74,1738,1363,375,1363,1063,300,2022-01-01,zipcode,Cottonwood
ZCTA5 36321,01,2156,56964,783,158200,1689,821,1500,254,594,467,110,75,880,799,81,799,624,175,2022-01-01,zipcode,Cowarts
ZCTA5 36322,01,8186,46590,739,111700,6960,2852,6084,895,2067,2120,709,293,4495,3795,700,3795,2312,1483,2022-01-01,zipcode,Daleville
ZCTA5 36323,01,7941,41907,664,93300,6854,3466,6038,1237,2171,1750,593,287,4023,3150,873,3150,2534,616,2022-01-01,zipcode,Elba
ZCTA5 36330,01,38461,69544,971,190000,29957,12188,25508,2685,6851,9804,3782,2386,16725,14498,2227,14498,9229,5269,2022-01-01,zipcode,Enterprise
ZCTA5 36340,01,5235,45922,657,123100,4258,2202,3819,789,1584,816,369,261,2458,2175,283,2175,1482,693,2022-01-01,zipcode,Geneva
ZCTA5 36343,01,1391,47083,879,97100,1198,647,1076,209,421,355,66,25,783,549,234,549,414,135,2022-01-01,zipcode,Gordon
ZCTA5 36344,01,5872,53566,738,146400,4486,1969,4082,498,1474,1521,410,179,2615,2143,472,2143,1594,549,2022-01-01,zipcode,Hartford
ZCTA5 36345,01,8977,73750,728,161800,6830,2198,5955,890,1709,1718,1214,424,3528,3223,305,3223,2700,523,2022-01-01,zipcode,Headland
ZCTA5 36346,01,1309,57308,696,122900,1044,446,887,220,295,228,67,77,774,510,264,510,461,49,2022-01-01,zipcode,Jack
ZCTA5 36350,01,7958,52417,769,157500,6187,2263,5397,1178,1693,1485,762,279,3428,2971,457,2971,1729,1242,2022-01-01,zipcode,Midland city
ZCTA5 36351,01,3670,64107,689,135200,2966,1305,2601,358,785,897,383,178,1733,1467,266,1467,1212,255,2022-01-01,zipcode,New brockton
ZCTA5 36352,01,5682,69429,769,177500,4680,2075,3869,366,1238,1584,427,254,2177,1937,240,1937,1635,302,2022-01-01,zipcode,Newton
ZCTA5 36353,01,1704,43125,830,97500,1514,751,1253,164,479,446,131,33,880,644,236,644,562,82,2022-01-01,zipcode,Newville
ZCTA5 36360,01,19053,48654,739,131900,15415,7950,13430,1933,4175,4867,1366,1089,8995,7763,1232,7763,5039,2724,2022-01-01,zipcode,Ozark
ZCTA5 36362,01,5422,72681,1347,-666666666,3452,894,2520,22,291,1092,943,172,1550,1465,85,1465,12,1453,2022-01-01,zipcode,Fort rucker
ZCTA5 36370,01,973,52000,567,90400,816,395,728,111,353,204,60,0,431,360,71,360,335,25,2022-01-01,zipcode,Pansey
ZCTA5 36371,01,447,39250,767,118900,397,163,336,33,121,155,20,7,221,203,18,203,147,56,2022-01-01,zipcode,Pinckard
ZCTA5 36373,01,435,31188,-666666666,-666666666,416,192,375,122,197,56,0,0,436,171,265,171,130,41,2022-01-01,zipcode,Shorterville
ZCTA5 36374,01,572,65139,856,96500,471,159,443,81,106,158,44,54,458,235,223,235,183,52,2022-01-01,zipcode,Skipperville
ZCTA5 36375,01,7242,47247,789,120000,5933,2883,5160,909,1929,1768,409,145,3378,2771,607,2771,2153,618,2022-01-01,zipcode,Slocomb
ZCTA5 36376,01,2253,46985,814,95200,1840,906,1709,255,857,470,64,63,1074,890,184,890,715,175,2022-01-01,zipcode,Webb
ZCTA5 36401,01,7579,38324,721,101000,6124,3719,5215,477,2496,1626,284,332,3921,2834,1087,2834,2039,795,2022-01-01,zipcode,Evergreen
ZCTA5 36420,01,10429,47935,652,150800,8230,3762,7219,1099,2186,2325,926,683,5033,3850,1183,3850,2849,1001,2022-01-01,zipcode,Andalusia
ZCTA5 36421,01,9717,57018,723,147700,7526,3614,6778,886,2321,2424,724,423,4952,3636,1316,3636,2776,860,2022-01-01,zipcode,Andalusia
ZCTA5 36425,01,719,33281,-666666666,-666666666,601,325,452,67,232,109,37,7,533,287,246,287,205,82,2022-01-01,zipcode,Beatrice
ZCTA5 36426,01,15932,48314,670,122800,12492,5792,10730,1651,4316,3016,1276,471,7202,5455,1747,5455,3871,1584,2022-01-01,zipcode,Brewton
ZCTA5 36432,01,1718,44390,756,55300,1583,874,1420,268,567,348,181,56,1035,721,314,721,584,137,2022-01-01,zipcode,Castleberry
ZCTA5 36435,01,433,41458,-666666666,110700,421,238,406,94,193,106,6,7,294,194,100,194,152,42,2022-01-01,zipcode,Coy
ZCTA5 36436,01,718,63571,-666666666,134200,563,246,368,88,103,158,4,15,344,218,126,218,167,51,2022-01-01,zipcode,Dickinson
ZCTA5 36439,01,82,74464,-666666666,-666666666,65,38,59,9,8,20,14,8,70,39,31,39,30,9,2022-01-01,zipcode,Excel
ZCTA5 36441,01,3505,42500,695,124000,2599,1119,2290,280,968,661,225,156,1918,1298,620,1298,897,401,2022-01-01,zipcode,Flomaton
ZCTA5 36442,01,3456,43594,714,112000,2775,1413,2441,390,975,864,106,106,1787,1222,565,1222,830,392,2022-01-01,zipcode,Florala
ZCTA5 36444,01,626,58000,-666666666,85500,526,337,514,126,263,79,15,31,436,216,220,216,199,17,2022-01-01,zipcode,Franklin
ZCTA5 36445,01,5115,37450,754,99100,4443,2677,3850,833,1764,948,149,156,2337,1830,507,1830,1512,318,2022-01-01,zipcode,Frisco city
ZCTA5 36446,01,451,54583,-666666666,109800,347,145,286,29,142,81,34,0,202,117,85,117,81,36,2022-01-01,zipcode,Fulton
ZCTA5 36451,01,4348,47083,757,123600,3694,1920,3162,553,1311,853,288,157,2139,1613,526,1613,1282,331,2022-01-01,zipcode,Grove hill
ZCTA5 36453,01,2583,44099,669,91400,2205,1097,1882,287,761,581,172,81,1100,973,127,973,794,179,2022-01-01,zipcode,Kinston
ZCTA5 36454,01,30,105556,-666666666,77800,30,5,30,0,30,0,0,0,53,28,25,28,28,0,2022-01-01,zipcode,Lenox
ZCTA5 36455,01,304,33583,668,75000,267,154,248,28,167,39,5,9,224,143,81,143,80,63,2022-01-01,zipcode,Lockhart
ZCTA5 36456,01,1705,47500,545,78700,1284,649,1081,105,504,331,109,32,929,632,297,632,521,111,2022-01-01,zipcode,Mc kenzie
ZCTA5 36460,01,9483,37409,663,118100,7506,3892,6414,980,2695,1606,671,462,4710,3671,1039,3671,2313,1358,2022-01-01,zipcode,Monroeville
ZCTA5 36467,01,10057,43244,673,112200,8352,3785,7229,1068,2902,2375,581,303,4882,3978,904,3978,3026,952,2022-01-01,zipcode,Opp
ZCTA5 36470,01,0,-666666666,-666666666,-666666666,0,0,0,0,0,0,0,0,0,0,0,0,0,0,2022-01-01,zipcode,Perdue hill
ZCTA5 36471,01,826,29554,721,61100,625,444,523,21,342,99,19,42,559,301,258,301,157,144,2022-01-01,zipcode,Peterman
ZCTA5 36473,01,171,-666666666,-666666666,129200,160,104,151,14,83,41,0,13,132,69,63,69,47,22,2022-01-01,zipcode,Range
ZCTA5 36474,01,2496,39348,711,94600,2009,925,1633,192,834,451,73,83,1302,972,330,972,838,134,2022-01-01,zipcode,Red level
ZCTA5 36475,01,2173,43641,717,109900,1799,918,1421,136,759,295,170,61,1079,753,326,753,604,149,2022-01-01,zipcode,Repton
ZCTA5 36476,01,40,-666666666,-666666666,-666666666,33,15,26,9,15,2,0,0,34,18,16,18,4,14,2022-01-01,zipcode,River falls
ZCTA5 36477,01,4276,46020,622,101500,3373,1496,3066,637,948,1190,216,75,2174,1706,468,1706,1282,424,2022-01-01,zipcode,Samson
ZCTA5 36480,01,1735,66103,-666666666,155500,1487,838,1229,122,403,586,71,47,927,585,342,585,525,60,2022-01-01,zipcode,Uriah
ZCTA5 36481,01,240,20568,-666666666,-666666666,214,163,181,51,96,20,1,13,148,71,77,71,63,8,2022-01-01,zipcode,Vredenburgh
ZCTA5 36482,01,825,-666666666,-666666666,113000,774,400,682,262,256,96,68,0,561,330,231,330,272,58,2022-01-01,zipcode,Whatley
ZCTA5 36483,01,588,58869,-666666666,138500,532,286,490,45,220,138,72,15,329,247,82,247,209,38,2022-01-01,zipcode,Wing
ZCTA5 36502,01,16132,35808,643,131400,12977,6743,11190,1952,5480,2682,682,394,7540,6230,1310,6230,3975,2255,2022-01-01,zipcode,Atmore
ZCTA5 36505,01,1176,89514,-666666666,161500,985,377,776,137,303,125,104,107,387,387,0,387,334,53,2022-01-01,zipcode,Axis
ZCTA5 36507,01,20603,50147,857,150000,17009,7287,13734,2400,4913,4392,1088,941,8364,7409,955,7409,5679,1730,2022-01-01,zipcode,Bay minette
ZCTA5 36509,01,1575,39375,716,83500,1280,694,1174,496,323,262,87,6,689,550,139,550,387,163,2022-01-01,zipcode,Bayou la batre
ZCTA5 36511,01,620,85588,-666666666,-666666666,479,71,479,156,227,0,96,0,519,320,199,320,320,0,2022-01-01,zipcode,Bon secour
ZCTA5 36512,01,20,-666666666,-666666666,-666666666,20,20,20,20,0,0,0,0,10,10,0,10,10,0,2022-01-01,zipcode,Bucks
ZCTA5 36513,01,409,-666666666,-666666666,113000,281,183,281,0,173,108,0,0,166,148,18,148,148,0,2022-01-01,zipcode,Calvert
ZCTA5 36518,01,2256,65125,646,168000,1993,969,1839,327,608,599,151,154,1161,839,322,839,703,136,2022-01-01,zipcode,Chatom
ZCTA5 36521,01,5804,67114,899,158900,4683,1963,4026,781,1821,875,384,165,2221,2001,220,2001,1825,176,2022-01-01,zipcode,Chunchula
ZCTA5 36522,01,7101,46888,740,155400,5320,2630,4544,645,2042,1425,298,134,2977,2506,471,2506,1749,757,2022-01-01,zipcode,Citronelle
ZCTA5 36523,01,3139,55815,974,168000,2530,1404,2141,435,870,447,255,134,1234,1047,187,1047,803,244,2022-01-01,zipcode,Coden
ZCTA5 36524,01,1193,36875,646,79900,1014,587,902,233,418,133,43,75,803,418,385,418,329,89,2022-01-01,zipcode,Coffeeville
ZCTA5 36525,01,2035,61550,942,168400,1522,695,1395,209,498,476,166,46,744,703,41,703,554,149,2022-01-01,zipcode,Creola
ZCTA5 36526,01,34611,82573,1325,280000,25936,9355,22955,1207,5560,7113,5680,3395,13772,12645,1127,12645,9305,3340,2022-01-01,zipcode,Daphne
ZCTA5 36527,01,19942,111334,1456,327100,14523,4634,12078,244,1987,4372,2968,2507,7408,6715,693,6715,5025,1690,2022-01-01,zipcode,Daphne
ZCTA5 36528,01,1793,62000,1268,355200,1685,911,1559,46,287,595,394,237,2244,816,1428,816,787,29,2022-01-01,zipcode,Dauphin island
ZCTA5 36529,01,193,123056,-666666666,-666666666,184,95,160,0,84,28,28,20,127,62,65,62,57,5,2022-01-01,zipcode,Deer park
ZCTA5 36530,01,6272,54766,939,236700,5518,2403,4870,601,1614,1604,748,303,3959,2903,1056,2903,2292,611,2022-01-01,zipcode,Elberta
ZCTA5 36532,01,35824,84886,1414,384500,29171,13315,26132,1341,4447,7246,7815,5283,16674,14309,2365,14309,11982,2327,2022-01-01,zipcode,Fairhope
ZCTA5 36535,01,37703,61158,976,237900,32001,13820,29099,3062,9975,9050,4434,2578,18106,15934,2172,15934,12353,3581,2022-01-01,zipcode,Foley
ZCTA5 36538,01,406,37865,-666666666,82200,350,206,263,37,178,19,11,18,295,185,110,185,86,99,2022-01-01,zipcode,Frankville
ZCTA5 36539,01,451,62639,-666666666,126400,355,221,257,17,155,70,6,9,260,177,83,177,169,8,2022-01-01,zipcode,Fruitdale
ZCTA5 36540,01,1050,27254,-666666666,-666666666,721,358,640,218,307,93,15,7,428,308,120,308,256,52,2022-01-01,zipcode,Gainestown
ZCTA5 36541,01,15601,77577,952,145400,12266,5267,10980,1244,4721,3701,833,481,6357,5422,935,5422,4725,697,2022-01-01,zipcode,Grand bay
ZCTA5 36542,01,17089,63305,1182,323900,15121,5880,13383,673,3056,4449,2933,2272,18299,7762,10537,7762,5371,2391,2022-01-01,zipcode,Gulf shores
ZCTA5 36543,01,8,-666666666,-666666666,-666666666,8,0,8,0,0,8,0,0,5,5,0,5,5,0,2022-01-01,zipcode,Huxford
ZCTA5 36544,01,11726,52268,781,129800,9459,3935,8292,2391,3204,2026,524,147,4803,4314,489,4314,3188,1126,2022-01-01,zipcode,Irvington
ZCTA5 36545,01,8818,52027,643,134100,7279,3939,6220,1166,2300,1660,693,401,4387,3116,1271,3116,2224,892,2022-01-01,zipcode,Jackson
ZCTA5 36548,01,1220,97917,-666666666,169300,825,368,708,25,265,211,123,84,513,387,126,387,339,48,2022-01-01,zipcode,Leroy
ZCTA5 36549,01,6048,64722,864,165700,5493,3080,4897,274,1721,1659,913,330,3027,2552,475,2552,2235,317,2022-01-01,zipcode,Lillian
ZCTA5 36550,01,368,-666666666,-666666666,-666666666,302,171,274,42,188,35,0,9,223,170,53,170,148,22,2022-01-01,zipcode,Little river
ZCTA5 36551,01,12416,70346,1186,209300,9533,3387,8397,604,2903,2925,1324,641,4379,3728,651,3728,3043,685,2022-01-01,zipcode,Loxley
ZCTA5 36553,01,3498,50000,600,155600,2869,1497,1904,88,827,746,120,123,1398,1068,330,1068,986,82,2022-01-01,zipcode,Mc intosh
ZCTA5 36555,01,1298,88333,1136,337500,1106,479,987,7,126,392,291,171,678,484,194,484,440,44,2022-01-01,zipcode,Magnolia springs
ZCTA5 36556,01,44,-666666666,-666666666,-666666666,44,44,19,0,0,19,0,0,206,19,187,19,19,0,2022-01-01,zipcode,Malcolm
ZCTA5 36558,01,4042,58962,701,119000,3318,1690,2856,471,1135,677,242,331,1965,1488,477,1488,1325,163,2022-01-01,zipcode,Millry
ZCTA5 36559,01,375,72783,-666666666,631300,375,256,356,0,0,75,68,213,201,128,73,128,128,0,2022-01-01,zipcode,Montrose
ZCTA5 36560,01,3211,42125,805,84900,2638,1387,2263,544,997,448,262,12,1292,1033,259,1033,833,200,2022-01-01,zipcode,Mount vernon
ZCTA5 36561,01,8952,90778,1260,482800,7953,3345,7168,224,1775,2152,1970,1047,15909,4150,11759,4150,2943,1207,2022-01-01,zipcode,Orange beach
ZCTA5 36562,01,1456,36632,-666666666,114400,1104,565,1013,181,497,249,77,9,678,570,108,570,457,113,2022-01-01,zipcode,Perdido
ZCTA5 36564,01,0,-666666666,-666666666,-666666666,0,0,0,0,0,0,0,0,0,0,0,0,0,0,2022-01-01,zipcode,Point clear
ZCTA5 36567,01,14313,61678,980,192800,11606,4940,10208,1522,3643,3074,1502,467,5739,5337,402,5337,4078,1259,2022-01-01,zipcode,Robertsdale
ZCTA5 36568,01,85,-666666666,-666666666,-666666666,85,30,55,0,0,20,0,35,36,36,0,36,16,20,2022-01-01,zipcode,Saint elmo
ZCTA5 36569,01,706,50625,-666666666,108200,666,534,666,57,370,184,25,30,359,262,97,262,253,9,2022-01-01,zipcode,Saint stephens
ZCTA5 36571,01,16497,63513,974,187600,12909,5371,11642,1179,4817,2969,1915,762,7305,6564,741,6564,4951,1613,2022-01-01,zipcode,Saraland
ZCTA5 36572,01,6770,88438,1233,178600,5371,2037,4921,416,1834,1328,919,424,2584,2414,170,2414,1977,437,2022-01-01,zipcode,Satsuma
ZCTA5 36574,01,1636,43137,1102,190100,1363,848,1131,79,551,246,197,58,682,579,103,579,461,118,2022-01-01,zipcode,Seminole
ZCTA5 36575,01,21680,66830,998,181400,16825,6794,14627,975,6326,4260,1955,1111,8010,7455,555,7455,6182,1273,2022-01-01,zipcode,Semmes
ZCTA5 36576,01,4360,85156,984,236000,3652,1035,3213,190,1046,1254,431,292,2070,1746,324,1746,1390,356,2022-01-01,zipcode,Silverhill
ZCTA5 36578,01,1217,67857,-666666666,198600,1022,360,1022,155,457,243,85,82,538,476,62,476,476,0,2022-01-01,zipcode,Stapleton
ZCTA5 36579,01,1649,64732,691,198300,1442,726,1245,171,553,255,228,38,1039,515,524,515,472,43,2022-01-01,zipcode,Stockton
ZCTA5 36580,01,6574,49844,906,205700,4762,1871,4311,1002,1061,1355,618,275,2763,2311,452,2311,2016,295,2022-01-01,zipcode,Summerdale
ZCTA5 36581,01,232,-666666666,-666666666,-666666666,232,117,232,24,158,50,0,0,190,145,45,145,104,41,2022-01-01,zipcode,Sunflower
ZCTA5 36582,01,23964,58333,854,161500,18590,8509,16126,2203,6041,4910,1841,1131,10382,9262,1120,9262,7098,2164,2022-01-01,zipcode,Theodore
ZCTA5 36583,01,505,46638,-666666666,167100,422,213,384,17,206,145,0,16,229,204,25,204,192,12,2022-01-01,zipcode,Tibbie
ZCTA5 36584,01,654,-666666666,-666666666,-666666666,571,368,502,127,171,160,36,8,599,375,224,375,347,28,2022-01-01,zipcode,Vinegar bend
ZCTA5 36585,01,917,63350,-666666666,71400,683,282,555,8,354,119,10,64,431,261,170,261,237,24,2022-01-01,zipcode,Wagarville
ZCTA5 36587,01,12967,60772,924,146900,10139,5108,7966,1680,3268,2011,614,393,4928,4069,859,4069,3266,803,2022-01-01,zipcode,Wilmer
ZCTA5 36602,01,928,30795,463,241000,910,498,853,117,198,223,197,118,778,643,135,643,139,504,2022-01-01,zipcode,Mobile
ZCTA5 36603,01,8562,24612,747,117400,6764,4604,5921,1407,2253,1543,435,283,3938,2997,941,2997,956,2041,2022-01-01,zipcode,Mobile
ZCTA5 36604,01,9080,58952,868,211700,7374,2563,6528,434,1592,1642,1640,1220,4962,3841,1121,3841,2254,1587,2022-01-01,zipcode,Mobile
ZCTA5 36605,01,25732,40802,995,95100,20148,9361,16787,2426,7052,4799,1560,950,12124,9752,2372,9752,4855,4897,2022-01-01,zipcode,Mobile
ZCTA5 36606,01,19672,50748,923,140800,14949,5126,13436,1802,4648,3200,2559,1227,9133,8144,989,8144,4099,4045,2022-01-01,zipcode,Mobile
ZCTA5 36607,01,5853,42389,885,111200,5126,2550,4561,686,1473,1117,929,356,3202,2514,688,2514,1398,1116,2022-01-01,zipcode,Mobile
ZCTA5 36608,01,36281,59400,992,205800,29408,11231,23986,1762,5504,6970,6011,3739,17664,15625,2039,15625,8218,7407,2022-01-01,zipcode,Mobile
ZCTA5 36609,01,23552,46173,991,179300,19296,6689,16192,1403,4324,5107,3418,1940,12761,11350,1411,11350,4787,6563,2022-01-01,zipcode,Mobile
ZCTA5 36610,01,10024,27464,674,52800,8027,4528,6846,1236,3089,1986,301,234,5338,3800,1538,3800,1730,2070,2022-01-01,zipcode,Mobile
ZCTA5 36611,01,6398,38985,871,89300,4839,1976,4007,468,1484,1567,389,99,2767,2379,388,2379,1134,1245,2022-01-01,zipcode,Mobile
ZCTA5 36612,01,3877,34575,733,75500,2771,1542,2367,589,949,552,143,134,1741,1369,372,1369,807,562,2022-01-01,zipcode,Mobile
ZCTA5 36613,01,12326,49056,1152,142100,9597,4952,7661,1239,2999,2411,532,480,5005,4002,1003,4002,2980,1022,2022-01-01,zipcode,Eight mile
ZCTA5 36615,01,0,-666666666,-666666666,-666666666,0,0,0,0,0,0,0,0,0,0,0,0,0,0,2022-01-01,zipcode,Mobile
ZCTA5 36617,01,12162,37379,1062,76600,10187,5626,8844,1228,3193,2899,1018,506,5847,4960,887,4960,2287,2673,2022-01-01,zipcode,Mobile
ZCTA5 36618,01,17386,52341,1055,141600,14213,5457,11449,1011,3207,4060,2037,1134,7332,6762,570,6762,4869,1893,2022-01-01,zipcode,Mobile
ZCTA5 36619,01,14658,57545,1031,157300,11891,4837,10250,1271,3211,3748,1365,655,6285,5646,639,5646,3919,1727,2022-01-01,zipcode,Mobile
ZCTA5 36688,01,1693,7609,608,-666666666,1693,1008,82,44,0,31,0,7,129,56,73,56,0,56,2022-01-01,zipcode,Mobile
ZCTA5 36693,01,18804,67048,1035,188100,15299,6096,13070,643,3580,4045,3205,1597,8805,7654,1151,7654,5226,2428,2022-01-01,zipcode,Mobile
ZCTA5 36695,01,51877,72825,1166,222700,39710,14202,34567,2064,9425,11598,7539,3941,20924,19596,1328,19596,13052,6544,2022-01-01,zipcode,Mobile
ZCTA5 36701,01,21940,41528,807,108400,17455,7291,14818,1692,5722,4408,1926,1070,10385,8222,2163,8222,4898,3324,2022-01-01,zipcode,Selma
ZCTA5 36703,01,10883,28337,666,61300,8999,5191,7677,1183,3243,2499,453,299,5708,4503,1205,4503,2654,1849,2022-01-01,zipcode,Selma
ZCTA5 36720,01,753,20536,-666666666,112800,576,372,460,103,304,39,8,6,343,260,83,260,240,20,2022-01-01,zipcode,Alberta
ZCTA5 36722,01,98,-666666666,-666666666,54800,82,44,82,7,8,67,0,0,188,70,118,70,46,24,2022-01-01,zipcode,Arlington
ZCTA5 36723,01,455,35625,-666666666,-666666666,347,213,146,51,31,64,0,0,277,117,160,117,104,13,2022-01-01,zipcode,Boykin
ZCTA5 36726,01,5016,38427,828,92200,3948,2197,3589,870,1208,947,394,170,2288,1653,635,1653,1278,375,2022-01-01,zipcode,Camden
ZCTA5 36727,01,168,-666666666,-666666666,9999,160,88,153,30,15,82,25,1,147,115,32,115,115,0,2022-01-01,zipcode,Campbell
ZCTA5 36728,01,604,18491,-666666666,47900,385,317,351,96,128,113,6,8,335,201,134,201,178,23,2022-01-01,zipcode,Catherine
ZCTA5 36732,01,7985,52524,681,184600,6401,2559,5594,309,1789,1701,1206,589,3985,3324,661,3324,1923,1401,2022-01-01,zipcode,Demopolis
ZCTA5 36736,01,1436,34500,1083,67900,767,525,692,157,203,157,10,165,485,354,131,354,313,41,2022-01-01,zipcode,Dixons mills
ZCTA5 36738,01,870,24609,726,77000,785,528,669,126,310,119,31,83,362,263,99,263,141,122,2022-01-01,zipcode,Faunsdale
ZCTA5 36740,01,1220,-666666666,702,60000,1054,657,795,142,332,176,112,33,685,421,264,421,304,117,2022-01-01,zipcode,Forkland
ZCTA5 36742,01,2801,43232,660,84000,2546,1599,1788,336,468,693,152,139,1263,998,265,998,820,178,2022-01-01,zipcode,Gallion
ZCTA5 36744,01,5703,29857,665,124800,4515,2285,4057,885,1737,844,428,163,3151,2359,792,2359,1600,759,2022-01-01,zipcode,Greensboro
ZCTA5 36748,01,2697,46149,729,93000,2316,1216,2053,246,875,680,133,119,1434,1020,414,1020,662,358,2022-01-01,zipcode,Linden
ZCTA5 36749,01,608,21651,-666666666,-666666666,532,344,469,127,213,129,0,0,377,260,117,260,166,94,2022-01-01,zipcode,Jones
ZCTA5 36750,01,2659,43846,954,153900,1885,838,1723,291,880,417,74,61,1135,974,161,974,838,136,2022-01-01,zipcode,Maplesville
ZCTA5 36751,01,416,41705,-666666666,23000,373,168,187,43,96,25,14,9,240,131,109,131,111,20,2022-01-01,zipcode,Lower peach tree
ZCTA5 36752,01,1081,42500,-666666666,137300,888,389,840,60,274,323,143,40,665,548,117,548,508,40,2022-01-01,zipcode,Lowndesboro
ZCTA5 36753,01,0,-666666666,-666666666,-666666666,0,0,0,0,0,0,0,0,0,0,0,0,0,0,2022-01-01,zipcode,Mc williams
ZCTA5 36754,01,284,-666666666,-666666666,-666666666,150,83,119,13,95,0,6,5,109,99,10,99,89,10,2022-01-01,zipcode,Magnolia
ZCTA5 36756,01,5570,37758,573,90700,4553,2915,3199,745,1334,605,323,192,2147,1746,401,1746,1175,571,2022-01-01,zipcode,Marion
ZCTA5 36758,01,1805,48276,760,85600,1166,531,1061,241,404,319,81,16,724,608,116,608,543,65,2022-01-01,zipcode,Plantersville
ZCTA5 36759,01,1683,27390,1574,58400,1335,598,1219,215,453,388,130,33,924,686,238,686,542,144,2022-01-01,zipcode,Marion junction
ZCTA5 36761,01,754,26528,785,51100,602,428,531,131,236,137,12,15,519,374,145,374,278,96,2022-01-01,zipcode,Minter
ZCTA5 36763,01,186,82917,-666666666,-666666666,182,117,173,11,127,27,4,4,91,59,32,59,57,2,2022-01-01,zipcode,Myrtlewood
ZCTA5 36765,01,1128,47984,-666666666,76300,928,524,827,134,462,179,45,7,546,442,104,442,402,40,2022-01-01,zipcode,Newbern
ZCTA5 36766,01,19,-666666666,-666666666,145000,19,12,19,5,0,0,9,5,27,13,14,13,8,5,2022-01-01,zipcode,Oak hill
ZCTA5 36767,01,1434,30608,346,82000,890,488,746,159,304,177,81,25,760,424,336,424,332,92,2022-01-01,zipcode,Orrville
ZCTA5 36768,01,1029,37614,935,-666666666,944,404,804,158,257,277,66,46,643,361,282,361,252,109,2022-01-01,zipcode,Pine apple
ZCTA5 36769,01,1927,40505,-666666666,76000,1521,917,1330,199,739,285,81,26,1074,783,291,783,621,162,2022-01-01,zipcode,Pine hill
ZCTA5 36773,01,283,32989,-666666666,-666666666,224,111,196,35,39,117,0,5,211,95,116,95,74,21,2022-01-01,zipcode,Safford
ZCTA5 36775,01,1117,55341,1117,97700,871,588,799,287,295,181,31,5,716,547,169,547,372,175,2022-01-01,zipcode,Sardis
ZCTA5 36776,01,1992,-666666666,-666666666,62200,1351,649,1047,205,306,306,145,85,835,582,253,582,459,123,2022-01-01,zipcode,Sawyerville
ZCTA5 36782,01,2004,58438,781,86700,1539,563,1263,100,467,557,97,42,1159,785,374,785,706,79,2022-01-01,zipcode,Sweet water
ZCTA5 36783,01,627,41944,488,74200,556,356,491,42,203,144,62,40,499,272,227,272,181,91,2022-01-01,zipcode,Thomaston
ZCTA5 36784,01,6112,49186,697,137100,4601,2170,3958,485,1861,1211,186,215,3100,2194,906,2194,1407,787,2022-01-01,zipcode,Thomasville
ZCTA5 36785,01,742,40515,1295,101900,621,318,598,72,283,202,36,5,529,363,166,363,291,72,2022-01-01,zipcode,Tyler
ZCTA5 36786,01,2055,24492,510,64900,1611,972,1493,290,640,346,138,79,1243,934,309,934,621,313,2022-01-01,zipcode,Uniontown
ZCTA5 36790,01,534,-666666666,240,155700,452,112,366,104,27,226,9,0,298,224,74,224,145,79,2022-01-01,zipcode,Stanton
ZCTA5 36792,01,800,33350,-666666666,-666666666,648,319,648,107,288,219,17,17,630,307,323,307,239,68,2022-01-01,zipcode,Randolph
ZCTA5 36793,01,859,92981,-666666666,153400,744,345,538,95,204,210,29,0,291,226,65,226,151,75,2022-01-01,zipcode,Lawley
ZCTA5 36801,01,23479,55728,872,193800,19154,7794,16502,1655,4651,4833,3260,2103,10901,9578,1323,9578,6084,3494,2022-01-01,zipcode,Opelika
ZCTA5 36804,01,19917,54504,738,138000,15768,6818,13349,1848,3465,4186,2382,1468,7943,7044,899,7044,5654,1390,2022-01-01,zipcode,Opelika
ZCTA5 36830,01,47050,63292,1004,322100,38932,14369,29446,994,3721,6680,9700,8351,22683,19684,2999,19684,10923,8761,2022-01-01,zipcode,Auburn
ZCTA5 36832,01,28917,32974,957,216000,24194,10111,13589,941,2696,3290,3111,3551,14049,10928,3121,10928,5113,5815,2022-01-01,zipcode,Auburn
ZCTA5 36849,01,5397,-666666666,-666666666,-666666666,5397,3689,32,0,0,22,10,0,0,0,0,0,0,0,2022-01-01,zipcode,Auburn university
ZCTA5 36850,01,2731,41611,589,63400,2222,1408,1988,485,836,496,113,58,1490,1108,382,1108,912,196,2022-01-01,zipcode,Camp hill
ZCTA5 36852,01,2281,73832,1070,184900,1568,599,1463,111,607,584,99,62,990,793,197,793,633,160,2022-01-01,zipcode,Cusseta
ZCTA5 36853,01,8579,60158,849,233000,7528,3965,6650,1026,1595,2453,1136,440,6086,3398,2688,3398,2664,734,2022-01-01,zipcode,Dadeville
ZCTA5 36854,01,15643,58324,990,130500,12558,4797,10675,1332,3992,3638,1236,477,7560,6074,1486,6074,4198,1876,2022-01-01,zipcode,Valley
ZCTA5 36855,01,1331,56220,973,157100,1180,572,1087,161,431,404,70,21,748,609,139,609,544,65,2022-01-01,zipcode,Five points
ZCTA5 36856,01,8769,66994,1597,224600,5942,2925,5331,687,965,2736,699,244,3000,2804,196,2804,2584,220,2022-01-01,zipcode,Fort mitchell
ZCTA5 36858,01,405,33750,-666666666,146200,302,181,302,42,123,75,21,41,221,204,17,204,182,22,2022-01-01,zipcode,Hatchechubbee
ZCTA5 36860,01,1710,46725,638,77600,1560,838,1322,249,434,479,90,70,954,715,239,715,544,171,2022-01-01,zipcode,Hurtsboro
ZCTA5 36861,01,2703,61563,702,238900,2414,1144,2218,454,677,579,275,233,2006,1098,908,1098,1014,84,2022-01-01,zipcode,Jacksons gap
ZCTA5 36862,01,5986,44014,599,139400,5023,2720,4638,981,1834,1226,472,125,2988,2329,659,2329,1782,547,2022-01-01,zipcode,Lafayette
ZCTA5 36863,01,12370,46120,724,105300,9949,4329,8647,1710,3228,2838,689,182,5580,4458,1122,4458,3177,1281,2022-01-01,zipcode,Lanett
ZCTA5 36865,01,46,62656,-666666666,-666666666,46,12,27,0,12,10,5,0,23,17,6,17,5,12,2022-01-01,zipcode,Loachapoka
ZCTA5 36866,01,4188,59086,550,96800,3444,1506,2961,724,994,896,239,108,1849,1551,298,1551,1165,386,2022-01-01,zipcode,Notasulga
ZCTA5 36867,01,21700,46401,938,175900,17265,6923,14341,1518,3914,5332,2120,1457,10474,8993,1481,8993,4121,4872,2022-01-01,zipcode,Phenix city
ZCTA5 36869,01,23052,47823,910,119800,18105,7266,15911,2856,4778,5860,1513,904,10603,9194,1409,9194,5507,3687,2022-01-01,zipcode,Phenix city
ZCTA5 36870,01,18812,69766,893,174100,15178,5729,13507,1185,3621,5500,1675,1526,7914,7259,655,7259,5970,1289,2022-01-01,zipcode,Phenix city
ZCTA5 36871,01,1027,41850,816,115500,853,532,777,275,290,105,58,49,605,417,188,417,373,44,2022-01-01,zipcode,Pittsview
ZCTA5 36874,01,10373,54478,914,170100,8250,3905,7358,811,2554,2490,954,549,4512,3929,583,3929,3539,390,2022-01-01,zipcode,Salem
ZCTA5 36875,01,3679,53735,701,186000,3035,1381,2628,205,696,1283,234,210,1665,1432,233,1432,1150,282,2022-01-01,zipcode,Seale
ZCTA5 36877,01,12933,62859,1043,189900,9830,3687,8040,1025,2065,3099,1091,760,4673,4099,574,4099,3240,859,2022-01-01,zipcode,Smiths station
ZCTA5 36879,01,3000,108015,707,288500,2438,931,2159,303,455,548,496,357,1038,986,52,986,840,146,2022-01-01,zipcode,Waverly
ZCTA5 36901,01,49,-666666666,-666666666,-666666666,49,44,49,18,31,0,0,0,95,39,56,39,39,0,2022-01-01,zipcode,Bellamy
ZCTA5 36904,01,4196,41419,658,121300,3430,1815,2979,344,1255,942,383,55,2167,1680,487,1680,1322,358,2022-01-01,zipcode,Butler
ZCTA5 36907,01,1572,32426,1271,87900,1380,932,1185,235,385,302,112,151,1057,795,262,795,685,110,2022-01-01,zipcode,Cuba
ZCTA5 36908,01,1885,64375,780,89600,1560,773,1254,187,424,405,200,38,1094,746,348,746,611,135,2022-01-01,zipcode,Gilbertown
ZCTA5 36910,01,14,-666666666,-666666666,-666666666,14,14,14,0,0,14,0,0,6,6,0,6,6,0,2022-01-01,zipcode,Jachin
ZCTA5 36912,01,1558,53000,1227,65100,1327,735,1186,149,289,602,56,90,908,598,310,598,525,73,2022-01-01,zipcode,Lisman
ZCTA5 36913,01,54,-666666666,-666666666,-666666666,54,54,54,40,0,14,0,0,25,25,0,25,25,0,2022-01-01,zipcode,Melvin
ZCTA5 36915,01,574,32941,-666666666,114800,474,251,431,63,227,121,19,1,355,280,75,280,213,67,2022-01-01,zipcode,Needham
ZCTA5 36916,01,689,28792,328,81100,538,302,467,97,144,206,8,12,409,296,113,296,233,63,2022-01-01,zipcode,Pennington
ZCTA5 36919,01,1764,51196,454,79700,1502,879,1305,266,637,294,67,41,938,708,230,708,555,153,2022-01-01,zipcode,Silas
ZCTA5 36921,01,919,26111,475,154700,831,532,681,238,233,170,40,0,696,524,172,524,461,63,2022-01-01,zipcode,Toxey
ZCTA5 36922,01,805,112778,-666666666,111000,602,286,485,177,153,123,32,0,392,224,168,224,224,0,2022-01-01,zipcode,Ward
ZCTA5 36925,01,2961,35481,545,49400,2398,1033,2191,219,658,955,240,119,1790,1397,393,1397,858,539,2022-01-01,zipcode,York
ZCTA5 75001,48,16633,77598,1620,414900,14872,2684,13005,594,1370,3537,4875,2629,10370,9355,1015,9355,1449,7906,2022-01-01,zipcode,Addison
ZCTA5 75002,48,72679,119301,1827,372100,56113,18339,46683,2320,7041,13215,16165,7942,23724,22731,993,22731,17980,4751,2022-01-01,zipcode,Allen
ZCTA5 75006,48,48062,79672,1453,278300,38515,10109,32986,5468,8072,8521,7733,3192,19226,18491,735,18491,9564,8927,2022-01-01,zipcode,Carrollton
ZCTA5 75007,48,54498,105969,1479,332900,46340,12634,40005,3469,7485,11762,12001,5288,20990,20170,820,20170,13807,6363,2022-01-01,zipcode,Carrollton
ZCTA5 75009,48,28109,153658,1806,434500,20895,6731,18069,865,2956,5325,6690,2233,8765,8507,258,8507,7692,815,2022-01-01,zipcode,Celina
ZCTA5 75010,48,31609,98567,1685,390300,26220,6110,22960,1326,3164,6413,8045,4012,13569,12616,953,12616,6157,6459,2022-01-01,zipcode,Carrollton
ZCTA5 75013,48,46649,149549,1681,487700,36020,9214,31098,1202,3112,7252,10514,9018,17551,16562,989,16562,10797,5765,2022-01-01,zipcode,Allen
ZCTA5 75019,48,44706,136679,1698,488900,34092,8645,30000,774,2591,5579,11443,9613,17329,16923,406,16923,11058,5865,2022-01-01,zipcode,Coppell
ZCTA5 75020,48,24486,64734,1055,165400,18929,7950,16359,1416,5045,6570,2151,1177,10780,9509,1271,9509,5791,3718,2022-01-01,zipcode,Denison
ZCTA5 75021,48,8925,61198,758,178600,7158,2950,6290,713,2356,2194,754,273,3816,3373,443,3373,2740,633,2022-01-01,zipcode,Denison
ZCTA5 75022,48,27000,179892,1918,574200,20989,6611,17413,537,1968,3073,7418,4417,9329,9029,300,9029,7695,1334,2022-01-01,zipcode,Flower mound
ZCTA5 75023,48,49376,101246,1789,359600,40584,11814,34787,2266,4634,9329,12558,6000,19139,18408,731,18408,11513,6895,2022-01-01,zipcode,Plano
ZCTA5 75024,48,43520,114623,1748,519000,35098,9226,30411,713,3056,5439,12290,8913,19756,17915,1841,17915,6921,10994,2022-01-01,zipcode,Plano
ZCTA5 75025,48,54201,134740,1856,438600,42382,12607,36206,1507,4695,6515,12575,10914,19081,18492,589,18492,12338,6154,2022-01-01,zipcode,Plano
ZCTA5 75028,48,47751,143712,2081,427900,37126,10046,32762,710,3705,7961,14150,6236,17841,17404,437,17404,14125,3279,2022-01-01,zipcode,Flower mound
ZCTA5 75032,48,36514,132756,1871,439200,28210,8993,23672,1175,4364,6557,7079,4497,12757,12283,474,12283,9944,2339,2022-01-01,zipcode,Rockwall
ZCTA5 75034,48,48749,104323,1613,639900,39501,10305,33206,1297,3571,6887,12181,9270,22307,20853,1454,20853,8526,12327,2022-01-01,zipcode,Frisco
ZCTA5 75035,48,83930,154811,2064,500500,62098,16704,52801,1905,4877,10813,20079,15127,28240,26920,1320,26920,20411,6509,2022-01-01,zipcode,Frisco
ZCTA5 75038,48,32559,69678,1373,349800,25521,5706,22177,1546,4269,6407,6089,3866,14822,13716,1106,13716,2821,10895,2022-01-01,zipcode,Irving
ZCTA5 75039,48,21795,100474,1765,574100,18499,3329,17045,162,1024,2880,7041,5938,12597,11306,1291,11306,1725,9581,2022-01-01,zipcode,Irving
ZCTA5 75040,48,63143,70592,1494,221800,48901,15483,40630,9980,10119,11733,5667,3131,21023,20062,961,20062,13777,6285,2022-01-01,zipcode,Garland
ZCTA5 75041,48,31344,62744,1266,193700,23518,7471,18320,6077,5163,4556,1889,635,10388,9728,660,9728,5736,3992,2022-01-01,zipcode,Garland
ZCTA5 75042,48,37925,60118,1239,200600,28314,8924,22836,7051,5922,5927,2626,1310,11908,11471,437,11471,6735,4736,2022-01-01,zipcode,Garland
ZCTA5 75043,48,64296,72079,1399,236300,50531,15949,41258,7131,10073,14534,6058,3462,23276,22026,1250,22026,13158,8868,2022-01-01,zipcode,Garland
ZCTA5 75044,48,47010,84016,1625,282000,37138,10865,31419,2921,6985,9038,8070,4405,16936,16357,579,16357,10068,6289,2022-01-01,zipcode,Garland
ZCTA5 75048,48,28210,126792,1677,328700,22726,6266,19294,1073,4048,5834,5415,2924,9918,9725,193,9725,8584,1141,2022-01-01,zipcode,Sachse
ZCTA5 75050,48,43856,68421,1334,195300,34255,9450,28039,5973,8575,7509,3996,1986,17038,16155,883,16155,6985,9170,2022-01-01,zipcode,Grand prairie
ZCTA5 75051,48,40166,49485,1144,172200,29861,10516,24014,8119,7898,5085,2093,819,14178,13290,888,13290,6214,7076,2022-01-01,zipcode,Grand prairie
ZCTA5 75052,48,94636,84055,1611,252000,72259,20650,59870,8105,14756,18907,12768,5334,32641,30996,1645,30996,20659,10337,2022-01-01,zipcode,Grand prairie
ZCTA5 75054,48,17261,154412,1738,408700,12496,3777,10459,428,902,3017,3619,2493,4941,4941,0,4941,4573,368,2022-01-01,zipcode,Grand prairie
ZCTA5 75056,48,65785,111589,1679,386400,53437,11695,47240,2414,7077,12881,16493,8375,27692,26243,1449,26243,15664,10579,2022-01-01,zipcode,The colony
ZCTA5 75057,48,17280,73935,1483,194900,12797,2973,10800,2189,2699,2826,2164,922,7101,6583,518,6583,2531,4052,2022-01-01,zipcode,Lewisville
ZCTA5 75058,48,3801,113194,1403,453400,2863,849,2295,277,378,648,707,285,1329,1167,162,1167,971,196,2022-01-01,zipcode,Gunter
ZCTA5 75060,48,48997,67479,1320,203700,36650,12311,29573,10755,7241,5810,3940,1827,15399,14516,883,14516,9310,5206,2022-01-01,zipcode,Irving
ZCTA5 75061,48,56319,58236,1196,202900,42043,11598,34195,12183,9106,7397,4015,1494,20055,18697,1358,18697,7391,11306,2022-01-01,zipcode,Irving
ZCTA5 75062,48,52772,68692,1306,234600,40100,11030,32169,8104,6113,7194,7645,3113,18659,17665,994,17665,7248,10417,2022-01-01,zipcode,Irving
ZCTA5 75063,48,44570,106909,1562,458900,33787,9468,29765,1026,2512,4779,11389,10059,18550,17497,1053,17497,6529,10968,2022-01-01,zipcode,Irving
ZCTA5 75065,48,12787,95403,1594,269200,10412,2426,8664,1215,1849,2626,2135,839,4927,4646,281,4646,3444,1202,2022-01-01,zipcode,Lake dallas
ZCTA5 75067,48,67117,75224,1425,292600,53691,12388,46525,5655,10574,14318,11416,4562,28733,27074,1659,27074,10037,17037,2022-01-01,zipcode,Lewisville
ZCTA5 75068,48,68074,119464,2062,358500,49784,13046,43705,3807,7829,13516,11911,6642,22408,21699,709,21699,17812,3887,2022-01-01,zipcode,Little elm
ZCTA5 75069,48,39048,74967,1438,379100,31521,11879,26091,3619,6019,6998,6117,3338,16657,15279,1378,15279,8057,7222,2022-01-01,zipcode,Mckinney
ZCTA5 75070,48,57516,101188,1712,392000,44014,11538,36747,747,4975,9798,14032,7195,23143,21648,1495,21648,11777,9871,2022-01-01,zipcode,Mckinney
ZCTA5 75071,48,66298,124763,1946,415600,49805,15269,43721,2496,7577,12117,14357,7174,22921,21977,944,21977,16691,5286,2022-01-01,zipcode,Mckinney
ZCTA5 75074,48,51443,78441,1544,322100,40981,12673,33498,5092,5417,8992,8716,5281,18673,17979,694,17979,9525,8454,2022-01-01,zipcode,Plano
ZCTA5 75075,48,37032,89081,1561,366500,30878,10245,26830,1935,3922,7465,8623,4885,15640,14600,1040,14600,8715,5885,2022-01-01,zipcode,Plano
ZCTA5 75076,48,8536,71910,1378,222500,7231,2492,6483,329,2167,2715,974,298,4424,3407,1017,3407,2698,709,2022-01-01,zipcode,Pottsboro
ZCTA5 75077,48,39853,120254,1681,398100,31954,10236,27047,803,4224,8567,9788,3665,14203,13801,402,13801,11175,2626,2022-01-01,zipcode,Lewisville
ZCTA5 75078,48,40513,178254,2089,582500,28859,8085,24855,714,2658,5227,10407,5849,12841,11942,899,11942,10721,1221,2022-01-01,zipcode,Prosper
ZCTA5 75080,48,52184,86341,1708,386600,41975,13546,31606,2314,4042,7229,10841,7180,20303,19011,1292,19011,10102,8909,2022-01-01,zipcode,Richardson
ZCTA5 75081,48,36493,88161,1646,323700,29118,8348,25445,2868,3577,7741,7113,4146,14675,14005,670,14005,7132,6873,2022-01-01,zipcode,Richardson
ZCTA5 75082,48,29386,108869,1813,449900,25168,6521,21520,687,1792,4737,7725,6579,12799,12184,615,12184,6109,6075,2022-01-01,zipcode,Richardson
ZCTA5 75087,48,40201,124583,1556,373500,30704,8964,26447,948,3654,8502,8502,4841,14683,14195,488,14195,11701,2494,2022-01-01,zipcode,Rockwall
ZCTA5 75088,48,27143,101995,1899,291100,22078,6335,19240,1172,5171,6253,4445,2199,9822,9676,146,9676,7556,2120,2022-01-01,zipcode,Rowlett
ZCTA5 75089,48,34974,119332,1724,313100,27361,7709,23426,1803,4403,7597,6615,3008,11949,11364,585,11364,9051,2313,2022-01-01,zipcode,Rowlett
ZCTA5 75090,48,25788,56323,992,139300,19520,7442,16280,2539,5609,5823,1558,751,9729,8618,1111,8618,5420,3198,2022-01-01,zipcode,Sherman
ZCTA5 75092,48,26588,62741,1143,231600,22044,7642,18656,1241,4424,7382,3481,2128,12551,11598,953,11598,6401,5197,2022-01-01,zipcode,Sherman
ZCTA5 75093,48,47069,121360,1698,588600,38613,13394,34647,822,3014,6693,13981,10137,20701,19475,1226,19475,11464,8011,2022-01-01,zipcode,Plano
ZCTA5 75094,48,23370,152461,2454,451700,17013,5665,13906,759,2006,3671,3917,3553,6441,6384,57,6384,5814,570,2022-01-01,zipcode,Plano
ZCTA5 75098,48,65655,112198,1844,328200,49984,13061,41029,3468,7560,13167,11455,5379,21772,20779,993,20779,16362,4417,2022-01-01,zipcode,Wylie
ZCTA5 75101,48,668,50455,1105,88600,520,197,413,133,164,85,27,4,240,216,24,216,117,99,2022-01-01,zipcode,Bardwell
ZCTA5 75102,48,1877,65850,1046,123400,1503,610,1277,278,323,483,132,61,717,581,136,581,489,92,2022-01-01,zipcode,Barry
ZCTA5 75103,48,16372,67878,1074,208800,13317,6241,11979,1218,3927,4510,1609,715,6997,6205,792,6205,4981,1224,2022-01-01,zipcode,Canton
ZCTA5 75104,48,49291,84760,1677,247100,37280,11295,31152,2893,7533,11699,5714,3313,16831,16240,591,16240,11470,4770,2022-01-01,zipcode,Cedar hill
ZCTA5 75105,48,154,-666666666,-666666666,-666666666,98,12,80,3,34,13,30,0,98,47,51,47,44,3,2022-01-01,zipcode,Chatfield
ZCTA5 75109,48,4466,73021,1295,151800,3571,1616,3229,442,1062,1098,450,177,1995,1593,402,1593,1379,214,2022-01-01,zipcode,Corsicana
ZCTA5 75110,48,31008,51048,976,151400,23753,9075,19186,4256,5459,6382,1936,1153,11815,10541,1274,10541,6252,4289,2022-01-01,zipcode,Corsicana
ZCTA5 75114,48,7123,96484,1471,236900,5411,1829,4629,707,1291,1802,619,210,2444,2281,163,2281,2014,267,2022-01-01,zipcode,Crandall
ZCTA5 75115,48,56012,81895,1414,258200,44958,14297,38546,3023,9231,14738,6445,5109,21644,20429,1215,20429,14338,6091,2022-01-01,zipcode,Desoto
ZCTA5 75116,48,20145,57245,1339,192300,15543,5992,12987,2557,3823,4102,1715,790,7349,6907,442,6907,4203,2704,2022-01-01,zipcode,Duncanville
ZCTA5 75117,48,4576,93373,1094,184100,3332,1178,2770,120,899,1340,311,100,1746,1510,236,1510,1206,304,2022-01-01,zipcode,Edgewood
ZCTA5 75119,48,29509,77225,1168,213800,22799,6866,18836,3524,5807,5833,2867,805,11026,10230,796,10230,7133,3097,2022-01-01,zipcode,Ennis
ZCTA5 75124,48,5822,76013,863,157200,4645,2391,3788,403,1311,1309,611,154,2295,1883,412,1883,1615,268,2022-01-01,zipcode,Eustace
ZCTA5 75125,48,6920,63684,1098,157400,4944,1725,4333,1546,1052,1254,315,166,2292,2162,130,2162,1655,507,2022-01-01,zipcode,Ferris
ZCTA5 75126,48,67852,101456,1786,301500,49129,12187,41246,3294,8539,15249,10089,4075,22056,21282,774,21282,17095,4187,2022-01-01,zipcode,Forney
ZCTA5 75127,48,1781,58330,691,194300,1442,828,1272,347,521,215,104,85,849,745,104,745,616,129,2022-01-01,zipcode,Fruitvale
ZCTA5 75132,48,0,-666666666,-666666666,-666666666,0,0,0,0,0,0,0,0,0,0,0,0,0,0,2022-01-01,zipcode,Fate
ZCTA5 75134,48,20179,65114,1483,189400,14634,4453,12197,1698,3339,4628,1492,1040,7084,6849,235,6849,5128,1721,2022-01-01,zipcode,Lancaster
ZCTA5 75135,48,8515,88369,1250,303400,6460,2126,5369,371,1756,1968,804,470,2856,2683,173,2683,2261,422,2022-01-01,zipcode,Caddo mills
ZCTA5 75137,48,20013,81160,1727,238800,15441,5699,12876,1955,3571,3722,2294,1334,7232,6742,490,6742,4582,2160,2022-01-01,zipcode,Duncanville
ZCTA5 75140,48,7933,44091,859,117300,6485,3255,5509,1242,2045,1460,573,189,3359,2894,465,2894,2297,597,2022-01-01,zipcode,Grand saline
ZCTA5 75141,48,4510,45213,1440,-666666666,3137,1122,2401,645,908,638,150,60,1380,1327,53,1327,622,705,2022-01-01,zipcode,Hutchins
ZCTA5 75142,48,22756,75072,1121,171400,16789,5766,14018,3350,5308,3608,1337,415,7664,6996,668,6996,5282,1714,2022-01-01,zipcode,Kaufman
ZCTA5 75143,48,14584,64178,1085,146500,11506,5084,10162,1627,3899,2934,1306,396,7171,5475,1696,5475,4517,958,2022-01-01,zipcode,Kemp
ZCTA5 75144,48,3883,60154,805,150800,3048,1465,2679,318,840,925,389,207,1591,1304,287,1304,995,309,2022-01-01,zipcode,Kerens
ZCTA5 75146,48,24089,68001,1502,216300,17205,5260,14795,1565,4406,5194,2327,1303,9121,8493,628,8493,4966,3527,2022-01-01,zipcode,Lancaster
ZCTA5 75147,48,8239,49167,989,205300,6449,2476,5188,703,1719,1975,577,214,3273,2828,445,2828,1957,871,2022-01-01,zipcode,Mabank
ZCTA5 75148,48,6143,57917,857,152600,5091,2412,4480,561,1475,1531,687,226,3556,2550,1006,2550,1877,673,2022-01-01,zipcode,Malakoff
ZCTA5 75149,48,59371,64858,1314,184800,44425,14149,36600,8153,12106,11567,3182,1592,20894,19826,1068,19826,12921,6905,2022-01-01,zipcode,Mesquite
ZCTA5 75150,48,63895,66265,1322,206800,49212,14371,40518,7989,12206,12778,5238,2307,24626,22931,1695,22931,11467,11464,2022-01-01,zipcode,Mesquite
ZCTA5 75152,48,5859,81772,1461,156900,4524,1450,3645,508,1328,1129,489,191,2067,1914,153,1914,1519,395,2022-01-01,zipcode,Palmer
ZCTA5 75153,48,568,95066,1281,136300,438,148,418,125,52,86,100,55,230,165,65,165,102,63,2022-01-01,zipcode,Powell
ZCTA5 75154,48,48510,95035,1362,267700,37341,11788,30900,3451,8688,9765,5963,3033,16225,15535,690,15535,13199,2336,2022-01-01,zipcode,Red oak
ZCTA5 75155,48,3142,56912,960,112500,2253,899,1829,511,742,428,127,21,1072,960,112,960,784,176,2022-01-01,zipcode,Rice
ZCTA5 75156,48,16262,52464,928,191600,13635,7026,11995,1928,4181,4000,1259,627,8950,6764,2186,6764,5027,1737,2022-01-01,zipcode,Mabank
ZCTA5 75157,48,216,-666666666,914,82000,182,72,172,30,78,56,3,5,95,92,3,92,66,26,2022-01-01,zipcode,Rosser
ZCTA5 75158,48,6202,88125,1095,268200,4802,1823,4034,613,1304,1231,632,254,1969,1869,100,1869,1649,220,2022-01-01,zipcode,Scurry
ZCTA5 75159,48,22751,69301,1219,204000,17262,7490,14630,3774,4835,4023,1512,486,6971,6469,502,6469,5151,1318,2022-01-01,zipcode,Seagoville
ZCTA5 75160,48,25964,67102,1155,186600,20085,7626,16888,2734,5688,5128,2235,1103,9286,8719,567,8719,5956,2763,2022-01-01,zipcode,Terrell
ZCTA5 75161,48,6468,74932,910,198700,5637,2110,5255,886,2013,1792,421,143,2474,2388,86,2388,1915,473,2022-01-01,zipcode,Terrell
ZCTA5 75163,48,2540,54741,731,185600,2198,1249,2052,280,654,715,279,124,1588,1204,384,1204,986,218,2022-01-01,zipcode,Trinidad
ZCTA5 75164,48,430,52736,1313,202100,412,223,332,49,171,112,0,0,188,175,13,175,158,17,2022-01-01,zipcode,Josephine
ZCTA5 75165,48,48970,83970,1371,274300,37966,12731,31480,2887,8430,11549,5750,2864,18105,17069,1036,17069,11123,5946,2022-01-01,zipcode,Waxahachie
ZCTA5 75166,48,5762,123653,1737,331700,4304,874,3762,135,828,1499,855,445,1887,1887,0,1887,1681,206,2022-01-01,zipcode,Lavon
ZCTA5 75167,48,13421,117254,1862,355300,10381,2752,8748,962,1984,2872,2016,914,4282,4176,106,4176,3768,408,2022-01-01,zipcode,Waxahachie
ZCTA5 75169,48,15361,56445,929,159000,12056,5267,10308,1891,3385,3613,966,453,6588,5900,688,5900,4492,1408,2022-01-01,zipcode,Wills point
ZCTA5 75172,48,5378,63003,1199,87100,4103,1451,3475,1294,980,966,142,93,1870,1766,104,1766,1143,623,2022-01-01,zipcode,Wilmer
ZCTA5 75173,48,9296,96636,1297,285300,7127,2202,5907,596,2235,2015,793,268,3050,2664,386,2664,2521,143,2022-01-01,zipcode,Nevada
ZCTA5 75180,48,27050,57827,1166,183800,19839,6400,15972,4832,4979,4865,949,347,8776,8112,664,8112,4980,3132,2022-01-01,zipcode,Balch springs
ZCTA5 75181,48,27980,107734,1463,256900,19745,5714,16181,2059,4144,6352,2303,1323,8255,7951,304,7951,7119,832,2022-01-01,zipcode,Mesquite
ZCTA5 75182,48,7873,152632,999,496500,6008,1705,5122,197,713,1155,1691,1366,2694,2624,70,2624,2218,406,2022-01-01,zipcode,Sunnyvale
ZCTA5 75189,48,38261,114068,1732,314300,28975,8560,24762,2030,6895,8941,4862,2034,13454,12919,535,12919,11621,1298,2022-01-01,zipcode,Royse city
ZCTA5 75201,48,17985,102891,1923,649900,17305,2165,14709,411,1609,2486,5972,4231,12836,11514,1322,11514,1314,10200,2022-01-01,zipcode,Dallas
ZCTA5 75202,48,2421,113843,2002,297600,2323,365,2132,50,141,452,871,618,1895,1578,317,1578,437,1141,2022-01-01,zipcode,Dallas
ZCTA5 75203,48,16265,43376,1070,116500,12289,4622,10243,3477,2789,2095,1005,877,7009,6204,805,6204,2221,3983,2022-01-01,zipcode,Dallas
ZCTA5 75204,48,31627,88142,1736,435100,29374,4672,24549,1260,1554,4446,10261,7028,22025,19316,2709,19316,3947,15369,2022-01-01,zipcode,Dallas
ZCTA5 75205,48,25212,180698,2203,1412600,20709,8098,14895,172,460,1545,6532,6186,10454,9226,1228,9226,5506,3720,2022-01-01,zipcode,Dallas
ZCTA5 75206,48,38432,84784,1610,514900,34064,6076,28926,1175,1765,4513,13979,7494,25408,21567,3841,21567,6126,15441,2022-01-01,zipcode,Dallas
ZCTA5 75207,48,8029,88655,1807,-666666666,8027,5156,7063,1380,1858,1621,1315,889,2446,2335,111,2335,24,2311,2022-01-01,zipcode,Dallas
ZCTA5 75208,48,29992,75699,1408,382400,24613,6562,21450,5330,3764,3968,4963,3425,13207,12159,1048,12159,6733,5426,2022-01-01,zipcode,Dallas
ZCTA5 75209,48,14208,116477,1715,762100,11898,3167,10949,445,1205,1567,4529,3203,7466,6753,713,6753,4183,2570,2022-01-01,zipcode,Dallas
ZCTA5 75210,48,8750,26822,910,90900,5851,2527,4579,1482,1666,1204,146,81,3215,2849,366,2849,832,2017,2022-01-01,zipcode,Dallas
ZCTA5 75211,48,73948,53614,1129,168000,56024,20334,42658,16879,12018,8123,3989,1649,24116,22587,1529,22587,12031,10556,2022-01-01,zipcode,Dallas
ZCTA5 75212,48,27045,47089,1022,163300,19884,7750,15560,5819,4649,2823,1616,653,8951,8401,550,8401,4574,3827,2022-01-01,zipcode,Dallas
ZCTA5 75214,48,34015,115304,1453,649700,27398,6387,24669,1180,2127,3902,10415,7045,17058,15398,1660,15398,8666,6732,2022-01-01,zipcode,Dallas
ZCTA5 75215,48,18950,39486,1111,100900,14833,5692,12341,2882,4170,3166,1304,819,8487,7356,1131,7356,2256,5100,2022-01-01,zipcode,Dallas
ZCTA5 75216,48,55085,33889,1079,106800,40515,19396,33240,10153,12639,7670,2147,631,20665,18776,1889,18776,10279,8497,2022-01-01,zipcode,Dallas
ZCTA5 75217,48,87154,49841,1114,141000,60405,25734,46558,19873,15442,8759,1999,485,25396,23868,1528,23868,13936,9932,2022-01-01,zipcode,Dallas
ZCTA5 75218,48,21393,104026,1499,447100,17502,4871,16211,1216,1992,2971,5707,4325,10356,9540,816,9540,6196,3344,2022-01-01,zipcode,Dallas
ZCTA5 75219,48,24797,86826,1672,383500,23221,3977,20801,1071,1447,3467,8671,6145,19273,16456,2817,16456,5153,11303,2022-01-01,zipcode,Dallas
ZCTA5 75220,48,40327,56849,1085,400500,29784,7633,24648,10210,5578,3618,3369,1873,15635,14128,1507,14128,4338,9790,2022-01-01,zipcode,Dallas
ZCTA5 75223,48,13174,66875,1286,223500,10496,3060,8593,3079,1931,1489,1366,728,5036,4478,558,4478,2165,2313,2022-01-01,zipcode,Dallas
ZCTA5 75224,48,35903,50061,1113,190000,27048,10982,22190,7530,7166,4284,2138,1072,12423,11701,722,11701,6110,5591,2022-01-01,zipcode,Dallas
ZCTA5 75225,48,21965,180181,2156,1396500,17259,7817,15685,154,710,1670,7572,5579,9699,8944,755,8944,6849,2095,2022-01-01,zipcode,Dallas
ZCTA5 75226,48,5108,67612,1590,-666666666,4813,1187,4160,718,852,1126,948,516,2910,2631,279,2631,160,2471,2022-01-01,zipcode,Dallas
ZCTA5 75227,48,58315,54743,1183,170100,43729,16682,35010,10890,11222,8419,3301,1178,19692,18746,946,18746,10684,8062,2022-01-01,zipcode,Dallas
ZCTA5 75228,48,68472,55848,1144,230900,50957,17995,41170,11266,12399,9613,5254,2638,27130,24158,2972,24158,11659,12499,2022-01-01,zipcode,Dallas
ZCTA5 75229,48,32885,117083,1424,540900,25349,6862,21975,4232,3315,3519,5983,4926,12410,11442,968,11442,7954,3488,2022-01-01,zipcode,Dallas
ZCTA5 75230,48,26503,109589,1291,792100,22747,8409,20621,524,1746,4507,7320,6524,14615,13069,1546,13069,7980,5089,2022-01-01,zipcode,Dallas
ZCTA5 75231,48,39158,50603,1141,445300,30433,7265,25994,5086,5829,6089,6084,2906,21448,17702,3746,17702,3001,14701,2022-01-01,zipcode,Dallas
ZCTA5 75232,48,33333,52739,1212,188800,26006,11665,21948,4464,7630,5243,2921,1690,11566,11294,272,11294,7643,3651,2022-01-01,zipcode,Dallas
ZCTA5 75233,48,15876,61750,1197,230600,11157,3897,9253,2403,2255,2569,1314,712,4940,4809,131,4809,2587,2222,2022-01-01,zipcode,Dallas
ZCTA5 75234,48,33838,85105,1623,281300,26745,6727,22443,4598,4543,4883,5753,2666,13691,12179,1512,12179,7066,5113,2022-01-01,zipcode,Dallas
ZCTA5 75235,48,18936,57744,1526,244500,15718,3900,13098,2901,2456,2300,2533,2908,9621,8904,717,8904,1892,7012,2022-01-01,zipcode,Dallas
ZCTA5 75236,48,18249,45739,1182,194600,12991,3708,10750,2644,2605,3429,1321,751,7357,6747,610,6747,2265,4482,2022-01-01,zipcode,Dallas
ZCTA5 75237,48,19530,38552,1141,173900,13501,3947,10973,1713,3777,3666,1330,487,8989,7959,1030,7959,1017,6942,2022-01-01,zipcode,Dallas
ZCTA5 75238,48,32180,71352,1194,478000,24365,6585,21460,1906,3813,4772,6522,4447,14269,13108,1161,13108,6550,6558,2022-01-01,zipcode,Dallas
ZCTA5 75240,48,26058,51607,1247,314400,19723,4947,16006,4396,3520,2916,3616,1558,11949,10496,1453,10496,2485,8011,2022-01-01,zipcode,Dallas
ZCTA5 75241,48,33081,45356,1152,145000,24640,12577,20654,4199,7123,6810,1622,900,11464,10554,910,10554,6853,3701,2022-01-01,zipcode,Dallas
ZCTA5 75243,48,63047,47319,1162,341100,49268,14040,41972,5812,9443,12829,8707,5181,31253,27520,3733,27520,7163,20357,2022-01-01,zipcode,Dallas
ZCTA5 75244,48,12734,109440,1749,527800,10507,2479,9400,419,774,1726,3844,2637,6417,5726,691,5726,2939,2787,2022-01-01,zipcode,Dallas
ZCTA5 75246,48,2265,42429,980,445600,1965,640,1844,411,410,620,282,121,1513,1254,259,1254,197,1057,2022-01-01,zipcode,Dallas
ZCTA5 75247,48,992,18750,1233,-666666666,925,602,897,258,229,303,37,70,356,341,15,341,0,341,2022-01-01,zipcode,Dallas
ZCTA5 75248,48,37282,98584,1523,505700,30831,8599,27499,919,2660,6139,10352,7429,18521,16721,1800,16721,8915,7806,2022-01-01,zipcode,Dallas
ZCTA5 75249,48,17853,79162,1788,239400,12480,3295,10584,1220,2710,3599,2175,880,5326,5226,100,5226,3761,1465,2022-01-01,zipcode,Dallas
ZCTA5 75251,48,3801,85294,1660,-666666666,3473,629,2723,86,175,792,1283,387,2917,2262,655,2262,0,2262,2022-01-01,zipcode,Dallas
ZCTA5 75252,48,27541,77147,1240,484000,23181,7291,20089,804,1997,4368,7350,5570,14409,12617,1792,12617,5762,6855,2022-01-01,zipcode,Dallas
ZCTA5 75253,48,24411,51642,1330,113900,16729,5774,12356,4718,3757,2770,717,394,7027,6699,328,6699,4536,2163,2022-01-01,zipcode,Dallas
ZCTA5 75254,48,24316,70901,1398,286400,19575,3442,16526,1600,2576,4102,5363,2885,13792,11663,2129,11663,2568,9095,2022-01-01,zipcode,Dallas
ZCTA5 75270,48,0,-666666666,-666666666,-666666666,0,0,0,0,0,0,0,0,0,0,0,0,0,0,2022-01-01,zipcode,Dallas
ZCTA5 75287,48,52240,60256,1286,379600,43901,10356,38641,2404,6768,11184,12123,6162,29586,26763,2823,26763,6202,20561,2022-01-01,zipcode,Dallas
ZCTA5 75390,48,0,-666666666,-666666666,-666666666,0,0,0,0,0,0,0,0,0,0,0,0,0,0,2022-01-01,zipcode,Dallas
ZCTA5 75401,48,21000,51882,1106,133700,16026,5648,14045,2571,6041,3621,1301,511,8759,7883,876,7883,4146,3737,2022-01-01,zipcode,Greenville
ZCTA5 75402,48,20299,78277,1325,219900,16224,5845,13892,941,4382,4272,2851,1446,8173,7406,767,7406,4770,2636,2022-01-01,zipcode,Greenville
ZCTA5 75407,48,26607,87839,1630,270000,20094,6081,16450,2169,5201,5423,2729,928,9064,8574,490,8574,6764,1810,2022-01-01,zipcode,Princeton
ZCTA5 75409,48,22249,89444,1881,275700,17129,5139,14203,1409,3830,3696,3971,1297,8045,7456,589,7456,6007,1449,2022-01-01,zipcode,Anna
ZCTA5 75410,48,4196,77778,900,174200,3742,2055,3563,580,1398,943,510,132,2509,2004,505,2004,1786,218,2022-01-01,zipcode,Alba
ZCTA5 75411,48,875,47857,774,206800,650,336,577,72,344,88,73,0,547,358,189,358,142,216,2022-01-01,zipcode,Arthur city
ZCTA5 75412,48,512,62000,-666666666,100500,431,167,375,28,71,203,32,41,297,216,81,216,163,53,2022-01-01,zipcode,Bagwell
ZCTA5 75413,48,187,-666666666,-666666666,66700,172,80,151,68,48,35,0,0,88,71,17,71,52,19,2022-01-01,zipcode,Bailey
ZCTA5 75414,48,3284,78776,848,212800,2383,748,2086,102,614,853,426,91,1423,1256,167,1256,970,286,2022-01-01,zipcode,Bells
ZCTA5 75415,48,302,115446,-666666666,-666666666,268,113,228,11,94,57,55,11,131,127,4,127,119,8,2022-01-01,zipcode,Ben franklin
ZCTA5 75416,48,2865,70000,855,139000,2235,885,2040,151,627,603,486,173,1287,1182,105,1182,984,198,2022-01-01,zipcode,Blossom
ZCTA5 75417,48,2357,53370,1193,120100,1786,880,1631,344,568,534,103,82,1190,948,242,948,689,259,2022-01-01,zipcode,Bogata
ZCTA5 75418,48,14473,58790,1012,176600,12218,6687,10720,1760,3809,2958,1269,924,5557,4867,690,4867,3422,1445,2022-01-01,zipcode,Bonham
ZCTA5 75420,48,1364,59826,826,130400,1056,346,871,147,292,253,128,51,620,573,47,573,491,82,2022-01-01,zipcode,Brashear
ZCTA5 75421,48,847,57688,850,121000,506,191,443,178,176,65,0,24,345,249,96,249,233,16,2022-01-01,zipcode,Brookston
ZCTA5 75422,48,2826,65093,1115,177800,2326,988,2097,335,683,558,335,186,1275,1134,141,1134,888,246,2022-01-01,zipcode,Campbell
ZCTA5 75423,48,3024,55288,886,140300,2313,974,2026,192,809,826,145,54,1265,1091,174,1091,884,207,2022-01-01,zipcode,Celeste
ZCTA5 75424,48,3483,85364,1550,271300,2659,1012,2350,383,808,825,228,106,1308,1204,104,1204,1058,146,2022-01-01,zipcode,Blue ridge
ZCTA5 75426,48,3793,39203,617,72000,3276,1917,2980,372,1326,931,248,103,2390,1665,725,1665,1162,503,2022-01-01,zipcode,Clarksville
ZCTA5 75428,48,11398,51205,920,127500,9314,3829,5972,640,1904,2035,847,546,4504,3812,692,3812,1950,1862,2022-01-01,zipcode,Commerce
ZCTA5 75431,48,1841,42201,811,124600,1444,740,1282,432,486,291,56,17,720,583,137,583,389,194,2022-01-01,zipcode,Como
ZCTA5 75432,48,3115,64286,881,156500,2381,877,2023,231,624,594,358,216,1404,1164,240,1164,835,329,2022-01-01,zipcode,Cooper
ZCTA5 75433,48,3053,80116,944,148400,2408,971,2155,194,736,651,430,144,1329,1178,151,1178,934,244,2022-01-01,zipcode,Cumby
ZCTA5 75435,48,1060,37321,583,94100,884,480,827,118,312,247,117,33,638,473,165,473,335,138,2022-01-01,zipcode,Deport
ZCTA5 75436,48,2334,75179,604,211200,1883,868,1578,264,598,505,167,44,1005,820,185,820,660,160,2022-01-01,zipcode,Detroit
ZCTA5 75437,48,1125,83611,993,186800,828,337,740,48,271,299,73,49,511,422,89,422,393,29,2022-01-01,zipcode,Dike
ZCTA5 75438,48,1046,92083,1191,179200,883,370,686,101,201,174,160,50,426,383,43,383,261,122,2022-01-01,zipcode,Dodd city
ZCTA5 75439,48,1123,61250,1050,128100,859,291,715,101,336,182,48,48,459,416,43,416,242,174,2022-01-01,zipcode,Ector
ZCTA5 75440,48,7251,61127,966,201100,6159,3050,5527,617,1832,1954,706,418,3300,2749,551,2749,2232,517,2022-01-01,zipcode,Emory
ZCTA5 75441,48,90,16474,-666666666,-666666666,90,90,90,67,10,0,6,7,79,79,0,79,73,6,2022-01-01,zipcode,Enloe
ZCTA5 75442,48,10571,81839,1271,309500,8563,3627,7459,598,2733,2592,1266,270,4268,3902,366,3902,3290,612,2022-01-01,zipcode,Farmersville
ZCTA5 75446,48,3594,55744,675,197400,2683,1461,2413,396,794,593,486,144,1701,1389,312,1389,1034,355,2022-01-01,zipcode,Honey grove
ZCTA5 75447,48,1187,101875,-666666666,216100,938,389,852,111,334,306,72,29,491,463,28,463,434,29,2022-01-01,zipcode,Ivanhoe
ZCTA5 75448,48,862,80098,-666666666,157700,654,255,589,53,260,196,74,6,277,277,0,277,246,31,2022-01-01,zipcode,Klondike
ZCTA5 75449,48,1082,62500,-666666666,118100,877,415,679,76,193,295,55,60,610,406,204,406,258,148,2022-01-01,zipcode,Ladonia
ZCTA5 75450,48,482,-666666666,-666666666,212900,414,152,414,7,190,194,23,0,294,255,39,255,229,26,2022-01-01,zipcode,Lake creek
ZCTA5 75451,48,1613,47902,-666666666,139300,1297,593,1220,104,396,414,250,56,857,567,290,567,524,43,2022-01-01,zipcode,Leesburg
ZCTA5 75452,48,4979,69911,1019,229900,3945,1564,2982,460,896,1018,415,193,1798,1596,202,1596,1183,413,2022-01-01,zipcode,Leonard
ZCTA5 75453,48,3173,98518,1127,167700,2161,636,1933,160,567,795,324,87,1295,1119,176,1119,1011,108,2022-01-01,zipcode,Lone oak
ZCTA5 75454,48,17241,137903,2250,368200,12275,3483,10664,303,1803,3089,4093,1376,5639,5421,218,5421,4895,526,2022-01-01,zipcode,Melissa
ZCTA5 75455,48,26816,57120,814,148800,20000,7661,16508,3590,6028,4237,1865,788,10239,9327,912,9327,5869,3458,2022-01-01,zipcode,Mount pleasant
ZCTA5 75457,48,6278,70192,929,212200,4834,1453,4171,398,1380,1192,843,358,2734,1984,750,1984,1410,574,2022-01-01,zipcode,Mount vernon
ZCTA5 75459,48,5395,71389,1073,197900,3700,923,3185,423,847,1126,490,299,2044,1766,278,1766,1129,637,2022-01-01,zipcode,Howe
ZCTA5 75460,48,24094,43884,849,111400,19017,7243,15931,2262,5759,5247,1802,861,11353,10066,1287,10066,5195,4871,2022-01-01,zipcode,Paris
ZCTA5 75462,48,11406,66884,888,211000,8718,3671,7754,702,2103,2684,1389,876,4631,4298,333,4298,3380,918,2022-01-01,zipcode,Paris
ZCTA5 75468,48,1142,69832,-666666666,177100,932,437,768,0,219,362,65,122,406,379,27,379,322,57,2022-01-01,zipcode,Pattonville
ZCTA5 75469,48,311,79018,765,209800,289,148,244,35,45,98,62,4,197,141,56,141,126,15,2022-01-01,zipcode,Pecan gap
ZCTA5 75470,48,161,97581,-666666666,-666666666,161,57,161,47,46,47,10,11,130,92,38,92,61,31,2022-01-01,zipcode,Petty
ZCTA5 75471,48,1690,53221,1089,134800,1239,446,1075,181,487,268,114,25,762,585,177,585,378,207,2022-01-01,zipcode,Pickton
ZCTA5 75472,48,3905,56941,845,158800,3285,1547,2949,340,1167,788,529,125,1993,1485,508,1485,1173,312,2022-01-01,zipcode,Point
ZCTA5 75473,48,3663,80699,850,186800,3025,1284,2857,321,1090,800,472,174,1530,1429,101,1429,1316,113,2022-01-01,zipcode,Powderly
ZCTA5 75474,48,16586,62461,1025,155000,13678,6120,11477,2044,4177,3430,1344,482,7232,6209,1023,6209,5099,1110,2022-01-01,zipcode,Quinlan
ZCTA5 75475,48,19,-666666666,-666666666,-666666666,19,0,13,0,0,13,0,0,19,19,0,19,19,0,2022-01-01,zipcode,Randolph
ZCTA5 75476,48,1195,56250,-666666666,213500,1096,520,1006,150,410,294,78,74,601,554,47,554,501,53,2022-01-01,zipcode,Ravenna
ZCTA5 75477,48,1246,80375,746,-666666666,975,333,891,95,264,269,187,76,509,441,68,441,333,108,2022-01-01,zipcode,Roxton
ZCTA5 75478,48,879,54688,864,119500,698,383,636,146,181,202,73,34,353,319,34,319,261,58,2022-01-01,zipcode,Saltillo
ZCTA5 75479,48,2019,72368,964,154800,1710,620,1557,163,542,535,219,98,827,706,121,706,543,163,2022-01-01,zipcode,Savoy
ZCTA5 75480,48,1730,69005,-666666666,309600,1481,842,1346,37,226,648,218,217,1212,750,462,750,744,6,2022-01-01,zipcode,Scroggins
ZCTA5 75481,48,385,61000,-666666666,141800,293,148,253,15,118,69,39,12,222,154,68,154,141,13,2022-01-01,zipcode,Sulphur bluff
ZCTA5 75482,48,25724,63312,955,184700,20333,7401,17300,2481,5909,4943,2655,1312,10758,9667,1091,9667,6402,3265,2022-01-01,zipcode,Sulphur springs
ZCTA5 75486,48,2569,89750,1563,204500,2098,654,1755,270,504,754,172,55,1088,1033,55,1033,998,35,2022-01-01,zipcode,Sumner
ZCTA5 75487,48,1398,35729,701,115300,1062,508,886,215,298,195,126,52,618,499,119,499,417,82,2022-01-01,zipcode,Talco
ZCTA5 75488,48,919,62303,938,231400,616,221,555,6,231,208,100,10,460,331,129,331,296,35,2022-01-01,zipcode,Telephone
ZCTA5 75489,48,832,77273,1152,209700,662,240,625,68,141,284,96,36,378,356,22,356,233,123,2022-01-01,zipcode,Tom bean
ZCTA5 75490,48,2775,83516,1356,242400,2252,652,2001,124,781,776,204,116,1176,1001,175,1001,839,162,2022-01-01,zipcode,Trenton
ZCTA5 75491,48,5094,73988,913,218800,4077,1640,3456,353,1027,1171,668,237,2083,1903,180,1903,1558,345,2022-01-01,zipcode,Whitewright
ZCTA5 75492,48,342,106806,-666666666,161900,249,104,225,30,74,80,23,18,159,129,30,129,107,22,2022-01-01,zipcode,Windom
ZCTA5 75493,48,699,55625,733,49400,411,160,317,160,87,52,15,3,177,151,26,151,105,46,2022-01-01,zipcode,Winfield
ZCTA5 75494,48,11167,65955,950,163800,8942,4425,7885,1180,2387,2629,1208,481,5120,3975,1145,3975,3209,766,2022-01-01,zipcode,Winnsboro
ZCTA5 75495,48,9658,89781,1366,326400,7051,2501,6084,383,1582,2373,1333,413,3698,3238,460,3238,2600,638,2022-01-01,zipcode,Van alstyne
ZCTA5 75496,48,3462,71250,943,170000,2783,1158,2384,243,953,653,348,187,1386,1224,162,1224,969,255,2022-01-01,zipcode,Wolfe city
ZCTA5 75497,48,3896,57368,860,183700,3555,2070,3208,394,800,1231,595,188,1959,1648,311,1648,1395,253,2022-01-01,zipcode,Yantis
ZCTA5 75501,48,34183,44064,812,122000,27146,13015,22965,2914,9020,7525,2403,1103,15243,13063,2180,13063,7482,5581,2022-01-01,zipcode,Texarkana
ZCTA5 75503,48,27675,68977,1088,209300,21502,8395,18696,1019,4531,6792,3875,2479,11302,10481,821,10481,6363,4118,2022-01-01,zipcode,Texarkana
ZCTA5 75550,48,615,70192,588,90800,553,252,449,41,259,95,47,7,327,240,87,240,215,25,2022-01-01,zipcode,Annona
ZCTA5 75551,48,10917,63929,933,156900,8563,3794,7518,669,2758,2530,1067,494,4983,4224,759,4224,3269,955,2022-01-01,zipcode,Atlanta
ZCTA5 75554,48,2447,44630,767,149100,2079,1026,1690,211,778,424,174,103,1217,979,238,979,820,159,2022-01-01,zipcode,Avery
ZCTA5 75555,48,1534,50579,687,93400,1303,759,1164,128,542,301,133,60,885,723,162,723,624,99,2022-01-01,zipcode,Bivins
ZCTA5 75556,48,1297,73214,1049,83100,948,351,850,82,429,207,92,40,508,422,86,422,318,104,2022-01-01,zipcode,Bloomburg
ZCTA5 75558,48,2043,90244,-666666666,99900,1599,862,1404,315,644,364,76,5,695,669,26,669,669,0,2022-01-01,zipcode,Cookville
ZCTA5 75559,48,5455,52983,672,116900,4462,2518,3898,416,1772,1078,347,285,2830,2277,553,2277,1632,645,2022-01-01,zipcode,De kalb
ZCTA5 75560,48,1033,51394,1143,52900,801,342,650,194,179,131,85,61,474,393,81,393,342,51,2022-01-01,zipcode,Douglassville
ZCTA5 75561,48,4901,55288,848,113500,3868,1544,3269,407,1194,935,484,249,2423,1879,544,1879,1407,472,2022-01-01,zipcode,Hooks
ZCTA5 75562,48,89,-666666666,-666666666,-666666666,76,58,76,0,57,19,0,0,43,43,0,43,43,0,2022-01-01,zipcode,Kildare
ZCTA5 75563,48,3920,50108,642,103300,3261,1950,2858,403,1150,825,322,158,2030,1684,346,1684,1239,445,2022-01-01,zipcode,Linden
ZCTA5 75565,48,218,19107,-666666666,178100,84,49,45,0,43,2,0,0,39,36,3,36,7,29,2022-01-01,zipcode,Mc leod
ZCTA5 75566,48,678,62159,-666666666,97000,556,347,485,94,163,186,32,10,379,245,134,245,242,3,2022-01-01,zipcode,Marietta
ZCTA5 75567,48,3863,59069,742,142500,3119,1484,2769,156,1299,716,368,230,1960,1594,366,1594,1212,382,2022-01-01,zipcode,Maud
ZCTA5 75568,48,2494,50134,787,114100,2077,894,1854,316,921,446,128,43,1448,1144,304,1144,791,353,2022-01-01,zipcode,Naples
ZCTA5 75569,48,3456,41850,887,152600,2354,686,1836,113,550,895,102,176,1282,1181,101,1181,663,518,2022-01-01,zipcode,Nash
ZCTA5 75570,48,11197,64304,755,120500,9164,5166,7953,1201,3115,2050,1064,523,3632,3222,410,3222,2236,986,2022-01-01,zipcode,New boston
ZCTA5 75571,48,2618,51450,779,110100,2082,918,1797,158,757,594,101,187,1290,1033,257,1033,924,109,2022-01-01,zipcode,Omaha
ZCTA5 75572,48,3162,41600,766,72400,2606,1177,2340,293,1213,510,283,41,1685,1342,343,1342,1002,340,2022-01-01,zipcode,Queen city
ZCTA5 75573,48,194,64792,950,9999,114,38,114,16,15,81,2,0,93,75,18,75,18,57,2022-01-01,zipcode,Redwater
ZCTA5 75574,48,1402,70801,-666666666,65000,1048,479,970,41,443,247,150,89,683,528,155,528,487,41,2022-01-01,zipcode,Simms
ZCTA5 75601,48,15470,60634,891,177800,12299,5244,10388,1317,3000,3363,1784,924,6505,5646,859,5646,3504,2142,2022-01-01,zipcode,Longview
ZCTA5 75602,48,21343,54656,857,106300,16183,5776,12805,2727,4186,3985,1386,521,8601,7304,1297,7304,4794,2510,2022-01-01,zipcode,Longview
ZCTA5 75603,48,6341,58750,793,162200,5130,2044,4043,238,1339,1482,666,318,3057,2585,472,2585,2190,395,2022-01-01,zipcode,Longview
ZCTA5 75604,48,31361,66109,1000,173600,23416,9013,19968,3033,5188,7386,2924,1437,13301,11983,1318,11983,6797,5186,2022-01-01,zipcode,Longview
ZCTA5 75605,48,33614,73582,1146,229600,27718,9716,23545,1290,6192,9121,4634,2308,16075,14740,1335,14740,8194,6546,2022-01-01,zipcode,Longview
ZCTA5 75630,48,2622,38750,851,98800,2211,1287,2031,262,798,648,257,66,1576,1090,486,1090,918,172,2022-01-01,zipcode,Avinger
ZCTA5 75631,48,2738,80703,869,126500,2112,803,1795,128,593,739,216,119,1113,867,246,867,697,170,2022-01-01,zipcode,Beckville
ZCTA5 75633,48,13055,62244,765,146800,10478,4489,8840,1459,2355,3392,1279,355,6465,4852,1613,4852,3728,1124,2022-01-01,zipcode,Carthage
ZCTA5 75638,48,5041,53409,738,99700,4076,1908,3412,477,1036,1345,378,176,2319,1998,321,1998,1546,452,2022-01-01,zipcode,Daingerfield
ZCTA5 75639,48,2256,32727,-666666666,126800,1880,868,1627,377,633,520,32,65,1236,824,412,824,755,69,2022-01-01,zipcode,De berry
ZCTA5 75640,48,5720,80833,1013,256800,4406,1425,3694,247,1134,1546,352,415,2092,2008,84,2008,1618,390,2022-01-01,zipcode,Diana
ZCTA5 75641,48,101,42500,-666666666,170000,89,51,80,15,29,36,0,0,58,42,16,42,28,14,2022-01-01,zipcode,Easton
ZCTA5 75642,48,71,-666666666,-666666666,-666666666,71,35,71,0,0,71,0,0,36,36,0,36,36,0,2022-01-01,zipcode,Elysian fields
ZCTA5 75643,48,2216,55000,815,155100,1723,865,1595,249,490,638,170,48,1185,870,315,870,732,138,2022-01-01,zipcode,Gary
ZCTA5 75644,48,12902,54579,874,161500,10288,5391,8764,1239,3044,2965,1134,382,5328,4468,860,4468,3298,1170,2022-01-01,zipcode,Gilmer
ZCTA5 75645,48,10180,70315,1050,183100,8177,3885,7328,662,2271,3055,982,358,4434,4027,407,4027,3427,600,2022-01-01,zipcode,Gilmer
ZCTA5 75647,48,13026,53016,923,149500,9670,3887,8728,1570,2752,3120,896,390,5501,4876,625,4876,3393,1483,2022-01-01,zipcode,Gladewater
ZCTA5 75650,48,9921,84531,1030,169700,7551,2404,6190,584,1470,2145,1447,544,4009,3501,508,3501,2354,1147,2022-01-01,zipcode,Hallsville
ZCTA5 75651,48,2197,65030,973,149300,1838,747,1527,124,747,404,172,80,970,825,145,825,675,150,2022-01-01,zipcode,Harleton
ZCTA5 75652,48,13704,65905,961,182500,11923,7074,10247,2001,3429,3364,1001,452,4821,3791,1030,3791,2703,1088,2022-01-01,zipcode,Henderson
ZCTA5 75654,48,12817,58839,922,150700,9961,4024,8404,1486,2494,2625,976,823,5439,4696,743,4696,3651,1045,2022-01-01,zipcode,Henderson
ZCTA5 75656,48,4580,51676,778,117500,3512,1597,2998,470,1296,807,329,96,2073,1766,307,1766,1330,436,2022-01-01,zipcode,Hughes springs
ZCTA5 75657,48,6771,48848,859,106000,5895,2845,5147,676,2210,1387,705,169,4082,2948,1134,2948,2193,755,2022-01-01,zipcode,Jefferson
ZCTA5 75661,48,2734,56600,-666666666,97200,2359,1241,1939,444,658,530,239,68,1645,996,649,996,850,146,2022-01-01,zipcode,Karnack
ZCTA5 75662,48,24640,64717,944,156100,18520,7256,15722,2606,4704,5503,1989,920,9599,8416,1183,8416,6702,1714,2022-01-01,zipcode,Kilgore
ZCTA5 75667,48,1329,68309,969,89700,1106,397,882,186,253,355,61,27,526,459,67,459,388,71,2022-01-01,zipcode,Laneville
ZCTA5 75668,48,2471,48214,850,128400,1972,1072,1498,104,909,408,39,38,1215,980,235,980,596,384,2022-01-01,zipcode,Lone star
ZCTA5 75669,48,1041,81155,-666666666,135900,701,528,585,140,113,263,51,18,304,227,77,227,227,0,2022-01-01,zipcode,Long branch
ZCTA5 75670,48,18466,37106,818,87600,13979,5765,10889,1787,4235,3277,1030,560,7411,6168,1243,6168,3445,2723,2022-01-01,zipcode,Marshall
ZCTA5 75672,48,16637,68853,948,169500,13438,5617,11587,909,3392,4496,1821,969,7192,6072,1120,6072,4734,1338,2022-01-01,zipcode,Marshall
ZCTA5 75681,48,2593,58125,1017,152100,2224,1002,1778,133,630,686,230,99,1275,1073,202,1073,951,122,2022-01-01,zipcode,Mount enterprise
ZCTA5 75682,48,664,53125,1125,171200,520,327,482,49,149,199,64,21,284,264,20,264,254,10,2022-01-01,zipcode,New london
ZCTA5 75683,48,3810,43531,1076,100400,3016,1542,2584,388,881,970,332,13,1812,1435,377,1435,1208,227,2022-01-01,zipcode,Ore city
ZCTA5 75684,48,8030,51629,893,130800,5836,3037,4784,669,1992,1459,521,143,2682,2235,447,2235,1820,415,2022-01-01,zipcode,Overton
ZCTA5 75686,48,13180,55327,755,146100,10104,4173,8518,1144,3196,2507,1148,523,6030,4705,1325,4705,3751,954,2022-01-01,zipcode,Pittsburg
ZCTA5 75691,48,4547,81667,954,149700,3464,1091,3081,240,988,1407,323,123,1996,1662,334,1662,1242,420,2022-01-01,zipcode,Tatum
ZCTA5 75692,48,4830,60705,1167,148700,4115,2054,3711,203,1599,1285,442,182,2175,1855,320,1855,1719,136,2022-01-01,zipcode,Waskom
ZCTA5 75693,48,6128,92938,1104,191800,4782,1611,4268,551,1240,1526,726,225,2446,2153,293,2153,1476,677,2022-01-01,zipcode,White oak
ZCTA5 75701,48,34822,59107,1137,178900,28225,10359,21980,2475,4810,8296,4560,1839,14298,12102,2196,12102,7164,4938,2022-01-01,zipcode,Tyler
ZCTA5 75702,48,27775,48485,836,95900,20787,8122,16206,4837,5356,4978,715,320,10233,8096,2137,8096,4215,3881,2022-01-01,zipcode,Tyler
ZCTA5 75703,48,43682,77858,1176,287600,35021,12152,29368,1139,4954,10725,8375,4175,19840,17142,2698,17142,9492,7650,2022-01-01,zipcode,Tyler
ZCTA5 75704,48,9284,55967,1150,158000,7644,2886,7032,1505,1747,2486,911,383,4119,3152,967,3152,2612,540,2022-01-01,zipcode,Tyler
ZCTA5 75705,48,2348,70850,1672,164100,1966,898,1884,204,519,902,187,72,944,645,299,645,444,201,2022-01-01,zipcode,Tyler
ZCTA5 75706,48,11334,63477,887,107800,8292,3234,7152,1622,2606,2189,502,233,4176,3162,1014,3162,2604,558,2022-01-01,zipcode,Tyler
ZCTA5 75707,48,15724,79764,1356,222300,12628,5119,10882,924,2350,3735,2333,1540,6619,5799,820,5799,4515,1284,2022-01-01,zipcode,Tyler
ZCTA5 75708,48,10155,79864,820,133000,7290,2106,5998,2037,1862,1662,148,289,3778,2868,910,2868,2265,603,2022-01-01,zipcode,Tyler
ZCTA5 75709,48,5031,71013,1209,186100,4477,1691,3768,410,592,1464,814,488,2928,2176,752,2176,1393,783,2022-01-01,zipcode,Tyler
ZCTA5 75750,48,3291,70109,1057,135700,2774,1249,2610,392,1114,703,276,125,1408,1254,154,1254,953,301,2022-01-01,zipcode,Arp
ZCTA5 75751,48,17989,59399,1031,163400,14240,6068,11640,1985,3878,3637,1362,778,7358,6275,1083,6275,3854,2421,2022-01-01,zipcode,Athens
ZCTA5 75752,48,7573,62135,991,168600,5781,2671,5243,532,1484,1899,810,518,3355,2756,599,2756,2403,353,2022-01-01,zipcode,Athens
ZCTA5 75754,48,7460,87846,939,227000,6128,2872,5513,736,1513,2262,692,310,2957,2611,346,2611,2218,393,2022-01-01,zipcode,Ben wheeler
ZCTA5 75755,48,4982,52913,1001,106100,4058,1777,3398,803,1338,873,285,99,2295,1824,471,1824,1207,617,2022-01-01,zipcode,Big sandy
ZCTA5 75756,48,4299,79688,1024,177200,3349,1054,2917,331,873,1052,377,284,1903,1565,338,1565,1190,375,2022-01-01,zipcode,Brownsboro
ZCTA5 75757,48,13430,79070,1194,238200,10197,4390,9181,712,2291,3174,1876,1128,5470,4837,633,4837,3982,855,2022-01-01,zipcode,Bullard
ZCTA5 75758,48,9131,59727,940,129500,7662,3706,6780,590,2552,2310,1040,288,4602,3615,987,3615,3017,598,2022-01-01,zipcode,Chandler
ZCTA5 75759,48,139,25156,-666666666,93700,113,58,93,12,40,41,0,0,49,49,0,49,43,6,2022-01-01,zipcode,Cuney
ZCTA5 75760,48,2204,67294,981,144200,1865,938,1703,172,608,514,205,204,1311,1069,242,1069,884,185,2022-01-01,zipcode,Cushing
ZCTA5 75762,48,14459,78520,1204,248800,11225,4142,9987,278,2285,3351,2474,1599,6326,5268,1058,5268,4349,919,2022-01-01,zipcode,Flint
ZCTA5 75763,48,6336,65022,1120,151600,5011,2471,4447,367,1456,1705,564,355,2947,2402,545,2402,2082,320,2022-01-01,zipcode,Frankston
ZCTA5 75764,48,158,73021,440,96800,114,26,85,30,31,15,9,0,76,59,17,59,35,24,2022-01-01,zipcode,Gallatin
ZCTA5 75765,48,7944,56477,944,159600,6816,3771,5530,456,1539,1837,943,755,4262,3119,1143,3119,2651,468,2022-01-01,zipcode,Hawkins
ZCTA5 75766,48,26128,50279,840,135100,19620,8191,15999,3622,5086,4439,1821,1031,10808,9558,1250,9558,6659,2899,2022-01-01,zipcode,Jacksonville
ZCTA5 75770,48,2557,98178,1053,226700,2162,1068,2008,165,772,678,265,128,1397,1026,371,1026,869,157,2022-01-01,zipcode,Larue
ZCTA5 75771,48,21408,83516,1277,239800,17067,7288,14548,1302,3895,5548,2453,1350,9173,7558,1615,7558,6292,1266,2022-01-01,zipcode,Lindale
ZCTA5 75773,48,14227,57854,851,181700,11713,5784,10146,1741,3415,3175,941,874,6179,5438,741,5438,3810,1628,2022-01-01,zipcode,Mineola
ZCTA5 75778,48,2471,43812,1030,142900,1965,985,1745,104,583,726,251,81,1587,1137,450,1137,782,355,2022-01-01,zipcode,Murchison
ZCTA5 75779,48,22,-666666666,-666666666,-666666666,22,11,22,11,11,0,0,0,11,11,0,11,11,0,2022-01-01,zipcode,Neches
ZCTA5 75780,48,404,64375,940,-666666666,345,102,252,119,59,36,10,28,182,128,54,128,108,20,2022-01-01,zipcode,New summerfield
ZCTA5 75783,48,7854,62410,995,159300,6174,3031,5510,736,1755,1801,622,596,3930,3206,724,3206,2758,448,2022-01-01,zipcode,Quitman
ZCTA5 75784,48,794,58750,880,119300,651,233,503,49,191,152,58,53,340,248,92,248,228,20,2022-01-01,zipcode,Reklaw
ZCTA5 75785,48,10906,61815,854,137100,9015,5328,7969,1839,2913,2279,704,234,3971,3303,668,3303,2509,794,2022-01-01,zipcode,Rusk
ZCTA5 75788,48,43,-666666666,-666666666,-666666666,43,0,43,0,43,0,0,0,43,43,0,43,43,0,2022-01-01,zipcode,Sacul
ZCTA5 75789,48,7898,79112,1002,180300,5994,2164,5252,673,1710,1794,699,376,3283,2889,394,2889,2317,572,2022-01-01,zipcode,Troup
ZCTA5 75790,48,3777,61218,1008,166000,2822,1072,2401,284,642,898,381,196,1593,1358,235,1358,989,369,2022-01-01,zipcode,Van
ZCTA5 75791,48,14685,72203,1482,206900,11303,3667,9516,729,2403,3882,1868,634,5628,5049,579,5049,3697,1352,2022-01-01,zipcode,Whitehouse
ZCTA5 75792,48,3558,52153,1078,115200,2741,1163,2575,284,931,1062,243,55,1352,1136,216,1136,889,247,2022-01-01,zipcode,Winona
ZCTA5 75801,48,16549,46706,972,146100,12885,4372,11008,1150,4337,3383,1641,497,7190,6303,887,6303,3636,2667,2022-01-01,zipcode,Palestine
ZCTA5 75803,48,21702,57654,949,166400,18543,12053,16370,2751,6234,5827,930,628,6952,5807,1145,5807,4267,1540,2022-01-01,zipcode,Palestine
ZCTA5 75831,48,5152,47358,922,95400,4126,2133,3622,816,1212,1281,209,104,2724,2080,644,2080,1465,615,2022-01-01,zipcode,Buffalo
ZCTA5 75833,48,2764,62378,967,169900,2450,1202,1997,187,752,722,238,98,1648,1064,584,1064,882,182,2022-01-01,zipcode,Centerville
ZCTA5 75835,48,11470,48706,739,134400,9308,4750,8136,1510,3111,2209,993,313,6128,4450,1678,4450,2897,1553,2022-01-01,zipcode,Crockett
ZCTA5 75838,48,304,37386,-666666666,147900,282,196,228,40,103,45,40,0,288,126,162,126,79,47,2022-01-01,zipcode,Donie
ZCTA5 75839,48,6189,63412,1069,126400,4767,2231,3857,353,1347,1501,490,166,2459,2010,449,2010,1498,512,2022-01-01,zipcode,Elkhart
ZCTA5 75840,48,6428,53368,831,187800,5023,2218,4337,692,1413,1417,551,264,3334,2510,824,2510,1674,836,2022-01-01,zipcode,Fairfield
ZCTA5 75844,48,4922,50294,840,122800,4032,1714,3589,355,1298,1214,462,260,2944,1874,1070,1874,1401,473,2022-01-01,zipcode,Grapeland
ZCTA5 75845,48,2262,54850,605,85200,1978,989,1822,404,532,590,229,67,1554,1003,551,1003,843,160,2022-01-01,zipcode,Groveton
ZCTA5 75846,48,2609,57482,912,205400,1985,1016,1795,321,576,540,248,110,1577,1095,482,1095,882,213,2022-01-01,zipcode,Jewett
ZCTA5 75847,48,1634,52969,1102,113500,1193,641,1114,146,450,305,131,82,825,553,272,553,408,145,2022-01-01,zipcode,Kennard
ZCTA5 75848,48,100,-666666666,639,95000,93,39,69,0,29,33,7,0,40,30,10,30,16,14,2022-01-01,zipcode,Kirvin
ZCTA5 75849,48,125,43125,900,87500,117,63,101,18,49,15,13,6,64,53,11,53,35,18,2022-01-01,zipcode,Latexo
ZCTA5 75850,48,1447,-666666666,-666666666,159100,1188,683,1093,325,414,240,102,12,577,472,105,472,417,55,2022-01-01,zipcode,Leona
ZCTA5 75851,48,4513,61310,889,150200,4106,3103,3829,866,1621,1065,174,103,1198,774,424,774,669,105,2022-01-01,zipcode,Lovelady
ZCTA5 75852,48,3173,52768,973,168100,2943,2486,2568,639,942,694,250,43,623,473,150,473,406,67,2022-01-01,zipcode,Midway
ZCTA5 75853,48,1042,68750,-666666666,219600,799,331,721,18,308,193,145,57,664,427,237,427,367,60,2022-01-01,zipcode,Montalba
ZCTA5 75855,48,2657,39337,780,171000,2184,1243,2062,152,946,604,271,89,1638,1172,466,1172,982,190,2022-01-01,zipcode,Oakwood
ZCTA5 75856,48,211,145096,-666666666,-666666666,181,42,94,0,20,13,61,0,147,85,62,85,35,50,2022-01-01,zipcode,Pennington
ZCTA5 75858,48,60,56591,-666666666,-666666666,48,37,48,8,29,11,0,0,109,30,79,30,30,0,2022-01-01,zipcode,Ratcliff
ZCTA5 75859,48,2607,59698,1396,169000,2308,1084,2097,290,680,518,423,186,1580,1099,481,1099,883,216,2022-01-01,zipcode,Streetman
ZCTA5 75860,48,6305,60995,659,118300,4832,2839,4314,705,1689,1395,385,140,2292,1557,735,1557,1337,220,2022-01-01,zipcode,Teague
ZCTA5 75861,48,1438,75528,847,208000,1237,373,1146,120,459,418,137,12,942,694,248,694,493,201,2022-01-01,zipcode,Tennessee colony
ZCTA5 75862,48,10017,47377,783,111800,8305,4587,7287,865,2970,2388,785,279,5937,4336,1601,4336,3205,1131,2022-01-01,zipcode,Trinity
ZCTA5 75901,48,28257,59350,1022,151000,21688,8336,18006,3242,5477,5433,2468,1386,11255,10040,1215,10040,6519,3521,2022-01-01,zipcode,Lufkin
ZCTA5 75904,48,34191,59444,994,159700,26204,9851,22313,2820,7226,7816,2561,1890,14808,13028,1780,13028,7625,5403,2022-01-01,zipcode,Lufkin
ZCTA5 75925,48,3217,41328,773,99700,2564,1169,2142,426,692,761,186,77,1550,1312,238,1312,780,532,2022-01-01,zipcode,Alto
ZCTA5 75926,48,1301,58375,721,110600,995,430,830,86,357,275,78,34,730,541,189,541,455,86,2022-01-01,zipcode,Apple springs
ZCTA5 75928,48,987,23718,-666666666,62100,954,663,831,99,481,251,0,0,534,431,103,431,364,67,2022-01-01,zipcode,Bon wier
ZCTA5 75929,48,1358,63454,491,165400,1256,710,1033,69,318,571,50,25,1251,511,740,511,428,83,2022-01-01,zipcode,Broaddus
ZCTA5 75930,48,1972,53472,967,80100,1546,926,1422,251,747,267,127,30,1112,740,372,740,641,99,2022-01-01,zipcode,Bronson
ZCTA5 75931,48,2053,54931,686,170000,1771,820,1626,161,665,433,265,102,1893,959,934,959,795,164,2022-01-01,zipcode,Brookeland
ZCTA5 75932,48,1393,55804,-666666666,69800,1232,675,1078,244,423,355,34,22,1134,569,565,569,512,57,2022-01-01,zipcode,Burkeville
ZCTA5 75933,48,1316,-666666666,-666666666,60300,985,420,892,130,445,198,97,22,739,518,221,518,451,67,2022-01-01,zipcode,Call
ZCTA5 75934,48,142,-666666666,-666666666,-666666666,100,29,83,0,5,50,28,0,101,45,56,45,45,0,2022-01-01,zipcode,Camden
ZCTA5 75935,48,12073,52569,907,103500,9238,3793,7862,1559,3102,2144,704,353,5598,4575,1023,4575,3420,1155,2022-01-01,zipcode,Center
ZCTA5 75936,48,951,65000,668,165800,816,356,745,99,355,193,58,40,457,326,131,326,287,39,2022-01-01,zipcode,Chester
ZCTA5 75937,48,1303,80262,653,75000,1052,450,944,158,327,283,150,26,652,465,187,465,394,71,2022-01-01,zipcode,Chireno
ZCTA5 75938,48,2306,47609,697,98200,1822,889,1601,172,633,524,210,62,1625,966,659,966,820,146,2022-01-01,zipcode,Colmesneil
ZCTA5 75939,48,5415,45339,693,108900,4531,1851,3644,762,1675,825,253,129,2180,1701,479,1701,1160,541,2022-01-01,zipcode,Corrigan
ZCTA5 75941,48,8666,56083,608,93400,6551,3067,5527,1229,1620,1725,681,272,2941,2574,367,2574,1972,602,2022-01-01,zipcode,Diboll
ZCTA5 75942,48,162,-666666666,-666666666,-666666666,162,102,162,102,60,0,0,0,42,42,0,42,0,42,2022-01-01,zipcode,Doucette
ZCTA5 75943,48,1372,71500,1188,188300,1019,419,869,36,192,274,204,163,545,520,25,520,447,73,2022-01-01,zipcode,Douglass
ZCTA5 75944,48,852,34667,-666666666,70300,733,474,696,96,227,250,67,56,669,444,225,444,421,23,2022-01-01,zipcode,Etoile
ZCTA5 75946,48,3943,58125,1019,144400,3155,1413,2836,375,861,992,456,152,1835,1598,237,1598,1193,405,2022-01-01,zipcode,Garrison
ZCTA5 75948,48,5307,46157,773,184300,4767,2967,4432,501,1420,1569,444,498,4755,2598,2157,2598,2175,423,2022-01-01,zipcode,Hemphill
ZCTA5 75949,48,8472,49577,855,102300,6743,3247,5880,632,2462,2087,539,160,4051,3352,699,3352,2265,1087,2022-01-01,zipcode,Huntington
ZCTA5 75951,48,15148,44141,840,118800,12099,5834,10454,1020,5051,2965,1043,375,7319,5899,1420,5899,4416,1483,2022-01-01,zipcode,Jasper
ZCTA5 75954,48,2719,44750,738,86700,2165,960,1932,378,683,601,189,81,1485,1127,358,1127,817,310,2022-01-01,zipcode,Joaquin
ZCTA5 75956,48,7374,48125,781,117500,5975,2572,4983,704,2395,1446,183,255,3514,2996,518,2996,2460,536,2022-01-01,zipcode,Kirbyville
ZCTA5 75959,48,974,58542,-666666666,115600,680,371,627,140,224,167,71,25,680,336,344,336,309,27,2022-01-01,zipcode,Milam
ZCTA5 75960,48,785,70156,-666666666,111200,510,172,418,202,31,165,20,0,410,259,151,259,259,0,2022-01-01,zipcode,Moscow
ZCTA5 75961,48,15081,38547,916,134800,11628,3954,8956,1188,3161,3010,1141,456,7669,6369,1300,6369,3107,3262,2022-01-01,zipcode,Nacogdoches
ZCTA5 75962,48,3336,-666666666,-666666666,-666666666,3336,2077,70,0,0,70,0,0,0,0,0,0,0,0,2022-01-01,zipcode,
ZCTA5 75964,48,20623,55039,846,103100,14978,5913,12517,3078,4024,3320,1259,836,8259,7337,922,7337,4757,2580,2022-01-01,zipcode,Nacogdoches
ZCTA5 75965,48,17410,52073,853,207100,14495,5550,10029,632,1927,3109,2662,1699,8528,7563,965,7563,3842,3721,2022-01-01,zipcode,Nacogdoches
ZCTA5 75966,48,4788,38156,888,104600,3670,1859,3166,559,1517,897,141,52,2101,1647,454,1647,1123,524,2022-01-01,zipcode,Newton
ZCTA5 75968,48,2128,43472,571,93500,1700,811,1400,238,450,558,72,82,1048,843,205,843,662,181,2022-01-01,zipcode,Pineland
ZCTA5 75969,48,4597,67471,1079,142000,3750,1644,3280,780,998,1032,357,113,1770,1597,173,1597,1222,375,2022-01-01,zipcode,Pollok
ZCTA5 75972,48,6081,42272,700,70700,5026,2752,4434,811,2149,781,406,287,3346,2425,921,2425,1740,685,2022-01-01,zipcode,San augustine
ZCTA5 75973,48,2934,52037,975,107700,2306,1032,1968,314,681,630,259,84,1545,1150,395,1150,984,166,2022-01-01,zipcode,Shelbyville
ZCTA5 75974,48,2726,41875,666,102000,1984,920,1793,424,606,536,195,32,1262,939,323,939,633,306,2022-01-01,zipcode,Tenaha
ZCTA5 75975,48,4441,58318,721,135300,3384,1517,2755,372,872,1211,213,87,1819,1363,456,1363,1025,338,2022-01-01,zipcode,Timpson
ZCTA5 75976,48,1225,62417,725,65300,835,379,699,168,177,246,40,68,438,369,69,369,253,116,2022-01-01,zipcode,Wells
ZCTA5 75977,48,461,22273,942,-666666666,327,140,322,69,121,127,5,0,330,214,116,214,166,48,2022-01-01,zipcode,Wiergate
ZCTA5 75979,48,11473,43822,937,111300,9512,5771,8332,1857,3290,2262,564,359,4951,3542,1409,3542,2620,922,2022-01-01,zipcode,Woodville
ZCTA5 75980,48,2522,40648,825,84200,2046,1009,1789,320,535,784,100,50,1891,1032,859,1032,896,136,2022-01-01,zipcode,Zavalla
ZCTA5 76001,48,38010,101311,1743,292500,28106,8737,23417,1978,4912,6569,7108,2850,11815,11522,293,11522,8963,2559,2022-01-01,zipcode,Arlington
ZCTA5 76002,48,33076,102369,2009,279900,25160,6253,20207,2037,4318,6779,4860,2213,9820,9606,214,9606,8028,1578,2022-01-01,zipcode,Arlington
ZCTA5 76006,48,24072,56312,1264,291100,20199,4019,16632,1412,3078,5969,3812,2361,13593,12094,1499,12094,2905,9189,2022-01-01,zipcode,Arlington
ZCTA5 76008,48,23084,154054,2122,417800,16690,5139,14963,301,2168,3604,5420,3470,7826,7536,290,7536,6928,608,2022-01-01,zipcode,Aledo
ZCTA5 76009,48,19879,71996,1183,169600,15381,6348,12801,2927,5171,2857,1266,580,7376,6474,902,6474,4931,1543,2022-01-01,zipcode,Alvarado
ZCTA5 76010,48,57197,42571,1151,172800,41495,13849,30954,11562,9547,6379,2514,952,20437,18520,1917,18520,6004,12516,2022-01-01,zipcode,Arlington
ZCTA5 76011,48,22529,50200,1199,201600,17857,4589,15122,2643,3099,5232,2619,1529,11544,10211,1333,10211,2023,8188,2022-01-01,zipcode,Arlington
ZCTA5 76012,48,27769,80972,1222,281000,22261,7953,19330,1481,4282,5423,5156,2988,11539,10722,817,10722,6705,4017,2022-01-01,zipcode,Arlington
ZCTA5 76013,48,35535,64585,1222,268600,28914,9774,22037,1927,4701,6012,6096,3301,14211,13274,937,13274,6637,6637,2022-01-01,zipcode,Arlington
ZCTA5 76014,48,32805,60894,1401,195500,24653,8006,19985,4799,6427,5275,2631,853,11263,10687,576,10687,5097,5590,2022-01-01,zipcode,Arlington
ZCTA5 76015,48,17474,69805,1443,214600,13645,3997,11333,986,3070,3816,2358,1103,6969,6358,611,6358,2960,3398,2022-01-01,zipcode,Arlington
ZCTA5 76016,48,31079,103605,1749,285000,25224,8912,21533,893,4592,7067,5953,3028,11491,10903,588,10903,9019,1884,2022-01-01,zipcode,Arlington
ZCTA5 76017,48,46361,89930,1431,253000,37682,11052,31005,2403,6719,11037,7306,3540,16804,15895,909,15895,10692,5203,2022-01-01,zipcode,Arlington
ZCTA5 76018,48,27827,83815,1744,217600,21371,5329,16664,2851,4336,5109,2882,1486,8618,8268,350,8268,6371,1897,2022-01-01,zipcode,Arlington
ZCTA5 76020,48,32937,87923,1114,235000,26106,9181,22855,2494,7125,8513,3519,1204,13609,12132,1477,12132,9741,2391,2022-01-01,zipcode,Azle
ZCTA5 76021,48,34858,84539,1307,322300,28574,8348,25193,1252,4188,8506,7791,3456,15399,14761,638,14761,7970,6791,2022-01-01,zipcode,Bedford
ZCTA5 76022,48,14632,70286,1429,232800,11568,3721,9743,735,2325,4088,1938,657,6244,5709,535,5709,2974,2735,2022-01-01,zipcode,Bedford
ZCTA5 76023,48,7227,83750,1048,261000,5871,1939,4988,604,1855,1585,798,146,2619,2491,128,2491,2170,321,2022-01-01,zipcode,Boyd
ZCTA5 76028,48,76343,93314,1558,272900,57829,18996,50270,4119,14601,16837,10061,4652,27439,26150,1289,26150,19785,6365,2022-01-01,zipcode,Burleson
ZCTA5 76031,48,18108,68203,1157,177200,14034,5932,11606,2267,4631,2938,1370,400,6326,5858,468,5858,4574,1284,2022-01-01,zipcode,Cleburne
ZCTA5 76033,48,27664,65488,1209,201400,21672,8447,18663,2193,6983,5905,2559,1023,10892,10340,552,10340,6538,3802,2022-01-01,zipcode,Cleburne
ZCTA5 76034,48,25793,196034,2785,673900,20472,7385,18440,142,1236,4377,7511,5174,9386,9225,161,9225,8847,378,2022-01-01,zipcode,Colleyville
ZCTA5 76035,48,3101,112983,1407,354500,2209,770,1856,160,470,581,424,221,1252,959,293,959,744,215,2022-01-01,zipcode,Cresson
ZCTA5 76036,48,30489,89393,1526,259300,23071,7642,19135,1596,5719,6315,3618,1887,10656,9920,736,9920,7382,2538,2022-01-01,zipcode,Crowley
ZCTA5 76039,48,41045,80176,1622,286200,32915,7058,28050,1763,5245,9184,7850,4008,18016,17107,909,17107,6281,10826,2022-01-01,zipcode,Euless
ZCTA5 76040,48,30708,65698,1129,263400,23393,6178,19903,2435,4809,6585,4234,1840,12808,11654,1154,11654,4821,6833,2022-01-01,zipcode,Euless
ZCTA5 76041,48,772,154427,-666666666,154400,717,142,546,22,218,229,77,0,279,267,12,267,267,0,2022-01-01,zipcode,Forreston
ZCTA5 76043,48,7281,75764,853,249000,6009,2052,5301,406,1721,1642,1219,313,2915,2619,296,2619,2023,596,2022-01-01,zipcode,Glen rose
ZCTA5 76044,48,7644,88795,1190,336900,5902,1914,4937,301,1885,1705,764,282,2769,2594,175,2594,2333,261,2022-01-01,zipcode,Godley
ZCTA5 76048,48,27005,61728,1165,206200,22118,10147,19214,2013,5649,6382,3547,1623,13145,11084,2061,11084,7960,3124,2022-01-01,zipcode,Granbury
ZCTA5 76049,48,29301,96674,1432,291700,24668,11300,22532,1099,5805,7358,5506,2764,13075,11875,1200,11875,10524,1351,2022-01-01,zipcode,Granbury
ZCTA5 76050,48,7395,80858,1148,207100,6006,2266,5231,697,1990,1765,609,170,2807,2624,183,2624,2065,559,2022-01-01,zipcode,Grandview
ZCTA5 76051,48,50303,106726,1750,429200,41091,9454,35854,1562,6099,8861,12462,6870,22311,21224,1087,21224,11190,10034,2022-01-01,zipcode,Grapevine
ZCTA5 76052,48,27171,135348,1837,367000,20239,5034,17443,854,2647,5692,5444,2806,9031,8811,220,8811,7795,1016,2022-01-01,zipcode,Haslet
ZCTA5 76053,48,31396,59985,1245,226100,23755,7580,20173,2417,5371,6552,4106,1727,12779,11655,1124,11655,6161,5494,2022-01-01,zipcode,Hurst
ZCTA5 76054,48,11886,104748,1490,337700,9861,3173,8709,257,1274,2822,2942,1414,4845,4660,185,4660,3860,800,2022-01-01,zipcode,Hurst
ZCTA5 76055,48,3566,68466,859,162200,2810,1122,2348,243,847,970,148,140,1399,1245,154,1245,1031,214,2022-01-01,zipcode,Itasca
ZCTA5 76058,48,21082,66777,1206,184500,16263,5819,13119,2519,4148,4331,1443,678,7626,7083,543,7083,5174,1909,2022-01-01,zipcode,Joshua
ZCTA5 76059,48,5224,49703,953,184500,3981,1493,2921,523,868,837,454,239,1935,1697,238,1697,675,1022,2022-01-01,zipcode,Keene
ZCTA5 76060,48,8552,112931,1181,333500,6902,2052,6132,995,1533,1821,1278,505,3027,2829,198,2829,2092,737,2022-01-01,zipcode,Kennedale
ZCTA5 76061,48,59,-666666666,-666666666,-666666666,59,0,59,0,0,59,0,0,29,29,0,29,29,0,2022-01-01,zipcode,Lillian
ZCTA5 76063,48,80101,110303,1619,350900,61203,18820,50941,3670,10186,17016,12778,7291,26984,25817,1167,25817,19506,6311,2022-01-01,zipcode,Mansfield
ZCTA5 76064,48,1952,78523,1537,241900,1576,523,1442,350,333,369,217,173,732,701,31,701,444,257,2022-01-01,zipcode,Maypearl
ZCTA5 76065,48,42415,121063,1522,343200,31752,8994,27036,1626,6412,8944,6880,3174,14640,14017,623,14017,11800,2217,2022-01-01,zipcode,Midlothian
ZCTA5 76066,48,4923,98145,584,235100,3289,1391,2912,453,858,613,429,559,1873,1496,377,1496,1198,298,2022-01-01,zipcode,Millsap
ZCTA5 76067,48,20582,59845,987,134200,15783,6525,13472,1929,5764,4061,1223,495,8360,7188,1172,7188,4754,2434,2022-01-01,zipcode,Mineral wells
ZCTA5 76070,48,766,130630,-666666666,103400,575,62,442,0,167,256,0,19,304,287,17,287,287,0,2022-01-01,zipcode,Nemo
ZCTA5 76071,48,4610,94318,1132,244200,3486,1115,2772,372,1142,790,366,102,1611,1442,169,1442,1157,285,2022-01-01,zipcode,Newark
ZCTA5 76073,48,6948,107759,1119,290300,5741,1828,5045,560,1859,1544,897,185,2620,2444,176,2444,2080,364,2022-01-01,zipcode,Paradise
ZCTA5 76077,48,748,-666666666,-666666666,218500,495,337,377,7,120,144,41,65,268,160,108,160,160,0,2022-01-01,zipcode,Rainbow
ZCTA5 76078,48,9696,89794,1440,242800,7363,2375,6189,645,2076,2260,990,218,3398,3143,255,3143,2590,553,2022-01-01,zipcode,Rhome
ZCTA5 76082,48,23489,84506,1134,234300,18334,6356,15836,2182,5595,5657,1850,552,8547,7651,896,7651,6435,1216,2022-01-01,zipcode,Springtown
ZCTA5 76084,48,12058,85748,1605,223100,9310,3761,7781,978,3186,2353,813,451,3625,3431,194,3431,3150,281,2022-01-01,zipcode,Venus
ZCTA5 76085,48,11695,91128,1646,320900,9709,3683,8500,1288,2460,3144,1077,531,4085,3834,251,3834,3306,528,2022-01-01,zipcode,Weatherford
ZCTA5 76086,48,21979,65707,1310,204000,17461,6263,14206,1651,4608,4741,2229,977,9236,8423,813,8423,4484,3939,2022-01-01,zipcode,Weatherford
ZCTA5 76087,48,31831,101606,1515,327000,25242,9536,22030,1723,4753,6987,5867,2700,12872,11666,1206,11666,10403,1263,2022-01-01,zipcode,Weatherford
ZCTA5 76088,48,14693,89554,1276,339900,11795,4443,10311,842,3633,3094,2114,628,5455,5215,240,5215,4332,883,2022-01-01,zipcode,Weatherford
ZCTA5 76092,48,31212,250001,2518,856100,22427,8929,19613,282,1454,3305,8061,6511,9871,9431,440,9431,8966,465,2022-01-01,zipcode,Southlake
ZCTA5 76093,48,3485,52832,1133,106300,2691,955,2413,539,671,892,202,109,1329,1269,60,1269,983,286,2022-01-01,zipcode,Rio vista
ZCTA5 76102,48,11645,81074,1579,325200,11121,6386,9256,1558,2293,2227,1768,1410,5277,4303,974,4303,1023,3280,2022-01-01,zipcode,Fort worth
ZCTA5 76103,48,17285,56641,1062,167800,13355,4263,10295,2966,3063,2239,1235,792,5996,5500,496,5500,3462,2038,2022-01-01,zipcode,Fort worth
ZCTA5 76104,48,18914,46098,1253,123900,14410,6178,11814,3332,3542,2598,1448,894,8997,7386,1611,7386,2903,4483,2022-01-01,zipcode,Fort worth
ZCTA5 76105,48,23252,44193,1070,104800,17404,7196,13067,5675,4340,2332,498,222,7863,6865,998,6865,3567,3298,2022-01-01,zipcode,Fort worth
ZCTA5 76106,48,37777,51972,1123,132800,27134,8669,22261,10254,6684,3831,1176,316,11526,10814,712,10814,5264,5550,2022-01-01,zipcode,Fort worth
ZCTA5 76107,48,29629,77277,1395,385100,25856,8244,22276,2285,3232,4623,7465,4671,17438,15194,2244,15194,6982,8212,2022-01-01,zipcode,Fort worth
ZCTA5 76108,48,44930,73183,1362,216000,34663,12578,29969,3089,8775,10223,5196,2686,17972,16385,1587,16385,11526,4859,2022-01-01,zipcode,Fort worth
ZCTA5 76109,48,25658,99102,1582,600300,21041,7542,15646,311,1214,2808,6555,4758,11217,9878,1339,9878,5133,4745,2022-01-01,zipcode,Fort worth
ZCTA5 76110,48,33640,59933,1201,219400,25627,9422,20466,6888,3715,4057,3727,2079,12722,11276,1446,11276,7005,4271,2022-01-01,zipcode,Fort worth
ZCTA5 76111,48,21366,54884,1162,166500,16770,5560,13599,4521,4688,2536,1421,433,8430,7673,757,7673,4270,3403,2022-01-01,zipcode,Fort worth
ZCTA5 76112,48,44116,53335,1132,188700,33439,10684,27956,4354,8709,8929,4138,1826,19175,17111,2064,17111,8437,8674,2022-01-01,zipcode,Fort worth
ZCTA5 76114,48,27297,63454,1153,175300,21578,8262,17625,4126,6429,4473,1822,775,10695,9635,1060,9635,5287,4348,2022-01-01,zipcode,Fort worth
ZCTA5 76115,48,21355,45311,1103,116800,14882,5885,11883,5250,2714,1918,969,1032,6781,6074,707,6074,2805,3269,2022-01-01,zipcode,Fort worth
ZCTA5 76116,48,49232,50982,1143,280700,38434,13193,32760,3974,8500,9791,6991,3504,25187,22150,3037,22150,7345,14805,2022-01-01,zipcode,Fort worth
ZCTA5 76117,48,32692,49782,1133,167800,24987,8977,21115,5983,8128,4796,1627,581,12475,11679,796,11679,6075,5604,2022-01-01,zipcode,Haltom city
ZCTA5 76118,48,16822,89394,1370,256000,13628,4004,11775,1390,2799,4132,2221,1233,6504,5849,655,5849,4097,1752,2022-01-01,zipcode,Fort worth
ZCTA5 76119,48,51401,44605,1151,116300,37360,15703,30789,10451,10316,7566,1813,643,16386,14805,1581,14805,7976,6829,2022-01-01,zipcode,Fort worth
ZCTA5 76120,48,19842,70129,1294,257500,15373,3669,12865,1084,2998,4602,2957,1224,8713,7807,906,7807,3740,4067,2022-01-01,zipcode,Fort worth
ZCTA5 76123,48,40973,91180,2028,245900,30647,8451,25251,2860,7136,7039,5274,2942,13117,12777,340,12777,9949,2828,2022-01-01,zipcode,Fort worth
ZCTA5 76126,48,25480,106467,1544,319700,19651,6870,17204,951,3138,5103,5044,2968,10255,9159,1096,9159,7570,1589,2022-01-01,zipcode,Fort worth
ZCTA5 76127,48,1657,103971,1794,-666666666,1634,1244,1256,311,492,398,23,32,77,44,33,44,0,44,2022-01-01,zipcode,Naval air station jrb
ZCTA5 76129,48,1724,-666666666,-666666666,-666666666,1724,1179,26,0,0,7,12,7,0,0,0,0,0,0,2022-01-01,zipcode,Fort worth
ZCTA5 76131,48,50572,101087,1649,284100,37115,10245,32135,2828,7119,9895,8485,3808,17036,16817,219,16817,12732,4085,2022-01-01,zipcode,Fort worth
ZCTA5 76132,48,26709,68284,1271,363400,22002,7474,18391,610,4476,4321,5291,3693,13664,12405,1259,12405,3975,8430,2022-01-01,zipcode,Fort worth
ZCTA5 76133,48,54241,69506,1348,203900,40738,14270,34633,4696,9515,10366,5779,4277,20276,19147,1129,19147,11578,7569,2022-01-01,zipcode,Fort worth
ZCTA5 76134,48,29211,65516,1289,188800,22669,7066,18132,3224,5833,5421,2199,1455,10542,9983,559,9983,6185,3798,2022-01-01,zipcode,Fort worth
ZCTA5 76135,48,18648,69525,1156,216900,15409,5360,12857,1358,4111,4392,1921,1075,8171,7724,447,7724,5010,2714,2022-01-01,zipcode,Fort worth
ZCTA5 76137,48,58970,86733,1519,256400,46673,11676,38698,3212,9619,13654,8907,3306,23435,21937,1498,21937,13004,8933,2022-01-01,zipcode,Fort worth
ZCTA5 76140,48,31882,70933,1393,179800,23960,7735,19297,3742,6297,6241,2093,924,10822,10064,758,10064,6704,3360,2022-01-01,zipcode,Fort worth
ZCTA5 76148,48,24080,88121,1758,201400,19236,5637,16542,1668,5461,5524,3148,741,8358,8071,287,8071,6423,1648,2022-01-01,zipcode,Fort worth
ZCTA5 76155,48,6295,59653,1320,-666666666,5263,614,4706,328,457,1765,1323,833,3843,3457,386,3457,21,3436,2022-01-01,zipcode,Fort worth
ZCTA5 76164,48,13853,52691,1040,116200,11100,4331,8950,4362,2724,1403,358,103,4900,4422,478,4422,2586,1836,2022-01-01,zipcode,Fort worth
ZCTA5 76177,48,21967,102719,1640,312600,17378,3510,14317,234,2274,4789,4992,2028,9525,8720,805,8720,4466,4254,2022-01-01,zipcode,Fort worth
ZCTA5 76179,48,74074,106288,1754,275100,53822,14633,47011,3375,13467,15741,9770,4658,25480,24505,975,24505,19194,5311,2022-01-01,zipcode,Fort worth
ZCTA5 76180,48,37271,76416,1427,267900,30137,9019,25553,2265,6108,8900,5714,2566,15722,14943,779,14943,7485,7458,2022-01-01,zipcode,North richland hills
ZCTA5 76182,48,30509,110669,1688,340800,24226,7751,21296,966,4271,7309,6317,2433,11589,11252,337,11252,9542,1710,2022-01-01,zipcode,North richland hills
ZCTA5 76201,48,28345,37703,1076,242100,26280,8262,12706,960,1894,4091,3528,2233,12852,11217,1635,11217,2152,9065,2022-01-01,zipcode,Denton
ZCTA5 76205,48,20734,60196,1288,263400,18178,5460,12974,1447,2505,3832,3707,1483,8395,7698,697,7698,2961,4737,2022-01-01,zipcode,Denton
ZCTA5 76207,48,16685,88152,1522,335700,14092,5850,11898,1007,1996,3790,3034,2071,6915,6578,337,6578,4295,2283,2022-01-01,zipcode,Denton
ZCTA5 76208,48,27364,100314,1446,341200,20494,6709,17414,1860,3991,5617,3919,2027,8877,8373,504,8373,5641,2732,2022-01-01,zipcode,Denton
ZCTA5 76209,48,27538,69090,1290,239700,22244,6651,16956,1889,3719,5318,3631,2399,11419,10591,828,10591,4919,5672,2022-01-01,zipcode,Denton
ZCTA5 76210,48,44990,102036,1636,317900,36988,11463,30671,2067,5980,9836,8203,4585,16583,16099,484,16099,11838,4261,2022-01-01,zipcode,Denton
ZCTA5 76225,48,3093,75750,929,251700,2664,802,2325,165,758,811,382,209,1381,1255,126,1255,1024,231,2022-01-01,zipcode,Alvord
ZCTA5 76226,48,37413,165428,2863,490600,28005,9372,24929,391,2815,5456,11096,5171,12876,12723,153,12723,11838,885,2022-01-01,zipcode,Argyle
ZCTA5 76227,48,49155,106113,1877,341900,36360,8603,32491,1343,6212,10962,9491,4483,18611,17982,629,17982,13852,4130,2022-01-01,zipcode,Aubrey
ZCTA5 76228,48,1258,67386,938,126700,1053,504,913,77,338,294,164,40,600,498,102,498,427,71,2022-01-01,zipcode,Bellevue
ZCTA5 76230,48,9742,68301,1088,180400,7718,3612,6871,777,2903,2144,859,188,5030,3835,1195,3835,3055,780,2022-01-01,zipcode,Bowie
ZCTA5 76233,48,3256,68068,1109,214100,2618,1035,2275,190,748,760,373,204,1321,1249,72,1249,971,278,2022-01-01,zipcode,Collinsville
ZCTA5 76234,48,20110,85052,1164,278400,15851,5523,13168,1721,3654,4658,1877,1258,7614,6805,809,6805,5315,1490,2022-01-01,zipcode,Decatur
ZCTA5 76238,48,499,107614,-666666666,-666666666,423,118,339,9,145,109,51,25,175,151,24,151,93,58,2022-01-01,zipcode,Era
ZCTA5 76239,48,1157,56042,772,207600,971,439,861,15,282,399,95,70,604,501,103,501,380,121,2022-01-01,zipcode,Forestburg
ZCTA5 76240,48,29253,58384,1069,183300,22799,8439,19420,2433,5913,6660,2903,1511,12364,11397,967,11397,7174,4223,2022-01-01,zipcode,Gainesville
ZCTA5 76244,48,75185,116568,1851,326700,54833,14314,45942,2305,9861,13935,13782,6059,25625,24135,1490,24135,17538,6597,2022-01-01,zipcode,Keller
ZCTA5 76245,48,1847,66652,639,175600,1683,1117,1641,266,456,591,232,96,1335,877,458,877,723,154,2022-01-01,zipcode,Gordonville
ZCTA5 76247,48,16870,107405,1889,321600,12910,3663,11093,320,2905,4582,2384,902,5846,5689,157,5689,4720,969,2022-01-01,zipcode,Justin
ZCTA5 76248,48,40130,161383,1855,479500,30954,10259,26781,717,3140,6773,10585,5566,14623,14315,308,14315,11622,2693,2022-01-01,zipcode,Keller
ZCTA5 76249,48,9572,103375,1434,257500,7487,2109,6245,372,1334,2352,1742,445,3209,3124,85,3124,2533,591,2022-01-01,zipcode,Krum
ZCTA5 76250,48,835,81964,1088,244000,639,288,592,53,163,235,95,46,353,339,14,339,284,55,2022-01-01,zipcode,Lindsay
ZCTA5 76251,48,672,61172,1386,216000,554,304,494,29,183,174,95,13,305,237,68,237,201,36,2022-01-01,zipcode,Montague
ZCTA5 76252,48,2729,103098,1159,256100,2303,656,1891,126,581,538,423,223,1199,1028,171,1028,831,197,2022-01-01,zipcode,Muenster
ZCTA5 76253,48,264,64130,-666666666,122500,248,134,159,23,102,31,3,0,82,82,0,82,73,9,2022-01-01,zipcode,Myra
ZCTA5 76255,48,5743,53901,763,139300,4436,1870,3873,620,1209,1361,464,219,3043,2229,814,2229,1674,555,2022-01-01,zipcode,Nocona
ZCTA5 76258,48,7559,81552,1200,318400,6298,2427,5193,933,1227,1346,1212,475,2901,2791,110,2791,2002,789,2022-01-01,zipcode,Pilot point
ZCTA5 76259,48,5611,82041,1233,287100,4290,1368,3912,686,1068,1181,575,402,2190,2156,34,2156,1640,516,2022-01-01,zipcode,Ponder
ZCTA5 76261,48,152,58571,-666666666,70000,138,67,133,18,56,20,33,6,126,76,50,76,50,26,2022-01-01,zipcode,Ringgold
ZCTA5 76262,48,42072,130524,1605,473800,31354,8635,27564,1254,3293,7638,10061,5318,15639,14948,691,14948,11085,3863,2022-01-01,zipcode,Roanoke
ZCTA5 76263,48,20,-666666666,-666666666,-666666666,20,0,20,6,8,6,0,0,9,9,0,9,9,0,2022-01-01,zipcode,Rosston
ZCTA5 76264,48,1143,75149,862,296000,1018,376,980,50,329,312,227,62,647,525,122,525,433,92,2022-01-01,zipcode,Sadler
ZCTA5 76265,48,1696,75212,559,170100,1268,521,1149,91,433,365,212,48,897,659,238,659,487,172,2022-01-01,zipcode,Saint jo
ZCTA5 76266,48,18546,93327,1237,291300,14892,4297,12986,1439,3814,4132,2242,1359,7062,6801,261,6801,5580,1221,2022-01-01,zipcode,Sanger
ZCTA5 76268,48,125,83125,-666666666,125000,104,53,88,17,33,38,0,0,50,41,9,41,32,9,2022-01-01,zipcode,Southmayd
ZCTA5 76270,48,2064,68705,-666666666,233800,1804,796,1613,213,647,512,184,57,981,841,140,841,824,17,2022-01-01,zipcode,Sunset
ZCTA5 76271,48,1961,77750,1548,308000,1605,489,1353,105,419,428,306,95,746,703,43,703,562,141,2022-01-01,zipcode,Tioga
ZCTA5 76272,48,5185,93800,779,286700,4199,1639,3797,375,1120,1381,684,237,2068,1873,195,1873,1662,211,2022-01-01,zipcode,Valley view
ZCTA5 76273,48,10553,81969,1097,231300,8683,3574,7416,722,2884,2291,805,714,4180,3995,185,3995,3028,967,2022-01-01,zipcode,Whitesboro
ZCTA5 76301,48,15610,36250,755,60300,12414,5274,10294,2131,4122,2904,598,539,7792,6326,1466,6326,3219,3107,2022-01-01,zipcode,Wichita falls
ZCTA5 76302,48,11169,51159,940,130100,8879,3302,7613,911,2164,2625,1342,571,5142,4858,284,4858,2929,1929,2022-01-01,zipcode,Wichita falls
ZCTA5 76305,48,4829,73729,799,155300,4048,1736,3620,315,1298,1207,612,188,2327,1994,333,1994,1585,409,2022-01-01,zipcode,Wichita falls
ZCTA5 76306,48,14391,47746,902,102200,10518,4185,9100,1307,3266,2739,1234,554,6616,5485,1131,5485,3127,2358,2022-01-01,zipcode,Wichita falls
ZCTA5 76308,48,20493,70872,1040,185300,16548,5376,12500,609,2975,4442,2594,1880,9519,8391,1128,8391,4587,3804,2022-01-01,zipcode,Wichita falls
ZCTA5 76309,48,14216,52250,940,127300,11013,3865,9160,945,3132,2890,1493,700,6626,5714,912,5714,3311,2403,2022-01-01,zipcode,Wichita falls
ZCTA5 76310,48,19676,79264,1003,178800,15521,4331,13420,935,3362,4945,2739,1439,8425,7711,714,7711,5545,2166,2022-01-01,zipcode,Wichita falls
ZCTA5 76311,48,7009,91048,1440,-666666666,6338,499,1575,24,267,702,269,313,682,650,32,650,12,638,2022-01-01,zipcode,Sheppard afb
ZCTA5 76351,48,1687,51010,499,98100,1348,653,1114,137,479,238,181,79,831,687,144,687,503,184,2022-01-01,zipcode,Archer city
ZCTA5 76354,48,11794,64493,876,138700,9703,3935,8434,792,3058,2683,1152,749,5353,4777,576,4777,3082,1695,2022-01-01,zipcode,Burkburnett
ZCTA5 76357,48,490,77083,-666666666,105800,385,160,362,33,136,106,52,35,314,211,103,211,176,35,2022-01-01,zipcode,Byers
ZCTA5 76360,48,2541,51500,705,59100,1972,853,1765,222,596,588,275,84,1463,1108,355,1108,737,371,2022-01-01,zipcode,Electra
ZCTA5 76363,48,247,34107,-666666666,-666666666,214,91,189,33,73,69,10,4,164,107,57,107,87,20,2022-01-01,zipcode,Goree
ZCTA5 76364,48,228,62083,1694,63900,166,50,143,7,47,32,31,26,113,94,19,94,57,37,2022-01-01,zipcode,Harrold
ZCTA5 76365,48,4566,62397,767,134300,3685,1649,3223,256,971,1083,612,301,2327,1904,423,1904,1471,433,2022-01-01,zipcode,Henrietta
ZCTA5 76366,48,1984,49706,743,122900,1525,577,1321,111,535,355,201,119,974,810,164,810,664,146,2022-01-01,zipcode,Holliday
ZCTA5 76367,48,13984,68058,968,128600,11690,6214,10617,2419,3825,2669,1042,662,4313,3993,320,3993,3425,568,2022-01-01,zipcode,Iowa park
ZCTA5 76370,48,478,83250,-666666666,80800,393,161,375,36,191,16,96,36,244,181,63,181,151,30,2022-01-01,zipcode,Megargel
ZCTA5 76371,48,1628,57431,475,54100,1226,491,1092,211,387,346,93,55,783,589,194,589,516,73,2022-01-01,zipcode,Munday
ZCTA5 76372,48,1005,69167,538,91700,782,334,677,103,314,159,75,26,505,406,99,406,302,104,2022-01-01,zipcode,Newcastle
ZCTA5 76373,48,155,77938,-666666666,-666666666,150,78,121,69,20,7,25,0,57,57,0,57,50,7,2022-01-01,zipcode,Oklaunion
ZCTA5 76374,48,3629,41019,605,91100,2944,1238,2642,284,911,863,395,189,1993,1713,280,1713,1226,487,2022-01-01,zipcode,Olney
ZCTA5 76377,48,438,52857,625,84800,366,210,338,26,153,114,33,12,309,210,99,210,174,36,2022-01-01,zipcode,Petrolia
ZCTA5 76379,48,596,80972,904,127400,464,137,373,27,157,128,57,4,215,195,20,195,158,37,2022-01-01,zipcode,Scotland
ZCTA5 76380,48,3526,53197,568,91800,2842,1293,2519,352,916,677,481,93,2258,1497,761,1497,1013,484,2022-01-01,zipcode,Seymour
ZCTA5 76384,48,12279,50250,790,84900,9954,4190,8353,1800,2773,2428,1039,313,5585,4398,1187,4398,2589,1809,2022-01-01,zipcode,Vernon
ZCTA5 76388,48,205,48125,-666666666,50000,178,74,151,20,66,38,23,4,109,87,22,87,62,25,2022-01-01,zipcode,Weinert
ZCTA5 76389,48,1418,99375,814,189600,1151,405,952,111,459,217,136,29,567,502,65,502,442,60,2022-01-01,zipcode,Windthorst
ZCTA5 76401,48,30703,56918,1079,227500,25156,8977,17631,2033,4355,5111,4201,1931,13520,11897,1623,11897,6757,5140,2022-01-01,zipcode,Stephenville
ZCTA5 76402,48,720,-666666666,-666666666,-666666666,720,319,0,0,0,0,0,0,0,0,0,0,0,0,2022-01-01,zipcode,Stephenville
ZCTA5 76424,48,8656,44423,688,94500,6880,2871,5878,1022,2044,1753,778,281,4212,3166,1046,3166,2445,721,2022-01-01,zipcode,Breckenridge
ZCTA5 76426,48,11132,82346,1097,235900,8835,3375,7657,1267,2184,2206,1339,661,4493,3830,663,3830,2866,964,2022-01-01,zipcode,Bridgeport
ZCTA5 76427,48,1030,70141,959,117900,757,321,622,69,249,209,94,1,421,356,65,356,218,138,2022-01-01,zipcode,Bryson
ZCTA5 76429,48,129,2499,-666666666,-666666666,129,82,129,20,63,7,39,0,133,72,61,72,72,0,2022-01-01,zipcode,Caddo
ZCTA5 76430,48,2260,60093,478,172900,1879,688,1576,89,400,593,413,81,1124,972,152,972,795,177,2022-01-01,zipcode,Albany
ZCTA5 76431,48,4543,70536,1224,163100,3349,1285,2970,558,1179,847,314,72,1767,1609,158,1609,1377,232,2022-01-01,zipcode,Chico
ZCTA5 76432,48,1178,53333,758,130900,918,428,830,148,296,271,68,47,629,446,183,446,414,32,2022-01-01,zipcode,Blanket
ZCTA5 76433,48,1945,108080,969,362300,1614,748,1455,73,350,349,408,275,815,734,81,734,629,105,2022-01-01,zipcode,Bluff dale
ZCTA5 76435,48,541,59792,1313,87700,442,208,383,71,144,106,56,6,353,203,150,203,185,18,2022-01-01,zipcode,Carbon
ZCTA5 76436,48,101,57125,-666666666,-666666666,90,28,62,0,28,11,23,0,117,43,74,43,38,5,2022-01-01,zipcode,Carlton
ZCTA5 76437,48,5920,63272,847,113800,5087,2117,3849,363,891,1501,751,343,2895,2320,575,2320,1697,623,2022-01-01,zipcode,Cisco
ZCTA5 76442,48,7281,60321,815,132400,5693,2166,4965,689,1666,1778,523,309,3641,2814,827,2814,2266,548,2022-01-01,zipcode,Comanche
ZCTA5 76443,48,1828,49844,695,119800,1396,670,1268,83,454,419,258,54,970,774,196,774,554,220,2022-01-01,zipcode,Cross plains
ZCTA5 76444,48,3793,57583,535,104900,3086,1182,2751,527,1006,687,420,111,1726,1461,265,1461,1197,264,2022-01-01,zipcode,De leon
ZCTA5 76445,48,416,-666666666,-666666666,-666666666,323,106,290,8,108,89,0,85,197,108,89,108,104,4,2022-01-01,zipcode,Desdemona
ZCTA5 76446,48,8554,57321,955,172300,6751,2573,5609,1171,1701,1493,801,443,3944,3188,756,3188,2659,529,2022-01-01,zipcode,Dublin
ZCTA5 76448,48,4969,63641,759,178100,4043,1861,3804,392,1362,925,708,417,2859,2083,776,2083,1457,626,2022-01-01,zipcode,Eastland
ZCTA5 76449,48,2389,73824,788,222500,2075,990,1900,113,618,682,316,171,2990,1110,1880,1110,961,149,2022-01-01,zipcode,Graford
ZCTA5 76450,48,13003,71563,887,168500,10155,4135,8950,1097,2865,2974,1440,574,6300,5328,972,5328,3951,1377,2022-01-01,zipcode,Graham
ZCTA5 76452,48,133,197593,-666666666,-666666666,133,45,133,5,15,96,17,0,97,60,37,60,60,0,2022-01-01,zipcode,Energy
ZCTA5 76453,48,1442,95536,992,317000,1175,583,1143,85,357,290,195,216,952,671,281,671,581,90,2022-01-01,zipcode,Gordon
ZCTA5 76454,48,1668,41204,629,86400,1323,687,1160,240,386,406,96,32,798,630,168,630,388,242,2022-01-01,zipcode,Gorman
ZCTA5 76455,48,698,54375,725,113800,610,255,539,104,173,121,117,24,471,335,136,335,298,37,2022-01-01,zipcode,Gustine
ZCTA5 76457,48,4023,59569,988,149800,3105,1448,2710,240,1044,821,430,175,1968,1434,534,1434,1119,315,2022-01-01,zipcode,Hico
ZCTA5 76458,48,6049,56786,822,136900,4908,2733,4220,944,1325,1283,500,168,2533,2058,475,2058,1492,566,2022-01-01,zipcode,Jacksboro
ZCTA5 76459,48,139,48750,-666666666,56500,121,52,115,38,60,17,0,0,100,72,28,72,72,0,2022-01-01,zipcode,Jermyn
ZCTA5 76460,48,472,85729,-666666666,201800,452,154,326,0,89,129,91,17,225,161,64,161,116,45,2022-01-01,zipcode,Loving
ZCTA5 76462,48,4669,94167,1396,254700,3310,978,2830,310,770,762,566,422,1639,1478,161,1478,1278,200,2022-01-01,zipcode,Lipan
ZCTA5 76463,48,500,61250,642,84000,442,192,388,49,151,130,51,7,278,194,84,194,166,28,2022-01-01,zipcode,Mingus
ZCTA5 76464,48,409,63750,725,117200,388,159,366,67,88,68,109,34,334,211,123,211,170,41,2022-01-01,zipcode,Moran
ZCTA5 76466,48,621,128260,-666666666,-666666666,389,73,306,67,99,79,61,0,155,155,0,155,118,37,2022-01-01,zipcode,Olden
ZCTA5 76469,48,73,56750,-666666666,67000,69,51,61,17,25,15,4,0,66,35,31,35,35,0,2022-01-01,zipcode,Putnam
ZCTA5 76470,48,3022,36646,585,54400,2409,1097,1936,474,489,759,140,74,1664,1264,400,1264,796,468,2022-01-01,zipcode,Ranger
ZCTA5 76471,48,1464,48529,626,101300,1203,616,1092,173,283,372,143,121,967,650,317,650,480,170,2022-01-01,zipcode,Rising star
ZCTA5 76472,48,1503,96360,-666666666,-666666666,1281,316,1027,79,290,200,375,83,621,541,80,541,444,97,2022-01-01,zipcode,Santo
ZCTA5 76474,48,340,-666666666,-666666666,320400,231,112,210,3,19,138,38,12,130,111,19,111,104,7,2022-01-01,zipcode,Sidney
ZCTA5 76475,48,947,54688,708,138500,754,374,712,64,239,243,116,50,847,381,466,381,268,113,2022-01-01,zipcode,Strawn
ZCTA5 76476,48,3423,77130,1161,193900,2516,970,2203,215,886,733,247,122,1129,1056,73,1056,899,157,2022-01-01,zipcode,Tolar
ZCTA5 76481,48,205,75690,-666666666,72800,205,68,166,45,0,58,39,24,169,150,19,150,150,0,2022-01-01,zipcode,South bend
ZCTA5 76483,48,746,51827,-666666666,57900,684,234,579,69,205,187,90,28,549,375,174,375,263,112,2022-01-01,zipcode,Throckmorton
ZCTA5 76484,48,739,91731,-666666666,166200,723,412,564,53,216,182,64,49,524,284,240,284,278,6,2022-01-01,zipcode,Palo pinto
ZCTA5 76486,48,1379,65625,1031,280400,1112,338,912,66,222,453,126,45,679,539,140,539,411,128,2022-01-01,zipcode,Perrin
ZCTA5 76487,48,2707,75063,1457,189500,2048,821,1742,124,600,711,147,160,1231,954,277,954,833,121,2022-01-01,zipcode,Poolville
ZCTA5 76490,48,39,-666666666,-666666666,-666666666,39,0,21,0,0,21,0,0,21,21,0,21,14,7,2022-01-01,zipcode,Whitt
ZCTA5 76491,48,625,64438,772,99700,478,207,417,35,167,124,69,22,269,215,54,215,151,64,2022-01-01,zipcode,Woodson
ZCTA5 76501,48,17200,50855,879,147700,13482,6039,11115,1814,3525,3670,1562,544,7408,6600,808,6600,4313,2287,2022-01-01,zipcode,Temple
ZCTA5 76502,48,48508,77704,1330,222600,35317,12905,30707,2487,6598,10181,6780,4661,18381,17425,956,17425,11352,6073,2022-01-01,zipcode,Temple
ZCTA5 76504,48,24276,44256,1023,142600,19515,7392,15975,2516,4800,5458,1906,1295,10953,9990,963,9990,3177,6813,2022-01-01,zipcode,Temple
ZCTA5 76511,48,2390,54750,738,150200,1868,726,1669,214,758,506,120,71,1045,895,150,895,725,170,2022-01-01,zipcode,Bartlett
ZCTA5 76513,48,43738,76564,1134,235500,33774,12636,27567,2790,6810,9004,5601,3362,15868,14872,996,14872,10069,4803,2022-01-01,zipcode,Belton
ZCTA5 76518,48,1473,53125,688,160700,1214,662,953,125,438,283,92,15,640,524,116,524,404,120,2022-01-01,zipcode,Buckholts
ZCTA5 76519,48,483,86181,-666666666,171900,361,158,343,30,82,111,100,20,355,177,178,177,177,0,2022-01-01,zipcode,Burlington
ZCTA5 76520,48,7878,59340,836,135000,5886,2380,5117,991,1680,1415,760,271,3255,2731,524,2731,2005,726,2022-01-01,zipcode,Cameron
ZCTA5 76522,48,41087,65760,966,153000,31383,11490,26498,1656,7198,12364,3831,1449,16789,15716,1073,15716,9399,6317,2022-01-01,zipcode,Copperas cove
ZCTA5 76523,48,477,56089,-666666666,170800,350,137,283,28,146,109,0,0,135,135,0,135,131,4,2022-01-01,zipcode,Davilla
ZCTA5 76524,48,4053,75435,1136,176800,3355,1283,2882,557,865,917,251,292,1547,1452,95,1452,1181,271,2022-01-01,zipcode,Eddy
ZCTA5 76525,48,1227,74063,739,142600,1012,450,893,101,268,254,157,113,623,495,128,495,374,121,2022-01-01,zipcode,Evant
ZCTA5 76527,48,4141,71366,766,374400,3121,1053,2663,219,870,1068,352,154,1597,1501,96,1501,1108,393,2022-01-01,zipcode,Florence
ZCTA5 76528,48,19323,58862,862,157900,15834,8474,14004,1593,4268,5807,1428,908,7440,6592,848,6592,4591,2001,2022-01-01,zipcode,Gatesville
ZCTA5 76530,48,2424,76953,727,201200,2113,808,1847,183,713,617,227,107,1099,963,136,963,816,147,2022-01-01,zipcode,Granger
ZCTA5 76531,48,4591,55857,853,128500,3915,1733,3230,385,1178,882,581,204,2311,1680,631,1680,1402,278,2022-01-01,zipcode,Hamilton
ZCTA5 76534,48,2890,71103,836,185000,2322,1022,2064,291,593,693,348,139,1214,1065,149,1065,814,251,2022-01-01,zipcode,Holland
ZCTA5 76537,48,11501,88250,1604,251900,8729,1972,7392,1031,2218,2624,1124,395,4159,3951,208,3951,3225,726,2022-01-01,zipcode,Jarrell
ZCTA5 76538,48,1155,58654,658,123200,1017,542,922,63,297,336,179,47,592,496,96,496,423,73,2022-01-01,zipcode,Jonesboro
ZCTA5 76539,48,8713,82053,894,237200,7017,3410,6314,422,1831,2786,925,350,3708,3124,584,3124,2886,238,2022-01-01,zipcode,Kempner
ZCTA5 76541,48,18849,34732,824,87400,15012,5512,12117,2191,3780,4921,1049,176,10208,8321,1887,8321,1996,6325,2022-01-01,zipcode,Killeen
ZCTA5 76542,48,52059,73133,1191,210900,39220,12357,31516,1721,7275,13328,6434,2758,20185,18996,1189,18996,11639,7357,2022-01-01,zipcode,Killeen
ZCTA5 76543,48,33220,49021,1036,123100,24612,7942,19831,2045,5803,8591,2319,1073,14858,13081,1777,13081,4971,8110,2022-01-01,zipcode,Killeen
ZCTA5 76544,48,26040,54561,1291,9999,20422,3546,8003,133,1473,4525,1426,446,7361,4207,3154,4207,25,4182,2022-01-01,zipcode,Fort hood
ZCTA5 76548,48,32608,71845,1062,239400,24121,7739,20107,1865,4574,7381,4353,1934,12605,11655,950,11655,6516,5139,2022-01-01,zipcode,Harker heights
ZCTA5 76549,48,55730,62607,1248,185600,39796,12365,32505,1630,8960,14296,5173,2446,21152,19398,1754,19398,10059,9339,2022-01-01,zipcode,Killeen
ZCTA5 76550,48,13574,71618,854,218300,10842,4822,9490,928,3043,3578,1314,627,6129,5050,1079,5050,3817,1233,2022-01-01,zipcode,Lampasas
ZCTA5 76554,48,2509,72656,1073,158000,1695,472,1483,215,386,580,204,98,909,807,102,807,616,191,2022-01-01,zipcode,Little river academy
ZCTA5 76556,48,2008,63438,-666666666,156600,1571,630,1276,133,499,414,120,110,940,735,205,735,668,67,2022-01-01,zipcode,Milano
ZCTA5 76557,48,5389,70017,1055,168800,4510,1782,3631,384,1147,1169,649,282,1995,1805,190,1805,1383,422,2022-01-01,zipcode,Moody
ZCTA5 76559,48,6443,65022,1046,171600,4652,1400,3791,448,740,1556,441,606,2566,2319,247,2319,1529,790,2022-01-01,zipcode,Nolanville
ZCTA5 76561,48,1207,69250,835,136000,934,377,823,124,273,252,112,62,532,427,105,427,325,102,2022-01-01,zipcode,Oglesby
ZCTA5 76565,48,39,-666666666,-666666666,-666666666,39,20,19,0,0,19,0,0,10,10,0,10,10,0,2022-01-01,zipcode,Pottsville
ZCTA5 76566,48,344,142500,-666666666,250000,255,128,233,42,65,58,60,8,156,120,36,120,116,4,2022-01-01,zipcode,Purmela
ZCTA5 76567,48,8244,48472,938,152500,6960,2906,5969,879,2572,1607,587,324,4203,3668,535,3668,2659,1009,2022-01-01,zipcode,Rockdale
ZCTA5 76569,48,3304,78798,994,102700,2644,1023,2058,76,727,855,258,142,1122,991,131,991,833,158,2022-01-01,zipcode,Rogers
ZCTA5 76570,48,2243,38632,723,79300,1724,847,1402,225,463,457,148,109,1223,861,362,861,692,169,2022-01-01,zipcode,Rosebud
ZCTA5 76571,48,9648,94517,1135,351300,7681,3128,6872,326,1564,2182,1832,968,3865,3555,310,3555,3073,482,2022-01-01,zipcode,Salado
ZCTA5 76573,48,27,-666666666,-666666666,-666666666,20,14,13,13,0,0,0,0,6,6,0,6,6,0,2022-01-01,zipcode,Schwertner
ZCTA5 76574,48,19629,68360,1050,235100,15645,5957,13740,1970,4944,4168,1781,877,8461,7686,775,7686,5648,2038,2022-01-01,zipcode,Taylor
ZCTA5 76577,48,3196,68141,970,134100,2539,929,2251,191,833,643,444,140,1450,1262,188,1262,966,296,2022-01-01,zipcode,Thorndale
ZCTA5 76578,48,1232,92188,1094,235700,1003,382,915,158,284,288,136,49,576,460,116,460,364,96,2022-01-01,zipcode,Thrall
ZCTA5 76579,48,5129,69471,1129,189700,3673,1502,3146,176,1075,1044,601,250,1840,1713,127,1713,1072,641,2022-01-01,zipcode,Troy
ZCTA5 76596,48,1097,-666666666,-666666666,-666666666,1097,1097,1026,234,261,490,34,7,0,0,0,0,0,0,2022-01-01,zipcode,Gatesville
ZCTA5 76597,48,3123,-666666666,-666666666,-666666666,3123,3123,2974,961,1053,870,45,45,0,0,0,0,0,0,2022-01-01,zipcode,Gatesville
ZCTA5 76598,48,440,-666666666,-666666666,-666666666,440,440,412,107,146,156,0,3,0,0,0,0,0,0,2022-01-01,zipcode,Gatesville
ZCTA5 76599,48,1764,-666666666,-666666666,-666666666,1764,1764,1720,407,616,640,52,5,0,0,0,0,0,0,2022-01-01,zipcode,Gatesville
ZCTA5 76621,48,1002,94375,1347,224100,731,195,673,18,180,254,153,68,473,360,113,360,342,18,2022-01-01,zipcode,Abbott
ZCTA5 76622,48,1558,73438,611,200000,1162,459,966,88,283,432,128,35,566,495,71,495,418,77,2022-01-01,zipcode,Aquilla
ZCTA5 76623,48,197,62917,-666666666,85000,149,48,138,74,28,34,2,0,79,63,16,63,56,7,2022-01-01,zipcode,Avalon
ZCTA5 76624,48,2587,67708,882,126600,2188,1013,1647,256,530,694,124,43,1100,918,182,918,832,86,2022-01-01,zipcode,Axtell
ZCTA5 76626,48,1363,94688,1102,151000,1100,409,924,71,248,473,109,23,691,541,150,541,432,109,2022-01-01,zipcode,Blooming grove
ZCTA5 76627,48,1389,70250,1115,121900,1215,381,958,189,398,268,80,23,668,558,110,558,502,56,2022-01-01,zipcode,Blum
ZCTA5 76628,48,91,117857,-666666666,178600,68,24,44,22,14,3,5,0,23,18,5,18,18,0,2022-01-01,zipcode,Brandon
ZCTA5 76629,48,1916,63333,890,149800,1582,832,1478,247,545,528,119,39,1121,832,289,832,637,195,2022-01-01,zipcode,Bremond
ZCTA5 76630,48,1953,79000,991,226900,1554,664,1402,152,288,693,122,147,860,804,56,804,695,109,2022-01-01,zipcode,Bruceville
ZCTA5 76631,48,540,83438,1031,121400,435,157,328,42,136,79,39,32,194,153,41,153,124,29,2022-01-01,zipcode,Bynum
ZCTA5 76632,48,1901,41875,836,126500,1465,624,1275,351,311,415,140,58,723,577,146,577,473,104,2022-01-01,zipcode,Chilton
ZCTA5 76633,48,6348,106700,1680,300200,4930,2033,4208,213,1404,1452,664,475,2024,1996,28,1996,1787,209,2022-01-01,zipcode,China spring
ZCTA5 76634,48,7316,68440,904,154000,5906,2766,5432,608,1441,1987,1007,389,3740,2936,804,2936,2247,689,2022-01-01,zipcode,Clifton
ZCTA5 76635,48,1397,55393,763,118600,873,329,766,89,182,237,105,153,578,469,109,469,347,122,2022-01-01,zipcode,Coolidge
ZCTA5 76636,48,1638,66917,775,208400,1316,528,1082,168,392,355,139,28,645,581,64,581,529,52,2022-01-01,zipcode,Covington
ZCTA5 76637,48,466,71250,805,262500,416,244,374,45,137,111,54,27,257,208,49,208,139,69,2022-01-01,zipcode,Cranfills gap
ZCTA5 76638,48,3106,117708,1113,328700,2334,911,2026,42,559,697,433,295,1126,1023,103,1023,959,64,2022-01-01,zipcode,Crawford
ZCTA5 76639,48,1823,39907,603,113200,1456,750,1173,83,457,471,125,37,868,692,176,692,444,248,2022-01-01,zipcode,Dawson
ZCTA5 76640,48,2953,52074,852,162100,2148,975,1888,128,731,695,319,15,1209,1091,118,1091,827,264,2022-01-01,zipcode,Elm mott
ZCTA5 76641,48,1714,64231,1087,137000,1420,672,1187,214,413,394,85,81,700,592,108,592,474,118,2022-01-01,zipcode,Frost
ZCTA5 76642,48,6216,57622,779,170000,4984,2653,4487,735,1452,1454,665,181,2843,2306,537,2306,1697,609,2022-01-01,zipcode,Groesbeck
ZCTA5 76643,48,16034,75898,1308,233700,12542,4265,10575,786,1909,4186,2355,1339,6057,5955,102,5955,3953,2002,2022-01-01,zipcode,Hewitt
ZCTA5 76645,48,10970,57500,903,139100,8645,3707,7309,1230,2489,2280,866,444,4415,3940,475,3940,2440,1500,2022-01-01,zipcode,Hillsboro
ZCTA5 76648,48,2751,49833,845,113800,2174,1004,1910,234,644,699,247,86,1356,1006,350,1006,778,228,2022-01-01,zipcode,Hubbard
ZCTA5 76649,48,700,67500,1073,122800,596,299,539,45,245,177,69,3,407,316,91,316,263,53,2022-01-01,zipcode,Iredell
ZCTA5 76650,48,96,79167,-666666666,110900,64,17,59,9,22,28,0,0,42,30,12,30,27,3,2022-01-01,zipcode,Irene
ZCTA5 76651,48,3902,63173,1080,190900,3001,1289,2388,283,867,830,258,150,1566,1401,165,1401,986,415,2022-01-01,zipcode,Italy
ZCTA5 76652,48,955,65278,-666666666,162500,838,459,789,60,402,252,62,13,561,436,125,436,400,36,2022-01-01,zipcode,Kopperl
ZCTA5 76653,48,1426,56875,-666666666,136900,1241,622,1046,132,448,395,57,14,687,590,97,590,485,105,2022-01-01,zipcode,Kosse
ZCTA5 76654,48,173,65417,-666666666,158000,156,64,134,15,37,47,29,6,91,84,7,84,66,18,2022-01-01,zipcode,Leroy
ZCTA5 76655,48,8591,110248,1390,259600,6959,2240,6062,199,1526,2095,1635,607,3235,3048,187,3048,2710,338,2022-01-01,zipcode,Lorena
ZCTA5 76656,48,2560,71691,967,106200,2080,782,1799,144,709,626,215,105,1116,909,207,909,695,214,2022-01-01,zipcode,Lott
ZCTA5 76657,48,12160,92935,1210,341700,9322,3199,8055,695,2130,2404,1835,991,4382,4048,334,4048,3079,969,2022-01-01,zipcode,Mc gregor
ZCTA5 76660,48,664,47188,981,125000,435,241,342,66,96,111,61,8,261,195,66,195,148,47,2022-01-01,zipcode,Malone
ZCTA5 76661,48,7118,31888,558,78200,5878,3543,4930,1197,1350,2047,242,94,2961,1988,973,1988,1417,571,2022-01-01,zipcode,Marlin
ZCTA5 76664,48,3698,63621,958,120100,2830,1356,2301,287,856,867,252,39,1366,1216,150,1216,912,304,2022-01-01,zipcode,Mart
ZCTA5 76665,48,2596,56130,611,117600,2155,994,1842,247,591,719,185,100,1315,1047,268,1047,635,412,2022-01-01,zipcode,Meridian
ZCTA5 76666,48,186,41042,-666666666,118800,156,53,138,13,40,71,3,11,105,79,26,79,45,34,2022-01-01,zipcode,Mertens
ZCTA5 76667,48,10275,46130,768,108900,8135,4233,7033,1150,2640,2292,670,281,4629,3717,912,3717,2586,1131,2022-01-01,zipcode,Mexia
ZCTA5 76670,48,1934,57206,940,157800,1547,598,1352,236,515,519,33,49,706,626,80,626,441,185,2022-01-01,zipcode,Milford
ZCTA5 76671,48,2011,68750,820,185300,1718,909,1554,179,525,602,157,91,1125,820,305,820,685,135,2022-01-01,zipcode,Morgan
ZCTA5 76673,48,1162,53482,1035,115600,877,389,764,108,213,328,88,27,475,377,98,377,310,67,2022-01-01,zipcode,Mount calm
ZCTA5 76676,48,317,63125,917,155000,232,93,222,38,58,60,57,9,144,125,19,125,112,13,2022-01-01,zipcode,Penelope
ZCTA5 76678,48,112,45682,-666666666,154500,112,63,87,5,18,51,10,3,77,52,25,52,52,0,2022-01-01,zipcode,Prairie hill
ZCTA5 76679,48,1161,77702,-666666666,120400,875,318,797,88,280,233,171,25,494,375,119,375,358,17,2022-01-01,zipcode,Purdon
ZCTA5 76680,48,199,-666666666,-666666666,29400,199,114,152,0,93,33,14,12,147,51,96,51,51,0,2022-01-01,zipcode,Reagan
ZCTA5 76681,48,419,31705,-666666666,86800,358,143,326,45,150,92,37,2,285,175,110,175,157,18,2022-01-01,zipcode,Richland
ZCTA5 76682,48,3276,73654,1125,136600,2393,854,1980,174,756,640,321,89,1293,1124,169,1124,933,191,2022-01-01,zipcode,Riesel
ZCTA5 76685,48,49,-666666666,-666666666,-666666666,49,35,49,17,32,0,0,0,61,31,30,31,31,0,2022-01-01,zipcode,Satin
ZCTA5 76686,48,230,63750,-666666666,110000,205,92,166,1,56,57,46,6,116,96,20,96,70,26,2022-01-01,zipcode,Tehuacana
ZCTA5 76687,48,1741,67720,889,249300,1619,1031,1492,111,559,504,239,79,1247,795,452,795,698,97,2022-01-01,zipcode,Thornton
ZCTA5 76689,48,4308,63889,1124,183400,3274,1261,2687,289,809,1167,298,124,1774,1496,278,1496,1233,263,2022-01-01,zipcode,Valley mills
ZCTA5 76690,48,1285,41667,1064,121000,905,384,801,156,360,149,81,55,765,474,291,474,343,131,2022-01-01,zipcode,Walnut springs
ZCTA5 76691,48,6315,75163,935,213300,5006,1884,4298,500,1451,1493,580,274,2629,2345,284,2345,1849,496,2022-01-01,zipcode,West
ZCTA5 76692,48,9673,57891,880,121900,8085,3803,7327,1095,2490,2334,929,479,5343,4039,1304,4039,3102,937,2022-01-01,zipcode,Whitney
ZCTA5 76693,48,2320,54074,844,134700,1875,1102,1569,336,284,611,270,68,1018,800,218,800,619,181,2022-01-01,zipcode,Wortham
ZCTA5 76701,48,1861,29714,1137,100000,1686,797,1277,215,347,295,206,214,999,826,173,826,152,674,2022-01-01,zipcode,Waco
ZCTA5 76704,48,7450,19966,713,105200,5095,2294,4290,828,1816,1442,119,85,3801,3250,551,3250,1060,2190,2022-01-01,zipcode,Waco
ZCTA5 76705,48,31985,51546,882,152000,25426,11293,20018,3945,5917,6851,2090,1215,12180,10811,1369,10811,6384,4427,2022-01-01,zipcode,Waco
ZCTA5 76706,48,40770,39317,997,162900,33369,13500,17907,2965,5640,5142,2707,1453,16488,14397,2091,14397,5390,9007,2022-01-01,zipcode,Waco
ZCTA5 76707,48,16516,33964,1012,99500,12167,4675,9275,2401,3188,2392,898,396,6731,5656,1075,5656,3182,2474,2022-01-01,zipcode,Waco
ZCTA5 76708,48,26917,64618,1058,182400,20020,6610,16539,2603,3921,5926,2609,1480,10806,9523,1283,9523,6170,3353,2022-01-01,zipcode,Waco
ZCTA5 76710,48,23008,49762,1022,202900,19127,6808,16671,1288,4445,5761,2934,2243,12299,10762,1537,10762,5096,5666,2022-01-01,zipcode,Waco
ZCTA5 76711,48,9474,51526,1313,90500,7680,2600,6116,1424,1911,1780,418,583,4241,3814,427,3814,1982,1832,2022-01-01,zipcode,Waco
ZCTA5 76712,48,28758,91862,1244,277900,21671,7640,19400,1020,2910,5823,5238,4409,11502,10732,770,10732,7378,3354,2022-01-01,zipcode,Woodway
ZCTA5 76798,48,2907,-666666666,-666666666,-666666666,2907,2197,39,0,0,0,39,0,0,0,0,0,0,0,2022-01-01,zipcode,Waco
ZCTA5 76801,48,25048,51603,851,126100,20472,8340,17004,2293,5735,5846,2213,917,11887,9660,2227,9660,6034,3626,2022-01-01,zipcode,Brownwood
ZCTA5 76802,48,5667,65750,1125,182800,4443,1702,3944,377,1213,1306,885,163,2491,2180,311,2180,1698,482,2022-01-01,zipcode,Early
ZCTA5 76820,48,135,-666666666,-666666666,316000,135,71,115,0,49,35,25,6,113,80,33,80,56,24,2022-01-01,zipcode,Art
ZCTA5 76821,48,4436,60924,964,89500,3460,1366,3122,394,1087,1014,379,248,2191,1701,490,1701,1228,473,2022-01-01,zipcode,Ballinger
ZCTA5 76823,48,2741,54594,762,117000,2347,1120,2024,192,794,595,337,106,1338,1049,289,1049,839,210,2022-01-01,zipcode,Bangs
ZCTA5 76824,48,0,-666666666,-666666666,-666666666,0,0,0,0,0,0,0,0,0,0,0,0,0,0,2022-01-01,zipcode,Bend
ZCTA5 76825,48,6415,52143,805,93800,5136,2060,4465,982,1293,1351,648,191,3440,2658,782,2658,1786,872,2022-01-01,zipcode,Brady
ZCTA5 76827,48,611,-666666666,725,160300,528,321,459,100,100,206,44,9,360,280,80,280,263,17,2022-01-01,zipcode,Brookesmith
ZCTA5 76828,48,236,49688,-666666666,126400,203,140,203,13,21,120,45,4,149,111,38,111,108,3,2022-01-01,zipcode,Burkett
ZCTA5 76831,48,0,-666666666,-666666666,-666666666,0,0,0,0,0,0,0,0,0,0,0,0,0,0,2022-01-01,zipcode,Castell
ZCTA5 76832,48,572,44886,-666666666,116100,484,205,398,83,150,113,40,12,320,187,133,187,115,72,2022-01-01,zipcode,Cherokee
ZCTA5 76834,48,4992,50565,752,88000,3990,1583,3513,467,1067,1276,536,167,3100,2098,1002,2098,1475,623,2022-01-01,zipcode,Coleman
ZCTA5 76836,48,3,-666666666,-666666666,-666666666,3,0,3,0,0,2,1,0,26,1,25,1,1,0,2022-01-01,zipcode,Doole
ZCTA5 76837,48,1964,49250,688,87100,1670,1191,1480,445,511,398,81,45,657,442,215,442,328,114,2022-01-01,zipcode,Eden
ZCTA5 76841,48,186,-666666666,-666666666,-666666666,62,33,29,0,0,0,9,20,67,9,58,9,0,9,2022-01-01,zipcode,Fort mc kavett
ZCTA5 76842,48,179,52625,-666666666,-666666666,175,115,169,50,18,51,34,16,233,107,126,107,107,0,2022-01-01,zipcode,Fredonia
ZCTA5 76844,48,3307,61989,625,184600,2770,1221,2434,321,718,684,441,270,1929,1343,586,1343,1127,216,2022-01-01,zipcode,Goldthwaite
ZCTA5 76845,48,231,72500,-666666666,226000,190,58,165,7,49,40,55,14,146,106,40,106,94,12,2022-01-01,zipcode,Gouldbusk
ZCTA5 76848,48,66,-666666666,-666666666,-666666666,66,39,66,0,0,66,0,0,53,30,23,30,30,0,2022-01-01,zipcode,Hext
ZCTA5 76849,48,3733,58413,700,189600,3071,1222,2696,395,760,809,489,243,2231,1429,802,1429,1131,298,2022-01-01,zipcode,Junction
ZCTA5 76852,48,286,78333,1031,197000,235,131,228,11,80,84,29,24,196,124,72,124,107,17,2022-01-01,zipcode,Lohn
ZCTA5 76853,48,1639,56420,582,225000,1410,678,1194,188,302,389,230,85,828,551,277,551,430,121,2022-01-01,zipcode,Lometa
ZCTA5 76854,48,290,-666666666,-666666666,157300,229,85,215,118,43,0,39,15,228,86,142,86,29,57,2022-01-01,zipcode,London
ZCTA5 76856,48,3506,80210,818,239600,2759,1247,2383,385,473,609,651,265,1866,1278,588,1278,1016,262,2022-01-01,zipcode,Mason
ZCTA5 76857,48,1989,46047,1558,152500,1703,931,1551,162,496,615,214,64,1793,958,835,958,667,291,2022-01-01,zipcode,May
ZCTA5 76858,48,226,50500,-666666666,81800,197,90,180,54,25,58,29,14,174,108,66,108,100,8,2022-01-01,zipcode,Melvin
ZCTA5 76859,48,1728,39730,714,89500,1546,789,1458,292,398,407,249,112,1510,948,562,948,734,214,2022-01-01,zipcode,Menard
ZCTA5 76861,48,2048,68750,850,150900,1543,578,1305,223,433,359,228,62,784,690,94,690,529,161,2022-01-01,zipcode,Miles
ZCTA5 76862,48,167,56250,-666666666,-666666666,137,89,133,4,65,36,19,9,241,76,165,76,70,6,2022-01-01,zipcode,Millersview
ZCTA5 76864,48,800,43464,716,230600,688,365,635,65,266,176,88,40,514,317,197,317,277,40,2022-01-01,zipcode,Mullin
ZCTA5 76865,48,200,54792,-666666666,107700,195,73,195,65,58,62,10,0,141,85,56,85,73,12,2022-01-01,zipcode,Norton
ZCTA5 76866,48,946,62885,-666666666,125000,750,324,726,136,305,189,84,12,367,206,161,206,172,34,2022-01-01,zipcode,Paint rock
ZCTA5 76869,48,190,-666666666,-666666666,-666666666,60,27,49,0,4,39,0,6,79,32,47,32,32,0,2022-01-01,zipcode,Pontotoc
ZCTA5 76870,48,70,-666666666,-666666666,-666666666,64,25,63,0,13,23,14,13,41,23,18,23,20,3,2022-01-01,zipcode,Priddy
ZCTA5 76871,48,561,59375,650,192900,491,294,357,20,140,99,74,24,391,193,198,193,168,25,2022-01-01,zipcode,Richland springs
ZCTA5 76872,48,798,55000,1065,129200,626,299,574,46,276,142,40,70,481,312,169,312,245,67,2022-01-01,zipcode,Rochelle
ZCTA5 76873,48,89,-666666666,-666666666,820300,59,29,52,7,10,1,18,16,53,30,23,30,23,7,2022-01-01,zipcode,Rockwood
ZCTA5 76874,48,0,-666666666,-666666666,-666666666,0,0,0,0,0,0,0,0,11,0,11,0,0,0,2022-01-01,zipcode,Roosevelt
ZCTA5 76875,48,484,54429,738,147200,385,150,368,31,172,104,42,19,296,234,62,234,192,42,2022-01-01,zipcode,Rowena
ZCTA5 76877,48,4509,54406,914,132400,3689,1804,3223,457,1302,866,424,174,2003,1555,448,1555,1174,381,2022-01-01,zipcode,San saba
ZCTA5 76878,48,1717,49250,550,67500,1294,577,1165,118,338,495,164,50,915,618,297,618,424,194,2022-01-01,zipcode,Santa anna
ZCTA5 76882,48,194,56000,-666666666,205000,144,54,139,6,18,95,12,8,146,78,68,78,53,25,2022-01-01,zipcode,Talpa
ZCTA5 76884,48,75,73750,-666666666,42100,72,20,61,12,19,28,0,2,49,30,19,30,23,7,2022-01-01,zipcode,Valera
ZCTA5 76885,48,65,-666666666,-666666666,-666666666,51,36,28,0,0,19,6,3,63,19,44,19,7,12,2022-01-01,zipcode,Valley spring
ZCTA5 76887,48,68,88854,-666666666,238500,68,29,68,0,44,0,0,24,72,59,13,59,47,12,2022-01-01,zipcode,Voca
ZCTA5 76888,48,127,57566,-666666666,-666666666,127,79,124,6,13,67,27,11,181,73,108,73,47,26,2022-01-01,zipcode,Voss
ZCTA5 76890,48,902,56008,775,117200,769,367,660,85,250,229,57,39,439,365,74,365,281,84,2022-01-01,zipcode,Zephyr
ZCTA5 76901,48,31415,62879,1071,161600,24386,8224,20683,2577,6570,6649,3141,1746,13628,12274,1354,12274,9125,3149,2022-01-01,zipcode,San angelo
ZCTA5 76903,48,30955,50077,915,105300,25065,10407,21378,5162,6827,6369,2187,833,14160,11958,2202,11958,7536,4422,2022-01-01,zipcode,San angelo
ZCTA5 76904,48,37090,81684,1029,245900,29183,9333,23997,1421,5129,8983,5321,3143,16700,15094,1606,15094,9493,5601,2022-01-01,zipcode,San angelo
ZCTA5 76905,48,13424,77614,1547,153900,9593,3536,8179,915,2621,2870,1322,451,5286,4800,486,4800,3329,1471,2022-01-01,zipcode,San angelo
ZCTA5 76908,48,1943,-666666666,-666666666,-666666666,1943,33,323,0,31,192,100,0,6,0,6,0,0,0,2022-01-01,zipcode,Goodfellow afb
ZCTA5 76930,48,87,52857,-666666666,-666666666,73,25,73,13,17,43,0,0,51,36,15,36,36,0,2022-01-01,zipcode,Barnhart
ZCTA5 76932,48,3308,70319,1057,123900,2368,650,1986,236,1049,463,144,94,1325,1090,235,1090,735,355,2022-01-01,zipcode,Big lake
ZCTA5 76933,48,1238,53935,837,135300,1004,500,844,116,336,260,87,45,630,501,129,501,336,165,2022-01-01,zipcode,Bronte
ZCTA5 76934,48,1068,51083,939,160200,859,536,734,115,333,145,66,75,390,281,109,281,249,32,2022-01-01,zipcode,Carlsbad
ZCTA5 76935,48,1721,-666666666,-666666666,331100,1362,674,1309,50,257,504,391,107,875,668,207,668,668,0,2022-01-01,zipcode,Christoval
ZCTA5 76936,48,2474,53774,645,96700,1949,811,1655,298,491,641,163,62,1243,899,344,899,757,142,2022-01-01,zipcode,Eldorado
ZCTA5 76937,48,56,-666666666,-666666666,-666666666,54,16,44,21,8,0,15,0,37,33,4,33,31,2,2022-01-01,zipcode,Eola
ZCTA5 76939,48,0,-666666666,-666666666,-666666666,0,0,0,0,0,0,0,0,0,0,0,0,0,0,2022-01-01,zipcode,Knickerbocker
ZCTA5 76940,48,14,-666666666,-666666666,-666666666,14,8,14,3,5,3,2,1,15,0,15,0,0,0,2022-01-01,zipcode,Mereta
ZCTA5 76941,48,1237,53315,1145,127100,956,406,907,113,193,409,169,23,702,547,155,547,471,76,2022-01-01,zipcode,Mertzon
ZCTA5 76943,48,2841,64457,583,180400,2410,864,2264,658,679,602,220,105,1820,1246,574,1246,935,311,2022-01-01,zipcode,Ozona
ZCTA5 76945,48,1825,37697,406,55800,1429,588,1305,203,386,408,194,114,1175,832,343,832,579,253,2022-01-01,zipcode,Robert lee
ZCTA5 76950,48,3386,56889,701,133200,2336,794,2016,395,734,565,176,146,1700,1072,628,1072,685,387,2022-01-01,zipcode,Sonora
ZCTA5 76951,48,1392,63558,882,121000,923,348,820,81,345,202,120,72,521,392,129,392,337,55,2022-01-01,zipcode,Sterling city
ZCTA5 76953,48,85,-666666666,-666666666,-666666666,85,45,85,0,36,46,3,0,59,49,10,49,28,21,2022-01-01,zipcode,Tennyson
ZCTA5 76955,48,241,78036,-666666666,183000,162,82,140,36,56,30,18,0,139,84,55,84,73,11,2022-01-01,zipcode,Vancourt
ZCTA5 76957,48,189,-666666666,-666666666,-666666666,88,42,88,0,32,36,0,20,42,42,0,42,10,32,2022-01-01,zipcode,Wall
ZCTA5 76958,48,241,-666666666,-666666666,-666666666,162,62,154,0,55,64,35,0,108,89,19,89,85,4,2022-01-01,zipcode,Water valley
ZCTA5 77002,48,18800,78292,1714,293000,18571,11474,15775,2525,4842,3156,3103,2149,8090,6436,1654,6436,651,5785,2022-01-01,zipcode,Houston
ZCTA5 77003,48,10169,87618,1510,345400,9101,2012,8081,726,1392,2057,2202,1704,6094,5354,740,5354,2450,2904,2022-01-01,zipcode,Houston
ZCTA5 77004,48,35506,68141,1269,375500,30962,11826,23949,1120,3718,5083,7132,6896,18015,15465,2550,15465,5646,9819,2022-01-01,zipcode,Houston
ZCTA5 77005,48,28470,213059,1984,1296300,22380,9292,17215,333,507,1542,6013,8820,10524,9955,569,9955,7241,2714,2022-01-01,zipcode,Houston
ZCTA5 77006,48,24006,104375,1713,560600,22437,4676,19129,304,1066,2734,7304,7721,16115,13902,2213,13902,4774,9128,2022-01-01,zipcode,Houston
ZCTA5 77007,48,42881,140536,1933,483700,38008,5384,33728,621,2053,3955,15061,12038,24824,22436,2388,22436,10957,11479,2022-01-01,zipcode,Houston
ZCTA5 77008,48,38496,140609,1473,553800,32514,6340,29779,1490,2598,4134,12241,9316,19642,18349,1293,18349,11197,7152,2022-01-01,zipcode,Houston
ZCTA5 77009,48,36872,77817,1101,383000,30243,9789,26826,6143,5925,4689,5832,4237,17426,15088,2338,15088,9026,6062,2022-01-01,zipcode,Houston
ZCTA5 77010,48,837,221776,3400,-666666666,826,148,818,0,21,279,280,238,691,529,162,529,0,529,2022-01-01,zipcode,Houston
ZCTA5 77011,48,16685,44412,888,163000,13395,5362,11255,4900,3194,2132,819,210,7287,6178,1109,6178,3060,3118,2022-01-01,zipcode,Houston
ZCTA5 77012,48,17950,45784,884,113300,13553,5568,10796,4905,3229,1585,821,256,6996,5996,1000,5996,2280,3716,2022-01-01,zipcode,Houston
ZCTA5 77013,48,18512,43492,1094,130100,14086,6148,11575,4034,3738,2616,942,245,6963,5813,1150,5813,2503,3310,2022-01-01,zipcode,Houston
ZCTA5 77014,48,37573,54303,1139,189900,27719,9712,22809,4643,6360,7374,3266,1166,13017,11968,1049,11968,6033,5935,2022-01-01,zipcode,Houston
ZCTA5 77015,48,59314,55171,1126,149600,43135,14583,34040,9975,11167,9216,3052,630,20069,18311,1758,18311,9618,8693,2022-01-01,zipcode,Houston
ZCTA5 77016,48,29376,42186,1067,98900,22104,9834,18494,5237,6554,4705,1387,611,11065,9767,1298,9767,6202,3565,2022-01-01,zipcode,Houston
ZCTA5 77017,48,32574,53236,1020,131800,24390,9024,19860,7878,5681,4142,1483,676,11285,10355,930,10355,5179,5176,2022-01-01,zipcode,Houston
ZCTA5 77018,48,28892,111524,1248,529300,22296,6252,20332,1608,3297,3768,6526,5133,13037,11684,1353,11684,8107,3577,2022-01-01,zipcode,Houston
ZCTA5 77019,48,22839,118172,1799,739200,19977,4972,17835,374,1098,2945,6937,6481,13545,12079,1466,12079,5141,6938,2022-01-01,zipcode,Houston
ZCTA5 77020,48,25715,46606,878,116600,20118,8085,16838,5838,5218,3544,1696,542,10006,9081,925,9081,4707,4374,2022-01-01,zipcode,Houston
ZCTA5 77021,48,25500,46508,1170,163300,20796,8142,17281,2331,5027,4199,3046,2678,12535,10935,1600,10935,4080,6855,2022-01-01,zipcode,Houston
ZCTA5 77022,48,26903,46525,1005,169600,21620,7926,17495,6942,4791,3522,1684,556,10742,9232,1510,9232,4304,4928,2022-01-01,zipcode,Houston
ZCTA5 77023,48,25680,47697,996,202100,20697,7468,17307,4794,5039,3483,2376,1615,11716,10139,1577,10139,4510,5629,2022-01-01,zipcode,Houston
ZCTA5 77024,48,37269,132710,1760,1153200,30184,11844,26571,533,1893,4212,11178,8755,18433,15875,2558,15875,9814,6061,2022-01-01,zipcode,Houston
ZCTA5 77025,48,29295,84274,1436,532200,24031,7918,21346,1345,1651,3001,6539,8810,15238,13724,1514,13724,5503,8221,2022-01-01,zipcode,Houston
ZCTA5 77026,48,20732,33452,886,91200,16718,7462,14224,4468,5731,2809,968,248,9534,8101,1433,8101,3299,4802,2022-01-01,zipcode,Houston
ZCTA5 77027,48,19478,103627,1737,896500,17685,4626,15716,275,778,2711,6450,5502,13203,11185,2018,11185,3028,8157,2022-01-01,zipcode,Houston
ZCTA5 77028,48,18669,33403,1047,95900,13386,6028,10608,3202,3744,2846,590,226,7083,6307,776,6307,3559,2748,2022-01-01,zipcode,Houston
ZCTA5 77029,48,16008,49443,1039,108600,12350,5036,10348,3800,3449,2264,667,168,6350,5573,777,5573,3632,1941,2022-01-01,zipcode,Houston
ZCTA5 77030,48,12546,90475,1588,740600,10334,3346,8827,143,306,1045,2960,4373,7289,5870,1419,5870,2228,3642,2022-01-01,zipcode,Houston
ZCTA5 77031,48,17351,44412,1044,219100,13722,4811,11017,4124,2382,2399,1288,824,6924,6103,821,6103,2689,3414,2022-01-01,zipcode,Houston
ZCTA5 77032,48,13743,38834,1153,110700,9669,3598,7719,2430,2272,2085,710,222,4725,4375,350,4375,1701,2674,2022-01-01,zipcode,Houston
ZCTA5 77033,48,28255,39118,1172,88700,20665,9567,16946,4743,6715,3955,984,549,10133,9179,954,9179,5627,3552,2022-01-01,zipcode,Houston
ZCTA5 77034,48,37273,56772,1167,163200,28312,9924,22517,6253,6512,6909,2334,509,14060,12297,1763,12297,6040,6257,2022-01-01,zipcode,Houston
ZCTA5 77035,48,34254,52205,1049,249200,26610,9634,22252,4144,5945,5268,3864,3031,15505,13831,1674,13831,5732,8099,2022-01-01,zipcode,Houston
ZCTA5 77036,48,72278,41899,966,205200,54998,14915,44891,19923,11093,7116,4821,1938,30841,26160,4681,26160,4295,21865,2022-01-01,zipcode,Houston
ZCTA5 77037,48,17585,47381,906,141000,13065,5433,10471,5555,2941,1348,407,220,5291,4994,297,4994,3515,1479,2022-01-01,zipcode,Houston
ZCTA5 77038,48,32142,47682,1189,163300,22973,8817,18302,6426,6031,3826,1183,836,9187,8863,324,8863,5024,3839,2022-01-01,zipcode,Houston
ZCTA5 77039,48,27907,41988,1115,137400,20284,8438,16236,6818,5415,3062,703,238,8576,7923,653,7923,4608,3315,2022-01-01,zipcode,Houston
ZCTA5 77040,48,49762,62685,1246,197400,38118,12398,31861,6564,7473,9192,6099,2533,19203,18348,855,18348,9392,8956,2022-01-01,zipcode,Houston
ZCTA5 77041,48,31912,84928,1593,255500,26365,8919,21996,3667,4922,4928,5739,2740,11967,10965,1002,10965,8184,2781,2022-01-01,zipcode,Houston
ZCTA5 77042,48,40747,51723,1224,320400,32456,8350,27777,2329,5036,7686,8135,4591,21398,19166,2232,19166,4916,14250,2022-01-01,zipcode,Houston
ZCTA5 77043,48,25900,74320,1365,363800,20121,6336,17589,2895,3053,4187,4861,2593,10872,10048,824,10048,5588,4460,2022-01-01,zipcode,Houston
ZCTA5 77044,48,54313,87958,1587,252300,38519,12271,32301,5252,7535,9163,6889,3462,17490,16587,903,16587,12478,4109,2022-01-01,zipcode,Houston
ZCTA5 77045,48,32478,58373,1250,142300,25257,9739,20681,5114,6861,5258,2033,1415,10740,10312,428,10312,5862,4450,2022-01-01,zipcode,Houston
ZCTA5 77046,48,1254,145567,1692,258400,1246,293,1181,0,120,266,371,424,1161,1016,145,1016,551,465,2022-01-01,zipcode,Houston
ZCTA5 77047,48,33569,70666,1577,204500,25397,6742,22004,2287,4787,7630,4221,3079,12785,12238,547,12238,8529,3709,2022-01-01,zipcode,Houston
ZCTA5 77048,48,19741,45714,1157,151400,14641,5252,12548,1833,3978,4338,1655,744,7578,7104,474,7104,4014,3090,2022-01-01,zipcode,Houston
ZCTA5 77049,48,41035,70736,1408,192000,28834,8409,22396,5489,6672,7384,2143,708,12629,11807,822,11807,8069,3738,2022-01-01,zipcode,Houston
ZCTA5 77050,48,5949,30750,1138,100800,4350,2019,3449,1653,1004,658,95,39,1788,1710,78,1710,975,735,2022-01-01,zipcode,Houston
ZCTA5 77051,48,16974,38694,1171,139700,12148,5105,9602,2015,3517,2706,1092,272,7201,6269,932,6269,2468,3801,2022-01-01,zipcode,Houston
ZCTA5 77053,48,30175,61750,1471,142000,23530,8934,19127,5701,6516,4820,1376,714,9517,9248,269,9248,6183,3065,2022-01-01,zipcode,Houston
ZCTA5 77054,48,26708,56447,1400,165300,23866,5975,19527,348,2301,4431,5871,6576,18449,16001,2448,16001,1874,14127,2022-01-01,zipcode,Houston
ZCTA5 77055,48,43362,69743,1171,579400,33790,10546,28621,6436,5745,5272,6858,4310,17452,15885,1567,15885,7290,8595,2022-01-01,zipcode,Houston
ZCTA5 77056,48,21941,97097,1783,809900,19744,5977,17837,312,852,3012,7347,6314,14982,12078,2904,12078,4207,7871,2022-01-01,zipcode,Houston
ZCTA5 77057,48,45023,68955,1319,346900,36206,8841,32206,4461,3649,6917,10177,7002,24826,21814,3012,21814,6935,14879,2022-01-01,zipcode,Houston
ZCTA5 77058,48,17956,63267,1237,229700,15401,4775,12979,879,2176,4073,3398,2453,10699,9603,1096,9603,2873,6730,2022-01-01,zipcode,Houston
ZCTA5 77059,48,18370,158958,1853,369300,14509,5905,12520,530,1129,2657,4524,3680,6558,6427,131,6427,5973,454,2022-01-01,zipcode,Houston
ZCTA5 77060,48,46266,37041,974,126600,32148,10940,25372,11442,7664,4675,1120,471,16816,15007,1809,15007,3519,11488,2022-01-01,zipcode,Houston
ZCTA5 77061,48,25169,42039,935,195700,18842,6014,15356,4800,4935,3348,1681,592,10065,9171,894,9171,3513,5658,2022-01-01,zipcode,Houston
ZCTA5 77062,48,24561,103477,1204,268600,19340,6765,17201,1431,2715,4051,5353,3651,9944,9439,505,9439,7199,2240,2022-01-01,zipcode,Houston
ZCTA5 77063,48,39554,51899,1272,271700,33957,9127,29334,2470,4554,8299,9338,4673,22827,20255,2572,20255,4460,15795,2022-01-01,zipcode,Houston
ZCTA5 77064,48,49240,82500,1499,222400,37704,10467,31034,4892,7999,9418,6644,2081,17079,15868,1211,15868,9736,6132,2022-01-01,zipcode,Houston
ZCTA5 77065,48,38994,72816,1283,241500,31330,8673,26640,3050,6126,9980,5043,2441,17011,15902,1109,15902,6863,9039,2022-01-01,zipcode,Houston
ZCTA5 77066,48,39234,76716,1438,202700,29640,10111,24380,5319,6548,7155,3993,1365,12078,11766,312,11766,8690,3076,2022-01-01,zipcode,Houston
ZCTA5 77067,48,32405,49682,1091,161200,22795,7993,18627,5458,5601,5464,1336,768,11046,10044,1002,10044,4316,5728,2022-01-01,zipcode,Houston
ZCTA5 77068,48,11451,83990,1258,275600,9057,2771,7497,1047,1282,2477,2029,662,4359,3920,439,3920,2687,1233,2022-01-01,zipcode,Houston
ZCTA5 77069,48,20633,72744,1447,307400,15357,4444,13186,521,2130,4200,4316,2019,9192,8444,748,8444,5122,3322,2022-01-01,zipcode,Houston
ZCTA5 77070,48,58409,73579,1489,245300,43836,12493,37456,3625,8267,11078,9767,4719,23133,21502,1631,21502,9884,11618,2022-01-01,zipcode,Houston
ZCTA5 77071,48,26990,56559,1016,208200,21387,7625,17907,3326,3675,5086,3584,2236,11000,10090,910,10090,5065,5025,2022-01-01,zipcode,Houston
ZCTA5 77072,48,61688,50886,1174,162100,48094,17249,37790,11635,10891,9184,4407,1673,20495,18899,1596,18899,8500,10399,2022-01-01,zipcode,Houston
ZCTA5 77073,48,41866,69784,1266,185400,31823,8671,25985,4918,8905,8791,2440,931,14731,13898,833,13898,8748,5150,2022-01-01,zipcode,Houston
ZCTA5 77074,48,38624,48196,1003,186600,28550,9447,23623,9482,5205,3988,3648,1300,15274,13087,2187,13087,4243,8844,2022-01-01,zipcode,Houston
ZCTA5 77075,48,41271,71609,1167,202700,30053,8314,24436,7305,6260,7177,2764,930,13167,12407,760,12407,7481,4926,2022-01-01,zipcode,Houston
ZCTA5 77076,48,33529,37927,1122,134100,24437,9959,19059,8639,5895,3641,636,248,10700,9915,785,9915,4883,5032,2022-01-01,zipcode,Houston
ZCTA5 77077,48,62933,69782,1382,352900,50751,13830,44828,2370,5167,11332,15201,10758,32937,29223,3714,29223,10249,18974,2022-01-01,zipcode,Houston
ZCTA5 77078,48,14241,40873,1142,124800,10359,4592,8974,2632,3019,2333,715,275,5429,4784,645,4784,2803,1981,2022-01-01,zipcode,Houston
ZCTA5 77079,48,35097,99164,1582,604500,26363,7993,22805,1440,1250,4602,9369,6144,15960,13717,2243,13717,7264,6453,2022-01-01,zipcode,Houston
ZCTA5 77080,48,47661,61659,1214,302100,35571,11311,28970,9047,7080,5139,5282,2422,17311,15536,1775,15536,7345,8191,2022-01-01,zipcode,Houston
ZCTA5 77081,48,52360,40805,951,338600,38751,10179,30310,13801,6700,4043,3614,2152,21158,19202,1956,19202,1167,18035,2022-01-01,zipcode,Houston
ZCTA5 77082,48,53401,55962,1299,208500,43165,12537,36505,4724,8184,11050,8114,4433,24102,21825,2277,21825,8029,13796,2022-01-01,zipcode,Houston
ZCTA5 77083,48,75004,61979,1278,203800,60000,20755,47800,9997,12311,13582,7925,3985,23723,22672,1051,22672,14568,8104,2022-01-01,zipcode,Houston
ZCTA5 77084,48,108557,75510,1400,215600,81861,24131,67157,10504,15413,21193,14495,5552,38544,35552,2992,35552,21476,14076,2022-01-01,zipcode,Houston
ZCTA5 77085,48,16550,65715,1288,159800,13376,4408,10867,3524,3059,2608,1237,439,5637,5477,160,5477,3572,1905,2022-01-01,zipcode,Houston
ZCTA5 77086,48,29705,56200,1162,168100,22010,7204,17553,5519,6017,4007,1458,552,9327,8700,627,8700,4923,3777,2022-01-01,zipcode,Houston
ZCTA5 77087,48,35960,50918,948,127200,27158,11097,22193,9144,6429,4117,1727,776,12455,11222,1233,11222,6296,4926,2022-01-01,zipcode,Houston
ZCTA5 77088,48,54007,48627,1116,152100,41352,16472,33768,9415,10856,9104,3098,1295,18580,17424,1156,17424,11397,6027,2022-01-01,zipcode,Houston
ZCTA5 77089,48,56988,83648,1401,216000,44199,14350,35437,5194,8884,11927,6621,2811,19711,18635,1076,18635,12630,6005,2022-01-01,zipcode,Houston
ZCTA5 77090,48,40764,49438,1135,209000,31149,8363,24803,2525,6753,9228,4547,1750,18939,16452,2487,16452,4654,11798,2022-01-01,zipcode,Houston
ZCTA5 77091,48,30357,34988,1052,201100,22899,8741,19258,5921,5342,4695,2483,817,12686,11083,1603,11083,4118,6965,2022-01-01,zipcode,Houston
ZCTA5 77092,48,36320,54494,1130,222300,29377,8233,24974,6434,5731,6570,4216,2023,15803,14509,1294,14509,5885,8624,2022-01-01,zipcode,Houston
ZCTA5 77093,48,48215,37583,1015,107100,35028,15589,28500,14313,8010,4700,1245,232,14768,13665,1103,13665,7928,5737,2022-01-01,zipcode,Houston
ZCTA5 77094,48,10623,179387,1555,453400,8377,3189,7643,126,920,1327,3538,1732,4340,4064,276,4064,3356,708,2022-01-01,zipcode,Houston
ZCTA5 77095,48,69644,90690,1479,269100,56633,16911,48053,4105,9049,15562,13696,5641,26127,24914,1213,24914,17623,7291,2022-01-01,zipcode,Houston
ZCTA5 77096,48,33001,79483,1200,401000,25476,8844,22686,2124,3521,4769,6902,5370,15311,12975,2336,12975,6372,6603,2022-01-01,zipcode,Houston
ZCTA5 77098,48,15553,108799,1862,717000,13665,3270,11748,90,493,1382,4021,5762,10058,8680,1378,8680,2796,5884,2022-01-01,zipcode,Houston
ZCTA5 77099,48,49541,45691,1167,163100,36994,13045,30526,8558,8952,7688,3980,1348,17551,16146,1405,16146,5879,10267,2022-01-01,zipcode,Houston
ZCTA5 77301,48,34299,59452,1177,172300,25909,9984,21272,5198,6552,5129,2960,1433,12099,11240,859,11240,6332,4908,2022-01-01,zipcode,Conroe
ZCTA5 77302,48,19076,85590,1347,241500,14340,5604,12245,1382,4326,3956,1868,713,6810,6458,352,6458,5178,1280,2022-01-01,zipcode,Conroe
ZCTA5 77303,48,24106,75448,1164,192000,18095,5469,14938,2400,5791,4823,1131,793,8634,8003,631,8003,6078,1925,2022-01-01,zipcode,Conroe
ZCTA5 77304,48,40317,74182,1297,294100,31873,10372,25995,1868,5196,8305,6737,3889,17249,16525,724,16525,9813,6712,2022-01-01,zipcode,Conroe
ZCTA5 77306,48,16443,65423,880,156000,12190,4663,9442,3718,2640,2002,715,367,5464,5017,447,5017,4269,748,2022-01-01,zipcode,Conroe
ZCTA5 77316,48,30577,120846,1504,386900,23309,8326,20327,1042,4790,5803,6638,2054,11170,10469,701,10469,9239,1230,2022-01-01,zipcode,Montgomery
ZCTA5 77318,48,19127,88162,1311,265500,15599,6257,13906,1377,4770,4205,2487,1067,8411,7235,1176,7235,5773,1462,2022-01-01,zipcode,Willis
ZCTA5 77320,48,38170,50343,990,179400,33550,21581,28413,5067,11725,7424,2925,1272,12122,9978,2144,9978,6230,3748,2022-01-01,zipcode,Huntsville
ZCTA5 77326,48,235,-666666666,-666666666,183700,235,225,209,41,149,19,0,0,159,133,26,133,133,0,2022-01-01,zipcode,Ace
ZCTA5 77327,48,33673,54022,937,127200,24055,11092,19165,4509,7345,5108,1468,735,12204,10281,1923,10281,8263,2018,2022-01-01,zipcode,Cleveland
ZCTA5 77328,48,17860,55747,1078,150400,13652,6263,11749,2545,4639,3423,792,350,7054,6177,877,6177,4667,1510,2022-01-01,zipcode,Cleveland
ZCTA5 77331,48,7465,50123,925,193400,6264,3008,5765,709,2108,1690,630,628,4815,3106,1709,3106,2563,543,2022-01-01,zipcode,Coldspring
ZCTA5 77334,48,226,-666666666,-666666666,-666666666,164,102,164,0,0,122,42,0,62,62,0,62,42,20,2022-01-01,zipcode,Dodge
ZCTA5 77335,48,3157,52355,1120,111800,2545,1155,1958,470,664,591,135,98,1407,1092,315,1092,902,190,2022-01-01,zipcode,Goodrich
ZCTA5 77336,48,11835,82105,1217,237600,9167,3825,7376,895,1930,2804,1205,542,4877,4032,845,4032,3334,698,2022-01-01,zipcode,Huffman
ZCTA5 77338,48,47997,68239,1279,195500,35016,10828,29910,3630,8627,12106,4071,1476,17396,16523,873,16523,8339,8184,2022-01-01,zipcode,Humble
ZCTA5 77339,48,43810,81274,1540,257000,34521,11797,29357,1479,6186,10214,7376,4102,18960,17303,1657,17303,9961,7342,2022-01-01,zipcode,Kingwood
ZCTA5 77340,48,33969,41008,976,205200,29640,12896,19281,1979,6662,5516,3039,2085,14443,12472,1971,12472,5647,6825,2022-01-01,zipcode,Huntsville
ZCTA5 77342,48,0,-666666666,-666666666,-666666666,0,0,0,0,0,0,0,0,0,0,0,0,0,0,2022-01-01,zipcode,Huntsville
ZCTA5 77345,48,26791,159013,1890,353800,20306,7946,17517,590,1621,4255,6831,4220,9854,9317,537,9317,8107,1210,2022-01-01,zipcode,Kingwood
ZCTA5 77346,48,70704,122321,1657,264700,52857,14991,45483,2449,8360,14852,13995,5827,24514,23614,900,23614,19925,3689,2022-01-01,zipcode,Humble
ZCTA5 77350,48,134,50000,-666666666,83800,112,29,112,28,47,31,3,3,74,50,24,50,37,13,2022-01-01,zipcode,Leggett
ZCTA5 77351,48,34676,59245,940,161900,28971,15660,25877,4592,9435,8051,2485,1314,17348,12506,4842,12506,9843,2663,2022-01-01,zipcode,Livingston
ZCTA5 77354,48,40094,112562,1456,344600,30574,10545,26568,2204,6058,7521,7342,3443,15045,13451,1594,13451,10820,2631,2022-01-01,zipcode,Magnolia
ZCTA5 77355,48,31593,107714,1249,316600,24948,9222,21075,2140,5973,7065,4545,1352,10778,10409,369,10409,8939,1470,2022-01-01,zipcode,Magnolia
ZCTA5 77356,48,29515,112394,1604,338500,24523,10084,22071,979,4403,7206,6564,2919,14597,12457,2140,12457,10614,1843,2022-01-01,zipcode,Montgomery
ZCTA5 77357,48,30907,69521,1234,181400,23239,7783,17755,3709,6487,5214,1497,848,11449,9967,1482,9967,7444,2523,2022-01-01,zipcode,New caney
ZCTA5 77358,48,5013,71966,931,166700,4286,1712,3734,473,1556,1240,272,193,2608,2141,467,2141,1621,520,2022-01-01,zipcode,New waverly
ZCTA5 77359,48,265,55331,-666666666,182600,245,127,245,80,87,39,39,0,178,137,41,137,82,55,2022-01-01,zipcode,Oakhurst
ZCTA5 77360,48,5700,58076,1019,125700,4390,2195,3982,679,1447,1522,260,74,3283,2205,1078,2205,1643,562,2022-01-01,zipcode,Onalaska
ZCTA5 77362,48,6626,84612,1338,246100,5455,2157,4365,223,1500,1314,959,369,2460,2317,143,2317,2108,209,2022-01-01,zipcode,Pinehurst
ZCTA5 77363,48,3177,49946,1175,296900,2556,1268,2353,518,416,650,664,105,1620,1385,235,1385,1206,179,2022-01-01,zipcode,Plantersville
ZCTA5 77364,48,2005,53548,913,150000,1869,1048,1823,195,506,615,301,206,1420,1052,368,1052,908,144,2022-01-01,zipcode,Pointblank
ZCTA5 77365,48,39385,90493,1270,243000,30296,10753,25257,4756,6585,7450,4782,1684,14227,13179,1048,13179,11296,1883,2022-01-01,zipcode,Porter
ZCTA5 77367,48,460,71199,1285,210900,376,179,369,24,33,207,62,43,292,225,67,225,139,86,2022-01-01,zipcode,Riverside
ZCTA5 77368,48,0,-666666666,-666666666,-666666666,0,0,0,0,0,0,0,0,0,0,0,0,0,0,2022-01-01,zipcode,Romayor
ZCTA5 77369,48,598,-666666666,-666666666,107300,486,281,461,231,132,98,0,0,382,247,135,247,192,55,2022-01-01,zipcode,Rye
ZCTA5 77371,48,7370,57056,959,131600,5506,2610,4531,770,2048,1398,185,130,2946,2173,773,2173,1744,429,2022-01-01,zipcode,Shepherd
ZCTA5 77372,48,13364,72749,1178,176600,9943,3567,8351,1681,3113,2700,628,229,4754,4251,503,4251,3564,687,2022-01-01,zipcode,Splendora
ZCTA5 77373,48,64828,83835,1632,198300,49863,14714,42255,4931,12378,14098,8068,2780,22795,21753,1042,21753,15779,5974,2022-01-01,zipcode,Spring
ZCTA5 77374,48,378,81411,-666666666,-666666666,294,133,207,0,154,10,43,0,218,155,63,155,133,22,2022-01-01,zipcode,Thicket
ZCTA5 77375,48,67965,93886,1452,272000,49181,15654,41924,2949,8916,12514,11064,6481,23975,23062,913,23062,16453,6609,2022-01-01,zipcode,Tomball
ZCTA5 77376,48,596,29498,-666666666,-666666666,542,163,395,28,247,120,0,0,289,289,0,289,281,8,2022-01-01,zipcode,Votaw
ZCTA5 77377,48,38188,114943,1560,330300,29511,10272,25502,1525,5778,7252,6792,4155,13308,12748,560,12748,10535,2213,2022-01-01,zipcode,Tomball
ZCTA5 77378,48,18112,66882,1324,149500,14350,5216,11739,2416,4138,3345,1423,417,6240,5797,443,5797,4534,1263,2022-01-01,zipcode,Willis
ZCTA5 77379,48,83247,110361,1499,309200,62202,19961,53182,2282,8547,15445,18127,8781,29385,28224,1161,28224,21387,6837,2022-01-01,zipcode,Spring
ZCTA5 77380,48,30034,82383,1478,336900,25263,8044,22042,612,3145,6436,7455,4394,15746,14398,1348,14398,5170,9228,2022-01-01,zipcode,Spring
ZCTA5 77381,48,36414,143198,1637,417200,28787,11921,24990,809,3308,5284,9161,6428,13919,13554,365,13554,10556,2998,2022-01-01,zipcode,Spring
ZCTA5 77382,48,41085,162774,1905,507200,30498,11227,25702,388,1856,5125,11070,7263,13727,13262,465,13262,10537,2725,2022-01-01,zipcode,Spring
ZCTA5 77384,48,22958,99884,1395,394300,18898,6944,17011,378,2261,4887,5876,3609,11137,9974,1163,9974,5600,4374,2022-01-01,zipcode,Conroe
ZCTA5 77385,48,26497,109677,1627,274800,20046,5654,16394,1644,2625,5957,4286,1882,9295,8717,578,8717,6740,1977,2022-01-01,zipcode,Conroe
ZCTA5 77386,48,66816,131285,1810,311900,47600,13433,40884,2214,5971,12812,13141,6746,21875,21060,815,21060,16979,4081,2022-01-01,zipcode,Spring
ZCTA5 77388,48,52127,99591,1749,246000,39738,12099,33703,2699,7523,11121,8515,3845,18471,17711,760,17711,12567,5144,2022-01-01,zipcode,Spring
ZCTA5 77389,48,43674,142611,1699,377900,31485,10456,26904,1004,4801,5932,9207,5960,14727,14072,655,14072,11288,2784,2022-01-01,zipcode,Spring
ZCTA5 77396,48,60253,76919,1415,207900,46265,15824,38317,6701,11640,10412,4947,4617,21007,19761,1246,19761,13182,6579,2022-01-01,zipcode,Humble
ZCTA5 77401,48,17233,215197,2423,956600,13373,4971,11884,178,681,1331,3958,5736,6732,6107,625,6107,5342,765,2022-01-01,zipcode,Bellaire
ZCTA5 77406,48,63187,139280,1879,368700,47755,16357,42207,2496,6871,12182,12307,8351,20888,20063,825,20063,17713,2350,2022-01-01,zipcode,Richmond
ZCTA5 77407,48,76600,106131,1824,338000,55592,15167,47572,3736,7554,11236,16222,8824,23355,22646,709,22646,17798,4848,2022-01-01,zipcode,Richmond
ZCTA5 77412,48,0,-666666666,-666666666,-666666666,0,0,0,0,0,0,0,0,0,0,0,0,0,0,2022-01-01,zipcode,Altair
ZCTA5 77414,48,24107,54859,990,153800,18432,7920,15593,2486,4670,4959,2274,1204,12195,9430,2765,9430,6052,3378,2022-01-01,zipcode,Bay city
ZCTA5 77415,48,393,71908,-666666666,113200,279,174,222,30,109,69,0,14,165,142,23,142,93,49,2022-01-01,zipcode,Cedar lane
ZCTA5 77417,48,3267,55208,979,115200,2136,1068,1786,566,745,387,62,26,881,835,46,835,598,237,2022-01-01,zipcode,Beasley
ZCTA5 77418,48,10384,79444,1051,282700,8059,3247,6981,700,2000,2045,1661,575,4424,3844,580,3844,2865,979,2022-01-01,zipcode,Bellville
ZCTA5 77419,48,746,45614,-666666666,162700,475,182,394,117,119,116,42,0,461,349,112,349,324,25,2022-01-01,zipcode,Blessing
ZCTA5 77420,48,2313,57266,750,167400,1802,742,1554,195,298,613,400,48,882,783,99,783,583,200,2022-01-01,zipcode,Boling
ZCTA5 77422,48,14302,68937,1058,181500,12079,6780,10402,1605,3454,3923,1108,312,6375,5067,1308,5067,4226,841,2022-01-01,zipcode,Brazoria
ZCTA5 77423,48,15627,85082,1298,248600,11232,4255,9328,1779,2287,2983,1534,745,4940,4495,445,4495,3768,727,2022-01-01,zipcode,Brookshire
ZCTA5 77426,48,2086,94091,-666666666,354500,1926,824,1748,245,530,432,397,144,1013,850,163,850,699,151,2022-01-01,zipcode,Chappell hill
ZCTA5 77428,48,94,-666666666,-666666666,-666666666,64,0,64,0,34,30,0,0,30,30,0,30,0,30,2022-01-01,zipcode,Collegeport
ZCTA5 77429,48,90790,123172,1591,321100,68077,19600,58965,3675,9479,17231,19429,9151,31776,30660,1116,30660,25707,4953,2022-01-01,zipcode,Cypress
ZCTA5 77430,48,1718,106094,-666666666,280900,1349,577,1145,159,249,271,268,198,730,623,107,623,549,74,2022-01-01,zipcode,Damon
ZCTA5 77432,48,0,-666666666,-666666666,-666666666,0,0,0,0,0,0,0,0,23,0,23,0,0,0,2022-01-01,zipcode,Danevang
ZCTA5 77433,48,107887,134390,1775,365000,74722,22981,64017,3311,10788,17084,20871,11963,32960,31919,1041,31919,25917,6002,2022-01-01,zipcode,Cypress
ZCTA5 77434,48,4103,60227,866,72700,3069,1401,2306,472,732,693,326,83,1636,1240,396,1240,1005,235,2022-01-01,zipcode,Eagle lake
ZCTA5 77435,48,4242,62701,1125,231700,3375,1447,2902,351,1052,877,411,211,2028,1725,303,1725,1457,268,2022-01-01,zipcode,East bernard
ZCTA5 77436,48,0,-666666666,-666666666,-666666666,0,0,0,0,0,0,0,0,24,0,24,0,0,0,2022-01-01,zipcode,Egypt
ZCTA5 77437,48,18466,63810,960,166800,13708,5365,11647,2424,3874,3319,1433,597,7049,6414,635,6414,4201,2213,2022-01-01,zipcode,El campo
ZCTA5 77440,48,121,-666666666,-666666666,-666666666,63,0,63,0,0,40,23,0,23,23,0,23,23,0,2022-01-01,zipcode,Elmaton
ZCTA5 77441,48,27067,170261,1745,492700,20252,7923,17211,671,1419,3308,7343,4470,9143,8588,555,8588,8197,391,2022-01-01,zipcode,Fulshear
ZCTA5 77442,48,1451,56042,696,169000,810,376,652,112,285,196,43,16,438,329,109,329,219,110,2022-01-01,zipcode,Garwood
ZCTA5 77443,48,114,-666666666,-666666666,-666666666,114,76,114,0,0,76,0,38,93,38,55,38,0,38,2022-01-01,zipcode,Glen flora
ZCTA5 77444,48,809,-666666666,871,201000,641,346,543,178,181,153,3,28,499,345,154,345,315,30,2022-01-01,zipcode,Guy
ZCTA5 77445,48,14680,57217,1046,247300,11312,5240,8471,1006,3060,3004,1036,365,5939,5239,700,5239,2961,2278,2022-01-01,zipcode,Hempstead
ZCTA5 77446,48,6276,33466,1182,241900,6005,3196,718,68,207,215,138,90,1117,991,126,991,106,885,2022-01-01,zipcode,Prairie view
ZCTA5 77447,48,19196,100250,1390,266000,13520,3840,11625,957,3417,4264,2142,845,6870,6411,459,6411,5383,1028,2022-01-01,zipcode,Hockley
ZCTA5 77448,48,186,-666666666,-666666666,-666666666,140,30,140,57,8,24,51,0,132,79,53,79,27,52,2022-01-01,zipcode,Hungerford
ZCTA5 77449,48,122098,82300,1636,213500,89374,23593,76347,11150,17771,24775,15928,6723,39407,38037,1370,38037,26706,11331,2022-01-01,zipcode,Katy
ZCTA5 77450,48,72651,103245,1641,318400,55122,17819,47354,2599,6982,12680,15875,9218,26080,24931,1149,24931,17369,7562,2022-01-01,zipcode,Katy
ZCTA5 77451,48,472,55417,1089,96000,307,155,293,46,162,51,15,19,246,162,84,162,114,48,2022-01-01,zipcode,Kendleton
ZCTA5 77453,48,187,-666666666,-666666666,-666666666,80,36,80,17,44,19,0,0,87,61,26,61,17,44,2022-01-01,zipcode,Lane city
ZCTA5 77454,48,159,-666666666,-666666666,-666666666,159,56,159,0,0,41,118,0,77,77,0,77,77,0,2022-01-01,zipcode,Lissie
ZCTA5 77455,48,1962,61401,1104,143400,1423,536,1151,267,398,325,145,16,745,641,104,641,522,119,2022-01-01,zipcode,Louise
ZCTA5 77456,48,1345,58443,850,117900,897,552,639,112,266,162,83,16,443,372,71,372,314,58,2022-01-01,zipcode,Markham
ZCTA5 77457,48,526,34531,-666666666,162500,526,229,526,83,107,239,60,37,871,310,561,310,232,78,2022-01-01,zipcode,Matagorda
ZCTA5 77458,48,13,-666666666,-666666666,-666666666,13,13,13,0,0,0,13,0,42,13,29,13,13,0,2022-01-01,zipcode,Midfield
ZCTA5 77459,48,79937,128851,1926,354200,61753,19830,51636,2518,7858,12215,16886,12159,26914,26003,911,26003,21752,4251,2022-01-01,zipcode,Missouri city
ZCTA5 77460,48,132,-666666666,-666666666,-666666666,107,81,107,32,32,43,0,0,31,24,7,24,24,0,2022-01-01,zipcode,Nada
ZCTA5 77461,48,12719,69766,1156,237200,9338,3689,7968,1719,2409,2034,1304,502,4275,4136,139,4136,3256,880,2022-01-01,zipcode,Needville
ZCTA5 77464,48,411,54583,1130,206800,325,193,311,78,64,152,2,15,198,182,16,182,82,100,2022-01-01,zipcode,Orchard
ZCTA5 77465,48,7272,65515,909,179200,5862,2398,5169,1367,1177,1666,673,286,3845,2796,1049,2796,2150,646,2022-01-01,zipcode,Palacios
ZCTA5 77466,48,335,45588,-666666666,290200,302,138,262,8,99,107,43,5,196,182,14,182,130,52,2022-01-01,zipcode,Pattison
ZCTA5 77467,48,0,-666666666,-666666666,-666666666,0,0,0,0,0,0,0,0,0,0,0,0,0,0,2022-01-01,zipcode,Pierce
ZCTA5 77468,48,0,-666666666,-666666666,-666666666,0,0,0,0,0,0,0,0,0,0,0,0,0,0,2022-01-01,zipcode,Pledger
ZCTA5 77469,48,60971,98210,1448,279700,46621,14652,40076,3616,9557,11380,9650,5873,21525,20975,550,20975,16689,4286,2022-01-01,zipcode,Richmond
ZCTA5 77470,48,404,48478,-666666666,149200,308,115,274,60,80,109,7,18,298,172,126,172,154,18,2022-01-01,zipcode,Rock island
ZCTA5 77471,48,43116,67743,1302,210900,33101,11355,27027,4530,8524,8644,3920,1409,16893,15698,1195,15698,8940,6758,2022-01-01,zipcode,Rosenberg
ZCTA5 77473,48,24,-666666666,-666666666,-666666666,24,11,24,0,16,8,0,0,18,11,7,11,6,5,2022-01-01,zipcode,San felipe
ZCTA5 77474,48,14819,74139,1126,222600,11615,3915,9990,1333,3406,3221,1450,580,6478,5917,561,5917,4908,1009,2022-01-01,zipcode,Sealy
ZCTA5 77475,48,446,58255,-666666666,186900,433,278,405,43,239,63,17,43,484,251,233,251,229,22,2022-01-01,zipcode,Sheridan
ZCTA5 77476,48,270,65491,-666666666,344200,203,122,203,24,24,105,37,13,165,93,72,93,74,19,2022-01-01,zipcode,Simonton
ZCTA5 77477,48,33771,71746,1385,215900,26945,6944,22687,2967,4689,6270,6455,2306,14152,13289,863,13289,5543,7746,2022-01-01,zipcode,Stafford
ZCTA5 77478,48,23105,110032,1689,368300,19949,7817,17262,1056,2222,4161,5911,3912,9150,8883,267,8883,6802,2081,2022-01-01,zipcode,Sugar land
ZCTA5 77479,48,91618,154658,1971,437500,71399,24452,61084,3107,5890,11055,21135,19897,30185,29236,949,29236,24640,4596,2022-01-01,zipcode,Sugar land
ZCTA5 77480,48,8017,76445,1086,161700,6027,2867,5312,754,1696,1913,790,159,3503,2859,644,2859,2388,471,2022-01-01,zipcode,Sweeny
ZCTA5 77481,48,103,-666666666,-666666666,215600,103,88,103,0,71,25,4,3,92,87,5,87,25,62,2022-01-01,zipcode,Thompsons
ZCTA5 77482,48,1403,71359,-666666666,158300,1200,539,1003,127,268,397,196,15,854,551,303,551,470,81,2022-01-01,zipcode,Van vleck
ZCTA5 77483,48,319,-666666666,-666666666,144000,207,0,207,40,44,123,0,0,261,141,120,141,141,0,2022-01-01,zipcode,Wadsworth
ZCTA5 77484,48,13661,72485,1074,232900,11095,3769,8355,965,2825,2929,1421,215,5364,4781,583,4781,3259,1522,2022-01-01,zipcode,Waller
ZCTA5 77485,48,3454,46528,906,186300,2804,1032,2457,391,876,798,299,93,1676,1393,283,1393,944,449,2022-01-01,zipcode,Wallis
ZCTA5 77486,48,7689,88809,1246,210100,6060,2520,4935,662,1277,1889,631,476,3353,2885,468,2885,2241,644,2022-01-01,zipcode,West columbia
ZCTA5 77488,48,14205,53167,788,161900,11595,4846,9623,1770,2922,3481,941,509,6385,5390,995,5390,3305,2085,2022-01-01,zipcode,Wharton
ZCTA5 77489,48,37748,71858,1670,184200,29723,9703,24882,2940,7548,8579,3934,1881,13335,12758,577,12758,9531,3227,2022-01-01,zipcode,Missouri city
ZCTA5 77493,48,55317,110220,1608,290200,39555,11473,32786,2229,7048,10276,8835,4398,17622,16669,953,16669,13694,2975,2022-01-01,zipcode,Katy
ZCTA5 77494,48,130920,144444,1977,420100,93642,33859,80997,3319,7857,16236,30880,22705,42520,40821,1699,40821,29303,11518,2022-01-01,zipcode,Katy
ZCTA5 77498,48,54402,93703,1753,263500,42231,13114,33687,3687,6698,9849,8039,5414,18180,16830,1350,16830,11764,5066,2022-01-01,zipcode,Sugar land
ZCTA5 77502,48,36374,58714,1132,148100,26802,9542,21605,8317,6676,4910,1251,451,11783,10961,822,10961,7014,3947,2022-01-01,zipcode,Pasadena
ZCTA5 77503,48,23248,67697,1155,147500,17032,6120,14496,3919,5132,3791,1258,396,8877,7978,899,7978,4288,3690,2022-01-01,zipcode,Pasadena
ZCTA5 77504,48,25401,52620,1168,193100,19487,6561,15819,2997,5870,4181,2002,769,10177,9144,1033,9144,3790,5354,2022-01-01,zipcode,Pasadena
ZCTA5 77505,48,23179,90917,1502,256200,17618,5841,14343,1411,4048,4940,2306,1638,8784,8190,594,8190,5534,2656,2022-01-01,zipcode,Pasadena
ZCTA5 77506,48,37561,51810,996,114700,26389,9439,20692,8479,7244,3723,970,276,12266,10582,1684,10582,3992,6590,2022-01-01,zipcode,Pasadena
ZCTA5 77507,48,561,70406,1699,-666666666,540,46,426,0,144,46,134,102,407,334,73,334,0,334,2022-01-01,zipcode,Pasadena
ZCTA5 77510,48,13506,92344,980,245900,11577,4661,9629,1064,3260,3363,1520,422,5861,5104,757,5104,4360,744,2022-01-01,zipcode,Santa fe
ZCTA5 77511,48,50799,74466,1218,197700,38937,13872,32328,5306,9158,11894,4442,1528,19968,17517,2451,17517,11984,5533,2022-01-01,zipcode,Alvin
ZCTA5 77514,48,5541,61569,1120,149900,4351,2146,3918,1017,1436,1221,141,103,2672,2044,628,2044,1683,361,2022-01-01,zipcode,Anahuac
ZCTA5 77515,48,33406,84443,1026,189900,27645,12134,23804,2922,8284,8394,2774,1430,13080,11786,1294,11786,8562,3224,2022-01-01,zipcode,Angleton
ZCTA5 77517,48,6160,81618,830,263000,4743,2123,4245,523,1454,1685,480,103,2172,2140,32,2140,1923,217,2022-01-01,zipcode,Santa fe
ZCTA5 77518,48,10313,52246,1174,159000,7483,2427,6147,1487,1550,1915,955,240,3927,3629,298,3629,2047,1582,2022-01-01,zipcode,Bacliff
ZCTA5 77519,48,561,90571,-666666666,-666666666,430,208,388,31,246,47,45,19,214,214,0,214,192,22,2022-01-01,zipcode,Batson
ZCTA5 77520,48,36488,53226,1094,125300,28373,10985,23795,6758,7110,7265,1549,1113,14851,13192,1659,13192,7484,5708,2022-01-01,zipcode,Baytown
ZCTA5 77521,48,66215,74948,1285,202100,49107,16362,40310,7374,11451,14234,4957,2294,24945,23523,1422,23523,13873,9650,2022-01-01,zipcode,Baytown
ZCTA5 77523,48,27489,131444,1366,330600,20618,6011,17441,1238,3957,7394,3331,1521,9877,9277,600,9277,7698,1579,2022-01-01,zipcode,Baytown
ZCTA5 77530,48,31304,62455,1005,149400,22093,8085,17197,5993,5605,3737,1152,710,10226,9081,1145,9081,6625,2456,2022-01-01,zipcode,Channelview
ZCTA5 77531,48,15842,69676,1198,216000,12203,3690,9859,1507,3067,3147,1616,522,7125,6222,903,6222,3430,2792,2022-01-01,zipcode,Clute
ZCTA5 77532,48,31384,91471,1084,228400,23904,7915,20305,1809,7271,7582,2443,1200,11881,10870,1011,10870,8960,1910,2022-01-01,zipcode,Crosby
ZCTA5 77533,48,1059,56466,960,110900,864,441,696,84,408,154,21,29,448,376,72,376,291,85,2022-01-01,zipcode,Daisetta
ZCTA5 77534,48,3210,100483,1063,217500,2323,823,1812,245,466,808,226,67,1156,927,229,927,851,76,2022-01-01,zipcode,Danbury
ZCTA5 77535,48,36841,77148,1041,199800,28640,14041,24505,4945,9187,7751,2127,495,11993,10777,1216,10777,9211,1566,2022-01-01,zipcode,Dayton
ZCTA5 77536,48,33111,90468,1302,224200,26354,9628,21333,2231,6199,7653,3769,1481,11791,11282,509,11282,8846,2436,2022-01-01,zipcode,Deer park
ZCTA5 77538,48,987,75294,-666666666,152700,756,309,645,93,270,203,64,15,362,306,56,306,282,24,2022-01-01,zipcode,Devers
ZCTA5 77539,48,47240,83707,1338,224500,36554,11748,30997,4588,7279,11089,5977,2064,19162,17641,1521,17641,13434,4207,2022-01-01,zipcode,Dickinson
ZCTA5 77541,48,17087,55237,1063,136600,13188,5970,11372,2220,3840,4292,781,239,9364,6561,2803,6561,4547,2014,2022-01-01,zipcode,Freeport
ZCTA5 77545,48,25988,89784,2008,236800,20959,5722,16854,2476,5031,4527,3386,1434,8904,8458,446,8458,7092,1366,2022-01-01,zipcode,Fresno
ZCTA5 77546,48,53830,117118,1644,320400,41383,13695,35272,1900,5702,11456,10301,5913,19586,18777,809,18777,14338,4439,2022-01-01,zipcode,Friendswood
ZCTA5 77547,48,9336,41485,1127,97400,6464,2641,4924,1823,1716,1040,278,67,2710,2570,140,2570,1724,846,2022-01-01,zipcode,Galena park
ZCTA5 77550,48,23215,47366,1115,245300,20273,8298,16599,2330,3779,5064,3174,2252,15592,11282,4310,11282,4656,6626,2022-01-01,zipcode,Galveston
ZCTA5 77551,48,22521,56620,1251,242800,18685,8015,16059,2386,4430,4822,2773,1648,10876,9174,1702,9174,4359,4815,2022-01-01,zipcode,Galveston
ZCTA5 77554,48,9825,86912,1435,391800,9255,3770,7583,326,1422,2240,2211,1384,10406,4628,5778,4628,3127,1501,2022-01-01,zipcode,Galveston
ZCTA5 77560,48,1079,95486,-666666666,251500,802,322,748,25,229,388,96,10,375,375,0,375,320,55,2022-01-01,zipcode,Hankamer
ZCTA5 77561,48,45,-666666666,-666666666,-666666666,45,34,45,0,45,0,0,0,24,17,7,17,17,0,2022-01-01,zipcode,Hardin
ZCTA5 77562,48,9793,64225,1071,179600,7327,3000,6415,1199,2122,2193,678,223,3931,3430,501,3430,2627,803,2022-01-01,zipcode,Highlands
ZCTA5 77563,48,10382,77917,1252,194800,8296,3164,7250,875,2013,2885,1109,368,4771,4221,550,4221,3233,988,2022-01-01,zipcode,Hitchcock
ZCTA5 77564,48,1907,48315,-666666666,105000,1455,877,1383,262,422,495,131,73,913,733,180,733,641,92,2022-01-01,zipcode,Hull
ZCTA5 77565,48,6493,81921,1640,342100,5534,1862,4884,235,967,1868,1135,679,3376,2997,379,2997,1808,1189,2022-01-01,zipcode,Kemah
ZCTA5 77566,48,30538,91806,1404,242400,23705,7795,20088,1455,4998,7005,4584,2046,12436,11525,911,11525,7610,3915,2022-01-01,zipcode,Lake jackson
ZCTA5 77568,48,20417,63806,1125,183300,15533,5419,13723,1976,3803,4949,1659,1336,8465,7592,873,7592,5792,1800,2022-01-01,zipcode,La marque
ZCTA5 77571,48,37346,80778,1266,199800,28820,10383,24907,2794,8378,9428,2821,1486,14147,13480,667,13480,9828,3652,2022-01-01,zipcode,La porte
ZCTA5 77573,48,95704,119948,1625,322500,72915,22128,63264,2383,10099,19319,21160,10303,36173,34834,1339,34834,25927,8907,2022-01-01,zipcode,League city
ZCTA5 77575,48,16392,51285,916,153900,12357,6146,10475,2110,4344,2619,1012,390,6535,5584,951,5584,4234,1350,2022-01-01,zipcode,Liberty
ZCTA5 77577,48,1106,61006,575,229900,896,379,768,177,258,263,38,32,575,429,146,429,407,22,2022-01-01,zipcode,Liverpool
ZCTA5 77578,48,24322,126498,1392,339600,18838,6252,16111,1187,3046,5570,3609,2699,9139,8297,842,8297,6957,1340,2022-01-01,zipcode,Manvel
ZCTA5 77580,48,0,-666666666,-666666666,-666666666,0,0,0,0,0,0,0,0,0,0,0,0,0,0,2022-01-01,zipcode,Mont belvieu
ZCTA5 77581,48,50554,105053,1485,289400,39013,12202,32942,1907,7910,11129,7814,4182,18254,17599,655,17599,13549,4050,2022-01-01,zipcode,Pearland
ZCTA5 77583,48,44443,110852,1124,267400,34195,14793,29260,4948,8121,7242,5229,3720,13071,11571,1500,11571,10398,1173,2022-01-01,zipcode,Rosharon
ZCTA5 77584,48,90364,112994,1661,324700,67622,20966,58412,3768,8187,15904,18649,11904,31696,29940,1756,29940,22585,7355,2022-01-01,zipcode,Pearland
ZCTA5 77585,48,1036,-666666666,-666666666,-666666666,803,390,724,105,488,92,39,0,507,442,65,442,373,69,2022-01-01,zipcode,Saratoga
ZCTA5 77586,48,23802,105076,1430,305100,19172,6365,16222,1082,2180,5777,4816,2367,10099,9416,683,9416,6537,2879,2022-01-01,zipcode,Seabrook
ZCTA5 77587,48,16185,50925,1131,146300,11836,4196,8744,3489,2788,1697,643,127,5432,4829,603,4829,2508,2321,2022-01-01,zipcode,South houston
ZCTA5 77590,48,33347,57293,1122,156700,26079,9613,21872,3725,7326,7117,2704,1000,14371,13176,1195,13176,6986,6190,2022-01-01,zipcode,Texas city
ZCTA5 77591,48,15914,62135,1152,172500,12434,4844,10598,1076,3303,3831,1736,652,6856,6260,596,6260,3397,2863,2022-01-01,zipcode,Texas city
ZCTA5 77597,48,398,-666666666,-666666666,318800,371,52,347,0,109,121,103,14,219,190,29,190,142,48,2022-01-01,zipcode,Wallisville
ZCTA5 77598,48,26635,56551,1231,207800,21369,4739,18375,1997,4390,6520,3742,1726,13466,12443,1023,12443,2435,10008,2022-01-01,zipcode,Webster
ZCTA5 77611,48,9814,98718,1041,181200,7604,2511,6367,725,1871,2015,1260,496,4121,3528,593,3528,2664,864,2022-01-01,zipcode,Bridge city
ZCTA5 77612,48,9725,59666,686,113400,7420,3330,6511,1110,2845,1920,482,154,4381,3799,582,3799,3291,508,2022-01-01,zipcode,Buna
ZCTA5 77613,48,855,51786,790,180200,700,291,638,63,169,307,52,47,475,432,43,432,296,136,2022-01-01,zipcode,China
ZCTA5 77614,48,493,28698,-666666666,115700,417,222,380,33,213,101,33,0,292,219,73,219,167,52,2022-01-01,zipcode,Deweyville
ZCTA5 77615,48,339,59688,-666666666,79300,302,78,254,10,192,45,7,0,177,141,36,141,109,32,2022-01-01,zipcode,Evadale
ZCTA5 77616,48,686,-666666666,-666666666,164600,588,164,381,3,310,43,25,0,261,187,74,187,176,11,2022-01-01,zipcode,Fred
ZCTA5 77617,48,38,70536,-666666666,-666666666,38,32,38,10,8,12,8,0,120,22,98,22,14,8,2022-01-01,zipcode,
ZCTA5 77619,48,17110,64737,1210,147500,13419,5243,11989,1597,3554,5183,1162,493,6735,6034,701,6034,4453,1581,2022-01-01,zipcode,Groves
ZCTA5 77622,48,1990,117779,-666666666,223900,1515,455,1044,87,411,264,234,48,700,629,71,629,579,50,2022-01-01,zipcode,Hamshire
ZCTA5 77623,48,515,64318,-666666666,-666666666,483,197,464,24,196,146,34,64,323,256,67,256,245,11,2022-01-01,zipcode,High island
ZCTA5 77624,48,644,47917,-666666666,149000,570,360,561,6,346,151,45,13,302,260,42,260,260,0,2022-01-01,zipcode,Hillister
ZCTA5 77625,48,8274,67942,899,115300,6785,3196,5739,1122,2301,1419,637,260,3835,3153,682,3153,2533,620,2022-01-01,zipcode,Kountze
ZCTA5 77627,48,22180,75461,1210,177000,17331,6173,15037,950,4185,5943,2940,1019,9972,8874,1098,8874,6509,2365,2022-01-01,zipcode,Nederland
ZCTA5 77629,48,576,53527,-666666666,152100,514,233,480,46,230,132,51,21,288,249,39,249,229,20,2022-01-01,zipcode,Nome
ZCTA5 77630,48,29160,61223,993,155300,22045,8916,18912,2197,6957,6965,2070,723,12973,10587,2386,10587,7002,3585,2022-01-01,zipcode,Orange
ZCTA5 77632,48,21451,83679,1014,178800,17152,6911,14719,1379,5030,5288,2296,726,9411,8086,1325,8086,6467,1619,2022-01-01,zipcode,Orange
ZCTA5 77640,48,16896,49122,1101,91100,13468,6731,11312,2085,4120,3690,869,548,8906,6655,2251,6655,4522,2133,2022-01-01,zipcode,Port arthur
ZCTA5 77642,48,38720,42076,885,90800,28150,12983,23076,5811,8180,6579,1772,734,15891,13549,2342,13549,6974,6575,2022-01-01,zipcode,Port arthur
ZCTA5 77650,48,2073,61211,-666666666,363800,1973,1350,1973,76,828,826,243,0,2684,1161,1523,1161,1073,88,2022-01-01,zipcode,Port bolivar
ZCTA5 77651,48,13635,85086,1038,223500,10611,3865,9247,742,2393,3601,1595,916,5626,4936,690,4936,3743,1193,2022-01-01,zipcode,Port neches
ZCTA5 77655,48,294,68472,-666666666,142500,279,134,264,27,118,87,13,19,195,171,24,171,163,8,2022-01-01,zipcode,Sabine pass
ZCTA5 77656,48,17280,61286,937,113700,13761,6438,11937,1159,5009,3816,1602,351,7690,6302,1388,6302,5095,1207,2022-01-01,zipcode,Silsbee
ZCTA5 77657,48,21084,86611,975,219200,16423,6365,14588,1114,4925,5380,2394,775,8715,7938,777,7938,6582,1356,2022-01-01,zipcode,Lumberton
ZCTA5 77659,48,6305,93780,1176,187600,4513,1723,3588,549,1177,959,644,259,2149,1921,228,1921,1690,231,2022-01-01,zipcode,Sour lake
ZCTA5 77660,48,1111,52647,-666666666,140600,988,623,792,131,197,352,86,26,493,360,133,360,320,40,2022-01-01,zipcode,Spurger
ZCTA5 77661,48,371,-666666666,-666666666,-666666666,204,118,163,0,37,69,0,57,170,123,47,123,66,57,2022-01-01,zipcode,Stowell
ZCTA5 77662,48,25849,68901,874,119300,20677,7891,17949,2123,6948,6584,1727,567,11665,9726,1939,9726,7943,1783,2022-01-01,zipcode,Vidor
ZCTA5 77663,48,888,-666666666,-666666666,233700,692,399,617,0,317,270,30,0,626,389,237,389,265,124,2022-01-01,zipcode,Village mills
ZCTA5 77664,48,2621,64643,1115,123100,2209,1189,1869,180,834,463,251,141,1339,1050,289,1050,958,92,2022-01-01,zipcode,Warren
ZCTA5 77665,48,6593,70564,1000,161100,5258,1957,4162,544,1469,1412,568,169,2488,2059,429,2059,1613,446,2022-01-01,zipcode,Winnie
ZCTA5 77701,48,12955,46653,911,69100,10060,4460,8639,2583,3266,2086,408,296,5857,4544,1313,4544,2446,2098,2022-01-01,zipcode,Beaumont
ZCTA5 77702,48,3234,61042,975,152800,2501,719,2139,353,530,610,373,273,1702,1469,233,1469,857,612,2022-01-01,zipcode,Beaumont
ZCTA5 77703,48,11704,27972,838,87100,8484,4466,7101,1657,3277,1641,336,190,5320,4345,975,4345,2027,2318,2022-01-01,zipcode,Beaumont
ZCTA5 77705,48,38228,47311,823,114600,32914,20671,28178,5593,10533,9529,1786,737,12386,10432,1954,10432,5987,4445,2022-01-01,zipcode,Beaumont
ZCTA5 77706,48,29693,70772,1098,217200,23644,9291,20138,900,3752,5869,6656,2961,14628,13285,1343,13285,7605,5680,2022-01-01,zipcode,Beaumont
ZCTA5 77707,48,18124,64545,1118,147900,13382,4881,11454,1545,3203,3787,1994,925,7164,6298,866,6298,4372,1926,2022-01-01,zipcode,Beaumont
ZCTA5 77708,48,13284,56151,990,163300,10484,3517,9066,943,3336,3155,1260,372,5894,5305,589,5305,2773,2532,2022-01-01,zipcode,Beaumont
ZCTA5 77713,48,14458,84710,1316,205200,10741,3708,9497,868,2431,3546,1959,693,6554,5613,941,5613,3605,2008,2022-01-01,zipcode,Beaumont
ZCTA5 77801,48,15163,30849,923,173200,11552,3909,6623,1078,2146,1908,831,660,7140,6058,1082,6058,881,5177,2022-01-01,zipcode,Bryan
ZCTA5 77802,48,24226,65150,1193,223000,20164,7150,16744,1078,3852,3929,4533,3352,11866,10904,962,10904,5688,5216,2022-01-01,zipcode,Bryan
ZCTA5 77803,48,32130,51914,1122,120000,23596,9308,19102,5781,6705,4780,1225,611,10230,9411,819,9411,5691,3720,2022-01-01,zipcode,Bryan
ZCTA5 77807,48,12949,71966,1189,220700,10682,4362,8863,1541,2234,2143,1801,1144,5446,4677,769,4677,2780,1897,2022-01-01,zipcode,Bryan
ZCTA5 77808,48,14666,92868,1050,316100,11841,4519,10677,869,2766,3118,2580,1344,5976,5460,516,5460,4992,468,2022-01-01,zipcode,Bryan
ZCTA5 77830,48,2815,103635,975,304400,2275,656,1896,176,563,520,420,217,1264,1091,173,1091,891,200,2022-01-01,zipcode,Anderson
ZCTA5 77831,48,3095,58250,934,113000,2440,1054,2233,149,870,827,185,202,1810,1164,646,1164,1063,101,2022-01-01,zipcode,Bedias
ZCTA5 77833,48,28884,63474,985,232100,23254,9869,18619,2080,5446,5743,3686,1664,12938,11373,1565,11373,8017,3356,2022-01-01,zipcode,Brenham
ZCTA5 77835,48,2912,80385,1318,288800,2280,922,2035,75,625,723,346,266,1721,1150,571,1150,1028,122,2022-01-01,zipcode,Burton
ZCTA5 77836,48,12042,75357,978,181900,9576,4176,8553,1385,3139,2234,1278,517,5775,4932,843,4932,3991,941,2022-01-01,zipcode,Caldwell
ZCTA5 77837,48,1439,53523,854,111600,1147,591,986,195,268,259,138,126,856,589,267,589,394,195,2022-01-01,zipcode,Calvert
ZCTA5 77840,48,53891,30049,1036,234100,48991,18199,17473,1290,3002,4455,4635,4091,25630,21526,4104,21526,2275,19251,2022-01-01,zipcode,College station
ZCTA5 77845,48,73969,87391,1307,322700,58232,19643,43694,1625,5261,10427,13413,12968,30839,28150,2689,28150,18165,9985,2022-01-01,zipcode,College station
ZCTA5 77853,48,1009,55238,779,116400,851,387,783,193,344,129,84,33,552,392,160,392,335,57,2022-01-01,zipcode,Dime box
ZCTA5 77855,48,64,-666666666,-666666666,-666666666,64,36,64,14,36,14,0,0,48,25,23,25,25,0,2022-01-01,zipcode,Flynn
ZCTA5 77856,48,4748,84940,928,250400,3574,1558,3135,270,1240,930,545,150,2682,1617,1065,1617,1259,358,2022-01-01,zipcode,Franklin
ZCTA5 77857,48,1033,55417,692,269400,811,371,731,71,288,235,73,64,504,437,67,437,350,87,2022-01-01,zipcode,Gause
ZCTA5 77859,48,7220,49817,616,124100,6011,2684,4857,858,2103,1206,460,230,3212,2721,491,2721,1966,755,2022-01-01,zipcode,Hearne
ZCTA5 77861,48,2921,67113,882,244800,2256,1029,1906,219,636,607,284,160,1299,1085,214,1085,931,154,2022-01-01,zipcode,Iola
ZCTA5 77864,48,7565,67574,782,128200,5896,2330,4935,1197,1646,1368,489,235,3197,2666,531,2666,1786,880,2022-01-01,zipcode,Madisonville
ZCTA5 77865,48,2141,84602,1169,162500,1560,704,1183,36,480,481,125,61,1055,687,368,687,539,148,2022-01-01,zipcode,Marquez
ZCTA5 77867,48,211,29531,-666666666,-666666666,145,122,121,43,70,2,6,0,94,77,17,77,72,5,2022-01-01,zipcode,Mumford
ZCTA5 77868,48,17559,59534,905,186000,14129,7112,11793,2706,3800,3607,892,788,6105,5170,935,5170,3574,1596,2022-01-01,zipcode,Navasota
ZCTA5 77871,48,2528,56544,742,185200,2198,1022,2021,153,953,411,248,256,1600,1180,420,1180,924,256,2022-01-01,zipcode,Normangee
ZCTA5 77872,48,2327,76250,1102,166000,1732,851,1448,110,681,463,157,37,993,754,239,754,587,167,2022-01-01,zipcode,North zulch
ZCTA5 77873,48,1287,76705,540,204900,1083,434,872,42,310,267,172,81,640,525,115,525,488,37,2022-01-01,zipcode,Richards
ZCTA5 77876,48,175,67457,-666666666,-666666666,142,79,142,0,40,63,3,36,81,63,18,63,63,0,2022-01-01,zipcode,Shiro
ZCTA5 77878,48,705,47403,905,136800,694,259,596,157,212,99,90,38,407,372,35,372,206,166,2022-01-01,zipcode,Snook
ZCTA5 77879,48,4876,69636,892,132500,4142,1928,3631,558,1008,1169,708,188,3159,2231,928,2231,1764,467,2022-01-01,zipcode,Somerville
ZCTA5 77880,48,2041,87324,1408,284200,1829,688,1785,86,963,261,183,292,1456,1052,404,1052,973,79,2022-01-01,zipcode,Washington
ZCTA5 77901,48,40137,52823,1017,127600,30876,11302,25399,6409,7959,7572,2666,793,17478,14909,2569,14909,8597,6312,2022-01-01,zipcode,Victoria
ZCTA5 77904,48,29761,85410,1178,226500,23174,8438,20076,1374,5577,7766,3638,1721,12545,11455,1090,11455,7933,3522,2022-01-01,zipcode,Victoria
ZCTA5 77905,48,16500,77146,1068,183200,13090,5229,11170,1508,3327,4378,1495,462,6809,6104,705,6104,5068,1036,2022-01-01,zipcode,Victoria
ZCTA5 77950,48,156,55455,-666666666,62500,138,62,126,13,42,57,12,2,152,68,84,68,53,15,2022-01-01,zipcode,Austwell
ZCTA5 77951,48,1246,24331,739,57300,877,551,831,246,393,153,10,29,720,537,183,537,336,201,2022-01-01,zipcode,Bloomington
ZCTA5 77954,48,10918,61382,937,166000,8943,4498,7978,1324,3558,1916,802,378,4707,3382,1325,3382,2226,1156,2022-01-01,zipcode,Cuero
ZCTA5 77957,48,8492,63750,916,111700,6730,3270,5758,1104,2078,1726,686,164,3835,2990,845,2990,2212,778,2022-01-01,zipcode,Edna
ZCTA5 77960,48,55,-666666666,-666666666,-666666666,55,0,55,0,0,55,0,0,55,55,0,55,55,0,2022-01-01,zipcode,Fannin
ZCTA5 77961,48,137,-666666666,-666666666,-666666666,137,45,137,45,0,92,0,0,137,137,0,137,45,92,2022-01-01,zipcode,Francitas
ZCTA5 77962,48,3813,79004,853,187900,2999,1263,2461,480,806,926,196,53,1563,1297,266,1297,858,439,2022-01-01,zipcode,Ganado
ZCTA5 77963,48,5246,55313,775,172800,4169,2026,3595,554,1176,1210,434,221,2569,1929,640,1929,1552,377,2022-01-01,zipcode,Goliad
ZCTA5 77964,48,7911,60435,909,207700,6243,2413,5413,766,1899,1644,750,354,4299,3229,1070,3229,2292,937,2022-01-01,zipcode,Hallettsville
ZCTA5 77968,48,3220,77794,675,278300,2346,893,2135,63,600,784,547,141,1288,1154,134,1154,1014,140,2022-01-01,zipcode,Inez
ZCTA5 77969,48,224,78125,-666666666,490000,212,145,196,62,62,49,23,0,110,92,18,92,92,0,2022-01-01,zipcode,La salle
ZCTA5 77970,48,273,83542,695,-666666666,211,87,147,51,48,14,0,34,146,80,66,80,53,27,2022-01-01,zipcode,La ward
ZCTA5 77971,48,854,56124,-666666666,223700,745,387,643,98,341,204,0,0,380,253,127,253,253,0,2022-01-01,zipcode,Lolita
ZCTA5 77973,48,23,-666666666,-666666666,-666666666,23,6,15,9,6,0,0,0,9,9,0,9,0,9,2022-01-01,zipcode,Mcfaddin
ZCTA5 77974,48,565,59000,1112,183700,399,149,344,19,92,199,29,5,203,194,9,194,133,61,2022-01-01,zipcode,Meyersville
ZCTA5 77975,48,1643,55533,920,170100,1308,461,1184,139,442,329,185,89,1015,720,295,720,513,207,2022-01-01,zipcode,Moulton
ZCTA5 77976,48,49,-666666666,-666666666,200000,49,16,49,0,16,16,11,6,50,22,28,22,22,0,2022-01-01,zipcode,Nursery
ZCTA5 77977,48,536,22500,-666666666,44100,421,198,370,64,242,45,19,0,279,238,41,238,212,26,2022-01-01,zipcode,Placedo
ZCTA5 77978,48,458,90625,984,98300,385,187,354,32,172,125,18,7,218,170,48,170,121,49,2022-01-01,zipcode,Point comfort
ZCTA5 77979,48,16607,60782,944,123500,13051,4582,11112,1732,3773,3740,1137,730,7774,6508,1266,6508,4858,1650,2022-01-01,zipcode,Port lavaca
ZCTA5 77982,48,791,91150,-666666666,256600,779,556,668,21,253,350,26,18,1244,365,879,365,345,20,2022-01-01,zipcode,Port o connor
ZCTA5 77983,48,2337,80541,1355,156300,1773,629,1492,382,462,387,186,75,1368,1004,364,1004,826,178,2022-01-01,zipcode,Seadrift
ZCTA5 77984,48,4365,84177,963,199300,3498,1506,3116,263,1120,859,728,146,2249,1761,488,1761,1542,219,2022-01-01,zipcode,Shiner
ZCTA5 77987,48,146,109375,-666666666,-666666666,102,21,93,13,36,32,3,9,78,51,27,51,45,6,2022-01-01,zipcode,Sweet home
ZCTA5 77988,48,161,61913,-666666666,-666666666,161,18,161,19,75,49,18,0,116,75,41,75,26,49,2022-01-01,zipcode,Telferner
ZCTA5 77990,48,962,74250,980,89400,782,352,710,78,351,169,72,40,466,327,139,327,285,42,2022-01-01,zipcode,Tivoli
ZCTA5 77991,48,526,119531,-666666666,-666666666,267,40,232,33,43,84,72,0,163,98,65,98,98,0,2022-01-01,zipcode,Vanderbilt
ZCTA5 77993,48,214,-666666666,-666666666,204300,138,118,138,61,34,23,20,0,112,54,58,54,54,0,2022-01-01,zipcode,Weesatche
ZCTA5 77994,48,430,81544,-666666666,-666666666,308,156,297,11,77,143,46,20,250,128,122,128,109,19,2022-01-01,zipcode,Westhoff
ZCTA5 77995,48,10890,54300,838,171400,8289,3432,6999,1385,2806,1807,785,216,4767,3906,861,3906,2963,943,2022-01-01,zipcode,Yoakum
ZCTA5 78001,48,0,-666666666,-666666666,-666666666,0,0,0,0,0,0,0,0,0,0,0,0,0,0,2022-01-01,zipcode,Artesia wells
ZCTA5 78002,48,8047,64792,1193,162200,6082,2589,4582,1292,1390,1448,283,169,2638,2386,252,2386,1784,602,2022-01-01,zipcode,Atascosa
ZCTA5 78003,48,8940,63052,962,221100,6844,3412,6365,559,1803,2280,978,745,4987,3705,1282,3705,3087,618,2022-01-01,zipcode,Bandera
ZCTA5 78004,48,610,137598,-666666666,520100,568,263,557,0,160,97,164,136,265,265,0,265,206,59,2022-01-01,zipcode,Bergheim
ZCTA5 78005,48,1421,66093,-666666666,-666666666,1388,438,1358,690,367,206,11,84,687,604,83,604,373,231,2022-01-01,zipcode,Bigfoot
ZCTA5 78006,48,41236,107803,1487,470700,33050,13095,28644,2022,4153,8397,8729,5343,16345,15316,1029,15316,11319,3997,2022-01-01,zipcode,Boerne
ZCTA5 78007,48,196,62143,-666666666,-666666666,97,50,97,5,59,31,2,0,118,44,74,44,35,9,2022-01-01,zipcode,Calliham
ZCTA5 78008,48,365,-666666666,-666666666,-666666666,246,179,246,68,136,20,0,22,237,116,121,116,58,58,2022-01-01,zipcode,Campbellton
ZCTA5 78009,48,9202,98732,1221,320000,7464,2829,6268,619,1215,2471,1149,814,3533,3102,431,3102,2618,484,2022-01-01,zipcode,Castroville
ZCTA5 78010,48,4174,73682,-666666666,246200,3415,1051,2923,562,867,820,462,212,1829,1560,269,1560,1207,353,2022-01-01,zipcode,Center point
ZCTA5 78011,48,1608,27193,-666666666,61600,1275,555,932,360,343,176,53,0,740,571,169,571,537,34,2022-01-01,zipcode,Charlotte
ZCTA5 78012,48,253,46000,-666666666,92300,208,70,144,45,76,23,0,0,148,82,66,82,58,24,2022-01-01,zipcode,Christine
ZCTA5 78013,48,5169,75838,956,344900,4426,1608,4065,390,1036,1203,903,533,2671,2193,478,2193,1870,323,2022-01-01,zipcode,Comfort
ZCTA5 78014,48,5245,67994,848,95000,4088,2395,3518,1273,1604,478,105,58,1873,1333,540,1333,1010,323,2022-01-01,zipcode,Cotulla
ZCTA5 78015,48,21583,146838,1485,474600,16029,5441,13718,381,1417,3112,5940,2868,7777,7440,337,7440,6940,500,2022-01-01,zipcode,Boerne
ZCTA5 78016,48,11345,56205,683,168100,9018,3722,7664,1088,2906,2155,987,528,4246,3805,441,3805,2945,860,2022-01-01,zipcode,Devine
ZCTA5 78017,48,5471,72188,697,106300,4292,2477,3506,858,1456,782,207,203,1469,1037,432,1037,771,266,2022-01-01,zipcode,Dilley
ZCTA5 78019,48,1877,49306,910,106500,1712,1041,1122,435,388,165,95,39,570,442,128,442,412,30,2022-01-01,zipcode,Encinal
ZCTA5 78021,48,5,-666666666,-666666666,-666666666,5,5,5,0,3,0,0,2,43,2,41,2,2,0,2022-01-01,zipcode,Fowlerton
ZCTA5 78022,48,4724,57833,951,154100,3747,1856,3277,1029,877,1022,163,186,2116,1564,552,1564,1111,453,2022-01-01,zipcode,George west
ZCTA5 78023,48,28195,129145,1561,374800,22707,7741,19399,563,2274,5761,6445,4356,9800,9545,255,9545,8524,1021,2022-01-01,zipcode,Helotes
ZCTA5 78024,48,1190,71386,883,492100,1053,536,1018,57,141,399,278,143,858,483,375,483,383,100,2022-01-01,zipcode,Hunt
ZCTA5 78025,48,5264,64340,985,207100,4332,1874,3887,463,1207,1098,874,245,2707,2164,543,2164,1616,548,2022-01-01,zipcode,Ingram
ZCTA5 78026,48,6426,74047,955,139200,5069,2264,4528,865,2044,612,888,119,3281,2613,668,2613,1693,920,2022-01-01,zipcode,Jourdanton
ZCTA5 78027,48,460,103194,-666666666,226100,427,119,413,0,14,231,156,12,255,160,95,160,160,0,2022-01-01,zipcode,Kendalia
ZCTA5 78028,48,39906,64768,1068,259300,33652,15578,28838,2760,8270,9043,5170,3595,18602,16878,1724,16878,11480,5398,2022-01-01,zipcode,Kerrville
ZCTA5 78029,48,0,-666666666,-666666666,-666666666,0,0,0,0,0,0,0,0,0,0,0,0,0,0,2022-01-01,zipcode,Kerrville
ZCTA5 78039,48,2193,69669,933,86600,1893,705,1713,151,919,316,238,89,895,823,72,823,707,116,2022-01-01,zipcode,La coste
ZCTA5 78040,48,36727,33819,853,101100,26647,12096,20971,10010,4454,4895,1133,479,13568,11438,2130,11438,4673,6765,2022-01-01,zipcode,Laredo
ZCTA5 78041,48,47594,61696,914,194100,35702,13537,28171,7568,5469,7551,5351,2232,16338,15212,1126,15212,7854,7358,2022-01-01,zipcode,Laredo
ZCTA5 78043,48,44443,54816,956,130200,32036,12234,24683,8932,5897,6701,2304,849,14101,12624,1477,12624,6751,5873,2022-01-01,zipcode,Laredo
ZCTA5 78044,48,397,-666666666,-666666666,232400,315,157,275,90,117,68,0,0,226,139,87,139,110,29,2022-01-01,zipcode,Laredo
ZCTA5 78045,48,67686,85219,1289,210700,48838,15310,39565,6625,7248,11517,10069,4106,21360,20412,948,20412,15689,4723,2022-01-01,zipcode,Laredo
ZCTA5 78046,48,69422,51667,984,131900,47083,19013,36120,13170,9458,9115,3148,1229,18970,17552,1418,17552,13777,3775,2022-01-01,zipcode,Laredo
ZCTA5 78050,48,713,92679,-666666666,125000,496,222,387,80,153,136,18,0,207,178,29,178,162,16,2022-01-01,zipcode,Leming
ZCTA5 78052,48,6339,69583,1022,142700,5097,1943,4259,498,1450,1709,398,204,2318,1939,379,1939,1584,355,2022-01-01,zipcode,Lytle
ZCTA5 78055,48,2036,67560,963,215000,1820,1013,1658,180,648,464,193,173,1162,805,357,805,731,74,2022-01-01,zipcode,Medina
ZCTA5 78056,48,2096,115885,-666666666,469800,1668,593,1515,39,228,559,286,403,947,772,175,772,701,71,2022-01-01,zipcode,Mico
ZCTA5 78057,48,556,-666666666,-666666666,-666666666,440,336,440,45,48,332,10,5,523,173,350,173,173,0,2022-01-01,zipcode,Moore
ZCTA5 78058,48,871,98661,-666666666,326500,800,398,699,18,140,278,174,89,590,417,173,417,364,53,2022-01-01,zipcode,Mountain home
ZCTA5 78059,48,6106,72648,969,154700,4812,2254,3973,1190,1404,880,368,131,2242,2008,234,2008,1799,209,2022-01-01,zipcode,Natalia
ZCTA5 78061,48,10892,45783,817,94000,8601,4312,6594,1915,2777,1415,388,99,3746,2971,775,2971,1653,1318,2022-01-01,zipcode,Pearsall
ZCTA5 78063,48,10309,78149,915,238200,9025,3711,7911,548,2203,2856,1471,833,4879,3940,939,3940,3631,309,2022-01-01,zipcode,Pipe creek
ZCTA5 78064,48,15969,71180,1066,188900,11816,4860,9876,1910,3608,2495,1293,570,5935,5228,707,5228,3813,1415,2022-01-01,zipcode,Pleasanton
ZCTA5 78065,48,11741,59450,917,122500,8882,3612,7551,1565,3340,1762,680,204,4086,3547,539,3547,2582,965,2022-01-01,zipcode,Poteet
ZCTA5 78066,48,707,88532,-666666666,172800,682,569,682,0,238,267,108,69,356,356,0,356,344,12,2022-01-01,zipcode,Rio medina
ZCTA5 78067,48,811,69181,-666666666,74900,576,307,492,135,183,117,57,0,434,239,195,239,239,0,2022-01-01,zipcode,San ygnacio
ZCTA5 78069,48,7124,73355,895,96900,5902,2635,4679,850,1887,1525,332,85,2404,2124,280,2124,1886,238,2022-01-01,zipcode,Somerset
ZCTA5 78070,48,18529,99219,1250,432400,15371,6247,13579,939,3342,4179,3320,1799,7804,7074,730,7074,6487,587,2022-01-01,zipcode,Spring branch
ZCTA5 78071,48,3837,45426,917,142800,3323,2169,2918,861,895,819,279,64,1649,1250,399,1250,855,395,2022-01-01,zipcode,Three rivers
ZCTA5 78072,48,437,53056,-666666666,97400,331,140,304,43,120,83,41,17,219,136,83,136,120,16,2022-01-01,zipcode,Tilden
ZCTA5 78073,48,9219,64375,1029,143400,7089,2764,5781,1506,2250,1327,562,136,2980,2616,364,2616,2173,443,2022-01-01,zipcode,Von ormy
ZCTA5 78075,48,154,-666666666,-666666666,105300,148,97,113,21,78,14,0,0,113,106,7,106,71,35,2022-01-01,zipcode,Whitsett
ZCTA5 78076,48,13037,34779,557,86300,9199,4219,7389,2588,2141,1819,665,176,5630,4328,1302,4328,3174,1154,2022-01-01,zipcode,Zapata
ZCTA5 78101,48,8863,83052,803,265000,6870,3157,5928,1042,1796,1703,852,535,3326,3183,143,3183,2844,339,2022-01-01,zipcode,Adkins
ZCTA5 78102,48,26887,51147,991,113200,22412,12991,18921,3888,6528,6500,1272,733,8742,7180,1562,7180,4706,2474,2022-01-01,zipcode,Beeville
ZCTA5 78104,48,86,66771,-666666666,-666666666,45,0,45,4,3,38,0,0,35,25,10,25,0,25,2022-01-01,zipcode,Beeville
ZCTA5 78107,48,310,-666666666,-666666666,-666666666,256,151,234,20,66,117,31,0,212,180,32,180,131,49,2022-01-01,zipcode,Berclair
ZCTA5 78108,48,46463,111863,1925,282500,34815,12947,28468,1786,6275,9770,6766,3871,15471,14779,692,14779,12468,2311,2022-01-01,zipcode,Cibolo
ZCTA5 78109,48,52507,81152,1471,219100,38274,11816,32296,2623,7942,11672,6547,3512,18195,17790,405,17790,13390,4400,2022-01-01,zipcode,Converse
ZCTA5 78112,48,10234,55481,1167,113100,7811,3278,6711,1506,2188,2441,442,134,3625,3469,156,3469,3092,377,2022-01-01,zipcode,Elmendorf
ZCTA5 78113,48,2691,87865,1046,232800,2083,866,1814,210,727,421,360,96,1154,1051,103,1051,844,207,2022-01-01,zipcode,Falls city
ZCTA5 78114,48,23351,83511,1051,254900,18966,7906,16343,1580,5913,5030,2712,1108,8966,8249,717,8249,6874,1375,2022-01-01,zipcode,Floresville
ZCTA5 78116,48,220,-666666666,-666666666,270000,208,180,208,3,133,35,0,37,220,108,112,108,108,0,2022-01-01,zipcode,Gillett
ZCTA5 78117,48,667,84479,-666666666,241700,479,218,454,50,118,132,108,46,366,285,81,285,276,9,2022-01-01,zipcode,Hobson
ZCTA5 78118,48,4147,61577,829,110900,3588,2092,2933,885,993,608,345,102,1648,1203,445,1203,939,264,2022-01-01,zipcode,Karnes city
ZCTA5 78119,48,7147,-666666666,962,129200,5874,3716,5305,1296,1964,1370,514,161,2438,1731,707,1731,1035,696,2022-01-01,zipcode,Kenedy
ZCTA5 78121,48,14461,114338,1055,328300,11098,3463,9647,422,2881,3395,2066,883,5132,4807,325,4807,4242,565,2022-01-01,zipcode,La vernia
ZCTA5 78122,48,207,148125,-666666666,257900,207,91,191,64,82,36,5,4,158,123,35,123,106,17,2022-01-01,zipcode,Leesville
ZCTA5 78123,48,2310,92004,1184,198600,1835,608,1756,133,745,440,254,184,1363,953,410,953,828,125,2022-01-01,zipcode,Mc queeney
ZCTA5 78124,48,7250,78571,1119,237200,6029,2259,5139,745,1767,1690,710,227,2754,2552,202,2552,2197,355,2022-01-01,zipcode,Marion
ZCTA5 78125,48,21,24167,-666666666,-666666666,18,15,18,4,5,3,4,2,25,12,13,12,12,0,2022-01-01,zipcode,Mineral
ZCTA5 78130,48,91275,82896,1420,276200,71751,23990,60888,5691,15840,18135,14947,6275,38305,34859,3446,34859,22527,12332,2022-01-01,zipcode,New braunfels
ZCTA5 78132,48,37386,119561,1349,504200,29371,11599,25871,1094,4590,7184,7915,5088,14567,13664,903,13664,11579,2085,2022-01-01,zipcode,New braunfels
ZCTA5 78133,48,22120,78674,1219,278300,18142,8418,16596,1026,5023,5571,3121,1855,11266,9113,2153,9113,7700,1413,2022-01-01,zipcode,Canyon lake
ZCTA5 78140,48,3889,66940,875,90100,2647,804,2138,601,956,491,77,13,1471,1280,191,1280,862,418,2022-01-01,zipcode,Nixon
ZCTA5 78141,48,850,45104,975,70300,749,488,699,58,360,227,33,21,542,365,177,365,315,50,2022-01-01,zipcode,Nordheim
ZCTA5 78142,48,35,36042,-666666666,162500,35,28,35,3,13,9,4,6,36,21,15,21,16,5,2022-01-01,zipcode,Normanna
ZCTA5 78143,48,191,-666666666,-666666666,-666666666,191,112,191,0,76,0,115,0,64,51,13,51,51,0,2022-01-01,zipcode,Pandora
ZCTA5 78144,48,0,-666666666,-666666666,-666666666,0,0,0,0,0,0,0,0,0,0,0,0,0,0,2022-01-01,zipcode,Panna maria
ZCTA5 78145,48,81,45313,-666666666,-666666666,53,26,53,11,40,2,0,0,38,28,10,28,20,8,2022-01-01,zipcode,Pawnee
ZCTA5 78146,48,798,-666666666,1330,125000,521,226,442,62,183,172,20,5,279,208,71,208,112,96,2022-01-01,zipcode,Pettus
ZCTA5 78147,48,1709,69917,1137,181300,1235,443,1017,96,376,356,158,31,655,569,86,569,370,199,2022-01-01,zipcode,Poth
ZCTA5 78148,48,22236,71368,1184,226600,16983,5278,14402,659,3707,5365,2988,1683,8560,8316,244,8316,4226,4090,2022-01-01,zipcode,Universal city
ZCTA5 78150,48,0,-666666666,-666666666,-666666666,0,0,0,0,0,0,0,0,0,0,0,0,0,0,2022-01-01,zipcode,Jbsa randolph
ZCTA5 78151,48,1592,38225,417,103300,1235,548,934,243,313,182,113,83,878,729,149,729,401,328,2022-01-01,zipcode,Runge
ZCTA5 78152,48,2969,113205,1696,283900,2523,933,2056,61,688,589,456,262,1139,1062,77,1062,961,101,2022-01-01,zipcode,Saint hedwig
ZCTA5 78154,48,40535,95422,1596,273200,31881,9606,27786,1521,5639,9576,6796,4254,15348,14580,768,14580,10307,4273,2022-01-01,zipcode,Schertz
ZCTA5 78155,48,52295,68430,1083,216300,42202,15940,35511,5772,13783,8753,4987,2216,21019,19013,2006,19013,13520,5493,2022-01-01,zipcode,Seguin
ZCTA5 78159,48,587,32000,950,86400,487,274,420,87,178,82,73,0,337,266,71,266,202,64,2022-01-01,zipcode,Smiley
ZCTA5 78160,48,5008,81649,1070,183500,4083,1697,3343,539,978,1307,337,182,1969,1717,252,1717,1431,286,2022-01-01,zipcode,Stockdale
ZCTA5 78161,48,519,52552,-666666666,-666666666,383,148,266,32,137,57,40,0,231,157,74,157,148,9,2022-01-01,zipcode,Sutherland springs
ZCTA5 78162,48,343,44091,-666666666,170800,317,180,212,48,41,93,28,2,162,112,50,112,86,26,2022-01-01,zipcode,Tuleta
ZCTA5 78163,48,15389,127650,1396,411000,12571,5695,11021,390,2360,3119,3609,1543,5832,5499,333,5499,5247,252,2022-01-01,zipcode,Bulverde
ZCTA5 78164,48,3397,58750,881,168000,2703,1491,2361,410,974,679,190,108,1766,1284,482,1284,1013,271,2022-01-01,zipcode,Yorktown
ZCTA5 78201,48,45355,40356,983,164600,37112,15217,31008,8250,9196,8227,2896,2439,19010,16937,2073,16937,8099,8838,2022-01-01,zipcode,San antonio
ZCTA5 78202,48,9695,39759,1066,208900,8216,3239,7092,1605,2261,1563,929,734,5112,4375,737,4375,2188,2187,2022-01-01,zipcode,San antonio
ZCTA5 78203,48,5174,32500,877,106800,3889,1380,3413,913,1163,955,206,176,2573,2102,471,2102,1031,1071,2022-01-01,zipcode,San antonio
ZCTA5 78204,48,11969,47620,1327,117800,9650,3656,8287,1978,2246,2240,900,923,6314,5024,1290,5024,2250,2774,2022-01-01,zipcode,San antonio
ZCTA5 78205,48,1741,36746,1259,600400,1652,654,1366,251,262,248,352,253,1752,1234,518,1234,97,1137,2022-01-01,zipcode,San antonio
ZCTA5 78207,48,51381,28500,808,85800,38201,18616,31936,12615,10155,7370,1133,663,18724,16655,2069,16655,7277,9378,2022-01-01,zipcode,San antonio
ZCTA5 78208,48,4186,23864,890,118300,3280,1529,2853,725,978,783,221,146,2257,1860,397,1860,626,1234,2022-01-01,zipcode,San antonio
ZCTA5 78209,48,43184,79914,1301,468900,34941,11070,29412,1113,4011,6405,9113,8770,22234,19559,2675,19559,9445,10114,2022-01-01,zipcode,San antonio
ZCTA5 78210,48,33413,50169,1045,142900,25991,10427,21904,5293,6941,6454,2046,1170,14438,12046,2392,12046,6997,5049,2022-01-01,zipcode,San antonio
ZCTA5 78211,48,31433,50183,990,98500,24424,9481,20619,7539,7074,4599,1006,401,10584,9763,821,9763,6345,3418,2022-01-01,zipcode,San antonio
ZCTA5 78212,48,26911,58029,1046,269100,23467,8339,18534,2478,3701,5290,3644,3421,13298,11309,1989,11309,5190,6119,2022-01-01,zipcode,San antonio
ZCTA5 78213,48,42321,51118,1101,188000,32896,10796,27601,5807,6812,8438,4411,2133,18093,16553,1540,16553,7728,8825,2022-01-01,zipcode,San antonio
ZCTA5 78214,48,22914,38591,891,110900,17912,8523,14610,4434,5146,3857,882,291,8602,8004,598,8004,4717,3287,2022-01-01,zipcode,San antonio
ZCTA5 78215,48,3231,77725,1707,461300,3112,503,2686,35,239,508,954,950,2658,2207,451,2207,98,2109,2022-01-01,zipcode,San antonio
ZCTA5 78216,48,42379,54394,1134,261200,35230,10450,29290,2960,6510,9876,5448,4496,21932,19492,2440,19492,6576,12916,2022-01-01,zipcode,San antonio
ZCTA5 78217,48,32152,53795,1132,189900,26582,8171,22262,2473,5182,8441,3887,2279,15772,14182,1590,14182,6300,7882,2022-01-01,zipcode,San antonio
ZCTA5 78218,48,37122,52151,1132,165400,29286,9964,25298,4895,7972,8093,2862,1476,15006,14097,909,14097,6718,7379,2022-01-01,zipcode,San antonio
ZCTA5 78219,48,16442,49534,1057,134500,12172,4627,10233,2516,3038,3506,904,269,6201,5589,612,5589,3137,2452,2022-01-01,zipcode,San antonio
ZCTA5 78220,48,16919,39694,1137,112600,12588,6046,10396,2493,4200,2737,694,272,6621,6052,569,6052,3323,2729,2022-01-01,zipcode,San antonio
ZCTA5 78221,48,40272,57209,1043,138900,31205,11777,25190,6845,9232,6524,1747,842,14425,13023,1402,13023,8837,4186,2022-01-01,zipcode,San antonio
ZCTA5 78222,48,24866,66836,1235,172300,19420,7597,16574,2902,6047,4787,2152,686,9178,8315,863,8315,5759,2556,2022-01-01,zipcode,San antonio
ZCTA5 78223,48,55063,45687,1000,137800,41722,16846,35782,7778,13379,11014,2432,1179,21789,19963,1826,19963,11222,8741,2022-01-01,zipcode,San antonio
ZCTA5 78224,48,20965,53841,1106,129500,15763,5509,12526,3161,4225,3628,1199,313,7118,6554,564,6554,3505,3049,2022-01-01,zipcode,San antonio
ZCTA5 78225,48,13802,43883,983,97500,10885,4098,9082,2333,3303,2340,672,434,5587,5185,402,5185,3530,1655,2022-01-01,zipcode,San antonio
ZCTA5 78226,48,7357,30669,887,105000,5700,2542,4421,1689,1423,1000,243,66,2877,2320,557,2320,898,1422,2022-01-01,zipcode,San antonio
ZCTA5 78227,48,45553,45396,1036,129700,33792,12975,27292,6552,10074,8042,1850,774,16229,14960,1269,14960,8437,6523,2022-01-01,zipcode,San antonio
ZCTA5 78228,48,57172,46736,953,147800,44677,18521,36390,10090,12319,9297,3281,1403,21553,19636,1917,19636,11375,8261,2022-01-01,zipcode,San antonio
ZCTA5 78229,48,34082,44574,1172,178500,27999,8812,21714,2620,4934,7156,4043,2961,18973,16317,2656,16317,2392,13925,2022-01-01,zipcode,San antonio
ZCTA5 78230,48,42387,69171,1214,317000,35822,11641,30130,1687,5237,8351,8768,6087,20859,19070,1789,19070,9335,9735,2022-01-01,zipcode,San antonio
ZCTA5 78231,48,9972,106719,1267,366800,8259,2680,6966,198,917,1730,2093,2028,4125,4020,105,4020,2691,1329,2022-01-01,zipcode,San antonio
ZCTA5 78232,48,36169,85029,1353,322700,28626,8919,25179,993,4032,7846,7688,4620,15779,15086,693,15086,8611,6475,2022-01-01,zipcode,San antonio
ZCTA5 78233,48,47172,68157,1391,185800,36976,12185,30893,2921,9089,11841,4724,2318,18836,18078,758,18078,10910,7168,2022-01-01,zipcode,San antonio
ZCTA5 78234,48,5534,85903,2110,-666666666,4058,713,2041,23,236,768,653,361,1130,967,163,967,2,965,2022-01-01,zipcode,Jbsa ft sam houston
ZCTA5 78235,48,2548,60202,1388,-666666666,2044,393,1557,101,464,513,320,159,1318,1209,109,1209,0,1209,2022-01-01,zipcode,San antonio
ZCTA5 78236,48,8154,73750,1832,-666666666,7362,522,1904,110,258,872,532,132,572,476,96,476,12,464,2022-01-01,zipcode,Jbsa lackland
ZCTA5 78237,48,38492,38447,939,93700,29128,12021,24152,8799,8479,5538,923,413,13534,12406,1128,12406,7687,4719,2022-01-01,zipcode,San antonio
ZCTA5 78238,48,25900,54287,1113,180900,20698,6866,17271,2496,5215,6364,2109,1087,11525,10528,997,10528,5005,5523,2022-01-01,zipcode,San antonio
ZCTA5 78239,48,30482,71721,1357,201600,23851,9802,20290,2336,6250,6344,3405,1955,10840,9988,852,9988,7246,2742,2022-01-01,zipcode,San antonio
ZCTA5 78240,48,57532,61241,1252,228800,45626,13732,37851,2779,7452,12914,8855,5851,27299,24651,2648,24651,8456,16195,2022-01-01,zipcode,San antonio
ZCTA5 78242,48,36404,45589,1111,116400,25251,9942,19712,6703,6340,4955,1403,311,11264,10605,659,10605,5493,5112,2022-01-01,zipcode,San antonio
ZCTA5 78243,48,299,-666666666,-666666666,-666666666,299,0,57,0,0,57,0,0,0,0,0,0,0,0,2022-01-01,zipcode,San antonio
ZCTA5 78244,48,36234,64968,1512,180700,27490,8364,23275,3399,5995,8461,3509,1911,12685,12073,612,12073,8510,3563,2022-01-01,zipcode,San antonio
ZCTA5 78245,48,92770,83005,1480,218100,69219,20308,57093,5226,16450,21343,9513,4561,31715,29831,1884,29831,21554,8277,2022-01-01,zipcode,San antonio
ZCTA5 78247,48,49888,84283,1418,235000,39726,12118,33794,2185,6709,12370,8633,3897,19223,18576,647,18576,14000,4576,2022-01-01,zipcode,San antonio
ZCTA5 78248,48,13366,125089,1304,424900,10963,3614,9681,173,897,2546,3309,2756,5779,5503,276,5503,3836,1667,2022-01-01,zipcode,San antonio
ZCTA5 78249,48,60769,78836,1379,262800,51216,13678,34971,1646,4909,10664,10705,7047,23950,22566,1384,22566,11375,11191,2022-01-01,zipcode,San antonio
ZCTA5 78250,48,59434,80403,1421,200300,45904,13461,39057,2742,9098,14489,8381,4347,20410,19612,798,19612,14372,5240,2022-01-01,zipcode,San antonio
ZCTA5 78251,48,62064,74572,1259,227200,47757,12169,38266,3312,8659,14489,7524,4282,22745,21758,987,21758,11271,10487,2022-01-01,zipcode,San antonio
ZCTA5 78252,48,15624,80270,1529,216400,11817,4496,10209,1913,2910,3553,1360,473,4864,4546,318,4546,4079,467,2022-01-01,zipcode,San antonio
ZCTA5 78253,48,63735,104951,1435,307500,45604,13615,38089,2226,7389,12442,9573,6459,22100,20536,1564,20536,16061,4475,2022-01-01,zipcode,San antonio
ZCTA5 78254,48,76945,108322,1674,271700,55024,13734,47566,2546,8067,16697,13996,6260,24230,23499,731,23499,19324,4175,2022-01-01,zipcode,San antonio
ZCTA5 78255,48,18149,149188,1601,451800,14182,5040,12099,604,1165,3039,4081,3210,6753,6347,406,6347,5346,1001,2022-01-01,zipcode,San antonio
ZCTA5 78256,48,12195,70177,1488,513200,10141,2717,7112,229,378,2034,2318,2153,6181,5258,923,5258,1515,3743,2022-01-01,zipcode,San antonio
ZCTA5 78257,48,9783,74437,1607,484800,8238,2071,7045,178,965,2076,2238,1588,6203,5301,902,5301,2054,3247,2022-01-01,zipcode,San antonio
ZCTA5 78258,48,48344,110635,1607,415700,37302,11595,32505,999,2986,8935,11387,8198,19700,18598,1102,18598,11020,7578,2022-01-01,zipcode,San antonio
ZCTA5 78259,48,26568,98399,1469,351400,20536,6503,18173,758,2161,6151,5544,3559,10915,10358,557,10358,6779,3579,2022-01-01,zipcode,San antonio
ZCTA5 78260,48,35972,136602,1762,435500,27118,8347,23761,833,2901,6247,8195,5585,12333,11882,451,11882,10517,1365,2022-01-01,zipcode,San antonio
ZCTA5 78261,48,25729,127813,1476,379200,20102,5777,17425,620,2471,5012,5361,3961,9318,8972,346,8972,7170,1802,2022-01-01,zipcode,San antonio
ZCTA5 78263,48,5642,91224,1123,271600,4531,1829,3673,390,1335,988,720,240,1975,1930,45,1930,1595,335,2022-01-01,zipcode,San antonio
ZCTA5 78264,48,12545,48870,1133,130900,9771,4441,8155,2058,2828,2394,602,273,4490,3931,559,3931,3214,717,2022-01-01,zipcode,San antonio
ZCTA5 78266,48,6913,132024,2226,474100,5714,2311,4937,172,797,1111,1559,1298,2741,2594,147,2594,2418,176,2022-01-01,zipcode,San antonio
ZCTA5 78330,48,489,53077,-666666666,85000,388,189,360,68,173,64,31,24,225,178,47,178,150,28,2022-01-01,zipcode,Agua dulce
ZCTA5 78332,48,27003,44499,876,91000,20121,9239,16638,3607,6187,4733,1629,482,10577,8677,1900,8677,5550,3127,2022-01-01,zipcode,Alice
ZCTA5 78336,48,11774,57699,1151,167200,9299,4540,8192,1334,3498,2206,855,299,6637,4599,2038,4599,3075,1524,2022-01-01,zipcode,Aransas pass
ZCTA5 78338,48,0,-666666666,-666666666,-666666666,0,0,0,0,0,0,0,0,0,0,0,0,0,0,2022-01-01,zipcode,Armstrong
ZCTA5 78339,48,316,-666666666,-666666666,69400,261,104,261,139,0,61,25,36,180,129,51,129,129,0,2022-01-01,zipcode,Banquete
ZCTA5 78340,48,396,52857,1688,156700,366,165,344,75,123,94,32,20,306,206,100,206,181,25,2022-01-01,zipcode,Bayside
ZCTA5 78341,48,1508,55469,850,84600,1079,600,828,149,335,278,37,29,777,419,358,419,239,180,2022-01-01,zipcode,Benavides
ZCTA5 78342,48,363,50125,-666666666,21600,292,115,199,108,66,0,25,0,110,110,0,110,56,54,2022-01-01,zipcode,Ben bolt
ZCTA5 78343,48,4554,56150,852,96800,3718,1827,3347,847,1006,842,480,172,2092,1687,405,1687,1494,193,2022-01-01,zipcode,Bishop
ZCTA5 78344,48,488,80583,-666666666,87500,401,153,337,0,201,127,9,0,216,175,41,175,159,16,2022-01-01,zipcode,Bruni
ZCTA5 78349,48,568,33750,-666666666,138600,306,264,296,213,29,41,13,0,269,109,160,109,106,3,2022-01-01,zipcode,Concepcion
ZCTA5 78351,48,652,35697,1082,86300,420,168,286,54,167,33,20,12,213,172,41,172,41,131,2022-01-01,zipcode,Driscoll
ZCTA5 78352,48,235,-666666666,-666666666,-666666666,126,64,126,38,88,0,0,0,78,38,40,38,38,0,2022-01-01,zipcode,Edroy
ZCTA5 78353,48,381,36477,-666666666,80900,347,167,347,129,100,13,93,12,315,194,121,194,104,90,2022-01-01,zipcode,Encino
ZCTA5 78355,48,7080,30874,395,81200,5709,2639,4818,1396,1495,1044,633,250,3500,2585,915,2585,1631,954,2022-01-01,zipcode,Falfurrias
ZCTA5 78357,48,2817,61875,938,79600,2260,1005,1813,366,770,408,116,153,1187,884,303,884,625,259,2022-01-01,zipcode,Freer
ZCTA5 78358,48,832,45859,1156,250800,827,627,782,187,229,183,81,102,623,469,154,469,434,35,2022-01-01,zipcode,Fulton
ZCTA5 78359,48,2122,34691,815,98600,1578,713,1279,428,434,332,68,17,746,654,92,654,379,275,2022-01-01,zipcode,Gregory
ZCTA5 78361,48,4830,42292,754,115100,3434,1245,2439,522,1041,565,209,102,2076,1342,734,1342,855,487,2022-01-01,zipcode,Hebbronville
ZCTA5 78362,48,10737,75384,1271,172800,8240,2902,6964,1018,2288,2401,879,378,4483,3839,644,3839,2651,1188,2022-01-01,zipcode,Ingleside
ZCTA5 78363,48,29246,51908,972,133000,22872,9263,16114,2896,5514,4044,2395,1265,13015,11232,1783,11232,5870,5362,2022-01-01,zipcode,Kingsville
ZCTA5 78368,48,8989,40153,655,88600,7362,4153,6088,1520,1911,1981,453,223,4750,3587,1163,3587,2780,807,2022-01-01,zipcode,Mathis
ZCTA5 78369,48,220,-666666666,-666666666,-666666666,179,67,145,31,36,67,11,0,185,86,99,86,62,24,2022-01-01,zipcode,Mirando city
ZCTA5 78370,48,5350,61350,1120,159600,4141,1774,3575,792,1172,1056,332,223,1899,1698,201,1698,1266,432,2022-01-01,zipcode,Odem
ZCTA5 78371,48,130,39063,-666666666,75000,124,56,88,25,28,35,0,0,140,62,78,62,55,7,2022-01-01,zipcode,Oilton
ZCTA5 78372,48,4999,52083,779,115200,3702,1868,3308,702,1277,925,294,110,2270,1711,559,1711,1316,395,2022-01-01,zipcode,Orange grove
ZCTA5 78373,48,3242,80250,2098,478800,2850,1345,2627,83,730,847,635,332,5263,1555,3708,1555,1137,418,2022-01-01,zipcode,Port aransas
ZCTA5 78374,48,20037,82791,1731,217400,15150,5420,12876,1016,3809,4556,2352,1143,8258,7037,1221,7037,4604,2433,2022-01-01,zipcode,Portland
ZCTA5 78375,48,3238,46529,737,81700,2645,1075,2007,629,804,349,180,45,1592,1199,393,1199,769,430,2022-01-01,zipcode,Premont
ZCTA5 78376,48,258,61346,1119,77200,199,88,192,54,88,39,10,1,235,94,141,94,55,39,2022-01-01,zipcode,Realitos
ZCTA5 78377,48,3296,45884,697,92000,2508,1292,2138,307,1041,648,100,42,1555,1049,506,1049,689,360,2022-01-01,zipcode,Refugio
ZCTA5 78379,48,1597,66019,1186,97100,1322,579,1093,137,457,214,157,128,897,674,223,674,572,102,2022-01-01,zipcode,Riviera
ZCTA5 78380,48,24055,57188,1035,122100,18847,8489,16128,3511,5525,5134,1226,732,9540,8319,1221,8319,6584,1735,2022-01-01,zipcode,Robstown
ZCTA5 78382,48,19425,59131,1187,221500,16478,8193,15372,1564,4292,5295,2797,1424,12802,9365,3437,9365,7476,1889,2022-01-01,zipcode,Rockport
ZCTA5 78383,48,4374,68996,1018,210600,3447,1691,3363,302,1023,779,940,319,2396,1609,787,1609,1335,274,2022-01-01,zipcode,Sandia
ZCTA5 78384,48,5510,44324,-666666666,61100,4153,1942,3543,948,1058,1308,197,32,2329,1589,740,1589,1222,367,2022-01-01,zipcode,San diego
ZCTA5 78385,48,116,45455,-666666666,-666666666,88,42,87,58,19,3,5,2,81,38,43,38,6,32,2022-01-01,zipcode,Sarita
ZCTA5 78387,48,9148,47951,572,103900,6881,3378,5787,1268,2083,1768,305,363,3690,2975,715,2975,1979,996,2022-01-01,zipcode,Sinton
ZCTA5 78389,48,2097,41295,962,55700,1594,704,1384,190,207,689,69,229,952,701,251,701,593,108,2022-01-01,zipcode,Skidmore
ZCTA5 78390,48,5737,62500,1168,109500,4236,2055,3645,972,1399,902,287,85,2220,1776,444,1776,1214,562,2022-01-01,zipcode,Taft
ZCTA5 78391,48,150,67857,-666666666,-666666666,100,15,90,39,34,17,0,0,50,50,0,50,23,27,2022-01-01,zipcode,Tynan
ZCTA5 78393,48,1966,57440,719,92600,1670,793,1443,287,558,391,168,39,884,611,273,611,512,99,2022-01-01,zipcode,Woodsboro
ZCTA5 78401,48,4583,29968,962,76000,4386,3126,3854,896,1497,933,368,160,2128,1551,577,1551,264,1287,2022-01-01,zipcode,Corpus christi
ZCTA5 78402,48,308,52560,-666666666,194600,238,134,219,0,48,58,95,18,560,147,413,147,107,40,2022-01-01,zipcode,Corpus christi
ZCTA5 78404,48,14873,56488,1110,157700,12303,4941,10900,2198,2768,3462,1418,1054,7244,5911,1333,5911,3006,2905,2022-01-01,zipcode,Corpus christi
ZCTA5 78405,48,14901,34063,963,70500,11716,5452,9597,3596,3776,1919,247,59,6287,5432,855,5432,2814,2618,2022-01-01,zipcode,Corpus christi
ZCTA5 78406,48,2240,49653,1585,-666666666,1819,1250,1417,488,544,343,29,13,380,380,0,380,115,265,2022-01-01,zipcode,Corpus christi
ZCTA5 78407,48,1796,50933,1021,131400,1379,462,1111,281,606,134,81,9,840,562,278,562,357,205,2022-01-01,zipcode,Corpus christi
ZCTA5 78408,48,10104,40910,844,85200,7637,3779,6442,2225,2108,1538,407,164,4696,3916,780,3916,2019,1897,2022-01-01,zipcode,Corpus christi
ZCTA5 78409,48,2424,62926,930,120300,1875,694,1616,415,409,587,128,77,997,858,139,858,473,385,2022-01-01,zipcode,Corpus christi
ZCTA5 78410,48,28167,82467,1162,207800,20678,7056,17275,1990,5099,6545,2793,848,10573,9649,924,9649,6562,3087,2022-01-01,zipcode,Corpus christi
ZCTA5 78411,48,23492,58667,1145,163900,19814,7652,16272,2176,4784,5369,2060,1883,10365,8874,1491,8874,5337,3537,2022-01-01,zipcode,Corpus christi
ZCTA5 78412,48,40398,57503,1205,167600,33238,11863,24304,2233,6861,7995,4708,2507,16768,15443,1325,15443,7226,8217,2022-01-01,zipcode,Corpus christi
ZCTA5 78413,48,35750,72849,1245,216600,28498,9048,23464,1622,6189,8652,4451,2550,15439,14185,1254,14185,7673,6512,2022-01-01,zipcode,Corpus christi
ZCTA5 78414,48,48891,95423,1420,249300,37320,11515,31143,1511,5978,12141,6996,4517,19346,17760,1586,17760,11580,6180,2022-01-01,zipcode,Corpus christi
ZCTA5 78415,48,42831,51970,1149,124200,31781,11829,26973,5848,9977,8366,1954,828,15742,14544,1198,14544,8280,6264,2022-01-01,zipcode,Corpus christi
ZCTA5 78416,48,13865,44320,985,90400,11014,4997,9541,2808,3492,2481,536,224,5408,5005,403,5005,3060,1945,2022-01-01,zipcode,Corpus christi
ZCTA5 78417,48,4542,56325,1194,134000,3630,1145,3067,915,1123,737,180,112,1628,1495,133,1495,936,559,2022-01-01,zipcode,Corpus christi
ZCTA5 78418,48,29626,89769,1207,258700,23740,8422,21122,2058,4627,7676,4336,2425,15568,12073,3495,12073,7841,4232,2022-01-01,zipcode,Corpus christi
ZCTA5 78419,48,553,77750,1796,-666666666,296,87,271,0,105,116,29,21,186,172,14,172,0,172,2022-01-01,zipcode,Corpus christi
ZCTA5 78501,48,59954,47809,892,142400,46693,18748,39024,9534,8988,9827,7343,3332,24711,21415,3296,21415,11073,10342,2022-01-01,zipcode,Mcallen
ZCTA5 78503,48,21799,44879,1055,124600,16026,6224,12968,4316,2271,2983,2157,1241,7746,6441,1305,6441,3791,2650,2022-01-01,zipcode,Mcallen
ZCTA5 78504,48,60999,71648,1095,181500,45326,15887,36348,5062,7008,10331,8729,5218,20809,19158,1651,19158,13018,6140,2022-01-01,zipcode,Mcallen
ZCTA5 78516,48,34469,50282,720,82800,24924,10473,19504,8005,5001,4095,1890,513,12367,10175,2192,10175,7682,2493,2022-01-01,zipcode,Alamo
ZCTA5 78520,48,62344,45093,800,114900,47671,20753,36966,12082,9521,7822,5437,2104,21787,19253,2534,19253,11328,7925,2022-01-01,zipcode,Brownsville
ZCTA5 78521,48,87040,38633,831,84300,65262,28777,50523,20125,12711,10454,5396,1837,28981,26617,2364,26617,15585,11032,2022-01-01,zipcode,Brownsville
ZCTA5 78526,48,59547,66339,1025,145300,42545,15239,33881,7470,6998,9791,6865,2757,17735,16690,1045,16690,11643,5047,2022-01-01,zipcode,Brownsville
ZCTA5 78535,48,633,37838,542,65400,543,257,437,181,129,91,23,13,258,226,32,226,130,96,2022-01-01,zipcode,Combes
ZCTA5 78536,48,404,41136,-666666666,123400,345,160,284,68,122,67,20,7,182,136,46,136,116,20,2022-01-01,zipcode,Delmita
ZCTA5 78537,48,51034,35214,711,69600,34441,15481,26277,11895,6739,4949,1972,722,16387,13828,2559,13828,10149,3679,2022-01-01,zipcode,Donna
ZCTA5 78538,48,10091,41081,495,81000,7492,3149,5620,2122,1838,998,475,187,3466,2973,493,2973,2236,737,2022-01-01,zipcode,Edcouch
ZCTA5 78539,48,37182,60202,970,183200,29381,10804,23429,3590,4330,6738,5265,3506,15157,13999,1158,13999,7733,6266,2022-01-01,zipcode,Edinburg
ZCTA5 78541,48,48558,45738,875,125000,34324,12448,26190,6821,6088,7180,4492,1609,16760,15113,1647,15113,7930,7183,2022-01-01,zipcode,Edinburg
ZCTA5 78542,48,83925,51979,837,102400,57865,24861,44460,15793,13107,9566,4592,1402,24229,21779,2450,21779,16283,5496,2022-01-01,zipcode,Edinburg
ZCTA5 78543,48,8614,46624,707,73300,6639,3184,5066,1097,2099,1485,209,176,3017,2815,202,2815,2138,677,2022-01-01,zipcode,Elsa
ZCTA5 78545,48,444,21875,-666666666,41200,361,232,270,158,56,34,0,22,337,202,135,202,197,5,2022-01-01,zipcode,Falcon heights
ZCTA5 78548,48,1384,39306,783,43100,965,393,783,280,272,215,16,0,601,467,134,467,374,93,2022-01-01,zipcode,Grulla
ZCTA5 78549,48,838,-666666666,-666666666,48800,549,395,460,257,110,64,0,29,343,251,92,251,225,26,2022-01-01,zipcode,Hargill
ZCTA5 78550,48,54441,46341,841,104700,40884,17557,33792,8045,9119,9812,4719,2097,21961,19305,2656,19305,9834,9471,2022-01-01,zipcode,Harlingen
ZCTA5 78552,48,40824,62235,978,134500,29797,11826,25576,4653,7156,8311,3480,1976,16076,13672,2404,13672,10530,3142,2022-01-01,zipcode,Harlingen
ZCTA5 78557,48,14075,45919,832,136100,10137,3533,7912,2512,1831,1897,1488,184,4020,3705,315,3705,2800,905,2022-01-01,zipcode,Hidalgo
ZCTA5 78558,48,533,-666666666,-666666666,55700,417,169,360,173,76,45,66,0,155,125,30,125,125,0,2022-01-01,zipcode,La blanca
ZCTA5 78559,48,12973,42861,886,94300,9021,4060,7418,2021,2204,2078,711,404,4933,4037,896,4037,2952,1085,2022-01-01,zipcode,La feria
ZCTA5 78560,48,4500,51637,638,108100,3456,1455,2972,854,926,483,411,298,1730,1352,378,1352,863,489,2022-01-01,zipcode,La joya
ZCTA5 78561,48,900,26339,-666666666,77100,740,342,531,251,105,116,14,45,238,208,30,208,156,52,2022-01-01,zipcode,Lasara
ZCTA5 78562,48,3157,58846,335,119500,2598,1647,2068,915,495,464,176,18,736,624,112,624,467,157,2022-01-01,zipcode,La villa
ZCTA5 78563,48,62,65476,-666666666,-666666666,62,53,62,13,42,3,4,0,83,34,49,34,32,2,2022-01-01,zipcode,Linn
ZCTA5 78564,48,48,-666666666,-666666666,-666666666,31,13,31,0,18,13,0,0,83,13,70,13,0,13,2022-01-01,zipcode,Lopeno
ZCTA5 78565,48,57,-666666666,-666666666,-666666666,57,50,57,57,0,0,0,0,103,51,52,51,44,7,2022-01-01,zipcode,Los ebanos
ZCTA5 78566,48,24232,55121,846,124000,17299,7377,13510,3840,3484,3573,1857,756,8108,7035,1073,7035,5264,1771,2022-01-01,zipcode,Los fresnos
ZCTA5 78567,48,484,36250,-666666666,44200,327,143,249,124,66,44,11,4,160,135,25,135,109,26,2022-01-01,zipcode,Los indios
ZCTA5 78569,48,4133,53150,663,102700,3444,1578,2988,883,1159,496,364,86,1494,1273,221,1273,1041,232,2022-01-01,zipcode,Lyford
ZCTA5 78570,48,35043,38396,626,83500,24834,11004,18842,7344,4751,4417,1409,921,10998,9267,1731,9267,6971,2296,2022-01-01,zipcode,Mercedes
ZCTA5 78572,48,76753,50562,853,113600,58346,27751,47837,12756,11773,11543,8000,3765,31755,25476,6279,25476,18868,6608,2022-01-01,zipcode,Mission
ZCTA5 78573,48,43555,47038,835,130800,30904,11774,23943,9077,6026,5648,2405,787,12964,11790,1174,11790,8304,3486,2022-01-01,zipcode,Mission
ZCTA5 78574,48,63165,45379,814,107800,43883,18197,34231,14711,7569,6697,4005,1249,18077,16492,1585,16492,12798,3694,2022-01-01,zipcode,Mission
ZCTA5 78575,48,4649,69971,1049,178100,3669,1502,2901,576,455,563,858,449,1862,1637,225,1637,1070,567,2022-01-01,zipcode,Olmito
ZCTA5 78576,48,13466,39956,703,98900,8202,4033,5659,2608,2073,685,205,88,3411,3068,343,3068,2462,606,2022-01-01,zipcode,Penitas
ZCTA5 78577,48,79496,44871,925,98300,56143,22771,44520,13544,12584,10651,5656,2085,26783,23309,3474,23309,13668,9641,2022-01-01,zipcode,Pharr
ZCTA5 78578,48,10540,49396,636,184100,8307,4565,7460,1448,2515,1886,960,651,6376,4119,2257,4119,2880,1239,2022-01-01,zipcode,Port isabel
ZCTA5 78579,48,3063,27941,-666666666,-666666666,2043,737,1667,745,420,261,88,153,880,732,148,732,631,101,2022-01-01,zipcode,Progreso
ZCTA5 78580,48,13344,44362,740,63800,10122,4378,8154,2620,3134,1684,507,209,4069,3319,750,3319,2122,1197,2022-01-01,zipcode,Raymondville
ZCTA5 78582,48,44988,40221,696,97700,31874,12761,24466,9331,6730,5385,2174,846,14806,12422,2384,12422,9253,3169,2022-01-01,zipcode,Rio grande city
ZCTA5 78583,48,6384,59217,761,124300,4942,2381,4223,1038,1538,986,540,121,2951,2095,856,2095,1735,360,2022-01-01,zipcode,Rio hondo
ZCTA5 78584,48,17721,29398,607,72300,12652,5689,10204,4284,2442,2038,1063,377,6400,5098,1302,5098,3336,1762,2022-01-01,zipcode,Roma
ZCTA5 78585,48,0,-666666666,-666666666,-666666666,0,0,0,0,0,0,0,0,0,0,0,0,0,0,2022-01-01,zipcode,Salineno
ZCTA5 78586,48,49504,42515,812,75800,35998,16497,27756,9686,7773,6826,2229,1242,16335,14690,1645,14690,11270,3420,2022-01-01,zipcode,San benito
ZCTA5 78588,48,124,-666666666,-666666666,22700,94,75,94,16,18,43,4,13,98,44,54,44,31,13,2022-01-01,zipcode,San isidro
ZCTA5 78589,48,40115,50099,880,104500,28348,11257,22388,8622,5957,4755,2310,744,12424,11276,1148,11276,8785,2491,2022-01-01,zipcode,San juan
ZCTA5 78590,48,711,32857,-666666666,47800,561,294,382,175,102,65,37,3,184,134,50,134,100,34,2022-01-01,zipcode,San perlita
ZCTA5 78591,48,270,-666666666,-666666666,256800,218,64,214,6,67,79,23,39,246,122,124,122,118,4,2022-01-01,zipcode,Santa elena
ZCTA5 78592,48,587,30156,-666666666,34800,517,321,410,255,98,50,7,0,188,166,22,166,147,19,2022-01-01,zipcode,Santa maria
ZCTA5 78593,48,5015,34773,772,63700,3681,1705,2832,994,1019,645,108,66,1701,1522,179,1522,1062,460,2022-01-01,zipcode,Santa rosa
ZCTA5 78594,48,1398,23258,382,54100,1221,641,1051,452,333,212,54,0,593,523,70,523,378,145,2022-01-01,zipcode,Sebastian
ZCTA5 78595,48,6128,46125,566,76500,4179,1490,3513,1399,863,1044,140,67,2025,1853,172,1853,1536,317,2022-01-01,zipcode,Sullivan city
ZCTA5 78596,48,36545,53097,883,88200,26931,11484,22232,5895,5297,6260,3420,1360,15456,11497,3959,11497,7521,3976,2022-01-01,zipcode,Weslaco
ZCTA5 78597,48,2386,62557,1361,389400,2158,742,1924,161,93,636,605,429,6054,1233,4821,1233,878,355,2022-01-01,zipcode,South padre island
ZCTA5 78598,48,108,23523,-666666666,208700,99,72,99,17,27,11,26,18,387,67,320,67,56,11,2022-01-01,zipcode,Port mansfield
ZCTA5 78602,48,34978,82500,1198,248700,28243,10987,23576,3162,7974,6450,4242,1748,13406,12244,1162,12244,9144,3100,2022-01-01,zipcode,Bastrop
ZCTA5 78605,48,7463,79092,1081,189800,6091,2250,5094,970,1594,1768,526,236,2829,2643,186,2643,2397,246,2022-01-01,zipcode,Bertram
ZCTA5 78606,48,6942,89688,777,326200,5610,2273,5092,558,1281,1612,1248,393,3317,2650,667,2650,2090,560,2022-01-01,zipcode,Blanco
ZCTA5 78607,48,208,54531,-666666666,356300,197,142,166,0,83,57,26,0,279,71,208,71,54,17,2022-01-01,zipcode,Bluffton
ZCTA5 78608,48,298,90500,-666666666,265000,276,140,250,15,84,117,18,16,240,124,116,124,105,19,2022-01-01,zipcode,Briggs
ZCTA5 78609,48,1880,67578,989,260600,1611,902,1525,40,505,565,164,251,1294,819,475,819,676,143,2022-01-01,zipcode,Buchanan dam
ZCTA5 78610,48,44410,103562,1540,346700,34048,9948,29546,2475,7494,7824,8328,3425,16505,16017,488,16017,12606,3411,2022-01-01,zipcode,Buda
ZCTA5 78611,48,13815,74098,1100,258700,11517,5203,10365,900,3468,3234,1932,831,7245,5318,1927,5318,4299,1019,2022-01-01,zipcode,Burnet
ZCTA5 78612,48,19354,81275,1386,217400,13173,5565,11095,2615,2862,3042,1647,929,5707,5381,326,5381,4642,739,2022-01-01,zipcode,Cedar creek
ZCTA5 78613,48,88189,116893,1646,416000,69081,19477,60219,1935,9448,16930,21534,10372,34357,33717,640,33717,21834,11883,2022-01-01,zipcode,Cedar park
ZCTA5 78614,48,302,58553,-666666666,403100,277,103,257,22,42,79,83,31,261,160,101,160,148,12,2022-01-01,zipcode,Cost
ZCTA5 78615,48,1781,73462,1065,265700,1155,375,977,126,356,263,119,113,561,528,33,528,397,131,2022-01-01,zipcode,Coupland
ZCTA5 78616,48,8821,68191,1127,171500,6574,2546,5392,1637,1729,1245,559,222,2910,2590,320,2590,2130,460,2022-01-01,zipcode,Dale
ZCTA5 78617,48,29244,74773,1366,222100,23064,7615,18588,5690,6395,3888,2006,609,8583,8116,467,8116,6528,1588,2022-01-01,zipcode,Del valle
ZCTA5 78618,48,310,84688,863,335600,267,173,264,3,101,51,45,64,351,139,212,139,120,19,2022-01-01,zipcode,Doss
ZCTA5 78619,48,6067,171398,1257,655500,4758,1324,4304,54,597,1305,1521,827,2195,2104,91,2104,1914,190,2022-01-01,zipcode,Driftwood
ZCTA5 78620,48,19893,138639,1486,585300,15380,4913,13246,370,1922,2772,5516,2666,7466,7000,466,7000,6020,980,2022-01-01,zipcode,Dripping springs
ZCTA5 78621,48,26133,92103,1163,247900,19898,6434,17450,3240,5459,4880,2485,1386,9555,8747,808,8747,6968,1779,2022-01-01,zipcode,Elgin
ZCTA5 78622,48,353,64583,1344,117500,266,119,246,12,97,54,65,18,156,136,20,136,107,29,2022-01-01,zipcode,Fentress
ZCTA5 78623,48,1094,100000,-666666666,435400,967,471,938,16,217,289,229,187,590,508,82,508,508,0,2022-01-01,zipcode,Fischer
ZCTA5 78624,48,23538,71082,1297,404600,19472,8209,17250,1785,4268,4956,3984,2257,12161,9698,2463,9698,6720,2978,2022-01-01,zipcode,Fredericksburg
ZCTA5 78626,48,40758,94927,1677,324300,32010,9695,25720,2572,6156,7660,5573,3759,14799,13927,872,13927,9070,4857,2022-01-01,zipcode,Georgetown
ZCTA5 78628,48,41428,111491,1417,419900,32565,11241,28802,1255,4361,8061,9473,5652,16028,15543,485,15543,12012,3531,2022-01-01,zipcode,Georgetown
ZCTA5 78629,48,12054,64807,922,185700,8982,3720,7655,1653,3403,1528,762,309,5215,4419,796,4419,2723,1696,2022-01-01,zipcode,Gonzales
ZCTA5 78631,48,2818,66875,1158,310200,2195,896,1990,170,674,674,209,263,1465,1021,444,1021,832,189,2022-01-01,zipcode,Harper
ZCTA5 78632,48,1188,63173,-666666666,162600,1022,550,898,76,305,426,25,66,641,531,110,531,463,68,2022-01-01,zipcode,Harwood
ZCTA5 78633,48,27292,95510,1765,400400,25105,16785,24003,536,3151,6784,8058,5474,14057,13531,526,13531,12393,1138,2022-01-01,zipcode,Georgetown
ZCTA5 78634,48,41099,105023,1821,289800,32000,8398,27165,1618,7542,8798,6883,2324,14487,14077,410,14077,11432,2645,2022-01-01,zipcode,Hutto
ZCTA5 78635,48,73,-666666666,-666666666,-666666666,73,66,73,0,34,32,2,5,100,34,66,34,34,0,2022-01-01,zipcode,Hye
ZCTA5 78636,48,3582,65313,1033,349500,3145,1378,2763,254,786,839,730,154,2138,1669,469,1669,1180,489,2022-01-01,zipcode,Johnson city
ZCTA5 78638,48,1982,60000,1106,197200,1612,715,1407,107,557,440,209,94,922,770,152,770,661,109,2022-01-01,zipcode,Kingsbury
ZCTA5 78639,48,8274,55870,907,236300,7005,3664,6383,824,1890,1989,1139,541,5055,3495,1560,3495,2726,769,2022-01-01,zipcode,Kingsland
ZCTA5 78640,48,68265,83735,1498,259900,51394,15024,41864,5932,11999,12473,7689,3771,23639,22797,842,22797,16113,6684,2022-01-01,zipcode,Kyle
ZCTA5 78641,48,87106,124614,1788,395700,64989,16785,56370,3141,9378,17241,17429,9181,30799,29559,1240,29559,23731,5828,2022-01-01,zipcode,Leander
ZCTA5 78642,48,20699,117490,1415,454600,15753,4500,13298,1168,2819,3768,4015,1528,7119,6877,242,6877,5880,997,2022-01-01,zipcode,Liberty hill
ZCTA5 78643,48,6811,64451,968,273600,5751,2584,5127,444,1444,1666,1220,353,4278,3008,1270,3008,2206,802,2022-01-01,zipcode,Llano
ZCTA5 78644,48,20088,70496,1133,214500,16094,7266,13766,1998,5755,3436,1874,703,7262,6565,697,6565,4570,1995,2022-01-01,zipcode,Lockhart
ZCTA5 78645,48,14344,107736,1140,367500,12556,5654,11788,740,2611,3965,2932,1540,7205,6187,1018,6187,5463,724,2022-01-01,zipcode,Leander
ZCTA5 78648,48,8250,55406,1023,183500,7160,3026,6313,1348,2317,1828,493,327,3745,3414,331,3414,2442,972,2022-01-01,zipcode,Luling
ZCTA5 78650,48,2807,62125,-666666666,223200,2014,832,1819,180,773,591,144,131,1059,859,200,859,788,71,2022-01-01,zipcode,Mc dade
ZCTA5 78652,48,5199,126333,2248,435300,4119,1250,3791,227,851,1193,991,529,1805,1796,9,1796,1579,217,2022-01-01,zipcode,Manchaca
ZCTA5 78653,48,32884,95651,1685,288500,23368,6447,20268,3765,4784,5903,3882,1934,10627,10029,598,10029,8789,1240,2022-01-01,zipcode,Manor
ZCTA5 78654,48,19379,65503,1278,294800,15627,6391,13429,1641,3266,3851,3156,1515,9476,7344,2132,7344,5187,2157,2022-01-01,zipcode,Marble falls
ZCTA5 78655,48,3671,53750,1064,194400,2997,901,2701,665,615,870,402,149,1492,1401,91,1401,917,484,2022-01-01,zipcode,Martindale
ZCTA5 78656,48,2631,56923,1108,-666666666,2002,616,1709,551,407,621,108,22,897,882,15,882,535,347,2022-01-01,zipcode,Maxwell
ZCTA5 78657,48,6958,81518,1510,409300,6075,3075,5578,315,1161,1747,1779,576,5322,3090,2232,3090,2670,420,2022-01-01,zipcode,Horseshoe bay
ZCTA5 78659,48,2782,82635,-666666666,247600,2171,749,2063,63,578,772,554,96,1350,1107,243,1107,1022,85,2022-01-01,zipcode,Paige
ZCTA5 78660,48,113386,105874,1631,335500,86537,20673,74118,6424,15570,21768,20749,9607,41319,39826,1493,39826,27929,11897,2022-01-01,zipcode,Pflugerville
ZCTA5 78661,48,437,-666666666,-666666666,161500,346,172,262,24,160,41,34,3,156,147,9,147,141,6,2022-01-01,zipcode,Prairie lea
ZCTA5 78662,48,3035,67756,1058,228900,2570,942,2257,173,528,1364,122,70,1373,1289,84,1289,900,389,2022-01-01,zipcode,Red rock
ZCTA5 78663,48,599,150593,-666666666,178800,590,185,571,19,129,305,106,12,347,316,31,316,283,33,2022-01-01,zipcode,Round mountain
ZCTA5 78664,48,62168,83599,1500,281800,49884,12040,40995,4071,9393,14240,9105,4186,23890,23021,869,23021,12576,10445,2022-01-01,zipcode,Round rock
ZCTA5 78665,48,61640,113365,1812,381300,46284,12129,39537,1325,6191,11898,12566,7557,23509,22105,1404,22105,14523,7582,2022-01-01,zipcode,Round rock
ZCTA5 78666,48,86530,52432,1245,248700,75627,26129,46835,5464,11719,14058,9488,6106,35923,33173,2750,33173,12400,20773,2022-01-01,zipcode,San marcos
ZCTA5 78669,48,10802,125600,1265,548300,8819,3412,8183,346,1346,2094,3056,1341,5583,4256,1327,4256,3841,415,2022-01-01,zipcode,Spicewood
ZCTA5 78670,48,156,82589,1643,262500,105,46,98,10,26,29,24,9,66,61,5,61,37,24,2022-01-01,zipcode,Staples
ZCTA5 78671,48,755,32093,-666666666,176400,722,294,598,227,117,153,56,45,404,340,64,340,208,132,2022-01-01,zipcode,Stonewall
ZCTA5 78672,48,687,46033,-666666666,197300,617,439,605,124,152,272,57,0,743,349,394,349,320,29,2022-01-01,zipcode,Tow
ZCTA5 78675,48,96,33068,-666666666,411400,82,41,77,11,37,15,14,0,72,45,27,45,45,0,2022-01-01,zipcode,Willow city
ZCTA5 78676,48,15321,86122,1175,434100,13117,5807,11420,892,1428,3499,3605,1996,7304,6345,959,6345,5051,1294,2022-01-01,zipcode,Wimberley
ZCTA5 78677,48,12,-666666666,-666666666,-666666666,12,12,12,0,12,0,0,0,0,0,0,0,0,0,2022-01-01,zipcode,Wrightsboro
ZCTA5 78681,48,57760,123948,1781,418900,43986,12899,37398,1736,4319,10680,13318,7345,20717,20005,712,20005,14842,5163,2022-01-01,zipcode,Round rock
ZCTA5 78701,48,10659,148049,2574,609800,10499,2054,9714,303,513,1102,4624,3172,7328,6667,661,6667,3294,3373,2022-01-01,zipcode,Austin
ZCTA5 78702,48,25723,87342,1749,569700,22151,5562,20500,1940,2650,4242,7082,4586,13425,12349,1076,12349,5200,7149,2022-01-01,zipcode,Austin
ZCTA5 78703,48,22669,139617,2131,1194200,19639,4826,18061,223,801,1654,8806,6577,12336,11272,1064,11272,5651,5621,2022-01-01,zipcode,Austin
ZCTA5 78704,48,50250,89258,1673,721200,45298,8716,38071,2038,3575,6132,16661,9665,29541,27465,2076,27465,8730,18735,2022-01-01,zipcode,Austin
ZCTA5 78705,48,32644,24126,1479,493900,32318,16234,6991,212,540,1182,2913,2144,11744,10053,1691,10053,1196,8857,2022-01-01,zipcode,Austin
ZCTA5 78712,48,210,-666666666,-666666666,-666666666,210,180,10,0,0,0,0,10,0,0,0,0,0,0,2022-01-01,zipcode,Austin
ZCTA5 78717,48,34499,136960,1678,532400,25762,6260,22830,1062,1778,4671,8512,6807,13425,13022,403,13022,7325,5697,2022-01-01,zipcode,Austin
ZCTA5 78719,48,1511,53712,-666666666,130000,1348,514,1088,398,335,239,54,62,585,528,57,528,497,31,2022-01-01,zipcode,Austin
ZCTA5 78721,48,10445,80573,1637,436900,8688,2134,7772,1162,1446,1298,2532,1334,4544,4237,307,4237,2128,2109,2022-01-01,zipcode,Austin
ZCTA5 78722,48,6308,92543,1668,622900,5548,1100,5071,156,475,778,2169,1493,3268,3136,132,3136,1520,1616,2022-01-01,zipcode,Austin
ZCTA5 78723,48,37000,81986,1389,456100,29531,7709,26834,3221,4346,5631,8086,5550,16411,15420,991,15420,7500,7920,2022-01-01,zipcode,Austin
ZCTA5 78724,48,28331,69925,1396,224200,20728,6053,17046,5008,4332,3908,2449,1349,8764,8446,318,8446,5601,2845,2022-01-01,zipcode,Austin
ZCTA5 78725,48,9896,94603,2176,266000,8225,1846,7702,1067,1359,2368,1875,1033,3912,3807,105,3807,3243,564,2022-01-01,zipcode,Austin
ZCTA5 78726,48,13696,96352,1536,592500,11288,2942,9972,97,886,2270,4046,2673,6476,6123,353,6123,2707,3416,2022-01-01,zipcode,Austin
ZCTA5 78727,48,30601,104347,1754,417300,25332,6285,23413,1148,2431,5030,8041,6763,14474,13624,850,13624,6057,7567,2022-01-01,zipcode,Austin
ZCTA5 78728,48,27111,70092,1426,355000,21859,4605,19437,1369,3672,5617,5852,2927,13593,12720,873,12720,3536,9184,2022-01-01,zipcode,Austin
ZCTA5 78729,48,31309,78889,1489,381600,26314,5579,22993,832,2145,5773,9103,5140,15652,14597,1055,14597,6169,8428,2022-01-01,zipcode,Austin
ZCTA5 78730,48,9746,141794,1588,929500,7961,2450,7091,73,556,1211,2760,2491,4434,4149,285,4149,2691,1458,2022-01-01,zipcode,Austin
ZCTA5 78731,48,26314,98555,1484,778000,22377,7107,19950,265,1172,2900,7754,7859,14441,13432,1009,13432,7363,6069,2022-01-01,zipcode,Austin
ZCTA5 78732,48,19311,187286,1638,666800,14717,4472,12021,290,456,2603,4434,4238,7303,7062,241,7062,5042,2020,2022-01-01,zipcode,Austin
ZCTA5 78733,48,9014,193786,3013,859100,6596,2294,5914,19,351,771,2410,2363,3353,3069,284,3069,2737,332,2022-01-01,zipcode,Austin
ZCTA5 78734,48,21685,125074,1933,571100,18031,6871,16493,747,1978,3833,6305,3630,10410,9362,1048,9362,7681,1681,2022-01-01,zipcode,Austin
ZCTA5 78735,48,19793,118593,1829,741000,16185,4317,14524,634,1159,2461,6146,4124,9787,9116,671,9116,4223,4893,2022-01-01,zipcode,Austin
ZCTA5 78736,48,9352,96385,1741,493800,7865,2517,6863,159,1073,1825,2465,1341,4088,3979,109,3979,2804,1175,2022-01-01,zipcode,Austin
ZCTA5 78737,48,24951,151635,2075,628800,16864,5499,15218,361,1461,3716,6003,3677,7993,7729,264,7729,6857,872,2022-01-01,zipcode,Austin
ZCTA5 78738,48,28613,158194,1896,691400,21466,8002,19835,389,1464,2975,9035,5972,11875,11128,747,11128,8543,2585,2022-01-01,zipcode,Austin
ZCTA5 78739,48,19907,205821,2965,644200,14541,4326,13223,187,476,1814,5302,5444,6853,6775,78,6775,6165,610,2022-01-01,zipcode,Austin
ZCTA5 78741,48,45780,59049,1379,325200,39512,7429,30891,5131,5114,6499,10637,3510,24050,22410,1640,22410,4147,18263,2022-01-01,zipcode,Austin
ZCTA5 78742,48,1241,67500,1355,-666666666,866,241,649,190,191,196,64,8,378,378,0,378,259,119,2022-01-01,zipcode,Austin
ZCTA5 78744,48,49452,74702,1460,265900,38510,7985,32418,7546,7346,7712,7253,2561,18843,18012,831,18012,9144,8868,2022-01-01,zipcode,Austin
ZCTA5 78745,48,61322,80437,1603,398200,52744,13202,48277,3785,8571,11857,17212,6852,30494,29030,1464,29030,13936,15094,2022-01-01,zipcode,Austin
ZCTA5 78746,48,28329,174367,1923,1209300,22425,7871,19392,223,812,2267,8546,7544,11715,10904,811,10904,7282,3622,2022-01-01,zipcode,Austin
ZCTA5 78747,48,21253,90704,1643,318700,17141,4342,15134,1785,3645,3887,4005,1812,8109,7959,150,7959,5789,2170,2022-01-01,zipcode,Austin
ZCTA5 78748,48,53550,94143,1642,385300,44033,9958,39731,2005,5761,11268,14910,5787,24660,23542,1118,23542,13097,10445,2022-01-01,zipcode,Austin
ZCTA5 78749,48,34714,118174,1761,474900,28928,8044,26329,961,2115,5300,10225,7728,16308,15459,849,15459,9732,5727,2022-01-01,zipcode,Austin
ZCTA5 78750,48,28564,118186,1729,531700,23063,6080,20881,748,2121,4892,8369,4751,11760,11391,369,11391,7184,4207,2022-01-01,zipcode,Austin
ZCTA5 78751,48,16326,75972,1602,626600,15404,2302,12617,149,902,1951,5531,4084,9753,8982,771,8982,1977,7005,2022-01-01,zipcode,Austin
ZCTA5 78752,48,22599,62931,1353,330500,19404,4447,15823,2511,2897,3987,4193,2235,10671,10322,349,10322,2160,8162,2022-01-01,zipcode,Austin
ZCTA5 78753,48,59951,60045,1331,302200,47397,13025,39847,8322,8424,10028,9433,3640,24727,23524,1203,23524,7902,15622,2022-01-01,zipcode,Austin
ZCTA5 78754,48,31110,88382,1537,288100,23725,5401,20960,2998,4265,5531,4869,3297,12319,11885,434,11885,7279,4606,2022-01-01,zipcode,Austin
ZCTA5 78756,48,9816,97264,1337,720100,8678,2069,7309,143,555,1767,2635,2209,4795,4558,237,4558,2016,2542,2022-01-01,zipcode,Austin
ZCTA5 78757,48,25183,96667,1465,598900,20230,4952,18677,1099,2339,3196,7425,4618,11821,11362,459,11362,6705,4657,2022-01-01,zipcode,Austin
ZCTA5 78758,48,51185,68322,1462,361900,40761,9586,35117,5250,6931,6855,9658,6423,25361,23625,1736,23625,6251,17374,2022-01-01,zipcode,Austin
ZCTA5 78759,48,45400,97688,1569,587700,38710,10139,34266,967,2870,6895,13620,9914,23240,22112,1128,22112,10511,11601,2022-01-01,zipcode,Austin
ZCTA5 78801,48,21248,54375,1047,131300,16199,7679,13139,3317,3491,3914,1788,629,8182,7142,1040,7142,4766,2376,2022-01-01,zipcode,Uvalde
ZCTA5 78802,48,0,-666666666,-666666666,-666666666,0,0,0,0,0,0,0,0,0,0,0,0,0,0,2022-01-01,zipcode,Uvalde
ZCTA5 78827,48,742,28438,556,96800,650,380,586,242,167,146,25,6,455,327,128,327,253,74,2022-01-01,zipcode,Asherton
ZCTA5 78828,48,83,66250,-666666666,-666666666,83,54,83,0,13,44,12,14,149,44,105,44,44,0,2022-01-01,zipcode,Barksdale
ZCTA5 78829,48,1124,35132,1083,42400,757,339,539,161,214,108,56,0,372,284,88,284,212,72,2022-01-01,zipcode,Batesville
ZCTA5 78830,48,479,32188,760,71300,367,218,315,123,77,88,8,19,302,184,118,184,135,49,2022-01-01,zipcode,Big wells
ZCTA5 78832,48,3157,52386,728,112200,2786,1446,2536,390,622,1187,174,163,1473,1105,368,1105,829,276,2022-01-01,zipcode,Brackettville
ZCTA5 78833,48,1261,38250,864,67500,1034,724,880,108,446,279,28,19,512,356,156,356,201,155,2022-01-01,zipcode,Camp wood
ZCTA5 78834,48,7386,26508,680,64000,5490,3465,4367,1046,1607,995,396,323,3143,2274,869,2274,1426,848,2022-01-01,zipcode,Carrizo springs
ZCTA5 78836,48,65,67396,-666666666,-666666666,59,34,59,40,7,12,0,0,42,23,19,23,11,12,2022-01-01,zipcode,Catarina
ZCTA5 78837,48,128,-666666666,-666666666,-666666666,122,82,112,29,12,20,26,25,119,62,57,62,62,0,2022-01-01,zipcode,Comstock
ZCTA5 78838,48,105,-666666666,-666666666,435300,105,87,105,33,26,16,25,5,263,64,199,64,64,0,2022-01-01,zipcode,Concan
ZCTA5 78839,48,7415,57083,816,79700,5699,2542,4664,1201,1327,1467,484,185,3149,2778,371,2778,1990,788,2022-01-01,zipcode,Crystal city
ZCTA5 78840,48,47030,57201,913,138600,35235,13564,28600,7604,7860,7374,3466,2296,18293,16507,1786,16507,10880,5627,2022-01-01,zipcode,Del rio
ZCTA5 78843,48,459,-666666666,-666666666,-666666666,459,0,73,0,0,60,13,0,41,41,0,41,0,41,2022-01-01,zipcode,Laughlin afb
ZCTA5 78850,48,827,75667,879,272200,593,281,462,58,113,164,86,41,378,226,152,226,190,36,2022-01-01,zipcode,D hanis
ZCTA5 78851,48,61,-666666666,-666666666,-666666666,61,42,61,0,0,0,61,0,68,61,7,61,61,0,2022-01-01,zipcode,Dryden
ZCTA5 78852,48,56745,48911,757,123000,41054,16978,32349,11181,8594,7339,3846,1389,19575,17539,2036,17539,11920,5619,2022-01-01,zipcode,Eagle pass
ZCTA5 78860,48,0,-666666666,-666666666,-666666666,0,0,0,0,0,0,0,0,98,0,98,0,0,0,2022-01-01,zipcode,El indio
ZCTA5 78861,48,13131,60216,1106,156200,10932,5652,9186,1391,3408,2807,983,597,5018,4479,539,4479,3372,1107,2022-01-01,zipcode,Hondo
ZCTA5 78870,48,1302,70411,820,163700,1034,348,797,114,227,278,148,30,442,387,55,387,317,70,2022-01-01,zipcode,Knippa
ZCTA5 78871,48,32,-666666666,-666666666,-666666666,18,0,18,0,0,12,6,0,24,12,12,12,12,0,2022-01-01,zipcode,Langtry
ZCTA5 78872,48,1161,38063,-666666666,69900,860,387,619,236,98,209,48,28,458,365,93,365,283,82,2022-01-01,zipcode,La pryor
ZCTA5 78873,48,1278,59091,780,279500,954,623,851,107,244,227,203,70,1055,524,531,524,431,93,2022-01-01,zipcode,Leakey
ZCTA5 78877,48,1061,39785,-666666666,-666666666,838,461,838,559,179,84,0,16,390,362,28,362,279,83,2022-01-01,zipcode,Quemado
ZCTA5 78879,48,291,71250,-666666666,-666666666,258,155,191,0,0,109,75,7,224,94,130,94,80,14,2022-01-01,zipcode,Rio frio
ZCTA5 78880,48,1269,36563,680,87500,999,341,730,215,151,249,95,20,855,486,369,486,390,96,2022-01-01,zipcode,Rocksprings
ZCTA5 78881,48,1415,34259,546,74700,1177,500,966,170,371,226,144,55,806,566,240,566,439,127,2022-01-01,zipcode,Sabinal
ZCTA5 78883,48,267,72539,-666666666,344900,247,183,223,0,52,69,62,40,256,131,125,131,95,36,2022-01-01,zipcode,Tarpley
ZCTA5 78884,48,1068,73583,810,208300,834,325,787,104,195,309,128,51,678,397,281,397,291,106,2022-01-01,zipcode,Utopia
ZCTA5 78885,48,100,78750,-666666666,345500,100,58,81,0,17,46,6,12,119,44,75,44,36,8,2022-01-01,zipcode,Vanderpool
ZCTA5 78886,48,393,118125,-666666666,103200,347,158,262,35,113,93,13,8,175,128,47,128,128,0,2022-01-01,zipcode,Yancey
ZCTA5 78931,48,210,-666666666,-666666666,-666666666,186,96,154,10,51,40,53,0,145,93,52,93,93,0,2022-01-01,zipcode,Bleiblerville
ZCTA5 78932,48,486,68214,1719,286400,424,222,383,51,64,117,139,12,332,194,138,194,180,14,2022-01-01,zipcode,Carmine
ZCTA5 78933,48,1120,68125,-666666666,275900,790,337,772,133,218,161,167,93,536,405,131,405,347,58,2022-01-01,zipcode,Cat spring
ZCTA5 78934,48,6478,64375,910,211500,5290,2199,4676,732,1593,1216,733,402,3387,2371,1016,2371,1792,579,2022-01-01,zipcode,Columbus
ZCTA5 78935,48,594,-666666666,-666666666,-666666666,582,321,541,16,167,172,121,65,591,382,209,382,382,0,2022-01-01,zipcode,Alleyton
ZCTA5 78938,48,221,62917,721,223100,171,46,163,9,60,62,22,10,146,103,43,103,86,17,2022-01-01,zipcode,Ellinger
ZCTA5 78940,48,2071,86604,950,246600,1831,734,1758,53,782,486,346,91,1281,874,407,874,818,56,2022-01-01,zipcode,Fayetteville
ZCTA5 78941,48,3430,70588,871,177700,2835,1256,2418,309,1164,600,288,57,1623,1232,391,1232,992,240,2022-01-01,zipcode,Flatonia
ZCTA5 78942,48,9746,66184,1069,180500,8019,3133,6837,1108,2630,1783,1073,243,4278,3442,836,3442,2463,979,2022-01-01,zipcode,Giddings
ZCTA5 78943,48,304,-666666666,-666666666,-666666666,290,131,290,206,14,70,0,0,178,178,0,178,96,82,2022-01-01,zipcode,Glidden
ZCTA5 78944,48,676,119038,-666666666,400900,618,318,564,30,137,190,183,24,394,286,108,286,283,3,2022-01-01,zipcode,Industry
ZCTA5 78945,48,10718,70035,812,269000,8921,4110,7988,785,3282,1859,1609,453,5499,4237,1262,4237,3321,916,2022-01-01,zipcode,La grange
ZCTA5 78946,48,931,70458,1114,164200,856,346,750,52,362,268,46,22,632,437,195,437,257,180,2022-01-01,zipcode,Ledbetter
ZCTA5 78947,48,4818,73984,1064,235300,3718,1587,3250,144,1391,1277,223,215,2134,1799,335,1799,1552,247,2022-01-01,zipcode,Lexington
ZCTA5 78948,48,689,-666666666,779,238600,563,261,542,147,238,124,13,20,367,247,120,247,172,75,2022-01-01,zipcode,Lincoln
ZCTA5 78949,48,662,86410,-666666666,241700,602,458,416,59,108,133,92,24,408,216,192,216,197,19,2022-01-01,zipcode,Muldoon
ZCTA5 78950,48,2376,98391,-666666666,232800,1894,641,1809,146,786,412,412,53,1170,889,281,889,825,64,2022-01-01,zipcode,New ulm
ZCTA5 78951,48,0,-666666666,-666666666,-666666666,0,0,0,0,0,0,0,0,0,0,0,0,0,0,2022-01-01,zipcode,Oakland
ZCTA5 78953,48,1145,84802,1682,264100,1112,326,1014,93,344,322,165,90,695,594,101,594,406,188,2022-01-01,zipcode,Rosanky
ZCTA5 78954,48,1272,97857,-666666666,431000,1055,520,1006,28,307,260,260,151,927,526,401,526,491,35,2022-01-01,zipcode,Round top
ZCTA5 78956,48,5067,65744,1149,205800,3956,1579,3478,445,1346,1045,406,236,2585,1779,806,1779,1349,430,2022-01-01,zipcode,Schulenburg
ZCTA5 78957,48,9887,63732,971,227000,7765,2767,7039,741,1764,2713,1282,539,4831,3954,877,3954,3047,907,2022-01-01,zipcode,Smithville
ZCTA5 78959,48,1601,57610,818,100000,1431,665,1211,336,476,247,51,101,890,686,204,686,534,152,2022-01-01,zipcode,Waelder
ZCTA5 78962,48,5202,71755,539,222200,4387,1547,3724,424,1215,1175,639,271,2546,1951,595,1951,1645,306,2022-01-01,zipcode,Weimar
ZCTA5 78963,48,608,87105,-666666666,247700,498,174,480,19,178,136,123,24,319,234,85,234,234,0,2022-01-01,zipcode,West point
ZCTA5 79001,48,210,128750,1125,129200,158,49,151,41,33,35,23,19,120,66,54,66,36,30,2022-01-01,zipcode,Adrian
ZCTA5 79003,48,132,86250,-666666666,65000,123,42,72,7,38,7,17,3,69,48,21,48,34,14,2022-01-01,zipcode,Allison
ZCTA5 79005,48,1669,67462,869,136100,1228,389,960,213,281,260,165,41,716,592,124,592,463,129,2022-01-01,zipcode,Booker
ZCTA5 79007,48,13928,58524,883,92900,10795,4165,8879,1475,2912,2946,1096,450,6601,4482,2119,4482,3533,949,2022-01-01,zipcode,Borger
ZCTA5 79009,48,1627,40908,807,104800,1349,501,1078,384,303,283,77,31,635,539,96,539,375,164,2022-01-01,zipcode,Bovina
ZCTA5 79010,48,423,97708,-666666666,-666666666,227,166,58,0,0,2,40,16,44,31,13,31,0,31,2022-01-01,zipcode,Boys ranch
ZCTA5 79011,48,214,80125,970,231300,181,75,162,8,58,48,37,11,138,85,53,85,59,26,2022-01-01,zipcode,Briscoe
ZCTA5 79012,48,0,-666666666,-666666666,-666666666,0,0,0,0,0,0,0,0,0,0,0,0,0,0,2022-01-01,zipcode,Bushland
ZCTA5 79013,48,3019,49013,699,53800,2186,696,1611,1182,279,138,0,12,1020,903,117,903,363,540,2022-01-01,zipcode,Cactus
ZCTA5 79014,48,3195,67411,1028,201100,2446,891,2149,251,789,633,391,85,1588,1287,301,1287,933,354,2022-01-01,zipcode,Canadian
ZCTA5 79015,48,22659,86793,935,268300,17911,6148,13835,555,2945,4440,3586,2309,9146,7997,1149,7997,5551,2446,2022-01-01,zipcode,Canyon
ZCTA5 79016,48,600,-666666666,-666666666,-666666666,600,415,0,0,0,0,0,0,0,0,0,0,0,0,2022-01-01,zipcode,Canyon
ZCTA5 79018,48,399,54375,782,93800,330,152,320,18,60,135,85,22,228,157,71,157,92,65,2022-01-01,zipcode,Channing
ZCTA5 79019,48,1800,70167,937,166700,1445,675,1267,94,432,437,209,95,830,682,148,682,601,81,2022-01-01,zipcode,Claude
ZCTA5 79021,48,72,74375,-666666666,85500,64,28,56,5,11,29,6,5,48,25,23,25,14,11,2022-01-01,zipcode,Cotton center
ZCTA5 79022,48,10672,75880,1113,143700,7893,3005,7251,1404,2838,1673,945,391,3905,3194,711,3194,2460,734,2022-01-01,zipcode,Dalhart
ZCTA5 79024,48,339,68750,765,109100,271,82,223,19,99,50,38,17,190,145,45,145,90,55,2022-01-01,zipcode,Darrouzett
ZCTA5 79025,48,13,-666666666,-666666666,-666666666,13,5,13,5,8,0,0,0,13,5,8,5,5,0,2022-01-01,zipcode,Dawn
ZCTA5 79027,48,4720,63933,844,103200,3519,1071,2859,617,968,581,515,178,1904,1505,399,1505,929,576,2022-01-01,zipcode,Dimmitt
ZCTA5 79029,48,15358,65101,933,140600,10917,3784,9022,2230,3111,2542,718,421,5750,5000,750,5000,3327,1673,2022-01-01,zipcode,Dumas
ZCTA5 79031,48,1263,50455,761,91800,992,454,844,211,337,213,74,9,633,472,161,472,360,112,2022-01-01,zipcode,Earth
ZCTA5 79032,48,114,48194,-666666666,93300,78,23,66,14,21,27,4,0,66,43,23,43,28,15,2022-01-01,zipcode,Edmonson
ZCTA5 79033,48,26,-666666666,-666666666,-666666666,26,11,26,0,0,15,11,0,21,21,0,21,6,15,2022-01-01,zipcode,Farnsworth
ZCTA5 79034,48,510,80625,690,115600,382,145,341,24,58,164,81,14,308,189,119,189,149,40,2022-01-01,zipcode,Follett
ZCTA5 79035,48,5439,77938,789,148200,4307,1501,3604,1080,792,1026,490,216,2059,1843,216,1843,1380,463,2022-01-01,zipcode,Friona
ZCTA5 79036,48,5147,72963,868,114700,4120,1674,3737,414,1349,1548,332,94,2390,1644,746,1644,1545,99,2022-01-01,zipcode,Fritch
ZCTA5 79039,48,695,52269,1057,124300,517,208,465,43,164,173,69,16,372,287,85,287,229,58,2022-01-01,zipcode,Groom
ZCTA5 79040,48,2271,77933,890,167100,1673,639,1405,559,203,187,372,84,848,671,177,671,504,167,2022-01-01,zipcode,Gruver
ZCTA5 79041,48,2612,55331,629,98400,2195,1059,1892,588,608,497,162,37,1272,1021,251,1021,835,186,2022-01-01,zipcode,Hale center
ZCTA5 79042,48,1103,56607,969,100000,774,297,662,41,200,204,186,31,578,421,157,421,316,105,2022-01-01,zipcode,Happy
ZCTA5 79043,48,1634,53018,1024,54700,1147,408,989,363,335,225,60,6,628,526,102,526,296,230,2022-01-01,zipcode,Hart
ZCTA5 79044,48,662,52366,1619,182100,520,233,444,56,147,130,20,91,389,309,80,309,211,98,2022-01-01,zipcode,Hartley
ZCTA5 79045,48,18597,52124,844,103600,13382,4729,10753,3118,4290,2106,924,315,6979,5982,997,5982,3850,2132,2022-01-01,zipcode,Hereford
ZCTA5 79046,48,588,91875,675,110300,425,196,386,33,153,89,80,31,315,217,98,217,194,23,2022-01-01,zipcode,Higgins
ZCTA5 79051,48,4,-666666666,-666666666,-666666666,4,4,4,0,0,4,0,0,12,4,8,4,4,0,2022-01-01,zipcode,Kerrick
ZCTA5 79052,48,1157,57646,830,104400,905,300,820,153,278,213,140,36,589,473,116,473,339,134,2022-01-01,zipcode,Kress
ZCTA5 79053,48,95,40000,-666666666,90000,61,34,39,0,11,6,22,0,38,20,18,20,12,8,2022-01-01,zipcode,Lazbuddie
ZCTA5 79054,48,551,68750,917,41000,382,161,343,22,126,119,64,12,267,180,87,180,131,49,2022-01-01,zipcode,Lefors
ZCTA5 79056,48,65,-666666666,-666666666,75000,55,42,53,0,7,26,17,3,43,34,9,34,34,0,2022-01-01,zipcode,Lipscomb
ZCTA5 79057,48,1167,66000,950,81900,890,375,757,75,338,241,77,26,621,436,185,436,316,120,2022-01-01,zipcode,Mclean
ZCTA5 79058,48,0,-666666666,-666666666,-666666666,0,0,0,0,0,0,0,0,39,0,39,0,0,0,2022-01-01,zipcode,Masterson
ZCTA5 79059,48,645,59375,554,122300,500,155,445,44,170,160,56,15,334,273,61,273,233,40,2022-01-01,zipcode,Miami
ZCTA5 79061,48,328,81563,592,86700,248,83,235,14,100,107,12,2,144,111,33,111,104,7,2022-01-01,zipcode,Mobeetie
ZCTA5 79062,48,330,-666666666,-666666666,115600,219,49,135,7,43,35,37,13,111,74,37,74,65,9,2022-01-01,zipcode,Morse
ZCTA5 79063,48,629,72708,585,189800,496,216,433,4,164,167,79,19,242,219,23,219,197,22,2022-01-01,zipcode,Nazareth
ZCTA5 79064,48,2371,60625,809,88300,1784,793,1457,297,564,421,145,30,1018,763,255,763,533,230,2022-01-01,zipcode,Olton
ZCTA5 79065,48,19549,54351,843,96300,15331,6526,12974,2494,4084,4286,1612,498,9139,7410,1729,7410,5201,2209,2022-01-01,zipcode,Pampa
ZCTA5 79068,48,3269,84310,973,142800,2697,929,2216,121,718,721,424,232,1467,1267,200,1267,1027,240,2022-01-01,zipcode,Panhandle
ZCTA5 79070,48,9693,62077,848,115800,7178,2337,5893,1385,2005,1413,717,373,4160,3575,585,3575,2503,1072,2022-01-01,zipcode,Perryton
ZCTA5 79072,48,25747,49104,766,97100,19375,7978,15297,4025,5083,4083,1225,881,10176,8367,1809,8367,4864,3503,2022-01-01,zipcode,Plainview
ZCTA5 79078,48,150,-666666666,-666666666,53500,101,80,97,17,48,32,0,0,160,60,100,60,59,1,2022-01-01,zipcode,Sanford
ZCTA5 79079,48,2409,50066,875,85300,1947,752,1674,261,720,440,219,34,1470,993,477,993,716,277,2022-01-01,zipcode,Shamrock
ZCTA5 79080,48,437,39286,845,43800,355,207,303,43,116,118,25,1,312,170,142,170,150,20,2022-01-01,zipcode,Skellytown
ZCTA5 79081,48,3257,63333,834,93600,2449,829,2037,509,517,488,452,71,1549,1158,391,1158,828,330,2022-01-01,zipcode,Spearman
ZCTA5 79082,48,197,-666666666,-666666666,47000,159,63,147,36,26,57,26,2,169,82,87,82,62,20,2022-01-01,zipcode,Springlake
ZCTA5 79083,48,1715,56250,875,83900,1285,659,1093,14,325,570,140,44,1150,683,467,683,522,161,2022-01-01,zipcode,Stinnett
ZCTA5 79084,48,1402,53462,933,111700,1118,378,967,167,203,340,186,71,735,540,195,540,463,77,2022-01-01,zipcode,Stratford
ZCTA5 79085,48,0,-666666666,-666666666,-666666666,0,0,0,0,0,0,0,0,11,0,11,0,0,0,2022-01-01,zipcode,Summerfield
ZCTA5 79086,48,3420,56667,949,106300,2613,983,2237,707,586,492,392,60,1530,1228,302,1228,945,283,2022-01-01,zipcode,Sunray
ZCTA5 79087,48,838,63008,679,96600,606,230,555,154,164,139,86,12,384,307,77,307,181,126,2022-01-01,zipcode,Texline
ZCTA5 79088,48,5355,32976,739,83800,4188,2108,3459,818,1178,804,545,114,2214,1772,442,1772,1143,629,2022-01-01,zipcode,Tulia
ZCTA5 79091,48,70,-666666666,-666666666,-666666666,32,0,32,17,0,15,0,0,40,17,23,17,17,0,2022-01-01,zipcode,Umbarger
ZCTA5 79092,48,1277,72829,1101,140300,1037,442,914,159,256,343,104,52,548,459,89,459,372,87,2022-01-01,zipcode,Vega
ZCTA5 79093,48,127,75147,-666666666,305900,81,45,81,45,17,0,11,8,91,48,43,48,48,0,2022-01-01,zipcode,Waka
ZCTA5 79094,48,12,-666666666,-666666666,-666666666,12,5,12,0,0,3,0,9,28,8,20,8,8,0,2022-01-01,zipcode,Wayside
ZCTA5 79095,48,2736,51395,652,89600,1986,705,1678,372,400,490,329,87,1290,970,320,970,736,234,2022-01-01,zipcode,Wellington
ZCTA5 79096,48,2001,66037,937,147200,1519,580,1380,206,452,437,232,53,912,711,201,711,533,178,2022-01-01,zipcode,Wheeler
ZCTA5 79097,48,1063,113125,793,167300,843,297,715,77,235,276,83,44,539,422,117,422,356,66,2022-01-01,zipcode,White deer
ZCTA5 79098,48,450,38105,1097,130500,414,259,374,31,209,79,36,19,217,185,32,185,151,34,2022-01-01,zipcode,Wildorado
ZCTA5 79101,48,2498,38291,852,156300,2359,1497,2025,300,829,454,359,83,1428,1252,176,1252,128,1124,2022-01-01,zipcode,Amarillo
ZCTA5 79102,48,8805,47878,962,126600,6832,2645,5644,1131,1691,1690,853,279,4569,4089,480,4089,1982,2107,2022-01-01,zipcode,Amarillo
ZCTA5 79103,48,10961,53879,1041,113200,7953,2663,6582,1440,1897,2385,707,153,3905,3722,183,3722,2472,1250,2022-01-01,zipcode,Amarillo
ZCTA5 79104,48,6253,45119,877,79300,4562,1784,4058,1041,1639,1067,215,96,2625,2244,381,2244,1150,1094,2022-01-01,zipcode,Amarillo
ZCTA5 79106,48,27992,50271,938,148700,21448,7399,17677,2608,4979,5832,2755,1503,13454,11806,1648,11806,5586,6220,2022-01-01,zipcode,Amarillo
ZCTA5 79107,48,38441,38047,956,81900,28773,14812,23728,9033,8074,4880,1441,300,12322,10512,1810,10512,6309,4203,2022-01-01,zipcode,Amarillo
ZCTA5 79108,48,11161,60115,1049,130600,8910,3613,7441,1112,2699,2648,845,137,5229,4493,736,4493,3440,1053,2022-01-01,zipcode,Amarillo
ZCTA5 79109,48,42659,67831,894,198900,33695,11298,28928,2151,6187,11091,6241,3258,20354,18217,2137,18217,11042,7175,2022-01-01,zipcode,Amarillo
ZCTA5 79110,48,18844,63647,1146,141800,14493,4368,11763,894,3795,5355,1335,384,7794,7047,747,7047,4762,2285,2022-01-01,zipcode,Amarillo
ZCTA5 79111,48,1854,67375,1206,-666666666,1213,544,1076,103,393,514,55,11,543,475,68,475,4,471,2022-01-01,zipcode,Amarillo
ZCTA5 79118,48,26937,82990,1213,205400,21083,6428,17940,1610,4843,7174,3111,1202,10903,10131,772,10131,8104,2027,2022-01-01,zipcode,Amarillo
ZCTA5 79119,48,22371,94044,1155,310600,17429,4783,15201,262,2838,4983,4681,2437,9480,8832,648,8832,5750,3082,2022-01-01,zipcode,Amarillo
ZCTA5 79121,48,5696,73375,924,252900,4906,2028,4416,116,519,1704,1212,865,2916,2554,362,2554,1911,643,2022-01-01,zipcode,Amarillo
ZCTA5 79124,48,11207,101604,1037,314400,8703,3277,7705,500,1568,2894,1670,1073,4537,4247,290,4247,3797,450,2022-01-01,zipcode,Amarillo
ZCTA5 79201,48,6799,55938,858,109200,5672,2503,4996,899,1895,1507,502,193,2795,1910,885,1910,1364,546,2022-01-01,zipcode,Childress
ZCTA5 79220,48,212,45750,-666666666,116300,170,51,140,39,46,30,12,13,120,69,51,69,41,28,2022-01-01,zipcode,Afton
ZCTA5 79225,48,901,69659,780,62400,749,273,560,152,135,194,42,37,446,309,137,309,238,71,2022-01-01,zipcode,Chillicothe
ZCTA5 79226,48,2713,49318,717,103400,2221,1149,1722,307,582,590,163,80,1639,1012,627,1012,698,314,2022-01-01,zipcode,Clarendon
ZCTA5 79227,48,1125,42237,537,63000,918,342,737,143,185,292,86,31,700,490,210,490,332,158,2022-01-01,zipcode,Crowell
ZCTA5 79229,48,255,42917,-666666666,27100,235,127,229,42,96,71,20,0,218,124,94,124,117,7,2022-01-01,zipcode,Dickens
ZCTA5 79230,48,60,48393,-666666666,-666666666,54,42,51,12,10,3,13,13,42,19,23,19,16,3,2022-01-01,zipcode,Dodson
ZCTA5 79231,48,20,-666666666,-666666666,-666666666,20,0,20,0,12,8,0,0,8,8,0,8,8,0,2022-01-01,zipcode,Dougherty
ZCTA5 79233,48,96,-666666666,-666666666,-666666666,67,21,58,14,10,33,1,0,85,42,43,42,25,17,2022-01-01,zipcode,Estelline
ZCTA5 79234,48,106,78523,-666666666,220500,80,8,80,0,5,49,23,3,47,37,10,37,19,18,2022-01-01,zipcode,Flomot
ZCTA5 79235,48,3152,48140,531,92600,2172,857,1862,603,391,579,226,63,1578,1141,437,1141,724,417,2022-01-01,zipcode,Floydada
ZCTA5 79236,48,189,59375,-666666666,-666666666,149,72,148,29,51,21,39,8,126,72,54,72,28,44,2022-01-01,zipcode,Guthrie
ZCTA5 79237,48,429,78194,575,76300,384,112,359,30,97,169,37,26,305,191,114,191,175,16,2022-01-01,zipcode,Hedley
ZCTA5 79239,48,104,31250,-666666666,96700,104,63,104,13,50,19,22,0,150,58,92,58,56,2,2022-01-01,zipcode,Lakeview
ZCTA5 79240,48,249,125625,-666666666,-666666666,148,63,119,0,65,40,14,0,45,26,19,26,20,6,2022-01-01,zipcode,Lelia lake
ZCTA5 79241,48,2138,54125,864,90900,1810,840,1581,400,570,346,200,65,1006,775,231,775,617,158,2022-01-01,zipcode,Lockney
ZCTA5 79243,48,21,26786,-666666666,-666666666,21,17,21,6,0,8,7,0,19,10,9,10,5,5,2022-01-01,zipcode,Mcadoo
ZCTA5 79244,48,789,71513,709,85000,625,236,560,69,148,224,85,34,492,295,197,295,229,66,2022-01-01,zipcode,Matador
ZCTA5 79245,48,2227,44095,544,74400,1761,815,1531,269,527,478,181,76,1184,900,284,900,621,279,2022-01-01,zipcode,Memphis
ZCTA5 79247,48,23,-666666666,-666666666,-666666666,20,18,20,0,13,7,0,0,22,18,4,18,18,0,2022-01-01,zipcode,Odell
ZCTA5 79248,48,1520,37500,395,48400,1184,525,988,189,300,311,116,72,969,638,331,638,404,234,2022-01-01,zipcode,Paducah
ZCTA5 79250,48,1136,43438,628,66800,916,366,786,149,254,264,85,34,654,463,191,463,331,132,2022-01-01,zipcode,Petersburg
ZCTA5 79251,48,32,-666666666,-666666666,142200,32,4,32,13,0,9,7,3,23,13,10,13,13,0,2022-01-01,zipcode,Quail
ZCTA5 79252,48,2702,59244,559,69200,2183,745,1975,220,726,673,286,70,1419,1036,383,1036,686,350,2022-01-01,zipcode,Quanah
ZCTA5 79255,48,412,49583,744,66000,350,196,293,43,97,81,54,18,322,181,141,181,126,55,2022-01-01,zipcode,Quitaque
ZCTA5 79256,48,288,36382,-666666666,47500,278,145,251,50,114,44,32,11,159,113,46,113,83,30,2022-01-01,zipcode,Roaring springs
ZCTA5 79257,48,854,32800,1083,76100,712,368,671,118,242,241,37,33,608,392,216,392,314,78,2022-01-01,zipcode,Silverton
ZCTA5 79258,48,8,-666666666,-666666666,-666666666,8,0,8,0,0,4,4,0,4,4,0,4,4,0,2022-01-01,zipcode,South plains
ZCTA5 79259,48,58,-666666666,-666666666,-666666666,58,13,58,0,5,0,53,0,39,21,18,21,21,0,2022-01-01,zipcode,Tell
ZCTA5 79261,48,381,57188,565,43000,319,139,246,64,74,64,37,7,341,125,216,125,80,45,2022-01-01,zipcode,Turkey
ZCTA5 79311,48,3705,63958,726,129400,2832,1166,2258,309,914,492,355,188,1549,1401,148,1401,1007,394,2022-01-01,zipcode,Abernathy
ZCTA5 79312,48,1176,53646,593,49400,902,444,767,186,357,166,50,8,396,313,83,313,245,68,2022-01-01,zipcode,Amherst
ZCTA5 79313,48,1451,57619,1069,63900,1072,450,924,210,259,317,99,39,720,544,176,544,404,140,2022-01-01,zipcode,Anton
ZCTA5 79314,48,104,-666666666,-666666666,29000,53,29,53,38,3,12,0,0,66,26,40,26,10,16,2022-01-01,zipcode,Bledsoe
ZCTA5 79316,48,10109,41698,762,103300,7689,3196,6407,1549,2266,1955,506,131,4238,3724,514,3724,2440,1284,2022-01-01,zipcode,Brownfield
ZCTA5 79322,48,1877,49432,513,68400,1454,680,1260,282,510,295,145,28,837,705,132,705,466,239,2022-01-01,zipcode,Crosbyton
ZCTA5 79323,48,7275,71723,826,176000,5010,1802,3958,1332,1151,1191,246,38,2671,2447,224,2447,1538,909,2022-01-01,zipcode,Denver city
ZCTA5 79324,48,4,-666666666,-666666666,-666666666,4,4,4,0,4,0,0,0,17,4,13,4,4,0,2022-01-01,zipcode,Enochs
ZCTA5 79325,48,2374,74875,1033,144700,1533,484,1365,256,450,365,237,57,892,725,167,725,475,250,2022-01-01,zipcode,Farwell
ZCTA5 79326,48,59,-666666666,-666666666,-666666666,48,33,29,0,3,26,0,0,15,15,0,15,15,0,2022-01-01,zipcode,Fieldton
ZCTA5 79329,48,3306,69725,758,178800,2470,866,2183,302,557,780,384,160,1520,1279,241,1279,958,321,2022-01-01,zipcode,Idalou
ZCTA5 79330,48,60,121429,-666666666,-666666666,60,11,60,0,41,11,8,0,283,40,243,40,32,8,2022-01-01,zipcode,Justiceburg
ZCTA5 79331,48,11619,42500,806,95600,9065,4637,7447,2190,2567,1717,824,149,4610,3928,682,3928,2795,1133,2022-01-01,zipcode,Lamesa
ZCTA5 79336,48,15489,51257,758,124200,12033,4478,9906,2048,2817,3424,1047,570,6720,5843,877,5843,4182,1661,2022-01-01,zipcode,Levelland
ZCTA5 79339,48,6704,49444,806,76400,4963,2007,4237,1050,1528,1094,406,159,3064,2498,566,2498,1752,746,2022-01-01,zipcode,Littlefield
ZCTA5 79342,48,362,98068,-666666666,118400,283,121,245,89,77,57,13,9,138,125,13,125,121,4,2022-01-01,zipcode,Loop
ZCTA5 79343,48,1443,61250,442,113100,1166,411,987,193,298,287,195,14,628,525,103,525,418,107,2022-01-01,zipcode,Lorenzo
ZCTA5 79344,48,0,-666666666,-666666666,-666666666,0,0,0,0,0,0,0,0,0,0,0,0,0,0,2022-01-01,zipcode,Maple
ZCTA5 79345,48,1059,64688,693,110900,787,291,648,113,163,289,63,20,353,309,44,309,219,90,2022-01-01,zipcode,Meadow
ZCTA5 79346,48,1790,39850,671,44500,1384,518,1230,365,439,316,87,23,950,739,211,739,480,259,2022-01-01,zipcode,Morton
ZCTA5 79347,48,7182,70509,668,113900,5447,2268,4479,1297,1402,1072,506,202,2553,2023,530,2023,1445,578,2022-01-01,zipcode,Muleshoe
ZCTA5 79350,48,398,44563,-666666666,52500,356,142,328,80,65,166,17,0,220,184,36,184,173,11,2022-01-01,zipcode,New deal
ZCTA5 79351,48,1100,60833,908,90800,873,330,765,162,210,283,94,16,588,448,140,448,320,128,2022-01-01,zipcode,Odonnell
ZCTA5 79353,48,23,111875,-666666666,-666666666,17,7,14,0,0,7,7,0,9,9,0,9,9,0,2022-01-01,zipcode,Pep
ZCTA5 79355,48,1573,79340,882,124200,1117,313,983,239,218,379,135,12,749,623,126,623,325,298,2022-01-01,zipcode,Plains
ZCTA5 79356,48,5654,52870,1054,91000,4900,3123,4101,1251,1349,987,286,228,1979,1646,333,1646,1144,502,2022-01-01,zipcode,Post
ZCTA5 79357,48,1936,55938,719,65500,1500,434,1256,298,471,324,121,42,982,788,194,788,555,233,2022-01-01,zipcode,Ralls
ZCTA5 79358,48,1412,75417,883,206300,950,332,791,165,164,245,142,75,487,459,28,459,321,138,2022-01-01,zipcode,Ropesville
ZCTA5 79359,48,3321,53750,684,85300,2505,1085,2083,609,657,534,164,119,1442,1263,179,1263,868,395,2022-01-01,zipcode,Seagraves
ZCTA5 79360,48,16858,81607,811,192800,11548,4474,9100,3815,3046,1252,803,184,5610,5143,467,5143,4035,1108,2022-01-01,zipcode,Seminole
ZCTA5 79363,48,5506,77264,1083,186200,4312,1408,3780,382,1110,1152,690,446,2229,2031,198,2031,1757,274,2022-01-01,zipcode,Shallowater
ZCTA5 79364,48,7541,57151,986,89700,5752,2171,4797,709,1659,1531,568,330,3008,2668,340,2668,1950,718,2022-01-01,zipcode,Slaton
ZCTA5 79366,48,1073,120156,-666666666,314400,947,423,823,22,151,256,198,196,521,451,70,451,440,11,2022-01-01,zipcode,Ransom canyon
ZCTA5 79367,48,598,44464,857,78800,401,128,339,111,73,95,54,6,254,215,39,215,129,86,2022-01-01,zipcode,Smyer
ZCTA5 79369,48,47,-666666666,-666666666,-666666666,47,16,47,0,0,16,0,31,12,12,0,12,12,0,2022-01-01,zipcode,Spade
ZCTA5 79370,48,1166,46797,450,70200,971,513,865,86,347,229,133,70,966,491,475,491,421,70,2022-01-01,zipcode,Spur
ZCTA5 79371,48,1387,68650,907,104000,1083,380,869,98,361,265,128,17,658,520,138,520,423,97,2022-01-01,zipcode,Sudan
ZCTA5 79372,48,1483,61563,619,90200,1143,389,942,184,350,258,94,56,593,546,47,546,395,151,2022-01-01,zipcode,Sundown
ZCTA5 79373,48,2897,50758,961,109600,2285,883,1997,374,616,510,319,178,1310,1050,260,1050,752,298,2022-01-01,zipcode,Tahoka
ZCTA5 79376,48,112,-666666666,-666666666,-666666666,35,17,35,33,0,0,1,1,57,19,38,19,1,18,2022-01-01,zipcode,Tokio
ZCTA5 79377,48,322,36932,-666666666,85000,192,113,158,88,24,34,12,0,133,89,44,89,61,28,2022-01-01,zipcode,Welch
ZCTA5 79378,48,234,112941,479,136800,151,40,139,49,52,14,13,11,111,70,41,70,54,16,2022-01-01,zipcode,Wellman
ZCTA5 79379,48,698,58750,729,70000,534,256,448,114,134,145,37,18,245,207,38,207,170,37,2022-01-01,zipcode,Whiteface
ZCTA5 79380,48,83,51875,-666666666,-666666666,71,34,58,15,20,13,8,2,43,31,12,31,25,6,2022-01-01,zipcode,Whitharral
ZCTA5 79381,48,1500,63688,807,202600,1024,396,829,111,186,236,240,56,576,499,77,499,400,99,2022-01-01,zipcode,Wilson
ZCTA5 79382,48,8999,82981,1223,215900,6234,1749,5310,463,1432,1916,1043,456,3330,3132,198,3132,2424,708,2022-01-01,zipcode,Wolfforth
ZCTA5 79401,48,9431,23400,1021,105800,9037,3995,3675,726,1194,874,458,423,5007,4039,968,4039,408,3631,2022-01-01,zipcode,Lubbock
ZCTA5 79403,48,16194,41582,888,76500,12194,4971,9875,2435,3935,2485,653,367,6492,5789,703,5789,3452,2337,2022-01-01,zipcode,Lubbock
ZCTA5 79404,48,8935,45653,870,87900,7262,3390,6355,1509,2359,1595,584,308,4185,3225,960,3225,2155,1070,2022-01-01,zipcode,Lubbock
ZCTA5 79406,48,7765,-666666666,-666666666,-666666666,7765,5739,87,0,0,69,9,9,0,0,0,0,0,0,2022-01-01,zipcode,Lubbock
ZCTA5 79407,48,23177,61563,1101,173700,19218,5474,13614,1092,3320,4473,2893,1836,11500,10537,963,10537,4602,5935,2022-01-01,zipcode,Lubbock
ZCTA5 79410,48,10502,44650,1299,189400,8315,2764,5869,721,943,1613,1155,1437,4664,4377,287,4377,1463,2914,2022-01-01,zipcode,Lubbock
ZCTA5 79411,48,6437,39259,872,125500,5486,1860,3891,1042,1299,873,376,301,3552,2942,610,2942,934,2008,2022-01-01,zipcode,Lubbock
ZCTA5 79412,48,15161,44610,918,103100,11264,4112,8996,2088,2995,2749,787,377,6372,5763,609,5763,2839,2924,2022-01-01,zipcode,Lubbock
ZCTA5 79413,48,23523,65719,1266,182700,17478,5536,14377,1377,3678,4214,3250,1858,9483,8889,594,8889,5064,3825,2022-01-01,zipcode,Lubbock
ZCTA5 79414,48,18027,48587,1063,140500,14798,4074,10634,1223,2859,3741,1620,1191,9159,8524,635,8524,3009,5515,2022-01-01,zipcode,Lubbock
ZCTA5 79415,48,17086,37072,936,84200,13345,5463,9011,2054,2772,2197,1133,855,7205,6325,880,6325,2519,3806,2022-01-01,zipcode,Lubbock
ZCTA5 79416,48,35524,65774,1197,187000,28360,9565,20277,1455,4584,6106,5093,3039,15768,14332,1436,14332,7209,7123,2022-01-01,zipcode,Lubbock
ZCTA5 79423,48,42284,82854,1274,204500,32257,9072,27563,1813,6163,9040,6394,4153,17636,16494,1142,16494,12009,4485,2022-01-01,zipcode,Lubbock
ZCTA5 79424,48,50448,91572,1092,259500,39302,11870,33407,2048,5749,10342,9589,5679,21934,20548,1386,20548,14225,6323,2022-01-01,zipcode,Lubbock
ZCTA5 79501,48,2648,53539,917,86500,2158,1062,1889,224,540,876,173,76,1477,1154,323,1154,915,239,2022-01-01,zipcode,Anson
ZCTA5 79502,48,1244,65114,757,53700,960,336,716,147,330,145,41,53,594,413,181,413,345,68,2022-01-01,zipcode,Aspermont
ZCTA5 79503,48,150,90795,-666666666,112500,142,36,142,11,17,73,31,10,123,102,21,102,81,21,2022-01-01,zipcode,Avoca
ZCTA5 79504,48,3181,66208,676,99300,2661,973,2400,312,844,732,412,100,1437,1116,321,1116,878,238,2022-01-01,zipcode,Baird
ZCTA5 79505,48,225,38295,520,60300,167,78,166,15,37,106,8,0,174,65,109,65,45,20,2022-01-01,zipcode,Benjamin
ZCTA5 79506,48,546,39306,725,79800,486,296,486,59,114,216,56,41,556,311,245,311,243,68,2022-01-01,zipcode,Blackwell
ZCTA5 79508,48,1041,74583,1091,165000,861,465,791,49,295,248,144,55,517,435,82,435,360,75,2022-01-01,zipcode,Buffalo gap
ZCTA5 79510,48,8058,64338,948,135000,6526,2658,5389,322,2066,1787,892,322,3631,3002,629,3002,2534,468,2022-01-01,zipcode,Clyde
ZCTA5 79511,48,1044,81071,975,186900,741,301,662,49,160,274,123,56,527,360,167,360,307,53,2022-01-01,zipcode,Coahoma
ZCTA5 79512,48,7879,49602,770,84100,6747,3374,4842,797,1944,1662,325,114,3207,2053,1154,2053,1418,635,2022-01-01,zipcode,Colorado city
ZCTA5 79517,48,140,63889,-666666666,-666666666,140,11,140,60,15,42,7,16,66,66,0,66,47,19,2022-01-01,zipcode,Fluvanna
ZCTA5 79518,48,115,-666666666,-666666666,-666666666,89,60,81,2,36,30,1,12,93,41,52,41,25,16,2022-01-01,zipcode,Girard
ZCTA5 79519,48,57,152938,-666666666,195600,57,9,57,0,19,6,32,0,53,37,16,37,37,0,2022-01-01,zipcode,Goldsboro
ZCTA5 79520,48,2552,52847,866,49600,1927,650,1550,217,614,505,167,47,1310,1073,237,1073,766,307,2022-01-01,zipcode,Hamlin
ZCTA5 79521,48,3359,60227,692,79600,2891,1360,2510,480,947,555,260,268,1958,1266,692,1266,829,437,2022-01-01,zipcode,Haskell
ZCTA5 79525,48,2829,67306,903,135700,2261,797,1861,81,707,698,312,63,1227,1164,63,1164,1125,39,2022-01-01,zipcode,Hawley
ZCTA5 79526,48,946,66875,-666666666,136900,721,338,645,111,188,165,132,49,484,356,128,356,319,37,2022-01-01,zipcode,Hermleigh
ZCTA5 79527,48,274,80417,-666666666,118300,230,80,225,17,107,59,27,15,182,111,71,111,106,5,2022-01-01,zipcode,Ira
ZCTA5 79528,48,524,69342,929,75000,396,220,354,50,88,110,59,47,321,200,121,200,164,36,2022-01-01,zipcode,Jayton
ZCTA5 79529,48,1132,35329,1002,58000,934,493,773,124,242,255,79,73,597,439,158,439,300,139,2022-01-01,zipcode,Knox city
ZCTA5 79530,48,505,51250,950,72100,405,177,363,46,159,102,54,2,317,211,106,211,173,38,2022-01-01,zipcode,Lawn
ZCTA5 79532,48,754,50625,340,86500,552,188,449,90,165,115,58,21,428,294,134,294,233,61,2022-01-01,zipcode,Loraine
ZCTA5 79533,48,442,41406,883,40600,348,158,310,38,101,120,42,9,256,197,59,197,165,32,2022-01-01,zipcode,Lueders
ZCTA5 79534,48,213,91389,-666666666,180100,196,70,174,28,19,37,41,49,113,96,17,96,83,13,2022-01-01,zipcode,Mc caulley
ZCTA5 79535,48,117,53750,-666666666,88300,111,59,91,10,31,34,9,7,60,53,7,53,48,5,2022-01-01,zipcode,Maryneal
ZCTA5 79536,48,6123,67788,1260,118600,4420,1698,3667,331,1812,1043,366,115,2337,1919,418,1919,1512,407,2022-01-01,zipcode,Merkel
ZCTA5 79537,48,40,43571,-666666666,-666666666,40,32,23,7,13,2,1,0,28,14,14,14,6,8,2022-01-01,zipcode,Nolan
ZCTA5 79538,48,173,-666666666,-666666666,331600,163,84,158,7,70,44,30,7,107,62,45,62,58,4,2022-01-01,zipcode,Novice
ZCTA5 79539,48,197,55179,770,-666666666,164,67,125,51,29,6,32,7,111,73,38,73,51,22,2022-01-01,zipcode,O brien
ZCTA5 79540,48,38,100000,-666666666,-666666666,33,5,28,0,9,8,5,6,49,18,31,18,18,0,2022-01-01,zipcode,Old glory
ZCTA5 79541,48,1253,58901,-666666666,264900,914,267,882,0,389,347,73,73,591,540,51,540,369,171,2022-01-01,zipcode,Ovalo
ZCTA5 79543,48,1178,63403,760,66100,934,256,791,86,332,244,98,31,594,471,123,471,391,80,2022-01-01,zipcode,Roby
ZCTA5 79544,48,577,56786,919,-666666666,446,157,367,88,117,151,8,3,215,164,51,164,119,45,2022-01-01,zipcode,Rochester
ZCTA5 79545,48,1873,51179,893,85000,1448,598,1177,137,438,352,190,60,874,685,189,685,575,110,2022-01-01,zipcode,Roscoe
ZCTA5 79546,48,1749,49650,563,79000,1396,522,1225,225,373,392,165,70,969,707,262,707,511,196,2022-01-01,zipcode,Rotan
ZCTA5 79547,48,867,29258,1070,54200,711,407,650,146,202,155,108,39,568,401,167,401,319,82,2022-01-01,zipcode,Rule
ZCTA5 79548,48,162,53750,-666666666,83100,127,49,119,26,33,22,32,6,105,73,32,73,62,11,2022-01-01,zipcode,Rule
ZCTA5 79549,48,15608,57063,1032,108100,12179,5707,10124,1527,3379,3417,1324,477,6318,5222,1096,5222,4185,1037,2022-01-01,zipcode,Snyder
ZCTA5 79553,48,3081,48313,1066,72800,2391,1060,1971,285,794,556,294,42,1554,1329,225,1329,969,360,2022-01-01,zipcode,Stamford
ZCTA5 79556,48,12621,47221,803,92500,9689,3921,8176,1358,2825,2938,678,377,6109,4863,1246,4863,3073,1790,2022-01-01,zipcode,Sweetwater
ZCTA5 79560,48,60,-666666666,-666666666,106300,57,27,57,9,30,10,6,2,61,27,34,27,21,6,2022-01-01,zipcode,Sylvester
ZCTA5 79561,48,508,71818,675,76600,447,191,404,47,115,180,56,6,280,220,60,220,181,39,2022-01-01,zipcode,Trent
ZCTA5 79562,48,4157,117901,1550,266700,3235,1471,2885,127,627,850,814,467,1436,1401,35,1401,1277,124,2022-01-01,zipcode,Tuscola
ZCTA5 79563,48,1024,53553,1000,60200,840,399,713,153,311,198,33,18,532,414,118,414,366,48,2022-01-01,zipcode,Tye
ZCTA5 79565,48,365,115536,-666666666,103300,269,133,198,0,133,44,21,0,110,79,31,79,74,5,2022-01-01,zipcode,Westbrook
ZCTA5 79566,48,228,46875,-666666666,267900,162,92,162,16,76,44,13,13,140,94,46,94,88,6,2022-01-01,zipcode,Wingate
ZCTA5 79567,48,3064,47039,703,64300,2432,1041,2066,490,739,548,235,54,1647,1166,481,1166,941,225,2022-01-01,zipcode,Winters
ZCTA5 79601,48,26603,53049,931,156800,23040,12464,15351,2662,5171,4452,2027,1039,9503,7667,1836,7667,3580,4087,2022-01-01,zipcode,Abilene
ZCTA5 79602,48,26487,78850,985,213500,20663,7472,18027,1536,4408,5566,3612,2905,10819,9529,1290,9529,7442,2087,2022-01-01,zipcode,Abilene
ZCTA5 79603,48,24189,52055,976,105200,18317,6372,14708,2701,5449,4128,1955,475,9926,8827,1099,8827,5098,3729,2022-01-01,zipcode,Abilene
ZCTA5 79605,48,28989,56890,1061,151900,22661,7025,18243,2209,6178,5482,3080,1294,13001,11606,1395,11606,6267,5339,2022-01-01,zipcode,Abilene
ZCTA5 79606,48,27797,73381,1114,238700,21768,7276,17689,854,3829,6472,3982,2552,12576,11689,887,11689,6305,5384,2022-01-01,zipcode,Abilene
ZCTA5 79607,48,3699,58372,1287,452100,2541,366,1409,0,177,778,327,127,950,924,26,924,63,861,2022-01-01,zipcode,Dyess afb
ZCTA5 79699,48,116,-666666666,-666666666,-666666666,116,38,0,0,0,0,0,0,49,0,49,0,0,0,2022-01-01,zipcode,Abilene
ZCTA5 79701,48,28461,57500,1222,186900,20616,7071,17117,5227,4042,5037,1927,884,11597,10368,1229,10368,6643,3725,2022-01-01,zipcode,Midland
ZCTA5 79703,48,21434,88718,1515,211300,15518,3662,12318,2500,3562,4345,1435,476,8364,8017,347,8017,5086,2931,2022-01-01,zipcode,Midland
ZCTA5 79705,48,41140,95939,1426,316200,31002,8789,27010,2951,5221,8401,7898,2539,19019,17513,1506,17513,12049,5464,2022-01-01,zipcode,Midland
ZCTA5 79706,48,32527,99515,1110,243500,23555,7157,19754,3039,4890,7204,2846,1775,12178,11222,956,11222,9194,2028,2022-01-01,zipcode,Midland
ZCTA5 79707,48,39347,99732,1368,372600,29781,8059,24991,2117,5513,7323,6818,3220,15951,15453,498,15453,9263,6190,2022-01-01,zipcode,Midland
ZCTA5 79713,48,879,69500,-666666666,140600,665,284,534,90,176,151,89,28,312,266,46,266,192,74,2022-01-01,zipcode,Ackerly
ZCTA5 79714,48,18362,86458,1345,179300,13367,3844,11043,2890,3222,2756,1636,539,6976,6603,373,6603,4789,1814,2022-01-01,zipcode,Andrews
ZCTA5 79718,48,625,31250,1102,58600,551,202,456,89,252,101,9,5,316,205,111,205,154,51,2022-01-01,zipcode,Balmorhea
ZCTA5 79719,48,345,29408,858,59800,246,121,194,48,92,52,2,0,180,129,51,129,101,28,2022-01-01,zipcode,Barstow
ZCTA5 79720,48,32297,66655,983,132700,26010,11727,22308,4037,7907,7251,2121,992,13405,11539,1866,11539,7663,3876,2022-01-01,zipcode,Big spring
ZCTA5 79730,48,104,-666666666,-666666666,31100,58,31,44,22,15,7,0,0,66,31,35,31,31,0,2022-01-01,zipcode,Coyanosa
ZCTA5 79731,48,4387,71818,913,118000,3409,1252,2772,698,1061,579,311,123,1733,1614,119,1614,1371,243,2022-01-01,zipcode,Crane
ZCTA5 79733,48,397,73333,385,-666666666,268,80,260,7,74,154,19,6,116,116,0,116,50,66,2022-01-01,zipcode,Forsan
ZCTA5 79734,48,1859,43646,1113,170900,1594,896,1501,199,316,572,163,251,1696,1021,675,1021,904,117,2022-01-01,zipcode,Fort davis
ZCTA5 79735,48,13056,59167,983,141600,10358,5046,9174,2284,3520,2408,541,421,4922,4380,542,4380,3091,1289,2022-01-01,zipcode,Fort stockton
ZCTA5 79738,48,326,80179,-666666666,-666666666,227,104,183,10,30,30,75,38,107,87,20,87,63,24,2022-01-01,zipcode,Gail
ZCTA5 79739,48,939,125125,-666666666,260300,733,333,630,93,94,200,186,57,395,349,46,349,203,146,2022-01-01,zipcode,Garden city
ZCTA5 79741,48,380,100274,-666666666,208800,276,121,247,31,52,120,30,14,148,133,15,133,112,21,2022-01-01,zipcode,Goldsmith
ZCTA5 79742,48,419,75156,650,91800,305,114,232,83,69,38,22,20,223,189,34,189,161,28,2022-01-01,zipcode,Grandfalls
ZCTA5 79743,48,267,105385,-666666666,85500,206,68,181,10,53,63,32,23,146,98,48,98,69,29,2022-01-01,zipcode,Imperial
ZCTA5 79744,48,1749,54063,1179,185100,1157,493,921,162,160,412,141,46,664,562,102,562,344,218,2022-01-01,zipcode,Iraan
ZCTA5 79745,48,6561,85083,919,108300,4966,2040,4060,1263,1483,999,247,68,2781,2336,445,2336,1944,392,2022-01-01,zipcode,Kermit
ZCTA5 79748,48,536,80809,-666666666,-666666666,435,124,258,123,92,22,21,0,118,99,19,99,61,38,2022-01-01,zipcode,Knott
ZCTA5 79749,48,578,-666666666,805,153900,439,165,385,52,179,98,38,18,246,239,7,239,100,139,2022-01-01,zipcode,Lenorah
ZCTA5 79752,48,2000,45625,1164,83900,1467,634,1347,284,708,259,34,62,1060,809,251,809,634,175,2022-01-01,zipcode,Mc camey
ZCTA5 79754,48,96,-666666666,-666666666,218800,68,29,63,2,10,51,0,0,55,40,15,40,12,28,2022-01-01,zipcode,Mentone
ZCTA5 79755,48,72,136635,-666666666,-666666666,46,8,46,0,10,22,14,0,35,23,12,23,7,16,2022-01-01,zipcode,Midkiff
ZCTA5 79756,48,9632,72101,1109,131000,7208,2563,6174,1230,2182,2059,548,155,4297,3563,734,3563,2818,745,2022-01-01,zipcode,Monahans
ZCTA5 79758,48,2540,130489,-666666666,371100,1847,519,1685,128,433,790,232,102,974,915,59,915,819,96,2022-01-01,zipcode,Gardendale
ZCTA5 79759,48,0,-666666666,-666666666,-666666666,0,0,0,0,0,0,0,0,0,0,0,0,0,0,2022-01-01,zipcode,Notrees
ZCTA5 79761,48,31521,66593,1229,139900,23275,7206,18140,4774,4765,6120,1719,762,13893,12754,1139,12754,7234,5520,2022-01-01,zipcode,Odessa
ZCTA5 79762,48,39649,76569,1322,208400,29338,8438,23839,3250,7221,8476,3498,1394,16918,15263,1655,15263,8716,6547,2022-01-01,zipcode,Odessa
ZCTA5 79763,48,35940,54668,1085,116900,26150,10549,22187,7301,7330,5459,1510,587,15217,13638,1579,13638,9676,3962,2022-01-01,zipcode,Odessa
ZCTA5 79764,48,25907,77249,933,156100,18710,5398,15362,3654,4749,3839,1750,1370,9880,9097,783,9097,6450,2647,2022-01-01,zipcode,Odessa
ZCTA5 79765,48,21210,96260,1514,292900,15372,4161,12975,1013,3637,4558,2448,1319,8614,8132,482,8132,5188,2944,2022-01-01,zipcode,Odessa
ZCTA5 79766,48,11822,71346,1065,166300,8274,3741,6833,2944,1815,1512,502,60,3531,3460,71,3460,2725,735,2022-01-01,zipcode,Odessa
ZCTA5 79770,48,0,-666666666,-666666666,-666666666,0,0,0,0,0,0,0,0,19,0,19,0,0,0,2022-01-01,zipcode,Orla
ZCTA5 79772,48,13305,57474,950,110300,10502,4118,8587,2547,3024,2131,703,182,4645,3896,749,3896,2930,966,2022-01-01,zipcode,Pecos
ZCTA5 79777,48,138,-666666666,-666666666,192500,103,32,95,11,37,12,17,18,74,51,23,51,42,9,2022-01-01,zipcode,Pyote
ZCTA5 79778,48,1202,68883,519,113500,939,392,792,178,241,278,93,2,573,523,50,523,402,121,2022-01-01,zipcode,Rankin
ZCTA5 79780,48,77,-666666666,-666666666,-666666666,77,18,77,11,34,32,0,0,38,18,20,18,7,11,2022-01-01,zipcode,Saragosa
ZCTA5 79781,48,65,65972,-666666666,-666666666,65,27,65,0,37,16,0,12,73,46,27,46,46,0,2022-01-01,zipcode,Sheffield
ZCTA5 79782,48,3972,73295,1022,123400,2944,903,2267,386,874,570,234,203,1742,1481,261,1481,954,527,2022-01-01,zipcode,Stanton
ZCTA5 79783,48,90,158500,-666666666,-666666666,69,4,58,8,11,31,0,8,45,32,13,32,24,8,2022-01-01,zipcode,Tarzan
ZCTA5 79785,48,30,-666666666,-666666666,49300,30,18,30,21,9,0,0,0,43,13,30,13,13,0,2022-01-01,zipcode,Toyah
ZCTA5 79788,48,798,71014,750,75500,535,157,474,49,311,81,32,1,335,317,18,317,293,24,2022-01-01,zipcode,Wickett
ZCTA5 79789,48,1021,111875,183,117800,716,183,615,24,214,267,103,7,429,349,80,349,295,54,2022-01-01,zipcode,Wink
ZCTA5 79821,48,6678,55047,977,145000,5281,2739,4472,1099,1372,1465,378,158,2025,1842,183,1842,1461,381,2022-01-01,zipcode,Anthony
ZCTA5 79830,48,7912,50584,795,206800,6702,2517,6099,663,1038,1491,1622,1285,4895,4264,631,4264,2684,1580,2022-01-01,zipcode,Alpine
ZCTA5 79834,48,246,46462,777,-666666666,229,25,227,0,7,22,169,29,201,181,20,181,14,167,2022-01-01,zipcode,Big bend national park
ZCTA5 79835,48,12378,36778,905,95600,8879,3900,7528,2449,1893,2124,592,470,4443,3974,469,3974,2875,1099,2022-01-01,zipcode,Canutillo
ZCTA5 79836,48,7751,52129,907,99500,5450,2230,4388,1245,1221,1238,521,163,2536,2364,172,2364,1902,462,2022-01-01,zipcode,Clint
ZCTA5 79837,48,201,-666666666,-666666666,24700,182,53,182,31,25,45,81,0,213,107,106,107,33,74,2022-01-01,zipcode,Dell city
ZCTA5 79838,48,5470,36366,635,84000,4504,2011,3840,1573,1162,779,178,148,2312,1941,371,1941,1486,455,2022-01-01,zipcode,Fabens
ZCTA5 79839,48,1365,31863,497,57100,1129,539,741,374,277,64,17,9,549,446,103,446,301,145,2022-01-01,zipcode,Fort hancock
ZCTA5 79842,48,340,43064,421,115300,268,95,256,47,40,80,79,10,351,191,160,191,94,97,2022-01-01,zipcode,Marathon
ZCTA5 79843,48,2814,31452,391,215200,2329,685,2140,528,480,503,447,182,1838,1426,412,1426,1072,354,2022-01-01,zipcode,Marfa
ZCTA5 79845,48,3354,19650,391,81100,2208,1058,1654,928,189,361,121,55,1481,849,632,849,611,238,2022-01-01,zipcode,Presidio
ZCTA5 79846,48,0,-666666666,-666666666,-666666666,0,0,0,0,0,0,0,0,46,0,46,0,0,0,2022-01-01,zipcode,Redford
ZCTA5 79847,48,78,38864,-666666666,-666666666,78,74,78,1,30,41,4,2,68,40,28,40,34,6,2022-01-01,zipcode,Salt flat
ZCTA5 79848,48,801,55469,-666666666,107500,703,358,657,45,284,177,82,69,579,375,204,375,337,38,2022-01-01,zipcode,Sanderson
ZCTA5 79849,48,13200,43801,847,91700,9392,3998,7331,2774,2662,1397,410,88,4370,3853,517,3853,2687,1166,2022-01-01,zipcode,San elizario
ZCTA5 79851,48,1376,56563,854,-666666666,1252,1044,1042,581,205,178,78,0,194,163,31,163,115,48,2022-01-01,zipcode,Sierra blanca
ZCTA5 79852,48,531,43112,779,121400,450,217,441,82,92,166,72,29,390,254,136,254,176,78,2022-01-01,zipcode,Terlingua
ZCTA5 79853,48,3007,62167,964,83600,2471,1068,1974,883,477,409,191,14,979,902,77,902,824,78,2022-01-01,zipcode,Tornillo
ZCTA5 79854,48,133,30806,-666666666,73200,133,83,133,34,0,58,41,0,114,74,40,74,74,0,2022-01-01,zipcode,Valentine
ZCTA5 79855,48,2160,35326,918,82600,1847,813,1667,399,828,263,164,13,875,618,257,618,466,152,2022-01-01,zipcode,Van horn
ZCTA5 79901,48,8747,14142,502,84000,7293,4307,6154,3335,1272,1098,323,126,4551,3759,792,3759,267,3492,2022-01-01,zipcode,El paso
ZCTA5 79902,48,19108,39414,751,214400,16555,7082,13559,2684,2261,3847,2889,1878,9787,8591,1196,8591,3266,5325,2022-01-01,zipcode,El paso
ZCTA5 79903,48,15729,35750,843,115500,12707,6033,11032,3170,2585,3483,1426,368,6832,6137,695,6137,3623,2514,2022-01-01,zipcode,El paso
ZCTA5 79904,48,31634,38476,935,112300,24013,10136,18849,4145,5770,6359,1733,842,13142,11792,1350,11792,4760,7032,2022-01-01,zipcode,El paso
ZCTA5 79905,48,22133,24618,605,97000,17331,9205,13811,6054,3253,3348,919,237,9132,7984,1148,7984,3736,4248,2022-01-01,zipcode,El paso
ZCTA5 79906,48,5970,54326,1414,-666666666,3599,1023,2234,65,321,1023,501,324,1765,1482,283,1482,0,1482,2022-01-01,zipcode,El paso
ZCTA5 79907,48,49169,40962,864,102100,39002,16976,31698,9704,9901,8456,2807,830,17670,16466,1204,16466,9556,6910,2022-01-01,zipcode,El paso
ZCTA5 79908,48,4378,58929,1638,-666666666,2394,991,2061,76,437,1053,365,130,1139,1080,59,1080,0,1080,2022-01-01,zipcode,El paso
ZCTA5 79911,48,8844,116536,1453,280700,6628,2308,5614,120,805,1252,2191,1246,3338,3175,163,3175,2533,642,2022-01-01,zipcode,El paso
ZCTA5 79912,48,76890,71324,1134,228300,60777,20007,51584,4786,8938,12860,14713,10287,33320,29899,3421,29899,16546,13353,2022-01-01,zipcode,El paso
ZCTA5 79915,48,36737,35278,755,109800,28478,13413,23936,7933,7076,5931,2517,479,14253,13099,1154,13099,7766,5333,2022-01-01,zipcode,El paso
ZCTA5 79916,48,3395,-666666666,-666666666,-666666666,3395,301,999,7,264,550,152,26,0,0,0,0,0,0,2022-01-01,zipcode,Fort bliss
ZCTA5 79920,48,33,-666666666,-666666666,-666666666,33,0,15,0,0,15,0,0,0,0,0,0,0,0,2022-01-01,zipcode,
ZCTA5 79922,48,6796,90278,1313,286800,5554,2121,4862,385,939,1013,1625,900,3150,2644,506,2644,2296,348,2022-01-01,zipcode,El paso
ZCTA5 79924,48,60667,53555,985,122600,47311,19197,38027,7313,10610,13294,4862,1948,22587,21219,1368,21219,13069,8150,2022-01-01,zipcode,El paso
ZCTA5 79925,48,40001,55357,969,167400,31199,10339,25747,3693,5908,8675,4728,2743,16218,15076,1142,15076,7679,7397,2022-01-01,zipcode,El paso
ZCTA5 79927,48,42241,46581,992,112300,32795,12744,26797,8568,8695,6979,1965,590,13879,13243,636,13243,10542,2701,2022-01-01,zipcode,El paso
ZCTA5 79928,48,79330,67016,1020,167000,55890,18208,43428,7495,10767,14849,7573,2744,23786,22317,1469,22317,19824,2493,2022-01-01,zipcode,El paso
ZCTA5 79930,48,25899,41953,845,117300,21116,7693,16571,4544,4398,4737,1999,893,11971,10138,1833,10138,4516,5622,2022-01-01,zipcode,El paso
ZCTA5 79932,48,29269,80383,958,233500,22446,7854,18499,2288,3193,5438,4731,2849,11113,10154,959,10154,7288,2866,2022-01-01,zipcode,El paso
ZCTA5 79934,48,26620,77010,1352,179800,20124,5827,16158,1227,2939,6214,3768,2010,10696,9513,1183,9513,6293,3220,2022-01-01,zipcode,El paso
ZCTA5 79935,48,18815,62018,1032,172600,14919,5293,12201,1818,3213,3818,2354,998,7046,6537,509,6537,3436,3101,2022-01-01,zipcode,El paso
ZCTA5 79936,48,107512,60981,1133,156400,84836,29423,68767,9799,16187,23895,13527,5359,36834,35900,934,35900,23926,11974,2022-01-01,zipcode,El paso
ZCTA5 79938,48,95452,70806,1235,180800,66292,20708,53185,7685,11491,18922,10422,4665,28941,27649,1292,27649,22322,5327,2022-01-01,zipcode,El paso
