name,state,total_population,median_household_income,gross_rent,median_home_value,total_in_labor_workforce,total_not_in_labor_workforce,total_education,education_no_hs,education_hs,education_associates,education_bachelors,education_graduate,total_occupancy_status,occupancy_status_occupied,occupancy_status_vacant,total_home_tenure,home_tenure_owner_occupied,home_tenure_renter_occupied,reporting_date,region_type
Alabama,01,4864680,48486,772,137200,3894696,1657532,3299958,470043,1020172,987148,515443,307152,2244462,1860269,384193,1860269,1275223,585046,2018-01-01,state
Alabama,01,4876250,50536,792,142700,3907144,1664359,3320877,458922,1022839,993344,529178,316594,2255026,1867893,387133,1867893,1284748,583145,2019-01-01,state
Alabama,01,4893186,52035,811,149600,3926842,1666862,3344006,438947,1014342,1013673,546674,330370,2270398,1888504,381894,1888504,1306505,581999,2020-01-01,state
Alabama,01,4997675,54943,852,157100,4005499,1691883,3413803,430047,1041209,1032122,563628,346797,2278526,1902983,375543,1902983,1320571,582412,2021-01-01,state
Alabama,01,5028092,59609,925,179400,4046614,1701528,3428520,421180,1041725,1032770,572252,360593,2296920,1933150,363770,1933150,1347792,585358,2022-01-01,state
Florida,12,20598139,53267,1128,196800,16932309,7000510,14686727,1769489,4231678,4402103,2721635,1561822,9348689,7621760,1726929,7621760,4954601,2667159,2018-01-01,state
Florida,12,20901636,55660,1175,215300,17201999,7085973,14965745,1767583,4276237,4450224,2827938,1643763,9448159,7736311,1711848,7736311,5058841,2677470,2019-01-01,state
Florida,12,21216924,57703,1218,232000,17486583,7178515,15255326,1751798,4308542,4535040,2938593,1721353,9562324,7931313,1631011,7931313,5250878,2680435,2020-01-01,state
Florida,12,21339762,61777,1301,248700,17577024,7128734,15349290,1682505,4282929,4543900,3038293,1801663,9764897,8157420,1607477,8157420,5420631,2736789,2021-01-01,state
Florida,12,21634529,67917,1444,292200,17893588,7263895,15579847,1670872,4316799,4554710,3154240,1883226,9915957,8353441,1562516,8353441,5585924,2767517,2022-01-01,state
ZCTA5 32003,12,28531,91287,1500,255800,23012,8128,19401,564,4001,6239,5733,2864,10840,10292,548,10292,8116,2176,2018-01-01,zipcode
ZCTA5 32008,12,4538,40573,691,83100,3850,1558,3493,581,1512,1092,261,47,2782,1853,929,1853,1485,368,2018-01-01,zipcode
ZCTA5 32009,12,3821,69821,1194,158400,3101,926,2512,257,1077,890,258,30,1370,1217,153,1217,1068,149,2018-01-01,zipcode
ZCTA5 32011,12,13805,61038,775,170800,11169,4265,9640,1162,4171,2938,983,386,5644,4999,645,4999,4115,884,2018-01-01,zipcode
ZCTA5 32024,12,19378,51607,907,118500,15462,6724,13464,1680,4946,4506,1674,658,8007,7045,962,7045,5930,1115,2018-01-01,zipcode
ZCTA5 32025,12,22374,44904,836,115900,18416,10064,14998,2245,5306,5188,1400,859,8935,7533,1402,7533,4569,2964,2018-01-01,zipcode
ZCTA5 32026,12,1907,-666666666,-666666666,-666666666,1907,1907,1784,883,618,213,57,13,0,0,0,0,0,0,2018-01-01,zipcode
ZCTA5 32033,12,4660,52419,1306,179800,4130,1937,3499,422,1028,1359,398,292,2030,1792,238,1792,1428,364,2018-01-01,zipcode
ZCTA5 32034,12,34928,71476,1141,310700,29919,13649,27453,1503,6510,7877,6647,4916,20037,15074,4963,15074,11444,3630,2018-01-01,zipcode
ZCTA5 32038,12,10103,40534,873,101400,8269,4133,7473,912,2754,2755,600,452,4623,3887,736,3887,3339,548,2018-01-01,zipcode
ZCTA5 32040,12,7570,59604,829,117300,5833,2337,4915,571,2375,1217,631,121,2921,2465,456,2465,2104,361,2018-01-01,zipcode
ZCTA5 32043,12,24952,62317,984,180700,19994,8483,17462,1985,5837,6138,2346,1156,9917,9032,885,9032,6723,2309,2018-01-01,zipcode
ZCTA5 32044,12,1824,46250,-666666666,71500,1505,732,1313,251,487,371,177,27,1115,764,351,764,615,149,2018-01-01,zipcode
ZCTA5 32046,12,9426,57445,885,135500,7642,3525,6606,897,3004,2189,346,170,3779,3341,438,3341,2576,765,2018-01-01,zipcode
ZCTA5 32052,12,9704,36486,575,72500,8365,5565,7059,1755,3211,1641,322,130,3451,2720,731,2720,1824,896,2018-01-01,zipcode
ZCTA5 32053,12,3139,36034,874,67600,2327,1372,1992,461,821,423,241,46,1514,1088,426,1088,835,253,2018-01-01,zipcode
ZCTA5 32054,12,11724,41566,604,108100,9655,6029,8472,1836,3286,2577,562,211,3987,3476,511,3476,2471,1005,2018-01-01,zipcode
ZCTA5 32055,12,17114,40173,803,117700,13461,6190,11836,1741,4320,4035,1159,581,6943,6165,778,6165,4215,1950,2018-01-01,zipcode
ZCTA5 32058,12,4585,38500,785,102100,3866,2526,3225,867,1465,730,106,57,1488,1210,278,1210,935,275,2018-01-01,zipcode
ZCTA5 32059,12,2465,44792,778,83700,1918,931,1760,299,674,691,81,15,1241,974,267,974,849,125,2018-01-01,zipcode
ZCTA5 32060,12,23768,40619,779,105300,18642,9414,16329,3068,6348,4530,1693,690,9898,8093,1805,8093,5884,2209,2018-01-01,zipcode
ZCTA5 32061,12,457,83125,-666666666,188000,377,161,248,91,98,32,27,0,122,104,18,104,84,20,2018-01-01,zipcode
ZCTA5 32062,12,2085,50990,434,87500,1893,1000,1583,189,691,344,213,146,1100,757,343,757,684,73,2018-01-01,zipcode
ZCTA5 32063,12,13840,64643,734,152100,10855,5082,9548,1351,3600,3238,784,575,5145,4512,633,4512,3115,1397,2018-01-01,zipcode
ZCTA5 32064,12,6888,39827,645,88700,5859,2290,4940,1010,1541,1327,697,365,3019,2354,665,2354,1196,1158,2018-01-01,zipcode
ZCTA5 32065,12,37160,69791,1208,185100,28162,9080,24168,1812,7132,8579,4248,2397,13170,12373,797,12373,9135,3238,2018-01-01,zipcode
ZCTA5 32066,12,7664,39726,534,110500,6182,3906,5294,1418,2140,899,392,445,2415,1753,662,1753,1383,370,2018-01-01,zipcode
ZCTA5 32068,12,57226,59722,1170,153600,44405,16264,37988,3791,14417,13371,4707,1702,21170,19383,1787,19383,14768,4615,2018-01-01,zipcode
ZCTA5 32071,12,3856,40852,709,114800,2942,1399,2409,378,1003,761,221,46,1599,1263,336,1263,949,314,2018-01-01,zipcode
ZCTA5 32072,12,299,-666666666,-666666666,61400,299,58,202,0,76,56,70,0,158,120,38,120,120,0,2018-01-01,zipcode
ZCTA5 32073,12,41863,57201,1046,166800,33899,12380,29066,2428,8497,11379,4855,1907,16568,15574,994,15574,10058,5516,2018-01-01,zipcode
ZCTA5 32079,12,461,39097,1336,92500,461,439,461,43,87,60,155,116,298,239,59,239,20,219,2018-01-01,zipcode
ZCTA5 32080,12,21943,73350,1172,352300,19578,9438,17272,603,3306,4564,4912,3887,15670,9535,6135,9535,7128,2407,2018-01-01,zipcode
ZCTA5 32081,12,13266,115250,1689,371300,9710,3844,8616,43,1078,2385,2989,2121,4941,4374,567,4374,3574,800,2018-01-01,zipcode
ZCTA5 32082,12,30898,107717,1400,489400,26037,11197,23186,426,2950,5781,8493,5536,15558,12745,2813,12745,10339,2406,2018-01-01,zipcode
ZCTA5 32083,12,3563,37647,738,100500,3181,2716,2906,769,1122,864,114,37,597,492,105,492,310,182,2018-01-01,zipcode
ZCTA5 32084,12,34892,48691,971,187800,29535,11716,24521,2617,7992,7148,4766,1998,15723,12861,2862,12861,8226,4635,2018-01-01,zipcode
ZCTA5 32086,12,29568,56647,1132,214000,25466,11170,22370,1451,5667,8525,4539,2188,13196,11586,1610,11586,8626,2960,2018-01-01,zipcode
ZCTA5 32087,12,5979,46825,805,75500,4739,2940,3897,948,1854,784,220,91,1619,1468,151,1468,1125,343,2018-01-01,zipcode
ZCTA5 32091,12,15311,44211,817,86300,12042,5699,10684,1881,4214,3486,829,274,6721,5619,1102,5619,3497,2122,2018-01-01,zipcode
ZCTA5 32092,12,34642,89018,1708,270200,26400,9322,24337,1648,5059,7379,6577,3674,13572,11984,1588,11984,10424,1560,2018-01-01,zipcode
ZCTA5 32094,12,2254,43750,-666666666,70700,2015,1338,1924,267,1019,454,125,59,1233,910,323,910,786,124,2018-01-01,zipcode
ZCTA5 32095,12,10006,66731,1180,257900,7669,3146,6924,437,1875,1936,1690,986,3931,3784,147,3784,2905,879,2018-01-01,zipcode
ZCTA5 32096,12,2179,38033,508,93000,1852,997,1666,282,623,448,182,131,1348,1015,333,1015,762,253,2018-01-01,zipcode
ZCTA5 32097,12,18518,67279,1206,185100,14616,5427,12629,1244,4479,4009,2076,821,7129,6578,551,6578,5282,1296,2018-01-01,zipcode
ZCTA5 32102,12,2195,35051,1133,130100,2017,1184,1762,274,630,504,253,101,1819,1109,710,1109,893,216,2018-01-01,zipcode
ZCTA5 32110,12,8009,34188,758,116900,6771,3508,5792,966,2576,1618,466,166,3577,2916,661,2916,1980,936,2018-01-01,zipcode
ZCTA5 32112,12,8054,36940,583,86200,6029,3277,5112,1642,1945,1058,328,139,3945,2849,1096,2849,2091,758,2018-01-01,zipcode
ZCTA5 32113,12,5366,35000,963,84500,4433,2265,3783,706,1797,1015,188,77,2697,1942,755,1942,1536,406,2018-01-01,zipcode
ZCTA5 32114,12,32923,25894,852,97300,27633,13895,21279,3402,6633,7173,2751,1320,16303,13528,2775,13528,4192,9336,2018-01-01,zipcode
ZCTA5 32117,12,24602,35690,935,89300,19946,8994,17518,2242,6890,5866,1777,743,12436,9823,2613,9823,5214,4609,2018-01-01,zipcode
ZCTA5 32118,12,17349,41278,911,219500,15775,8390,14615,1113,3869,4589,3225,1819,15818,9024,6794,9024,5737,3287,2018-01-01,zipcode
ZCTA5 32119,12,22398,38951,992,131900,19560,9302,16631,1794,5767,5666,2327,1077,11838,10021,1817,10021,6140,3881,2018-01-01,zipcode
ZCTA5 32124,12,5823,58125,1679,215600,5044,3063,4408,868,1458,958,622,502,1792,1598,194,1598,1318,280,2018-01-01,zipcode
ZCTA5 32127,12,30415,49903,1119,172900,26421,12675,23487,2227,7585,7717,3518,2440,16285,12777,3508,12777,9611,3166,2018-01-01,zipcode
ZCTA5 32128,12,19806,75787,1522,252300,16468,7603,14692,893,3140,4569,3839,2251,8993,7854,1139,7854,6692,1162,2018-01-01,zipcode
ZCTA5 32129,12,22149,44331,1102,130900,19230,8375,16608,1583,5595,6146,2426,858,10743,9722,1021,9722,6458,3264,2018-01-01,zipcode
ZCTA5 32130,12,5581,50341,1004,167700,4681,2188,4019,726,1439,1127,463,264,2344,1945,399,1945,1532,413,2018-01-01,zipcode
ZCTA5 32131,12,4560,41553,792,127700,3855,2181,3590,556,1495,935,344,260,2064,1736,328,1736,1270,466,2018-01-01,zipcode
ZCTA5 32132,12,7514,41224,875,132600,6504,3057,5933,537,2240,2363,431,362,3720,3302,418,3302,2570,732,2018-01-01,zipcode
ZCTA5 32133,12,34,-666666666,-666666666,-666666666,34,9,34,0,16,18,0,0,73,25,48,25,25,0,2018-01-01,zipcode
ZCTA5 32134,12,7376,34288,791,68600,6247,3840,5560,1024,2489,1540,269,238,5908,3050,2858,3050,2530,520,2018-01-01,zipcode
ZCTA5 32136,12,7933,52419,1070,234000,7137,4067,6808,418,1719,2295,1418,958,5426,3721,1705,3721,3036,685,2018-01-01,zipcode
ZCTA5 32137,12,43813,58155,1225,226800,37418,20992,33616,2363,10880,10865,5910,3598,22051,16689,5362,16689,13339,3350,2018-01-01,zipcode
ZCTA5 32139,12,854,29688,-666666666,70000,777,619,768,231,289,200,41,7,780,452,328,452,432,20,2018-01-01,zipcode
ZCTA5 32140,12,1393,51591,-666666666,60800,1277,562,1175,256,421,440,24,34,745,548,197,548,490,58,2018-01-01,zipcode
ZCTA5 32141,12,18828,50266,1039,148700,16060,8227,14486,1659,5811,4918,1213,885,8505,7379,1126,7379,5955,1424,2018-01-01,zipcode
ZCTA5 32145,12,5659,39295,849,83200,4415,1880,3812,706,1334,1339,245,188,2237,1875,362,1875,1510,365,2018-01-01,zipcode
ZCTA5 32147,12,556,-666666666,-666666666,22400,427,190,341,53,172,74,42,0,258,174,84,174,130,44,2018-01-01,zipcode
ZCTA5 32148,12,10450,31014,706,62100,7957,4676,6986,1375,3194,1826,376,215,5494,4043,1451,4043,2802,1241,2018-01-01,zipcode
ZCTA5 32157,12,202,51250,825,169300,188,122,158,0,77,45,21,15,256,106,150,106,64,42,2018-01-01,zipcode
ZCTA5 32159,12,30135,45198,1007,174900,27702,19149,26550,2165,9257,8496,3839,2793,18984,15267,3717,15267,12509,2758,2018-01-01,zipcode
ZCTA5 32162,12,54530,61654,1586,261400,53812,46326,53662,1739,13940,15984,12923,9076,36672,30152,6520,30152,28919,1233,2018-01-01,zipcode
ZCTA5 32164,12,45207,52466,1175,186000,37381,17690,33325,2697,11857,12028,4142,2601,18784,16303,2481,16303,11512,4791,2018-01-01,zipcode
ZCTA5 32168,12,27186,50557,1012,208500,23377,11835,21278,2158,6467,7286,3544,1823,13796,11549,2247,11549,8978,2571,2018-01-01,zipcode
ZCTA5 32169,12,10502,67245,1321,348000,9736,5594,9348,333,1900,3174,2295,1646,11742,5448,6294,5448,4207,1241,2018-01-01,zipcode
ZCTA5 32174,12,50869,52527,1032,203300,43898,21844,39793,2497,11321,14276,7405,4294,25016,22123,2893,22123,17208,4915,2018-01-01,zipcode
ZCTA5 32176,12,14629,46875,1143,214800,13216,7237,12168,784,3245,4158,2305,1676,10644,7090,3554,7090,5281,1809,2018-01-01,zipcode
ZCTA5 32177,12,26377,34645,711,87800,20815,9779,18366,3280,7901,4899,1507,779,11740,10138,1602,10138,6595,3543,2018-01-01,zipcode
ZCTA5 32179,12,8075,31626,725,66700,6736,3624,6112,981,2891,1528,406,306,4699,3333,1366,3333,2606,727,2018-01-01,zipcode
ZCTA5 32180,12,3934,46757,706,118300,2952,1372,2503,536,765,888,240,74,1499,1240,259,1240,976,264,2018-01-01,zipcode
ZCTA5 32181,12,2268,39018,913,92500,1813,1024,1525,246,531,452,197,99,1363,857,506,857,734,123,2018-01-01,zipcode
ZCTA5 32187,12,2186,37591,539,141500,1785,904,1545,221,594,581,124,25,778,733,45,733,568,165,2018-01-01,zipcode
ZCTA5 32189,12,5611,31712,860,68900,4882,2884,4374,796,1692,1370,454,62,4023,2557,1466,2557,2207,350,2018-01-01,zipcode
ZCTA5 32190,12,1089,32930,621,115100,929,396,780,246,355,109,53,17,482,371,111,371,269,102,2018-01-01,zipcode
ZCTA5 32193,12,718,35433,629,110500,597,395,526,79,266,120,34,27,638,329,309,329,239,90,2018-01-01,zipcode
ZCTA5 32195,12,2986,44375,1306,121300,2585,1153,2256,271,887,800,225,73,1438,1229,209,1229,1069,160,2018-01-01,zipcode
ZCTA5 32202,12,6165,26250,600,117000,5920,4432,4937,1326,1468,1147,624,372,2280,1793,487,1793,187,1606,2018-01-01,zipcode
ZCTA5 32204,12,7507,40483,944,152600,6622,2299,5542,592,1223,1347,1463,917,4499,3825,674,3825,1070,2755,2018-01-01,zipcode
ZCTA5 32205,12,29499,44546,897,146700,23730,7711,21259,2608,5660,6769,4020,2202,14754,13074,1680,13074,6145,6929,2018-01-01,zipcode
ZCTA5 32206,12,16500,26565,788,78700,13451,5963,11629,2536,4084,3382,1055,572,8911,6767,2144,6767,2801,3966,2018-01-01,zipcode
ZCTA5 32207,12,35917,47115,897,157200,28121,8987,24776,3866,6292,7063,4807,2748,16727,14740,1987,14740,7081,7659,2018-01-01,zipcode
ZCTA5 32208,12,32194,35898,922,76100,25484,11128,22032,3784,8385,7235,1919,709,14649,12336,2313,12336,7022,5314,2018-01-01,zipcode
ZCTA5 32209,12,35436,24664,768,56300,26442,12768,22575,4841,10104,5632,1371,627,17101,13207,3894,13207,6182,7025,2018-01-01,zipcode
ZCTA5 32210,12,61496,45006,943,118000,47378,15982,40660,5176,13048,14434,5487,2515,27063,23548,3515,23548,12417,11131,2018-01-01,zipcode
ZCTA5 32211,12,34607,39375,854,118100,26541,8674,22020,3008,7439,7607,2778,1188,14824,13258,1566,13258,5842,7416,2018-01-01,zipcode
ZCTA5 32212,12,2499,45119,1605,-666666666,2027,70,548,12,115,337,45,39,256,248,8,248,0,248,2018-01-01,zipcode
ZCTA5 32216,12,38073,52100,1039,152200,31046,11160,26781,3120,7048,7978,5991,2644,17780,15592,2188,15592,7469,8123,2018-01-01,zipcode
ZCTA5 32217,12,19411,44389,886,181400,16034,5633,14014,1375,3480,4176,3278,1705,9391,8377,1014,8377,4358,4019,2018-01-01,zipcode
ZCTA5 32218,12,61846,53969,1036,157600,48284,18340,40140,4096,12871,14722,6285,2166,23613,21429,2184,21429,13228,8201,2018-01-01,zipcode
ZCTA5 32219,12,11931,50865,916,131600,10156,3999,8504,1156,3304,3084,691,269,4760,4115,645,4115,3354,761,2018-01-01,zipcode
ZCTA5 32220,12,13179,54253,958,133700,10206,3810,8861,1226,3738,2445,967,485,5268,4627,641,4627,3696,931,2018-01-01,zipcode
ZCTA5 32221,12,30227,61924,1260,155200,23078,8274,19513,2560,6897,6363,2736,957,10850,10050,800,10050,7487,2563,2018-01-01,zipcode
ZCTA5 32222,12,9772,60861,1214,174800,7350,2511,6214,561,1451,2833,968,401,4133,3304,829,3304,2322,982,2018-01-01,zipcode
ZCTA5 32223,12,24039,79878,1156,257900,20047,7111,17824,735,3442,6113,4692,2842,10146,9566,580,9566,7893,1673,2018-01-01,zipcode
ZCTA5 32224,12,43751,76546,1279,284300,34932,12141,27562,1359,5167,8280,8319,4437,17585,15868,1717,15868,9322,6546,2018-01-01,zipcode
ZCTA5 32225,12,54496,75517,1284,211700,43613,13360,37470,2432,9398,12326,8953,4361,21797,19956,1841,19956,13946,6010,2018-01-01,zipcode
ZCTA5 32226,12,16013,77368,1641,209100,12256,4263,10667,1013,3121,3699,2000,834,6330,5544,786,5544,4625,919,2018-01-01,zipcode
ZCTA5 32227,12,3087,51750,1574,-666666666,2238,289,930,15,209,521,109,76,589,411,178,411,4,407,2018-01-01,zipcode
ZCTA5 32228,12,368,-666666666,-666666666,-666666666,368,0,84,0,9,56,19,0,0,0,0,0,0,0,2018-01-01,zipcode
ZCTA5 32233,12,24473,62713,1140,254200,21097,6275,17786,1242,4489,5600,4103,2352,11079,9518,1561,9518,5510,4008,2018-01-01,zipcode
ZCTA5 32234,12,5780,52449,869,107000,4792,1641,4228,829,1815,1171,305,108,2526,2183,343,2183,1624,559,2018-01-01,zipcode
ZCTA5 32244,12,60712,52928,1060,122700,46736,15027,39276,4236,12070,14956,5682,2332,24471,21611,2860,21611,12839,8772,2018-01-01,zipcode
ZCTA5 32246,12,51275,57507,1180,166200,41645,12205,36112,3302,9277,12382,8020,3131,22446,20148,2298,20148,10777,9371,2018-01-01,zipcode
ZCTA5 32250,12,26956,79125,1283,343500,22881,7161,20789,956,3167,5617,6776,4273,14720,12378,2342,12378,8408,3970,2018-01-01,zipcode
ZCTA5 32254,12,13039,31141,896,60100,9659,4353,8362,1754,3585,2427,479,117,5868,4624,1244,4624,2248,2376,2018-01-01,zipcode
ZCTA5 32256,12,45688,62235,1173,263200,38196,11159,32411,1552,5540,9482,9674,6163,22815,20410,2405,20410,7535,12875,2018-01-01,zipcode
ZCTA5 32257,12,38651,58246,1054,194900,31542,10515,28072,2253,7146,8672,6924,3077,16966,15517,1449,15517,9449,6068,2018-01-01,zipcode
ZCTA5 32258,12,31990,80207,1377,226300,24857,6404,22771,674,4018,7628,6547,3904,13383,12186,1197,12186,8483,3703,2018-01-01,zipcode
ZCTA5 32259,12,49969,114033,1805,336500,37388,12392,32135,671,5428,8659,11312,6065,16664,15732,932,15732,13557,2175,2018-01-01,zipcode
ZCTA5 32266,12,7080,89500,1243,381400,5980,1853,4992,142,824,1422,1505,1099,3401,2924,477,2924,2003,921,2018-01-01,zipcode
ZCTA5 32277,12,32029,49474,993,157500,25002,7785,20651,1784,6035,7773,3829,1230,13294,11913,1381,11913,6198,5715,2018-01-01,zipcode
ZCTA5 32301,12,30712,42165,978,149700,26643,8200,17994,1276,3366,5685,4418,3249,15536,12947,2589,12947,4146,8801,2018-01-01,zipcode
ZCTA5 32303,12,50436,48338,1017,148000,42213,11565,31068,1910,6046,10217,7968,4927,23497,21112,2385,21112,10373,10739,2018-01-01,zipcode
ZCTA5 32304,12,47787,23438,915,90500,44553,17687,14258,2171,3085,4923,2350,1729,20391,16535,3856,16535,2187,14348,2018-01-01,zipcode
ZCTA5 32305,12,20659,39723,836,100000,15868,6504,12850,1709,4287,4183,1781,890,9190,7789,1401,7789,4805,2984,2018-01-01,zipcode
ZCTA5 32308,12,22441,61260,1054,220200,18652,6416,16197,573,2144,4111,4561,4808,11188,10318,870,10318,5672,4646,2018-01-01,zipcode
ZCTA5 32309,12,31610,80544,1110,252700,24991,8810,22004,521,3109,5855,6857,5662,13034,12391,643,12391,9741,2650,2018-01-01,zipcode
ZCTA5 32310,12,15864,36653,841,96500,12718,5550,8945,1159,3482,2467,1216,621,7761,5662,2099,5662,2719,2943,2018-01-01,zipcode
ZCTA5 32311,12,21038,73731,1179,194900,16979,5351,14650,757,2792,3740,3917,3444,9112,8139,973,8139,5054,3085,2018-01-01,zipcode
ZCTA5 32312,12,32864,97594,1261,293300,26299,8703,22203,463,2492,5419,7639,6190,13469,12683,786,12683,10376,2307,2018-01-01,zipcode
ZCTA5 32317,12,14665,92598,1445,250600,11536,3667,9844,280,1707,2368,3199,2290,5689,5333,356,5333,4837,496,2018-01-01,zipcode
ZCTA5 32320,12,3832,49167,692,139200,3122,1270,2786,626,903,832,250,175,2112,1512,600,1512,1028,484,2018-01-01,zipcode
ZCTA5 32321,12,6277,34792,577,57400,5489,3618,4505,958,2197,907,264,179,2534,1616,918,1616,1182,434,2018-01-01,zipcode
ZCTA5 32322,12,4152,35116,735,128900,3606,2705,3290,744,1274,870,262,140,1981,1132,849,1132,901,231,2018-01-01,zipcode
ZCTA5 32323,12,422,42554,-666666666,49000,334,197,334,65,142,50,27,50,451,155,296,155,124,31,2018-01-01,zipcode
ZCTA5 32324,12,4726,32614,663,81200,3981,2632,3531,980,1259,878,283,131,1993,1673,320,1673,1061,612,2018-01-01,zipcode
ZCTA5 32327,12,28319,64221,857,147800,22965,10299,20458,2383,7501,6803,2440,1331,11094,9616,1478,9616,7734,1882,2018-01-01,zipcode
ZCTA5 32328,12,3032,45357,884,157300,2624,1183,2258,298,781,626,344,209,3101,1274,1827,1274,1025,249,2018-01-01,zipcode
ZCTA5 32330,12,828,41250,781,76000,519,275,492,125,202,122,33,10,339,280,59,280,149,131,2018-01-01,zipcode
ZCTA5 32331,12,4269,39312,685,76900,3578,1879,3035,591,1194,751,304,195,2013,1613,400,1613,1337,276,2018-01-01,zipcode
ZCTA5 32332,12,1315,31938,604,60300,1051,548,878,212,409,186,40,31,641,526,115,526,338,188,2018-01-01,zipcode
ZCTA5 32333,12,10506,47784,750,119800,9064,4438,8113,1381,2759,2168,1104,701,5503,4735,768,4735,3630,1105,2018-01-01,zipcode
ZCTA5 32334,12,2088,42218,586,139600,1678,814,1502,161,680,343,243,75,1052,765,287,765,611,154,2018-01-01,zipcode
ZCTA5 32336,12,1373,50506,-666666666,96400,1065,412,971,156,262,284,180,89,876,557,319,557,496,61,2018-01-01,zipcode
ZCTA5 32340,12,11294,34882,685,93000,9455,5745,8260,1685,3159,2150,738,528,4910,3896,1014,3896,2791,1105,2018-01-01,zipcode
ZCTA5 32343,12,3301,54526,903,137600,2420,580,2051,365,621,566,307,192,1402,1277,125,1277,963,314,2018-01-01,zipcode
ZCTA5 32344,12,12360,43485,772,120100,10676,5995,9638,1762,3302,2516,1265,793,5892,5023,869,5023,3830,1193,2018-01-01,zipcode
ZCTA5 32346,12,1769,44375,877,108100,1514,719,1303,320,379,445,130,29,1687,800,887,800,593,207,2018-01-01,zipcode
ZCTA5 32347,12,7795,42226,665,86000,6257,3063,5306,885,2047,1886,333,155,3644,2880,764,2880,2519,361,2018-01-01,zipcode
ZCTA5 32348,12,12673,33145,707,75900,10695,7327,9406,2515,4168,2083,481,159,4814,3664,1150,3664,2843,821,2018-01-01,zipcode
ZCTA5 32350,12,1184,36705,811,117400,1068,678,995,111,323,440,96,25,725,559,166,559,497,62,2018-01-01,zipcode
ZCTA5 32351,12,18643,36082,617,88200,14360,8220,12442,2933,4644,3192,1148,525,7225,6206,1019,6206,4165,2041,2018-01-01,zipcode
ZCTA5 32352,12,6698,46604,733,88600,5383,2288,4621,642,1862,1260,526,331,2763,2383,380,2383,1828,555,2018-01-01,zipcode
ZCTA5 32355,12,224,41250,1028,152500,181,65,164,12,56,55,34,7,159,100,59,100,84,16,2018-01-01,zipcode
ZCTA5 32356,12,91,-666666666,-666666666,-666666666,91,91,91,0,91,0,0,0,67,46,21,46,46,0,2018-01-01,zipcode
ZCTA5 32358,12,1889,56719,818,146500,1485,707,1374,93,417,521,260,83,1418,785,633,785,689,96,2018-01-01,zipcode
ZCTA5 32359,12,1162,38564,929,113600,1119,738,1119,223,573,293,23,7,2474,732,1742,732,477,255,2018-01-01,zipcode
ZCTA5 32361,12,256,54286,-666666666,82000,180,63,170,27,78,60,5,0,112,84,28,84,77,7,2018-01-01,zipcode
ZCTA5 32399,12,0,-666666666,-666666666,-666666666,0,0,0,0,0,0,0,0,0,0,0,0,0,0,2018-01-01,zipcode
ZCTA5 32401,12,22566,37691,858,128500,18197,8356,16146,2734,5302,5127,1909,1074,11282,9323,1959,9323,4622,4701,2018-01-01,zipcode
ZCTA5 32403,12,3374,64875,1562,-666666666,2148,583,1410,35,148,505,455,267,1003,810,193,810,0,810,2018-01-01,zipcode
ZCTA5 32404,12,40029,50681,951,155100,31954,12715,27362,3029,9124,11175,2629,1405,17179,14384,2795,14384,9375,5009,2018-01-01,zipcode
ZCTA5 32405,12,32064,47988,1002,171500,25732,10097,22324,1717,7507,7513,3503,2084,14186,12496,1690,12496,7098,5398,2018-01-01,zipcode
ZCTA5 32407,12,10433,60908,1283,219400,9072,3050,7722,515,2237,2823,1452,695,7931,4503,3428,4503,2389,2114,2018-01-01,zipcode
ZCTA5 32408,12,18141,56740,1080,223000,14907,4713,12658,734,3566,4389,2754,1215,17382,7408,9974,7408,4612,2796,2018-01-01,zipcode
ZCTA5 32409,12,10191,55466,907,159100,8141,3240,7034,1080,2317,2772,658,207,4168,3618,550,3618,3014,604,2018-01-01,zipcode
ZCTA5 32410,12,987,55417,1241,220800,956,547,935,32,239,332,187,145,1552,506,1046,506,386,120,2018-01-01,zipcode
ZCTA5 32413,12,14619,63477,1030,237600,12463,5058,11642,822,3245,3757,2718,1100,17644,6288,11356,6288,4561,1727,2018-01-01,zipcode
ZCTA5 32420,12,1983,31858,641,78500,1697,994,1515,403,590,412,77,33,1215,849,366,849,734,115,2018-01-01,zipcode
ZCTA5 32421,12,5256,44571,697,68100,4002,1649,3409,539,1370,1063,348,89,2208,1814,394,1814,1497,317,2018-01-01,zipcode
ZCTA5 32423,12,1025,70195,784,79200,864,425,791,76,232,387,82,14,540,425,115,425,375,50,2018-01-01,zipcode
ZCTA5 32424,12,7182,36176,642,86600,5963,4106,5425,1552,2242,1140,319,172,2638,1968,670,1968,1576,392,2018-01-01,zipcode
ZCTA5 32425,12,13480,37434,664,95200,11054,6626,9727,2193,3667,2867,677,323,5912,4672,1240,4672,3412,1260,2018-01-01,zipcode
ZCTA5 32426,12,914,29821,739,76800,744,408,592,170,235,123,34,30,463,349,114,349,296,53,2018-01-01,zipcode
ZCTA5 32427,12,926,24474,810,81500,826,479,681,236,259,119,26,41,497,406,91,406,337,69,2018-01-01,zipcode
ZCTA5 32428,12,17179,39990,764,117500,14256,8178,12610,2315,5052,3506,1226,511,7091,5585,1506,5585,4320,1265,2018-01-01,zipcode
ZCTA5 32430,12,1064,53000,-666666666,90000,923,325,768,62,367,271,61,7,617,420,197,420,366,54,2018-01-01,zipcode
ZCTA5 32431,12,3975,43520,659,85000,3231,1429,2821,622,1241,726,173,59,2219,1615,604,1615,1208,407,2018-01-01,zipcode
ZCTA5 32432,12,0,-666666666,-666666666,-666666666,0,0,0,0,0,0,0,0,0,0,0,0,0,0,2018-01-01,zipcode
ZCTA5 32433,12,17586,35575,762,104800,13997,7142,12290,2387,4878,3839,680,506,7495,6306,1189,6306,4439,1867,2018-01-01,zipcode
ZCTA5 32435,12,7325,44118,727,129900,5889,2413,5068,800,1837,1485,519,427,3804,2883,921,2883,2098,785,2018-01-01,zipcode
ZCTA5 32437,12,921,25536,-666666666,77500,591,263,556,43,322,178,12,1,379,304,75,304,203,101,2018-01-01,zipcode
ZCTA5 32438,12,3473,31496,464,74500,3037,1802,2650,450,1364,759,77,0,1978,1397,581,1397,1282,115,2018-01-01,zipcode
ZCTA5 32439,12,9964,54637,970,208500,8191,2775,7173,733,2147,2608,1191,494,4955,3953,1002,3953,2914,1039,2018-01-01,zipcode
ZCTA5 32440,12,7762,44014,649,110400,6751,4067,5705,1266,2210,1511,448,270,2427,2015,412,2015,1411,604,2018-01-01,zipcode
ZCTA5 32442,12,3132,39961,629,133500,2556,1086,2258,483,930,584,137,124,1734,1431,303,1431,1046,385,2018-01-01,zipcode
ZCTA5 32443,12,3322,34701,681,88500,2593,1188,2305,405,867,707,196,130,1720,1264,456,1264,997,267,2018-01-01,zipcode
ZCTA5 32444,12,21730,66822,1039,197100,17366,6262,14972,676,3803,5407,3016,2070,8934,8085,849,8085,6001,2084,2018-01-01,zipcode
ZCTA5 32445,12,2525,36838,719,86200,2239,1702,1944,663,747,397,102,35,600,475,125,475,332,143,2018-01-01,zipcode
ZCTA5 32446,12,11303,45596,696,146200,9504,5006,8169,1187,2536,2735,932,779,4725,3968,757,3968,2668,1300,2018-01-01,zipcode
ZCTA5 32447,12,161,-666666666,-666666666,-666666666,101,101,0,0,0,0,0,0,0,0,0,0,0,0,2018-01-01,zipcode
ZCTA5 32448,12,8480,26738,463,86100,6912,3295,6168,756,2464,2094,470,384,4680,3890,790,3890,2536,1354,2018-01-01,zipcode
ZCTA5 32449,12,637,38438,-666666666,73400,499,270,423,81,139,203,0,0,319,231,88,231,213,18,2018-01-01,zipcode
ZCTA5 32455,12,4514,40785,680,87400,3829,1685,3233,983,1190,736,216,108,2328,1723,605,1723,1308,415,2018-01-01,zipcode
ZCTA5 32456,12,8437,47770,1161,186600,6997,3032,6234,508,1896,2111,940,779,6409,3356,3053,3356,2403,953,2018-01-01,zipcode
ZCTA5 32459,12,15400,80335,1411,377700,12608,4397,11612,472,2004,3806,3918,1412,13987,6356,7631,6356,4917,1439,2018-01-01,zipcode
ZCTA5 32460,12,5831,40034,644,90800,5084,3526,4506,1010,1922,1232,259,83,1753,1463,290,1463,1090,373,2018-01-01,zipcode
ZCTA5 32461,12,34,-666666666,-666666666,-666666666,34,11,34,0,0,0,34,0,78,23,55,23,23,0,2018-01-01,zipcode
ZCTA5 32462,12,3641,37485,603,91000,3020,1178,2501,316,1180,813,139,53,1903,1395,508,1395,1051,344,2018-01-01,zipcode
ZCTA5 32463,12,171,-666666666,625,67500,126,50,104,21,40,43,0,0,69,65,4,65,37,28,2018-01-01,zipcode
ZCTA5 32464,12,4311,39755,449,79200,3584,1782,3213,861,1225,840,243,44,2179,1836,343,1836,1592,244,2018-01-01,zipcode
ZCTA5 32465,12,8179,39289,847,93100,7256,4802,6386,1381,2747,1680,449,129,3507,2237,1270,2237,1758,479,2018-01-01,zipcode
ZCTA5 32466,12,6450,53283,898,122400,5035,2218,4177,671,1637,1666,140,63,2416,2017,399,2017,1827,190,2018-01-01,zipcode
ZCTA5 32501,12,11557,30253,788,120500,9205,4748,7848,1356,2265,2436,1074,717,5315,4323,992,4323,2240,2083,2018-01-01,zipcode
ZCTA5 32502,12,3185,48316,988,139600,2567,904,2369,161,672,827,413,296,1782,1452,330,1452,795,657,2018-01-01,zipcode
ZCTA5 32503,12,34520,49416,888,153600,28448,10637,19951,1626,4688,6956,4049,2632,13470,11984,1486,11984,7416,4568,2018-01-01,zipcode
ZCTA5 32504,12,23080,49845,968,163800,17264,6237,14230,746,3074,5285,3003,2122,10163,9199,964,9199,5159,4040,2018-01-01,zipcode
ZCTA5 32505,12,24965,38214,876,63000,21106,8923,18725,2616,7598,6121,1578,812,13401,10926,2475,10926,5501,5425,2018-01-01,zipcode
ZCTA5 32506,12,36923,48783,1038,116700,28926,11527,24978,2792,6532,10214,3598,1842,16080,14117,1963,14117,7673,6444,2018-01-01,zipcode
ZCTA5 32507,12,31288,47605,943,151000,24607,9358,21407,1594,5155,8523,3751,2384,17706,12952,4754,12952,7339,5613,2018-01-01,zipcode
ZCTA5 32508,12,5381,39417,1256,-666666666,5068,467,939,13,125,413,335,53,632,505,127,505,0,505,2018-01-01,zipcode
ZCTA5 32509,12,702,-666666666,-666666666,-666666666,702,702,702,49,254,278,55,66,0,0,0,0,0,0,2018-01-01,zipcode
ZCTA5 32511,12,1034,-666666666,-666666666,-666666666,1034,42,64,0,8,35,21,0,0,0,0,0,0,0,2018-01-01,zipcode
ZCTA5 32514,12,44759,47175,982,137400,35746,13248,27576,2393,6760,9839,5942,2642,18816,16816,2000,16816,8411,8405,2018-01-01,zipcode
ZCTA5 32526,12,36300,58665,1066,127100,29815,12103,26635,1764,7239,10947,4564,2121,16100,14320,1780,14320,10724,3596,2018-01-01,zipcode
ZCTA5 32530,12,0,-666666666,-666666666,-666666666,0,0,0,0,0,0,0,0,0,0,0,0,0,0,2018-01-01,zipcode
ZCTA5 32531,12,5735,58650,1065,176700,4569,2145,4099,491,1509,1416,440,243,2699,2154,545,2154,1883,271,2018-01-01,zipcode
ZCTA5 32533,12,27632,71528,1066,162400,22931,9673,20194,1853,5486,6867,4354,1634,11394,10190,1204,10190,8449,1741,2018-01-01,zipcode
ZCTA5 32534,12,14524,49130,1059,112500,12471,4954,10955,659,3083,4670,1898,645,6827,6144,683,6144,4360,1784,2018-01-01,zipcode
ZCTA5 32535,12,5694,38917,693,77300,5156,3276,4658,921,2124,1225,290,98,2066,1818,248,1818,1168,650,2018-01-01,zipcode
ZCTA5 32536,12,23426,68599,1043,192400,17730,6354,14767,1150,3629,6133,2546,1309,9474,8459,1015,8459,5465,2994,2018-01-01,zipcode
ZCTA5 32539,12,29265,57757,956,153800,22422,10480,19463,2325,6197,7413,2612,916,10494,9400,1094,9400,6654,2746,2018-01-01,zipcode
ZCTA5 32541,12,18908,77609,1457,358900,15866,5046,14082,602,2933,4494,3746,2307,16570,8088,8482,8088,4957,3131,2018-01-01,zipcode
ZCTA5 32542,12,3081,48409,1442,-666666666,2316,234,1053,8,120,627,246,52,945,658,287,658,0,658,2018-01-01,zipcode
ZCTA5 32544,12,2003,-666666666,1436,-666666666,1412,112,570,6,44,336,126,58,338,311,27,311,0,311,2018-01-01,zipcode
ZCTA5 32547,12,33339,51335,1025,174500,27630,10219,23841,2610,6152,8290,4455,2334,15879,14518,1361,14518,6834,7684,2018-01-01,zipcode
ZCTA5 32548,12,21315,52883,994,175900,17743,6054,15670,1372,4013,6421,2289,1575,13200,9502,3698,9502,5363,4139,2018-01-01,zipcode
ZCTA5 32550,12,8490,64974,1208,360400,7322,3243,6725,167,889,2466,1978,1225,13550,3866,9684,3866,2732,1134,2018-01-01,zipcode
ZCTA5 32561,12,9305,103769,1413,394900,7743,2855,6896,194,926,1749,2216,1811,6465,3974,2491,3974,3165,809,2018-01-01,zipcode
ZCTA5 32563,12,25550,67546,1182,233800,20280,7341,17938,757,3950,6565,4097,2569,10890,9770,1120,9770,7460,2310,2018-01-01,zipcode
ZCTA5 32564,12,2931,75795,1159,168600,2291,978,2213,223,665,928,308,89,1203,1034,169,1034,848,186,2018-01-01,zipcode
ZCTA5 32565,12,4826,46233,909,114600,4166,1864,3693,320,1500,1219,512,142,2473,2089,384,2089,1647,442,2018-01-01,zipcode
ZCTA5 32566,12,38112,78368,1288,228000,29676,11034,25655,1306,6109,10313,5259,2668,17296,14019,3277,14019,10843,3176,2018-01-01,zipcode
ZCTA5 32567,12,3104,43094,740,121900,2430,1129,2221,326,845,790,167,93,1695,1309,386,1309,1067,242,2018-01-01,zipcode
ZCTA5 32568,12,2735,53854,938,150600,2211,869,2009,246,650,871,122,120,1212,1038,174,1038,846,192,2018-01-01,zipcode
ZCTA5 32569,12,12971,61976,1052,179800,10617,3234,8722,732,2263,3427,1500,800,5353,4915,438,4915,3367,1548,2018-01-01,zipcode
ZCTA5 32570,12,30768,57160,899,139200,24992,11144,21374,2190,6784,8069,3095,1236,13221,11658,1563,11658,8058,3600,2018-01-01,zipcode
ZCTA5 32571,12,35388,71494,1020,177200,27791,10258,23159,1642,6181,8368,4716,2252,13465,12210,1255,12210,9368,2842,2018-01-01,zipcode
ZCTA5 32577,12,4321,56619,713,137600,3686,1664,3213,279,920,1274,508,232,1936,1747,189,1747,1522,225,2018-01-01,zipcode
ZCTA5 32578,12,32833,82569,1168,268500,26000,9154,22756,869,3898,7572,6021,4396,13660,12436,1224,12436,9461,2975,2018-01-01,zipcode
ZCTA5 32579,12,10187,71988,1178,269200,8512,3446,7512,477,1568,2280,1775,1412,4649,4360,289,4360,2940,1420,2018-01-01,zipcode
ZCTA5 32580,12,4364,56581,1127,213100,3312,1103,2745,206,647,1190,402,300,1863,1497,366,1497,957,540,2018-01-01,zipcode
ZCTA5 32583,12,28585,57124,986,134700,24242,13067,21211,3602,6931,6869,2654,1155,9900,8558,1342,8558,6505,2053,2018-01-01,zipcode
ZCTA5 32601,12,18579,25481,838,147800,17153,6778,9266,565,2074,2432,2087,2108,9753,7628,2125,7628,2163,5465,2018-01-01,zipcode
ZCTA5 32603,12,7195,21992,839,266600,6947,4001,1529,20,135,237,368,769,2257,1718,539,1718,331,1387,2018-01-01,zipcode
ZCTA5 32605,12,24684,69102,1208,183000,20626,7006,17810,754,3035,4166,4576,5279,11245,10107,1138,10107,7183,2924,2018-01-01,zipcode
ZCTA5 32606,12,23766,67984,1220,205900,18775,6682,16078,617,2250,3944,4235,5032,10776,9160,1616,9160,4825,4335,2018-01-01,zipcode
ZCTA5 32607,12,30624,38521,929,205700,26652,9894,15760,811,3437,4559,3413,3540,15239,11911,3328,11911,4065,7846,2018-01-01,zipcode
ZCTA5 32608,12,48905,42424,975,226700,41600,15775,28957,1708,4539,6843,7743,8124,23752,19357,4395,19357,7730,11627,2018-01-01,zipcode
ZCTA5 32609,12,19906,33585,879,98300,16406,6957,13330,2210,3880,4289,1806,1145,8216,6894,1322,6894,3993,2901,2018-01-01,zipcode
ZCTA5 32612,12,7606,-666666666,-666666666,-666666666,7606,6082,27,0,6,16,0,5,5,5,0,5,0,5,2018-01-01,zipcode
ZCTA5 32615,12,14630,56662,1012,167700,11492,4276,10061,619,2413,3421,2186,1422,6464,5572,892,5572,4238,1334,2018-01-01,zipcode
ZCTA5 32616,12,1142,31250,722,86300,852,375,795,151,390,186,44,24,432,391,41,391,214,177,2018-01-01,zipcode
ZCTA5 32617,12,3937,42536,595,133800,3353,1505,2736,364,1099,840,201,232,1767,1491,276,1491,1226,265,2018-01-01,zipcode
ZCTA5 32618,12,8058,53987,730,157000,6587,2555,5556,815,1534,1638,875,694,3390,2871,519,2871,2355,516,2018-01-01,zipcode
ZCTA5 32619,12,5326,40963,763,88600,4303,1959,3512,503,1448,1097,348,116,2393,2037,356,2037,1726,311,2018-01-01,zipcode
ZCTA5 32621,12,5394,36368,642,74300,4356,2444,3817,807,1609,987,318,96,2555,2131,424,2131,1536,595,2018-01-01,zipcode
ZCTA5 32622,12,1004,66250,779,116000,779,367,739,103,262,213,93,68,485,371,114,371,320,51,2018-01-01,zipcode
ZCTA5 32625,12,1626,38571,774,138100,1288,583,1152,66,457,316,149,164,1230,680,550,680,505,175,2018-01-01,zipcode
ZCTA5 32626,12,8784,34039,672,93000,7023,3656,6210,1112,2577,1872,479,170,4476,3639,837,3639,2763,876,2018-01-01,zipcode
ZCTA5 32628,12,5040,38460,703,80100,4162,2896,3697,783,1803,839,205,67,1667,1333,334,1333,944,389,2018-01-01,zipcode
ZCTA5 32631,12,264,64901,-666666666,274500,253,169,253,0,8,102,46,97,149,149,0,149,149,0,2018-01-01,zipcode
ZCTA5 32639,12,123,25568,-666666666,46500,123,71,123,24,67,0,0,32,221,81,140,81,70,11,2018-01-01,zipcode
ZCTA5 32640,12,10790,44821,738,109300,9281,4626,8361,1446,3065,2328,806,716,5647,4317,1330,4317,3524,793,2018-01-01,zipcode
ZCTA5 32641,12,14989,36885,846,95900,11759,5510,9783,1722,3507,3201,890,463,5528,4715,813,4715,2804,1911,2018-01-01,zipcode
ZCTA5 32643,12,11207,56108,916,159600,9386,3945,8179,637,2483,3184,1167,708,4984,4339,645,4339,3600,739,2018-01-01,zipcode
ZCTA5 32648,12,570,74000,-666666666,160300,401,190,342,51,156,112,16,7,576,184,392,184,168,16,2018-01-01,zipcode
ZCTA5 32653,12,13168,65427,937,191400,10976,4179,9664,420,1716,3117,2337,2074,6166,5745,421,5745,4385,1360,2018-01-01,zipcode
ZCTA5 32656,12,14433,46256,900,105600,11868,5577,10311,1576,3689,3534,1145,367,6603,5473,1130,5473,4347,1126,2018-01-01,zipcode
ZCTA5 32658,12,376,46250,1125,99000,317,144,283,46,107,101,29,0,122,104,18,104,85,19,2018-01-01,zipcode
ZCTA5 32664,12,538,44821,900,108100,477,218,463,67,202,72,78,44,285,229,56,229,173,56,2018-01-01,zipcode
ZCTA5 32666,12,7147,47067,869,136100,6265,3278,5183,637,1947,1592,478,529,3464,2670,794,2670,2128,542,2018-01-01,zipcode
ZCTA5 32667,12,4090,52500,728,236200,3399,1508,2939,108,779,803,631,618,2002,1720,282,1720,1258,462,2018-01-01,zipcode
ZCTA5 32668,12,4700,39277,948,153500,4153,2294,3820,469,1650,1233,344,124,2507,2044,463,2044,1709,335,2018-01-01,zipcode
ZCTA5 32669,12,13098,69439,973,194900,9762,2959,8828,450,2137,2899,2170,1172,5433,4662,771,4662,3955,707,2018-01-01,zipcode
ZCTA5 32680,12,10111,36117,577,67700,8552,5379,7662,1615,3296,1930,521,300,5971,4550,1421,4550,3578,972,2018-01-01,zipcode
ZCTA5 32681,12,47,-666666666,-666666666,-666666666,47,32,47,0,47,0,0,0,31,31,0,31,31,0,2018-01-01,zipcode
ZCTA5 32683,12,140,14138,-666666666,-666666666,106,91,106,14,58,34,0,0,59,48,11,48,42,6,2018-01-01,zipcode
ZCTA5 32686,12,4764,36905,586,151300,3954,1911,3283,745,1097,787,394,260,2394,1871,523,1871,1338,533,2018-01-01,zipcode
ZCTA5 32692,12,274,-666666666,-666666666,-666666666,250,142,250,35,76,127,12,0,688,142,546,142,142,0,2018-01-01,zipcode
ZCTA5 32693,12,12186,37988,678,88100,9790,5153,8034,1324,3244,2379,798,289,5081,4405,676,4405,3451,954,2018-01-01,zipcode
ZCTA5 32694,12,2454,48816,535,119200,1882,706,1517,186,608,465,224,34,1095,838,257,838,603,235,2018-01-01,zipcode
ZCTA5 32696,12,12363,48982,752,136400,10144,4462,8923,1188,3609,2789,818,519,5495,4692,803,4692,3708,984,2018-01-01,zipcode
ZCTA5 32697,12,334,25357,805,180000,235,86,151,41,61,45,0,4,161,102,59,102,8,94,2018-01-01,zipcode
ZCTA5 32701,12,21997,54546,1120,162200,18656,6498,16679,875,3800,6180,4059,1765,11503,9633,1870,9633,4992,4641,2018-01-01,zipcode
ZCTA5 32702,12,2793,37470,2181,63400,2265,1397,1993,307,756,599,177,154,1622,1151,471,1151,768,383,2018-01-01,zipcode
ZCTA5 32703,12,50992,49742,1094,168500,40014,14175,34305,4867,10574,10285,6357,2222,19554,17678,1876,17678,10842,6836,2018-01-01,zipcode
ZCTA5 32707,12,35369,53373,1143,162400,29958,11385,26301,1596,6164,10939,5652,1950,16319,14371,1948,14371,9332,5039,2018-01-01,zipcode
ZCTA5 32708,12,44826,68774,1247,242000,37255,13682,32535,1695,6445,10522,9372,4501,18117,16702,1415,16702,12493,4209,2018-01-01,zipcode
ZCTA5 32709,12,1986,43462,-666666666,168900,1816,866,1701,308,551,485,207,150,895,818,77,818,724,94,2018-01-01,zipcode
ZCTA5 32712,12,46662,69726,1287,227000,36687,12212,32191,4463,8325,10441,5460,3502,17416,15659,1757,15659,12429,3230,2018-01-01,zipcode
ZCTA5 32713,12,20697,56002,1078,184600,17257,7901,15473,1028,5434,4706,3125,1180,9095,8297,798,8297,6960,1337,2018-01-01,zipcode
ZCTA5 32714,12,37223,51814,1185,188000,30715,9694,26865,1943,5279,9935,6647,3061,17289,14829,2460,14829,6978,7851,2018-01-01,zipcode
ZCTA5 32720,12,31819,44146,921,177600,26734,12922,22320,2342,6672,7810,3744,1752,14175,12478,1697,12478,8570,3908,2018-01-01,zipcode
ZCTA5 32724,12,36047,47182,1008,161800,30139,14778,25593,2377,8065,8357,4455,2339,15745,14210,1535,14210,9756,4454,2018-01-01,zipcode
ZCTA5 32725,12,48008,48830,1123,143100,39048,16871,34043,4119,11154,12929,4283,1558,18548,16693,1855,16693,12930,3763,2018-01-01,zipcode
ZCTA5 32726,12,22377,42208,846,145600,18165,7922,15635,2261,6211,4234,2050,879,9908,8657,1251,8657,5451,3206,2018-01-01,zipcode
ZCTA5 32730,12,5991,42772,1068,142400,5296,2134,4621,290,1186,1873,897,375,2738,2500,238,2500,988,1512,2018-01-01,zipcode
ZCTA5 32732,12,4809,83962,-666666666,302400,4254,1457,3612,88,850,1587,778,309,2157,1760,397,1760,1727,33,2018-01-01,zipcode
ZCTA5 32735,12,4673,58962,1160,129400,3729,1964,3627,402,1182,1411,393,239,2174,2038,136,2038,1792,246,2018-01-01,zipcode
ZCTA5 32736,12,9922,73430,1030,258200,8063,3335,7150,705,2160,2435,1189,661,3993,3370,623,3370,3050,320,2018-01-01,zipcode
ZCTA5 32738,12,45881,50446,1154,140000,36016,14427,30533,3114,11364,10981,4074,1000,16187,14994,1193,14994,11252,3742,2018-01-01,zipcode
ZCTA5 32744,12,3764,45510,985,156200,3171,1379,2899,335,1060,944,434,126,1752,1516,236,1516,1261,255,2018-01-01,zipcode
ZCTA5 32746,12,43232,80756,1397,289500,35553,12458,31386,1208,5229,9837,9531,5581,18812,16676,2136,16676,10674,6002,2018-01-01,zipcode
ZCTA5 32750,12,24389,71842,1195,220100,20510,6732,17912,987,4748,6243,4071,1863,9792,9033,759,9033,6357,2676,2018-01-01,zipcode
ZCTA5 32751,12,22073,71382,1280,284400,17851,6521,15195,470,2409,4200,5057,3059,9717,8481,1236,8481,5854,2627,2018-01-01,zipcode
ZCTA5 32754,12,10436,52463,821,161700,8667,4082,7896,923,2816,2821,872,464,5324,4038,1286,4038,3613,425,2018-01-01,zipcode
ZCTA5 32757,12,26679,56206,1036,205800,22749,10343,20462,2240,5930,6295,3584,2413,13266,11303,1963,11303,7884,3419,2018-01-01,zipcode
ZCTA5 32759,12,2787,32456,833,160100,2453,1575,2342,348,956,724,248,66,1551,1228,323,1228,902,326,2018-01-01,zipcode
ZCTA5 32763,12,23098,44390,1110,114400,18935,8500,16650,1748,5982,5843,1978,1099,10248,8996,1252,8996,5599,3397,2018-01-01,zipcode
ZCTA5 32764,12,3188,61667,986,214800,2889,1227,2549,299,966,864,306,114,1516,1202,314,1202,1083,119,2018-01-01,zipcode
ZCTA5 32765,12,65151,77074,1384,270300,51938,17846,40918,1598,7031,13640,11714,6935,22859,21128,1731,21128,14752,6376,2018-01-01,zipcode
ZCTA5 32766,12,17252,104938,1696,322500,13045,4848,11001,534,1984,3143,3171,2169,5420,5134,286,5134,4517,617,2018-01-01,zipcode
ZCTA5 32767,12,3273,47531,850,93500,2668,1028,2220,495,1079,584,33,29,1433,1063,370,1063,845,218,2018-01-01,zipcode
ZCTA5 32771,12,54980,56934,1143,185900,42273,14017,36820,3195,9257,12971,7716,3681,22685,19336,3349,19336,11541,7795,2018-01-01,zipcode
ZCTA5 32773,12,30955,44804,1053,124600,24173,9002,20851,2112,7157,7211,3351,1020,13195,11056,2139,11056,6531,4525,2018-01-01,zipcode
ZCTA5 32776,12,12416,79602,1309,215400,9742,3185,8596,723,2494,3373,1301,705,4127,3966,161,3966,3316,650,2018-01-01,zipcode
ZCTA5 32778,12,21406,45828,944,135400,18082,9679,16303,1767,5853,5224,2284,1175,11244,9082,2162,9082,6824,2258,2018-01-01,zipcode
ZCTA5 32779,12,29737,91996,1384,310400,23942,8986,21184,528,3316,6353,7077,3910,11429,10777,652,10777,8772,2005,2018-01-01,zipcode
ZCTA5 32780,12,35399,48531,904,151200,30176,14640,27051,2406,8062,9545,4827,2211,20077,15260,4817,15260,10602,4658,2018-01-01,zipcode
ZCTA5 32784,12,12313,45320,727,132600,9800,4564,8315,1471,2593,3014,661,576,5340,4315,1025,4315,3143,1172,2018-01-01,zipcode
ZCTA5 32789,12,26568,73003,1153,437700,22031,9095,19053,1002,2609,3941,6102,5399,12708,11015,1693,11015,7534,3481,2018-01-01,zipcode
ZCTA5 32792,12,50991,50943,1130,209600,43498,14772,36139,2290,7708,11975,9423,4743,23744,20657,3087,20657,9590,11067,2018-01-01,zipcode
ZCTA5 32796,12,20948,45654,952,126700,17545,8586,15833,1293,5187,5935,2160,1258,10072,8202,1870,8202,6143,2059,2018-01-01,zipcode
ZCTA5 32798,12,2595,42591,1061,78800,2442,1556,2199,191,725,868,317,98,1584,1294,290,1294,1208,86,2018-01-01,zipcode
ZCTA5 32801,12,12174,53628,1233,314200,11017,3275,10313,571,1959,2054,3518,2211,8951,7394,1557,7394,1679,5715,2018-01-01,zipcode
ZCTA5 32803,12,19583,67009,1235,266300,17737,3897,16011,606,2200,4280,5507,3418,11142,9497,1645,9497,5162,4335,2018-01-01,zipcode
ZCTA5 32804,12,17653,72782,1169,305500,14918,4746,13615,582,2982,3267,4481,2303,8885,7722,1163,7722,4887,2835,2018-01-01,zipcode
ZCTA5 32805,12,20695,26584,778,115200,16608,7286,14643,3027,5242,3863,1879,632,9140,7706,1434,7706,2529,5177,2018-01-01,zipcode
ZCTA5 32806,12,27768,60878,1107,242600,22828,7012,20383,1338,4699,5972,5498,2876,12478,11265,1213,11265,6589,4676,2018-01-01,zipcode
ZCTA5 32807,12,34306,42781,1080,138100,27918,9528,23649,5076,8344,6225,2843,1161,13098,11820,1278,11820,5372,6448,2018-01-01,zipcode
ZCTA5 32808,12,57443,35186,960,97400,43684,14106,35144,7426,12143,11226,2964,1385,19788,18106,1682,18106,7092,11014,2018-01-01,zipcode
ZCTA5 32809,12,28258,43919,973,150100,22756,7729,19486,3869,7039,5379,2268,931,11015,9275,1740,9275,4833,4442,2018-01-01,zipcode
ZCTA5 32810,12,39384,48727,1099,128400,30402,8937,26081,3058,8214,9018,4279,1512,14629,13447,1182,13447,6845,6602,2018-01-01,zipcode
ZCTA5 32811,12,41246,35911,1080,86800,32271,8662,26323,3734,7463,9347,4045,1734,17581,15429,2152,15429,3751,11678,2018-01-01,zipcode
ZCTA5 32812,12,35101,49611,1080,213600,29633,9694,25716,2040,6531,8705,5942,2498,15300,14144,1156,14144,7938,6206,2018-01-01,zipcode
ZCTA5 32814,12,7155,93589,1807,440000,5905,1412,5367,112,507,881,1976,1891,3866,3165,701,3165,1431,1734,2018-01-01,zipcode
ZCTA5 32817,12,35317,58958,1193,202100,29964,10653,21013,1824,4530,6928,5168,2563,13283,11528,1755,11528,6337,5191,2018-01-01,zipcode
ZCTA5 32818,12,55586,43438,1037,155500,41721,12765,34118,6704,10651,10961,4374,1428,18058,16968,1090,16968,9283,7685,2018-01-01,zipcode
ZCTA5 32819,12,27442,68964,1290,317300,22943,7504,19783,1293,3239,5807,6395,3049,14114,10142,3972,10142,6481,3661,2018-01-01,zipcode
ZCTA5 32820,12,9240,81628,1305,255000,7189,1966,5989,622,1336,2028,1314,689,3093,2836,257,2836,2490,346,2018-01-01,zipcode
ZCTA5 32821,12,17374,56090,1312,191500,15008,3767,12935,1008,2470,4489,3750,1218,12057,7232,4825,7232,2888,4344,2018-01-01,zipcode
ZCTA5 32822,12,60781,37565,1104,117800,48199,16711,41365,6260,13732,13114,6078,2181,25590,22469,3121,22469,8764,13705,2018-01-01,zipcode
ZCTA5 32824,12,46545,60405,1434,204200,36951,11576,31171,3825,7768,10977,6059,2542,15466,13039,2427,13039,8768,4271,2018-01-01,zipcode
ZCTA5 32825,12,61550,57839,1201,198600,49559,15842,40828,4014,9601,14356,8948,3909,22489,20407,2082,20407,12632,7775,2018-01-01,zipcode
ZCTA5 32826,12,36464,46240,1121,161500,33241,20523,13717,1808,3381,3612,3155,1761,8895,7646,1249,7646,4075,3571,2018-01-01,zipcode
ZCTA5 32827,12,9421,76304,1653,284700,7270,2364,6285,334,1234,1495,1943,1279,4097,3498,599,3498,2184,1314,2018-01-01,zipcode
ZCTA5 32828,12,65665,70619,1457,251700,51703,16369,41502,3138,7196,13122,11461,6585,22980,21327,1653,21327,13508,7819,2018-01-01,zipcode
ZCTA5 32829,12,19888,67782,1424,217100,15267,4496,13377,953,3302,3874,3269,1979,7389,6230,1159,6230,4756,1474,2018-01-01,zipcode
ZCTA5 32830,12,5,-666666666,-666666666,-666666666,5,0,5,0,0,5,0,0,5,5,0,5,0,5,2018-01-01,zipcode
ZCTA5 32831,12,3280,38125,-666666666,-666666666,3269,3244,2857,1154,1130,490,38,45,115,25,90,25,25,0,2018-01-01,zipcode
ZCTA5 32832,12,24325,87310,1591,322500,18305,5409,15824,660,1736,4359,5598,3471,10136,8170,1966,8170,5267,2903,2018-01-01,zipcode
ZCTA5 32833,12,9697,59250,891,235000,7544,2342,6827,733,2179,1986,1024,905,3748,3271,477,3271,2556,715,2018-01-01,zipcode
ZCTA5 32835,12,46058,54805,1299,223400,37338,8983,31121,2392,7014,9893,7876,3946,18741,16879,1862,16879,6759,10120,2018-01-01,zipcode
ZCTA5 32836,12,20154,91060,1273,427700,16253,5929,14450,610,1798,3802,5303,2937,8511,7145,1366,7145,4758,2387,2018-01-01,zipcode
ZCTA5 32837,12,54051,60460,1379,222100,42490,13262,36234,3465,8549,11530,8667,4023,20281,17084,3197,17084,9648,7436,2018-01-01,zipcode
ZCTA5 32839,12,52371,36011,1033,126700,41773,13909,34613,6809,10634,10544,5210,1416,22728,18160,4568,18160,4044,14116,2018-01-01,zipcode
ZCTA5 32901,12,24772,37225,918,134200,22232,11570,17913,1844,5450,5790,2832,1997,12933,10722,2211,10722,5035,5687,2018-01-01,zipcode
ZCTA5 32903,12,14090,79870,1248,329400,11931,4945,10980,285,1835,3280,3346,2234,6954,6012,942,6012,4881,1131,2018-01-01,zipcode
ZCTA5 32904,12,31206,65074,1257,199500,25390,11609,22421,1733,6248,7357,4029,3054,13218,11824,1394,11824,9265,2559,2018-01-01,zipcode
ZCTA5 32905,12,23395,37746,930,111100,19557,8850,16425,2067,5411,5511,2364,1072,11548,9508,2040,9508,4986,4522,2018-01-01,zipcode
ZCTA5 32907,12,44097,49769,1125,141000,36157,16323,30741,3283,10635,11266,4115,1442,16701,14883,1818,14883,11669,3214,2018-01-01,zipcode
ZCTA5 32908,12,13001,57313,1267,147800,9765,3883,8369,829,3195,2813,1118,414,4133,3996,137,3996,3237,759,2018-01-01,zipcode
ZCTA5 32909,12,30798,50285,1004,147800,24356,10186,21440,2144,7692,7546,2557,1501,12071,10760,1311,10760,8493,2267,2018-01-01,zipcode
ZCTA5 32920,12,10181,46806,864,228800,9361,4772,8781,450,2273,3202,1659,1197,8866,5380,3486,5380,3206,2174,2018-01-01,zipcode
ZCTA5 32922,12,15741,29066,746,88800,11991,5498,9930,2002,3358,3162,950,458,7613,5925,1688,5925,2308,3617,2018-01-01,zipcode
ZCTA5 32925,12,1506,49758,1417,-666666666,1116,406,829,49,123,354,210,93,492,440,52,440,0,440,2018-01-01,zipcode
ZCTA5 32926,12,22350,50015,970,145500,19035,8873,16868,1989,5200,6143,2467,1069,9975,8365,1610,8365,6472,1893,2018-01-01,zipcode
ZCTA5 32927,12,26687,60761,1027,134100,21761,8273,19124,1852,6570,7061,2384,1257,11436,9401,2035,9401,8045,1356,2018-01-01,zipcode
ZCTA5 32931,12,14118,60494,1135,313800,12824,6947,11787,435,2616,3606,3091,2039,10931,7155,3776,7155,4763,2392,2018-01-01,zipcode
ZCTA5 32934,12,18761,66163,1377,225100,15956,7434,14078,869,3264,4837,2839,2269,7658,7132,526,7132,6093,1039,2018-01-01,zipcode
ZCTA5 32935,12,41550,47344,968,141400,34673,13860,30730,2908,10021,11070,4274,2457,19504,17006,2498,17006,10064,6942,2018-01-01,zipcode
ZCTA5 32937,12,27126,69642,1209,274200,22871,9911,20480,581,4355,6138,5564,3842,13502,11349,2153,11349,8608,2741,2018-01-01,zipcode
ZCTA5 32940,12,39396,71198,1381,262000,33495,16240,29410,1090,5266,9421,7620,6013,17551,15694,1857,15694,12890,2804,2018-01-01,zipcode
ZCTA5 32948,12,7908,39683,744,150700,5825,2679,4493,1610,1269,1026,539,49,2180,1776,404,1776,1282,494,2018-01-01,zipcode
ZCTA5 32949,12,2629,65227,1114,311500,2105,851,1944,88,572,839,238,207,1209,956,253,956,910,46,2018-01-01,zipcode
ZCTA5 32950,12,4222,67716,886,258900,3701,1553,3307,109,966,1133,754,345,1798,1683,115,1683,1562,121,2018-01-01,zipcode
ZCTA5 32951,12,12029,71091,1535,329700,10697,6023,10147,379,2104,2891,2710,2063,7218,5310,1908,5310,4442,868,2018-01-01,zipcode
ZCTA5 32952,12,20732,73469,1114,270300,17598,7459,15539,668,3567,5144,3726,2434,9808,8432,1376,8432,6902,1530,2018-01-01,zipcode
ZCTA5 32953,12,24181,57281,955,245300,20389,8793,17933,1410,4696,5847,3967,2013,11475,9861,1614,9861,7247,2614,2018-01-01,zipcode
ZCTA5 32955,12,39127,68946,1224,207700,32192,13257,29065,1712,7376,10062,6130,3785,17722,15167,2555,15167,11475,3692,2018-01-01,zipcode
ZCTA5 32958,12,27676,50752,995,171100,24125,13726,22098,2066,8310,6900,3018,1804,13611,10839,2772,10839,8930,1909,2018-01-01,zipcode
ZCTA5 32960,12,20960,38133,864,158100,17805,8183,15579,1705,5382,5048,2245,1199,11414,8364,3050,8364,4742,3622,2018-01-01,zipcode
ZCTA5 32962,12,26469,47643,968,135400,21867,10017,19785,3229,5327,7452,2594,1183,12931,9025,3906,9025,7283,1742,2018-01-01,zipcode
ZCTA5 32963,12,14790,110471,1518,609500,14044,9376,13481,468,1122,2987,4642,4262,12303,7181,5122,7181,6653,528,2018-01-01,zipcode
ZCTA5 32966,12,17868,46464,1037,123100,15992,9670,14946,1168,4876,4699,2546,1657,10914,7934,2980,7934,5872,2062,2018-01-01,zipcode
ZCTA5 32967,12,21111,49613,965,204200,16841,7914,14876,2164,5008,3923,2171,1610,10456,7604,2852,7604,5723,1881,2018-01-01,zipcode
ZCTA5 32968,12,14015,78349,1287,253800,11662,5184,10196,624,2943,3398,2223,1008,5291,4615,676,4615,4288,327,2018-01-01,zipcode
ZCTA5 32970,12,204,13488,-666666666,59500,204,204,204,0,173,0,15,16,160,82,78,82,82,0,2018-01-01,zipcode
ZCTA5 32976,12,9001,36049,842,84900,8469,6122,8223,836,3471,2741,784,391,6713,4662,2051,4662,4133,529,2018-01-01,zipcode
ZCTA5 33001,12,323,44338,2175,322600,319,172,313,34,152,68,51,8,730,201,529,201,134,67,2018-01-01,zipcode
ZCTA5 33004,12,16812,44137,1248,190900,13814,4851,12393,1275,3715,4232,2141,1030,8370,6561,1809,6561,3121,3440,2018-01-01,zipcode
ZCTA5 33009,12,41276,37794,1190,202700,34753,13671,31081,4780,8297,8687,5583,3734,29937,18421,11516,18421,9570,8851,2018-01-01,zipcode
ZCTA5 33010,12,47231,27116,981,213800,40572,18000,36240,12481,12714,6544,3406,1095,15765,15108,657,15108,4680,10428,2018-01-01,zipcode
ZCTA5 33012,12,75666,32241,1105,206400,64872,28420,57737,16501,19166,13217,6580,2273,24936,23929,1007,23929,11160,12769,2018-01-01,zipcode
ZCTA5 33013,12,32980,32461,1102,220900,28617,12598,25895,8595,9729,4496,2257,818,9965,9543,422,9543,5454,4089,2018-01-01,zipcode
ZCTA5 33014,12,41316,38846,1236,243400,34282,14021,30386,6966,9074,7341,4567,2438,14942,14119,823,14119,6094,8025,2018-01-01,zipcode
ZCTA5 33015,12,66272,50426,1347,241300,53393,17647,45035,6555,13700,14301,6993,3486,22384,21075,1309,21075,10986,10089,2018-01-01,zipcode
ZCTA5 33016,12,51003,44330,1328,199400,41968,15056,35910,7886,12035,8497,5366,2126,15446,14948,498,14948,8180,6768,2018-01-01,zipcode
ZCTA5 33018,12,52526,60063,1592,249400,43107,13403,37090,7211,11939,9531,5853,2556,14516,14004,512,14004,10279,3725,2018-01-01,zipcode
ZCTA5 33019,12,14933,80727,1582,427400,12950,5541,12069,575,1863,3484,3278,2869,12568,6880,5688,6880,5076,1804,2018-01-01,zipcode
ZCTA5 33020,12,44578,41641,1050,196100,37090,10735,32719,4799,10426,9864,5156,2474,21803,18546,3257,18546,6143,12403,2018-01-01,zipcode
ZCTA5 33021,12,49350,57926,1303,254600,40328,14720,35224,4299,9187,11392,6076,4270,21386,18255,3131,18255,11829,6426,2018-01-01,zipcode
ZCTA5 33023,12,73671,50406,1235,187200,57989,18582,48438,8177,16266,16682,4977,2336,22025,20500,1525,20500,13523,6977,2018-01-01,zipcode
ZCTA5 33024,12,75306,58893,1327,220100,59584,17965,50541,6630,16642,15238,8017,4014,26011,23426,2585,23426,15739,7687,2018-01-01,zipcode
ZCTA5 33025,12,71763,57219,1405,215500,57489,18060,49794,3114,14767,19066,7925,4922,28017,24198,3819,24198,11355,12843,2018-01-01,zipcode
ZCTA5 33026,12,31045,74362,1668,251100,25601,8236,22266,1407,4724,7323,5331,3481,12070,11307,763,11307,9253,2054,2018-01-01,zipcode
ZCTA5 33027,12,60191,63227,1456,307000,49898,21011,44106,2802,11475,14394,8783,6652,24134,21138,2996,21138,16783,4355,2018-01-01,zipcode
ZCTA5 33028,12,27235,103811,1961,373600,21959,6357,18371,843,3166,5835,5248,3279,9003,8054,949,8054,6149,1905,2018-01-01,zipcode
ZCTA5 33029,12,47895,107109,2612,379100,37804,12932,30529,1792,6744,9390,7854,4749,14105,12773,1332,12773,11261,1512,2018-01-01,zipcode
ZCTA5 33030,12,35701,37576,1039,195100,26022,9339,21617,8340,6269,4586,1492,930,9678,9011,667,9011,3431,5580,2018-01-01,zipcode
ZCTA5 33031,12,7387,73193,1299,381900,5655,1695,4938,1026,1683,1296,462,471,2052,1925,127,1925,1652,273,2018-01-01,zipcode
ZCTA5 33032,12,47067,48341,1204,221100,34966,11244,27962,5841,8126,7796,4466,1733,13255,12314,941,12314,6714,5600,2018-01-01,zipcode
ZCTA5 33033,12,58224,45782,1252,197000,42367,15594,35001,8826,9398,9648,4850,2279,16622,15375,1247,15375,8391,6984,2018-01-01,zipcode
ZCTA5 33034,12,23281,36363,1058,113200,16419,8130,14194,5959,3842,3418,738,237,5673,4894,779,4894,1810,3084,2018-01-01,zipcode
ZCTA5 33035,12,15658,51207,1455,167700,11478,3015,9472,1357,2764,2883,1453,1015,5177,4390,787,4390,1830,2560,2018-01-01,zipcode
ZCTA5 33036,12,3274,76080,1397,635100,3090,1316,2832,87,799,900,712,334,3578,1519,2059,1519,1245,274,2018-01-01,zipcode
ZCTA5 33037,12,10955,63979,1443,422100,9515,4252,8974,845,2338,2857,1603,1331,10689,4630,6059,4630,3484,1146,2018-01-01,zipcode
ZCTA5 33039,12,356,75046,-666666666,236700,345,52,273,71,128,74,0,0,106,106,0,106,106,0,2018-01-01,zipcode
ZCTA5 33040,12,34784,67740,1739,499000,29527,8463,25905,2482,6924,7882,5230,3387,17812,13160,4652,13160,5853,7307,2018-01-01,zipcode
ZCTA5 33042,12,6524,83530,1822,486900,5900,2356,5636,299,1376,1672,1496,793,4937,3002,1935,3002,2275,727,2018-01-01,zipcode
ZCTA5 33043,12,4928,58479,1675,368100,4279,1667,3998,319,1109,1336,845,389,2937,2023,914,2023,1531,492,2018-01-01,zipcode
ZCTA5 33050,12,9433,55846,1319,403700,8332,3064,7194,692,2336,2211,1328,627,6784,3910,2874,3910,2230,1680,2018-01-01,zipcode
ZCTA5 33051,12,569,90625,1313,566800,569,257,569,30,176,125,150,88,1421,349,1072,349,223,126,2018-01-01,zipcode
ZCTA5 33054,12,32035,24597,857,141400,24801,12131,19976,5462,8752,3734,1663,365,10155,9072,1083,9072,4247,4825,2018-01-01,zipcode
ZCTA5 33055,12,43405,43373,1315,179200,35129,14836,29968,6666,11982,6803,2979,1538,11999,11368,631,11368,8591,2777,2018-01-01,zipcode
ZCTA5 33056,12,36409,40985,1182,164700,28489,11261,23604,4591,8507,7256,2208,1042,10701,9860,841,9860,6224,3636,2018-01-01,zipcode
ZCTA5 33060,12,37168,43924,1106,238000,29358,11305,25587,5230,8059,7243,3040,2015,14714,12867,1847,12867,5557,7310,2018-01-01,zipcode
ZCTA5 33062,12,22014,62162,1336,342100,20403,10511,19786,1358,4438,5557,4963,3470,21346,12053,9293,12053,8637,3416,2018-01-01,zipcode
ZCTA5 33063,12,54937,45964,1387,166400,46633,16361,42107,5205,15042,12484,6741,2635,26343,22261,4082,22261,15313,6948,2018-01-01,zipcode
ZCTA5 33064,12,61397,49984,1258,172700,48567,15765,42515,8140,14735,10031,7052,2557,24179,20480,3699,20480,13071,7409,2018-01-01,zipcode
ZCTA5 33065,12,57399,54621,1312,260800,44074,12894,36637,3945,10104,12087,7301,3200,19684,17886,1798,17886,8908,8978,2018-01-01,zipcode
ZCTA5 33066,12,16786,47605,1193,122000,15306,7973,14193,1078,4083,4377,2686,1969,11002,8673,2329,8673,7082,1591,2018-01-01,zipcode
ZCTA5 33067,12,27784,98750,1641,434400,21728,5908,18345,559,3123,5278,5278,4107,9430,8714,716,8714,6125,2589,2018-01-01,zipcode
ZCTA5 33068,12,51617,44857,1366,165800,40102,10434,33638,5049,13418,9693,3482,1996,18189,16131,2058,16131,9313,6818,2018-01-01,zipcode
ZCTA5 33069,12,27612,47279,1274,154000,23879,11126,20780,3121,6430,5662,3738,1829,14426,10453,3973,10453,5144,5309,2018-01-01,zipcode
ZCTA5 33070,12,5518,68375,1631,487300,4693,1866,4162,392,1064,1245,970,491,4522,2175,2347,2175,1487,688,2018-01-01,zipcode
ZCTA5 33071,12,39839,89440,1525,353900,31400,9224,26773,1460,5136,8598,7482,4097,13472,12879,593,12879,8209,4670,2018-01-01,zipcode
ZCTA5 33073,12,34652,75640,1694,304200,26559,7039,22077,1277,6250,6828,5733,1989,12342,11338,1004,11338,6384,4954,2018-01-01,zipcode
ZCTA5 33076,12,36600,124303,2344,481700,27425,8996,23161,850,3521,5458,7956,5376,12289,11501,788,11501,9192,2309,2018-01-01,zipcode
ZCTA5 33101,12,0,-666666666,-666666666,-666666666,0,0,0,0,0,0,0,0,0,0,0,0,0,0,2018-01-01,zipcode
ZCTA5 33109,12,475,223618,-666666666,2000001,475,296,475,0,55,20,222,178,961,273,688,273,232,41,2018-01-01,zipcode
ZCTA5 33122,12,109,-666666666,2174,-666666666,81,37,69,0,11,11,35,12,47,47,0,47,0,47,2018-01-01,zipcode
ZCTA5 33125,12,61492,27518,1004,214400,52425,23382,46307,15145,17281,7578,4705,1598,22576,20893,1683,20893,5212,15681,2018-01-01,zipcode
ZCTA5 33126,12,52987,35319,1228,185000,45530,17162,40257,8166,13594,9163,6860,2474,19590,18026,1564,18026,6140,11886,2018-01-01,zipcode
ZCTA5 33127,12,33464,30231,961,183900,26451,11009,22679,6572,7930,4815,2293,1069,11414,10096,1318,10096,2828,7268,2018-01-01,zipcode
ZCTA5 33128,12,7585,18920,773,180100,6404,2750,5768,2473,1891,847,441,116,3456,3113,343,3113,169,2944,2018-01-01,zipcode
ZCTA5 33129,12,13128,82143,1829,488800,11260,3082,10205,551,1016,1444,3703,3491,8447,6210,2237,6210,3018,3192,2018-01-01,zipcode
ZCTA5 33130,12,27818,30618,1096,288000,24055,8601,21407,5202,5364,3743,3926,3172,16246,12767,3479,12767,1939,10828,2018-01-01,zipcode
ZCTA5 33131,12,16715,88917,2252,473700,14842,3419,13700,234,977,1900,5164,5425,15495,9417,6078,9417,3035,6382,2018-01-01,zipcode
ZCTA5 33132,12,12895,77779,1964,483100,12088,4330,10835,984,1434,2072,3570,2775,9223,6389,2834,6389,1668,4721,2018-01-01,zipcode
ZCTA5 33133,12,34460,63992,1434,628600,28193,10209,25845,2320,5574,5194,6632,6125,16969,13628,3341,13628,6466,7162,2018-01-01,zipcode
ZCTA5 33134,12,41861,67818,1376,475700,35905,12504,32648,3343,6173,7181,8583,7368,18720,16304,2416,16304,8650,7654,2018-01-01,zipcode
ZCTA5 33135,12,39789,27172,998,262300,33829,14019,30028,8979,11317,4687,3540,1505,15573,14517,1056,14517,2854,11663,2018-01-01,zipcode
ZCTA5 33136,12,14839,24702,824,173700,12313,4632,10641,2544,3643,2539,1374,541,6961,5830,1131,5830,791,5039,2018-01-01,zipcode
ZCTA5 33137,12,23965,60259,1616,339900,20897,5667,18623,2284,3557,4683,5125,2974,12263,10039,2224,10039,2659,7380,2018-01-01,zipcode
ZCTA5 33138,12,29867,47604,949,415700,24624,7910,22178,3736,4428,5590,5134,3290,13956,12447,1509,12447,5689,6758,2018-01-01,zipcode
ZCTA5 33139,12,38606,52278,1426,398800,34243,9489,32026,2988,5350,7006,9374,7308,33000,20882,12118,20882,7237,13645,2018-01-01,zipcode
ZCTA5 33140,12,21807,79804,1632,621200,17886,7007,16390,1414,2172,3551,4742,4511,17812,9181,8631,9181,5342,3839,2018-01-01,zipcode
ZCTA5 33141,12,40005,48096,1273,323600,34823,9651,31369,3708,7882,8170,6550,5059,23519,17739,5780,17739,5391,12348,2018-01-01,zipcode
ZCTA5 33142,12,58574,24106,901,156800,45910,20505,39130,12864,13727,8101,3195,1243,21156,18983,2173,18983,5000,13983,2018-01-01,zipcode
ZCTA5 33143,12,32197,67170,1321,563400,26567,8732,23489,1294,3803,5970,6860,5562,13799,12274,1525,12274,6599,5675,2018-01-01,zipcode
ZCTA5 33144,12,30235,44611,1320,281200,26525,10284,24196,5172,7597,6014,3739,1674,9480,9175,305,9175,5362,3813,2018-01-01,zipcode
ZCTA5 33145,12,31465,51181,1413,340200,27289,9506,24520,4194,7097,5237,4507,3485,12803,11555,1248,11555,5664,5891,2018-01-01,zipcode
ZCTA5 33146,12,16156,121319,2179,868300,13667,6412,7960,329,609,1428,2504,3090,4920,4077,843,4077,3083,994,2018-01-01,zipcode
ZCTA5 33147,12,47834,30632,1007,139800,37404,16321,31773,9151,12177,7009,2172,1264,15808,14189,1619,14189,6520,7669,2018-01-01,zipcode
ZCTA5 33149,12,13054,133958,2448,1218200,9781,3965,8502,129,663,1458,3260,2992,7340,4367,2973,4367,3105,1262,2018-01-01,zipcode
ZCTA5 33150,12,29839,28069,864,174200,22721,9049,19195,5428,6507,4623,1676,961,10858,9733,1125,9733,2934,6799,2018-01-01,zipcode
ZCTA5 33154,12,14790,74212,1805,592500,11540,4674,10450,443,1322,2835,3289,2561,10776,6272,4504,6272,3428,2844,2018-01-01,zipcode
ZCTA5 33155,12,47450,63653,1447,335900,40248,14919,35562,5186,9602,9190,7246,4338,15483,14518,965,14518,10378,4140,2018-01-01,zipcode
ZCTA5 33156,12,34167,112373,1664,812100,27533,10467,23180,1191,3256,4709,7127,6897,12726,10991,1735,10991,7800,3191,2018-01-01,zipcode
ZCTA5 33157,12,68402,63943,1150,287900,53250,19472,45202,6525,13109,11761,9191,4616,20958,19426,1532,19426,13023,6403,2018-01-01,zipcode
ZCTA5 33158,12,6641,159914,2338,667000,5121,1864,4414,117,435,644,1329,1889,2285,2110,175,2110,1976,134,2018-01-01,zipcode
ZCTA5 33160,12,41113,52170,1503,296300,35605,15036,32746,2083,5035,10890,8372,6366,36461,19617,16844,19617,10704,8913,2018-01-01,zipcode
ZCTA5 33161,12,55663,36618,1076,213800,43542,15247,36364,9030,10477,9707,4986,2164,17931,15904,2027,15904,6162,9742,2018-01-01,zipcode
ZCTA5 33162,12,48185,42643,1110,182800,38187,13169,31727,7106,9330,9747,3973,1571,14727,12927,1800,12927,6959,5968,2018-01-01,zipcode
ZCTA5 33165,12,56133,50758,1378,287900,47922,19147,41733,8153,13880,8841,7227,3632,16902,16079,823,16079,10768,5311,2018-01-01,zipcode
ZCTA5 33166,12,24830,53717,1261,341600,21116,8205,18573,2721,4855,5111,3700,2186,9325,7908,1417,7908,3773,4135,2018-01-01,zipcode
ZCTA5 33167,12,19837,36870,1108,172700,16139,6387,13364,3508,4525,3606,1252,473,5994,5706,288,5706,3093,2613,2018-01-01,zipcode
ZCTA5 33168,12,29072,45395,1299,171800,23710,9017,19545,5203,7033,4853,1744,712,7159,6701,458,6701,4740,1961,2018-01-01,zipcode
ZCTA5 33169,12,41525,43331,1142,181700,32112,11795,26976,5081,8656,8286,3403,1550,13292,11777,1515,11777,6180,5597,2018-01-01,zipcode
ZCTA5 33170,12,13748,42946,1011,253000,10370,4486,8897,1820,3096,2270,1339,372,4070,3823,247,3823,2247,1576,2018-01-01,zipcode
ZCTA5 33172,12,43083,46983,1462,158700,36005,12621,31902,5144,9200,8140,6183,3235,15660,13687,1973,13687,6076,7611,2018-01-01,zipcode
ZCTA5 33173,12,32307,69414,1466,307000,26905,10279,23678,2479,5060,6550,6044,3545,11971,10977,994,10977,7733,3244,2018-01-01,zipcode
ZCTA5 33174,12,34015,46613,1264,253700,29755,12446,24160,6504,6003,5058,4586,2009,10193,9667,526,9667,5582,4085,2018-01-01,zipcode
ZCTA5 33175,12,55334,55304,1556,281400,47926,19439,41890,7239,13478,10155,7543,3475,16272,15655,617,15655,11703,3952,2018-01-01,zipcode
ZCTA5 33176,12,52461,70572,1371,376700,43599,15111,38040,3439,8613,11098,8807,6083,18793,17152,1641,17152,11638,5514,2018-01-01,zipcode
ZCTA5 33177,12,58129,58912,1425,236600,48231,19079,39873,6897,13898,10636,6220,2222,15240,14600,640,14600,10529,4071,2018-01-01,zipcode
ZCTA5 33178,12,51459,80554,2028,373800,38581,12078,32753,1624,5289,8534,10832,6474,19615,14891,4724,14891,7767,7124,2018-01-01,zipcode
ZCTA5 33179,12,45243,48456,1228,154600,37175,12566,32041,3842,8499,10358,5801,3541,18131,15886,2245,15886,9501,6385,2018-01-01,zipcode
ZCTA5 33180,12,31883,70014,1868,377700,27387,11295,25096,1163,3083,7421,7864,5565,23901,14729,9172,14729,9816,4913,2018-01-01,zipcode
ZCTA5 33181,12,19986,46038,1192,247100,16756,5886,14184,1809,3699,4107,3012,1557,9055,7435,1620,7435,2832,4603,2018-01-01,zipcode
ZCTA5 33182,12,17379,73785,1786,315700,15020,7863,12824,2889,3424,3011,2569,931,3891,3769,122,3769,3305,464,2018-01-01,zipcode
ZCTA5 33183,12,37504,56400,1440,233800,31007,11078,26572,3152,7120,8878,4863,2559,12214,11630,584,11630,7370,4260,2018-01-01,zipcode
ZCTA5 33184,12,21733,50569,1443,238600,19050,8068,16745,4753,4378,3220,3459,935,6371,6104,267,6104,4612,1492,2018-01-01,zipcode
ZCTA5 33185,12,30959,87438,2205,348900,25236,8632,21163,2534,4983,5490,5754,2402,8226,7954,272,7954,6758,1196,2018-01-01,zipcode
ZCTA5 33186,12,70614,69823,1676,278900,57677,20086,49778,3684,11505,17921,11052,5616,22986,21383,1603,21383,14387,6996,2018-01-01,zipcode
ZCTA5 33187,12,19286,75543,1955,329300,15771,5246,13565,2269,3243,3999,2852,1202,5417,5127,290,5127,4576,551,2018-01-01,zipcode
ZCTA5 33189,12,26937,54834,1158,244400,21057,6927,18300,2507,5811,5414,3294,1274,8591,7943,648,7943,4677,3266,2018-01-01,zipcode
ZCTA5 33190,12,16305,59057,1304,246000,12104,3428,10105,1085,2080,3554,2478,908,4846,4608,238,4608,1917,2691,2018-01-01,zipcode
ZCTA5 33193,12,51378,58004,1459,260100,42418,15209,35229,6637,8922,8624,8682,2364,14912,14402,510,14402,9102,5300,2018-01-01,zipcode
ZCTA5 33194,12,8485,112730,1818,345400,6880,3594,5690,1143,1384,1621,990,552,1563,1563,0,1563,1274,289,2018-01-01,zipcode
ZCTA5 33196,12,51752,73853,1804,300500,41532,14003,35044,3377,7622,11760,8714,3571,14962,13948,1014,13948,9254,4694,2018-01-01,zipcode
ZCTA5 33301,12,15062,90497,1965,570700,13792,4375,12631,589,1486,2850,4337,3369,10780,7675,3105,7675,3687,3988,2018-01-01,zipcode
ZCTA5 33304,12,18771,54749,1225,395000,16356,4638,15136,962,2913,4163,4384,2714,12961,9329,3632,9329,3418,5911,2018-01-01,zipcode
ZCTA5 33305,12,12425,67665,1348,395800,11398,3682,10835,383,1908,2615,3998,1931,8087,6466,1621,6466,3988,2478,2018-01-01,zipcode
ZCTA5 33306,12,3378,64125,1044,479300,2980,919,2838,67,366,890,833,682,2205,1752,453,1752,1113,639,2018-01-01,zipcode
ZCTA5 33308,12,27951,62768,1340,377700,25518,11434,24215,1250,5118,5904,6877,5066,23510,15485,8025,15485,10612,4873,2018-01-01,zipcode
ZCTA5 33309,12,40926,54639,1239,170500,32725,9459,29226,4862,9553,7839,4649,2323,14080,12974,1106,12974,7870,5104,2018-01-01,zipcode
ZCTA5 33311,12,73034,35075,1085,140600,54964,22109,46269,11936,16787,12211,3445,1890,26095,22430,3665,22430,9141,13289,2018-01-01,zipcode
ZCTA5 33312,12,53552,54918,1259,239500,42858,14056,37341,5128,10486,11003,7062,3662,20886,17769,3117,17769,10070,7699,2018-01-01,zipcode
ZCTA5 33313,12,62405,36410,1122,117800,48220,16779,39627,7788,14777,11322,3586,2154,23567,19653,3914,19653,8287,11366,2018-01-01,zipcode
ZCTA5 33314,12,26188,44785,1322,165300,21395,7375,17429,2533,5923,4508,3500,965,9899,8768,1131,8768,3802,4966,2018-01-01,zipcode
ZCTA5 33315,12,13362,61890,1361,289300,11856,3451,10919,1224,2877,3044,2510,1264,6937,6029,908,6029,3206,2823,2018-01-01,zipcode
ZCTA5 33316,12,9801,57862,1110,560000,9002,3868,8380,804,1387,2050,2505,1634,7919,5077,2842,5077,3132,1945,2018-01-01,zipcode
ZCTA5 33317,12,38360,65934,1290,285500,30375,10195,26713,3334,7041,7220,6088,3030,13309,12456,853,12456,9268,3188,2018-01-01,zipcode
ZCTA5 33319,12,47021,45531,1218,120500,38591,13389,33600,5127,10743,9976,5158,2596,23167,18181,4986,18181,11711,6470,2018-01-01,zipcode
ZCTA5 33321,12,47974,48986,1396,162600,40724,16372,36449,3721,10968,11261,6661,3838,22254,19836,2418,19836,14496,5340,2018-01-01,zipcode
ZCTA5 33322,12,39049,49681,1632,151900,33801,14038,30558,3140,7923,9535,6204,3756,19792,16111,3681,16111,12957,3154,2018-01-01,zipcode
ZCTA5 33323,12,21195,87667,1936,302000,17200,4718,14749,1106,2903,5004,3705,2031,8195,7038,1157,7038,4929,2109,2018-01-01,zipcode
ZCTA5 33324,12,48807,65297,1609,219000,40093,12005,35637,1710,7279,10814,9350,6484,22393,19217,3176,19217,10707,8510,2018-01-01,zipcode
ZCTA5 33325,12,28987,78367,1618,301400,23313,7269,19939,1536,5371,5644,4637,2751,10514,9099,1415,9099,6974,2125,2018-01-01,zipcode
ZCTA5 33326,12,32946,84910,1827,355900,25993,8584,22703,1098,3767,5943,7077,4818,13723,10847,2876,10847,7422,3425,2018-01-01,zipcode
ZCTA5 33327,12,23762,106414,2617,528800,16539,6516,13585,392,1589,2846,5178,3580,7044,6609,435,6609,5210,1399,2018-01-01,zipcode
ZCTA5 33328,12,28782,85858,1514,341300,23216,7605,19417,1111,4209,5750,4989,3358,10756,10166,590,10166,7828,2338,2018-01-01,zipcode
ZCTA5 33330,12,15226,122204,2657,506800,12477,4220,10072,544,1768,2905,2646,2209,4854,4612,242,4612,4218,394,2018-01-01,zipcode
ZCTA5 33331,12,25854,119518,2332,473400,19977,6228,16953,738,2240,4308,5412,4255,8205,7578,627,7578,6484,1094,2018-01-01,zipcode
ZCTA5 33332,12,11518,127708,2362,598100,9153,3006,7290,308,1026,1688,2160,2108,3598,3210,388,3210,2870,340,2018-01-01,zipcode
ZCTA5 33334,12,29478,51241,1125,261600,25257,6828,22785,3574,6133,6371,4393,2314,13804,12280,1524,12280,6635,5645,2018-01-01,zipcode
ZCTA5 33351,12,35581,58962,1457,203800,27989,8483,23650,2726,6416,7749,5089,1670,12554,11425,1129,11425,6077,5348,2018-01-01,zipcode
ZCTA5 33401,12,28287,48767,1223,228100,24048,9022,19805,2616,4451,5344,4551,2843,16179,11588,4591,11588,4482,7106,2018-01-01,zipcode
ZCTA5 33403,12,12558,50320,1185,172400,10049,3022,8631,1732,2305,2478,1505,611,5097,4236,861,4236,1905,2331,2018-01-01,zipcode
ZCTA5 33404,12,28717,42044,1091,147900,22453,9286,19426,3035,6563,5219,2847,1762,15275,10002,5273,10002,5460,4542,2018-01-01,zipcode
ZCTA5 33405,12,20537,49770,1139,262000,16906,5665,15084,3179,4238,3393,2550,1724,8078,7021,1057,7021,4070,2951,2018-01-01,zipcode
ZCTA5 33406,12,26858,60142,1246,185300,21873,7332,18514,2778,5993,5638,3054,1051,9414,8580,834,8580,5505,3075,2018-01-01,zipcode
ZCTA5 33407,12,30928,41085,1086,163600,24792,8143,21165,4432,6528,5383,3004,1818,13123,10719,2404,10719,4576,6143,2018-01-01,zipcode
ZCTA5 33408,12,18248,73890,1319,349600,16503,7589,15269,855,2909,4144,4566,2795,12770,9025,3745,9025,6986,2039,2018-01-01,zipcode
ZCTA5 33409,12,33875,49256,1204,154600,26688,8414,21847,3859,5649,6238,4307,1794,12966,11116,1850,11116,4788,6328,2018-01-01,zipcode
ZCTA5 33410,12,35597,69037,1516,296200,30728,11275,27885,2015,6021,8740,7389,3720,17325,14869,2456,14869,9785,5084,2018-01-01,zipcode
ZCTA5 33411,12,71587,68507,1362,267700,57720,20601,50198,4828,13470,15383,10663,5854,28217,24028,4189,24028,17610,6418,2018-01-01,zipcode
ZCTA5 33412,12,14918,89052,1947,348000,12827,5136,11516,729,2939,3532,2666,1650,6291,5320,971,5320,4648,672,2018-01-01,zipcode
ZCTA5 33413,12,17473,60635,1439,232300,13468,4396,11281,1688,2895,3888,1794,1016,5671,5099,572,5099,3249,1850,2018-01-01,zipcode
ZCTA5 33414,12,61301,86034,1751,349700,47875,16260,41091,2328,8339,12572,11211,6641,23331,19617,3714,19617,14423,5194,2018-01-01,zipcode
ZCTA5 33415,12,51582,42077,1129,114400,40534,13455,33828,7261,11619,9251,4309,1388,18970,16516,2454,16516,9280,7236,2018-01-01,zipcode
ZCTA5 33417,12,33287,36228,1099,71100,26946,10895,23789,4114,7720,6823,3815,1317,18796,14246,4550,14246,8261,5985,2018-01-01,zipcode
ZCTA5 33418,12,40225,90130,1693,381600,34570,14612,31973,1371,5394,8559,9424,7225,21415,16864,4551,16864,13338,3526,2018-01-01,zipcode
ZCTA5 33426,12,23155,57983,1534,183300,19697,6836,17152,1546,5326,5708,3195,1377,11121,9361,1760,9361,5614,3747,2018-01-01,zipcode
ZCTA5 33428,12,41189,67500,1604,270500,33386,11644,28441,2132,7225,8460,7194,3430,15463,13682,1781,13682,9804,3878,2018-01-01,zipcode
ZCTA5 33430,12,22603,24840,616,102000,16704,7663,13567,5419,4334,2699,825,290,8453,7249,1204,7249,2254,4995,2018-01-01,zipcode
ZCTA5 33431,12,20967,74614,1573,380400,18116,7477,13876,662,2301,3544,4286,3083,9652,7576,2076,7576,5235,2341,2018-01-01,zipcode
ZCTA5 33432,12,19578,72425,1583,586800,18233,7937,16258,831,3078,3969,4385,3995,15480,10269,5211,10269,6469,3800,2018-01-01,zipcode
ZCTA5 33433,12,39954,62710,1755,287600,33933,15848,30168,1122,6291,7807,8923,6025,23462,18180,5282,18180,12503,5677,2018-01-01,zipcode
ZCTA5 33434,12,20006,56760,1103,235000,17852,9701,16841,1095,3537,4096,4581,3532,13811,9694,4117,9694,8087,1607,2018-01-01,zipcode
ZCTA5 33435,12,36423,46283,1423,160400,30640,12080,26817,4738,7325,7926,4613,2215,18250,13441,4809,13441,7735,5706,2018-01-01,zipcode
ZCTA5 33436,12,44249,55735,1419,220400,37064,15360,33403,3010,7912,10352,8421,3708,21537,17401,4136,17401,12600,4801,2018-01-01,zipcode
ZCTA5 33437,12,38921,61472,1462,275400,35192,21834,33574,1717,8111,9612,7867,6267,21355,18402,2953,18402,15978,2424,2018-01-01,zipcode
ZCTA5 33438,12,265,56500,-666666666,112500,256,72,211,0,155,22,34,0,148,84,64,84,78,6,2018-01-01,zipcode
ZCTA5 33440,12,19878,37359,795,71600,15657,6323,12872,4405,4624,2828,724,291,7953,6467,1486,6467,4147,2320,2018-01-01,zipcode
ZCTA5 33441,12,27050,46098,1179,211900,22986,7483,20242,3245,6544,5626,3382,1445,13748,11029,2719,11029,5377,5652,2018-01-01,zipcode
ZCTA5 33442,12,28846,45781,1589,131400,24791,10959,22390,1424,7152,6937,4262,2615,19407,13692,5715,13692,9090,4602,2018-01-01,zipcode
ZCTA5 33444,12,23770,53352,1270,277200,19815,6459,17119,3825,4603,4557,2799,1335,9449,8257,1192,8257,4313,3944,2018-01-01,zipcode
ZCTA5 33445,12,32261,53929,1540,203500,27972,11250,24478,2692,5631,6709,5706,3740,16963,13655,3308,13655,8439,5216,2018-01-01,zipcode
ZCTA5 33446,12,24983,56361,1109,272800,22898,14739,22143,1292,5005,5907,5691,4248,17680,12932,4748,12932,11040,1892,2018-01-01,zipcode
ZCTA5 33449,12,11602,116269,1913,417400,9149,3694,7603,273,1045,1976,2329,1980,4397,3802,595,3802,3590,212,2018-01-01,zipcode
ZCTA5 33455,12,22415,54113,1050,250600,19549,9912,18000,1447,4736,5438,4116,2263,12089,9854,2235,9854,8112,1742,2018-01-01,zipcode
ZCTA5 33458,12,56642,82555,1513,346900,45588,13782,40036,3095,7568,11180,11394,6799,23633,21197,2436,21197,15051,6146,2018-01-01,zipcode
ZCTA5 33460,12,32688,37863,1048,199400,26073,8476,22672,7321,6008,5244,2704,1395,13269,11310,1959,11310,4729,6581,2018-01-01,zipcode
ZCTA5 33461,12,46344,41081,1156,128400,36342,12372,30896,8249,9462,8499,3227,1459,17679,14912,2767,14912,7079,7833,2018-01-01,zipcode
ZCTA5 33462,12,33173,52165,1175,200200,27646,10005,24678,4046,7800,6749,3977,2106,15213,12124,3089,12124,7159,4965,2018-01-01,zipcode
ZCTA5 33463,12,62043,52352,1274,174800,47109,14286,39048,8791,9938,11143,6676,2500,21018,18184,2834,18184,12596,5588,2018-01-01,zipcode
ZCTA5 33467,12,53339,69644,1204,286700,44726,19142,39394,3211,9656,11772,8706,6049,23398,19875,3523,19875,17141,2734,2018-01-01,zipcode
ZCTA5 33469,12,15195,76662,1350,356800,13378,6334,12178,319,2233,3538,3846,2242,8835,6805,2030,6805,5823,982,2018-01-01,zipcode
ZCTA5 33470,12,26384,83668,1805,306600,21721,6922,18028,2629,5333,6153,2724,1189,8826,7881,945,7881,7105,776,2018-01-01,zipcode
ZCTA5 33471,12,7155,38690,709,67000,6226,4006,5431,1438,2154,1246,422,171,3209,2086,1123,2086,1563,523,2018-01-01,zipcode
ZCTA5 33472,12,20039,74700,2142,279400,17088,8758,15742,492,3523,4911,4073,2743,8953,7940,1013,7940,7247,693,2018-01-01,zipcode
ZCTA5 33473,12,11300,137895,2848,564800,8404,3350,7540,54,1216,1622,2673,1975,4191,3540,651,3540,2998,542,2018-01-01,zipcode
ZCTA5 33476,12,8618,21748,563,96100,6540,2915,5439,1965,1653,1312,396,113,3120,2735,385,2735,1048,1687,2018-01-01,zipcode
ZCTA5 33477,12,13710,74614,1614,385200,12972,7491,12495,368,2493,3285,3720,2629,12145,7356,4789,7356,6002,1354,2018-01-01,zipcode
ZCTA5 33478,12,13015,103333,1857,371700,10607,3551,9784,526,2232,3303,2388,1335,4776,4506,270,4506,4403,103,2018-01-01,zipcode
ZCTA5 33480,12,10027,110756,1668,943000,9505,6219,9359,236,745,2289,3241,2848,11592,5615,5977,5615,4804,811,2018-01-01,zipcode
ZCTA5 33483,12,11904,83592,1660,544700,11039,5160,10369,451,1526,2260,3745,2387,9025,6051,2974,6051,4203,1848,2018-01-01,zipcode
ZCTA5 33484,12,26146,41044,1304,137600,24782,15239,23586,1573,6613,7125,4847,3428,18687,14332,4355,14332,11098,3234,2018-01-01,zipcode
ZCTA5 33486,12,24146,78931,1441,399100,19754,7252,17487,631,3928,4295,5611,3022,10738,9097,1641,9097,7286,1811,2018-01-01,zipcode
ZCTA5 33487,12,20176,80947,1798,386700,17309,7569,16113,573,2287,4580,5284,3389,12645,9168,3477,9168,7179,1989,2018-01-01,zipcode
ZCTA5 33493,12,5543,35104,819,83400,4873,3997,4401,1860,1587,705,169,80,794,540,254,540,257,283,2018-01-01,zipcode
ZCTA5 33496,12,21825,86461,1779,370400,19029,10220,17316,672,2740,4046,5311,4547,11982,9701,2281,9701,8403,1298,2018-01-01,zipcode
ZCTA5 33498,12,14404,99514,2646,404500,11623,4611,10386,360,1762,2710,3228,2326,5497,5165,332,5165,4879,286,2018-01-01,zipcode
ZCTA5 33503,12,204,-666666666,-666666666,267900,204,74,126,80,9,37,0,0,50,50,0,50,45,5,2018-01-01,zipcode
ZCTA5 33510,12,28176,58631,1118,160000,22656,8489,19352,1408,6405,6412,3715,1412,11237,10310,927,10310,6175,4135,2018-01-01,zipcode
ZCTA5 33511,12,57642,57868,1209,186600,46189,15094,40167,3038,9708,14302,8899,4220,23945,21972,1973,21972,10746,11226,2018-01-01,zipcode
ZCTA5 33513,12,12303,37761,697,93300,10481,6555,8963,1753,3672,2590,643,305,5171,3819,1352,3819,3091,728,2018-01-01,zipcode
ZCTA5 33514,12,2350,39145,816,87100,1654,759,1419,412,452,437,44,74,804,690,114,690,406,284,2018-01-01,zipcode
ZCTA5 33521,12,430,32143,628,65000,338,186,332,46,184,86,14,2,300,184,116,184,138,46,2018-01-01,zipcode
ZCTA5 33523,12,18387,45839,786,113000,14666,6280,12128,2569,4529,3130,1197,703,7701,6371,1330,6371,4287,2084,2018-01-01,zipcode
ZCTA5 33525,12,20449,52865,783,141600,17129,8683,14177,1837,4820,4498,2094,928,8674,7249,1425,7249,5252,1997,2018-01-01,zipcode
ZCTA5 33527,12,14850,55841,889,220600,11689,4758,10033,2665,3173,2634,1119,442,5321,4753,568,4753,3521,1232,2018-01-01,zipcode
ZCTA5 33534,12,16487,49596,1024,165200,11947,4329,9803,2099,3177,2887,1152,488,5522,4942,580,4942,3193,1749,2018-01-01,zipcode
ZCTA5 33538,12,4523,35849,780,85000,3851,2092,3506,746,1453,907,271,129,2866,1939,927,1939,1502,437,2018-01-01,zipcode
ZCTA5 33540,12,8737,35602,773,70900,7428,4137,6756,1123,2850,2004,578,201,5261,3846,1415,3846,2742,1104,2018-01-01,zipcode
ZCTA5 33541,12,19900,39334,954,69300,17463,11247,16304,2529,6591,5005,1410,769,12560,8868,3692,8868,6953,1915,2018-01-01,zipcode
ZCTA5 33542,12,21101,33956,815,69400,18093,10832,16425,2522,6367,5482,1412,642,13315,9792,3523,9792,6901,2891,2018-01-01,zipcode
ZCTA5 33543,12,26172,80443,1413,208200,20537,7240,17765,1071,3786,5777,4331,2800,10049,8944,1105,8944,7177,1767,2018-01-01,zipcode
ZCTA5 33544,12,27606,81115,1474,241200,20776,6266,17915,1582,3828,4945,4934,2626,9838,9304,534,9304,6572,2732,2018-01-01,zipcode
ZCTA5 33545,12,18522,77705,1510,198100,13832,3939,11694,691,2450,4458,2712,1383,6207,5814,393,5814,4294,1520,2018-01-01,zipcode
ZCTA5 33547,12,24813,103167,1772,316900,17442,5796,14972,798,2655,3548,4671,3300,8524,7916,608,7916,6556,1360,2018-01-01,zipcode
ZCTA5 33548,12,7063,106182,1354,346500,5783,2177,5088,163,1010,1487,1543,885,2688,2545,143,2545,2262,283,2018-01-01,zipcode
ZCTA5 33549,12,18015,71176,1047,220300,14859,5761,12996,782,3110,4428,2785,1891,7320,6858,462,6858,5278,1580,2018-01-01,zipcode
ZCTA5 33556,12,22978,100456,1301,361800,18291,6874,16131,941,3307,4500,4441,2942,8936,7958,978,7958,7238,720,2018-01-01,zipcode
ZCTA5 33558,12,22843,78391,1037,329300,17784,5972,15478,567,2903,4324,4914,2770,9516,8688,828,8688,5947,2741,2018-01-01,zipcode
ZCTA5 33559,12,17731,63414,1174,176100,14703,4141,12016,788,2754,3989,2540,1945,7335,6663,672,6663,3843,2820,2018-01-01,zipcode
ZCTA5 33563,12,27875,44121,915,122200,21214,7770,17862,3617,6938,4786,1848,673,10819,9683,1136,9683,5269,4414,2018-01-01,zipcode
ZCTA5 33565,12,17311,53883,948,157500,13940,6149,12450,2135,4972,3455,1321,567,6767,6085,682,6085,4791,1294,2018-01-01,zipcode
ZCTA5 33566,12,20602,61201,959,191600,15788,5820,13468,2303,4337,3327,2400,1101,7720,7035,685,7035,5096,1939,2018-01-01,zipcode
ZCTA5 33567,12,12318,49403,730,173700,9247,3208,7901,2180,2519,2001,887,314,3924,3692,232,3692,2766,926,2018-01-01,zipcode
ZCTA5 33569,12,27428,65761,1345,201400,21354,7928,18550,1324,5018,6461,3635,2112,10316,9617,699,9617,7742,1875,2018-01-01,zipcode
ZCTA5 33570,12,27821,50809,892,158200,21528,8680,18687,3467,5992,6219,1847,1162,11695,9311,2384,9311,6712,2599,2018-01-01,zipcode
ZCTA5 33572,12,18998,83642,1574,260400,15546,5465,14289,790,3085,4924,3428,2062,8374,7613,761,7613,6433,1180,2018-01-01,zipcode
ZCTA5 33573,12,22412,46681,1801,162500,21198,16181,20678,1029,5806,7123,3944,2776,14916,12630,2286,12630,10031,2599,2018-01-01,zipcode
ZCTA5 33576,12,4654,58431,740,183000,4220,2618,3865,230,1140,1507,561,427,2380,2061,319,2061,1829,232,2018-01-01,zipcode
ZCTA5 33578,12,49634,61604,1198,181200,38524,10511,32994,2277,8410,12104,7111,3092,19851,18564,1287,18564,9919,8645,2018-01-01,zipcode
ZCTA5 33579,12,34271,81635,1687,207400,25417,7220,21782,2111,5231,7378,4440,2622,11374,10390,984,10390,8065,2325,2018-01-01,zipcode
ZCTA5 33584,12,27153,62899,1128,160600,21351,7475,18753,1970,6237,6295,3073,1178,10079,9258,821,9258,7099,2159,2018-01-01,zipcode
ZCTA5 33585,12,1394,47339,781,164000,1101,585,1031,120,613,233,41,24,565,480,85,480,399,81,2018-01-01,zipcode
ZCTA5 33592,12,11068,38297,813,101300,8874,4007,7402,1305,2867,1854,985,391,4515,3989,526,3989,2674,1315,2018-01-01,zipcode
ZCTA5 33594,12,35465,63853,1353,176800,28005,10070,24927,2506,7350,8292,4705,2074,13521,12663,858,12663,10256,2407,2018-01-01,zipcode
ZCTA5 33596,12,30015,99210,1618,260400,23706,8080,20277,822,4222,6010,6130,3093,10366,9893,473,9893,8546,1347,2018-01-01,zipcode
ZCTA5 33597,12,8207,50385,791,106800,6773,3096,5952,1147,2319,1840,480,166,3738,2843,895,2843,2411,432,2018-01-01,zipcode
ZCTA5 33598,12,18226,61650,817,221800,13633,5556,11925,3671,3252,2831,1316,855,6226,5453,773,5453,4164,1289,2018-01-01,zipcode
ZCTA5 33602,12,14409,71043,1551,305300,12765,3813,11588,1011,1663,2715,3044,3155,9260,7865,1395,7865,3084,4781,2018-01-01,zipcode
ZCTA5 33603,12,21044,43012,984,165100,16973,5325,14849,2296,4409,3990,2938,1216,9387,8467,920,8467,4440,4027,2018-01-01,zipcode
ZCTA5 33604,12,38690,40621,939,140100,31753,11383,27606,5378,9714,7171,3510,1833,16865,14951,1914,14951,7443,7508,2018-01-01,zipcode
ZCTA5 33605,12,17457,26954,920,93700,13631,5959,11570,3099,3972,2675,1357,467,8209,7041,1168,7041,2539,4502,2018-01-01,zipcode
ZCTA5 33606,12,19466,79598,1342,505600,17348,6338,12108,491,1605,2269,4434,3309,9191,8030,1161,8030,3566,4464,2018-01-01,zipcode
ZCTA5 33607,12,23813,41794,1257,144500,19667,6822,17274,3430,5003,3548,3546,1747,12272,10644,1628,10644,4159,6485,2018-01-01,zipcode
ZCTA5 33609,12,18413,63873,1141,347200,15545,4417,13517,950,2090,3285,4181,3011,9389,8476,913,8476,4468,4008,2018-01-01,zipcode
ZCTA5 33610,12,45963,34878,971,99300,33383,13187,28208,5460,11145,7221,2971,1411,17671,16005,1666,16005,6773,9232,2018-01-01,zipcode
ZCTA5 33611,12,31791,64523,1103,257700,26597,8410,24416,1561,5156,6047,7519,4133,16633,14838,1795,14838,8321,6517,2018-01-01,zipcode
ZCTA5 33612,12,49312,33196,887,127700,38707,15489,31510,5880,11490,8508,3869,1763,20808,18487,2321,18487,6304,12183,2018-01-01,zipcode
ZCTA5 33613,12,34941,32676,852,158200,29840,10114,20399,3524,5125,5521,4098,2131,16607,14335,2272,14335,4272,10063,2018-01-01,zipcode
ZCTA5 33614,12,48029,39746,961,152300,39245,12643,33270,7038,10969,8646,4660,1957,20096,18484,1612,18484,7232,11252,2018-01-01,zipcode
ZCTA5 33615,12,45851,49506,1059,155800,37924,12584,32623,4231,10981,8591,6132,2688,19738,17479,2259,17479,9406,8073,2018-01-01,zipcode
ZCTA5 33616,12,16145,60538,1292,187100,12874,3689,11034,825,3468,3148,2157,1436,7455,6519,936,6519,3027,3492,2018-01-01,zipcode
ZCTA5 33617,12,45652,37257,967,147400,35988,11451,29434,3461,8380,8718,5409,3466,19989,18006,1983,18006,6666,11340,2018-01-01,zipcode
ZCTA5 33618,12,27081,70545,1078,273000,22727,7439,19994,646,4012,6246,5440,3650,12439,11423,1016,11423,7446,3977,2018-01-01,zipcode
ZCTA5 33619,12,39747,41318,1119,102100,31302,12368,25856,5557,9368,6831,2691,1409,14255,13156,1099,13156,6005,7151,2018-01-01,zipcode
ZCTA5 33620,12,5402,-666666666,-666666666,-666666666,5402,4329,45,11,0,24,10,0,23,11,12,11,0,11,2018-01-01,zipcode
ZCTA5 33621,12,2533,67708,2135,-666666666,1443,472,991,0,210,421,213,147,621,563,58,563,0,563,2018-01-01,zipcode
ZCTA5 33624,12,38618,68125,1225,212400,32126,9602,28378,1617,6822,9397,7071,3471,16115,15017,1098,15017,9641,5376,2018-01-01,zipcode
ZCTA5 33625,12,26242,68300,1263,208500,21447,6228,19021,1332,5366,6046,4293,1984,10759,10180,579,10180,6845,3335,2018-01-01,zipcode
ZCTA5 33626,12,29964,106560,1485,347700,22692,6750,20081,663,2726,4741,7290,4661,12387,11371,1016,11371,7440,3931,2018-01-01,zipcode
ZCTA5 33629,12,25999,115180,1245,492300,19732,6632,17926,400,1916,3571,6377,5662,11464,10454,1010,10454,8308,2146,2018-01-01,zipcode
ZCTA5 33634,12,22733,58013,1249,162400,18635,6322,16107,2082,5283,4171,3230,1341,8059,7568,491,7568,4620,2948,2018-01-01,zipcode
ZCTA5 33635,12,18353,60267,1361,164700,14460,4532,12990,1061,3708,4009,2497,1715,7845,7120,725,7120,4342,2778,2018-01-01,zipcode
ZCTA5 33637,12,17345,52635,1103,146000,13731,3790,10494,1153,2595,3543,2044,1159,7150,6258,892,6258,2391,3867,2018-01-01,zipcode
ZCTA5 33647,12,67730,84967,1302,284500,52957,14971,44140,1999,6239,10858,14844,10200,26436,24218,2218,24218,13572,10646,2018-01-01,zipcode
ZCTA5 33701,12,15209,35770,859,344500,14038,5954,12729,987,2756,3021,3494,2471,11768,8629,3139,8629,3017,5612,2018-01-01,zipcode
ZCTA5 33702,12,30562,50214,981,157600,25811,8881,23152,2203,6497,7127,4749,2576,15581,13070,2511,13070,8111,4959,2018-01-01,zipcode
ZCTA5 33703,12,25457,69575,1345,208200,21270,7735,19244,1192,4188,6032,4872,2960,12015,10694,1321,10694,8096,2598,2018-01-01,zipcode
ZCTA5 33704,12,16503,78090,978,364800,14017,4920,12883,565,2162,2940,4007,3209,8602,7372,1230,7372,5241,2131,2018-01-01,zipcode
ZCTA5 33705,12,27596,48171,1033,177100,23057,9646,19499,2206,5249,5981,3681,2382,14171,10546,3625,10546,5762,4784,2018-01-01,zipcode
ZCTA5 33706,12,16294,75212,1155,397600,15052,7110,14374,608,2698,4532,3873,2663,13876,8513,5363,8513,6154,2359,2018-01-01,zipcode
ZCTA5 33707,12,25143,47259,1041,185800,22705,11309,21167,1603,5810,6592,4730,2432,15782,12349,3433,12349,8329,4020,2018-01-01,zipcode
ZCTA5 33708,12,16098,59189,1167,282700,14823,7673,14075,751,3272,4796,3314,1942,13960,8310,5650,8310,6063,2247,2018-01-01,zipcode
ZCTA5 33709,12,25455,42146,931,111000,21817,9979,19659,2726,7340,6134,2459,1000,14378,10886,3492,10886,7943,2943,2018-01-01,zipcode
ZCTA5 33710,12,33883,57815,985,177500,28634,9749,25296,2082,7535,8009,5367,2303,15593,13341,2252,13341,10084,3257,2018-01-01,zipcode
ZCTA5 33711,12,20366,39720,1140,151000,16697,7713,13395,1730,4812,3615,2013,1225,9427,7224,2203,7224,4137,3087,2018-01-01,zipcode
ZCTA5 33712,12,25674,45077,985,163300,21139,8291,17891,1907,4902,5992,3545,1545,11770,9366,2404,9366,4857,4509,2018-01-01,zipcode
ZCTA5 33713,12,32350,54067,1102,149400,27257,9173,23629,3314,6584,7726,4250,1755,14784,12724,2060,12724,8231,4493,2018-01-01,zipcode
ZCTA5 33714,12,20375,35301,971,89000,16503,6319,14538,3195,4950,4535,1336,522,10056,7999,2057,7999,4947,3052,2018-01-01,zipcode
ZCTA5 33715,12,7488,89301,1606,375300,6969,4097,6652,126,1001,1802,2095,1628,6848,3769,3079,3769,3327,442,2018-01-01,zipcode
ZCTA5 33716,12,18043,53713,1212,206500,15339,3686,13464,416,2636,4457,4096,1859,10562,8882,1680,8882,1561,7321,2018-01-01,zipcode
ZCTA5 33744,12,145,-666666666,-666666666,-666666666,145,134,134,22,90,22,0,0,0,0,0,0,0,0,2018-01-01,zipcode
ZCTA5 33755,12,25445,39461,962,174200,20499,7846,17784,2309,6104,5818,2579,974,11153,9300,1853,9300,4856,4444,2018-01-01,zipcode
ZCTA5 33756,12,33649,42241,910,182600,27363,11428,24445,3377,5549,8906,4717,1896,16086,13356,2730,13356,7811,5545,2018-01-01,zipcode
ZCTA5 33759,12,18366,51316,1253,164700,15337,6520,13408,1398,3963,4034,2624,1389,8874,7785,1089,7785,4383,3402,2018-01-01,zipcode
ZCTA5 33760,12,17260,48195,1038,120800,14291,5067,12097,1628,3855,4189,1791,634,7769,6600,1169,6600,3054,3546,2018-01-01,zipcode
ZCTA5 33761,12,19744,50703,994,160200,17299,8181,16105,824,4264,5446,3808,1763,10410,8951,1459,8951,7323,1628,2018-01-01,zipcode
ZCTA5 33762,12,8093,65161,1342,229800,7315,3794,6473,817,1757,1657,1242,1000,3098,2652,446,2652,1939,713,2018-01-01,zipcode
ZCTA5 33763,12,20195,42992,1061,115800,18035,8731,16238,1704,5313,4963,2661,1597,11384,9416,1968,9416,6561,2855,2018-01-01,zipcode
ZCTA5 33764,12,26282,50800,1120,171800,22285,9334,20228,1315,6502,6851,3848,1712,14541,11353,3188,11353,8028,3325,2018-01-01,zipcode
ZCTA5 33765,12,14270,42224,1005,152300,11912,4111,10644,1168,3347,3712,1284,1133,6466,5899,567,5899,2695,3204,2018-01-01,zipcode
ZCTA5 33767,12,7714,80625,1725,431500,7287,4176,6917,279,1416,1910,1688,1624,8378,4111,4267,4111,3305,806,2018-01-01,zipcode
ZCTA5 33770,12,25688,44321,1034,166000,22463,9008,20066,1999,6639,6916,2946,1566,14170,11686,2484,11686,6505,5181,2018-01-01,zipcode
ZCTA5 33771,12,30346,41473,981,82000,25914,11658,23825,2385,8583,7808,3626,1423,17188,13867,3321,13867,7641,6226,2018-01-01,zipcode
ZCTA5 33772,12,22517,50833,1116,191500,19233,8354,17421,1238,5271,6026,3369,1517,12461,9934,2527,9934,7297,2637,2018-01-01,zipcode
ZCTA5 33773,12,17768,52241,1009,172900,15333,5878,13518,1009,4404,4565,2432,1108,8477,7263,1214,7263,5266,1997,2018-01-01,zipcode
ZCTA5 33774,12,19108,50085,1008,203300,16125,7351,14803,1109,4283,5336,2635,1440,10120,8237,1883,8237,5827,2410,2018-01-01,zipcode
ZCTA5 33776,12,12872,74332,1462,268400,11112,4713,10118,312,2637,3079,2577,1513,5681,5115,566,5115,4640,475,2018-01-01,zipcode
ZCTA5 33777,12,17179,55650,1233,167200,14552,6134,13335,1238,4030,4118,2339,1610,8343,7115,1228,7115,5598,1517,2018-01-01,zipcode
ZCTA5 33778,12,14710,46037,1040,141800,12376,5472,11214,1001,3745,4313,1528,627,7487,6003,1484,6003,4669,1334,2018-01-01,zipcode
ZCTA5 33781,12,25059,40055,898,136000,20872,8487,18444,2670,6614,5419,2538,1203,11827,10179,1648,10179,5994,4185,2018-01-01,zipcode
ZCTA5 33782,12,23052,48382,1148,137300,19032,8469,17466,1707,6196,5717,2400,1446,10802,9455,1347,9455,6884,2571,2018-01-01,zipcode
ZCTA5 33785,12,5515,67838,1204,426600,5179,2440,4959,189,911,1478,1512,869,6152,3002,3150,3002,2054,948,2018-01-01,zipcode
ZCTA5 33786,12,1632,78571,2479,591300,1450,871,1380,46,224,299,461,350,1167,778,389,778,680,98,2018-01-01,zipcode
ZCTA5 33801,12,35305,35696,804,78700,28649,14279,21655,4650,7836,5769,2440,960,14749,12271,2478,12271,6193,6078,2018-01-01,zipcode
ZCTA5 33803,12,29675,51502,996,133100,24528,10070,21532,1993,6797,5892,4333,2517,14581,12015,2566,12015,7378,4637,2018-01-01,zipcode
ZCTA5 33805,12,25709,35198,950,79900,20194,9235,16970,3358,6528,4293,1911,880,10547,9018,1529,9018,4223,4795,2018-01-01,zipcode
ZCTA5 33809,12,30137,52268,1057,154100,25469,11051,22263,2505,8008,7198,3053,1499,13027,10886,2141,10886,7511,3375,2018-01-01,zipcode
ZCTA5 33810,12,50302,54509,1105,142900,39888,16790,34685,4646,12463,11120,4161,2295,20101,17503,2598,17503,13149,4354,2018-01-01,zipcode
ZCTA5 33811,12,21739,57589,1001,166500,17488,6842,15324,1390,5697,4693,2482,1062,9033,7782,1251,7782,5548,2234,2018-01-01,zipcode
ZCTA5 33812,12,13450,79405,1146,180800,10443,3442,9082,563,2808,2917,1673,1121,5161,4484,677,4484,3593,891,2018-01-01,zipcode
ZCTA5 33813,12,37211,82354,1149,206700,29735,11285,25845,1038,7002,7601,6227,3977,14174,12766,1408,12766,10446,2320,2018-01-01,zipcode
ZCTA5 33815,12,14328,30973,734,26600,11295,5494,9614,2035,4495,2116,724,244,7651,5395,2256,5395,3027,2368,2018-01-01,zipcode
ZCTA5 33823,12,32139,50066,844,133400,25864,11684,22290,3764,7859,6429,2961,1277,12819,10923,1896,10923,7906,3017,2018-01-01,zipcode
ZCTA5 33825,12,26526,36595,757,82800,21615,12421,18968,3785,7086,5292,1553,1252,11653,9082,2571,9082,6437,2645,2018-01-01,zipcode
ZCTA5 33827,12,2930,61425,1026,162700,2445,1275,1882,248,627,634,239,134,1216,907,309,907,804,103,2018-01-01,zipcode
ZCTA5 33830,12,27476,50521,820,113600,21776,8579,18420,2175,7621,4983,2771,870,11328,9437,1891,9437,6176,3261,2018-01-01,zipcode
ZCTA5 33834,12,7695,44167,731,77600,5959,3628,5051,1401,2260,863,409,118,2310,1754,556,1754,1140,614,2018-01-01,zipcode
ZCTA5 33837,12,27428,55877,1211,169100,21842,9495,19268,2399,5443,6658,3355,1413,12569,8882,3687,8882,6671,2211,2018-01-01,zipcode
ZCTA5 33838,12,4178,36299,847,115200,2914,1300,2535,702,1021,661,92,59,1554,1183,371,1183,683,500,2018-01-01,zipcode
ZCTA5 33839,12,3267,45417,842,112700,2488,1023,2162,470,818,620,186,68,1147,1037,110,1037,686,351,2018-01-01,zipcode
ZCTA5 33841,12,8944,42838,738,88200,6994,3266,6056,1029,2867,1348,517,295,4071,2980,1091,2980,2220,760,2018-01-01,zipcode
ZCTA5 33843,12,11136,42200,680,70900,9561,6028,8138,2363,2878,1916,559,422,5153,3457,1696,3457,2697,760,2018-01-01,zipcode
ZCTA5 33844,12,35280,39759,875,113200,27253,12176,23661,4862,8819,6768,2105,1107,16640,11760,4880,11760,7519,4241,2018-01-01,zipcode
ZCTA5 33847,12,171,-666666666,-666666666,-666666666,124,52,72,25,36,5,6,0,48,37,11,37,35,2,2018-01-01,zipcode
ZCTA5 33848,12,1059,-666666666,-666666666,54600,778,342,573,232,267,57,0,17,488,186,302,186,116,70,2018-01-01,zipcode
ZCTA5 33849,12,1191,46875,-666666666,96700,978,442,839,207,383,213,25,11,446,335,111,335,291,44,2018-01-01,zipcode
ZCTA5 33850,12,7802,42768,918,102300,6264,2961,5486,1001,2128,1423,441,493,3806,3087,719,3087,2039,1048,2018-01-01,zipcode
ZCTA5 33851,12,1105,49500,1096,119600,853,349,782,77,390,222,84,9,414,348,66,348,332,16,2018-01-01,zipcode
ZCTA5 33852,12,21202,36972,751,120300,18179,10559,16288,2213,7331,4423,1557,764,12233,8301,3932,8301,6801,1500,2018-01-01,zipcode
ZCTA5 33853,12,12254,38300,758,114900,9043,3353,8086,1884,2393,2422,928,459,4906,4225,681,4225,2077,2148,2018-01-01,zipcode
ZCTA5 33854,12,236,30982,614,38500,212,138,212,22,78,69,30,13,653,160,493,160,70,90,2018-01-01,zipcode
ZCTA5 33855,12,0,-666666666,-666666666,-666666666,0,0,0,0,0,0,0,0,0,0,0,0,0,0,2018-01-01,zipcode
ZCTA5 33856,12,330,31094,537,-666666666,330,305,330,0,171,111,48,0,433,215,218,215,0,215,2018-01-01,zipcode
ZCTA5 33857,12,2071,27165,554,110200,1558,748,1510,451,764,268,27,0,1445,893,552,893,538,355,2018-01-01,zipcode
ZCTA5 33859,12,10364,39407,860,89900,8624,4758,7322,1252,2687,2400,592,391,5069,4219,850,4219,2901,1318,2018-01-01,zipcode
ZCTA5 33860,12,25150,51665,971,122100,19136,7766,16598,2445,6917,4566,1790,880,9387,7979,1408,7979,6091,1888,2018-01-01,zipcode
ZCTA5 33865,12,1078,43500,-666666666,83900,941,410,880,163,467,177,73,0,290,248,42,248,190,58,2018-01-01,zipcode
ZCTA5 33867,12,393,-666666666,-666666666,107300,393,265,393,46,104,101,105,37,290,205,85,205,205,0,2018-01-01,zipcode
ZCTA5 33868,12,12092,52787,867,101300,10083,5860,9233,1807,3852,2415,756,403,4590,3809,781,3809,3119,690,2018-01-01,zipcode
ZCTA5 33870,12,21760,31195,674,78000,18532,10286,16552,3515,6065,4779,1344,849,11865,8728,3137,8728,5614,3114,2018-01-01,zipcode
ZCTA5 33872,12,15778,41381,875,84000,13844,9098,12896,1084,4249,4608,1920,1035,9332,6922,2410,6922,5367,1555,2018-01-01,zipcode
ZCTA5 33873,12,13762,36250,688,85300,10390,4397,8538,2017,4039,1492,640,350,5377,4357,1020,4357,2659,1698,2018-01-01,zipcode
ZCTA5 33875,12,10928,50380,895,124200,9469,4875,8730,898,2886,2618,1611,717,5555,4631,924,4631,3940,691,2018-01-01,zipcode
ZCTA5 33876,12,4689,49828,982,99200,4023,2626,3722,525,1544,1154,313,186,2692,2000,692,2000,1734,266,2018-01-01,zipcode
ZCTA5 33877,12,589,-666666666,-666666666,-666666666,435,310,241,66,134,41,0,0,172,134,38,134,42,92,2018-01-01,zipcode
ZCTA5 33880,12,41346,42623,870,106300,32284,14336,27803,6761,10040,7597,2108,1297,16414,13648,2766,13648,8937,4711,2018-01-01,zipcode
ZCTA5 33881,12,33463,40871,838,88500,27407,14450,23960,4206,8751,7049,2670,1284,15368,12680,2688,12680,8599,4081,2018-01-01,zipcode
ZCTA5 33884,12,32069,58227,1112,168300,26493,11788,23126,1875,6940,8254,3874,2183,14556,11945,2611,11945,8424,3521,2018-01-01,zipcode
ZCTA5 33890,12,4872,35446,713,77100,3529,1646,2965,627,1610,502,110,116,1813,1463,350,1463,1189,274,2018-01-01,zipcode
ZCTA5 33896,12,9746,61738,1408,181300,8100,2664,6809,481,1883,2587,1313,545,5141,3097,2044,3097,1842,1255,2018-01-01,zipcode
ZCTA5 33897,12,19855,53130,1439,150900,15857,6338,13876,1248,5038,5104,1843,643,12073,6345,5728,6345,4607,1738,2018-01-01,zipcode
ZCTA5 33898,12,17107,43237,871,113400,14158,7057,12573,2274,4871,3539,1225,664,9351,6314,3037,6314,4878,1436,2018-01-01,zipcode
ZCTA5 33901,12,20950,35758,838,171300,17504,7911,15583,3020,4497,4058,2521,1487,10969,8876,2093,8876,3728,5148,2018-01-01,zipcode
ZCTA5 33903,12,22122,39783,870,96300,19710,11968,18416,2695,6630,5574,2235,1282,14502,10508,3994,10508,8155,2353,2018-01-01,zipcode
ZCTA5 33904,12,31859,51558,1069,222100,28278,13555,26417,2277,9550,8270,4423,1897,19946,13854,6092,13854,10472,3382,2018-01-01,zipcode
ZCTA5 33905,12,37081,47430,994,146000,30380,13672,26334,6391,8705,6593,2849,1796,14596,11385,3211,11385,7169,4216,2018-01-01,zipcode
ZCTA5 33907,12,24198,42566,1060,148300,19860,7182,17778,2697,5432,4909,3126,1614,12759,9546,3213,9546,4140,5406,2018-01-01,zipcode
ZCTA5 33908,12,36071,56593,1376,253100,33149,20600,31191,1721,8421,8254,7604,5191,31168,17557,13611,17557,12371,5186,2018-01-01,zipcode
ZCTA5 33909,12,31467,54280,1149,173400,25167,9627,21543,2195,8217,7043,2927,1161,11786,10445,1341,10445,6302,4143,2018-01-01,zipcode
ZCTA5 33912,12,18402,73271,1302,265800,16529,8957,15147,727,3521,4623,3694,2582,11215,7905,3310,7905,6622,1283,2018-01-01,zipcode
ZCTA5 33913,12,23816,80713,1486,289600,20543,9630,17426,1130,3501,4965,4693,3137,12171,8271,3900,8271,6983,1288,2018-01-01,zipcode
ZCTA5 33914,12,37375,64484,1193,270800,32267,14148,29290,2006,9538,9609,5183,2954,20234,14735,5499,14735,11025,3710,2018-01-01,zipcode
ZCTA5 33916,12,23438,36765,943,94400,17410,6170,14888,3683,4537,3745,1803,1120,10963,8169,2794,8169,2961,5208,2018-01-01,zipcode
ZCTA5 33917,12,29439,45736,824,92100,26151,15414,24515,2870,10004,7036,2885,1720,17120,12471,4649,12471,10145,2326,2018-01-01,zipcode
ZCTA5 33919,12,30764,55669,1184,195700,26913,13072,25269,1707,6110,8062,5524,3866,18660,14047,4613,14047,10342,3705,2018-01-01,zipcode
ZCTA5 33920,12,5993,78750,859,263900,5044,2132,4470,575,1362,1614,585,334,2473,1958,515,1958,1730,228,2018-01-01,zipcode
ZCTA5 33921,12,861,68661,-666666666,925700,845,521,762,35,51,434,194,48,1837,321,1516,321,268,53,2018-01-01,zipcode
ZCTA5 33922,12,3731,41607,959,174200,3321,2048,3119,287,992,1054,483,303,2677,1656,1021,1656,1348,308,2018-01-01,zipcode
ZCTA5 33924,12,200,-666666666,-666666666,-666666666,200,75,188,78,37,35,26,12,1904,49,1855,49,36,13,2018-01-01,zipcode
ZCTA5 33928,12,24682,75302,1589,305900,21387,12134,20481,1125,4446,5832,5350,3728,17163,10908,6255,10908,9278,1630,2018-01-01,zipcode
ZCTA5 33930,12,903,44018,-666666666,-666666666,618,117,516,116,277,87,0,36,442,371,71,371,326,45,2018-01-01,zipcode
ZCTA5 33931,12,10675,58019,1097,321600,10421,7456,10204,688,2860,3032,2070,1554,14985,5623,9362,5623,4762,861,2018-01-01,zipcode
ZCTA5 33935,12,21968,41605,746,87700,16437,6880,13633,4539,4609,3204,606,675,7955,6229,1726,6229,4347,1882,2018-01-01,zipcode
ZCTA5 33936,12,23787,40732,920,114800,19467,9282,17230,3306,6589,4620,1783,932,9770,8130,1640,8130,5020,3110,2018-01-01,zipcode
ZCTA5 33944,12,268,-666666666,-666666666,-666666666,165,138,165,0,165,0,0,0,137,104,33,104,104,0,2018-01-01,zipcode
ZCTA5 33945,12,0,-666666666,-666666666,-666666666,0,0,0,0,0,0,0,0,187,0,187,0,0,0,2018-01-01,zipcode
ZCTA5 33946,12,2325,74063,1592,416200,2261,1552,2225,118,760,550,599,198,2883,1184,1699,1184,1040,144,2018-01-01,zipcode
ZCTA5 33947,12,8901,51078,1172,233000,8273,5506,7804,454,2691,2813,1126,720,5651,4100,1551,4100,3470,630,2018-01-01,zipcode
ZCTA5 33948,12,16361,45197,976,163800,14336,7596,13061,1173,4559,4656,1510,1163,8843,6826,2017,6826,5524,1302,2018-01-01,zipcode
ZCTA5 33950,12,22017,56855,966,280000,20767,13935,19645,1278,4890,6371,4365,2741,15536,11210,4326,11210,9157,2053,2018-01-01,zipcode
ZCTA5 33952,12,33662,39761,953,131900,29066,13981,26192,3078,9703,8762,3108,1541,16330,13739,2591,13739,9647,4092,2018-01-01,zipcode
ZCTA5 33953,12,6885,56888,985,214900,6410,4160,6002,468,1938,2190,828,578,3893,2986,907,2986,2669,317,2018-01-01,zipcode
ZCTA5 33954,12,9294,55546,1312,193800,7952,3985,7070,618,2555,2334,1023,540,4043,3599,444,3599,2843,756,2018-01-01,zipcode
ZCTA5 33955,12,11406,60169,1066,235500,10439,7236,9721,1531,2914,2749,1637,890,6515,4376,2139,4376,3935,441,2018-01-01,zipcode
ZCTA5 33956,12,3437,54464,1089,197600,3295,2341,3108,147,967,942,620,432,3244,1637,1607,1637,1457,180,2018-01-01,zipcode
ZCTA5 33957,12,7224,102135,1443,720500,6695,4243,6525,147,907,1513,1998,1960,8929,3678,5251,3678,3117,561,2018-01-01,zipcode
ZCTA5 33960,12,719,49464,1089,168800,665,317,627,51,283,182,92,19,615,329,286,329,289,40,2018-01-01,zipcode
ZCTA5 33965,12,1659,-666666666,-666666666,-666666666,1659,821,11,0,0,11,0,0,0,0,0,0,0,0,2018-01-01,zipcode
ZCTA5 33966,12,10185,61911,1052,256000,8802,4418,7885,406,1893,2191,1888,1507,5672,4343,1329,4343,3065,1278,2018-01-01,zipcode
ZCTA5 33967,12,25041,64896,1232,206400,20452,5928,16522,2165,4142,5407,3458,1350,9764,8231,1533,8231,6082,2149,2018-01-01,zipcode
ZCTA5 33971,12,27255,50212,1089,148100,20194,7208,16322,3317,5800,4902,1530,773,8176,7284,892,7284,5014,2270,2018-01-01,zipcode
ZCTA5 33972,12,15299,58151,1079,162200,12111,4813,10115,1709,3624,3422,1000,360,5242,4453,789,4453,3025,1428,2018-01-01,zipcode
ZCTA5 33973,12,14875,39250,963,195300,9533,3137,7662,1995,2945,1933,542,247,4284,3811,473,3811,790,3021,2018-01-01,zipcode
ZCTA5 33974,12,17119,47831,1117,145800,12653,4306,10721,1772,4192,3177,1121,459,5320,4580,740,4580,2846,1734,2018-01-01,zipcode
ZCTA5 33976,12,18554,48957,1117,133300,12969,3936,10688,2616,3737,2979,1088,268,4930,4614,316,4614,2960,1654,2018-01-01,zipcode
ZCTA5 33980,12,13336,43559,834,140800,11700,7723,10709,1090,3120,3926,1574,999,8046,5796,2250,5796,4256,1540,2018-01-01,zipcode
ZCTA5 33981,12,10729,54461,1209,231300,9532,5498,9118,704,3307,3178,1217,712,6272,4530,1742,4530,3795,735,2018-01-01,zipcode
ZCTA5 33982,12,11025,47067,839,113200,9384,5406,8444,1403,2809,2986,659,587,5211,4117,1094,4117,3440,677,2018-01-01,zipcode
ZCTA5 33983,12,14422,54683,993,201000,12307,6615,11201,843,3658,3867,1819,1014,7630,5849,1781,5849,4765,1084,2018-01-01,zipcode
ZCTA5 33990,12,32901,54022,1087,201300,27964,11971,25361,2208,9409,8757,3412,1575,14074,11404,2670,11404,7974,3430,2018-01-01,zipcode
ZCTA5 33991,12,22354,66095,1435,231600,17589,6597,15195,752,5128,4712,3137,1466,9264,7484,1780,7484,5659,1825,2018-01-01,zipcode
ZCTA5 33993,12,24856,58935,1359,199300,20480,8506,17457,1755,6761,5419,2323,1199,9715,8056,1659,8056,6206,1850,2018-01-01,zipcode
ZCTA5 34101,12,0,-666666666,-666666666,-666666666,0,0,0,0,0,0,0,0,15,0,15,0,0,0,2018-01-01,zipcode
ZCTA5 34102,12,11454,80609,1180,968600,10307,5818,9608,811,1406,2244,3104,2043,9716,5555,4161,5555,3925,1630,2018-01-01,zipcode
ZCTA5 34103,12,12802,84972,1319,695600,11882,7199,11205,763,2378,2638,2935,2491,11174,6126,5048,6126,4810,1316,2018-01-01,zipcode
ZCTA5 34104,12,24121,51793,1139,242100,20848,10027,18915,2279,5520,5312,3506,2298,15068,10467,4601,10467,7250,3217,2018-01-01,zipcode
ZCTA5 34105,12,17248,88223,1526,438500,15188,8043,14064,539,2415,4226,4192,2692,10440,7688,2752,7688,5359,2329,2018-01-01,zipcode
ZCTA5 34108,12,16636,90907,1358,692700,15379,9017,14552,617,3088,3154,4125,3568,14423,8014,6409,8014,6461,1553,2018-01-01,zipcode
ZCTA5 34109,12,24662,66038,1357,387700,20868,9938,19254,988,4386,4276,6050,3554,14753,11148,3605,11148,6824,4324,2018-01-01,zipcode
ZCTA5 34110,12,24008,77197,1567,377100,21659,12639,20418,925,4105,5404,5510,4474,16335,10901,5434,10901,8431,2470,2018-01-01,zipcode
ZCTA5 34112,12,27543,55687,1034,214300,24574,13208,22532,2739,7162,5959,3999,2673,19354,12201,7153,12201,9177,3024,2018-01-01,zipcode
ZCTA5 34113,12,21409,51992,1232,259400,18081,8818,15535,2913,4234,3950,2782,1656,13066,8177,4889,8177,5611,2566,2018-01-01,zipcode
ZCTA5 34114,12,16727,59800,1205,237000,14960,8530,13570,1668,4191,3937,2333,1441,12567,7251,5316,7251,6074,1177,2018-01-01,zipcode
ZCTA5 34116,12,36531,50579,1168,228600,27966,7313,23896,6881,8462,5043,2343,1167,10448,9620,828,9620,5092,4528,2018-01-01,zipcode
ZCTA5 34117,12,15794,73010,1529,276400,13110,4189,11059,1598,3449,3088,2059,865,5167,4664,503,4664,4314,350,2018-01-01,zipcode
ZCTA5 34119,12,31632,87992,1460,433300,26597,13167,23806,967,5425,6362,6350,4702,16246,12767,3479,12767,9691,3076,2018-01-01,zipcode
ZCTA5 34120,12,32502,79244,1581,311100,25044,9022,22197,2720,6213,6041,3930,3293,13053,10156,2897,10156,8623,1533,2018-01-01,zipcode
ZCTA5 34134,12,13977,83135,1156,475700,13248,9026,12802,406,2790,3149,3688,2769,14012,7139,6873,7139,6095,1044,2018-01-01,zipcode
ZCTA5 34135,12,46064,61809,1217,261900,40173,21226,36228,5922,8403,9914,7254,4735,27842,18232,9610,18232,14223,4009,2018-01-01,zipcode
ZCTA5 34137,12,454,23219,-666666666,-666666666,195,114,195,0,99,96,0,0,114,114,0,114,16,98,2018-01-01,zipcode
ZCTA5 34138,12,268,-666666666,-666666666,143800,268,166,268,0,96,101,56,15,326,119,207,119,119,0,2018-01-01,zipcode
ZCTA5 34139,12,486,-666666666,788,118400,301,114,266,31,94,78,41,22,475,177,298,177,157,20,2018-01-01,zipcode
ZCTA5 34140,12,437,-666666666,-666666666,-666666666,346,221,290,0,44,116,130,0,480,144,336,144,100,44,2018-01-01,zipcode
ZCTA5 34141,12,67,-666666666,-666666666,-666666666,58,22,36,0,0,14,4,18,17,17,0,17,3,14,2018-01-01,zipcode
ZCTA5 34142,12,30955,32128,773,137300,22450,7305,16761,9748,3923,1703,942,445,7897,6701,1196,6701,2727,3974,2018-01-01,zipcode
ZCTA5 34145,12,17692,79157,1595,598200,16469,9859,15800,1265,3083,4286,4427,2739,18700,8515,10185,8515,7310,1205,2018-01-01,zipcode
ZCTA5 34201,12,3930,92876,1929,413800,3618,2154,3475,162,488,744,986,1095,2619,1817,802,1817,1691,126,2018-01-01,zipcode
ZCTA5 34202,12,23739,96919,1816,419300,19700,9374,17661,526,2782,4341,5595,4417,11224,9193,2031,9193,7095,2098,2018-01-01,zipcode
ZCTA5 34203,12,37632,51569,1038,190500,30925,14158,28140,3760,9554,7957,4274,2595,18325,14093,4232,14093,10282,3811,2018-01-01,zipcode
ZCTA5 34205,12,32534,40613,954,126100,26199,11424,23215,3783,8113,7135,2668,1516,15684,12686,2998,12686,7243,5443,2018-01-01,zipcode
ZCTA5 34207,12,36738,37906,948,72500,30285,13975,26146,4977,10140,6806,2592,1631,19275,15023,4252,15023,8499,6524,2018-01-01,zipcode
ZCTA5 34208,12,39538,47139,1021,161800,30442,12536,25780,5270,9664,5954,3393,1499,14411,12339,2072,12339,6932,5407,2018-01-01,zipcode
ZCTA5 34209,12,34794,57995,1171,215900,30784,15234,27590,1652,8847,8885,5131,3075,18313,14484,3829,14484,10621,3863,2018-01-01,zipcode
ZCTA5 34210,12,17023,47547,1103,200000,14992,7477,13077,1003,3731,4224,2389,1730,11125,7262,3863,7262,4245,3017,2018-01-01,zipcode
ZCTA5 34211,12,7885,103385,1675,377000,6668,3484,6140,219,1404,1813,1769,935,4131,3191,940,3191,2868,323,2018-01-01,zipcode
ZCTA5 34212,12,19301,91971,1558,339100,15537,6079,13775,397,2541,4598,3860,2379,8444,6942,1502,6942,5605,1337,2018-01-01,zipcode
ZCTA5 34215,12,560,45000,-666666666,831100,544,350,498,0,109,173,125,91,540,262,278,262,221,41,2018-01-01,zipcode
ZCTA5 34216,12,874,70833,1148,858600,823,511,792,40,154,242,186,170,1367,416,951,416,381,35,2018-01-01,zipcode
ZCTA5 34217,12,5127,61228,1211,546800,4787,2810,4648,97,806,1614,1080,1051,6478,2761,3717,2761,2041,720,2018-01-01,zipcode
ZCTA5 34219,12,23792,81918,1724,258200,19061,7481,17332,903,4562,6295,3827,1745,9621,8349,1272,8349,7573,776,2018-01-01,zipcode
ZCTA5 34221,12,44294,53329,1055,151600,36978,17691,32317,4330,11482,9597,4443,2465,20221,15392,4829,15392,12091,3301,2018-01-01,zipcode
ZCTA5 34222,12,11184,51103,1011,95100,9785,5565,9150,736,3056,3543,1200,615,7253,5182,2071,5182,4015,1167,2018-01-01,zipcode
ZCTA5 34223,12,17370,53430,938,220000,16300,11321,15648,742,5890,4610,2595,1811,13401,8667,4734,8667,7098,1569,2018-01-01,zipcode
ZCTA5 34224,12,15913,44673,929,152800,14493,8576,13409,1306,5515,3691,1727,1170,10803,7459,3344,7459,5957,1502,2018-01-01,zipcode
ZCTA5 34228,12,7233,104825,1435,720700,7118,5439,6993,252,682,1502,2228,2329,9319,3835,5484,3835,3555,280,2018-01-01,zipcode
ZCTA5 34229,12,7824,91972,1191,428400,6873,3644,6322,221,1224,1508,1699,1670,4205,3407,798,3407,2859,548,2018-01-01,zipcode
ZCTA5 34231,12,30267,51758,1114,226300,26474,11167,24314,1817,6989,7555,4617,3336,18297,14425,3872,14425,8907,5518,2018-01-01,zipcode
ZCTA5 34232,12,34639,64331,1345,207600,29261,10687,26204,2151,9263,7258,5145,2387,15201,13538,1663,13538,9236,4302,2018-01-01,zipcode
ZCTA5 34233,12,17989,60589,1440,249000,15239,6816,13662,880,3819,3587,3283,2093,8931,7797,1134,7797,5911,1886,2018-01-01,zipcode
ZCTA5 34234,12,21865,35891,952,117800,17819,8136,14998,2576,5476,3715,1948,1283,10315,8698,1617,8698,4566,4132,2018-01-01,zipcode
ZCTA5 34235,12,14671,56761,1347,217200,12788,6488,11407,709,2863,3419,2450,1966,8386,6473,1913,6473,4954,1519,2018-01-01,zipcode
ZCTA5 34236,12,12920,53247,1030,655700,11870,7281,11544,940,1627,2847,3179,2951,10718,7003,3715,7003,4251,2752,2018-01-01,zipcode
ZCTA5 34237,12,17307,42341,1074,137900,14851,5537,13204,2201,4617,3530,1986,870,8471,6960,1511,6960,3552,3408,2018-01-01,zipcode
ZCTA5 34238,12,19364,72426,1581,354700,17815,10772,16669,471,3075,4290,4563,4270,12514,9886,2628,9886,7465,2421,2018-01-01,zipcode
ZCTA5 34239,12,15499,56059,1245,263300,13208,4990,12064,936,2733,3343,3181,1871,8573,6912,1661,6912,4864,2048,2018-01-01,zipcode
ZCTA5 34240,12,11142,88430,1542,399400,9118,4377,8144,349,2025,2200,1956,1614,5456,3954,1502,3954,3704,250,2018-01-01,zipcode
ZCTA5 34241,12,14675,82616,1609,340100,12358,5476,11102,459,2687,3339,2644,1973,6639,5727,912,5727,4962,765,2018-01-01,zipcode
ZCTA5 34242,12,7706,100352,1531,690500,7060,4196,6697,212,804,1663,2184,1834,10834,3860,6974,3860,3293,567,2018-01-01,zipcode
ZCTA5 34243,12,32235,61541,1472,266000,28060,13515,25284,1288,6180,7686,5997,4133,15428,13399,2029,13399,9926,3473,2018-01-01,zipcode
ZCTA5 34251,12,5922,82154,1262,307300,4913,1628,4322,538,1655,1268,515,346,2119,1815,304,1815,1678,137,2018-01-01,zipcode
ZCTA5 34266,12,32246,33810,678,81500,26318,13573,22387,6716,9798,3767,1511,595,12369,10053,2316,10053,6695,3358,2018-01-01,zipcode
ZCTA5 34268,12,128,23286,-666666666,-666666666,109,109,109,64,45,0,0,0,155,80,75,80,51,29,2018-01-01,zipcode
ZCTA5 34269,12,4025,41535,871,126800,3653,2387,3422,303,1328,931,608,252,2578,1863,715,1863,1637,226,2018-01-01,zipcode
ZCTA5 34275,12,20074,60258,1053,283700,17897,9981,16297,705,4924,4672,3560,2436,11340,9229,2111,9229,7491,1738,2018-01-01,zipcode
ZCTA5 34285,12,18069,52701,1179,192000,17561,12117,16607,654,5196,4697,3599,2461,15226,9741,5485,9741,7412,2329,2018-01-01,zipcode
ZCTA5 34286,12,18625,64500,1407,165300,14600,5736,12549,1494,4378,4306,1886,485,7246,6264,982,6264,5130,1134,2018-01-01,zipcode
ZCTA5 34287,12,27532,50627,1037,140500,24208,13610,22376,2229,9028,6631,2869,1619,14935,11122,3813,11122,8100,3022,2018-01-01,zipcode
ZCTA5 34288,12,12304,56746,1216,181900,9983,4871,9016,724,3206,3555,939,592,4888,4419,469,4419,3569,850,2018-01-01,zipcode
ZCTA5 34289,12,3734,54922,1185,192200,3231,1176,2448,81,388,1071,665,243,1970,1563,407,1563,572,991,2018-01-01,zipcode
ZCTA5 34291,12,6119,57841,1354,182000,4949,2155,4440,395,1899,1500,431,215,2126,2126,0,2126,1767,359,2018-01-01,zipcode
ZCTA5 34292,12,16054,61759,1429,296700,14631,10450,13922,678,3456,3996,3409,2383,9663,7814,1849,7814,6046,1768,2018-01-01,zipcode
ZCTA5 34293,12,37969,57835,1258,222100,34132,19325,31925,1709,9412,10142,6722,3940,22392,17457,4935,17457,14773,2684,2018-01-01,zipcode
ZCTA5 34420,12,18107,42040,796,103000,14604,5852,12691,1747,5486,4158,1041,259,7940,6561,1379,6561,4754,1807,2018-01-01,zipcode
ZCTA5 34428,12,9369,38250,709,109200,7998,4147,7183,1028,2636,2469,736,314,5315,4025,1290,4025,3049,976,2018-01-01,zipcode
ZCTA5 34429,12,8272,42398,962,118200,7551,4407,6647,591,2512,2098,844,602,5051,3765,1286,3765,3163,602,2018-01-01,zipcode
ZCTA5 34431,12,7958,38553,788,109100,6704,3866,6088,639,2781,1759,552,357,4174,3473,701,3473,2903,570,2018-01-01,zipcode
ZCTA5 34432,12,12583,41921,892,133100,10887,6841,10179,1412,3517,3222,1470,558,6553,5505,1048,5505,4640,865,2018-01-01,zipcode
ZCTA5 34433,12,5957,52525,829,128200,5181,2729,4719,593,1784,1560,593,189,3359,2725,634,2725,2403,322,2018-01-01,zipcode
ZCTA5 34434,12,7731,47369,1153,137500,6385,3080,5817,517,2546,2050,575,129,3917,2961,956,2961,2403,558,2018-01-01,zipcode
ZCTA5 34436,12,8225,36401,698,89700,7082,4055,6306,1094,2607,1904,315,386,4576,3591,985,3591,2966,625,2018-01-01,zipcode
ZCTA5 34442,12,13953,46612,825,161400,12677,8447,11912,1171,4275,3235,1898,1333,8643,6535,2108,6535,5780,755,2018-01-01,zipcode
ZCTA5 34445,12,0,-666666666,-666666666,-666666666,0,0,0,0,0,0,0,0,0,0,0,0,0,0,2018-01-01,zipcode
ZCTA5 34446,12,16647,44962,954,136000,14811,10050,13804,1578,5048,4352,1951,875,9378,7632,1746,7632,6782,850,2018-01-01,zipcode
ZCTA5 34448,12,10620,38397,774,77200,9341,5862,8545,1005,3673,2977,690,200,6472,4780,1692,4780,3739,1041,2018-01-01,zipcode
ZCTA5 34449,12,2966,25970,504,80000,2690,1539,2555,434,1051,738,206,126,1830,1388,442,1388,942,446,2018-01-01,zipcode
ZCTA5 34450,12,10747,36630,738,116900,9274,5486,8510,921,3178,2802,854,755,6090,5072,1018,5072,3685,1387,2018-01-01,zipcode
ZCTA5 34452,12,11400,38151,834,108200,9826,5433,8676,1026,3606,2730,822,492,5781,4933,848,4933,3942,991,2018-01-01,zipcode
ZCTA5 34453,12,11427,39495,899,102600,9521,5510,8650,1480,3304,2727,779,360,5709,4418,1291,4418,3478,940,2018-01-01,zipcode
ZCTA5 34461,12,10664,44536,705,161100,9611,6145,8591,1169,3137,2559,1117,609,5521,4232,1289,4232,3325,907,2018-01-01,zipcode
ZCTA5 34465,12,17603,37870,853,145400,14900,8969,13871,1328,5107,4891,1593,952,9100,7929,1171,7929,6299,1630,2018-01-01,zipcode
ZCTA5 34470,12,19856,36440,833,98600,16212,7353,14021,1636,5251,4842,1632,660,9477,7924,1553,7924,4644,3280,2018-01-01,zipcode
ZCTA5 34471,12,24898,49805,883,170700,20044,8569,17013,1419,5343,4930,3145,2176,11338,9586,1752,9586,6311,3275,2018-01-01,zipcode
ZCTA5 34472,12,31632,42003,946,100200,24302,10817,19920,2489,7452,6681,2254,1044,11928,10499,1429,10499,7569,2930,2018-01-01,zipcode
ZCTA5 34473,12,19522,52949,998,148300,15611,6949,14190,1823,5760,4314,1823,470,7955,6742,1213,6742,5221,1521,2018-01-01,zipcode
ZCTA5 34474,12,16659,43394,999,131600,13485,5525,11900,1427,3493,3794,2042,1144,7934,6730,1204,6730,3187,3543,2018-01-01,zipcode
ZCTA5 34475,12,12882,23955,692,79400,10185,6198,8657,2046,3430,2178,674,329,5195,4068,1127,4068,1969,2099,2018-01-01,zipcode
ZCTA5 34476,12,22665,51241,853,144200,19833,11990,18306,1751,6347,6354,2646,1208,11490,9693,1797,9693,8665,1028,2018-01-01,zipcode
ZCTA5 34479,12,13533,43879,842,99400,10765,4542,9521,1109,4008,2932,1036,436,5754,5128,626,5128,3616,1512,2018-01-01,zipcode
ZCTA5 34480,12,19029,53160,795,141700,15112,5817,13006,1101,4767,3915,1713,1510,7927,6679,1248,6679,4806,1873,2018-01-01,zipcode
ZCTA5 34481,12,19147,42276,926,115100,17981,13383,17346,1371,5577,5863,3118,1417,11587,9769,1818,9769,8825,944,2018-01-01,zipcode
ZCTA5 34482,12,25244,41820,778,141300,21674,13546,19562,4014,7166,5451,2167,764,9522,7479,2043,7479,5772,1707,2018-01-01,zipcode
ZCTA5 34484,12,3604,42697,853,213400,2826,1422,2513,219,810,958,368,158,1928,1548,380,1548,947,601,2018-01-01,zipcode
ZCTA5 34488,12,10499,33302,794,58100,8599,5129,7728,1089,3438,2407,656,138,5524,4139,1385,4139,3208,931,2018-01-01,zipcode
ZCTA5 34491,12,24936,46338,930,165600,22276,14833,21127,2057,8268,6462,3002,1338,15024,11817,3207,11817,10342,1475,2018-01-01,zipcode
ZCTA5 34498,12,576,40938,1012,159400,464,285,437,51,159,130,67,30,500,279,221,279,210,69,2018-01-01,zipcode
ZCTA5 34601,12,21847,38699,794,100900,18117,10194,16243,2514,5909,4697,2078,1045,11424,9267,2157,9267,6436,2831,2018-01-01,zipcode
ZCTA5 34602,12,7314,53675,928,140000,6126,3296,5587,1032,2114,1320,682,439,2939,2614,325,2614,2121,493,2018-01-01,zipcode
ZCTA5 34604,12,11573,53694,898,145900,9528,4616,8448,1082,3122,2733,1016,495,4385,3989,396,3989,3382,607,2018-01-01,zipcode
ZCTA5 34606,12,26274,41744,931,119000,22419,13345,20404,2255,7521,6927,2499,1202,13913,11723,2190,11723,8819,2904,2018-01-01,zipcode
ZCTA5 34607,12,8778,44213,969,194500,7975,4816,7148,717,2304,2467,1140,520,5181,4043,1138,4043,3317,726,2018-01-01,zipcode
ZCTA5 34608,12,34476,45573,991,124600,28515,13953,24750,3370,9336,8654,2309,1081,14720,13208,1512,13208,9366,3842,2018-01-01,zipcode
ZCTA5 34609,12,41250,52582,1111,152600,33243,16146,29304,2873,9619,11164,3782,1866,17421,15419,2002,15419,12301,3118,2018-01-01,zipcode
ZCTA5 34610,12,14656,49551,997,138300,12084,5882,10376,1783,3956,3150,980,507,5717,5051,666,5051,4020,1031,2018-01-01,zipcode
ZCTA5 34613,12,17433,43059,950,94700,15599,9840,14525,1972,5562,4690,1500,801,10182,8142,2040,8142,6968,1174,2018-01-01,zipcode
ZCTA5 34614,12,7237,49841,1036,143200,5964,2773,5131,624,1971,1739,474,323,2937,2596,341,2596,2346,250,2018-01-01,zipcode
ZCTA5 34637,12,8209,80691,1644,223500,7004,4689,6251,858,1608,1822,1147,816,2553,2118,435,2118,1796,322,2018-01-01,zipcode
ZCTA5 34638,12,26512,92393,1422,241700,19153,5635,16607,904,3514,5607,4596,1986,9071,8484,587,8484,6868,1616,2018-01-01,zipcode
ZCTA5 34639,12,27522,80380,1264,233900,22009,7339,19092,1324,4268,6428,4796,2276,10124,9606,518,9606,7791,1815,2018-01-01,zipcode
ZCTA5 34652,12,23409,37171,891,95200,20244,10585,18281,2274,6922,6016,2007,1062,14568,10538,4030,10538,6521,4017,2018-01-01,zipcode
ZCTA5 34653,12,35015,40321,989,94300,29153,14489,25815,3053,9647,9053,2736,1326,17301,14609,2692,14609,8941,5668,2018-01-01,zipcode
ZCTA5 34654,12,23021,48903,1031,150200,19355,9903,17071,2097,6123,5774,1971,1106,10459,8854,1605,8854,6728,2126,2018-01-01,zipcode
ZCTA5 34655,12,39385,61845,1161,214700,32995,15319,30135,1827,9130,10146,5843,3189,19378,16595,2783,16595,13116,3479,2018-01-01,zipcode
ZCTA5 34661,12,138,31250,-666666666,-666666666,101,34,83,0,75,8,0,0,69,42,27,42,34,8,2018-01-01,zipcode
ZCTA5 34667,12,33960,42472,896,125200,29649,17781,27261,3250,10235,8737,3361,1678,19588,15450,4138,15450,11073,4377,2018-01-01,zipcode
ZCTA5 34668,12,47309,36261,949,83100,38939,18915,34087,4636,13437,11551,3124,1339,22919,19363,3556,19363,11857,7506,2018-01-01,zipcode
ZCTA5 34669,12,12752,47072,987,137600,10676,5099,9375,834,4021,3072,997,451,5822,4990,832,4990,4071,919,2018-01-01,zipcode
ZCTA5 34677,12,22152,62288,1132,222400,18598,7027,16014,991,4282,4929,3830,1982,10230,8810,1420,8810,6321,2489,2018-01-01,zipcode
ZCTA5 34679,12,103,-666666666,-666666666,146400,86,65,86,0,68,6,6,6,71,53,18,53,36,17,2018-01-01,zipcode
ZCTA5 34681,12,775,58438,-666666666,406300,706,335,647,26,99,110,288,124,501,355,146,355,355,0,2018-01-01,zipcode
ZCTA5 34683,12,33162,62766,1183,261200,28147,11353,24807,1344,5652,8824,6208,2779,15912,13367,2545,13367,10078,3289,2018-01-01,zipcode
ZCTA5 34684,12,28784,51853,1299,181600,25561,11984,23013,1163,6568,7992,4998,2292,14765,13167,1598,13167,8758,4409,2018-01-01,zipcode
ZCTA5 34685,12,18899,84403,1317,334600,15815,6696,13872,499,2850,3800,4290,2433,8023,7295,728,7295,5481,1814,2018-01-01,zipcode
ZCTA5 34688,12,6497,85766,1625,343600,5610,2617,5203,226,930,1658,1510,879,3613,2839,774,2839,2536,303,2018-01-01,zipcode
ZCTA5 34689,12,27496,47262,845,185400,23477,11693,20829,2247,6197,6537,3651,2197,13499,10624,2875,10624,7526,3098,2018-01-01,zipcode
ZCTA5 34690,12,12028,35364,1007,70100,10285,5231,9161,1265,4124,2663,826,283,6792,5394,1398,5394,3428,1966,2018-01-01,zipcode
ZCTA5 34691,12,20473,39836,998,81100,16689,7958,15095,1521,6506,4640,1827,601,11876,8575,3301,8575,5700,2875,2018-01-01,zipcode
ZCTA5 34695,12,18096,72813,1249,241700,15115,5583,13690,595,3426,3975,3773,1921,8321,7295,1026,7295,5935,1360,2018-01-01,zipcode
ZCTA5 34698,12,38909,48246,1057,179500,34236,16029,31808,2673,9089,9743,6709,3594,21621,18237,3384,18237,12155,6082,2018-01-01,zipcode
ZCTA5 34705,12,2649,54708,956,104600,2024,739,1792,242,674,732,132,12,1122,896,226,896,686,210,2018-01-01,zipcode
ZCTA5 34711,12,60564,67795,1309,217000,48855,20282,42888,3437,11009,16065,7747,4630,24101,21224,2877,21224,16528,4696,2018-01-01,zipcode
ZCTA5 34714,12,21743,54141,1175,171400,17011,5503,14194,1010,4286,4832,3396,670,9506,7266,2240,7266,3781,3485,2018-01-01,zipcode
ZCTA5 34715,12,17948,59202,1226,219600,14468,5859,12299,1329,3412,4635,2015,908,6246,5669,577,5669,3717,1952,2018-01-01,zipcode
ZCTA5 34731,12,13218,46800,953,156900,11253,5448,10294,925,3675,3272,1496,926,6753,5682,1071,5682,4500,1182,2018-01-01,zipcode
ZCTA5 34734,12,4225,62014,1286,278100,3172,1287,2647,268,809,814,461,295,1363,1363,0,1363,1195,168,2018-01-01,zipcode
ZCTA5 34736,12,18213,58628,1310,174200,14533,5983,12845,1932,3904,3981,2081,947,6759,6104,655,6104,4994,1110,2018-01-01,zipcode
ZCTA5 34737,12,2551,58011,1147,211500,2115,983,1896,205,599,572,348,172,1303,979,324,979,810,169,2018-01-01,zipcode
ZCTA5 34739,12,334,-666666666,-666666666,93200,235,136,235,56,95,33,51,0,415,170,245,170,134,36,2018-01-01,zipcode
ZCTA5 34741,12,45920,37148,1056,151200,35896,12240,30424,4737,10234,10617,3360,1476,19850,15205,4645,15205,4535,10670,2018-01-01,zipcode
ZCTA5 34743,12,44335,43915,1244,161700,34729,12862,29106,4672,10422,9460,3359,1193,13304,11779,1525,11779,7552,4227,2018-01-01,zipcode
ZCTA5 34744,12,55210,48991,1202,196800,43263,16027,36355,4902,9998,12783,6081,2591,18504,15738,2766,15738,9678,6060,2018-01-01,zipcode
ZCTA5 34746,12,43249,54056,1407,187100,34348,12464,29253,3207,8707,10606,4650,2083,21749,12766,8983,12766,8455,4311,2018-01-01,zipcode
ZCTA5 34747,12,19413,63591,1406,300000,16122,4923,13335,379,2921,3938,3801,2296,24308,7147,17161,7147,3370,3777,2018-01-01,zipcode
ZCTA5 34748,12,39230,43969,894,150200,33447,21166,31016,3606,11765,9753,3613,2279,20941,17577,3364,17577,12666,4911,2018-01-01,zipcode
ZCTA5 34753,12,5818,43750,1001,121900,4448,1868,3907,837,1676,1160,148,86,1828,1783,45,1783,1430,353,2018-01-01,zipcode
ZCTA5 34756,12,3704,70565,1057,253800,2895,990,2352,196,541,954,442,219,1429,1238,191,1238,1018,220,2018-01-01,zipcode
ZCTA5 34758,12,41094,49329,1207,164200,31850,12528,25661,4001,9908,7809,2610,1333,12914,10311,2603,10311,7065,3246,2018-01-01,zipcode
ZCTA5 34759,12,39850,50952,1243,173100,30757,15981,26139,4788,7677,8031,3792,1851,15234,11633,3601,11633,8679,2954,2018-01-01,zipcode
ZCTA5 34760,12,874,62614,973,208200,678,160,612,54,226,249,75,8,332,290,42,290,223,67,2018-01-01,zipcode
ZCTA5 34761,12,45639,63923,1267,223900,34732,11016,30166,4213,6661,8774,7183,3335,16271,15349,922,15349,10338,5011,2018-01-01,zipcode
ZCTA5 34762,12,484,60781,-666666666,77600,470,243,442,108,240,66,12,16,269,230,39,230,230,0,2018-01-01,zipcode
ZCTA5 34769,12,25018,45951,985,141800,19689,8090,17156,2519,6237,5839,1922,639,10222,8159,2063,8159,5278,2881,2018-01-01,zipcode
ZCTA5 34771,12,17351,72769,1139,269500,13999,6064,11468,984,3723,4029,1936,796,6609,5265,1344,5265,4689,576,2018-01-01,zipcode
ZCTA5 34772,12,30746,66652,1397,210800,23250,8441,20042,2137,6194,7787,2916,1008,10615,8659,1956,8659,7220,1439,2018-01-01,zipcode
ZCTA5 34773,12,3771,64529,1113,180000,2577,1219,2183,295,492,770,433,193,1535,994,541,994,755,239,2018-01-01,zipcode
ZCTA5 34785,12,34933,59268,871,277900,33308,25707,31936,3334,9841,9247,5139,4375,17080,13482,3598,13482,11715,1767,2018-01-01,zipcode
ZCTA5 34786,12,43458,102375,1756,438800,31562,9745,27566,803,3048,6540,11273,5902,15410,13908,1502,13908,10026,3882,2018-01-01,zipcode
ZCTA5 34787,12,64723,70723,1137,292800,49886,16187,42919,4339,9708,11312,11089,6471,24301,21956,2345,21956,15547,6409,2018-01-01,zipcode
ZCTA5 34788,12,16886,42605,1004,76400,14920,8685,14094,1393,5405,4879,1590,827,9673,7810,1863,7810,6520,1290,2018-01-01,zipcode
ZCTA5 34797,12,1084,79056,-666666666,167000,977,489,927,0,394,326,91,116,641,421,220,421,406,15,2018-01-01,zipcode
ZCTA5 34945,12,5019,46576,1075,177600,4296,2491,3703,968,1139,1057,349,190,1779,1438,341,1438,1257,181,2018-01-01,zipcode
ZCTA5 34946,12,5950,30657,815,80300,5022,2539,4175,745,1545,1328,419,138,2968,2258,710,2258,1488,770,2018-01-01,zipcode
ZCTA5 34947,12,13188,32818,949,99800,9800,3872,8122,1711,3640,1874,559,338,4798,3991,807,3991,1500,2491,2018-01-01,zipcode
ZCTA5 34949,12,7429,63718,1200,270000,7171,4902,6911,274,1595,2230,1618,1194,7856,4048,3808,4048,3305,743,2018-01-01,zipcode
ZCTA5 34950,12,17027,25278,792,84200,12996,5816,10972,3313,3864,2745,801,249,7393,5915,1478,5915,2439,3476,2018-01-01,zipcode
ZCTA5 34951,12,15978,42272,949,101600,14105,7406,12651,1772,4766,3848,1410,855,8642,6982,1660,6982,5938,1044,2018-01-01,zipcode
ZCTA5 34952,12,40063,44462,1190,123800,34657,16425,31239,3165,10958,11353,4080,1683,21172,16892,4280,16892,11559,5333,2018-01-01,zipcode
ZCTA5 34953,12,69685,61171,1344,184600,54118,17818,45512,6890,14957,15495,5875,2295,23854,21593,2261,21593,17509,4084,2018-01-01,zipcode
ZCTA5 34956,12,10057,39282,824,81700,7735,4130,6515,2381,2146,1513,316,159,2627,2153,474,2153,1433,720,2018-01-01,zipcode
ZCTA5 34957,12,23078,54349,1103,234200,20737,11223,19051,1108,5974,5875,3783,2311,17602,10772,6830,10772,8326,2446,2018-01-01,zipcode
ZCTA5 34972,12,20496,37151,693,87100,16343,8758,13667,4379,5078,2788,1065,357,7245,5663,1582,5663,3651,2012,2018-01-01,zipcode
ZCTA5 34974,12,24163,41952,780,90900,20206,10843,18039,3211,7214,5515,1577,522,14156,9779,4377,9779,7654,2125,2018-01-01,zipcode
ZCTA5 34981,12,5139,52841,998,230500,4226,1822,3664,380,1586,971,368,359,2139,1805,334,1805,1067,738,2018-01-01,zipcode
ZCTA5 34982,12,25981,37947,1014,104400,21151,10209,18354,3408,6840,5320,1795,991,11300,10036,1264,10036,6912,3124,2018-01-01,zipcode
ZCTA5 34983,12,42737,54359,1376,164100,34880,15068,30515,3818,10972,10612,3183,1930,15268,13795,1473,13795,10723,3072,2018-01-01,zipcode
ZCTA5 34984,12,15663,61667,1342,167000,12997,4556,11422,1330,3418,4434,1471,769,6185,5512,673,5512,4511,1001,2018-01-01,zipcode
ZCTA5 34986,12,26317,54167,1347,228300,22148,14210,20251,2247,5506,5567,4160,2771,13613,11362,2251,11362,8692,2670,2018-01-01,zipcode
ZCTA5 34987,12,8660,72581,1766,267000,6898,3881,6463,325,1438,2165,1557,978,3900,3361,539,3361,2413,948,2018-01-01,zipcode
ZCTA5 34990,12,30101,79817,1526,347900,25708,12488,22972,1247,4290,7707,6177,3551,13759,11919,1840,11919,10299,1620,2018-01-01,zipcode
ZCTA5 34994,12,16909,45905,1061,170000,14208,6798,12590,1239,3299,4511,2186,1355,9380,6961,2419,6961,4210,2751,2018-01-01,zipcode
ZCTA5 34996,12,11119,65798,1176,275200,10029,5757,9567,441,2123,2948,2162,1893,8723,5598,3125,5598,4621,977,2018-01-01,zipcode
ZCTA5 34997,12,44018,54215,1109,236900,37341,16609,33749,3711,9206,11616,5972,3244,21004,17670,3334,17670,13629,4041,2018-01-01,zipcode
ZCTA5 35004,01,11762,60822,905,155700,9009,2697,7822,432,2573,3283,1128,406,4700,4533,167,4533,3544,989,2018-01-01,zipcode
ZCTA5 35005,01,7528,47490,921,94300,5851,2673,5230,914,1873,1626,639,178,3144,2663,481,2663,1943,720,2018-01-01,zipcode
ZCTA5 35006,01,2927,45743,819,84200,2346,1323,2009,290,954,568,122,75,1555,1084,471,1084,897,187,2018-01-01,zipcode
ZCTA5 35007,01,26328,71173,978,165000,19788,6879,17257,2142,4385,5572,3318,1840,9710,8979,731,8979,7232,1747,2018-01-01,zipcode
ZCTA5 35010,01,20625,38584,630,104600,16652,8151,14495,3189,4430,4476,1588,812,10427,8312,2115,8312,5640,2672,2018-01-01,zipcode
ZCTA5 35013,01,40,-666666666,-666666666,-666666666,40,40,40,40,0,0,0,0,20,15,5,15,8,7,2018-01-01,zipcode
ZCTA5 35014,01,4780,46709,981,86700,4079,2590,3688,773,1456,1031,203,225,1964,1698,266,1698,1470,228,2018-01-01,zipcode
ZCTA5 35016,01,16112,43863,580,130600,13136,5983,11330,1344,3390,4126,1606,864,7313,6381,932,6381,4786,1595,2018-01-01,zipcode
ZCTA5 35019,01,1991,30441,708,124100,1616,902,1404,212,662,384,132,14,963,820,143,820,640,180,2018-01-01,zipcode
ZCTA5 35020,01,26345,29067,731,67400,20925,9498,17688,3301,6884,5547,1441,515,13018,10018,3000,10018,5142,4876,2018-01-01,zipcode
ZCTA5 35022,01,20271,58195,893,173000,16759,6168,14523,1271,4202,4616,2962,1472,8912,8137,775,8137,6556,1581,2018-01-01,zipcode
ZCTA5 35023,01,24293,53013,867,114800,19378,8983,16514,2270,6482,5476,1444,842,9334,8333,1001,8333,6167,2166,2018-01-01,zipcode
ZCTA5 35031,01,8060,43663,575,115100,6492,3575,5426,1342,1823,1677,352,232,3619,2845,774,2845,2014,831,2018-01-01,zipcode
ZCTA5 35032,01,44,29250,-666666666,73300,35,22,35,4,17,9,0,5,18,17,1,17,14,3,2018-01-01,zipcode
ZCTA5 35033,01,3107,37548,615,115100,2525,1261,2126,435,657,743,149,142,1619,1233,386,1233,1049,184,2018-01-01,zipcode
ZCTA5 35034,01,6030,34408,778,62800,4898,3615,3954,1135,1697,770,282,70,1553,1081,472,1081,773,308,2018-01-01,zipcode
ZCTA5 35035,01,1179,86750,-666666666,126300,1096,464,942,42,505,184,144,67,678,389,289,389,389,0,2018-01-01,zipcode
ZCTA5 35036,01,367,16150,243,81300,214,69,159,53,70,22,14,0,153,129,24,129,28,101,2018-01-01,zipcode
ZCTA5 35040,01,17141,63763,993,145300,12869,3742,11290,936,3097,3973,2268,1016,6980,6275,705,6275,5139,1136,2018-01-01,zipcode
ZCTA5 35042,01,5961,49719,634,120600,4986,2039,4438,507,2060,1313,297,261,2620,2211,409,2211,1589,622,2018-01-01,zipcode
ZCTA5 35043,01,11461,87398,1556,231900,8424,2798,7382,257,1415,2520,2245,945,3909,3671,238,3671,3440,231,2018-01-01,zipcode
ZCTA5 35044,01,7351,38560,537,95800,5785,2503,4895,944,2036,1592,222,101,3327,2994,333,2994,1848,1146,2018-01-01,zipcode
ZCTA5 35045,01,14778,45323,682,113500,11969,5486,10417,1737,4435,2627,1042,576,6649,5748,901,5748,4113,1635,2018-01-01,zipcode
ZCTA5 35046,01,4641,46831,674,121400,3640,1749,3308,577,1354,785,393,199,2677,1935,742,1935,1532,403,2018-01-01,zipcode
ZCTA5 35049,01,3366,46250,593,125600,2733,1214,2338,490,818,742,155,133,1583,1288,295,1288,1088,200,2018-01-01,zipcode
ZCTA5 35051,01,9000,47460,626,150600,7334,3810,6281,1147,2450,1276,903,505,3560,3102,458,3102,2415,687,2018-01-01,zipcode
ZCTA5 35052,01,275,-666666666,-666666666,-666666666,275,226,275,86,80,80,29,0,19,19,0,19,0,19,2018-01-01,zipcode
ZCTA5 35053,01,2519,50577,891,164200,2189,1281,1957,397,569,534,302,155,2735,924,1811,924,840,84,2018-01-01,zipcode
ZCTA5 35054,01,3777,45469,604,169800,3152,1804,2765,493,1160,580,366,166,2139,1655,484,1655,1450,205,2018-01-01,zipcode
ZCTA5 35055,01,20884,42252,627,126300,16258,7090,13871,2479,4551,4000,1801,1040,8812,7837,975,7837,4881,2956,2018-01-01,zipcode
ZCTA5 35057,01,13542,51868,732,147900,10644,4348,9159,1643,3147,3087,867,415,6086,4773,1313,4773,3915,858,2018-01-01,zipcode
ZCTA5 35058,01,9234,41788,677,123300,7477,3519,6798,1216,2585,2159,549,289,4208,3577,631,3577,2674,903,2018-01-01,zipcode
ZCTA5 35060,01,332,22961,-666666666,45200,294,214,273,85,126,46,0,16,271,161,110,161,138,23,2018-01-01,zipcode
ZCTA5 35061,01,1212,39313,1003,76800,1004,378,847,189,166,417,72,3,563,417,146,417,270,147,2018-01-01,zipcode
ZCTA5 35062,01,7631,48125,766,113300,6064,2823,5222,863,1759,1683,493,424,3362,2928,434,2928,2511,417,2018-01-01,zipcode
ZCTA5 35063,01,3671,45260,799,81200,2961,1636,2633,617,925,933,104,54,1771,1303,468,1303,1179,124,2018-01-01,zipcode
ZCTA5 35064,01,11171,37199,721,97100,9168,3974,7329,847,2250,2894,942,396,5574,4514,1060,4514,2616,1898,2018-01-01,zipcode
ZCTA5 35068,01,8072,57723,948,149100,6381,2060,5407,602,1643,1885,874,403,3535,3315,220,3315,2261,1054,2018-01-01,zipcode
ZCTA5 35070,01,258,34063,779,103800,182,84,152,42,51,59,0,0,103,94,9,94,68,26,2018-01-01,zipcode
ZCTA5 35071,01,16181,66928,960,166400,12921,4882,11169,672,3580,3828,1887,1202,6920,6316,604,6316,5034,1282,2018-01-01,zipcode
ZCTA5 35072,01,4901,42011,498,80300,3943,1919,3510,729,1392,1045,219,125,2624,1855,769,1855,1521,334,2018-01-01,zipcode
ZCTA5 35073,01,2396,43281,802,85400,1988,1029,1725,306,731,538,119,31,1141,956,185,956,760,196,2018-01-01,zipcode
ZCTA5 35074,01,0,-666666666,-666666666,-666666666,0,0,0,0,0,0,0,0,0,0,0,0,0,0,2018-01-01,zipcode
ZCTA5 35077,01,13547,40411,649,106000,11171,5761,9519,1794,3246,3442,705,332,5984,4951,1033,4951,3711,1240,2018-01-01,zipcode
ZCTA5 35078,01,1919,56833,730,161600,1585,687,1409,274,531,407,122,75,892,722,170,722,598,124,2018-01-01,zipcode
ZCTA5 35079,01,9267,55265,646,128200,7429,3517,6406,814,2519,2329,481,263,3731,3197,534,3197,2935,262,2018-01-01,zipcode
ZCTA5 35080,01,17889,87346,1188,183400,13217,3653,11456,456,1886,3516,3917,1681,6453,6261,192,6261,5730,531,2018-01-01,zipcode
ZCTA5 35082,01,0,-666666666,-666666666,-666666666,0,0,0,0,0,0,0,0,9,0,9,0,0,0,2018-01-01,zipcode
ZCTA5 35083,01,3353,34637,721,104600,2587,1482,2261,510,903,651,172,25,1438,1294,144,1294,1009,285,2018-01-01,zipcode
ZCTA5 35085,01,9116,38943,731,83700,7145,3025,5936,1133,2615,1539,394,255,3630,3270,360,3270,2551,719,2018-01-01,zipcode
ZCTA5 35087,01,2253,28534,689,95600,1898,949,1642,319,548,681,24,70,1070,956,114,956,560,396,2018-01-01,zipcode
ZCTA5 35089,01,2034,30306,594,89800,1862,903,1631,359,640,504,92,36,996,793,203,793,653,140,2018-01-01,zipcode
ZCTA5 35091,01,3072,86250,872,190700,2198,629,1921,134,676,633,271,207,1119,1028,91,1028,945,83,2018-01-01,zipcode
ZCTA5 35094,01,14438,58988,812,162700,11263,4318,10039,1287,2907,3193,1785,867,6276,5571,705,5571,4343,1228,2018-01-01,zipcode
ZCTA5 35096,01,7610,54808,866,107800,6497,2504,5641,964,1845,1798,719,315,4059,2988,1071,2988,2409,579,2018-01-01,zipcode
ZCTA5 35097,01,2004,49063,782,111600,1550,851,1375,278,604,365,81,47,664,648,16,648,541,107,2018-01-01,zipcode
ZCTA5 35098,01,1068,36250,-666666666,87800,845,395,753,154,232,265,39,63,616,451,165,451,438,13,2018-01-01,zipcode
ZCTA5 35111,01,16893,76288,728,194800,13949,4998,11819,1025,3920,4064,1945,865,6768,6044,724,6044,5193,851,2018-01-01,zipcode
ZCTA5 35112,01,280,-666666666,-666666666,-666666666,240,125,240,10,151,79,0,0,202,136,66,136,122,14,2018-01-01,zipcode
ZCTA5 35114,01,8624,82102,1096,192900,6757,2018,5670,422,921,1822,1501,1004,3218,3075,143,3075,2619,456,2018-01-01,zipcode
ZCTA5 35115,01,15105,40514,751,124500,12466,5294,9156,1440,3579,2328,1177,632,6007,5405,602,5405,3670,1735,2018-01-01,zipcode
ZCTA5 35116,01,4372,62544,853,153600,3572,1435,3167,270,1131,1112,487,167,1857,1718,139,1718,1410,308,2018-01-01,zipcode
ZCTA5 35117,01,5235,70982,726,158900,4205,1408,3646,296,1174,1369,605,202,2145,2019,126,2019,1806,213,2018-01-01,zipcode
ZCTA5 35118,01,3040,56983,744,129400,2442,1166,2194,363,862,742,120,107,1312,1110,202,1110,914,196,2018-01-01,zipcode
ZCTA5 35119,01,259,-666666666,-666666666,-666666666,197,67,197,106,40,51,0,0,78,78,0,78,51,27,2018-01-01,zipcode
ZCTA5 35120,01,14055,61161,688,145400,10873,3639,9059,1443,3155,2906,1026,529,5596,5009,587,5009,4165,844,2018-01-01,zipcode
ZCTA5 35121,01,15426,46847,695,131600,12454,6348,10550,2533,3054,3553,890,520,6520,5710,810,5710,3840,1870,2018-01-01,zipcode
ZCTA5 35124,01,24438,75701,1062,186600,19570,5816,16849,1363,2990,5760,4424,2312,10009,9292,717,9292,7699,1593,2018-01-01,zipcode
ZCTA5 35125,01,10941,40560,712,120500,9117,4102,8185,1734,3035,2480,620,316,5009,4405,604,4405,2822,1583,2018-01-01,zipcode
ZCTA5 35126,01,20825,64349,978,145600,16891,6275,14308,1332,4866,5472,1844,794,8138,7600,538,7600,6383,1217,2018-01-01,zipcode
ZCTA5 35127,01,10185,69524,1162,154400,8404,3134,7137,504,2201,2800,993,639,4094,3745,349,3745,3306,439,2018-01-01,zipcode
ZCTA5 35128,01,10651,60046,795,169100,8719,3181,7581,938,2532,2543,1133,435,5001,4291,710,4291,3104,1187,2018-01-01,zipcode
ZCTA5 35130,01,2892,38333,479,76300,2329,1093,2029,468,938,489,76,58,1714,1232,482,1232,956,276,2018-01-01,zipcode
ZCTA5 35131,01,4332,38906,607,122400,3413,1753,2863,605,1251,700,171,136,1820,1507,313,1507,1135,372,2018-01-01,zipcode
ZCTA5 35133,01,3690,50517,522,123400,2795,1503,2597,287,967,990,256,97,1652,1366,286,1366,1274,92,2018-01-01,zipcode
ZCTA5 35135,01,2128,54138,745,184500,1575,445,1454,116,451,647,157,83,951,792,159,792,581,211,2018-01-01,zipcode
ZCTA5 35136,01,2076,41184,281,118300,1736,939,1524,253,472,580,162,57,1246,786,460,786,638,148,2018-01-01,zipcode
ZCTA5 35139,01,170,-666666666,-666666666,20300,148,99,148,103,39,6,0,0,77,77,0,77,71,6,2018-01-01,zipcode
ZCTA5 35143,01,3183,55500,608,162900,2585,1226,2360,364,842,699,365,90,2225,1236,989,1236,1139,97,2018-01-01,zipcode
ZCTA5 35146,01,11870,66969,684,176800,9551,4431,8658,1290,3058,2292,1397,621,4107,3616,491,3616,3243,373,2018-01-01,zipcode
ZCTA5 35147,01,6094,77007,1284,184400,4645,1497,4088,435,862,1350,1003,438,2427,2177,250,2177,1888,289,2018-01-01,zipcode
ZCTA5 35148,01,2444,38828,522,103000,1949,957,1686,230,664,684,90,18,1176,995,181,995,686,309,2018-01-01,zipcode
ZCTA5 35149,01,413,41139,-666666666,114700,413,139,271,95,154,22,0,0,222,181,41,181,141,40,2018-01-01,zipcode
ZCTA5 35150,01,17448,32496,596,93900,13559,6454,11768,2207,4253,3753,1098,457,8529,6971,1558,6971,4455,2516,2018-01-01,zipcode
ZCTA5 35151,01,7516,41797,713,98600,6135,3319,5181,1093,1656,1566,538,328,3778,2838,940,2838,2435,403,2018-01-01,zipcode
ZCTA5 35160,01,26312,34666,569,90900,21896,11681,18645,3897,6595,5592,1477,1084,12347,10087,2260,10087,6654,3433,2018-01-01,zipcode
ZCTA5 35171,01,3679,48646,658,105500,2850,1374,2351,505,960,476,311,99,1504,1316,188,1316,1091,225,2018-01-01,zipcode
ZCTA5 35172,01,3177,29811,668,74400,2642,1397,2393,639,979,595,140,40,1384,1226,158,1226,797,429,2018-01-01,zipcode
ZCTA5 35173,01,27371,85378,1102,229300,20795,7598,18499,1230,4182,6301,4414,2372,10060,9430,630,9430,8508,922,2018-01-01,zipcode
ZCTA5 35175,01,5714,51411,633,117500,4413,2047,3887,852,1292,1092,374,277,2485,2008,477,2008,1720,288,2018-01-01,zipcode
ZCTA5 35176,01,902,-666666666,715,64100,729,285,563,212,207,104,32,8,371,349,22,349,234,115,2018-01-01,zipcode
ZCTA5 35178,01,3814,39145,615,87400,2802,1270,2317,406,757,923,181,50,1631,1331,300,1331,1163,168,2018-01-01,zipcode
ZCTA5 35179,01,8929,44859,705,132300,7076,3015,6240,1163,2576,1911,342,248,3784,3310,474,3310,2749,561,2018-01-01,zipcode
ZCTA5 35180,01,14092,58968,589,139600,11199,5053,9728,1142,3857,3320,940,469,5616,5164,452,5164,4444,720,2018-01-01,zipcode
ZCTA5 35183,01,1062,56512,-666666666,77300,892,301,801,114,401,276,0,10,363,310,53,310,297,13,2018-01-01,zipcode
ZCTA5 35184,01,4356,41639,713,86400,3498,1921,3204,683,1436,630,319,136,2413,1652,761,1652,1276,376,2018-01-01,zipcode
ZCTA5 35186,01,5092,62670,931,170600,4311,1959,3729,416,1355,1162,496,300,2340,2013,327,2013,1699,314,2018-01-01,zipcode
ZCTA5 35187,01,5,-666666666,-666666666,-666666666,5,5,5,0,0,5,0,0,10,3,7,3,3,0,2018-01-01,zipcode
ZCTA5 35188,01,4001,60739,837,115000,3104,1307,2590,212,1439,740,155,44,1238,1110,128,1110,882,228,2018-01-01,zipcode
ZCTA5 35203,01,2996,16617,562,201600,2901,1726,2529,615,808,477,347,282,1819,1574,245,1574,294,1280,2018-01-01,zipcode
ZCTA5 35204,01,9399,21425,577,63000,7923,4048,6894,1561,2441,1970,598,324,6005,4397,1608,4397,1506,2891,2018-01-01,zipcode
ZCTA5 35205,01,20109,36391,765,182300,17991,6021,13368,916,2344,3351,4020,2737,12548,9489,3059,9489,2601,6888,2018-01-01,zipcode
ZCTA5 35206,01,17350,32807,809,78300,13782,5627,11996,2045,4287,3964,1210,490,8558,6722,1836,6722,3458,3264,2018-01-01,zipcode
ZCTA5 35207,01,9102,24419,549,60400,6651,3380,5751,1229,1935,1800,489,298,4538,3514,1024,3514,1977,1537,2018-01-01,zipcode
ZCTA5 35208,01,13864,33020,861,71700,10639,4840,9090,1111,3299,3623,782,275,7076,5426,1650,5426,2806,2620,2018-01-01,zipcode
ZCTA5 35209,01,27768,56525,954,326200,22444,6208,17449,749,2401,3919,5372,5008,15370,12335,3035,12335,5847,6488,2018-01-01,zipcode
ZCTA5 35210,01,13484,51623,917,140000,11239,4181,10001,1188,2715,2490,2412,1196,6553,5961,592,5961,4026,1935,2018-01-01,zipcode
ZCTA5 35211,01,24594,31396,775,79400,20364,8414,17492,2794,4751,5971,2630,1346,15159,11437,3722,11437,5222,6215,2018-01-01,zipcode
ZCTA5 35212,01,11896,29171,576,132100,9222,3675,7888,1191,2614,2335,1083,665,6202,4859,1343,4859,2169,2690,2018-01-01,zipcode
ZCTA5 35213,01,13516,113472,1335,530600,10505,3611,9278,40,592,1200,4281,3165,6102,5559,543,5559,4230,1329,2018-01-01,zipcode
ZCTA5 35214,01,18264,47385,782,102500,14962,6689,13174,1114,3881,4954,2209,1016,8671,7307,1364,7307,5258,2049,2018-01-01,zipcode
ZCTA5 35215,01,48483,41787,850,100300,35324,12584,29606,3660,9730,10996,3667,1553,20673,18078,2595,18078,9897,8181,2018-01-01,zipcode
ZCTA5 35216,01,37546,60650,1005,274400,28404,7432,24845,1314,3851,6420,7838,5422,16699,15117,1582,15117,8097,7020,2018-01-01,zipcode
ZCTA5 35217,01,13286,33387,697,76800,10718,4926,9246,1701,3806,2602,856,281,6146,4889,1257,4889,2731,2158,2018-01-01,zipcode
ZCTA5 35218,01,7178,26506,759,65200,5515,2347,4815,631,1646,2129,315,94,3808,2928,880,2928,1210,1718,2018-01-01,zipcode
ZCTA5 35221,01,4803,35691,828,65100,3984,1893,3371,475,1345,1062,327,162,2531,1828,703,1828,1206,622,2018-01-01,zipcode
ZCTA5 35222,01,9033,60989,730,231100,7427,2406,6645,602,1030,1542,1964,1507,4671,4077,594,4077,2254,1823,2018-01-01,zipcode
ZCTA5 35223,01,11251,131295,1616,490000,8861,3488,7802,41,224,1280,3073,3184,4492,4152,340,4152,3568,584,2018-01-01,zipcode
ZCTA5 35224,01,5168,34435,781,64100,4154,1638,3512,404,1258,1497,303,50,2855,2079,776,2079,1296,783,2018-01-01,zipcode
ZCTA5 35226,01,35542,100686,1200,265200,27092,7902,24529,516,3152,5118,8750,6993,14264,13344,920,13344,10552,2792,2018-01-01,zipcode
ZCTA5 35228,01,10349,32943,867,68400,8609,3512,7389,1142,2806,2425,852,164,4829,4083,746,4083,2490,1593,2018-01-01,zipcode
ZCTA5 35229,01,1219,-666666666,-666666666,-666666666,1219,785,0,0,0,0,0,0,0,0,0,0,0,0,2018-01-01,zipcode
ZCTA5 35233,01,1715,41500,1213,185900,1631,725,997,48,106,160,331,352,1317,864,453,864,119,745,2018-01-01,zipcode
ZCTA5 35234,01,5450,26008,592,61300,4753,2527,4320,1021,1356,1548,318,77,2691,1977,714,1977,925,1052,2018-01-01,zipcode
ZCTA5 35235,01,20926,55609,980,119800,16581,5394,14550,1515,4063,5253,2439,1280,8987,8191,796,8191,5683,2508,2018-01-01,zipcode
ZCTA5 35242,01,55122,91966,1097,347400,44217,14144,38505,1162,4048,10098,14754,8443,23744,21757,1987,21757,15215,6542,2018-01-01,zipcode
ZCTA5 35243,01,17259,82965,1210,352400,14174,4543,12633,157,869,2723,5124,3760,9020,7724,1296,7724,4708,3016,2018-01-01,zipcode
ZCTA5 35244,01,31930,86971,1121,293600,25738,7314,22462,854,2656,5650,8307,4995,13753,12609,1144,12609,8636,3973,2018-01-01,zipcode
ZCTA5 35254,01,1574,20057,659,83800,1553,1082,249,45,151,25,0,28,213,189,24,189,63,126,2018-01-01,zipcode
ZCTA5 35401,01,37194,25147,781,110600,32632,18740,16286,3139,5487,3828,2060,1772,18172,11118,7054,11118,3740,7378,2018-01-01,zipcode
ZCTA5 35404,01,22783,40616,881,133000,19058,7140,13550,1661,4513,4046,2279,1051,10971,8105,2866,8105,4145,3960,2018-01-01,zipcode
ZCTA5 35405,01,45473,56240,851,169400,36415,12295,29368,2315,8001,9229,6372,3451,20012,17060,2952,17060,9691,7369,2018-01-01,zipcode
ZCTA5 35406,01,17190,102403,1042,341400,13014,4569,11632,414,867,2039,4357,3955,7552,6576,976,6576,5152,1424,2018-01-01,zipcode
ZCTA5 35441,01,1089,40865,579,67900,836,434,713,116,295,199,68,35,829,403,426,403,351,52,2018-01-01,zipcode
ZCTA5 35442,01,6237,30332,550,93400,5283,3144,4591,1147,1357,1431,506,150,2432,1857,575,1857,1356,501,2018-01-01,zipcode
ZCTA5 35443,01,2157,14983,608,34300,1524,951,1014,172,624,184,22,12,1176,611,565,611,360,251,2018-01-01,zipcode
ZCTA5 35444,01,3962,50875,806,107600,3257,1357,2672,516,965,841,277,73,1534,1415,119,1415,1121,294,2018-01-01,zipcode
ZCTA5 35446,01,2081,45250,854,123000,1637,780,1423,266,550,414,128,65,806,730,76,730,602,128,2018-01-01,zipcode
ZCTA5 35447,01,2898,33750,403,96600,2315,1099,1945,393,731,594,181,46,1659,1146,513,1146,838,308,2018-01-01,zipcode
ZCTA5 35452,01,3061,52589,870,170700,2529,1208,2249,362,866,666,199,156,1302,1104,198,1104,910,194,2018-01-01,zipcode
ZCTA5 35453,01,10863,56044,775,138400,8305,3321,7183,1403,2819,2156,547,258,4503,3785,718,3785,3205,580,2018-01-01,zipcode
ZCTA5 35456,01,3461,53462,948,117200,2877,1078,2383,458,996,691,158,80,1425,1172,253,1172,982,190,2018-01-01,zipcode
ZCTA5 35457,01,0,-666666666,-666666666,-666666666,0,0,0,0,0,0,0,0,0,0,0,0,0,0,2018-01-01,zipcode
ZCTA5 35458,01,595,34167,-666666666,170100,498,198,412,42,254,68,34,14,174,174,0,174,133,41,2018-01-01,zipcode
ZCTA5 35459,01,1304,36500,525,66200,1067,590,856,193,366,200,50,47,630,444,186,444,361,83,2018-01-01,zipcode
ZCTA5 35460,01,864,22163,625,97900,806,468,596,62,170,219,91,54,480,362,118,362,274,88,2018-01-01,zipcode
ZCTA5 35461,01,2120,40104,-666666666,134100,1752,907,1539,203,612,564,89,71,1082,849,233,849,771,78,2018-01-01,zipcode
ZCTA5 35462,01,4258,21295,611,79200,3580,2154,3405,1017,969,1052,196,171,2655,1771,884,1771,1176,595,2018-01-01,zipcode
ZCTA5 35463,01,1794,53897,-666666666,128100,1426,531,1301,119,478,453,230,21,750,704,46,704,615,89,2018-01-01,zipcode
ZCTA5 35464,01,690,12500,310,-666666666,473,342,404,68,167,106,57,6,338,268,70,268,143,125,2018-01-01,zipcode
ZCTA5 35466,01,5567,50968,517,103500,4426,1925,3924,486,1519,1212,446,261,2633,2165,468,2165,1655,510,2018-01-01,zipcode
ZCTA5 35469,01,188,-666666666,-666666666,-666666666,166,145,166,32,67,45,19,3,180,66,114,66,34,32,2018-01-01,zipcode
ZCTA5 35470,01,4676,14983,583,106500,3898,2251,2195,271,754,495,328,347,2415,1753,662,1753,901,852,2018-01-01,zipcode
ZCTA5 35473,01,16305,64045,867,175400,12883,4717,10795,990,2823,3012,2299,1671,6847,6104,743,6104,4099,2005,2018-01-01,zipcode
ZCTA5 35474,01,6454,51228,770,126000,5103,2143,4340,649,1663,1173,550,305,2710,2238,472,2238,1841,397,2018-01-01,zipcode
ZCTA5 35475,01,15583,77537,768,186700,12375,4078,10651,843,3408,3197,1916,1287,6293,5398,895,5398,4755,643,2018-01-01,zipcode
ZCTA5 35476,01,7473,35777,760,134000,5962,2508,5152,644,1672,1594,754,488,3273,2829,444,2829,1357,1472,2018-01-01,zipcode
ZCTA5 35477,01,171,54191,-666666666,-666666666,134,48,109,0,60,35,7,7,158,53,105,53,53,0,2018-01-01,zipcode
ZCTA5 35480,01,1330,83375,1644,181500,1122,460,1085,106,378,372,99,130,510,423,87,423,359,64,2018-01-01,zipcode
ZCTA5 35481,01,3669,27917,429,79700,3119,1687,2624,612,1084,725,111,92,1802,1457,345,1457,970,487,2018-01-01,zipcode
ZCTA5 35490,01,4206,54202,995,114700,3076,1062,2704,550,1024,679,323,128,1671,1358,313,1358,1017,341,2018-01-01,zipcode
ZCTA5 35501,01,9644,37712,578,91500,7539,3417,6517,1251,2441,2080,440,305,4762,3693,1069,3693,2249,1444,2018-01-01,zipcode
ZCTA5 35503,01,9074,49542,729,117000,7403,3194,6290,1140,2128,2299,503,220,4297,3473,824,3473,2639,834,2018-01-01,zipcode
ZCTA5 35504,01,13160,50305,610,147000,10747,4849,9243,1199,3113,3050,1199,682,6150,5076,1074,5076,3927,1149,2018-01-01,zipcode
ZCTA5 35540,01,2436,43844,365,90200,2054,1012,1790,321,751,505,120,93,1138,1041,97,1041,777,264,2018-01-01,zipcode
ZCTA5 35541,01,3390,45640,439,147300,2997,1564,2584,481,943,672,192,296,2705,1444,1261,1444,1308,136,2018-01-01,zipcode
ZCTA5 35542,01,965,36150,720,82000,884,495,739,213,286,166,74,0,581,461,120,461,431,30,2018-01-01,zipcode
ZCTA5 35543,01,1285,32957,541,62200,999,473,790,172,310,249,28,31,489,441,48,441,316,125,2018-01-01,zipcode
ZCTA5 35544,01,476,45000,574,27300,383,169,365,105,109,115,31,5,326,240,86,240,168,72,2018-01-01,zipcode
ZCTA5 35545,01,122,30592,-666666666,30000,108,60,81,41,19,16,0,5,67,59,8,59,52,7,2018-01-01,zipcode
ZCTA5 35546,01,3801,46207,296,88200,3003,1390,2569,489,1093,627,197,163,1614,1484,130,1484,1266,218,2018-01-01,zipcode
ZCTA5 35548,01,1704,35573,400,65000,1409,739,1209,326,447,331,58,47,889,707,182,707,549,158,2018-01-01,zipcode
ZCTA5 35549,01,3512,34476,547,61500,2877,1613,2520,662,963,692,100,103,1735,1438,297,1438,995,443,2018-01-01,zipcode
ZCTA5 35550,01,5761,40286,618,74300,4678,2397,4167,837,1694,1243,227,166,2762,2367,395,2367,1833,534,2018-01-01,zipcode
ZCTA5 35552,01,887,34375,275,52600,639,322,500,85,202,177,36,0,392,332,60,332,311,21,2018-01-01,zipcode
ZCTA5 35553,01,4422,34706,482,67900,3692,2046,3271,947,1255,592,335,142,2370,1596,774,1596,1320,276,2018-01-01,zipcode
ZCTA5 35554,01,1054,33000,529,59100,856,358,760,115,384,236,25,0,549,462,87,462,374,88,2018-01-01,zipcode
ZCTA5 35555,01,9617,39398,573,86800,7826,3712,6751,865,2720,2027,831,308,5015,3869,1146,3869,2788,1081,2018-01-01,zipcode
ZCTA5 35559,01,12,-666666666,-666666666,-666666666,12,0,12,12,0,0,0,0,10,6,4,6,6,0,2018-01-01,zipcode
ZCTA5 35563,01,4501,38114,518,106200,3719,1756,3317,538,1336,1086,194,163,2247,1837,410,1837,1357,480,2018-01-01,zipcode
ZCTA5 35564,01,2112,26594,578,97600,1731,925,1501,312,562,495,71,61,1058,925,133,925,730,195,2018-01-01,zipcode
ZCTA5 35565,01,13266,34163,543,72000,10439,5011,9561,2045,3669,2937,550,360,6494,5321,1173,5321,4147,1174,2018-01-01,zipcode
ZCTA5 35570,01,11270,36168,522,90900,9431,4567,8205,1859,2637,2616,729,364,5679,4742,937,4742,3389,1353,2018-01-01,zipcode
ZCTA5 35571,01,811,43264,618,74400,719,323,619,141,178,220,53,27,529,351,178,351,288,63,2018-01-01,zipcode
ZCTA5 35572,01,1319,31250,-666666666,195800,1061,450,886,211,256,305,67,47,968,508,460,508,467,41,2018-01-01,zipcode
ZCTA5 35574,01,1692,36649,361,103200,1407,724,1320,206,550,339,114,111,929,743,186,743,640,103,2018-01-01,zipcode
ZCTA5 35575,01,1043,40792,490,75800,814,402,710,174,286,164,63,23,486,433,53,433,342,91,2018-01-01,zipcode
ZCTA5 35576,01,2958,46361,445,85200,2590,1129,2352,321,1027,713,188,103,1565,1377,188,1377,1039,338,2018-01-01,zipcode
ZCTA5 35577,01,41,-666666666,-666666666,-666666666,35,15,16,0,12,2,2,0,46,6,40,6,6,0,2018-01-01,zipcode
ZCTA5 35578,01,5806,37275,542,88700,4769,2764,4172,1013,1689,1044,285,141,2684,2190,494,2190,1900,290,2018-01-01,zipcode
ZCTA5 35579,01,3513,40994,462,70000,2754,1281,2490,580,1021,727,152,10,1776,1367,409,1367,1073,294,2018-01-01,zipcode
ZCTA5 35580,01,3708,40919,615,71600,2884,1154,2541,577,917,917,42,88,1673,1383,290,1383,1150,233,2018-01-01,zipcode
ZCTA5 35581,01,5709,37402,753,84200,4241,2258,3659,741,1007,1317,330,264,2534,2019,515,2019,1553,466,2018-01-01,zipcode
ZCTA5 35582,01,4444,36850,441,84200,3273,1438,2831,633,1194,691,179,134,2002,1649,353,1649,1184,465,2018-01-01,zipcode
ZCTA5 35584,01,387,38125,800,49100,295,165,268,64,94,99,5,6,179,134,45,134,120,14,2018-01-01,zipcode
ZCTA5 35585,01,1215,42414,-666666666,128900,1043,537,893,96,340,260,119,78,623,515,108,515,383,132,2018-01-01,zipcode
ZCTA5 35586,01,4164,29076,393,85700,3258,1615,3014,583,1177,993,169,92,2316,1824,492,1824,1375,449,2018-01-01,zipcode
ZCTA5 35587,01,676,35563,-666666666,54700,602,346,496,125,206,150,1,14,411,299,112,299,289,10,2018-01-01,zipcode
ZCTA5 35592,01,4655,36299,360,73300,3657,1836,3090,584,1203,807,317,179,2325,1899,426,1899,1398,501,2018-01-01,zipcode
ZCTA5 35593,01,1691,40885,463,84100,1329,531,1182,271,429,327,100,55,796,650,146,650,541,109,2018-01-01,zipcode
ZCTA5 35594,01,7208,38878,546,108900,5716,2720,4880,815,1669,1539,570,287,3467,2738,729,2738,2019,719,2018-01-01,zipcode
ZCTA5 35601,01,32666,41204,647,98300,25429,12103,22217,5278,6116,6262,3344,1217,14464,12393,2071,12393,7515,4878,2018-01-01,zipcode
ZCTA5 35603,01,31468,53396,647,168200,25802,10352,21990,2171,6009,7626,4268,1916,13938,13050,888,13050,9068,3982,2018-01-01,zipcode
ZCTA5 35610,01,1702,41198,479,157300,1481,690,1420,229,654,333,122,82,869,785,84,785,616,169,2018-01-01,zipcode
ZCTA5 35611,01,25744,38210,634,123300,21103,9499,17848,3827,6145,4698,2209,969,11589,9678,1911,9678,5977,3701,2018-01-01,zipcode
ZCTA5 35613,01,25577,77179,810,175400,20632,9612,18207,2472,5014,5354,3726,1641,8175,7621,554,7621,6805,816,2018-01-01,zipcode
ZCTA5 35614,01,7638,42936,690,107700,5930,2824,5145,1176,1828,1539,429,173,3045,2743,302,2743,2091,652,2018-01-01,zipcode
ZCTA5 35615,01,245,-666666666,-666666666,-666666666,245,75,245,75,0,0,170,0,143,109,34,109,91,18,2018-01-01,zipcode
ZCTA5 35616,01,3667,41636,702,84400,3077,1550,2681,609,908,841,142,181,2244,1605,639,1605,1309,296,2018-01-01,zipcode
ZCTA5 35618,01,1851,30655,422,78200,1489,834,1281,303,517,333,68,60,1111,849,262,849,558,291,2018-01-01,zipcode
ZCTA5 35619,01,4428,50036,658,105300,3787,1816,3253,855,1075,1093,156,74,2073,1694,379,1694,1435,259,2018-01-01,zipcode
ZCTA5 35620,01,9026,53401,765,125000,7430,2942,6336,887,2411,2280,449,309,3538,3240,298,3240,2629,611,2018-01-01,zipcode
ZCTA5 35621,01,2951,45991,495,109600,2492,1107,2108,482,788,546,197,95,1355,1253,102,1253,1073,180,2018-01-01,zipcode
ZCTA5 35622,01,7879,52198,731,87600,6103,2618,5518,998,2108,1780,411,221,3325,2655,670,2655,2190,465,2018-01-01,zipcode
ZCTA5 35630,01,33172,34781,642,108900,27882,12489,21021,3342,6392,6207,3161,1919,17520,14890,2630,14890,6654,8236,2018-01-01,zipcode
ZCTA5 35633,01,20747,55859,821,138900,16399,6974,14469,1686,5279,3738,2447,1319,9269,8260,1009,8260,6980,1280,2018-01-01,zipcode
ZCTA5 35634,01,9793,70996,736,177400,8423,3799,7466,534,2830,2110,1203,789,4327,3972,355,3972,3482,490,2018-01-01,zipcode
ZCTA5 35640,01,24570,55706,647,135200,19571,7898,16725,1831,5499,5868,2165,1362,10558,9210,1348,9210,7385,1825,2018-01-01,zipcode
ZCTA5 35643,01,3696,48568,548,115400,3208,1467,2738,856,1107,548,138,89,1628,1465,163,1465,1344,121,2018-01-01,zipcode
ZCTA5 35645,01,14011,61442,631,160800,11368,5118,10013,1031,3781,2693,1434,1074,6041,5322,719,5322,4506,816,2018-01-01,zipcode
ZCTA5 35646,01,4734,42028,483,100700,3968,2089,3504,639,1553,948,137,227,2474,1857,617,1857,1410,447,2018-01-01,zipcode
ZCTA5 35647,01,1185,46979,384,117600,1010,398,839,117,401,152,136,33,425,409,16,409,336,73,2018-01-01,zipcode
ZCTA5 35648,01,3250,49961,563,119200,2591,980,2144,300,985,488,199,172,1381,1256,125,1256,1030,226,2018-01-01,zipcode
ZCTA5 35649,01,89,108750,-666666666,400000,72,27,71,4,5,14,29,19,34,34,0,34,34,0,2018-01-01,zipcode
ZCTA5 35650,01,13992,43727,537,119700,11090,5587,9746,2050,4102,2491,733,370,6088,5265,823,5265,3956,1309,2018-01-01,zipcode
ZCTA5 35651,01,1255,33456,733,104400,985,603,841,102,499,194,30,16,543,461,82,461,347,114,2018-01-01,zipcode
ZCTA5 35652,01,8700,50233,718,135400,7090,3139,6180,683,2476,1807,794,420,4526,3514,1012,3514,2729,785,2018-01-01,zipcode
ZCTA5 35653,01,11043,42485,581,84700,8589,3630,7057,2021,2687,1552,465,332,4741,3667,1074,3667,2366,1301,2018-01-01,zipcode
ZCTA5 35654,01,8006,41168,550,98200,6309,2660,5361,1126,2154,1425,427,229,3767,2865,902,2865,1977,888,2018-01-01,zipcode
ZCTA5 35660,01,8986,34688,657,91600,7398,3617,6554,1296,2059,1802,902,495,5045,4045,1000,4045,2370,1675,2018-01-01,zipcode
ZCTA5 35661,01,16881,57127,815,145400,13837,5828,12046,1123,3941,3770,2168,1044,7520,6744,776,6744,5314,1430,2018-01-01,zipcode
ZCTA5 35670,01,6667,51495,633,119300,5435,2162,4687,625,1571,1527,702,262,3237,2570,667,2570,2113,457,2018-01-01,zipcode
ZCTA5 35671,01,2185,-666666666,572,79000,1869,624,1571,243,726,279,225,98,1114,899,215,899,596,303,2018-01-01,zipcode
ZCTA5 35672,01,6189,52236,568,98500,4824,2470,4161,578,1793,1180,326,284,2946,2353,593,2353,1902,451,2018-01-01,zipcode
ZCTA5 35673,01,7720,54379,549,125300,5954,2629,5331,1017,1796,1565,713,240,3191,2726,465,2726,2286,440,2018-01-01,zipcode
ZCTA5 35674,01,18690,51127,675,105600,14867,6688,12845,2194,4925,3855,1171,700,8493,7070,1423,7070,5066,2004,2018-01-01,zipcode
ZCTA5 35677,01,1799,38802,844,101300,1382,637,1203,174,588,259,136,46,1099,744,355,744,589,155,2018-01-01,zipcode
ZCTA5 35739,01,5048,51563,734,143300,3898,1245,3563,560,1208,998,526,271,2187,1956,231,1956,1514,442,2018-01-01,zipcode
ZCTA5 35740,01,3219,30071,478,89100,2651,1396,2280,365,956,695,200,64,1647,1435,212,1435,966,469,2018-01-01,zipcode
ZCTA5 35741,01,2984,78942,946,275800,2578,1081,2196,119,386,601,656,434,1470,1323,147,1323,998,325,2018-01-01,zipcode
ZCTA5 35744,01,2201,34800,418,107100,1782,948,1429,295,713,273,76,72,990,788,202,788,653,135,2018-01-01,zipcode
ZCTA5 35745,01,188,30938,-666666666,153700,170,87,141,14,65,45,11,6,145,84,61,84,69,15,2018-01-01,zipcode
ZCTA5 35746,01,604,33087,-666666666,-666666666,510,287,468,192,190,72,14,0,353,259,94,259,229,30,2018-01-01,zipcode
ZCTA5 35747,01,5231,50016,612,151600,4297,1936,3758,462,1580,1072,366,278,2658,2139,519,2139,1584,555,2018-01-01,zipcode
ZCTA5 35748,01,7257,62394,602,176600,5799,2501,5160,715,1823,1103,910,609,2888,2700,188,2700,2231,469,2018-01-01,zipcode
ZCTA5 35749,01,22295,88455,1149,181400,17225,5403,14758,816,2955,4544,4017,2426,8790,8088,702,8088,6913,1175,2018-01-01,zipcode
ZCTA5 35750,01,12294,50284,801,126000,10106,3690,8709,1107,3158,2689,1246,509,5594,4918,676,4918,3876,1042,2018-01-01,zipcode
ZCTA5 35751,01,237,18304,-666666666,212500,234,72,196,11,95,69,9,12,126,85,41,85,64,21,2018-01-01,zipcode
ZCTA5 35752,01,2680,45293,828,87500,2176,1174,1925,303,852,514,223,33,1148,966,182,966,809,157,2018-01-01,zipcode
ZCTA5 35754,01,5259,53245,549,152700,4465,1881,3940,867,932,1202,806,133,2119,1816,303,1816,1403,413,2018-01-01,zipcode
ZCTA5 35755,01,686,37297,448,169900,586,237,461,49,99,178,61,74,437,259,178,259,179,80,2018-01-01,zipcode
ZCTA5 35756,01,14202,87409,1316,224300,10358,3333,8945,628,1349,2413,2701,1854,5329,4890,439,4890,4401,489,2018-01-01,zipcode
ZCTA5 35757,01,16379,92018,1063,199000,12860,4251,11049,573,1667,3230,3314,2265,6251,5895,356,5895,5073,822,2018-01-01,zipcode
ZCTA5 35758,01,45736,85353,919,233800,36560,11255,31249,1118,4025,8201,10542,7363,19323,18208,1115,18208,12111,6097,2018-01-01,zipcode
ZCTA5 35759,01,7606,87260,1153,188100,6192,1948,5271,291,1043,1922,1405,610,3029,2942,87,2942,2706,236,2018-01-01,zipcode
ZCTA5 35760,01,4869,49832,752,126100,3921,1535,3427,659,1324,921,418,105,2224,1893,331,1893,1485,408,2018-01-01,zipcode
ZCTA5 35761,01,12568,63528,854,154400,9957,3678,8689,1163,2343,2544,1805,834,5287,4894,393,4894,4303,591,2018-01-01,zipcode
ZCTA5 35763,01,18201,110264,1179,274400,13680,5178,11956,375,1778,2606,4126,3071,6748,6519,229,6519,6066,453,2018-01-01,zipcode
ZCTA5 35764,01,497,46125,675,90000,417,220,382,103,186,75,12,6,226,203,23,203,172,31,2018-01-01,zipcode
ZCTA5 35765,01,3926,31192,525,91800,3306,1893,2877,651,922,878,248,178,1885,1483,402,1483,1158,325,2018-01-01,zipcode
ZCTA5 35766,01,123,-666666666,-666666666,129200,93,44,93,9,32,29,6,17,92,55,37,55,41,14,2018-01-01,zipcode
ZCTA5 35768,01,11164,41854,620,99800,9291,4311,8198,1412,3295,2225,706,560,5571,4497,1074,4497,3034,1463,2018-01-01,zipcode
ZCTA5 35769,01,9968,42369,638,143500,7995,3495,7172,836,2471,2214,1120,531,5220,4020,1200,4020,3008,1012,2018-01-01,zipcode
ZCTA5 35771,01,3916,47639,683,114400,3083,1291,2777,568,1091,843,192,83,1606,1387,219,1387,974,413,2018-01-01,zipcode
ZCTA5 35772,01,4409,32449,533,82800,3479,1827,3131,578,1475,833,174,71,2240,1789,451,1789,1235,554,2018-01-01,zipcode
ZCTA5 35773,01,12775,51959,846,119300,10223,3387,8903,1149,2876,2882,1349,647,5278,4807,471,4807,3715,1092,2018-01-01,zipcode
ZCTA5 35774,01,237,45833,-666666666,73000,237,158,180,20,117,29,14,0,94,82,12,82,75,7,2018-01-01,zipcode
ZCTA5 35775,01,1083,31750,-666666666,108500,837,335,836,150,209,321,134,22,451,417,34,417,332,85,2018-01-01,zipcode
ZCTA5 35776,01,3592,38182,613,86900,2898,1392,2434,471,1050,625,164,124,1643,1334,309,1334,1100,234,2018-01-01,zipcode
ZCTA5 35801,01,23724,69276,832,258600,19787,9087,17391,1645,2872,4056,5168,3650,10850,9839,1011,9839,6604,3235,2018-01-01,zipcode
ZCTA5 35802,01,21829,67029,822,231700,18221,7142,16124,650,2372,4425,5154,3523,11601,10128,1473,10128,5966,4162,2018-01-01,zipcode
ZCTA5 35803,01,25710,76796,895,180100,20860,8071,18672,870,3035,4972,6133,3662,11838,11125,713,11125,8968,2157,2018-01-01,zipcode
ZCTA5 35805,01,21200,25329,609,75300,15759,5974,12766,3077,3834,3997,1386,472,10632,9180,1452,9180,2861,6319,2018-01-01,zipcode
ZCTA5 35806,01,21888,68255,945,235200,18318,5808,15455,872,1843,3852,5844,3044,11150,10343,807,10343,4873,5470,2018-01-01,zipcode
ZCTA5 35808,01,1445,84375,1318,-666666666,1157,205,718,11,73,307,182,145,365,330,35,330,5,325,2018-01-01,zipcode
ZCTA5 35810,01,29503,37879,847,85500,24149,10113,18970,3108,5648,6272,2421,1521,12706,11387,1319,11387,7311,4076,2018-01-01,zipcode
ZCTA5 35811,01,27658,62688,810,164100,22373,8202,19524,2178,5108,6300,3883,2055,11864,10837,1027,10837,8650,2187,2018-01-01,zipcode
ZCTA5 35816,01,13923,25270,682,83600,11740,4017,8234,1119,2225,2890,1368,632,7869,6517,1352,6517,1419,5098,2018-01-01,zipcode
ZCTA5 35824,01,8645,86222,951,230400,7084,1478,5675,161,575,1883,1556,1500,3867,3750,117,3750,1945,1805,2018-01-01,zipcode
ZCTA5 35896,01,700,-666666666,-666666666,-666666666,700,419,7,0,0,7,0,0,0,0,0,0,0,0,2018-01-01,zipcode
ZCTA5 35901,01,20049,37809,603,112300,16153,7688,13976,2529,4172,4481,1709,1085,9419,7540,1879,7540,4866,2674,2018-01-01,zipcode
ZCTA5 35903,01,17125,36949,679,91600,14142,6521,11615,1926,4089,3835,1098,667,8349,6503,1846,6503,4075,2428,2018-01-01,zipcode
ZCTA5 35904,01,14030,36763,635,68700,11462,5683,9992,1854,3497,3127,1044,470,6677,5258,1419,5258,4199,1059,2018-01-01,zipcode
ZCTA5 35905,01,6144,58219,592,127400,5009,2338,4634,631,1325,1728,434,516,2787,2401,386,2401,1915,486,2018-01-01,zipcode
ZCTA5 35906,01,9875,49419,762,159900,7896,3409,7049,534,2024,2424,1211,856,4719,4149,570,4149,2620,1529,2018-01-01,zipcode
ZCTA5 35907,01,8511,71368,865,158500,7034,2645,6169,396,1423,2569,1239,542,3679,3247,432,3247,2798,449,2018-01-01,zipcode
ZCTA5 35950,01,21556,40945,676,104500,15666,6568,13219,3168,4067,3899,1462,623,7970,7424,546,7424,4684,2740,2018-01-01,zipcode
ZCTA5 35951,01,12911,36473,652,95000,9702,4278,8248,2362,2851,2208,637,190,4905,4338,567,4338,2951,1387,2018-01-01,zipcode
ZCTA5 35952,01,7482,40826,588,91000,5898,3045,5041,1207,1745,1564,362,163,3211,2691,520,2691,2121,570,2018-01-01,zipcode
ZCTA5 35953,01,7522,50072,701,107000,5935,2794,5198,1037,1907,1834,264,156,3360,2657,703,2657,2166,491,2018-01-01,zipcode
ZCTA5 35954,01,11818,40664,673,86100,9497,4119,8132,1344,3298,2808,348,334,5768,4359,1409,4359,3221,1138,2018-01-01,zipcode
ZCTA5 35956,01,9161,49789,662,109200,7298,3345,6280,1006,2307,2176,448,343,3653,3256,397,3256,2679,577,2018-01-01,zipcode
ZCTA5 35957,01,16135,38342,628,100200,12227,5582,10359,2179,3120,3346,1046,668,6546,5705,841,5705,3571,2134,2018-01-01,zipcode
ZCTA5 35958,01,3832,43092,621,125700,3111,1697,2626,528,1014,704,260,120,1667,1545,122,1545,1152,393,2018-01-01,zipcode
ZCTA5 35959,01,4843,40589,561,104700,3909,2076,3419,763,1377,881,241,157,3693,1995,1698,1995,1538,457,2018-01-01,zipcode
ZCTA5 35960,01,9668,42073,549,145200,8079,4243,7299,1221,2729,2201,502,646,6576,4158,2418,4158,3227,931,2018-01-01,zipcode
ZCTA5 35961,01,7003,38535,635,85900,5620,2746,4850,1454,1655,1439,200,102,2928,2489,439,2489,1683,806,2018-01-01,zipcode
ZCTA5 35962,01,9516,37230,675,84800,7189,3434,5965,2007,1906,1322,410,320,3589,3141,448,3141,2219,922,2018-01-01,zipcode
ZCTA5 35963,01,1139,26637,-666666666,92600,1002,564,927,142,323,306,110,46,673,481,192,481,360,121,2018-01-01,zipcode
ZCTA5 35966,01,3682,36432,685,96200,3125,1596,2647,690,1125,554,87,191,1743,1470,273,1470,1099,371,2018-01-01,zipcode
ZCTA5 35967,01,16373,39746,609,112000,12428,5344,10755,2959,3131,3093,795,777,7569,6177,1392,6177,4187,1990,2018-01-01,zipcode
ZCTA5 35968,01,4584,41443,580,132600,3796,1775,3219,856,1018,951,259,135,1769,1571,198,1571,1165,406,2018-01-01,zipcode
ZCTA5 35971,01,5428,39980,692,92000,4318,1963,3570,811,1335,1046,230,148,2262,1949,313,1949,1431,518,2018-01-01,zipcode
ZCTA5 35972,01,1211,58472,-666666666,107400,905,413,802,127,365,175,64,71,415,415,0,415,330,85,2018-01-01,zipcode
ZCTA5 35973,01,2856,33011,815,88800,2339,1262,1971,584,678,515,163,31,1601,1185,416,1185,1041,144,2018-01-01,zipcode
ZCTA5 35974,01,1514,28798,642,86900,1127,574,1007,294,346,204,125,38,757,641,116,641,334,307,2018-01-01,zipcode
ZCTA5 35975,01,463,-666666666,-666666666,-666666666,416,334,416,112,153,95,48,8,186,172,14,172,142,30,2018-01-01,zipcode
ZCTA5 35976,01,17252,48841,624,165100,14229,6770,12737,2051,3601,3568,2340,1177,8104,6825,1279,6825,5126,1699,2018-01-01,zipcode
ZCTA5 35978,01,4789,40104,605,89000,3809,1826,3514,676,1498,929,290,121,2301,1830,471,1830,1508,322,2018-01-01,zipcode
ZCTA5 35979,01,1608,40500,-666666666,132800,1232,473,1060,185,483,322,55,15,821,678,143,678,516,162,2018-01-01,zipcode
ZCTA5 35980,01,5154,39340,613,78500,3865,1790,3047,842,946,868,140,251,2104,1735,369,1735,1350,385,2018-01-01,zipcode
ZCTA5 35981,01,1860,39402,277,95300,1617,737,1384,170,642,446,97,29,788,673,115,673,485,188,2018-01-01,zipcode
ZCTA5 35983,01,3733,52852,732,159900,3193,1488,2769,312,1059,981,235,182,2458,1473,985,1473,1142,331,2018-01-01,zipcode
ZCTA5 35984,01,1573,35167,858,171700,1402,800,1365,199,340,352,341,133,1422,764,658,764,619,145,2018-01-01,zipcode
ZCTA5 35986,01,8130,38046,591,116300,6474,2854,5545,1038,1984,2034,274,215,3664,3142,522,3142,2224,918,2018-01-01,zipcode
ZCTA5 35987,01,2625,39766,593,83500,2042,934,1705,314,773,481,70,67,1055,969,86,969,751,218,2018-01-01,zipcode
ZCTA5 35988,01,2192,45819,636,95200,1642,586,1363,291,465,414,119,74,805,751,54,751,545,206,2018-01-01,zipcode
ZCTA5 35989,01,3519,37750,608,92700,2671,1296,2266,483,842,491,235,215,1706,1329,377,1329,1043,286,2018-01-01,zipcode
ZCTA5 35990,01,117,48214,950,-666666666,93,39,44,7,28,9,0,0,40,30,10,30,14,16,2018-01-01,zipcode
ZCTA5 36003,01,1898,27841,539,83400,1728,983,1497,375,647,322,90,63,1138,913,225,913,694,219,2018-01-01,zipcode
ZCTA5 36005,01,1640,46250,473,90100,1362,660,1066,195,415,279,102,75,727,502,225,502,421,81,2018-01-01,zipcode
ZCTA5 36006,01,913,47148,474,168200,848,384,739,112,300,176,50,101,546,423,123,423,359,64,2018-01-01,zipcode
ZCTA5 36009,01,2278,34074,439,88700,1884,907,1641,225,682,415,238,81,1261,922,339,922,674,248,2018-01-01,zipcode
ZCTA5 36010,01,4856,36639,499,81600,4022,2010,3154,754,1290,672,287,151,2383,1656,727,1656,1178,478,2018-01-01,zipcode
ZCTA5 36013,01,650,103259,-666666666,422000,546,199,475,14,65,239,84,73,225,225,0,225,206,19,2018-01-01,zipcode
ZCTA5 36016,01,4807,33142,529,78000,4273,2863,3783,1314,1458,700,232,79,1857,1439,418,1439,935,504,2018-01-01,zipcode
ZCTA5 36017,01,2936,25288,436,54200,2508,1899,2218,705,836,526,107,44,900,649,251,649,447,202,2018-01-01,zipcode
ZCTA5 36020,01,999,42273,769,161800,802,409,681,110,214,208,107,42,411,364,47,364,278,86,2018-01-01,zipcode
ZCTA5 36022,01,12141,67513,748,170700,9822,3773,8195,858,2713,2492,1548,584,4816,4385,431,4385,3833,552,2018-01-01,zipcode
ZCTA5 36024,01,4942,57970,736,145200,4160,1975,3742,454,1332,1022,630,304,2984,2011,973,2011,1583,428,2018-01-01,zipcode
ZCTA5 36025,01,6756,46714,903,148400,5961,4028,5194,1297,2190,1094,350,263,1478,1388,90,1388,892,496,2018-01-01,zipcode
ZCTA5 36026,01,1002,44028,-666666666,198600,835,412,748,83,223,217,195,30,1150,437,713,437,313,124,2018-01-01,zipcode
ZCTA5 36027,01,15496,34588,618,109500,12044,5546,10397,2285,3543,2993,969,607,7747,6111,1636,6111,3431,2680,2018-01-01,zipcode
ZCTA5 36028,01,1674,37604,395,108300,1398,696,1192,216,415,341,136,84,956,693,263,693,583,110,2018-01-01,zipcode
ZCTA5 36029,01,1160,44525,-666666666,156000,978,356,918,214,341,195,121,47,433,345,88,345,307,38,2018-01-01,zipcode
ZCTA5 36030,01,645,29688,-666666666,80000,587,299,492,26,331,83,39,13,326,190,136,190,156,34,2018-01-01,zipcode
ZCTA5 36031,01,175,31250,-666666666,66300,158,128,129,71,48,10,0,0,96,84,12,84,79,5,2018-01-01,zipcode
ZCTA5 36032,01,2336,35545,573,58900,1770,744,1470,291,590,361,109,119,1191,889,302,889,652,237,2018-01-01,zipcode
ZCTA5 36033,01,4426,38575,575,69900,3503,1883,3063,535,1346,814,166,202,2234,1381,853,1381,978,403,2018-01-01,zipcode
ZCTA5 36034,01,974,40417,529,50500,782,336,603,75,243,192,36,57,435,330,105,330,296,34,2018-01-01,zipcode
ZCTA5 36035,01,1468,44563,638,114600,1133,423,1023,158,445,212,126,82,909,563,346,563,484,79,2018-01-01,zipcode
ZCTA5 36036,01,1796,42250,662,94000,1599,697,1346,363,532,273,114,64,1070,766,304,766,640,126,2018-01-01,zipcode
ZCTA5 36037,01,13306,39346,622,92000,10342,4511,8966,1434,3761,2193,979,599,6513,4489,2024,4489,3019,1470,2018-01-01,zipcode
ZCTA5 36038,01,47,33333,-666666666,156300,47,31,47,10,14,23,0,0,18,18,0,18,18,0,2018-01-01,zipcode
ZCTA5 36039,01,240,50481,-666666666,82700,240,127,201,47,63,63,28,0,75,75,0,75,56,19,2018-01-01,zipcode
ZCTA5 36040,01,3584,23968,635,62600,2878,1529,2533,612,1115,484,209,113,1647,1474,173,1474,925,549,2018-01-01,zipcode
ZCTA5 36041,01,1401,44671,-666666666,69900,1103,466,922,208,425,232,29,28,606,455,151,455,405,50,2018-01-01,zipcode
ZCTA5 36042,01,1774,49792,583,79100,1472,685,1328,279,639,218,136,56,827,579,248,579,511,68,2018-01-01,zipcode
ZCTA5 36043,01,3636,37917,1049,175800,3040,1672,2603,545,942,505,377,234,1745,1445,300,1445,1170,275,2018-01-01,zipcode
ZCTA5 36046,01,1413,46625,-666666666,87900,1191,562,1082,241,466,249,114,12,749,576,173,576,548,28,2018-01-01,zipcode
ZCTA5 36047,01,1150,38710,-666666666,103700,837,425,769,136,316,202,106,9,617,470,147,470,382,88,2018-01-01,zipcode
ZCTA5 36048,01,1470,35787,560,65700,1209,587,1010,391,397,163,42,17,723,513,210,513,394,119,2018-01-01,zipcode
ZCTA5 36049,01,6067,41042,523,77500,4860,2286,4227,903,1516,943,637,228,2785,2206,579,2206,1480,726,2018-01-01,zipcode
ZCTA5 36051,01,2106,69423,832,86000,1771,584,1588,265,682,374,146,121,912,832,80,832,665,167,2018-01-01,zipcode
ZCTA5 36052,01,308,66563,-666666666,561500,264,119,264,7,59,79,91,28,212,157,55,157,144,13,2018-01-01,zipcode
ZCTA5 36053,01,1790,25282,447,78300,1341,610,1196,370,330,354,87,55,1116,703,413,703,497,206,2018-01-01,zipcode
ZCTA5 36054,01,16080,58573,809,138800,12068,3961,9704,1062,2964,3110,1542,1026,6329,5823,506,5823,4060,1763,2018-01-01,zipcode
ZCTA5 36064,01,9780,105830,1082,288500,7336,2194,6515,329,908,1532,2112,1634,3875,3559,316,3559,3277,282,2018-01-01,zipcode
ZCTA5 36066,01,19097,62089,1122,169700,14856,5413,13085,1076,3158,3584,2901,2366,8710,7950,760,7950,4834,3116,2018-01-01,zipcode
ZCTA5 36067,01,28727,53578,793,129800,22329,9487,18934,2534,6693,5548,2528,1631,11262,10351,911,10351,7910,2441,2018-01-01,zipcode
ZCTA5 36069,01,1939,44255,595,103400,1793,759,1538,324,474,365,219,156,1043,863,180,863,749,114,2018-01-01,zipcode
ZCTA5 36071,01,457,39107,583,95000,394,194,373,140,119,83,31,0,221,155,66,155,114,41,2018-01-01,zipcode
ZCTA5 36075,01,2159,39500,670,85400,1778,898,1623,277,570,464,191,121,1076,880,196,880,634,246,2018-01-01,zipcode
ZCTA5 36078,01,13178,54149,671,139800,10316,4479,8815,1534,2940,2787,1005,549,5708,4857,851,4857,3458,1399,2018-01-01,zipcode
ZCTA5 36079,01,10159,48438,699,131800,8162,2925,6665,887,2392,1739,1066,581,4444,3299,1145,3299,2444,855,2018-01-01,zipcode
ZCTA5 36080,01,2084,65406,-666666666,196200,1847,973,1647,147,759,398,237,106,1062,791,271,791,724,67,2018-01-01,zipcode
ZCTA5 36081,01,15894,27711,592,120800,13232,5951,8577,1990,2269,2072,1343,903,8468,6180,2288,6180,2815,3365,2018-01-01,zipcode
ZCTA5 36082,01,1271,-666666666,-666666666,-666666666,1271,1034,26,0,0,13,13,0,0,0,0,0,0,0,2018-01-01,zipcode
ZCTA5 36083,01,7542,32019,570,76900,6255,2829,5397,984,1451,1565,767,630,4752,3428,1324,3428,2189,1239,2018-01-01,zipcode
ZCTA5 36088,01,4802,27743,645,81000,4231,2085,1795,318,399,611,206,261,2017,1303,714,1303,551,752,2018-01-01,zipcode
ZCTA5 36089,01,7391,29602,675,80300,5949,2990,5027,1144,2172,1074,348,289,3184,2645,539,2645,1949,696,2018-01-01,zipcode
ZCTA5 36091,01,3526,40125,541,79200,2883,1395,2522,410,1123,616,219,154,1797,1451,346,1451,1115,336,2018-01-01,zipcode
ZCTA5 36092,01,19843,54499,859,138200,16241,7893,13904,2072,5083,3968,1976,805,8700,7441,1259,7441,5306,2135,2018-01-01,zipcode
ZCTA5 36093,01,11147,86869,1272,237600,8498,3238,7244,332,1547,2270,1898,1197,4070,3896,174,3896,3495,401,2018-01-01,zipcode
ZCTA5 36104,01,8342,23652,698,73500,6813,3688,4945,1285,1363,1170,540,587,4046,2888,1158,2888,914,1974,2018-01-01,zipcode
ZCTA5 36105,01,9815,30660,835,64300,8297,3947,7280,2016,2661,1749,543,311,5223,3996,1227,3996,2516,1480,2018-01-01,zipcode
ZCTA5 36106,01,15094,55255,974,158200,12272,4475,10048,696,1889,2734,2410,2319,6994,6245,749,6245,3526,2719,2018-01-01,zipcode
ZCTA5 36107,01,7688,30797,800,68900,5872,2252,4879,1198,1632,1021,583,445,4152,3101,1051,3101,1336,1765,2018-01-01,zipcode
ZCTA5 36108,01,18299,24690,595,64500,14456,7231,12621,3794,4152,3050,1106,519,9433,7520,1913,7520,4275,3245,2018-01-01,zipcode
ZCTA5 36109,01,24907,53548,937,117300,20577,8340,17262,1705,4755,5250,3505,2047,10975,10118,857,10118,7253,2865,2018-01-01,zipcode
ZCTA5 36110,01,11829,31305,820,58200,9232,4712,7651,2217,2648,1900,566,320,5563,4320,1243,4320,2283,2037,2018-01-01,zipcode
ZCTA5 36111,01,12369,49988,829,144200,9426,3211,7978,1088,2094,1967,1701,1128,5586,4841,745,4841,2712,2129,2018-01-01,zipcode
ZCTA5 36112,01,320,-666666666,-666666666,-666666666,320,11,157,0,31,98,0,28,0,0,0,0,0,0,2018-01-01,zipcode
ZCTA5 36113,01,1809,92813,1572,-666666666,1463,972,1306,93,450,395,151,217,309,274,35,274,0,274,2018-01-01,zipcode
ZCTA5 36115,01,964,62019,1348,-666666666,630,168,449,8,88,237,52,64,269,269,0,269,0,269,2018-01-01,zipcode
ZCTA5 36116,01,44556,43683,859,104500,34176,11359,27952,3861,7004,9097,4727,3263,20074,17198,2876,17198,8611,8587,2018-01-01,zipcode
ZCTA5 36117,01,53841,62753,974,179600,42229,13401,35466,2320,6766,10499,9485,6396,23977,22287,1690,22287,13151,9136,2018-01-01,zipcode
ZCTA5 36201,01,18052,28402,578,66700,14565,7243,12716,3419,4459,4000,615,223,9661,7234,2427,7234,4351,2883,2018-01-01,zipcode
ZCTA5 36203,01,18033,54835,849,148600,14350,4991,12515,1633,3828,4312,1691,1051,7765,6970,795,6970,4700,2270,2018-01-01,zipcode
ZCTA5 36205,01,688,59375,800,214400,585,243,443,64,57,127,66,129,290,202,88,202,126,76,2018-01-01,zipcode
ZCTA5 36206,01,11541,44226,643,94400,9083,3866,7830,1214,2802,2601,593,620,5155,4486,669,4486,3323,1163,2018-01-01,zipcode
ZCTA5 36207,01,19746,50809,764,143600,16154,7081,14084,1393,4350,4658,1738,1945,9743,8288,1455,8288,5871,2417,2018-01-01,zipcode
ZCTA5 36250,01,4958,70606,906,120500,3894,1410,3479,360,949,1419,509,242,1970,1788,182,1788,1494,294,2018-01-01,zipcode
ZCTA5 36251,01,4895,34362,417,88800,4147,1943,3340,853,1016,1111,229,131,2438,1905,533,1905,1311,594,2018-01-01,zipcode
ZCTA5 36255,01,871,44297,-666666666,132900,621,251,520,128,253,96,0,43,389,355,34,355,318,37,2018-01-01,zipcode
ZCTA5 36256,01,1638,46600,660,89600,1312,525,1207,204,480,375,105,43,838,652,186,652,550,102,2018-01-01,zipcode
ZCTA5 36258,01,1337,56848,543,164100,1128,550,1054,181,436,271,79,87,852,558,294,558,451,107,2018-01-01,zipcode
ZCTA5 36260,01,4001,41537,601,118400,3112,1412,2676,565,963,885,229,34,1832,1581,251,1581,1168,413,2018-01-01,zipcode
ZCTA5 36262,01,1427,36750,535,82300,1056,465,935,194,458,216,66,1,643,507,136,507,395,112,2018-01-01,zipcode
ZCTA5 36263,01,434,26154,600,85700,419,290,362,70,152,35,25,80,306,218,88,218,118,100,2018-01-01,zipcode
ZCTA5 36264,01,8523,36169,573,116500,6838,3489,5961,1538,2061,1497,484,381,3994,3306,688,3306,2412,894,2018-01-01,zipcode
ZCTA5 36265,01,20694,49356,624,148700,17308,7440,12912,1362,3328,4648,2082,1492,8640,7697,943,7697,4651,3046,2018-01-01,zipcode
ZCTA5 36266,01,5276,45720,596,111600,4049,1652,3549,853,1391,958,191,156,2740,1975,765,1975,1302,673,2018-01-01,zipcode
ZCTA5 36267,01,12,-666666666,-666666666,-666666666,12,0,12,12,0,0,0,0,12,12,0,12,12,0,2018-01-01,zipcode
ZCTA5 36268,01,5814,52561,768,117000,4568,1775,3950,705,1544,1327,248,126,2654,2362,292,2362,1991,371,2018-01-01,zipcode
ZCTA5 36269,01,1535,55536,547,78300,1071,535,974,194,472,182,120,6,519,482,37,482,388,94,2018-01-01,zipcode
ZCTA5 36271,01,5952,53448,678,97100,4893,1698,4313,903,1410,1492,297,211,2863,2283,580,2283,1896,387,2018-01-01,zipcode
ZCTA5 36272,01,13221,38513,495,79100,10642,5344,9276,2055,3529,2658,647,387,6583,5331,1252,5331,4248,1083,2018-01-01,zipcode
ZCTA5 36273,01,3015,45208,654,132900,2468,1015,2215,428,974,497,221,95,1434,1249,185,1249,981,268,2018-01-01,zipcode
ZCTA5 36274,01,11295,40568,603,81900,9108,4279,7882,1533,2777,2385,848,339,5405,4350,1055,4350,3124,1226,2018-01-01,zipcode
ZCTA5 36276,01,2615,31000,494,78100,2168,1060,1719,578,540,452,116,33,1140,892,248,892,675,217,2018-01-01,zipcode
ZCTA5 36277,01,5529,54449,826,102700,4305,1682,3741,511,1136,1599,359,136,2347,1993,354,1993,1534,459,2018-01-01,zipcode
ZCTA5 36278,01,4755,39330,707,134900,3805,2066,3319,627,1091,951,331,319,3182,1863,1319,1863,1362,501,2018-01-01,zipcode
ZCTA5 36279,01,2339,55913,-666666666,153300,2005,911,1838,399,628,532,71,208,1246,961,285,961,901,60,2018-01-01,zipcode
ZCTA5 36280,01,3875,47847,746,90500,3080,1640,2819,595,1247,672,146,159,1892,1461,431,1461,1149,312,2018-01-01,zipcode
ZCTA5 36301,01,37527,40702,721,112600,29451,12443,25284,4012,8902,8327,2565,1478,16760,14049,2711,14049,8595,5454,2018-01-01,zipcode
ZCTA5 36303,01,31005,42724,692,142700,24494,10538,21048,2856,5900,7030,3358,1904,14407,11678,2729,11678,6941,4737,2018-01-01,zipcode
ZCTA5 36305,01,15816,64987,942,179500,12340,4680,10944,716,2535,3904,2358,1431,6902,6128,774,6128,4222,1906,2018-01-01,zipcode
ZCTA5 36310,01,6055,40641,496,92200,5195,2933,4517,1005,1620,1196,350,346,4127,2566,1561,2566,2073,493,2018-01-01,zipcode
ZCTA5 36311,01,2715,41484,494,75200,2266,1232,1912,450,689,538,74,161,1413,1098,315,1098,943,155,2018-01-01,zipcode
ZCTA5 36312,01,6030,41429,659,98400,4898,2336,4195,654,1626,1343,357,215,2743,2266,477,2266,1741,525,2018-01-01,zipcode
ZCTA5 36313,01,240,83421,-666666666,140300,166,60,166,31,0,123,12,0,138,90,48,90,67,23,2018-01-01,zipcode
ZCTA5 36314,01,445,46902,575,122700,366,144,350,80,153,36,49,32,249,199,50,199,179,20,2018-01-01,zipcode
ZCTA5 36316,01,1921,68229,646,156300,1572,663,1422,117,433,631,169,72,890,739,151,739,613,126,2018-01-01,zipcode
ZCTA5 36317,01,569,34286,493,64300,533,340,501,170,156,118,45,12,361,248,113,248,201,47,2018-01-01,zipcode
ZCTA5 36318,01,1571,36908,677,70500,1234,649,1012,205,354,412,35,6,729,581,148,581,472,109,2018-01-01,zipcode
ZCTA5 36319,01,1917,40761,739,77900,1582,837,1472,222,471,583,128,68,1001,806,195,806,621,185,2018-01-01,zipcode
ZCTA5 36320,01,3708,39835,607,88400,2964,1273,2682,486,1179,764,205,48,1734,1351,383,1351,1098,253,2018-01-01,zipcode
ZCTA5 36321,01,1744,41974,809,91400,1337,511,1140,190,484,324,97,45,733,620,113,620,481,139,2018-01-01,zipcode
ZCTA5 36322,01,9201,43227,708,106400,7336,3237,6191,970,2160,2213,626,222,4642,3463,1179,3463,1962,1501,2018-01-01,zipcode
ZCTA5 36323,01,7810,42832,634,89100,6556,3109,5601,1314,1831,1798,450,208,3653,2921,732,2921,2062,859,2018-01-01,zipcode
ZCTA5 36330,01,36607,57985,831,168200,28445,10492,24634,2567,6128,9008,4623,2308,16285,14119,2166,14119,8567,5552,2018-01-01,zipcode
ZCTA5 36340,01,5721,31140,438,107900,4553,2384,4033,1111,1582,862,248,230,2636,2308,328,2308,1487,821,2018-01-01,zipcode
ZCTA5 36343,01,1343,41750,625,75700,1175,649,1012,262,408,275,49,18,744,505,239,505,456,49,2018-01-01,zipcode
ZCTA5 36344,01,5850,43062,620,107200,4762,2171,4202,784,1498,1460,322,138,2811,2179,632,2179,1502,677,2018-01-01,zipcode
ZCTA5 36345,01,8845,57618,619,141800,6896,2720,6122,959,2016,1790,868,489,3633,3223,410,3223,2602,621,2018-01-01,zipcode
ZCTA5 36346,01,1491,45167,586,92600,1151,549,976,188,378,262,89,59,632,552,80,552,427,125,2018-01-01,zipcode
ZCTA5 36350,01,6628,41282,641,125200,5040,1965,4439,585,1375,1719,501,259,3132,2696,436,2696,1647,1049,2018-01-01,zipcode
ZCTA5 36351,01,3410,48663,713,106900,2783,1278,2441,395,889,789,215,153,1598,1386,212,1386,1032,354,2018-01-01,zipcode
ZCTA5 36352,01,5305,55094,747,151000,4472,1724,3744,667,1006,1377,316,378,2005,1875,130,1875,1497,378,2018-01-01,zipcode
ZCTA5 36353,01,1720,43250,533,105200,1417,625,1124,189,333,445,104,53,882,672,210,672,593,79,2018-01-01,zipcode
ZCTA5 36360,01,19117,43605,635,109000,15535,7361,13653,2068,4643,4708,1449,785,9162,7664,1498,7664,5011,2653,2018-01-01,zipcode
ZCTA5 36362,01,5134,63839,1197,-666666666,3457,809,2314,21,298,1134,626,235,1452,1246,206,1246,0,1246,2018-01-01,zipcode
ZCTA5 36370,01,878,48333,779,86800,732,372,695,182,293,203,7,10,413,352,61,352,282,70,2018-01-01,zipcode
ZCTA5 36371,01,597,34479,794,109300,508,282,460,74,156,161,54,15,340,273,67,273,198,75,2018-01-01,zipcode
ZCTA5 36373,01,410,43103,-666666666,67900,393,211,300,68,145,83,0,4,365,182,183,182,167,15,2018-01-01,zipcode
ZCTA5 36374,01,691,58750,-666666666,108500,628,258,573,158,200,175,7,33,527,339,188,339,309,30,2018-01-01,zipcode
ZCTA5 36375,01,6962,41419,739,80200,5788,2606,4864,1121,1809,1330,421,183,3319,2766,553,2766,2031,735,2018-01-01,zipcode
ZCTA5 36376,01,2224,42708,700,86200,1866,909,1653,313,712,437,129,62,1117,826,291,826,687,139,2018-01-01,zipcode
ZCTA5 36401,01,8109,33116,573,84500,6614,3693,5722,846,3032,1226,397,221,4542,2939,1603,2939,2143,796,2018-01-01,zipcode
ZCTA5 36420,01,10369,44229,658,108900,8337,3630,7271,1125,2624,2193,755,574,5022,4109,913,4109,2889,1220,2018-01-01,zipcode
ZCTA5 36421,01,9861,41857,588,107300,7768,3465,6860,993,2002,2570,947,348,5065,3940,1125,3940,2998,942,2018-01-01,zipcode
ZCTA5 36425,01,1127,19567,542,40900,932,513,751,87,348,195,86,35,646,433,213,433,319,114,2018-01-01,zipcode
ZCTA5 36426,01,15293,37910,572,94300,12376,6204,10845,1917,4198,3040,1090,600,7434,6090,1344,6090,4188,1902,2018-01-01,zipcode
ZCTA5 36432,01,2223,32321,382,65500,1850,1006,1639,489,734,310,87,19,1228,749,479,749,603,146,2018-01-01,zipcode
ZCTA5 36435,01,426,25741,-666666666,84000,302,179,291,93,83,98,0,17,285,134,151,134,122,12,2018-01-01,zipcode
ZCTA5 36436,01,372,37014,-666666666,61500,354,202,327,71,169,72,15,0,290,203,87,203,162,41,2018-01-01,zipcode
ZCTA5 36439,01,728,46705,936,149300,536,257,467,64,168,122,55,58,290,241,49,241,151,90,2018-01-01,zipcode
ZCTA5 36441,01,4107,37692,564,86500,3071,1386,2869,373,1485,756,164,91,1854,1509,345,1509,1167,342,2018-01-01,zipcode
ZCTA5 36442,01,2985,31875,506,86000,2475,1292,2272,394,899,788,114,77,1664,1211,453,1211,856,355,2018-01-01,zipcode
ZCTA5 36444,01,924,19728,-666666666,64800,740,595,605,194,210,154,7,40,557,335,222,335,212,123,2018-01-01,zipcode
ZCTA5 36445,01,4713,40417,640,93300,3488,1966,3070,587,1485,714,224,60,2237,1766,471,1766,1174,592,2018-01-01,zipcode
ZCTA5 36446,01,472,17656,-666666666,80500,376,210,274,63,138,59,0,14,245,153,92,153,105,48,2018-01-01,zipcode
ZCTA5 36451,01,4330,48721,563,122200,3488,1786,3153,434,1329,1021,265,104,2446,1811,635,1811,1302,509,2018-01-01,zipcode
ZCTA5 36453,01,2423,39881,595,76500,2059,972,1748,296,652,578,139,83,1122,950,172,950,683,267,2018-01-01,zipcode
ZCTA5 36454,01,39,-666666666,-666666666,-666666666,39,34,30,0,16,0,9,5,49,17,32,17,17,0,2018-01-01,zipcode
ZCTA5 36455,01,250,31250,625,60000,203,94,194,42,76,66,6,4,161,111,50,111,86,25,2018-01-01,zipcode
ZCTA5 36456,01,1393,33125,379,58200,1152,682,962,151,401,313,69,28,718,507,211,507,384,123,2018-01-01,zipcode
ZCTA5 36460,01,9644,32048,500,118000,7712,3705,6675,942,2963,1661,693,416,4713,3663,1050,3663,2085,1578,2018-01-01,zipcode
ZCTA5 36467,01,9769,36847,588,91100,7881,3737,6846,1545,2513,1943,553,292,4915,4002,913,4002,2836,1166,2018-01-01,zipcode
ZCTA5 36470,01,178,-666666666,-666666666,-666666666,178,77,178,54,124,0,0,0,99,77,22,77,22,55,2018-01-01,zipcode
ZCTA5 36471,01,1057,22031,518,77000,905,609,773,126,496,99,18,34,810,441,369,441,244,197,2018-01-01,zipcode
ZCTA5 36473,01,21,-666666666,-666666666,-666666666,14,2,9,0,0,0,0,9,26,7,19,7,7,0,2018-01-01,zipcode
ZCTA5 36474,01,3099,42159,518,74000,2573,1160,2236,372,945,764,98,57,1645,1250,395,1250,1103,147,2018-01-01,zipcode
ZCTA5 36475,01,2127,28802,542,64100,1685,989,1524,263,743,293,158,67,1257,893,364,893,685,208,2018-01-01,zipcode
ZCTA5 36476,01,18,20250,-666666666,-666666666,18,10,10,2,4,4,0,0,21,9,12,9,8,1,2018-01-01,zipcode
ZCTA5 36477,01,3898,25109,522,66600,3053,1546,2658,532,1060,820,125,121,2107,1624,483,1624,1113,511,2018-01-01,zipcode
ZCTA5 36480,01,1564,31912,664,91900,1367,852,1160,137,455,359,77,132,1141,612,529,612,407,205,2018-01-01,zipcode
ZCTA5 36481,01,522,15729,-666666666,34200,431,272,310,99,138,73,0,0,322,137,185,137,58,79,2018-01-01,zipcode
ZCTA5 36482,01,573,34922,-666666666,78600,537,329,501,184,191,112,0,14,404,281,123,281,259,22,2018-01-01,zipcode
ZCTA5 36483,01,392,34500,-666666666,77600,363,220,337,41,159,108,29,0,202,172,30,172,167,5,2018-01-01,zipcode
ZCTA5 36502,01,18192,31623,603,107900,14726,8297,12372,2486,5986,2500,885,515,7345,5965,1380,5965,3991,1974,2018-01-01,zipcode
ZCTA5 36505,01,1965,58005,1147,119300,1467,511,1222,299,175,451,190,107,670,607,63,607,445,162,2018-01-01,zipcode
ZCTA5 36507,01,22096,43596,662,130700,16965,7852,14413,2130,5550,4509,1528,696,8285,7287,998,7287,5009,2278,2018-01-01,zipcode
ZCTA5 36509,01,2076,37760,720,73200,1621,645,1261,523,386,286,52,14,759,625,134,625,378,247,2018-01-01,zipcode
ZCTA5 36511,01,383,20159,-666666666,113100,345,315,345,177,144,24,0,0,350,250,100,250,215,35,2018-01-01,zipcode
ZCTA5 36512,01,47,-666666666,-666666666,-666666666,47,47,47,18,29,0,0,0,25,25,0,25,25,0,2018-01-01,zipcode
ZCTA5 36513,01,1024,32670,-666666666,-666666666,661,461,566,338,145,39,0,44,273,252,21,252,153,99,2018-01-01,zipcode
ZCTA5 36518,01,2468,47647,754,129000,2157,1139,1829,232,765,544,160,128,1433,992,441,992,778,214,2018-01-01,zipcode
ZCTA5 36521,01,5386,52582,782,118300,4515,2160,3996,827,1882,1070,139,78,2145,2021,124,2021,1760,261,2018-01-01,zipcode
ZCTA5 36522,01,7685,44880,760,108300,5786,2729,4821,781,2103,1351,461,125,2964,2567,397,2567,1804,763,2018-01-01,zipcode
ZCTA5 36523,01,2890,46944,847,87500,2356,1249,2188,652,864,466,99,107,1225,1044,181,1044,713,331,2018-01-01,zipcode
ZCTA5 36524,01,1255,35588,658,88100,986,592,797,156,377,194,50,20,951,482,469,482,413,69,2018-01-01,zipcode
ZCTA5 36525,01,1928,46250,789,119300,1487,660,1279,186,513,383,144,53,790,701,89,701,466,235,2018-01-01,zipcode
ZCTA5 36526,01,34669,71632,1108,196400,26956,8621,23248,1216,4755,8032,6262,2983,13934,12665,1269,12665,9319,3346,2018-01-01,zipcode
ZCTA5 36527,01,15262,91235,1235,285100,11368,3679,9843,430,1473,3126,2833,1981,5860,5620,240,5620,4026,1594,2018-01-01,zipcode
ZCTA5 36528,01,1229,84861,979,240500,1117,528,1018,41,260,313,202,202,1941,551,1390,551,484,67,2018-01-01,zipcode
ZCTA5 36529,01,237,-666666666,-666666666,219400,195,116,172,9,103,33,27,0,161,103,58,103,103,0,2018-01-01,zipcode
ZCTA5 36530,01,6939,47321,834,167900,5758,2506,4905,582,1650,1595,795,283,3584,2721,863,2721,2147,574,2018-01-01,zipcode
ZCTA5 36532,01,33743,67580,1079,245900,26340,11522,23522,1404,4520,6460,6921,4217,14741,12248,2493,12248,9819,2429,2018-01-01,zipcode
ZCTA5 36535,01,30187,45684,773,164900,25295,10830,22766,2665,6921,7768,3893,1519,14863,11973,2890,11973,8205,3768,2018-01-01,zipcode
ZCTA5 36538,01,407,28722,-666666666,21300,336,211,310,139,119,52,0,0,304,178,126,178,178,0,2018-01-01,zipcode
ZCTA5 36539,01,809,33403,-666666666,-666666666,665,394,443,60,226,115,19,23,372,289,83,289,235,54,2018-01-01,zipcode
ZCTA5 36540,01,696,-666666666,-666666666,54400,623,351,465,152,227,75,4,7,291,213,78,213,158,55,2018-01-01,zipcode
ZCTA5 36541,01,15635,54037,1074,107800,11624,4637,10110,1866,3697,3133,906,508,5813,5112,701,5112,4596,516,2018-01-01,zipcode
ZCTA5 36542,01,13932,50787,1034,242400,12583,5202,11131,455,2666,4095,2437,1478,16717,6706,10011,6706,4026,2680,2018-01-01,zipcode
ZCTA5 36543,01,189,93226,-666666666,93200,154,58,154,0,31,105,0,18,62,62,0,62,62,0,2018-01-01,zipcode
ZCTA5 36544,01,11396,43411,871,108300,9083,3877,7738,1912,3423,1803,509,91,4734,4057,677,4057,3084,973,2018-01-01,zipcode
ZCTA5 36545,01,10030,30966,593,103000,7982,4578,6613,1228,3063,1499,400,423,4835,3631,1204,3631,2428,1203,2018-01-01,zipcode
ZCTA5 36548,01,839,31953,-666666666,110200,742,362,648,43,212,309,31,53,552,420,132,420,378,42,2018-01-01,zipcode
ZCTA5 36549,01,4996,48904,940,121100,4511,2519,4171,238,1657,1382,570,324,2869,2093,776,2093,1910,183,2018-01-01,zipcode
ZCTA5 36550,01,489,-666666666,-666666666,-666666666,489,308,348,73,41,96,103,35,238,186,52,186,142,44,2018-01-01,zipcode
ZCTA5 36551,01,9029,54976,936,145000,7404,3340,6530,1132,2336,1894,784,384,3460,3043,417,3043,2465,578,2018-01-01,zipcode
ZCTA5 36553,01,3246,41622,440,93000,2716,1508,2011,456,1008,423,108,16,1495,1062,433,1062,999,63,2018-01-01,zipcode
ZCTA5 36555,01,791,54792,862,257300,738,382,704,25,236,163,223,57,495,358,137,358,316,42,2018-01-01,zipcode
ZCTA5 36556,01,601,-666666666,-666666666,48200,496,326,388,49,171,147,21,0,408,235,173,235,143,92,2018-01-01,zipcode
ZCTA5 36558,01,3414,45795,484,70900,2741,1332,2400,516,963,540,188,193,1891,1298,593,1298,1157,141,2018-01-01,zipcode
ZCTA5 36559,01,99,-666666666,-666666666,-666666666,99,65,63,0,0,33,16,14,97,50,47,50,33,17,2018-01-01,zipcode
ZCTA5 36560,01,3381,37931,658,65400,2948,1580,2561,802,1066,534,111,48,1537,1316,221,1316,959,357,2018-01-01,zipcode
ZCTA5 36561,01,6803,80057,1178,337000,5856,2647,5369,261,1090,1393,1823,802,13336,2982,10354,2982,2274,708,2018-01-01,zipcode
ZCTA5 36562,01,1463,44737,-666666666,102200,1188,518,1030,237,514,199,80,0,529,450,79,450,426,24,2018-01-01,zipcode
ZCTA5 36564,01,52,-666666666,-666666666,-666666666,52,52,52,0,0,11,10,31,170,41,129,41,41,0,2018-01-01,zipcode
ZCTA5 36567,01,13935,46783,755,133600,10870,4796,9415,1784,3626,2721,989,295,5786,4981,805,4981,3552,1429,2018-01-01,zipcode
ZCTA5 36568,01,67,-666666666,-666666666,-666666666,67,49,67,26,23,0,0,18,58,58,0,58,58,0,2018-01-01,zipcode
ZCTA5 36569,01,648,41685,-666666666,58500,589,355,580,67,279,190,41,3,348,257,91,257,215,42,2018-01-01,zipcode
ZCTA5 36571,01,15407,60408,929,138200,11946,4819,9980,1512,3679,3059,1141,589,5944,5249,695,5249,3834,1415,2018-01-01,zipcode
ZCTA5 36572,01,6165,63287,872,150000,4922,2240,4399,500,1854,1298,508,239,2332,2262,70,2262,1899,363,2018-01-01,zipcode
ZCTA5 36574,01,878,63839,-666666666,155900,744,354,668,70,364,120,79,35,541,365,176,365,332,33,2018-01-01,zipcode
ZCTA5 36575,01,21095,59016,881,144000,15972,6551,14024,1972,5796,3987,1611,658,7940,7391,549,7391,5974,1417,2018-01-01,zipcode
ZCTA5 36576,01,3796,44744,911,163200,3270,1166,2903,534,1066,661,539,103,1847,1613,234,1613,1196,417,2018-01-01,zipcode
ZCTA5 36578,01,1186,58625,728,256100,954,360,864,59,222,389,107,87,589,465,124,465,430,35,2018-01-01,zipcode
ZCTA5 36579,01,1204,39306,547,127300,983,523,901,183,306,197,104,111,1103,470,633,470,389,81,2018-01-01,zipcode
ZCTA5 36580,01,5762,43393,699,147100,4621,2053,3525,645,1243,1102,326,209,2413,1874,539,1874,1428,446,2018-01-01,zipcode
ZCTA5 36581,01,136,50273,-666666666,9999,113,81,113,0,109,4,0,0,104,57,47,57,43,14,2018-01-01,zipcode
ZCTA5 36582,01,24628,52676,713,123600,18853,7236,16130,2472,5938,4767,2278,675,9980,8917,1063,8917,6625,2292,2018-01-01,zipcode
ZCTA5 36583,01,843,37361,-666666666,172200,623,395,560,64,248,161,69,18,322,295,27,295,244,51,2018-01-01,zipcode
ZCTA5 36584,01,741,68750,-666666666,105300,604,284,571,144,218,168,41,0,454,275,179,275,233,42,2018-01-01,zipcode
ZCTA5 36585,01,1031,27672,483,-666666666,677,322,644,85,216,239,27,77,379,299,80,299,244,55,2018-01-01,zipcode
ZCTA5 36587,01,9475,53177,920,117000,7886,3681,6659,1254,2803,1833,582,187,4251,3193,1058,3193,2864,329,2018-01-01,zipcode
ZCTA5 36590,01,0,-666666666,-666666666,-666666666,0,0,0,0,0,0,0,0,0,0,0,0,0,0,2018-01-01,zipcode
ZCTA5 36602,01,939,23958,443,194000,939,510,850,116,161,342,120,111,794,649,145,649,103,546,2018-01-01,zipcode
ZCTA5 36603,01,10395,19203,579,82300,8945,6804,7537,2216,2699,1940,479,203,3784,2733,1051,2733,991,1742,2018-01-01,zipcode
ZCTA5 36604,01,9567,47695,817,156100,7771,2588,6640,626,1305,1966,1700,1043,5124,4036,1088,4036,2245,1791,2018-01-01,zipcode
ZCTA5 36605,01,26306,31834,816,77800,20060,9253,16869,2746,6906,4881,1651,685,12829,10079,2750,10079,5777,4302,2018-01-01,zipcode
ZCTA5 36606,01,18879,37837,836,99600,14870,5482,12694,1417,4475,3284,2362,1156,9515,7921,1594,7921,3995,3926,2018-01-01,zipcode
ZCTA5 36607,01,6270,39813,755,109400,5235,2391,4661,802,1320,1209,813,517,3397,2593,804,2593,1347,1246,2018-01-01,zipcode
ZCTA5 36608,01,35591,49068,862,159500,29425,12265,23324,1887,5478,6798,5533,3628,17037,14876,2161,14876,8063,6813,2018-01-01,zipcode
ZCTA5 36609,01,24282,39778,802,143500,19498,7158,16746,1340,4099,6201,3186,1920,13394,11352,2042,11352,5097,6255,2018-01-01,zipcode
ZCTA5 36610,01,10646,22639,698,48800,8276,5111,6976,1590,2953,1852,437,144,5712,4100,1612,4100,2084,2016,2018-01-01,zipcode
ZCTA5 36611,01,5837,32855,898,75500,4035,1787,3364,604,1192,1082,307,179,2529,2049,480,2049,1124,925,2018-01-01,zipcode
ZCTA5 36612,01,4926,22531,731,59900,3468,1910,2738,627,1133,811,79,88,2023,1660,363,1660,782,878,2018-01-01,zipcode
ZCTA5 36613,01,13475,37911,837,99700,10480,5666,8613,1484,3443,2626,781,279,5102,4282,820,4282,3357,925,2018-01-01,zipcode
ZCTA5 36615,01,0,-666666666,-666666666,-666666666,0,0,0,0,0,0,0,0,0,0,0,0,0,0,2018-01-01,zipcode
ZCTA5 36616,01,8,-666666666,-666666666,-666666666,8,0,0,0,0,0,0,0,21,8,13,8,0,8,2018-01-01,zipcode
ZCTA5 36617,01,13386,27626,874,72800,10664,5566,9366,1463,3786,2643,917,557,6135,5053,1082,5053,2771,2282,2018-01-01,zipcode
ZCTA5 36618,01,17451,47049,858,110100,14050,6157,11739,1364,3970,3940,1423,1042,7291,6596,695,6596,5262,1334,2018-01-01,zipcode
ZCTA5 36619,01,15422,55516,878,130300,12162,5247,10662,1352,4157,3167,1508,478,6450,5725,725,5725,4510,1215,2018-01-01,zipcode
ZCTA5 36688,01,216,-666666666,-666666666,-666666666,216,135,0,0,0,0,0,0,0,0,0,0,0,0,2018-01-01,zipcode
ZCTA5 36693,01,20220,60667,941,151900,16599,6254,14444,801,3555,4901,3433,1754,8834,7893,941,7893,5136,2757,2018-01-01,zipcode
ZCTA5 36695,01,51088,69674,1032,182600,40219,14335,33514,2260,8139,10494,8424,4197,20327,18736,1591,18736,12650,6086,2018-01-01,zipcode
ZCTA5 36701,01,21301,34377,654,92700,16541,7744,14308,2390,4723,4571,1448,1176,11199,8832,2367,8832,5299,3533,2018-01-01,zipcode
ZCTA5 36703,01,13502,27030,608,76000,10512,4994,8506,1729,3387,2468,542,380,6036,5224,812,5224,2689,2535,2018-01-01,zipcode
ZCTA5 36720,01,1012,11875,780,-666666666,682,540,506,223,96,130,47,10,402,340,62,340,246,94,2018-01-01,zipcode
ZCTA5 36722,01,298,-666666666,-666666666,90000,263,117,239,38,124,60,17,0,237,141,96,141,84,57,2018-01-01,zipcode
ZCTA5 36723,01,219,-666666666,-666666666,-666666666,135,86,125,39,28,58,0,0,209,82,127,82,40,42,2018-01-01,zipcode
ZCTA5 36726,01,4884,33365,481,88200,3801,2118,3258,621,1414,793,325,105,2447,1709,738,1709,1009,700,2018-01-01,zipcode
ZCTA5 36727,01,6,-666666666,-666666666,-666666666,6,6,6,0,6,0,0,0,52,6,46,6,6,0,2018-01-01,zipcode
ZCTA5 36728,01,287,35556,-666666666,-666666666,275,135,246,76,90,59,14,7,225,136,89,136,106,30,2018-01-01,zipcode
ZCTA5 36732,01,8231,28750,493,133600,6510,3130,5425,681,1816,1745,699,484,4071,3258,813,3258,1953,1305,2018-01-01,zipcode
ZCTA5 36736,01,1371,36622,-666666666,71900,861,522,726,161,294,105,87,79,533,394,139,394,351,43,2018-01-01,zipcode
ZCTA5 36738,01,745,28654,-666666666,93600,690,488,574,110,286,130,37,11,338,250,88,250,228,22,2018-01-01,zipcode
ZCTA5 36740,01,1347,30750,574,54800,1069,641,976,198,321,322,123,12,907,433,474,433,363,70,2018-01-01,zipcode
ZCTA5 36742,01,1606,39219,807,105500,1518,769,1355,300,573,337,66,79,1098,735,363,735,589,146,2018-01-01,zipcode
ZCTA5 36744,01,6487,27600,470,85500,5205,2725,4325,656,1909,1134,436,190,3485,2619,866,2619,1561,1058,2018-01-01,zipcode
ZCTA5 36748,01,2707,37694,600,81200,2415,1388,2171,312,973,582,138,166,1583,1215,368,1215,853,362,2018-01-01,zipcode
ZCTA5 36749,01,779,37054,-666666666,97100,718,423,622,116,286,162,47,11,368,297,71,297,251,46,2018-01-01,zipcode
ZCTA5 36750,01,2538,52600,500,110000,2034,1011,1808,369,792,500,75,72,1185,988,197,988,722,266,2018-01-01,zipcode
ZCTA5 36751,01,585,-666666666,660,-666666666,412,268,342,242,72,9,11,8,279,216,63,216,170,46,2018-01-01,zipcode
ZCTA5 36752,01,1162,54167,-666666666,117400,978,417,867,114,219,376,103,55,681,498,183,498,448,50,2018-01-01,zipcode
ZCTA5 36753,01,8,-666666666,-666666666,-666666666,8,8,8,8,0,0,0,0,28,8,20,8,0,8,2018-01-01,zipcode
ZCTA5 36754,01,400,-666666666,-666666666,-666666666,367,169,315,129,117,64,0,5,234,170,64,170,120,50,2018-01-01,zipcode
ZCTA5 36756,01,5792,25483,600,80700,4959,3273,3382,746,1321,772,221,322,2552,1723,829,1723,1222,501,2018-01-01,zipcode
ZCTA5 36758,01,1355,39861,390,79600,1025,447,886,115,456,196,68,51,575,517,58,517,427,90,2018-01-01,zipcode
ZCTA5 36759,01,1805,32569,-666666666,62800,1485,829,1330,315,378,428,131,78,899,725,174,725,609,116,2018-01-01,zipcode
ZCTA5 36761,01,884,27292,826,59200,726,418,557,170,200,121,43,23,608,378,230,378,291,87,2018-01-01,zipcode
ZCTA5 36763,01,275,31250,-666666666,55000,148,97,138,67,29,33,5,4,87,71,16,71,57,14,2018-01-01,zipcode
ZCTA5 36765,01,1239,19342,1018,61400,1014,674,919,221,540,118,30,10,611,518,93,518,453,65,2018-01-01,zipcode
ZCTA5 36766,01,18,-666666666,-666666666,-666666666,18,14,18,10,0,2,5,1,21,16,5,16,11,5,2018-01-01,zipcode
ZCTA5 36767,01,1456,22938,504,43600,1235,720,1053,386,317,236,92,22,1050,686,364,686,496,190,2018-01-01,zipcode
ZCTA5 36768,01,898,19255,692,39700,816,530,645,130,214,192,61,48,674,347,327,347,278,69,2018-01-01,zipcode
ZCTA5 36769,01,2830,32326,563,72700,2349,1412,1941,340,900,440,189,72,1339,967,372,967,634,333,2018-01-01,zipcode
ZCTA5 36773,01,433,25441,606,105100,358,250,216,72,33,89,14,8,250,186,64,186,99,87,2018-01-01,zipcode
ZCTA5 36775,01,839,33465,647,54100,653,329,609,137,198,228,40,6,526,352,174,352,282,70,2018-01-01,zipcode
ZCTA5 36776,01,1694,29808,-666666666,94400,1390,751,1090,174,362,358,159,37,804,550,254,550,442,108,2018-01-01,zipcode
ZCTA5 36782,01,2691,38026,706,60800,2046,1138,1873,321,714,689,126,23,1325,992,333,992,859,133,2018-01-01,zipcode
ZCTA5 36783,01,678,23514,455,65000,595,374,565,56,296,133,38,42,601,342,259,342,286,56,2018-01-01,zipcode
ZCTA5 36784,01,7370,38108,532,126500,5977,3118,5202,957,2191,1227,624,203,3644,2856,788,2856,1712,1144,2018-01-01,zipcode
ZCTA5 36785,01,1039,24318,756,62300,878,519,781,182,287,214,84,14,731,532,199,532,407,125,2018-01-01,zipcode
ZCTA5 36786,01,2804,19141,484,53900,1885,1155,1715,382,687,344,211,91,1644,1024,620,1024,735,289,2018-01-01,zipcode
ZCTA5 36790,01,312,40227,-666666666,52300,253,117,171,45,91,35,0,0,118,118,0,118,83,35,2018-01-01,zipcode
ZCTA5 36792,01,1103,69253,-666666666,101000,946,495,854,64,402,328,22,38,678,453,225,453,375,78,2018-01-01,zipcode
ZCTA5 36793,01,229,26912,-666666666,58800,201,72,118,8,81,11,0,18,216,98,118,98,85,13,2018-01-01,zipcode
ZCTA5 36801,01,24840,40146,680,159900,19859,7489,17146,2097,5156,5182,2615,2096,11182,9963,1219,9963,5851,4112,2018-01-01,zipcode
ZCTA5 36804,01,18582,48596,790,106800,14562,5960,12616,1528,3783,4530,1907,868,7228,6861,367,6861,5290,1571,2018-01-01,zipcode
ZCTA5 36830,01,39078,53632,869,250500,31841,11779,22489,1288,2915,5530,6695,6061,17478,15294,2184,15294,7706,7588,2018-01-01,zipcode
ZCTA5 36832,01,24509,27638,851,99100,20930,8515,10796,1159,2025,3096,2846,1670,12766,9834,2932,9834,3877,5957,2018-01-01,zipcode
ZCTA5 36849,01,4108,-666666666,-666666666,-666666666,4108,3121,20,0,9,4,7,0,0,0,0,0,0,0,2018-01-01,zipcode
ZCTA5 36850,01,2654,33363,370,60000,2276,1163,1790,372,658,549,130,81,1400,1049,351,1049,854,195,2018-01-01,zipcode
ZCTA5 36852,01,2317,24847,745,111600,1756,863,1466,156,604,524,156,26,1033,826,207,826,625,201,2018-01-01,zipcode
ZCTA5 36853,01,7828,53470,796,157400,6681,3784,5887,983,1944,1380,986,594,5926,3258,2668,3258,2599,659,2018-01-01,zipcode
ZCTA5 36854,01,16045,44914,806,109400,12519,5026,10422,1397,3747,3545,1251,482,7500,6078,1422,6078,3929,2149,2018-01-01,zipcode
ZCTA5 36855,01,1543,44412,544,113700,1235,533,1096,259,402,250,113,72,746,578,168,578,470,108,2018-01-01,zipcode
ZCTA5 36856,01,7415,72715,1468,195600,5344,1928,4677,534,1059,1655,910,519,2631,2427,204,2427,2017,410,2018-01-01,zipcode
ZCTA5 36858,01,260,28889,611,90300,229,133,213,28,106,34,29,16,232,138,94,138,113,25,2018-01-01,zipcode
ZCTA5 36859,01,18,-666666666,-666666666,-666666666,18,18,18,18,0,0,0,0,8,8,0,8,8,0,2018-01-01,zipcode
ZCTA5 36860,01,1889,34872,530,62500,1561,937,1463,472,517,339,97,38,980,696,284,696,541,155,2018-01-01,zipcode
ZCTA5 36861,01,2817,46364,672,131300,2436,1110,2300,442,805,547,340,166,1939,1300,639,1300,1098,202,2018-01-01,zipcode
ZCTA5 36862,01,5882,33096,576,78300,4883,2517,4369,1051,1706,1221,226,165,2945,2469,476,2469,1656,813,2018-01-01,zipcode
ZCTA5 36863,01,11604,36884,671,96500,9640,4121,8162,1567,3186,2195,865,349,6080,4774,1306,4774,3317,1457,2018-01-01,zipcode
ZCTA5 36865,01,34,-666666666,-666666666,-666666666,28,17,22,0,15,6,1,0,20,13,7,13,13,0,2018-01-01,zipcode
ZCTA5 36866,01,3758,40164,601,74900,3058,1115,2760,391,1088,852,282,147,2039,1698,341,1698,1367,331,2018-01-01,zipcode
ZCTA5 36867,01,22983,43144,831,136800,18005,6058,15172,1954,4331,5495,2003,1389,10849,9394,1455,9394,4746,4648,2018-01-01,zipcode
ZCTA5 36869,01,21064,35156,769,107200,16357,7281,13556,2522,4589,4603,1032,810,9855,8060,1795,8060,4692,3368,2018-01-01,zipcode
ZCTA5 36870,01,21208,51257,844,136900,16298,6301,13650,1762,4159,5564,1290,875,8372,7443,929,7443,5375,2068,2018-01-01,zipcode
ZCTA5 36871,01,1478,35179,-666666666,90200,1258,706,1143,107,487,379,154,16,700,539,161,539,439,100,2018-01-01,zipcode
ZCTA5 36874,01,7511,53393,1053,157200,6082,2586,5275,434,1559,1858,776,648,3552,3029,523,3029,2606,423,2018-01-01,zipcode
ZCTA5 36875,01,3174,54081,880,126800,2756,1189,2621,305,926,993,261,136,1809,1462,347,1462,1100,362,2018-01-01,zipcode
ZCTA5 36877,01,13058,55221,860,145600,10379,3756,9018,1058,2543,3657,1122,638,5331,4803,528,4803,3338,1465,2018-01-01,zipcode
ZCTA5 36879,01,1936,81908,613,214100,1571,519,1385,132,352,331,272,298,885,742,143,742,630,112,2018-01-01,zipcode
ZCTA5 36901,01,327,23167,507,35600,327,208,293,33,212,48,0,0,205,182,23,182,110,72,2018-01-01,zipcode
ZCTA5 36904,01,3738,35632,505,97700,3064,1608,2636,362,1065,788,329,92,2036,1526,510,1526,1080,446,2018-01-01,zipcode
ZCTA5 36907,01,1515,26875,712,79700,1276,712,1045,127,407,191,196,124,916,702,214,702,576,126,2018-01-01,zipcode
ZCTA5 36908,01,2069,53371,320,83500,1704,990,1555,215,608,556,138,38,1093,795,298,795,713,82,2018-01-01,zipcode
ZCTA5 36910,01,21,-666666666,-666666666,-666666666,11,11,0,0,0,0,0,0,41,11,30,11,0,11,2018-01-01,zipcode
ZCTA5 36912,01,2272,31683,593,75600,1914,1068,1716,276,673,586,59,122,1253,911,342,911,683,228,2018-01-01,zipcode
ZCTA5 36913,01,19,-666666666,-666666666,-666666666,19,19,19,19,0,0,0,0,9,9,0,9,9,0,2018-01-01,zipcode
ZCTA5 36915,01,805,-666666666,-666666666,58500,587,285,456,45,159,141,64,47,404,282,122,282,170,112,2018-01-01,zipcode
ZCTA5 36916,01,846,32500,475,67200,726,497,686,210,236,173,11,56,544,376,168,376,323,53,2018-01-01,zipcode
ZCTA5 36919,01,1748,29254,507,55700,1435,919,1244,329,511,319,54,31,1004,725,279,725,604,121,2018-01-01,zipcode
ZCTA5 36921,01,819,25774,563,73500,733,403,634,144,218,162,101,9,519,373,146,373,355,18,2018-01-01,zipcode
ZCTA5 36922,01,375,37823,-666666666,63800,328,142,324,119,91,89,7,18,338,214,124,214,183,31,2018-01-01,zipcode
ZCTA5 36925,01,3520,28583,605,49100,2778,1397,2319,475,859,605,177,203,1588,1257,331,1257,849,408,2018-01-01,zipcode
ZCTA5 32003,12,28676,94154,1488,269600,23003,8112,19616,536,3994,6379,5688,3019,10969,10428,541,10428,8503,1925,2019-01-01,zipcode
ZCTA5 32008,12,4425,33663,665,93500,3541,1845,3258,529,1532,890,224,83,2818,1949,869,1949,1646,303,2019-01-01,zipcode
ZCTA5 32009,12,3661,68929,1308,157000,3023,912,2419,182,1131,804,244,58,1350,1238,112,1238,1123,115,2019-01-01,zipcode
ZCTA5 32011,12,14509,63772,794,172900,11784,4422,10233,1369,4566,2886,907,505,5896,5374,522,5374,4452,922,2019-01-01,zipcode
ZCTA5 32024,12,19452,56830,894,135400,15789,6704,13726,1766,5122,4481,1638,719,7860,6996,864,6996,5837,1159,2019-01-01,zipcode
ZCTA5 32025,12,23416,45114,867,118100,18927,10224,15546,2503,5615,5166,1549,713,9062,7756,1306,7756,4435,3321,2019-01-01,zipcode
ZCTA5 32026,12,2002,-666666666,-666666666,-666666666,2002,2002,1854,872,679,238,45,20,0,0,0,0,0,0,2019-01-01,zipcode
ZCTA5 32033,12,4676,59375,1435,180300,4203,2108,3590,399,1028,1295,534,334,1999,1803,196,1803,1489,314,2019-01-01,zipcode
ZCTA5 32034,12,36395,74668,1112,334200,31227,14819,28807,1497,6321,8300,7425,5264,20483,15707,4776,15707,12384,3323,2019-01-01,zipcode
ZCTA5 32038,12,10184,39879,776,107700,8380,4295,7455,906,2740,2828,638,343,4795,3944,851,3944,3235,709,2019-01-01,zipcode
ZCTA5 32040,12,7329,52528,827,117900,5451,2249,4714,712,2253,1124,489,136,2900,2495,405,2495,2076,419,2019-01-01,zipcode
ZCTA5 32043,12,26743,67661,1057,200900,21033,8542,18372,1932,6086,6394,2632,1328,10121,9305,816,9305,7057,2248,2019-01-01,zipcode
ZCTA5 32044,12,1711,44555,597,-666666666,1388,707,1223,241,506,354,91,31,941,747,194,747,577,170,2019-01-01,zipcode
ZCTA5 32046,12,9418,60649,913,150900,7603,3477,6556,931,2839,2172,461,153,3783,3410,373,3410,2593,817,2019-01-01,zipcode
ZCTA5 32052,12,9427,42738,598,83600,8191,5492,7102,2018,3399,1254,344,87,3182,2467,715,2467,1562,905,2019-01-01,zipcode
ZCTA5 32053,12,3538,36250,737,80000,2539,1476,2143,582,778,517,203,63,1793,1235,558,1235,944,291,2019-01-01,zipcode
ZCTA5 32054,12,11811,42851,617,120400,9702,6100,8499,1864,3279,2482,606,268,4000,3504,496,3504,2403,1101,2019-01-01,zipcode
ZCTA5 32055,12,16590,40000,797,122700,13102,6188,11512,1803,4343,3815,1043,508,6860,5960,900,5960,3991,1969,2019-01-01,zipcode
ZCTA5 32058,12,4368,41552,798,101100,3619,2128,2961,681,1410,696,111,63,1464,1218,246,1218,968,250,2019-01-01,zipcode
ZCTA5 32059,12,2418,43321,743,82800,1917,900,1758,363,659,599,96,41,1195,1003,192,1003,842,161,2019-01-01,zipcode
ZCTA5 32060,12,24064,49731,741,113600,18978,9627,16597,3028,6351,4765,1662,791,9868,7856,2012,7856,5911,1945,2019-01-01,zipcode
ZCTA5 32061,12,514,85375,-666666666,190100,433,173,300,95,132,47,26,0,144,122,22,122,87,35,2019-01-01,zipcode
ZCTA5 32062,12,1826,56683,-666666666,69600,1601,741,1418,160,717,323,75,143,999,625,374,625,599,26,2019-01-01,zipcode
ZCTA5 32063,12,13482,67009,814,163500,10710,5022,9388,859,3594,3377,905,653,5050,4404,646,4404,3054,1350,2019-01-01,zipcode
ZCTA5 32064,12,6890,47859,717,110600,5866,2377,4878,652,1491,1353,944,438,3248,2441,807,2441,1410,1031,2019-01-01,zipcode
ZCTA5 32065,12,37195,69923,1222,199000,28946,9868,24762,1878,7013,9010,4617,2244,13397,12585,812,12585,9433,3152,2019-01-01,zipcode
ZCTA5 32066,12,7420,49953,518,105000,6152,3868,5168,1389,1988,1246,191,354,2386,1770,616,1770,1490,280,2019-01-01,zipcode
ZCTA5 32068,12,57305,63486,1165,161900,45017,17137,38541,3392,14540,13695,5134,1780,21624,19670,1954,19670,15393,4277,2019-01-01,zipcode
ZCTA5 32071,12,3903,37424,641,104400,2929,1321,2525,479,919,852,238,37,1747,1359,388,1359,1007,352,2019-01-01,zipcode
ZCTA5 32072,12,211,88516,-666666666,67800,211,74,211,0,82,55,74,0,145,109,36,109,109,0,2019-01-01,zipcode
ZCTA5 32073,12,42520,60088,1098,173600,34399,12115,29525,2347,8158,11528,5143,2349,16290,15384,906,15384,9885,5499,2019-01-01,zipcode
ZCTA5 32079,12,451,41685,1404,91900,451,423,451,47,85,46,150,123,296,233,63,233,19,214,2019-01-01,zipcode
ZCTA5 32080,12,22261,75719,1201,374500,19664,9560,17511,601,3309,4659,5178,3764,15928,9736,6192,9736,7587,2149,2019-01-01,zipcode
ZCTA5 32081,12,14856,119105,1924,389900,11055,4286,9724,79,1278,2644,3281,2442,5859,4925,934,4925,4241,684,2019-01-01,zipcode
ZCTA5 32082,12,30539,111853,1420,527400,25791,10969,22808,544,2712,5067,9094,5391,15265,12631,2634,12631,10219,2412,2019-01-01,zipcode
ZCTA5 32083,12,4115,53966,749,113700,3692,3201,3454,890,1322,1055,129,58,631,540,91,540,321,219,2019-01-01,zipcode
ZCTA5 32084,12,35761,52592,1021,195400,30715,12618,25601,2558,8316,7437,4887,2403,16266,13015,3251,13015,8797,4218,2019-01-01,zipcode
ZCTA5 32086,12,29580,56069,1144,228400,25387,11139,22715,1569,5910,8640,4389,2207,13530,11607,1923,11607,8948,2659,2019-01-01,zipcode
ZCTA5 32087,12,7097,65345,677,75000,5644,3162,4660,1139,2110,1143,201,67,1838,1624,214,1624,1244,380,2019-01-01,zipcode
ZCTA5 32091,12,15256,42036,842,94600,11989,5591,10734,1794,4275,3688,708,269,6754,5645,1109,5645,3521,2124,2019-01-01,zipcode
ZCTA5 32092,12,37014,90055,1753,280400,28148,9899,25603,1647,5574,7318,6718,4346,14193,12477,1716,12477,10925,1552,2019-01-01,zipcode
ZCTA5 32094,12,2575,52500,882,76500,2351,1585,2185,322,1088,556,107,112,1286,958,328,958,850,108,2019-01-01,zipcode
ZCTA5 32095,12,11800,75016,1219,317200,8902,3378,7858,300,2016,2087,2160,1295,4442,4099,343,4099,3283,816,2019-01-01,zipcode
ZCTA5 32096,12,2186,40820,492,85500,1971,1158,1803,277,830,463,147,86,1336,1062,274,1062,775,287,2019-01-01,zipcode
ZCTA5 32097,12,19030,70263,1198,201900,14924,5242,12982,1319,4473,4154,2089,947,7426,6837,589,6837,5492,1345,2019-01-01,zipcode
ZCTA5 32102,12,2283,41250,1152,135600,2005,1133,1740,370,558,462,247,103,1744,1062,682,1062,894,168,2019-01-01,zipcode
ZCTA5 32110,12,8267,35609,769,126800,6840,3479,5988,942,2745,1546,546,209,3600,3013,587,3013,2008,1005,2019-01-01,zipcode
ZCTA5 32112,12,7646,35722,602,100500,5957,3240,5155,1638,1833,1171,361,152,4019,2947,1072,2947,2070,877,2019-01-01,zipcode
ZCTA5 32113,12,5216,36787,845,84700,4268,1943,3557,687,1575,1031,170,94,2551,1805,746,1805,1459,346,2019-01-01,zipcode
ZCTA5 32114,12,32847,29220,879,107400,27606,13318,21400,3296,6567,7492,2743,1302,16187,13466,2721,13466,4402,9064,2019-01-01,zipcode
ZCTA5 32117,12,26425,36915,971,104300,22023,9745,19326,2358,7318,6639,2090,921,12646,10674,1972,10674,5727,4947,2019-01-01,zipcode
ZCTA5 32118,12,17520,44200,969,234800,15788,8076,14693,1061,4050,4799,2994,1789,15393,9052,6341,9052,5588,3464,2019-01-01,zipcode
ZCTA5 32119,12,22344,40018,1062,145800,19545,9247,16537,1595,5662,5494,2433,1353,11744,10041,1703,10041,5907,4134,2019-01-01,zipcode
ZCTA5 32124,12,6117,64757,1770,225700,5379,3210,4796,1010,1503,987,722,574,1968,1781,187,1781,1380,401,2019-01-01,zipcode
ZCTA5 32127,12,30398,51178,1128,191900,25753,12304,23102,1695,7147,8309,3617,2334,16080,12814,3266,12814,9675,3139,2019-01-01,zipcode
ZCTA5 32128,12,21183,73890,1465,264100,17590,8376,15782,703,3423,5137,3981,2538,9380,8421,959,8421,6993,1428,2019-01-01,zipcode
ZCTA5 32129,12,22185,45208,1122,139600,19313,8177,16899,1812,5627,6140,2349,971,11075,9829,1246,9829,6652,3177,2019-01-01,zipcode
ZCTA5 32130,12,5703,50219,1038,175600,4750,2330,4184,605,1587,1169,528,295,2392,1990,402,1990,1609,381,2019-01-01,zipcode
ZCTA5 32131,12,4365,41431,836,130600,3583,2014,3346,594,1343,761,362,286,2096,1653,443,1653,1232,421,2019-01-01,zipcode
ZCTA5 32132,12,7570,46016,879,149000,6659,3219,6165,480,2300,2517,514,354,3733,3365,368,3365,2688,677,2019-01-01,zipcode
ZCTA5 32133,12,17,-666666666,-666666666,-666666666,17,8,17,0,0,17,0,0,59,8,51,8,8,0,2019-01-01,zipcode
ZCTA5 32134,12,7754,35087,728,79100,6462,4086,5825,933,2695,1621,350,226,5947,3117,2830,3117,2583,534,2019-01-01,zipcode
ZCTA5 32136,12,8306,51734,1153,265100,7440,4326,7128,341,1896,2487,1408,996,5606,3949,1657,3949,3255,694,2019-01-01,zipcode
ZCTA5 32137,12,43876,60637,1338,242400,38281,21400,34375,2338,11625,10352,6251,3809,22379,17198,5181,17198,13855,3343,2019-01-01,zipcode
ZCTA5 32139,12,971,31438,959,71000,811,537,760,260,287,145,45,23,721,430,291,430,359,71,2019-01-01,zipcode
ZCTA5 32140,12,1439,49219,915,61400,1325,527,1153,206,384,516,23,24,745,560,185,560,475,85,2019-01-01,zipcode
ZCTA5 32141,12,19031,52150,1116,161100,16145,8062,14652,1553,5957,4858,1327,957,8600,7605,995,7605,6072,1533,2019-01-01,zipcode
ZCTA5 32145,12,5723,43153,847,88800,4441,1996,3799,678,1410,1306,274,131,2322,1951,371,1951,1593,358,2019-01-01,zipcode
ZCTA5 32147,12,790,-666666666,-666666666,21800,587,164,427,58,146,50,173,0,258,214,44,214,167,47,2019-01-01,zipcode
ZCTA5 32148,12,10710,34563,707,59900,8191,4509,7139,1248,3541,1692,440,218,5562,4212,1350,4212,2991,1221,2019-01-01,zipcode
ZCTA5 32157,12,363,48500,838,145800,327,131,282,107,76,79,20,0,251,158,93,158,90,68,2019-01-01,zipcode
ZCTA5 32159,12,29920,45576,1040,186600,27446,18962,26337,1987,9421,8548,3541,2840,18915,15318,3597,15318,12422,2896,2019-01-01,zipcode
ZCTA5 32162,12,54951,63877,1454,271400,54244,47512,53979,1379,13458,16736,13333,9073,37211,30155,7056,30155,28752,1403,2019-01-01,zipcode
ZCTA5 32164,12,47341,53213,1281,199400,38831,17393,34569,2847,12053,12518,4575,2576,19092,16964,2128,16964,11972,4992,2019-01-01,zipcode
ZCTA5 32168,12,27679,54300,1076,217400,23946,12520,21750,1933,6411,7462,4196,1748,13936,11689,2247,11689,9089,2600,2019-01-01,zipcode
ZCTA5 32169,12,10228,69214,1335,367600,9529,5360,9096,355,1731,3256,2150,1604,11823,5415,6408,5415,4267,1148,2019-01-01,zipcode
ZCTA5 32174,12,51165,54513,1080,215300,44250,22187,40133,2789,11315,14460,7410,4159,25085,22481,2604,22481,17392,5089,2019-01-01,zipcode
ZCTA5 32176,12,14460,48153,1204,222900,13096,7057,12156,680,3273,4090,2325,1788,10528,7084,3444,7084,5424,1660,2019-01-01,zipcode
ZCTA5 32177,12,26845,36592,731,96300,21461,10718,18892,3069,8226,5286,1468,843,11694,10389,1305,10389,6514,3875,2019-01-01,zipcode
ZCTA5 32179,12,7919,34338,799,77300,6662,3629,5914,1018,2625,1493,444,334,4760,3254,1506,3254,2563,691,2019-01-01,zipcode
ZCTA5 32180,12,4535,49063,825,123000,3447,1647,2975,708,908,1017,247,95,1611,1415,196,1415,1211,204,2019-01-01,zipcode
ZCTA5 32181,12,2558,37011,778,92400,2001,1087,1570,233,608,458,179,92,1469,997,472,997,732,265,2019-01-01,zipcode
ZCTA5 32187,12,1871,36509,790,124200,1558,836,1470,251,585,517,77,40,770,724,46,724,541,183,2019-01-01,zipcode
ZCTA5 32189,12,5874,35860,822,70200,5042,2680,4542,869,1832,1434,349,58,4061,2631,1430,2631,2058,573,2019-01-01,zipcode
ZCTA5 32190,12,1309,43611,628,119600,1117,450,798,251,288,125,82,52,537,422,115,422,326,96,2019-01-01,zipcode
ZCTA5 32193,12,705,42083,707,115000,562,360,490,62,247,135,25,21,584,307,277,307,233,74,2019-01-01,zipcode
ZCTA5 32195,12,2926,40164,1439,129700,2616,1335,2284,313,916,806,144,105,1455,1215,240,1215,1034,181,2019-01-01,zipcode
ZCTA5 32202,12,6523,33967,612,117400,6105,4471,5093,1254,1461,1365,637,376,2422,1986,436,1986,219,1767,2019-01-01,zipcode
ZCTA5 32204,12,7547,45375,987,202400,6582,1921,5578,675,1139,1388,1491,885,4501,3815,686,3815,1035,2780,2019-01-01,zipcode
ZCTA5 32205,12,30305,46649,930,162800,24088,7503,21652,2621,5664,6909,3993,2465,14893,13020,1873,13020,6045,6975,2019-01-01,zipcode
ZCTA5 32206,12,16027,28952,783,81900,12915,5599,11234,2496,3793,3354,978,613,8975,6550,2425,6550,2812,3738,2019-01-01,zipcode
ZCTA5 32207,12,35488,50465,936,164500,27573,8722,24398,3927,5943,6553,4931,3044,16823,14599,2224,14599,7387,7212,2019-01-01,zipcode
ZCTA5 32208,12,30841,34565,945,78400,24599,11194,21490,3784,7829,7160,1915,802,14479,12334,2145,12334,6687,5647,2019-01-01,zipcode
ZCTA5 32209,12,34945,25499,779,59800,26250,12245,22620,4872,10238,5667,1356,487,16772,13167,3605,13167,5981,7186,2019-01-01,zipcode
ZCTA5 32210,12,62048,47047,969,128000,48144,16245,41874,5303,13595,14153,5987,2836,27014,23643,3371,23643,12387,11256,2019-01-01,zipcode
ZCTA5 32211,12,35657,43699,903,127600,26908,8605,22286,2796,7731,7834,2810,1115,14879,13312,1567,13312,6045,7267,2019-01-01,zipcode
ZCTA5 32212,12,2466,36827,1685,-666666666,1995,69,552,10,104,301,81,56,239,231,8,231,4,227,2019-01-01,zipcode
ZCTA5 32216,12,38231,53988,1049,158200,31272,10963,27450,2929,7521,8291,5990,2719,17727,15623,2104,15623,7298,8325,2019-01-01,zipcode
ZCTA5 32217,12,19899,46313,889,195800,16542,5583,14384,1092,3860,4100,3392,1940,9551,8671,880,8671,4335,4336,2019-01-01,zipcode
ZCTA5 32218,12,64007,57383,1100,169400,49621,17734,41430,4184,13516,14144,6718,2868,24699,22199,2500,22199,13623,8576,2019-01-01,zipcode
ZCTA5 32219,12,12685,49910,916,140900,10672,4279,8928,1148,3503,2938,753,586,4829,4335,494,4335,3590,745,2019-01-01,zipcode
ZCTA5 32220,12,12981,57405,972,144200,10174,3797,8896,1270,3626,2513,1047,440,5183,4703,480,4703,3907,796,2019-01-01,zipcode
ZCTA5 32221,12,30900,63900,1264,165300,23693,9020,20029,2799,6592,6532,3035,1071,10927,10274,653,10274,7667,2607,2019-01-01,zipcode
ZCTA5 32222,12,11521,63707,1119,193100,8791,2836,7601,536,1972,3639,1081,373,4775,3945,830,3945,2810,1135,2019-01-01,zipcode
ZCTA5 32223,12,24571,84905,1187,269100,20574,7025,18430,760,3657,6433,4617,2963,10219,9785,434,9785,8165,1620,2019-01-01,zipcode
ZCTA5 32224,12,44058,78639,1291,299000,35468,12229,27704,1537,5088,8291,8226,4562,17949,16089,1860,16089,9691,6398,2019-01-01,zipcode
ZCTA5 32225,12,55018,75758,1341,225500,43889,13546,37474,2144,9218,12339,9311,4462,22021,20210,1811,20210,13793,6417,2019-01-01,zipcode
ZCTA5 32226,12,15667,81396,1684,223100,12328,4313,10955,1016,3044,3445,2528,922,6470,5577,893,5577,4842,735,2019-01-01,zipcode
ZCTA5 32227,12,3337,59896,1644,-666666666,2502,264,892,18,199,491,104,80,560,413,147,413,5,408,2019-01-01,zipcode
ZCTA5 32228,12,470,-666666666,-666666666,-666666666,470,0,107,0,9,68,30,0,0,0,0,0,0,0,2019-01-01,zipcode
ZCTA5 32233,12,24979,63328,1191,270400,21208,6129,17926,1180,4638,5308,4376,2424,10986,9655,1331,9655,5619,4036,2019-01-01,zipcode
ZCTA5 32234,12,5867,59349,799,110700,4898,1885,4384,829,1892,1254,267,142,2548,2253,295,2253,1726,527,2019-01-01,zipcode
ZCTA5 32244,12,59402,54778,1083,133000,46049,14474,39713,4021,13022,14593,5998,2079,24450,21504,2946,21504,12565,8939,2019-01-01,zipcode
ZCTA5 32246,12,51589,60038,1201,182100,41946,11953,36701,2954,8982,12449,8757,3559,22777,20318,2459,20318,10688,9630,2019-01-01,zipcode
ZCTA5 32250,12,27246,88794,1426,366600,23028,7280,21032,1063,3193,5276,7256,4244,14676,12380,2296,12380,8581,3799,2019-01-01,zipcode
ZCTA5 32254,12,13431,33167,900,62000,9941,4369,8671,2064,3639,2350,441,177,5977,4763,1214,4763,2383,2380,2019-01-01,zipcode
ZCTA5 32256,12,47943,63779,1217,272200,40318,11846,34161,1496,5641,9886,10689,6449,23703,21443,2260,21443,8090,13353,2019-01-01,zipcode
ZCTA5 32257,12,39000,61036,1092,209800,31315,10119,27872,2218,6776,8613,6786,3479,16918,15541,1377,15541,9678,5863,2019-01-01,zipcode
ZCTA5 32258,12,34036,81632,1428,236700,26289,6809,23728,655,4433,7894,6765,3981,13981,12802,1179,12802,8776,4026,2019-01-01,zipcode
ZCTA5 32259,12,52296,118479,1846,349400,39330,13254,34026,601,5541,9305,12116,6463,17444,16519,925,16519,14246,2273,2019-01-01,zipcode
ZCTA5 32266,12,7101,90037,1372,401000,6028,1665,5141,102,618,1515,1782,1124,3490,3048,442,3048,2044,1004,2019-01-01,zipcode
ZCTA5 32277,12,32327,51188,986,166800,25743,8296,20984,1884,6588,7677,3488,1347,13293,12084,1209,12084,6155,5929,2019-01-01,zipcode
ZCTA5 32301,12,31317,45235,995,155200,26680,8373,18195,1362,3600,5619,4419,3195,15360,12813,2547,12813,3897,8916,2019-01-01,zipcode
ZCTA5 32303,12,48507,50726,1041,152000,40068,11203,31314,1827,6097,10474,8006,4910,22872,20680,2192,20680,10548,10132,2019-01-01,zipcode
ZCTA5 32304,12,49927,23638,944,91800,46650,18201,15162,2104,3523,4777,2511,2247,21697,17635,4062,17635,2177,15458,2019-01-01,zipcode
ZCTA5 32305,12,20902,40701,862,101600,16305,6268,13030,1972,4021,4307,1667,1063,9200,7723,1477,7723,4724,2999,2019-01-01,zipcode
ZCTA5 32308,12,22029,65949,1112,229900,18422,6160,16035,509,2217,3928,4661,4720,11275,10321,954,10321,5661,4660,2019-01-01,zipcode
ZCTA5 32309,12,31597,80902,1104,261400,25217,9409,21972,562,3084,5556,7053,5717,13049,12438,611,12438,10002,2436,2019-01-01,zipcode
ZCTA5 32310,12,15544,36127,890,98700,12692,5431,8817,1357,3247,2360,1276,577,7708,5621,2087,5621,2479,3142,2019-01-01,zipcode
ZCTA5 32311,12,22264,74244,1194,209700,18064,5619,15458,653,2807,4005,4287,3706,9411,8401,1010,8401,5299,3102,2019-01-01,zipcode
ZCTA5 32312,12,32783,100360,1329,302100,26136,9005,22161,514,2202,5295,7585,6565,13583,12544,1039,12544,10531,2013,2019-01-01,zipcode
ZCTA5 32317,12,14876,88306,1268,260300,11682,3998,10062,298,1939,2386,3187,2252,5842,5474,368,5474,4874,600,2019-01-01,zipcode
ZCTA5 32320,12,3887,49292,697,154800,3156,1320,2821,643,888,802,295,193,2050,1519,531,1519,1024,495,2019-01-01,zipcode
ZCTA5 32321,12,6321,35822,627,63800,5520,3815,4463,980,2063,932,263,225,2514,1630,884,1630,1209,421,2019-01-01,zipcode
ZCTA5 32322,12,3994,38533,757,150600,3534,2649,3271,721,1290,831,276,153,1969,1142,827,1142,900,242,2019-01-01,zipcode
ZCTA5 32323,12,137,-666666666,-666666666,-666666666,137,114,137,23,44,30,18,22,421,91,330,91,67,24,2019-01-01,zipcode
ZCTA5 32324,12,4716,33505,756,67900,4088,2669,3588,897,1435,962,199,95,2128,1757,371,1757,1166,591,2019-01-01,zipcode
ZCTA5 32327,12,28525,64308,903,149600,23395,10644,20444,2475,7504,6774,2406,1285,11087,9578,1509,9578,7808,1770,2019-01-01,zipcode
ZCTA5 32328,12,3415,45625,855,180400,2866,1247,2516,334,829,730,379,244,3149,1423,1726,1423,1111,312,2019-01-01,zipcode
ZCTA5 32330,12,651,34836,840,75200,443,228,416,110,170,93,30,13,298,229,69,229,131,98,2019-01-01,zipcode
ZCTA5 32331,12,4193,38990,684,73100,3419,1761,2961,545,1265,673,323,155,2005,1593,412,1593,1280,313,2019-01-01,zipcode
ZCTA5 32332,12,1077,26094,612,72900,868,474,734,170,324,153,71,16,616,473,143,473,293,180,2019-01-01,zipcode
ZCTA5 32333,12,11314,48340,455,117700,9700,4665,8542,1654,2799,2316,1133,640,5670,4828,842,4828,3818,1010,2019-01-01,zipcode
ZCTA5 32334,12,2024,39596,581,117900,1673,857,1499,131,668,330,287,83,1107,829,278,829,646,183,2019-01-01,zipcode
ZCTA5 32336,12,1128,36500,-666666666,111100,861,422,821,113,324,236,88,60,845,462,383,462,399,63,2019-01-01,zipcode
ZCTA5 32340,12,11374,34629,658,98200,9608,5836,8430,1655,3371,2131,770,503,4929,3885,1044,3885,2660,1225,2019-01-01,zipcode
ZCTA5 32343,12,3221,59625,959,147700,2337,498,2052,247,676,614,263,252,1366,1237,129,1237,942,295,2019-01-01,zipcode
ZCTA5 32344,12,12356,43880,782,148400,10632,5917,9681,1813,3329,2358,1350,831,5929,5047,882,5047,3817,1230,2019-01-01,zipcode
ZCTA5 32346,12,1933,48669,1579,116400,1577,691,1486,260,456,508,230,32,1725,924,801,924,748,176,2019-01-01,zipcode
ZCTA5 32347,12,7609,49397,626,97500,5877,2765,5229,621,2049,1935,442,182,3696,2950,746,2950,2400,550,2019-01-01,zipcode
ZCTA5 32348,12,12935,36425,739,71100,10978,7628,9667,2584,4335,2057,436,255,4920,3755,1165,3755,2789,966,2019-01-01,zipcode
ZCTA5 32350,12,1272,39255,695,107500,1130,671,1078,123,390,420,123,22,756,629,127,629,515,114,2019-01-01,zipcode
ZCTA5 32351,12,18720,37467,656,84300,14268,7919,12329,2859,4392,3309,1164,605,7388,6245,1143,6245,4290,1955,2019-01-01,zipcode
ZCTA5 32352,12,6246,47019,681,107500,5039,2162,4490,548,1843,1365,520,214,2827,2380,447,2380,1869,511,2019-01-01,zipcode
ZCTA5 32355,12,244,35833,933,170800,213,111,197,18,66,77,29,7,199,124,75,124,86,38,2019-01-01,zipcode
ZCTA5 32356,12,0,-666666666,-666666666,-666666666,0,0,0,0,0,0,0,0,22,0,22,0,0,0,2019-01-01,zipcode
ZCTA5 32358,12,2021,54797,840,115200,1643,768,1611,155,528,499,297,132,1612,851,761,851,758,93,2019-01-01,zipcode
ZCTA5 32359,12,1271,33667,-666666666,108800,1190,787,1150,226,671,204,18,31,2487,704,1783,704,480,224,2019-01-01,zipcode
ZCTA5 32361,12,383,58458,-666666666,84100,279,124,273,30,89,134,20,0,191,161,30,161,148,13,2019-01-01,zipcode
ZCTA5 32399,12,0,-666666666,-666666666,-666666666,0,0,0,0,0,0,0,0,0,0,0,0,0,0,2019-01-01,zipcode
ZCTA5 32401,12,22027,39447,883,126900,17976,7713,15735,2468,5291,5071,1777,1128,11077,9333,1744,9333,4668,4665,2019-01-01,zipcode
ZCTA5 32403,12,2779,64132,1639,-666666666,1801,463,1132,19,134,379,408,192,817,641,176,641,0,641,2019-01-01,zipcode
ZCTA5 32404,12,39503,53662,975,157400,31340,12220,27074,3060,9250,10834,2437,1493,17026,14263,2763,14263,9810,4453,2019-01-01,zipcode
ZCTA5 32405,12,32239,50749,1000,177100,25750,10017,22621,1752,7403,7597,3573,2296,14648,12846,1802,12846,7526,5320,2019-01-01,zipcode
ZCTA5 32407,12,10822,63022,1363,222000,9333,3040,8099,533,2140,3034,1568,824,8338,4760,3578,4760,2526,2234,2019-01-01,zipcode
ZCTA5 32408,12,18864,57643,1127,238600,15550,5195,13527,793,3727,4600,3022,1385,17565,7970,9595,7970,5239,2731,2019-01-01,zipcode
ZCTA5 32409,12,10144,60269,685,163300,8147,3352,7129,937,2418,2844,658,272,4363,3743,620,3743,3156,587,2019-01-01,zipcode
ZCTA5 32410,12,964,63523,1356,248700,944,494,898,28,171,340,190,169,1486,499,987,499,371,128,2019-01-01,zipcode
ZCTA5 32413,12,14805,67103,1111,256000,12876,5378,11997,805,3276,3927,2796,1193,18042,6554,11488,6554,4881,1673,2019-01-01,zipcode
ZCTA5 32420,12,1958,32353,689,82300,1668,961,1512,373,567,440,80,52,1209,896,313,896,787,109,2019-01-01,zipcode
ZCTA5 32421,12,4834,36857,604,77800,3885,1851,3405,713,1325,1020,275,72,2044,1605,439,1605,1332,273,2019-01-01,zipcode
ZCTA5 32423,12,966,65288,-666666666,94200,829,419,770,62,218,370,98,22,517,430,87,430,372,58,2019-01-01,zipcode
ZCTA5 32424,12,7514,38447,594,91800,6180,3978,5603,1477,2378,1204,361,183,2924,2177,747,2177,1725,452,2019-01-01,zipcode
ZCTA5 32425,12,13586,37296,695,91800,11129,6513,9786,2260,3821,2754,739,212,5803,4692,1111,4692,3425,1267,2019-01-01,zipcode
ZCTA5 32426,12,814,30341,813,81700,689,381,556,152,259,97,28,20,444,319,125,319,275,44,2019-01-01,zipcode
ZCTA5 32427,12,1034,31227,625,89800,927,497,751,205,285,152,53,56,523,464,59,464,345,119,2019-01-01,zipcode
ZCTA5 32428,12,17564,38308,773,120100,14566,8359,12876,2322,5003,3723,1265,563,7224,5872,1352,5872,4559,1313,2019-01-01,zipcode
ZCTA5 32430,12,1173,40357,-666666666,75400,982,419,862,148,341,297,76,0,575,440,135,440,360,80,2019-01-01,zipcode
ZCTA5 32431,12,4145,43393,673,102500,3382,1664,2948,640,1215,781,211,101,2237,1733,504,1733,1287,446,2019-01-01,zipcode
ZCTA5 32432,12,0,-666666666,-666666666,-666666666,0,0,0,0,0,0,0,0,0,0,0,0,0,0,2019-01-01,zipcode
ZCTA5 32433,12,17877,40737,808,100800,14142,6893,12544,2424,4779,3902,957,482,7612,6395,1217,6395,4510,1885,2019-01-01,zipcode
ZCTA5 32435,12,7494,44150,725,136900,6124,2354,5269,688,2057,1492,657,375,3795,2971,824,2971,2166,805,2019-01-01,zipcode
ZCTA5 32437,12,843,26250,550,92700,583,273,542,89,271,175,6,1,399,330,69,330,216,114,2019-01-01,zipcode
ZCTA5 32438,12,3822,30380,467,76100,3356,1932,2916,498,1548,760,86,24,2000,1517,483,1517,1383,134,2019-01-01,zipcode
ZCTA5 32439,12,10413,54901,1023,208100,8322,2713,7193,670,2305,2485,1199,534,4906,3995,911,3995,2872,1123,2019-01-01,zipcode
ZCTA5 32440,12,7777,44080,655,105400,6918,4109,5848,1275,2413,1427,471,262,2555,2102,453,2102,1444,658,2019-01-01,zipcode
ZCTA5 32442,12,3299,36111,608,143600,2606,1142,2359,550,949,613,149,98,1800,1486,314,1486,1040,446,2019-01-01,zipcode
ZCTA5 32443,12,3165,39716,675,88400,2471,1269,2199,410,812,667,180,130,1656,1229,427,1229,981,248,2019-01-01,zipcode
ZCTA5 32444,12,22163,72021,1196,213400,17473,5829,14753,542,3516,5255,3359,2081,9099,8033,1066,8033,5882,2151,2019-01-01,zipcode
ZCTA5 32445,12,2497,34638,675,96700,2209,1735,1956,648,837,376,81,14,632,501,131,501,316,185,2019-01-01,zipcode
ZCTA5 32446,12,11115,49087,743,137000,9434,4672,8033,1073,2564,2877,834,685,4781,4016,765,4016,2604,1412,2019-01-01,zipcode
ZCTA5 32447,12,159,-666666666,-666666666,-666666666,88,88,0,0,0,0,0,0,0,0,0,0,0,0,2019-01-01,zipcode
ZCTA5 32448,12,8405,27059,461,85400,6706,3061,6056,847,2564,1932,373,340,4540,3871,669,3871,2445,1426,2019-01-01,zipcode
ZCTA5 32449,12,552,51898,-666666666,73100,393,185,365,64,146,155,0,0,247,161,86,161,153,8,2019-01-01,zipcode
ZCTA5 32455,12,4081,44688,690,86500,3468,1600,2985,791,1294,658,150,92,2260,1641,619,1641,1324,317,2019-01-01,zipcode
ZCTA5 32456,12,8036,53713,1150,208900,6624,2836,5912,455,1701,1987,954,815,6307,3339,2968,3339,2402,937,2019-01-01,zipcode
ZCTA5 32459,12,17213,81766,1605,378200,14161,5415,13013,473,2500,4396,3982,1662,14882,7224,7658,7224,5663,1561,2019-01-01,zipcode
ZCTA5 32460,12,5690,39564,659,89400,4923,3552,4390,1061,1836,1168,218,107,1798,1483,315,1483,1094,389,2019-01-01,zipcode
ZCTA5 32461,12,36,-666666666,-666666666,-666666666,36,11,36,0,0,0,36,0,178,25,153,25,25,0,2019-01-01,zipcode
ZCTA5 32462,12,3488,38542,667,98800,2960,1305,2533,368,1181,782,144,58,1845,1423,422,1423,1111,312,2019-01-01,zipcode
ZCTA5 32463,12,216,44167,637,81100,170,59,134,26,35,73,0,0,88,88,0,88,34,54,2019-01-01,zipcode
ZCTA5 32464,12,4367,43010,675,103000,3661,1797,3229,719,1225,845,282,158,2303,1857,446,1857,1682,175,2019-01-01,zipcode
ZCTA5 32465,12,7962,39939,775,90900,7103,4615,6376,1316,2659,1785,456,160,3630,2599,1031,2599,1983,616,2019-01-01,zipcode
ZCTA5 32466,12,5795,56033,940,117200,4556,2079,3966,694,1340,1663,173,96,2440,1940,500,1940,1665,275,2019-01-01,zipcode
ZCTA5 32501,12,11134,29422,728,135200,8790,4572,7665,1264,2201,2265,1173,762,5329,4324,1005,4324,2105,2219,2019-01-01,zipcode
ZCTA5 32502,12,3331,53306,1004,160500,2715,927,2487,226,591,835,442,393,1794,1535,259,1535,837,698,2019-01-01,zipcode
ZCTA5 32503,12,34233,50032,913,171200,28124,10786,20497,1535,4678,7325,3991,2968,13636,12086,1550,12086,7475,4611,2019-01-01,zipcode
ZCTA5 32504,12,22562,52824,982,172600,16925,6201,14112,796,3281,4751,2995,2289,9808,8950,858,8950,5312,3638,2019-01-01,zipcode
ZCTA5 32505,12,26354,37789,898,66000,21142,8934,18822,2902,7585,6158,1487,690,13403,11027,2376,11027,5199,5828,2019-01-01,zipcode
ZCTA5 32506,12,36664,50275,1052,123600,29220,11530,25160,2912,6372,10458,3602,1816,16139,14210,1929,14210,8062,6148,2019-01-01,zipcode
ZCTA5 32507,12,31036,48939,959,155600,25282,9734,21357,1839,4969,8343,3887,2319,17739,12914,4825,12914,7514,5400,2019-01-01,zipcode
ZCTA5 32508,12,5383,44107,1328,-666666666,5062,470,1013,11,137,446,353,66,657,545,112,545,0,545,2019-01-01,zipcode
ZCTA5 32509,12,675,-666666666,-666666666,-666666666,675,675,675,49,223,297,26,80,0,0,0,0,0,0,2019-01-01,zipcode
ZCTA5 32511,12,1034,-666666666,-666666666,-666666666,1034,49,109,0,19,64,26,0,0,0,0,0,0,0,2019-01-01,zipcode
ZCTA5 32514,12,42444,49889,1021,145400,34520,12625,27295,2770,6335,9138,6110,2942,18675,16570,2105,16570,8131,8439,2019-01-01,zipcode
ZCTA5 32526,12,37470,60007,1076,134500,30978,12399,27417,2123,7778,10979,4479,2058,16393,14638,1755,14638,11258,3380,2019-01-01,zipcode
ZCTA5 32530,12,40,-666666666,-666666666,-666666666,20,0,20,0,0,20,0,0,7,7,0,7,7,0,2019-01-01,zipcode
ZCTA5 32531,12,5526,57424,991,178100,4517,2017,4175,400,1673,1456,419,227,2688,2206,482,2206,1870,336,2019-01-01,zipcode
ZCTA5 32533,12,29713,75173,1058,171000,23820,9395,20822,1539,5900,7521,4010,1852,11771,10755,1016,10755,9228,1527,2019-01-01,zipcode
ZCTA5 32534,12,14742,50407,1067,119600,12544,4717,10943,641,3230,4685,1712,675,7010,6437,573,6437,4479,1958,2019-01-01,zipcode
ZCTA5 32535,12,6094,42663,722,79200,5405,3447,4857,909,2096,1419,290,143,2119,1837,282,1837,1238,599,2019-01-01,zipcode
ZCTA5 32536,12,24105,70651,1084,198500,18297,6560,15020,1324,3670,5994,2615,1417,9417,8466,951,8466,5391,3075,2019-01-01,zipcode
ZCTA5 32539,12,30131,59712,986,168300,22860,10298,19676,2143,6482,7477,2609,965,10746,9495,1251,9495,6747,2748,2019-01-01,zipcode
ZCTA5 32541,12,19066,80469,1554,368000,15919,5138,14247,596,2711,4601,3890,2449,16749,8174,8575,8174,5254,2920,2019-01-01,zipcode
ZCTA5 32542,12,3128,45391,1472,-666666666,2361,220,1157,9,181,536,334,97,1038,738,300,738,0,738,2019-01-01,zipcode
ZCTA5 32544,12,1962,38750,1440,-666666666,1464,120,623,7,109,307,176,24,367,304,63,304,0,304,2019-01-01,zipcode
ZCTA5 32547,12,34330,52714,1051,182700,28529,10201,24899,2435,6663,8836,4719,2246,16151,14819,1332,14819,7134,7685,2019-01-01,zipcode
ZCTA5 32548,12,21708,54776,1022,182000,18320,6270,16162,1185,4122,6571,2548,1736,13332,9643,3689,9643,5585,4058,2019-01-01,zipcode
ZCTA5 32550,12,7978,69410,1201,396500,6949,3204,6355,148,880,2155,1863,1309,13359,3628,9731,3628,2594,1034,2019-01-01,zipcode
ZCTA5 32561,12,9925,102517,1500,419100,8053,3174,7399,267,934,2036,2237,1925,6516,4203,2313,4203,3465,738,2019-01-01,zipcode
ZCTA5 32563,12,25912,72045,1282,243000,20715,7512,18525,837,4051,6444,4439,2754,11047,10208,839,10208,7732,2476,2019-01-01,zipcode
ZCTA5 32564,12,2959,72143,1191,169000,2254,936,2186,217,632,951,309,77,1148,1012,136,1012,846,166,2019-01-01,zipcode
ZCTA5 32565,12,5014,51324,948,120600,4270,1920,3749,296,1419,1363,530,141,2438,2072,366,2072,1604,468,2019-01-01,zipcode
ZCTA5 32566,12,40232,77584,1360,237100,31466,11943,26915,1603,6335,11381,4769,2827,17714,14632,3082,14632,11684,2948,2019-01-01,zipcode
ZCTA5 32567,12,3099,46950,732,120700,2430,1033,2211,313,771,890,149,88,1622,1289,333,1289,1038,251,2019-01-01,zipcode
ZCTA5 32568,12,2853,53486,682,156400,2357,988,2148,275,847,766,123,137,1293,1115,178,1115,956,159,2019-01-01,zipcode
ZCTA5 32569,12,12657,61551,1091,191700,10462,3051,8878,719,2256,3381,1751,771,5384,4873,511,4873,3346,1527,2019-01-01,zipcode
ZCTA5 32570,12,31341,57981,965,144500,25177,10418,21799,1933,6657,8840,3192,1177,13482,11949,1533,11949,7981,3968,2019-01-01,zipcode
ZCTA5 32571,12,35520,72496,1009,186700,27872,10249,23598,1648,6311,8309,4854,2476,13824,12753,1071,12753,10017,2736,2019-01-01,zipcode
ZCTA5 32577,12,4390,56543,644,139200,3647,1583,3201,262,910,1295,488,246,1951,1762,189,1762,1511,251,2019-01-01,zipcode
ZCTA5 32578,12,33130,85497,1275,283800,25909,9427,22735,857,3741,7857,5812,4468,13468,12384,1084,12384,9429,2955,2019-01-01,zipcode
ZCTA5 32579,12,10338,76639,1193,287000,8748,3748,7640,514,1580,2229,1905,1412,4640,4349,291,4349,2967,1382,2019-01-01,zipcode
ZCTA5 32580,12,4491,64009,1154,224800,3367,1203,2832,182,677,1269,437,267,1927,1533,394,1533,953,580,2019-01-01,zipcode
ZCTA5 32583,12,29365,60805,1033,141800,25045,13028,21969,4008,7181,6930,2681,1169,9991,8843,1148,8843,6772,2071,2019-01-01,zipcode
ZCTA5 32601,12,19363,25673,881,159600,17888,6678,9596,539,1885,2729,2315,2128,9978,7907,2071,7907,2036,5871,2019-01-01,zipcode
ZCTA5 32603,12,6949,20660,851,290000,6668,3892,1415,45,94,188,391,697,2311,1732,579,1732,244,1488,2019-01-01,zipcode
ZCTA5 32605,12,25556,69707,1251,193200,21309,7465,18309,845,2986,4612,4783,5083,11409,10248,1161,10248,7263,2985,2019-01-01,zipcode
ZCTA5 32606,12,23442,69974,1210,214000,18597,6433,16092,417,2095,3883,4374,5323,11064,9456,1608,9456,4822,4634,2019-01-01,zipcode
ZCTA5 32607,12,30214,39905,950,216700,26328,9719,15501,853,3064,4361,3552,3671,15299,11802,3497,11802,3979,7823,2019-01-01,zipcode
ZCTA5 32608,12,49659,45887,1036,240300,42226,16155,29321,1728,4111,6822,8109,8551,23763,19118,4645,19118,8112,11006,2019-01-01,zipcode
ZCTA5 32609,12,20105,34826,868,101100,16547,6796,13848,2210,4043,4620,1892,1083,8491,7153,1338,7153,3993,3160,2019-01-01,zipcode
ZCTA5 32612,12,7164,-666666666,-666666666,-666666666,7164,5733,30,0,7,17,1,5,5,5,0,5,0,5,2019-01-01,zipcode
ZCTA5 32615,12,13635,63043,1001,189300,10775,3838,9532,440,2359,3167,2179,1387,6123,5244,879,5244,4103,1141,2019-01-01,zipcode
ZCTA5 32616,12,1235,26528,747,87400,905,385,823,160,403,191,43,26,395,378,17,378,214,164,2019-01-01,zipcode
ZCTA5 32617,12,4541,44701,622,157500,3825,1689,3245,333,1412,1070,293,137,1869,1707,162,1707,1345,362,2019-01-01,zipcode
ZCTA5 32618,12,8264,54219,762,161600,6671,2628,5496,797,1627,1665,698,709,3316,2832,484,2832,2343,489,2019-01-01,zipcode
ZCTA5 32619,12,5639,44328,760,93300,4393,2045,3630,526,1408,1201,347,148,2420,1979,441,1979,1676,303,2019-01-01,zipcode
ZCTA5 32621,12,4946,36389,643,81000,4105,2174,3526,710,1442,970,336,68,2315,1976,339,1976,1464,512,2019-01-01,zipcode
ZCTA5 32622,12,1032,43400,1014,116300,831,394,814,189,267,191,79,88,535,422,113,422,321,101,2019-01-01,zipcode
ZCTA5 32625,12,1686,40563,770,179000,1251,545,1127,61,451,331,117,167,1203,629,574,629,458,171,2019-01-01,zipcode
ZCTA5 32626,12,8782,35572,727,97100,7210,3676,6350,915,2657,2047,520,211,4547,3613,934,3613,2784,829,2019-01-01,zipcode
ZCTA5 32628,12,5380,39263,706,72800,4521,3042,3964,833,1864,892,284,91,1892,1537,355,1537,1137,400,2019-01-01,zipcode
ZCTA5 32631,12,155,65449,-666666666,271200,142,68,142,0,15,60,45,22,102,102,0,102,102,0,2019-01-01,zipcode
ZCTA5 32639,12,194,38011,-666666666,-666666666,155,87,155,26,99,0,0,30,209,97,112,97,86,11,2019-01-01,zipcode
ZCTA5 32640,12,11299,47103,728,109900,9559,4949,8519,1272,3083,2674,764,726,5725,4393,1332,4393,3611,782,2019-01-01,zipcode
ZCTA5 32641,12,14959,37540,863,95800,11674,5289,10037,1680,3713,3208,968,468,5721,4749,972,4749,2841,1908,2019-01-01,zipcode
ZCTA5 32643,12,11666,56171,728,168900,9823,4509,8648,1014,2488,3162,1189,795,5098,4558,540,4558,3862,696,2019-01-01,zipcode
ZCTA5 32648,12,392,61442,-666666666,-666666666,342,159,291,57,123,91,13,7,582,169,413,169,166,3,2019-01-01,zipcode
ZCTA5 32653,12,14030,66471,935,199100,11499,4793,10158,438,1958,2939,2477,2346,6368,5974,394,5974,4625,1349,2019-01-01,zipcode
ZCTA5 32656,12,15150,50063,863,125300,12242,5527,10612,1333,3798,3808,1207,466,6610,5533,1077,5533,4359,1174,2019-01-01,zipcode
ZCTA5 32658,12,375,51875,-666666666,98500,322,151,295,56,115,93,31,0,116,98,18,98,85,13,2019-01-01,zipcode
ZCTA5 32664,12,391,51875,893,156300,334,175,317,29,101,83,65,39,223,181,42,181,132,49,2019-01-01,zipcode
ZCTA5 32666,12,6664,47457,826,141000,5822,3104,5035,534,1925,1656,404,516,3714,2745,969,2745,2289,456,2019-01-01,zipcode
ZCTA5 32667,12,4352,58892,774,262500,3689,1607,3130,95,790,959,672,614,2168,1811,357,1811,1314,497,2019-01-01,zipcode
ZCTA5 32668,12,4678,41438,1039,149200,4235,2362,3918,562,1662,1216,311,167,2603,2031,572,2031,1755,276,2019-01-01,zipcode
ZCTA5 32669,12,14037,70356,980,215200,10638,3572,9517,375,2249,3269,2237,1387,5552,4967,585,4967,4193,774,2019-01-01,zipcode
ZCTA5 32680,12,10139,38496,591,74500,8522,5114,7701,1683,3189,1984,505,340,5826,4424,1402,4424,3501,923,2019-01-01,zipcode
ZCTA5 32681,12,31,-666666666,-666666666,-666666666,31,31,31,0,31,0,0,0,16,16,0,16,16,0,2019-01-01,zipcode
ZCTA5 32683,12,268,-666666666,-666666666,-666666666,148,106,148,10,108,30,0,0,75,65,10,65,59,6,2019-01-01,zipcode
ZCTA5 32686,12,4737,35910,668,169400,3992,2026,3455,785,1138,781,418,333,2484,2011,473,2011,1422,589,2019-01-01,zipcode
ZCTA5 32692,12,160,-666666666,-666666666,91900,128,39,128,35,26,54,13,0,611,68,543,68,68,0,2019-01-01,zipcode
ZCTA5 32693,12,11882,38060,689,94200,9910,5314,8148,1318,3266,2562,691,311,5113,4323,790,4323,3386,937,2019-01-01,zipcode
ZCTA5 32694,12,2023,47917,559,127700,1563,556,1283,102,531,407,188,55,1002,738,264,738,519,219,2019-01-01,zipcode
ZCTA5 32696,12,12436,45457,731,128500,9885,4644,8770,1337,3622,2609,708,494,5403,4620,783,4620,3576,1044,2019-01-01,zipcode
ZCTA5 32697,12,253,38036,825,-666666666,178,72,120,42,47,27,2,2,160,99,61,99,15,84,2019-01-01,zipcode
ZCTA5 32701,12,22940,55137,1144,175800,19120,6391,17202,922,3697,6638,4196,1749,11391,9910,1481,9910,4960,4950,2019-01-01,zipcode
ZCTA5 32702,12,2796,44470,2463,58900,2304,1412,2068,392,766,555,222,133,1544,1160,384,1160,768,392,2019-01-01,zipcode
ZCTA5 32703,12,53763,51257,1129,189900,41993,14918,36004,5385,10478,10881,6857,2403,20093,18259,1834,18259,11676,6583,2019-01-01,zipcode
ZCTA5 32707,12,36036,54941,1178,181900,30628,11604,26850,1902,6405,10199,6089,2255,16493,14857,1636,14857,9539,5318,2019-01-01,zipcode
ZCTA5 32708,12,45323,70469,1309,249500,37536,13731,33080,1688,6238,10683,9601,4870,18851,17697,1154,17697,13156,4541,2019-01-01,zipcode
ZCTA5 32709,12,1832,54911,-666666666,191500,1663,667,1516,70,645,509,224,68,794,727,67,727,660,67,2019-01-01,zipcode
ZCTA5 32712,12,48151,79252,1415,243500,37897,12714,33106,4434,8784,10633,5848,3407,17318,15790,1528,15790,12613,3177,2019-01-01,zipcode
ZCTA5 32713,12,20892,63594,1131,208000,17420,7792,15798,860,5237,5397,3087,1217,9260,8324,936,8324,6722,1602,2019-01-01,zipcode
ZCTA5 32714,12,37981,52626,1211,200300,31436,9884,27620,1776,6165,9433,7202,3044,17146,15450,1696,15450,7092,8358,2019-01-01,zipcode
ZCTA5 32720,12,32421,49195,928,191800,27311,13404,22968,2011,7305,7958,3712,1982,13803,12493,1310,12493,8476,4017,2019-01-01,zipcode
ZCTA5 32724,12,36961,49722,1006,175000,31114,15284,26442,2261,7776,9530,4610,2265,16165,14711,1454,14711,10361,4350,2019-01-01,zipcode
ZCTA5 32725,12,49923,52577,1185,160000,40061,17138,34623,4171,11054,13335,4400,1663,18806,16949,1857,16949,13099,3850,2019-01-01,zipcode
ZCTA5 32726,12,22485,45405,872,155700,17831,7628,15646,2415,5685,4518,2187,841,9466,8489,977,8489,5313,3176,2019-01-01,zipcode
ZCTA5 32730,12,5943,45288,1135,156700,5203,2173,4627,251,1134,1978,869,395,2901,2639,262,2639,941,1698,2019-01-01,zipcode
ZCTA5 32732,12,4576,79087,-666666666,317700,3949,1368,3458,125,826,1460,745,302,2170,1757,413,1757,1703,54,2019-01-01,zipcode
ZCTA5 32735,12,4728,57680,1157,137000,3913,2085,3721,439,1131,1228,672,251,2192,2106,86,2106,1792,314,2019-01-01,zipcode
ZCTA5 32736,12,10848,79327,1032,272100,8682,3570,7674,636,2108,2762,1421,747,4284,3649,635,3649,3331,318,2019-01-01,zipcode
ZCTA5 32738,12,45611,53961,1174,154000,36034,14247,30745,3199,11441,11201,3885,1019,16041,14781,1260,14781,11415,3366,2019-01-01,zipcode
ZCTA5 32744,12,3807,46307,1014,164900,3143,1372,2857,421,1035,878,399,124,1740,1494,246,1494,1225,269,2019-01-01,zipcode
ZCTA5 32746,12,45244,87581,1449,306600,37131,12872,32554,1106,5310,9643,10524,5971,18823,17365,1458,17365,11169,6196,2019-01-01,zipcode
ZCTA5 32750,12,25025,71585,1260,239600,20789,6836,18248,1043,5014,6295,3885,2011,9959,9262,697,9262,6402,2860,2019-01-01,zipcode
ZCTA5 32751,12,22471,76108,1359,307800,18051,6428,15320,391,2191,4339,5086,3313,9571,8352,1219,8352,5622,2730,2019-01-01,zipcode
ZCTA5 32754,12,10984,54336,850,172900,9291,4709,8412,1006,2961,2989,965,491,5410,4161,1249,4161,3696,465,2019-01-01,zipcode
ZCTA5 32757,12,27990,57106,1072,216600,23231,10497,20828,2131,6141,5962,3744,2850,13245,11369,1876,11369,8159,3210,2019-01-01,zipcode
ZCTA5 32759,12,3014,42500,895,187800,2639,1573,2438,313,1082,684,290,69,1554,1218,336,1218,891,327,2019-01-01,zipcode
ZCTA5 32763,12,23277,45590,1113,133500,19323,8449,17358,1609,6187,6380,2026,1156,10563,9296,1267,9296,5818,3478,2019-01-01,zipcode
ZCTA5 32764,12,3165,72148,883,245700,2825,1158,2501,300,918,814,388,81,1483,1151,332,1151,1082,69,2019-01-01,zipcode
ZCTA5 32765,12,64268,81459,1494,285400,51358,17705,40475,1331,6333,13117,12137,7557,23371,21821,1550,21821,15254,6567,2019-01-01,zipcode
ZCTA5 32766,12,16855,113471,1801,339400,12945,4473,11061,481,1698,3367,3177,2338,5470,5247,223,5247,4622,625,2019-01-01,zipcode
ZCTA5 32767,12,3334,47869,916,96800,2802,1162,2344,551,1176,542,44,31,1459,1109,350,1109,900,209,2019-01-01,zipcode
ZCTA5 32771,12,56266,61983,1165,198700,43719,14664,38156,3696,9012,13138,8473,3837,22918,20450,2468,20450,12227,8223,2019-01-01,zipcode
ZCTA5 32773,12,31225,46353,1084,152000,24449,8899,21491,2135,7395,7419,3358,1184,12839,11574,1265,11574,6552,5022,2019-01-01,zipcode
ZCTA5 32776,12,12029,74113,1285,229100,9641,3291,8413,791,2194,3504,1179,745,4197,4001,196,4001,3176,825,2019-01-01,zipcode
ZCTA5 32778,12,22454,48441,990,151300,19022,10321,17122,1830,5932,5596,2268,1496,11833,9561,2272,9561,7187,2374,2019-01-01,zipcode
ZCTA5 32779,12,29603,93635,1418,335100,24002,8756,21145,505,3240,6231,7244,3925,11524,10962,562,10962,8860,2102,2019-01-01,zipcode
ZCTA5 32780,12,36116,51632,947,158200,30548,14470,27515,2099,8219,10224,4515,2458,19939,15226,4713,15226,10569,4657,2019-01-01,zipcode
ZCTA5 32784,12,12371,51519,749,143500,9867,4403,8439,1430,2927,2702,765,615,5333,4320,1013,4320,3248,1072,2019-01-01,zipcode
ZCTA5 32789,12,26483,79759,1289,491500,22321,9348,19462,1035,2920,3850,6162,5495,12791,11195,1596,11195,7585,3610,2019-01-01,zipcode
ZCTA5 32792,12,51659,52220,1190,227800,44023,14928,36141,2651,7322,11584,9249,5335,23812,20801,3011,20801,9619,11182,2019-01-01,zipcode
ZCTA5 32796,12,20609,49165,971,142500,17412,8585,15768,1362,5560,5344,2216,1286,10046,8043,2003,8043,6267,1776,2019-01-01,zipcode
ZCTA5 32798,12,2882,48086,1023,95300,2626,1632,2453,251,861,994,266,81,1599,1435,164,1435,1344,91,2019-01-01,zipcode
ZCTA5 32801,12,12243,57266,1331,310200,11328,3115,10664,710,1613,2094,3888,2359,9179,7524,1655,7524,1799,5725,2019-01-01,zipcode
ZCTA5 32803,12,20148,75474,1314,284600,18124,3840,16687,689,2382,4107,6192,3317,11193,9600,1593,9600,5022,4578,2019-01-01,zipcode
ZCTA5 32804,12,18023,79707,1216,332300,15085,4516,13594,613,2605,3045,4733,2598,9021,7775,1246,7775,5115,2660,2019-01-01,zipcode
ZCTA5 32805,12,18908,27530,791,139300,15482,6892,13874,2919,4927,3492,1844,692,9188,7344,1844,7344,2536,4808,2019-01-01,zipcode
ZCTA5 32806,12,27661,65987,1176,275000,22795,6929,20659,1301,4585,5662,5998,3113,12271,10985,1286,10985,6478,4507,2019-01-01,zipcode
ZCTA5 32807,12,34749,45989,1113,153800,28211,9237,24384,4691,8568,6877,2992,1256,12960,11720,1240,11720,5453,6267,2019-01-01,zipcode
ZCTA5 32808,12,59291,36913,995,121400,43819,13620,35678,7581,12168,11759,2820,1350,20282,18544,1738,18544,7408,11136,2019-01-01,zipcode
ZCTA5 32809,12,29095,44479,1001,159700,23169,7442,20217,4498,6632,5130,2815,1142,11079,9377,1702,9377,4682,4695,2019-01-01,zipcode
ZCTA5 32810,12,37861,51355,1168,156000,29545,8321,25899,2995,8225,8570,4565,1544,14422,13454,968,13454,6984,6470,2019-01-01,zipcode
ZCTA5 32811,12,41057,38768,1132,97200,32104,9249,26635,3942,7233,9335,4415,1710,17632,14954,2678,14954,3786,11168,2019-01-01,zipcode
ZCTA5 32812,12,35855,55131,1128,239600,29928,9595,26003,2496,6613,8712,5865,2317,15375,14009,1366,14009,7886,6123,2019-01-01,zipcode
ZCTA5 32814,12,8021,94581,1834,474000,6436,1538,5836,110,558,817,2267,2084,4242,3542,700,3542,1591,1951,2019-01-01,zipcode
ZCTA5 32817,12,35737,62421,1258,220400,30453,10938,21496,1770,4712,7374,4968,2672,13223,11593,1630,11593,6620,4973,2019-01-01,zipcode
ZCTA5 32818,12,58198,45795,1072,170300,44460,13377,36338,6808,11213,11695,4826,1796,18377,17421,956,17421,9681,7740,2019-01-01,zipcode
ZCTA5 32819,12,27840,73088,1355,335400,22922,7367,19924,1204,3141,5685,6945,2949,14128,10131,3997,10131,6222,3909,2019-01-01,zipcode
ZCTA5 32820,12,10442,95089,1438,278000,8059,2153,6467,538,1372,2136,1652,769,3198,2983,215,2983,2468,515,2019-01-01,zipcode
ZCTA5 32821,12,17680,55965,1380,207100,15314,3795,13144,794,2372,4316,4355,1307,13120,7231,5889,7231,2804,4427,2019-01-01,zipcode
ZCTA5 32822,12,61760,41350,1158,126300,49091,17390,42393,5773,14725,12602,6843,2450,25595,22323,3272,22323,8941,13382,2019-01-01,zipcode
ZCTA5 32824,12,46482,67303,1475,227100,36995,11028,31940,3970,8179,10559,6192,3040,16546,12894,3652,12894,9001,3893,2019-01-01,zipcode
ZCTA5 32825,12,61289,61236,1250,219500,49715,15868,40843,4377,9982,13875,8776,3833,22937,20184,2753,20184,12782,7402,2019-01-01,zipcode
ZCTA5 32826,12,35981,47462,1142,171700,33224,20044,13601,1612,3521,3789,3125,1554,8811,7644,1167,7644,4256,3388,2019-01-01,zipcode
ZCTA5 32827,12,9427,83125,1840,289500,7231,2673,6117,270,978,1529,2003,1337,4326,3414,912,3414,2240,1174,2019-01-01,zipcode
ZCTA5 32828,12,69497,77284,1549,274000,55420,17713,44351,3441,8121,13072,12438,7279,23680,22160,1520,22160,13827,8333,2019-01-01,zipcode
ZCTA5 32829,12,20376,75563,1458,224100,15523,4507,13631,1091,3232,4180,3316,1812,7243,6113,1130,6113,4799,1314,2019-01-01,zipcode
ZCTA5 32830,12,6,-666666666,-666666666,-666666666,6,0,6,0,0,6,0,0,6,6,0,6,0,6,2019-01-01,zipcode
ZCTA5 32831,12,3228,38875,-666666666,12800,3216,3189,2826,1110,1183,449,36,48,47,27,20,27,27,0,2019-01-01,zipcode
ZCTA5 32832,12,27919,89673,1582,335900,21150,6202,18358,798,1907,4968,6863,3822,11600,9406,2194,9406,6012,3394,2019-01-01,zipcode
ZCTA5 32833,12,9857,67554,1214,263900,7882,2801,6898,787,2062,2117,1078,854,3794,3357,437,3357,2706,651,2019-01-01,zipcode
ZCTA5 32835,12,48078,56927,1327,249100,39127,9112,32608,2617,7023,9986,8590,4392,18961,17491,1470,17491,6782,10709,2019-01-01,zipcode
ZCTA5 32836,12,20053,102714,1436,460900,16345,5701,14362,431,1845,3588,5205,3293,8847,7108,1739,7108,4828,2280,2019-01-01,zipcode
ZCTA5 32837,12,51310,63339,1413,238300,41471,12849,35161,3359,8764,10933,8113,3992,20374,15791,4583,15791,9365,6426,2019-01-01,zipcode
ZCTA5 32839,12,52886,39993,1083,152800,42178,14031,35420,7049,11223,10580,5136,1432,22990,17483,5507,17483,3850,13633,2019-01-01,zipcode
ZCTA5 32901,12,25089,39809,963,146400,22016,11395,17865,1792,5083,5830,3051,2109,12691,10508,2183,10508,5117,5391,2019-01-01,zipcode
ZCTA5 32903,12,14557,80181,1351,340000,12159,5281,11130,322,1991,3204,3414,2199,7017,6015,1002,6015,5019,996,2019-01-01,zipcode
ZCTA5 32904,12,32138,66086,1332,215500,26495,11585,22751,1615,6142,7550,4325,3119,13170,11938,1232,11938,9269,2669,2019-01-01,zipcode
ZCTA5 32905,12,23302,40583,973,121500,19275,8894,16456,1785,5621,5501,2333,1216,11307,9432,1875,9432,5188,4244,2019-01-01,zipcode
ZCTA5 32907,12,45037,54951,1123,158100,36995,16322,31470,3045,10924,11769,4058,1674,16336,14834,1502,14834,11885,2949,2019-01-01,zipcode
ZCTA5 32908,12,13397,57816,1370,156400,10240,4160,8566,1046,3393,2764,950,413,4226,3955,271,3955,3188,767,2019-01-01,zipcode
ZCTA5 32909,12,31251,51226,1030,168700,24658,9906,21666,2087,7593,7330,3005,1651,11901,10617,1284,10617,8695,1922,2019-01-01,zipcode
ZCTA5 32920,12,10283,55156,893,247200,9508,4804,8963,505,2100,3142,1851,1365,8999,5372,3627,5372,3350,2022,2019-01-01,zipcode
ZCTA5 32922,12,16709,31850,805,104500,12953,5766,10923,2318,3584,3693,921,407,8075,6293,1782,6293,2564,3729,2019-01-01,zipcode
ZCTA5 32925,12,1533,56591,1494,-666666666,1127,429,844,67,108,350,233,86,497,460,37,460,0,460,2019-01-01,zipcode
ZCTA5 32926,12,21915,51896,962,153600,18976,9301,17059,2172,5417,6099,2103,1268,9947,8279,1668,8279,6645,1634,2019-01-01,zipcode
ZCTA5 32927,12,27377,61633,1059,150000,22190,8332,19887,1701,6795,7260,2861,1270,11923,10032,1891,10032,8666,1366,2019-01-01,zipcode
ZCTA5 32931,12,13771,59874,1159,323100,12636,6776,11805,487,2426,3561,3126,2205,10880,7216,3664,7216,4997,2219,2019-01-01,zipcode
ZCTA5 32934,12,19105,71891,1414,244600,16403,7595,14473,1075,3249,4490,3315,2344,7679,7269,410,7269,6320,949,2019-01-01,zipcode
ZCTA5 32935,12,41209,49611,1026,157500,34721,13565,30678,2873,10184,10865,4371,2385,19148,16764,2384,16764,9821,6943,2019-01-01,zipcode
ZCTA5 32937,12,27551,73702,1271,298200,23034,10339,20625,481,4081,6204,5517,4342,13472,11088,2384,11088,8700,2388,2019-01-01,zipcode
ZCTA5 32940,12,42171,71812,1460,278000,35288,16884,31743,1182,5827,9696,8316,6722,18730,17013,1717,17013,13994,3019,2019-01-01,zipcode
ZCTA5 32948,12,7564,39852,758,140200,5559,2288,4169,1588,1350,903,253,75,2164,1849,315,1849,1311,538,2019-01-01,zipcode
ZCTA5 32949,12,2468,71094,-666666666,326900,2042,796,1803,66,475,791,240,231,1083,844,239,844,805,39,2019-01-01,zipcode
ZCTA5 32950,12,4522,68425,1294,281100,3880,1740,3429,183,1155,1147,724,220,1847,1766,81,1766,1589,177,2019-01-01,zipcode
ZCTA5 32951,12,11974,74143,1640,344900,10685,6195,10098,407,1845,2837,3106,1903,7247,5369,1878,5369,4530,839,2019-01-01,zipcode
ZCTA5 32952,12,20966,75256,1132,287700,17556,7407,15591,603,3523,5318,3881,2266,10047,8266,1781,8266,6992,1274,2019-01-01,zipcode
ZCTA5 32953,12,23939,62310,1021,278100,20200,8799,17774,1279,4245,5903,4232,2115,11662,9657,2005,9657,7076,2581,2019-01-01,zipcode
ZCTA5 32955,12,38889,73167,1270,228800,32597,13571,29453,1631,7052,10196,6684,3890,18276,15317,2959,15317,12116,3201,2019-01-01,zipcode
ZCTA5 32958,12,28617,53607,992,191200,25088,14086,23133,1761,8688,7087,3559,2038,14105,11493,2612,11493,9488,2005,2019-01-01,zipcode
ZCTA5 32960,12,22036,40529,877,166800,18377,8746,16063,1688,5649,5016,2418,1292,11504,8657,2847,8657,5007,3650,2019-01-01,zipcode
ZCTA5 32962,12,26459,48841,993,144700,22491,10172,19981,3348,5864,6937,2628,1204,12769,9021,3748,9021,7483,1538,2019-01-01,zipcode
ZCTA5 32963,12,15027,112755,1336,652400,14226,9424,13561,279,1305,2931,4498,4548,12511,7276,5235,7276,6784,492,2019-01-01,zipcode
ZCTA5 32966,12,18462,50172,1092,144700,16316,9410,15326,1114,4880,4868,2845,1619,10949,7955,2994,7955,6160,1795,2019-01-01,zipcode
ZCTA5 32967,12,22319,51625,922,235400,18195,9425,16441,2362,5159,4458,2696,1766,10852,7886,2966,7886,6091,1795,2019-01-01,zipcode
ZCTA5 32968,12,13154,78948,1281,266400,11083,5050,9479,445,2864,3097,2189,884,5119,4383,736,4383,4040,343,2019-01-01,zipcode
ZCTA5 32970,12,369,13375,-666666666,-666666666,369,304,369,24,329,16,0,0,157,110,47,110,94,16,2019-01-01,zipcode
ZCTA5 32976,12,9092,37577,794,93300,8721,6136,8428,697,3537,2902,892,400,6824,4872,1952,4872,4386,486,2019-01-01,zipcode
ZCTA5 33001,12,331,50216,2015,316000,320,169,318,17,165,70,60,6,681,185,496,185,128,57,2019-01-01,zipcode
ZCTA5 33004,12,16082,42469,1258,207400,13345,4955,12210,1167,3675,4055,2180,1133,8376,6588,1788,6588,3222,3366,2019-01-01,zipcode
ZCTA5 33009,12,41578,38665,1247,207900,35027,13641,31385,4778,8562,8124,5751,4170,29808,18467,11341,18467,9598,8869,2019-01-01,zipcode
ZCTA5 33010,12,45246,30000,1021,241600,39061,16785,34839,12669,11144,6520,3446,1060,16062,15294,768,15294,4560,10734,2019-01-01,zipcode
ZCTA5 33012,12,73828,31320,1160,227000,63380,29067,55987,17715,17423,12239,6199,2411,25378,24396,982,24396,11163,13233,2019-01-01,zipcode
ZCTA5 33013,12,31712,36280,1156,246500,27550,11828,24815,8222,9111,4333,2237,912,10111,9698,413,9698,5633,4065,2019-01-01,zipcode
ZCTA5 33014,12,41924,42700,1306,266400,34802,13812,30709,6978,9148,7494,4609,2480,15210,14568,642,14568,6401,8167,2019-01-01,zipcode
ZCTA5 33015,12,67191,53046,1434,262400,54309,17985,45693,6999,14073,13839,7225,3557,22350,21223,1127,21223,10783,10440,2019-01-01,zipcode
ZCTA5 33016,12,51700,49526,1389,221000,42054,14901,35820,7456,11808,7769,6216,2571,15887,15348,539,15348,8200,7148,2019-01-01,zipcode
ZCTA5 33018,12,53419,66889,1658,278800,43761,12993,37940,7590,12348,8943,6272,2787,15064,14637,427,14637,10868,3769,2019-01-01,zipcode
ZCTA5 33019,12,13729,80000,1539,465100,12076,5139,11311,459,1463,3523,3100,2766,12431,6560,5871,6560,4868,1692,2019-01-01,zipcode
ZCTA5 33020,12,45147,43494,1113,216800,37500,10982,33085,4735,10075,9984,5644,2647,21783,18578,3205,18578,6271,12307,2019-01-01,zipcode
ZCTA5 33021,12,49941,60289,1359,267400,40686,14825,35739,3895,9520,10962,6706,4656,21219,18335,2884,18335,11753,6582,2019-01-01,zipcode
ZCTA5 33023,12,73973,52783,1277,214400,57855,18354,48970,8212,17206,16411,4945,2196,22076,20576,1500,20576,13670,6906,2019-01-01,zipcode
ZCTA5 33024,12,76508,61470,1381,242100,60529,18654,51488,6769,16673,14902,8978,4166,25982,23605,2377,23605,15661,7944,2019-01-01,zipcode
ZCTA5 33025,12,73428,58483,1410,239600,59830,18680,52017,3306,17852,18441,7613,4805,28752,25464,3288,25464,11671,13793,2019-01-01,zipcode
ZCTA5 33026,12,31891,80232,1665,269400,26274,8492,22920,1727,4789,7537,5517,3350,12023,11230,793,11230,9172,2058,2019-01-01,zipcode
ZCTA5 33027,12,60679,63414,1484,321600,50009,21058,43745,2647,12403,13872,8138,6685,24067,21520,2547,21520,16934,4586,2019-01-01,zipcode
ZCTA5 33028,12,26848,104271,2050,390000,21671,5943,18369,991,3250,5164,5467,3497,8888,8133,755,8133,6277,1856,2019-01-01,zipcode
ZCTA5 33029,12,48161,113082,2735,403700,38754,12696,31531,1653,6917,9366,8314,5281,14295,13124,1171,13124,11607,1517,2019-01-01,zipcode
ZCTA5 33030,12,35303,39925,1045,251600,25103,8595,20900,8345,5773,4167,1782,833,9551,8950,601,8950,3302,5648,2019-01-01,zipcode
ZCTA5 33031,12,7124,78547,1982,396900,5580,1763,4695,1032,1585,1050,535,493,1964,1853,111,1853,1550,303,2019-01-01,zipcode
ZCTA5 33032,12,50135,54420,1270,251800,36983,11460,30685,6083,9105,8703,4993,1801,14084,13194,890,13194,7535,5659,2019-01-01,zipcode
ZCTA5 33033,12,58427,49485,1316,229300,42059,14636,34983,8155,9517,9628,5510,2173,16587,15638,949,15638,8741,6897,2019-01-01,zipcode
ZCTA5 33034,12,22142,35529,1107,132400,15295,7583,13140,5374,3672,3185,677,232,5410,4744,666,4744,1566,3178,2019-01-01,zipcode
ZCTA5 33035,12,16159,70608,1514,195900,11960,3408,9777,1222,2749,3202,1663,941,5222,4563,659,4563,2157,2406,2019-01-01,zipcode
ZCTA5 33036,12,3496,83261,1379,705500,3226,1259,2942,67,737,885,826,427,3638,1529,2109,1529,1212,317,2019-01-01,zipcode
ZCTA5 33037,12,10816,67917,1473,460700,9358,4214,8701,805,2161,2795,1607,1333,10603,4708,5895,4708,3686,1022,2019-01-01,zipcode
ZCTA5 33039,12,280,72500,-666666666,341200,270,126,260,57,65,81,0,57,100,100,0,100,100,0,2019-01-01,zipcode
ZCTA5 33040,12,34471,69702,1742,557100,29265,8581,25972,2613,7197,7699,5165,3298,18106,13968,4138,13968,6226,7742,2019-01-01,zipcode
ZCTA5 33042,12,6623,86739,1927,487700,5994,2434,5742,233,1324,1765,1469,951,4969,3070,1899,3070,2351,719,2019-01-01,zipcode
ZCTA5 33043,12,4933,58571,1645,365600,4370,1916,3970,283,1024,1429,824,410,2941,2088,853,2088,1517,571,2019-01-01,zipcode
ZCTA5 33050,12,9443,57537,1332,451600,8225,2844,7339,697,2107,2195,1715,625,6934,4115,2819,4115,2320,1795,2019-01-01,zipcode
ZCTA5 33051,12,534,100192,1211,603000,534,280,534,39,132,130,145,88,1366,320,1046,320,227,93,2019-01-01,zipcode
ZCTA5 33054,12,31797,26919,981,165200,24870,11646,19988,5413,8711,4193,1365,306,10391,9569,822,9569,4255,5314,2019-01-01,zipcode
ZCTA5 33055,12,40883,45306,1315,202300,33233,14639,28592,7524,11432,5891,2828,917,11774,11129,645,11129,8395,2734,2019-01-01,zipcode
ZCTA5 33056,12,36110,41769,1277,181200,27975,11557,23120,4687,8293,6943,2165,1032,10519,9791,728,9791,6152,3639,2019-01-01,zipcode
ZCTA5 33060,12,37612,44647,1160,261200,30056,11614,26249,5462,8763,6874,3197,1953,15203,13295,1908,13295,5921,7374,2019-01-01,zipcode
ZCTA5 33062,12,22692,64812,1416,351300,21092,10797,20381,1419,4162,6040,4715,4045,21201,12158,9043,12158,8806,3352,2019-01-01,zipcode
ZCTA5 33063,12,54707,46450,1432,173500,46954,16583,42578,5093,14808,12883,7208,2586,26827,22907,3920,22907,15508,7399,2019-01-01,zipcode
ZCTA5 33064,12,61293,53238,1343,188900,49009,15928,42813,8207,13534,10416,7785,2871,24285,20761,3524,20761,12795,7966,2019-01-01,zipcode
ZCTA5 33065,12,58171,55686,1407,274100,44320,13083,37025,3671,10364,12479,7329,3182,19650,17857,1793,17857,9053,8804,2019-01-01,zipcode
ZCTA5 33066,12,16752,50674,1254,130400,15158,7607,14138,931,3915,4469,2723,2100,10714,8319,2395,8319,6751,1568,2019-01-01,zipcode
ZCTA5 33067,12,27358,103337,1698,446500,21725,6115,18443,584,3135,5423,4814,4487,9269,8753,516,8753,6095,2658,2019-01-01,zipcode
ZCTA5 33068,12,52749,45613,1447,182400,40917,10736,34607,4982,13326,10198,3900,2201,18684,16841,1843,16841,9794,7047,2019-01-01,zipcode
ZCTA5 33069,12,28138,49732,1310,162100,23958,11052,20970,3326,6059,5832,3950,1803,14458,10494,3964,10494,5263,5231,2019-01-01,zipcode
ZCTA5 33070,12,5132,73676,1654,508400,4436,1640,3955,351,1041,1064,963,536,4265,2070,2195,2070,1407,663,2019-01-01,zipcode
ZCTA5 33071,12,39402,91999,1625,368200,30991,8945,26601,1279,5465,8366,7426,4065,13491,12851,640,12851,8366,4485,2019-01-01,zipcode
ZCTA5 33073,12,35378,77158,1742,325900,27336,7140,22985,1449,6499,7014,6010,2013,12389,11552,837,11552,6701,4851,2019-01-01,zipcode
ZCTA5 33076,12,39091,136343,2338,521900,28942,10518,24507,921,4000,5191,8025,6370,12886,12006,880,12006,9811,2195,2019-01-01,zipcode
ZCTA5 33101,12,0,-666666666,-666666666,-666666666,0,0,0,0,0,0,0,0,0,0,0,0,0,0,2019-01-01,zipcode
ZCTA5 33109,12,408,200577,-666666666,2000001,392,239,392,0,54,14,167,157,885,210,675,210,185,25,2019-01-01,zipcode
ZCTA5 33122,12,205,52321,2133,-666666666,162,73,150,32,13,26,68,11,94,94,0,94,0,94,2019-01-01,zipcode
ZCTA5 33125,12,61156,27544,1053,246400,51745,23468,45565,15319,16078,6991,5072,2105,22978,21349,1629,21349,5453,15896,2019-01-01,zipcode
ZCTA5 33126,12,52986,37241,1290,206800,45566,16891,40265,8089,13441,9179,7083,2473,19514,18242,1272,18242,6045,12197,2019-01-01,zipcode
ZCTA5 33127,12,31902,30633,1027,206200,25056,10406,21725,5827,7454,4933,2373,1138,11719,10207,1512,10207,2889,7318,2019-01-01,zipcode
ZCTA5 33128,12,7992,19482,837,221000,6782,2859,6117,2662,1787,1010,507,151,3597,3213,384,3213,185,3028,2019-01-01,zipcode
ZCTA5 33129,12,13750,78105,2050,506800,11679,3138,10649,575,1032,1596,4047,3399,8707,6545,2162,6545,3013,3532,2019-01-01,zipcode
ZCTA5 33130,12,29737,34937,1171,328600,26191,9268,23326,5129,5672,4180,4522,3823,17316,14007,3309,14007,1863,12144,2019-01-01,zipcode
ZCTA5 33131,12,18477,101248,2279,468700,16367,3067,15273,242,1187,2180,5715,5949,16318,10349,5969,10349,3413,6936,2019-01-01,zipcode
ZCTA5 33132,12,13849,80577,2041,485300,13014,4073,11794,1001,1268,2579,3879,3067,9688,6936,2752,6936,1968,4968,2019-01-01,zipcode
ZCTA5 33133,12,35592,66683,1490,678800,28712,10638,26570,2241,6045,5157,6811,6316,16980,13913,3067,13913,6865,7048,2019-01-01,zipcode
ZCTA5 33134,12,40265,68868,1467,493800,34176,12131,31419,3225,5908,6703,8491,7092,18599,16167,2432,16167,8373,7794,2019-01-01,zipcode
ZCTA5 33135,12,38920,27857,1041,288400,33116,13778,29478,8879,10405,4868,3818,1508,15721,14623,1098,14623,2867,11756,2019-01-01,zipcode
ZCTA5 33136,12,15848,26336,879,207200,12935,4623,11314,2411,3800,2924,1447,732,7336,6268,1068,6268,788,5480,2019-01-01,zipcode
ZCTA5 33137,12,22955,63650,1755,364600,19642,5216,17769,1799,2859,4408,5376,3327,12915,10134,2781,10134,2695,7439,2019-01-01,zipcode
ZCTA5 33138,12,30221,51262,1048,471700,24688,7700,22017,3233,4953,5441,4869,3521,14147,12587,1560,12587,5730,6857,2019-01-01,zipcode
ZCTA5 33139,12,39427,53327,1469,430800,34587,9674,32082,3695,5078,6883,9244,7182,32461,20840,11621,20840,7041,13799,2019-01-01,zipcode
ZCTA5 33140,12,19938,76960,1653,703500,16472,6236,15078,1185,2053,3258,4281,4301,17629,8674,8955,8674,5028,3646,2019-01-01,zipcode
ZCTA5 33141,12,39768,49861,1358,344800,34515,9681,30942,3284,7707,7637,7034,5280,23478,17569,5909,17569,5181,12388,2019-01-01,zipcode
ZCTA5 33142,12,59073,26424,909,171900,45872,19321,39620,13020,13818,7855,3599,1328,21509,19715,1794,19715,5341,14374,2019-01-01,zipcode
ZCTA5 33143,12,31056,67042,1386,599600,25687,9063,22348,1179,3755,5428,6606,5380,13828,12414,1414,12414,6408,6006,2019-01-01,zipcode
ZCTA5 33144,12,29344,48632,1386,300000,25834,10362,23517,4959,7146,5959,3954,1499,9683,9262,421,9262,5368,3894,2019-01-01,zipcode
ZCTA5 33145,12,30713,54288,1478,365800,26628,9489,24094,3563,6834,5328,4867,3502,12873,11640,1233,11640,5644,5996,2019-01-01,zipcode
ZCTA5 33146,12,16473,117500,2190,903300,13940,6405,7972,317,566,1251,2586,3252,5130,4332,798,4332,3169,1163,2019-01-01,zipcode
ZCTA5 33147,12,47811,32808,1025,154700,37010,16045,31478,8761,12125,7286,2163,1143,15795,14311,1484,14311,6720,7591,2019-01-01,zipcode
ZCTA5 33149,12,12943,151190,2548,1208300,9737,3819,8482,171,662,1447,3154,3048,7280,4428,2852,4428,3081,1347,2019-01-01,zipcode
ZCTA5 33150,12,29652,29782,886,209300,22743,9314,19235,5415,6350,4672,1742,1056,11088,9779,1309,9779,3046,6733,2019-01-01,zipcode
ZCTA5 33154,12,14634,76690,1831,634700,11390,4655,10134,289,1502,2240,3453,2650,10403,6185,4218,6185,3546,2639,2019-01-01,zipcode
ZCTA5 33155,12,46617,68699,1606,358500,39789,15020,35446,4357,8770,9665,8377,4277,15398,14471,927,14471,10137,4334,2019-01-01,zipcode
ZCTA5 33156,12,33514,117491,1738,857500,26866,9923,22818,941,2847,4515,7264,7251,12732,11107,1625,11107,7850,3257,2019-01-01,zipcode
ZCTA5 33157,12,67455,65099,1205,312700,52717,19115,44695,6522,12983,11281,8938,4971,21137,19697,1440,19697,13042,6655,2019-01-01,zipcode
ZCTA5 33158,12,6469,170673,2122,683400,4928,1908,4145,64,375,621,1292,1793,2261,1997,264,1997,1892,105,2019-01-01,zipcode
ZCTA5 33160,12,39615,51790,1549,294100,34495,14040,31889,1994,5036,10778,8047,6034,35911,19164,16747,19164,10242,8922,2019-01-01,zipcode
ZCTA5 33161,12,56130,40093,1138,242200,43820,15126,36934,8628,11538,9614,4874,2280,18422,16634,1788,16634,6373,10261,2019-01-01,zipcode
ZCTA5 33162,12,47123,45080,1154,207900,37227,12814,31331,6636,9858,8778,4360,1699,14703,13093,1610,13093,7316,5777,2019-01-01,zipcode
ZCTA5 33165,12,55822,53998,1408,321700,47563,19384,41425,8088,12655,9984,7053,3645,16932,16288,644,16288,11129,5159,2019-01-01,zipcode
ZCTA5 33166,12,24346,54362,1330,368700,20393,7878,17825,2852,4246,4709,3653,2365,9288,7923,1365,7923,3733,4190,2019-01-01,zipcode
ZCTA5 33167,12,20582,37474,1149,191300,16093,6809,13259,3406,4497,3439,1402,515,6145,5786,359,5786,2976,2810,2019-01-01,zipcode
ZCTA5 33168,12,27414,48894,1325,207600,22686,8628,18942,4761,7355,4414,1643,769,7147,6737,410,6737,4829,1908,2019-01-01,zipcode
ZCTA5 33169,12,41626,45711,1198,210100,31994,11781,27302,5088,8453,8545,3570,1646,13437,12163,1274,12163,6488,5675,2019-01-01,zipcode
ZCTA5 33170,12,14121,45929,1054,282800,11025,4835,9467,2172,3158,2246,1376,515,4141,3893,248,3893,2418,1475,2019-01-01,zipcode
ZCTA5 33172,12,43356,50139,1590,171100,36116,12348,32342,6618,8253,7574,6303,3594,15829,14017,1812,14017,6356,7661,2019-01-01,zipcode
ZCTA5 33173,12,33089,68382,1596,328800,28081,10387,24657,2846,5251,6874,6091,3595,11781,10987,794,10987,7309,3678,2019-01-01,zipcode
ZCTA5 33174,12,34403,51442,1340,272900,30549,12727,24891,6883,5954,5037,4991,2026,10387,9965,422,9965,5615,4350,2019-01-01,zipcode
ZCTA5 33175,12,53348,58945,1640,302600,46329,18606,40427,7388,12995,9126,7487,3431,16209,15643,566,15643,11668,3975,2019-01-01,zipcode
ZCTA5 33176,12,52288,72998,1417,417600,43570,15010,38168,3561,7879,11261,9146,6321,18859,17228,1631,17228,11559,5669,2019-01-01,zipcode
ZCTA5 33177,12,57526,61033,1586,262700,47269,18526,39877,6949,13904,10607,6065,2352,15405,14827,578,14827,10520,4307,2019-01-01,zipcode
ZCTA5 33178,12,52206,79707,2100,390800,39489,12950,33483,2726,4871,8021,10169,7696,19701,15272,4429,15272,7631,7641,2019-01-01,zipcode
ZCTA5 33179,12,44341,49016,1278,181100,36857,12297,31777,3694,8818,10494,5353,3418,18239,16181,2058,16181,9495,6686,2019-01-01,zipcode
ZCTA5 33180,12,32441,74091,1945,393500,27899,11330,25477,1190,3023,7469,8414,5381,23401,14485,8916,14485,9457,5028,2019-01-01,zipcode
ZCTA5 33181,12,20111,46139,1238,257800,16855,5865,14159,1883,3691,3963,2921,1701,9172,7627,1545,7627,2991,4636,2019-01-01,zipcode
ZCTA5 33182,12,16607,80213,1853,342500,14375,7253,12231,2619,3164,2862,2566,1020,3864,3771,93,3771,3258,513,2019-01-01,zipcode
ZCTA5 33183,12,36725,59797,1538,261400,30789,11281,26403,3469,7495,8065,4871,2503,12198,11794,404,11794,7415,4379,2019-01-01,zipcode
ZCTA5 33184,12,21785,53480,1579,256400,19193,8108,16862,4573,4324,3238,3858,869,6364,6065,299,6065,4609,1456,2019-01-01,zipcode
ZCTA5 33185,12,31359,89327,2328,367900,25469,8941,21466,2301,5138,5143,6061,2823,8420,8187,233,8187,6943,1244,2019-01-01,zipcode
ZCTA5 33186,12,68581,70529,1712,299000,55972,19286,48392,3735,11299,16153,11199,6006,22782,21439,1343,21439,14235,7204,2019-01-01,zipcode
ZCTA5 33187,12,19392,80629,2108,360500,15929,5483,13650,1980,3415,3937,3208,1110,5559,5323,236,5323,4612,711,2019-01-01,zipcode
ZCTA5 33189,12,25298,58190,1214,263200,19896,6661,17401,2239,5647,4962,3311,1242,8513,7897,616,7897,4801,3096,2019-01-01,zipcode
ZCTA5 33190,12,16147,64332,1368,266200,12542,3821,10672,1445,2452,3531,2613,631,4909,4675,234,4675,2043,2632,2019-01-01,zipcode
ZCTA5 33193,12,49999,63337,1544,293600,41323,14204,34481,7032,8467,7693,8862,2427,14916,14427,489,14427,8920,5507,2019-01-01,zipcode
ZCTA5 33194,12,8081,118125,1825,374100,6584,3484,5558,1062,1167,1439,1316,574,1428,1428,0,1428,1157,271,2019-01-01,zipcode
ZCTA5 33196,12,53047,76787,1878,331000,42287,14296,35505,3375,7672,11059,9544,3855,15280,14504,776,14504,9647,4857,2019-01-01,zipcode
ZCTA5 33301,12,14988,99382,2049,559300,13803,4151,12781,481,1494,2778,4416,3612,10873,7768,3105,7768,3547,4221,2019-01-01,zipcode
ZCTA5 33304,12,18351,58290,1299,422700,16404,4843,15199,1167,2659,4203,4683,2487,12969,9549,3420,9549,3396,6153,2019-01-01,zipcode
ZCTA5 33305,12,12222,74095,1372,402600,11190,3625,10756,438,1750,2917,3555,2096,7801,6313,1488,6313,4052,2261,2019-01-01,zipcode
ZCTA5 33306,12,3124,71357,1119,477200,2903,914,2746,57,464,804,753,668,2235,1708,527,1708,1041,667,2019-01-01,zipcode
ZCTA5 33308,12,27294,64792,1442,410100,25093,11391,23858,1213,4797,6043,6668,5137,23267,15194,8073,15194,10352,4842,2019-01-01,zipcode
ZCTA5 33309,12,40844,55134,1320,190000,32633,9317,28862,4412,9354,7603,4686,2807,14474,13402,1072,13402,8071,5331,2019-01-01,zipcode
ZCTA5 33311,12,76073,36649,1109,157700,56604,22930,47485,11474,17829,12626,3558,1998,26580,23494,3086,23494,9716,13778,2019-01-01,zipcode
ZCTA5 33312,12,55298,58144,1356,256800,43910,15075,38238,5644,10623,10625,7626,3720,20770,17943,2827,17943,10258,7685,2019-01-01,zipcode
ZCTA5 33313,12,62842,38201,1186,131900,48727,16888,40216,7977,14617,11344,4297,1981,23885,19959,3926,19959,8514,11445,2019-01-01,zipcode
ZCTA5 33314,12,27261,51635,1483,171400,22003,7156,18001,2751,5410,5094,3579,1167,10442,9244,1198,9244,3814,5430,2019-01-01,zipcode
ZCTA5 33315,12,13801,76507,1457,315000,12132,3277,11213,913,3309,2975,2607,1409,6970,6068,902,6068,3376,2692,2019-01-01,zipcode
ZCTA5 33316,12,9736,67477,1208,595100,9043,3670,8456,671,1388,2139,2528,1730,7857,5061,2796,5061,3120,1941,2019-01-01,zipcode
ZCTA5 33317,12,38427,67878,1396,311600,30891,9855,27022,3592,6722,7273,6317,3118,13490,12668,822,12668,9514,3154,2019-01-01,zipcode
ZCTA5 33319,12,46786,44993,1289,139100,38335,13521,33820,5132,11028,9823,5103,2734,23132,18315,4817,18315,11797,6518,2019-01-01,zipcode
ZCTA5 33321,12,47413,49784,1443,173800,40095,16100,35980,3222,11101,11857,6154,3646,22136,19526,2610,19526,14337,5189,2019-01-01,zipcode
ZCTA5 33322,12,39097,48179,1701,169700,34179,14823,31041,3306,8187,9853,5774,3921,20037,16678,3359,16678,13709,2969,2019-01-01,zipcode
ZCTA5 33323,12,21651,88946,1939,320900,17754,4715,15312,1268,2908,5098,3878,2160,8474,7338,1136,7338,5205,2133,2019-01-01,zipcode
ZCTA5 33324,12,49045,70461,1655,244200,40142,11696,35604,1754,6806,11568,9127,6349,21961,19037,2924,19037,10614,8423,2019-01-01,zipcode
ZCTA5 33325,12,29369,82805,1703,314800,23861,6893,19977,1638,5429,5628,4825,2457,10383,9137,1246,9137,7126,2011,2019-01-01,zipcode
ZCTA5 33326,12,33155,93197,1872,379200,26181,8580,22737,1048,3535,5753,7310,5091,13579,10794,2785,10794,7473,3321,2019-01-01,zipcode
ZCTA5 33327,12,23811,117906,2649,538000,16705,6311,13673,409,2134,2532,4774,3824,6875,6501,374,6501,4880,1621,2019-01-01,zipcode
ZCTA5 33328,12,29626,92227,1599,363500,23888,7341,19639,1221,3958,5845,5259,3356,10744,10151,593,10151,7817,2334,2019-01-01,zipcode
ZCTA5 33330,12,15793,130208,2739,539800,12818,4504,10401,704,1657,2837,2780,2423,4828,4615,213,4615,4236,379,2019-01-01,zipcode
ZCTA5 33331,12,25718,125608,2401,492600,19683,6340,16695,743,2089,4204,5260,4399,7929,7417,512,7417,6446,971,2019-01-01,zipcode
ZCTA5 33332,12,11622,139984,2611,634900,9352,3232,7478,383,889,1599,2353,2254,3516,3173,343,3173,2875,298,2019-01-01,zipcode
ZCTA5 33334,12,29494,52303,1163,290400,25364,7080,22752,3732,5855,6079,4404,2682,13688,12169,1519,12169,6541,5628,2019-01-01,zipcode
ZCTA5 33351,12,35769,60848,1494,229500,28425,8189,24715,2994,7074,7689,5161,1797,12785,11948,837,11948,6410,5538,2019-01-01,zipcode
ZCTA5 33401,12,28687,50824,1364,250900,24362,9045,20096,2377,4699,5337,4475,3208,16134,11406,4728,11406,4419,6987,2019-01-01,zipcode
ZCTA5 33403,12,12794,58371,1219,198100,10091,2985,8817,1481,2183,2685,1793,675,5060,4208,852,4208,2042,2166,2019-01-01,zipcode
ZCTA5 33404,12,29339,44165,1150,154400,23140,9637,20074,2836,6976,5674,2828,1760,15036,9981,5055,9981,5289,4692,2019-01-01,zipcode
ZCTA5 33405,12,20633,55000,1178,276600,16962,5620,14995,3092,4209,3507,2229,1958,7913,6992,921,6992,4222,2770,2019-01-01,zipcode
ZCTA5 33406,12,27585,62785,1281,218800,22341,7126,18880,2766,6118,5502,3396,1098,9513,8776,737,8776,5774,3002,2019-01-01,zipcode
ZCTA5 33407,12,31551,45093,1181,173300,24919,8314,21295,4500,6437,5468,3031,1859,12821,10733,2088,10733,4422,6311,2019-01-01,zipcode
ZCTA5 33408,12,18207,76030,1424,367900,16586,7738,15347,718,2924,4167,4607,2931,12965,9118,3847,9118,7134,1984,2019-01-01,zipcode
ZCTA5 33409,12,33212,49641,1259,167300,26404,8316,21331,3814,5453,6059,4099,1906,12810,10947,1863,10947,4856,6091,2019-01-01,zipcode
ZCTA5 33410,12,35089,76371,1618,326700,30161,10810,27392,1751,6299,8086,7185,4071,16784,14383,2401,14383,9863,4520,2019-01-01,zipcode
ZCTA5 33411,12,72546,75019,1433,284400,58064,20450,50874,4317,13464,15517,11059,6517,28143,24555,3588,24555,18042,6513,2019-01-01,zipcode
ZCTA5 33412,12,15472,101196,2016,375700,13300,5516,11906,689,3028,3606,2884,1699,6351,5390,961,5390,4776,614,2019-01-01,zipcode
ZCTA5 33413,12,17487,64714,1540,254800,13625,4213,11529,1708,3130,3704,1922,1065,5546,5038,508,5038,3313,1725,2019-01-01,zipcode
ZCTA5 33414,12,61323,86553,1860,364300,47823,16827,40762,2146,8419,12345,11459,6393,23436,19749,3687,19749,14348,5401,2019-01-01,zipcode
ZCTA5 33415,12,51791,43567,1185,135800,40465,13005,33842,7525,11258,9114,4454,1491,19021,16586,2435,16586,9131,7455,2019-01-01,zipcode
ZCTA5 33417,12,33743,37924,1170,82100,27493,10511,24253,4146,7428,7002,4285,1392,18845,14347,4498,14347,7886,6461,2019-01-01,zipcode
ZCTA5 33418,12,40926,96311,1766,399200,35025,15337,32229,1344,4938,8488,9817,7642,21445,16963,4482,16963,13538,3425,2019-01-01,zipcode
ZCTA5 33426,12,23866,61239,1586,206900,20534,7154,17937,1550,5427,6119,3264,1577,11544,9967,1577,9967,5906,4061,2019-01-01,zipcode
ZCTA5 33428,12,41441,71239,1663,291200,33510,11912,28611,2008,7040,8133,7866,3564,15592,13836,1756,13836,9756,4080,2019-01-01,zipcode
ZCTA5 33430,12,23172,24615,601,111500,17271,7982,14332,5670,4528,3056,889,189,8675,7498,1177,7498,2259,5239,2019-01-01,zipcode
ZCTA5 33431,12,21610,81381,1758,400800,18374,7762,14187,732,2264,3651,4242,3298,9890,7974,1916,7974,5423,2551,2019-01-01,zipcode
ZCTA5 33432,12,20487,77250,1701,620600,18737,8021,16802,979,2793,4349,4782,3899,15762,10547,5215,10547,6636,3911,2019-01-01,zipcode
ZCTA5 33433,12,40257,63774,1816,294100,34475,16202,30866,1199,6443,7581,9387,6256,23380,18298,5082,18298,12978,5320,2019-01-01,zipcode
ZCTA5 33434,12,20486,60457,1149,246800,18241,10181,17215,1213,3437,3999,4820,3746,13750,9849,3901,9849,8114,1735,2019-01-01,zipcode
ZCTA5 33435,12,36166,52210,1428,172300,30688,11795,27427,4930,7033,8226,4991,2247,18638,13696,4942,13696,8032,5664,2019-01-01,zipcode
ZCTA5 33436,12,44489,60422,1528,236500,37485,15138,33917,3128,7945,10732,7845,4267,21657,17333,4324,17333,12548,4785,2019-01-01,zipcode
ZCTA5 33437,12,38152,64612,1536,289500,34919,21657,33460,1616,7580,9716,8175,6373,21444,18312,3132,18312,15962,2350,2019-01-01,zipcode
ZCTA5 33438,12,367,58750,-666666666,107800,347,114,282,29,121,73,38,21,121,105,16,105,96,9,2019-01-01,zipcode
ZCTA5 33440,12,19761,40883,804,86500,15620,5918,12862,4300,4335,3105,852,270,7821,6496,1325,6496,4221,2275,2019-01-01,zipcode
ZCTA5 33441,12,27323,48778,1228,233300,23264,7465,20682,2894,6390,6269,3373,1756,13755,11104,2651,11104,5630,5474,2019-01-01,zipcode
ZCTA5 33442,12,28964,49599,1588,151700,24920,11111,22790,1580,6629,7142,4890,2549,19307,13802,5505,13802,9247,4555,2019-01-01,zipcode
ZCTA5 33444,12,24597,56722,1392,291000,20545,6484,17871,3799,4747,4819,2981,1525,9930,8705,1225,8705,4528,4177,2019-01-01,zipcode
ZCTA5 33445,12,31703,55274,1643,204400,28163,11625,24867,2131,5649,7022,6150,3915,17673,14077,3596,14077,9257,4820,2019-01-01,zipcode
ZCTA5 33446,12,26006,57383,1199,281500,23986,15545,23187,1398,4885,6411,5737,4756,18016,13456,4560,13456,11406,2050,2019-01-01,zipcode
ZCTA5 33449,12,12321,124107,1840,453800,9593,3922,8116,259,1202,1931,2187,2537,4449,3970,479,3970,3628,342,2019-01-01,zipcode
ZCTA5 33455,12,22200,56987,1036,271600,19488,9973,17922,1401,4658,5276,4222,2365,11962,9613,2349,9613,7895,1718,2019-01-01,zipcode
ZCTA5 33458,12,58714,85811,1581,365300,46991,14348,41108,2846,7173,12019,11769,7301,24032,21646,2386,21646,15513,6133,2019-01-01,zipcode
ZCTA5 33460,12,32573,42329,1098,211000,25600,8405,22305,6901,5678,5398,2659,1669,12788,11004,1784,11004,4691,6313,2019-01-01,zipcode
ZCTA5 33461,12,47735,44107,1207,152700,37550,12298,32154,8260,10129,8796,3251,1718,17642,15080,2562,15080,7146,7934,2019-01-01,zipcode
ZCTA5 33462,12,33241,53428,1247,216700,27844,10137,24967,3935,7593,6567,4271,2601,15395,12410,2985,12410,7718,4692,2019-01-01,zipcode
ZCTA5 33463,12,63577,54417,1360,200600,49106,14666,40860,9239,10788,11389,6600,2844,20983,18511,2472,18511,12776,5735,2019-01-01,zipcode
ZCTA5 33467,12,54261,71821,1257,303700,45384,19162,40285,3030,9569,12007,9544,6135,23527,20087,3440,20087,17364,2723,2019-01-01,zipcode
ZCTA5 33469,12,14924,82443,1443,389100,12900,6258,11852,365,2081,3465,3806,2135,8692,6593,2099,6593,5721,872,2019-01-01,zipcode
ZCTA5 33470,12,27317,85648,1886,342200,22633,7323,18681,2608,5265,6234,3060,1514,9137,8159,978,8159,7283,876,2019-01-01,zipcode
ZCTA5 33471,12,6866,40074,762,69000,5961,3855,5280,1410,2152,1119,396,203,3395,2208,1187,2208,1691,517,2019-01-01,zipcode
ZCTA5 33472,12,19925,76543,2068,299800,17179,8819,15837,738,3440,4718,4169,2772,8877,7967,910,7967,7243,724,2019-01-01,zipcode
ZCTA5 33473,12,12210,145245,3003,590000,9266,3734,8351,33,1388,1976,2799,2155,4764,3969,795,3969,3411,558,2019-01-01,zipcode
ZCTA5 33476,12,8513,22199,581,98200,6479,2857,5243,1908,1656,1196,357,126,3019,2665,354,2665,921,1744,2019-01-01,zipcode
ZCTA5 33477,12,12608,81883,1742,423800,11951,7076,11522,400,2002,2901,3703,2516,12178,6990,5188,6990,5806,1184,2019-01-01,zipcode
ZCTA5 33478,12,14067,109847,2191,412700,11630,4129,10577,535,2641,3262,2740,1399,4982,4623,359,4623,4487,136,2019-01-01,zipcode
ZCTA5 33480,12,10031,116901,1692,975900,9561,6310,9448,226,654,2228,3216,3124,11741,5701,6040,5701,4901,800,2019-01-01,zipcode
ZCTA5 33483,12,12703,90280,1797,572900,11791,5535,11073,566,1607,2430,4018,2452,9369,6235,3134,6235,4351,1884,2019-01-01,zipcode
ZCTA5 33484,12,26299,45200,1375,149200,24926,15495,23721,1647,6315,6881,5170,3708,18629,14177,4452,14177,10910,3267,2019-01-01,zipcode
ZCTA5 33486,12,23325,80970,1576,427800,18908,7172,16604,708,3332,3780,5772,3012,10721,9061,1660,9061,7108,1953,2019-01-01,zipcode
ZCTA5 33487,12,20677,76786,1827,406400,17712,7977,16309,528,2578,4375,5354,3474,12662,9332,3330,9332,7298,2034,2019-01-01,zipcode
ZCTA5 33493,12,5532,31850,803,82200,5131,4375,4701,2130,1675,658,175,63,724,483,241,483,255,228,2019-01-01,zipcode
ZCTA5 33496,12,22530,94816,1809,377800,19734,10338,17992,629,2795,4188,5852,4528,12111,9986,2125,9986,8681,1305,2019-01-01,zipcode
ZCTA5 33498,12,15150,107242,2633,421600,12237,4911,10915,492,1708,2697,3435,2583,5478,5250,228,5250,4906,344,2019-01-01,zipcode
ZCTA5 33503,12,162,-666666666,-666666666,356300,162,57,96,9,34,53,0,0,57,57,0,57,52,5,2019-01-01,zipcode
ZCTA5 33510,12,29574,59061,1150,171800,24040,9300,20680,1549,6772,6661,4165,1533,11451,10454,997,10454,6411,4043,2019-01-01,zipcode
ZCTA5 33511,12,58833,59862,1260,201900,47469,15723,41176,3523,9841,13742,9889,4181,24007,22101,1906,22101,11189,10912,2019-01-01,zipcode
ZCTA5 33513,12,12713,39758,760,114000,10454,6547,8978,1615,3870,2590,596,307,4922,3660,1262,3660,2858,802,2019-01-01,zipcode
ZCTA5 33514,12,2717,40994,911,102200,1833,884,1540,444,446,503,45,102,800,717,83,717,474,243,2019-01-01,zipcode
ZCTA5 33521,12,557,31167,-666666666,89400,432,235,402,38,194,136,29,5,352,218,134,218,151,67,2019-01-01,zipcode
ZCTA5 33523,12,18835,48365,780,119400,15023,6089,12390,2571,4584,3243,1267,725,7983,6612,1371,6612,4438,2174,2019-01-01,zipcode
ZCTA5 33525,12,20576,55103,861,154700,17200,8657,14205,1832,4718,4535,2136,984,8608,7203,1405,7203,5394,1809,2019-01-01,zipcode
ZCTA5 33527,12,15092,62171,831,229600,12185,4494,10450,2579,3588,2535,1230,518,5322,4738,584,4738,3530,1208,2019-01-01,zipcode
ZCTA5 33534,12,17123,54125,1015,188000,12235,4040,10118,2100,3177,3136,1257,448,5614,5117,497,5117,3343,1774,2019-01-01,zipcode
ZCTA5 33538,12,4728,36953,822,85100,4131,2242,3796,648,1640,1047,289,172,2898,1983,915,1983,1579,404,2019-01-01,zipcode
ZCTA5 33540,12,8652,35812,744,82300,7526,4233,6809,1051,2987,1955,551,265,5074,3803,1271,3803,2826,977,2019-01-01,zipcode
ZCTA5 33541,12,21612,41681,1008,76900,18601,11585,17262,2647,6650,5293,1750,922,12651,9319,3332,9319,7292,2027,2019-01-01,zipcode
ZCTA5 33542,12,22057,35095,839,72200,19110,11573,16997,2391,6759,5776,1445,626,13322,10010,3312,10010,6807,3203,2019-01-01,zipcode
ZCTA5 33543,12,28156,85855,1445,226800,22083,7720,19123,1161,3715,6114,4953,3180,10492,9387,1105,9387,7674,1713,2019-01-01,zipcode
ZCTA5 33544,12,28187,84122,1555,254800,21443,6624,18778,1581,4157,5246,4908,2886,10095,9582,513,9582,6827,2755,2019-01-01,zipcode
ZCTA5 33545,12,19592,81687,1514,221100,14680,4374,12417,731,2688,4611,2853,1534,6551,6124,427,6124,4521,1603,2019-01-01,zipcode
ZCTA5 33547,12,25907,107489,1788,326200,18017,6038,15460,823,2897,3651,4899,3190,8575,7995,580,7995,6742,1253,2019-01-01,zipcode
ZCTA5 33548,12,7222,111841,1588,362700,5884,2291,5009,80,888,1478,1622,941,2772,2605,167,2605,2352,253,2019-01-01,zipcode
ZCTA5 33549,12,17998,73251,1159,230500,14984,5545,13357,746,3147,4535,3046,1883,7115,6816,299,6816,5290,1526,2019-01-01,zipcode
ZCTA5 33556,12,23182,103983,1307,375600,18329,6814,16204,864,3016,4598,4599,3127,8926,8085,841,8085,7173,912,2019-01-01,zipcode
ZCTA5 33558,12,24248,82928,1099,342700,18936,6166,16469,654,2845,4528,5137,3305,9725,9047,678,9047,6288,2759,2019-01-01,zipcode
ZCTA5 33559,12,18473,68895,1211,206200,15224,4220,12476,820,2897,3900,2993,1866,7304,6743,561,6743,4023,2720,2019-01-01,zipcode
ZCTA5 33563,12,28033,46554,952,140000,21787,8130,18712,3740,6926,5030,2250,766,11082,9939,1143,9939,5282,4657,2019-01-01,zipcode
ZCTA5 33565,12,17864,53606,924,161300,14169,6190,12690,2310,4758,3607,1451,564,6721,6158,563,6158,4795,1363,2019-01-01,zipcode
ZCTA5 33566,12,21505,65064,1064,207200,16778,5917,14524,2550,4802,3636,2361,1175,7856,7369,487,7369,5307,2062,2019-01-01,zipcode
ZCTA5 33567,12,12195,60170,858,194500,9435,3314,8051,2227,2593,1939,956,336,4009,3741,268,3741,2846,895,2019-01-01,zipcode
ZCTA5 33569,12,28442,70583,1373,215800,22226,8082,19280,1660,5027,6411,4205,1977,10630,9801,829,9801,7914,1887,2019-01-01,zipcode
ZCTA5 33570,12,29967,51429,904,165200,23225,9233,20104,3453,6497,6790,2003,1361,11974,9868,2106,9868,7023,2845,2019-01-01,zipcode
ZCTA5 33572,12,20380,88654,1548,276300,16729,5822,15156,804,3132,5035,3850,2335,8726,7887,839,7887,6663,1224,2019-01-01,zipcode
ZCTA5 33573,12,23170,48644,1776,174400,21873,16496,21430,949,5987,7569,4158,2767,15152,12916,2236,12916,10395,2521,2019-01-01,zipcode
ZCTA5 33576,12,4543,63433,908,199900,4132,2677,3863,245,1083,1452,550,533,2454,2132,322,2132,1904,228,2019-01-01,zipcode
ZCTA5 33578,12,52486,64181,1283,197500,40856,11077,35095,2147,9312,12176,7625,3835,21204,19848,1356,19848,11022,8826,2019-01-01,zipcode
ZCTA5 33579,12,36005,85033,1708,227000,27039,7321,23741,2380,6005,7508,4952,2896,12060,11096,964,11096,8611,2485,2019-01-01,zipcode
ZCTA5 33584,12,26798,62004,1151,171900,21059,7751,18574,2071,6123,5810,3410,1160,10019,9217,802,9217,6970,2247,2019-01-01,zipcode
ZCTA5 33585,12,1133,51326,786,165700,948,575,889,130,358,346,38,17,513,471,42,471,340,131,2019-01-01,zipcode
ZCTA5 33592,12,11546,42308,859,112300,9204,4453,7841,1311,3082,1985,1038,425,4575,3980,595,3980,2519,1461,2019-01-01,zipcode
ZCTA5 33594,12,34941,64854,1396,188500,28703,10015,25689,2587,7590,8322,4947,2243,13609,12690,919,12690,10155,2535,2019-01-01,zipcode
ZCTA5 33596,12,30830,98993,1673,274800,24494,8405,21030,839,4423,6352,6267,3149,10467,10019,448,10019,8733,1286,2019-01-01,zipcode
ZCTA5 33597,12,7702,45335,802,105800,6362,3327,5426,1014,2153,1589,503,167,3594,2633,961,2633,2109,524,2019-01-01,zipcode
ZCTA5 33598,12,20053,66961,832,230600,15554,5856,13449,3597,3804,3204,1706,1138,6866,6138,728,6138,4734,1404,2019-01-01,zipcode
ZCTA5 33602,12,15586,72824,1597,348500,13732,4237,12667,1158,1877,2779,3351,3502,9967,8552,1415,8552,3230,5322,2019-01-01,zipcode
ZCTA5 33603,12,21366,48197,1003,192600,17089,5306,15095,2092,4313,4346,2889,1455,9545,8544,1001,8544,4469,4075,2019-01-01,zipcode
ZCTA5 33604,12,39604,43094,979,164800,32601,10923,27955,5075,9921,7082,3981,1896,16918,15220,1698,15220,8094,7126,2019-01-01,zipcode
ZCTA5 33605,12,17655,25855,996,108100,13660,6058,11688,3358,3856,2719,1234,521,8388,7092,1296,7092,2507,4585,2019-01-01,zipcode
ZCTA5 33606,12,20576,80878,1455,538700,18219,6212,12945,443,1328,2162,5090,3922,9710,8406,1304,8406,3510,4896,2019-01-01,zipcode
ZCTA5 33607,12,24384,44806,1302,172800,20718,7077,18357,3114,5716,3757,4058,1712,12469,10785,1684,10785,4356,6429,2019-01-01,zipcode
ZCTA5 33609,12,18367,71225,1169,359700,15289,4297,13407,867,1948,3168,4199,3225,9273,8311,962,8311,4627,3684,2019-01-01,zipcode
ZCTA5 33610,12,46799,36742,1019,115800,34149,13528,29206,5863,11313,7500,3133,1397,17901,16240,1661,16240,6895,9345,2019-01-01,zipcode
ZCTA5 33611,12,33070,67421,1146,281700,27506,8589,25314,1640,5615,5661,7900,4498,16809,14850,1959,14850,8679,6171,2019-01-01,zipcode
ZCTA5 33612,12,51745,32200,931,146200,40595,16605,32953,6538,12204,8489,3984,1738,20889,18866,2023,18866,6494,12372,2019-01-01,zipcode
ZCTA5 33613,12,36270,34932,886,162800,30759,11233,21028,3469,5659,5478,4239,2183,16747,14554,2193,14554,4403,10151,2019-01-01,zipcode
ZCTA5 33614,12,49060,41954,999,175100,40259,12582,34700,7128,11714,9002,5030,1826,19878,18397,1481,18397,7323,11074,2019-01-01,zipcode
ZCTA5 33615,12,47512,51672,1135,166500,38939,12367,34237,3811,11842,9409,6492,2683,19704,17455,2249,17455,9204,8251,2019-01-01,zipcode
ZCTA5 33616,12,16781,63074,1313,197200,13683,3766,11892,779,3883,3223,2616,1391,7631,6797,834,6797,3156,3641,2019-01-01,zipcode
ZCTA5 33617,12,47441,39700,999,172500,37425,11560,30580,3480,8581,9876,5267,3376,20039,18212,1827,18212,7071,11141,2019-01-01,zipcode
ZCTA5 33618,12,27352,70605,1125,278100,23292,8181,20711,775,4167,6399,5873,3497,12575,11512,1063,11512,7572,3940,2019-01-01,zipcode
ZCTA5 33619,12,40092,44085,1160,112200,31758,12330,26316,5032,9603,7394,2626,1661,14315,13208,1107,13208,6006,7202,2019-01-01,zipcode
ZCTA5 33620,12,5318,-666666666,-666666666,-666666666,5318,4264,48,11,0,27,10,0,23,11,12,11,0,11,2019-01-01,zipcode
ZCTA5 33621,12,2751,72428,2197,-666666666,1609,511,1105,0,236,463,261,145,621,570,51,570,0,570,2019-01-01,zipcode
ZCTA5 33624,12,39803,69910,1261,235400,33190,9874,29263,1598,7235,9277,7182,3971,16073,15190,883,15190,9667,5523,2019-01-01,zipcode
ZCTA5 33625,12,27305,68634,1317,234600,22405,6785,19598,1334,5515,6156,4319,2274,10972,10374,598,10374,6832,3542,2019-01-01,zipcode
ZCTA5 33626,12,30743,107269,1537,360800,23459,7062,20626,703,3134,4559,7553,4677,12621,11519,1102,11519,7716,3803,2019-01-01,zipcode
ZCTA5 33629,12,27061,128248,1361,544200,20408,6470,18601,402,1826,3271,6999,6103,11786,10694,1092,10694,8639,2055,2019-01-01,zipcode
ZCTA5 33634,12,22719,57423,1313,171500,18730,6391,15966,2117,4939,4198,3169,1543,8024,7438,586,7438,4248,3190,2019-01-01,zipcode
ZCTA5 33635,12,18650,63899,1383,197400,14773,4705,13328,1108,3602,3951,2809,1858,7891,7111,780,7111,4444,2667,2019-01-01,zipcode
ZCTA5 33637,12,17555,52004,1140,152300,14041,4005,11001,1187,2730,3357,2381,1346,7208,6429,779,6429,2622,3807,2019-01-01,zipcode
ZCTA5 33647,12,71004,88649,1383,295900,55525,16510,46971,2112,6401,11201,16153,11104,26924,24854,2070,24854,14110,10744,2019-01-01,zipcode
ZCTA5 33701,12,15728,39251,925,376100,14439,6003,12908,916,2504,3235,3800,2453,12123,8878,3245,8878,3104,5774,2019-01-01,zipcode
ZCTA5 33702,12,32019,53243,1037,169500,26882,9256,24155,2529,6613,7196,5127,2690,16184,13452,2732,13452,8516,4936,2019-01-01,zipcode
ZCTA5 33703,12,25699,77953,1290,248900,21753,7746,19523,1069,3916,6158,4927,3453,12055,10843,1212,10843,8398,2445,2019-01-01,zipcode
ZCTA5 33704,12,16982,83031,1018,384400,14563,4821,13518,587,2267,3108,4221,3335,8788,7614,1174,7614,5550,2064,2019-01-01,zipcode
ZCTA5 33705,12,28857,50637,1111,182500,24096,9752,20941,2305,5590,6445,3935,2666,14790,10919,3871,10919,6154,4765,2019-01-01,zipcode
ZCTA5 33706,12,16321,75636,1166,423300,15388,7603,14729,606,2756,4652,4045,2670,14122,8536,5586,8536,6475,2061,2019-01-01,zipcode
ZCTA5 33707,12,24767,51279,1098,210100,22519,11066,21055,1376,5692,6564,4789,2634,15710,12127,3583,12127,8395,3732,2019-01-01,zipcode
ZCTA5 33708,12,16083,62924,1230,299700,14817,7852,14033,772,3038,4795,3382,2046,13839,8168,5671,8168,6131,2037,2019-01-01,zipcode
ZCTA5 33709,12,24619,42111,949,121900,21283,9786,19183,2581,7077,5956,2530,1039,14303,10615,3688,10615,7770,2845,2019-01-01,zipcode
ZCTA5 33710,12,34222,60463,1127,194200,28927,9986,25916,2068,8020,7731,5697,2400,16114,13711,2403,13711,10540,3171,2019-01-01,zipcode
ZCTA5 33711,12,19706,46628,1151,161600,16765,7571,13238,1288,4911,3750,2048,1241,9620,6969,2651,6969,4212,2757,2019-01-01,zipcode
ZCTA5 33712,12,24738,47690,1047,191000,20728,7917,17483,1800,4692,5928,3417,1646,12169,9196,2973,9196,4885,4311,2019-01-01,zipcode
ZCTA5 33713,12,32348,56999,1099,164200,27161,9017,24318,3370,6099,7989,4645,2215,15072,12999,2073,12999,8948,4051,2019-01-01,zipcode
ZCTA5 33714,12,21866,38245,996,103700,17785,6846,15498,2845,5525,4836,1729,563,9828,7939,1889,7939,5121,2818,2019-01-01,zipcode
ZCTA5 33715,12,7296,91386,1731,384200,6825,4206,6502,141,899,1755,2055,1652,6887,3690,3197,3690,3340,350,2019-01-01,zipcode
ZCTA5 33716,12,18242,56867,1274,216800,15988,3619,13945,376,2868,4318,4265,2118,11011,9309,1702,9309,1666,7643,2019-01-01,zipcode
ZCTA5 33744,12,122,-666666666,-666666666,-666666666,122,111,111,11,100,0,0,0,0,0,0,0,0,0,2019-01-01,zipcode
ZCTA5 33755,12,26616,39406,954,194300,21324,8188,18714,2628,6319,5998,2862,907,11195,9736,1459,9736,5260,4476,2019-01-01,zipcode
ZCTA5 33756,12,33971,44271,962,195200,28147,11496,24975,2924,6374,8883,4853,1941,16228,13584,2644,13584,7909,5675,2019-01-01,zipcode
ZCTA5 33759,12,18236,52344,1283,175600,15261,6331,13641,1401,3859,4164,2749,1468,8992,7933,1059,7933,4409,3524,2019-01-01,zipcode
ZCTA5 33760,12,17336,52465,1104,147100,14528,5078,12229,1593,3611,4422,1856,747,7784,6651,1133,6651,3076,3575,2019-01-01,zipcode
ZCTA5 33761,12,19794,54151,1196,171200,17221,7996,15946,959,4005,5224,3776,1982,10336,8758,1578,8758,7081,1677,2019-01-01,zipcode
ZCTA5 33762,12,8355,68411,1340,233400,7599,3898,6779,716,1908,1895,1420,840,3032,2693,339,2693,1999,694,2019-01-01,zipcode
ZCTA5 33763,12,19730,44790,1094,128400,17520,8576,15987,1489,5271,4760,2730,1737,11245,9298,1947,9298,6606,2692,2019-01-01,zipcode
ZCTA5 33764,12,27320,52760,1189,193000,23300,9750,21108,1416,6383,7071,4224,2014,14718,11787,2931,11787,8488,3299,2019-01-01,zipcode
ZCTA5 33765,12,14744,46297,1052,158300,12554,4480,11416,1498,3164,3956,1636,1162,6710,6154,556,6154,2939,3215,2019-01-01,zipcode
ZCTA5 33767,12,7452,83770,1776,468300,7066,4304,6726,275,1477,1701,1741,1532,8363,3976,4387,3976,3255,721,2019-01-01,zipcode
ZCTA5 33770,12,26627,46355,1053,168200,22949,8931,20304,2104,6802,6873,2895,1630,14096,11621,2475,11621,6692,4929,2019-01-01,zipcode
ZCTA5 33771,12,30365,42528,1064,79300,25885,11740,23763,2461,8242,7828,3770,1462,17118,13404,3714,13404,7753,5651,2019-01-01,zipcode
ZCTA5 33772,12,23125,55200,1144,209400,19579,8347,17589,1180,5290,5884,3651,1584,12208,9848,2360,9848,7342,2506,2019-01-01,zipcode
ZCTA5 33773,12,17595,52884,1014,185800,15112,5759,13354,1066,4078,4692,2560,958,8340,7115,1225,7115,5243,1872,2019-01-01,zipcode
ZCTA5 33774,12,18097,55394,1015,222900,15051,6821,13863,1116,3872,4923,2578,1374,9884,7745,2139,7745,5549,2196,2019-01-01,zipcode
ZCTA5 33776,12,13573,80703,1566,292100,11582,4594,10334,355,2634,3051,2711,1583,5492,4964,528,4964,4534,430,2019-01-01,zipcode
ZCTA5 33777,12,16748,65207,1270,184100,13991,5839,12785,814,3807,3910,2584,1670,8136,6803,1333,6803,5582,1221,2019-01-01,zipcode
ZCTA5 33778,12,14582,50150,1074,160500,12309,5349,11369,953,3997,4191,1504,724,7571,5981,1590,5981,4681,1300,2019-01-01,zipcode
ZCTA5 33781,12,24856,42936,906,152600,20487,8028,18459,2988,6294,5337,2723,1117,11500,9772,1728,9772,6070,3702,2019-01-01,zipcode
ZCTA5 33782,12,23443,54063,1230,152400,19418,8654,17844,1923,6353,5366,2760,1442,10646,9314,1332,9314,6849,2465,2019-01-01,zipcode
ZCTA5 33785,12,5432,72222,1254,474500,5117,2380,4947,197,815,1569,1505,861,6159,2878,3281,2878,2034,844,2019-01-01,zipcode
ZCTA5 33786,12,1565,85500,2396,612400,1408,820,1348,56,200,294,457,341,1155,742,413,742,646,96,2019-01-01,zipcode
ZCTA5 33801,12,34370,36031,834,85000,27766,14368,20792,4521,7657,5395,2198,1021,14807,11788,3019,11788,5920,5868,2019-01-01,zipcode
ZCTA5 33803,12,29460,52832,1034,152800,24578,10044,21369,2119,5922,6277,4482,2569,14367,11722,2645,11722,7122,4600,2019-01-01,zipcode
ZCTA5 33805,12,25529,34525,981,92100,20472,9463,17265,3563,6301,4468,1951,982,10709,9041,1668,9041,4444,4597,2019-01-01,zipcode
ZCTA5 33809,12,30347,54465,1078,164500,25597,11174,22458,2556,7649,7762,2924,1567,13053,11147,1906,11147,7750,3397,2019-01-01,zipcode
ZCTA5 33810,12,51139,58285,1089,154800,40698,17357,35714,4687,13119,11647,4076,2185,20186,17545,2641,17545,13229,4316,2019-01-01,zipcode
ZCTA5 33811,12,22293,62678,1095,179400,18245,6985,15895,1564,5622,4870,2720,1119,9132,7975,1157,7975,5762,2213,2019-01-01,zipcode
ZCTA5 33812,12,12998,79688,1240,185500,10152,3591,8895,438,3019,2831,1587,1020,5325,4328,997,4328,3504,824,2019-01-01,zipcode
ZCTA5 33813,12,38214,83521,1199,224200,30548,11527,26822,1434,6986,8283,6315,3804,14232,13055,1177,13055,10469,2586,2019-01-01,zipcode
ZCTA5 33815,12,15148,32193,764,27900,11888,5668,9763,2015,4536,2321,624,267,7739,5690,2049,5690,3272,2418,2019-01-01,zipcode
ZCTA5 33823,12,33615,50309,862,149400,26501,12158,22957,3667,8354,6537,3109,1290,12786,11194,1592,11194,7902,3292,2019-01-01,zipcode
ZCTA5 33825,12,26420,38579,802,89900,21422,12454,18717,3472,6933,5526,1572,1214,11512,9110,2402,9110,6429,2681,2019-01-01,zipcode
ZCTA5 33827,12,3062,62631,1238,157100,2503,1284,1905,205,711,630,224,135,1246,953,293,953,832,121,2019-01-01,zipcode
ZCTA5 33830,12,28884,51083,833,134900,22502,8880,18989,2437,7821,5173,2533,1025,11362,9687,1675,9687,6287,3400,2019-01-01,zipcode
ZCTA5 33834,12,7524,48471,780,72300,5922,3580,5040,1228,2380,884,414,134,2190,1736,454,1736,1074,662,2019-01-01,zipcode
ZCTA5 33837,12,30634,57337,1348,190000,24321,10533,21609,2658,5796,7636,3801,1718,13469,9677,3792,9677,7466,2211,2019-01-01,zipcode
ZCTA5 33838,12,4358,38899,898,115600,3050,1490,2681,784,1043,718,81,55,1603,1193,410,1193,686,507,2019-01-01,zipcode
ZCTA5 33839,12,3356,50335,823,129700,2674,997,2357,512,839,683,245,78,1336,1119,217,1119,731,388,2019-01-01,zipcode
ZCTA5 33841,12,8969,43653,759,96800,7052,3335,6125,1154,2674,1508,510,279,3921,3017,904,3017,2300,717,2019-01-01,zipcode
ZCTA5 33843,12,11032,42668,731,71300,9406,6054,8312,2300,2961,2027,597,427,5101,3503,1598,3503,2781,722,2019-01-01,zipcode
ZCTA5 33844,12,36701,41883,937,124300,28902,12879,25064,4908,9436,7126,2338,1256,17135,12153,4982,12153,7866,4287,2019-01-01,zipcode
ZCTA5 33847,12,176,65750,-666666666,-666666666,123,58,87,18,32,19,11,7,47,47,0,47,39,8,2019-01-01,zipcode
ZCTA5 33848,12,1022,55750,-666666666,57000,756,309,537,219,232,66,0,20,483,169,314,169,98,71,2019-01-01,zipcode
ZCTA5 33849,12,1171,45640,-666666666,96100,946,427,838,214,394,205,13,12,423,300,123,300,256,44,2019-01-01,zipcode
ZCTA5 33850,12,8324,48341,882,120500,6754,3074,6032,1112,1945,1862,512,601,4139,3177,962,3177,2322,855,2019-01-01,zipcode
ZCTA5 33851,12,1153,48519,1063,144100,925,423,798,57,437,222,74,8,409,350,59,350,323,27,2019-01-01,zipcode
ZCTA5 33852,12,21099,39421,778,137600,18354,11201,16623,2210,7512,4559,1607,735,12468,8568,3900,8568,7060,1508,2019-01-01,zipcode
ZCTA5 33853,12,11649,37689,751,149900,9013,3577,7808,1741,2460,1949,1134,524,4937,4082,855,4082,2051,2031,2019-01-01,zipcode
ZCTA5 33854,12,294,33750,617,41000,272,168,259,23,88,86,52,10,618,188,430,188,95,93,2019-01-01,zipcode
ZCTA5 33855,12,0,-666666666,-666666666,-666666666,0,0,0,0,0,0,0,0,0,0,0,0,0,0,2019-01-01,zipcode
ZCTA5 33856,12,270,27986,541,-666666666,270,240,270,0,117,113,40,0,437,191,246,191,0,191,2019-01-01,zipcode
ZCTA5 33857,12,2377,28546,438,-666666666,1862,996,1771,484,953,291,43,0,1554,991,563,991,632,359,2019-01-01,zipcode
ZCTA5 33859,12,11025,43688,911,118600,9117,4705,7646,1219,2773,2560,723,371,5335,4332,1003,4332,3097,1235,2019-01-01,zipcode
ZCTA5 33860,12,26893,51904,988,132200,20414,8525,17702,2551,7347,5108,1859,837,9307,8141,1166,8141,6269,1872,2019-01-01,zipcode
ZCTA5 33865,12,958,57917,-666666666,-666666666,836,400,764,158,376,156,61,13,269,224,45,224,176,48,2019-01-01,zipcode
ZCTA5 33867,12,327,39038,-666666666,144200,327,231,327,38,111,77,88,13,256,166,90,166,166,0,2019-01-01,zipcode
ZCTA5 33868,12,12081,51250,867,109000,9941,5916,9096,1972,3582,2395,718,429,4652,3637,1015,3637,2999,638,2019-01-01,zipcode
ZCTA5 33870,12,22284,32364,744,84600,18737,10319,16497,3205,6171,4925,1328,868,11651,8696,2955,8696,5365,3331,2019-01-01,zipcode
ZCTA5 33872,12,15923,46574,900,105100,14060,9256,13120,1138,4381,4560,1928,1113,9509,7211,2298,7211,5801,1410,2019-01-01,zipcode
ZCTA5 33873,12,14162,37766,702,86100,10688,4779,8838,1917,4311,1649,615,346,5549,4489,1060,4489,2724,1765,2019-01-01,zipcode
ZCTA5 33875,12,11522,54054,992,150500,9990,4964,9108,880,3300,2402,1674,852,5701,4701,1000,4701,3948,753,2019-01-01,zipcode
ZCTA5 33876,12,4888,51088,1036,104800,4172,2511,3952,456,1700,1262,395,139,2635,2033,602,2033,1717,316,2019-01-01,zipcode
ZCTA5 33877,12,618,-666666666,-666666666,-666666666,457,289,201,60,106,35,0,0,139,106,33,106,36,70,2019-01-01,zipcode
ZCTA5 33880,12,40519,44239,907,117100,31762,13476,27460,6290,9903,7902,1993,1372,16390,13686,2704,13686,8904,4782,2019-01-01,zipcode
ZCTA5 33881,12,34340,40897,897,93200,28001,14871,24570,3852,8953,7544,2662,1559,16100,13059,3041,13059,8958,4101,2019-01-01,zipcode
ZCTA5 33884,12,32019,60298,1150,180900,26534,11761,23162,1851,6748,8058,4072,2433,14412,11973,2439,11973,8554,3419,2019-01-01,zipcode
ZCTA5 33890,12,4773,36082,719,83800,3524,1710,2985,697,1612,455,140,81,1828,1483,345,1483,1167,316,2019-01-01,zipcode
ZCTA5 33896,12,11654,63958,1546,205400,9727,3058,8142,896,2070,3035,1459,682,5227,3610,1617,3610,2128,1482,2019-01-01,zipcode
ZCTA5 33897,12,22752,60430,1559,168600,18334,6576,15909,1249,5760,5997,2099,804,12513,7009,5504,7009,4897,2112,2019-01-01,zipcode
ZCTA5 33898,12,16931,45193,899,118800,14149,6988,12611,2432,4816,3555,1256,552,9252,6318,2934,6318,4937,1381,2019-01-01,zipcode
ZCTA5 33901,12,21364,38112,933,194900,17706,8011,15766,2955,4853,4011,2438,1509,10780,8701,2079,8701,3596,5105,2019-01-01,zipcode
ZCTA5 33903,12,22657,43870,923,101200,20172,12122,18703,2687,6576,6011,2126,1303,14757,10711,4046,10711,8457,2254,2019-01-01,zipcode
ZCTA5 33904,12,31086,51861,1161,236800,27867,13798,26101,2335,9061,8359,4486,1860,19632,13395,6237,13395,10295,3100,2019-01-01,zipcode
ZCTA5 33905,12,37492,51634,1059,164000,30826,13777,26615,5716,9039,7008,3048,1804,14793,11778,3015,11778,7890,3888,2019-01-01,zipcode
ZCTA5 33907,12,24429,42530,1137,155700,20212,7795,18009,2654,5382,4910,3414,1649,12878,9536,3342,9536,4119,5417,2019-01-01,zipcode
ZCTA5 33908,12,36513,59596,1414,270600,33582,20730,31539,1579,8471,8374,7760,5355,31436,17577,13859,17577,12628,4949,2019-01-01,zipcode
ZCTA5 33909,12,31750,60105,1245,187500,25156,9352,21547,2011,8663,6711,3034,1128,11563,10215,1348,10215,6602,3613,2019-01-01,zipcode
ZCTA5 33912,12,18646,77333,1413,278800,16538,8974,15280,606,3403,4524,3911,2836,11378,7979,3399,7979,6681,1298,2019-01-01,zipcode
ZCTA5 33913,12,25497,85268,1639,307000,21979,10820,18821,1283,3902,5170,5090,3376,12934,8959,3975,8959,7744,1215,2019-01-01,zipcode
ZCTA5 33914,12,38281,65381,1189,282900,33812,14961,30578,2211,10748,9499,4928,3192,20535,14916,5619,14916,11526,3390,2019-01-01,zipcode
ZCTA5 33916,12,24907,36349,988,111600,18329,7027,15872,3986,4865,3792,2052,1177,11274,8553,2721,8553,3038,5515,2019-01-01,zipcode
ZCTA5 33917,12,30049,49671,854,107700,26402,15211,24852,3070,9466,7402,3059,1855,17245,12570,4675,12570,10329,2241,2019-01-01,zipcode
ZCTA5 33919,12,30330,56932,1192,202600,26714,12993,24937,1424,6121,7992,5615,3785,18705,13933,4772,13933,10329,3604,2019-01-01,zipcode
ZCTA5 33920,12,6243,78377,926,265100,5370,2508,4867,629,1487,1775,579,397,2492,2098,394,2098,1893,205,2019-01-01,zipcode
ZCTA5 33921,12,813,101250,-666666666,1198700,794,530,755,46,93,316,141,159,1919,331,1588,331,276,55,2019-01-01,zipcode
ZCTA5 33922,12,4108,47143,972,196500,3573,2202,3447,344,1103,1153,449,398,2779,1704,1075,1704,1442,262,2019-01-01,zipcode
ZCTA5 33924,12,195,-666666666,-666666666,-666666666,195,72,183,78,33,34,25,13,1893,45,1848,45,34,11,2019-01-01,zipcode
ZCTA5 33928,12,25141,79078,1681,313500,21851,12688,20876,1117,4210,6165,5523,3861,17771,11090,6681,11090,9566,1524,2019-01-01,zipcode
ZCTA5 33930,12,930,52713,-666666666,136800,598,182,482,80,248,113,0,41,426,357,69,357,302,55,2019-01-01,zipcode
ZCTA5 33931,12,10566,64738,1128,362000,10338,7241,10170,599,2561,3094,2142,1774,15227,5467,9760,5467,4873,594,2019-01-01,zipcode
ZCTA5 33935,12,23513,39098,765,96100,17549,7162,14648,4944,4888,3482,765,569,8262,6911,1351,6911,4664,2247,2019-01-01,zipcode
ZCTA5 33936,12,24517,38567,919,131300,20101,9203,17838,3254,7117,4762,1811,894,9938,8254,1684,8254,5088,3166,2019-01-01,zipcode
ZCTA5 33944,12,219,-666666666,-666666666,-666666666,97,70,97,0,97,0,0,0,105,70,35,70,70,0,2019-01-01,zipcode
ZCTA5 33945,12,0,-666666666,-666666666,-666666666,0,0,0,0,0,0,0,0,217,0,217,0,0,0,2019-01-01,zipcode
ZCTA5 33946,12,2104,93547,1707,482700,2073,1397,2073,46,614,577,586,250,2794,1083,1711,1083,978,105,2019-01-01,zipcode
ZCTA5 33947,12,9096,53302,1161,248200,8524,5670,7981,500,2818,2663,1260,740,5684,4179,1505,4179,3541,638,2019-01-01,zipcode
ZCTA5 33948,12,17122,47394,1047,178900,15087,8280,13780,1203,4689,4927,1674,1287,8969,7005,1964,7005,5663,1342,2019-01-01,zipcode
ZCTA5 33950,12,23299,57852,995,283900,21539,14545,20308,1159,5310,6715,4493,2631,16049,11663,4386,11663,9556,2107,2019-01-01,zipcode
ZCTA5 33952,12,33390,42484,972,148200,29006,14534,26228,3304,9792,8626,3112,1394,15937,13437,2500,13437,9380,4057,2019-01-01,zipcode
ZCTA5 33953,12,6741,56451,1330,223800,6357,4205,6006,527,1931,2112,870,566,3973,2929,1044,2929,2672,257,2019-01-01,zipcode
ZCTA5 33954,12,10573,60841,1259,209200,9171,4554,8280,833,2929,2697,1273,548,4346,3944,402,3944,3112,832,2019-01-01,zipcode
ZCTA5 33955,12,11436,65558,1196,242700,10574,7066,9899,1600,2956,2759,1667,917,6661,4444,2217,4444,4045,399,2019-01-01,zipcode
ZCTA5 33956,12,3489,51774,1176,230800,3439,2449,3236,311,1080,1009,309,527,3224,1680,1544,1680,1452,228,2019-01-01,zipcode
ZCTA5 33957,12,7319,108081,1545,721200,6758,4234,6617,152,945,1475,2021,2024,8945,3684,5261,3684,3151,533,2019-01-01,zipcode
ZCTA5 33960,12,672,39514,-666666666,109500,593,291,570,56,284,156,59,15,580,291,289,291,273,18,2019-01-01,zipcode
ZCTA5 33965,12,1735,-666666666,-666666666,-666666666,1735,847,28,0,0,28,0,0,0,0,0,0,0,0,2019-01-01,zipcode
ZCTA5 33966,12,10065,64686,1158,265800,8716,4168,7752,449,1725,2195,2029,1354,5921,4249,1672,4249,3107,1142,2019-01-01,zipcode
ZCTA5 33967,12,25129,67996,1335,224700,20504,6010,16556,2087,4185,5870,3205,1209,9991,8190,1801,8190,6143,2047,2019-01-01,zipcode
ZCTA5 33971,12,27941,53840,1184,168300,20987,7219,17135,3448,6311,5074,1504,798,8139,7396,743,7396,5322,2074,2019-01-01,zipcode
ZCTA5 33972,12,15515,62092,1158,179100,12306,4887,10479,1695,3676,3458,1153,497,5341,4506,835,4506,3355,1151,2019-01-01,zipcode
ZCTA5 33973,12,17161,42991,1051,217600,11288,4186,9332,2354,3366,2340,800,472,4419,4097,322,4097,962,3135,2019-01-01,zipcode
ZCTA5 33974,12,17757,49645,1241,162600,13343,4788,11375,1738,4464,3168,1457,548,5440,4692,748,4692,2986,1706,2019-01-01,zipcode
ZCTA5 33976,12,18245,50190,1212,150000,13171,4192,10892,2684,3719,2984,1232,273,4902,4555,347,4555,3172,1383,2019-01-01,zipcode
ZCTA5 33980,12,13342,46451,862,151300,11686,7791,10731,1074,3511,3653,1525,968,7944,5775,2169,5775,4326,1449,2019-01-01,zipcode
ZCTA5 33981,12,11407,55568,1247,256300,10128,6077,9696,408,3736,3451,1395,706,6444,4656,1788,4656,3941,715,2019-01-01,zipcode
ZCTA5 33982,12,10391,49750,960,124800,9103,5470,8409,1244,3054,2742,668,701,5141,4067,1074,4067,3323,744,2019-01-01,zipcode
ZCTA5 33983,12,15100,58148,1061,221300,12726,6995,11689,902,4008,3675,1967,1137,7819,5897,1922,5897,4868,1029,2019-01-01,zipcode
ZCTA5 33990,12,34657,59541,1167,215500,29558,12122,26587,2225,10152,8854,3606,1750,14040,11417,2623,11417,8208,3209,2019-01-01,zipcode
ZCTA5 33991,12,22516,69179,1501,240800,17903,6520,15818,826,5471,4640,3541,1340,9344,7722,1622,7722,5964,1758,2019-01-01,zipcode
ZCTA5 33993,12,27905,67680,1461,219100,22704,8980,19181,1949,7894,5426,2615,1297,10028,8588,1440,8588,6865,1723,2019-01-01,zipcode
ZCTA5 34101,12,0,-666666666,-666666666,-666666666,0,0,0,0,0,0,0,0,14,0,14,0,0,0,2019-01-01,zipcode
ZCTA5 34102,12,11548,85938,1262,1016900,10524,5889,9795,719,1430,2220,3212,2214,9745,5598,4147,5598,3993,1605,2019-01-01,zipcode
ZCTA5 34103,12,13129,95559,1433,768400,12067,7275,11330,520,2312,2748,3316,2434,11409,6115,5294,6115,4860,1255,2019-01-01,zipcode
ZCTA5 34104,12,24520,53303,1229,249700,21044,10010,19281,2459,5690,5530,3184,2418,15176,10494,4682,10494,7193,3301,2019-01-01,zipcode
ZCTA5 34105,12,18011,87617,1614,459700,15835,7914,14565,639,2870,4131,4349,2576,10863,7901,2962,7901,5210,2691,2019-01-01,zipcode
ZCTA5 34108,12,16450,100705,1459,735800,15232,9182,14450,546,2678,3042,4202,3982,14402,7928,6474,7928,6452,1476,2019-01-01,zipcode
ZCTA5 34109,12,24251,72095,1447,405100,21005,10407,19558,1231,4406,4216,6067,3638,14716,11064,3652,11064,6990,4074,2019-01-01,zipcode
ZCTA5 34110,12,23988,78410,1583,402100,21516,12687,20077,762,4139,5226,5262,4688,16694,11018,5676,11018,8314,2704,2019-01-01,zipcode
ZCTA5 34112,12,27064,57792,1118,227900,24155,13314,22300,2387,6789,6170,4149,2805,19295,11865,7430,11865,9100,2765,2019-01-01,zipcode
ZCTA5 34113,12,22175,57365,1333,321000,19315,9387,16603,2837,4605,3990,3251,1920,13822,8546,5276,8546,6048,2498,2019-01-01,zipcode
ZCTA5 34114,12,18223,60746,1274,255000,16370,9346,15028,1609,4776,4227,2688,1728,13362,7882,5480,7882,6505,1377,2019-01-01,zipcode
ZCTA5 34116,12,36111,52131,1242,249700,28081,7702,24024,6593,8545,5292,2405,1189,10464,9640,824,9640,5088,4552,2019-01-01,zipcode
ZCTA5 34117,12,17039,77035,1526,297900,14092,4695,11805,1886,3742,3310,1868,999,5230,4769,461,4769,4314,455,2019-01-01,zipcode
ZCTA5 34119,12,32911,92266,1621,456200,27281,14032,24391,887,5018,6653,6733,5100,16808,13103,3705,13103,10314,2789,2019-01-01,zipcode
ZCTA5 34120,12,35498,83398,1687,330200,27340,9321,24115,2539,7764,6347,4043,3422,13520,10702,2818,10702,9313,1389,2019-01-01,zipcode
ZCTA5 34134,12,14992,91019,1238,501000,14122,9815,13729,451,2541,3555,4095,3087,14340,7622,6718,7622,6529,1093,2019-01-01,zipcode
ZCTA5 34135,12,47356,66616,1290,280100,41564,22398,38237,5390,8868,10666,8081,5232,29415,19166,10249,19166,15321,3845,2019-01-01,zipcode
ZCTA5 34137,12,651,-666666666,-666666666,-666666666,278,115,278,0,187,91,0,0,159,159,0,159,84,75,2019-01-01,zipcode
ZCTA5 34138,12,340,-666666666,-666666666,-666666666,294,156,294,0,144,91,59,0,351,155,196,155,108,47,2019-01-01,zipcode
ZCTA5 34139,12,204,61250,863,234600,185,55,177,5,58,51,41,22,409,115,294,115,94,21,2019-01-01,zipcode
ZCTA5 34140,12,337,30489,-666666666,-666666666,249,170,196,0,46,110,40,0,412,98,314,98,52,46,2019-01-01,zipcode
ZCTA5 34141,12,67,-666666666,-666666666,-666666666,59,23,36,0,0,14,4,18,18,18,0,18,4,14,2019-01-01,zipcode
ZCTA5 34142,12,30534,35172,805,166000,22310,7577,17513,9570,4588,2048,952,355,8129,7088,1041,7088,3188,3900,2019-01-01,zipcode
ZCTA5 34145,12,17834,86215,1638,678900,16568,9838,15780,1152,3094,4458,4523,2553,18495,8379,10116,8379,7335,1044,2019-01-01,zipcode
ZCTA5 34201,12,3997,95164,1888,453500,3584,2355,3395,129,523,688,1032,1023,2471,1846,625,1846,1715,131,2019-01-01,zipcode
ZCTA5 34202,12,24637,102703,1842,445600,20580,9880,18662,501,2909,4821,5640,4791,11707,9529,2178,9529,7429,2100,2019-01-01,zipcode
ZCTA5 34203,12,38971,54558,1045,202800,31911,13893,29241,3596,9954,8897,4375,2419,18234,14278,3956,14278,10646,3632,2019-01-01,zipcode
ZCTA5 34205,12,32294,42816,993,144900,26309,11316,23363,3958,7725,7106,2995,1579,15703,12313,3390,12313,7126,5187,2019-01-01,zipcode
ZCTA5 34207,12,36292,39812,978,79200,30136,13817,26250,4693,10262,7126,2524,1645,19218,14608,4610,14608,8342,6266,2019-01-01,zipcode
ZCTA5 34208,12,40998,48664,1065,172100,32141,13134,27386,5848,9467,6538,3688,1845,14963,12747,2216,12747,7347,5400,2019-01-01,zipcode
ZCTA5 34209,12,35172,60037,1232,227200,31229,15485,28164,1652,8903,9142,5042,3425,18490,14668,3822,14668,11202,3466,2019-01-01,zipcode
ZCTA5 34210,12,16462,49662,1139,201500,14760,7674,12986,865,3901,4192,2481,1547,10928,7084,3844,7084,4209,2875,2019-01-01,zipcode
ZCTA5 34211,12,8898,109194,1698,383100,7746,3855,7032,224,1453,2149,2020,1186,5150,3730,1420,3730,3336,394,2019-01-01,zipcode
ZCTA5 34212,12,21244,96307,1634,355000,16847,6650,14961,277,3110,4919,4035,2620,8965,7549,1416,7549,6051,1498,2019-01-01,zipcode
ZCTA5 34215,12,596,48015,-666666666,900000,579,381,522,0,118,177,100,127,556,271,285,271,228,43,2019-01-01,zipcode
ZCTA5 34216,12,724,74000,-666666666,888000,686,443,672,30,138,188,168,148,1360,384,976,384,356,28,2019-01-01,zipcode
ZCTA5 34217,12,5079,68029,1304,590000,4772,2751,4626,111,774,1578,1176,987,6624,2743,3881,2743,2077,666,2019-01-01,zipcode
ZCTA5 34219,12,24750,83831,1758,277300,20263,8298,18249,823,4862,6431,4285,1848,10093,8617,1476,8617,7652,965,2019-01-01,zipcode
ZCTA5 34221,12,46357,57983,1108,169600,38096,17945,33707,4263,11878,10197,4627,2742,20236,15269,4967,15269,11972,3297,2019-01-01,zipcode
ZCTA5 34222,12,11659,54718,989,101700,10223,5710,9381,639,3096,3810,1231,605,7415,5236,2179,5236,4205,1031,2019-01-01,zipcode
ZCTA5 34223,12,18336,54586,1041,235700,17123,11826,16545,726,6139,4788,2766,2126,13848,9209,4639,9209,7520,1689,2019-01-01,zipcode
ZCTA5 34224,12,16422,45210,979,163100,15112,8759,13755,1235,5546,3970,1698,1306,10929,7441,3488,7441,5812,1629,2019-01-01,zipcode
ZCTA5 34228,12,7283,114762,1625,740500,7183,5655,7065,230,804,1477,2284,2270,9338,3838,5500,3838,3607,231,2019-01-01,zipcode
ZCTA5 34229,12,7674,87039,1211,449500,6707,3920,6352,244,1116,1322,1760,1910,4364,3377,987,3377,2833,544,2019-01-01,zipcode
ZCTA5 34231,12,30341,53332,1182,255300,26482,11683,24494,1778,6596,7485,5147,3488,18415,14505,3910,14505,9141,5364,2019-01-01,zipcode
ZCTA5 34232,12,35240,67146,1403,223100,29859,10496,26868,2171,9818,7401,5014,2464,15432,13767,1665,13767,9659,4108,2019-01-01,zipcode
ZCTA5 34233,12,17767,65738,1472,258300,15099,6705,13774,1006,4133,3665,3193,1777,9176,7891,1285,7891,5832,2059,2019-01-01,zipcode
ZCTA5 34234,12,21932,38243,1015,139300,18134,8452,15541,2506,5561,3914,2226,1334,10372,8784,1588,8784,4692,4092,2019-01-01,zipcode
ZCTA5 34235,12,15303,58740,1395,234500,13494,6705,12038,705,3233,3506,2579,2015,8320,6661,1659,6661,5008,1653,2019-01-01,zipcode
ZCTA5 34236,12,13217,69331,1176,685100,12414,7431,12025,870,1569,3028,3323,3235,11244,7251,3993,7251,4418,2833,2019-01-01,zipcode
ZCTA5 34237,12,18071,47756,1152,148600,15451,5625,13674,2096,4432,3844,2290,1012,8621,6916,1705,6916,3461,3455,2019-01-01,zipcode
ZCTA5 34238,12,20049,76465,1632,366600,18401,10903,17308,333,3423,4223,4467,4862,12922,10091,2831,10091,7895,2196,2019-01-01,zipcode
ZCTA5 34239,12,15716,60733,1355,279600,13621,5140,12326,978,2850,3655,3063,1780,8438,6869,1569,6869,4897,1972,2019-01-01,zipcode
ZCTA5 34240,12,11442,92000,1469,393500,9312,4320,8268,373,1886,2187,2066,1756,5657,3946,1711,3946,3740,206,2019-01-01,zipcode
ZCTA5 34241,12,15568,83316,1727,363900,13118,6098,11935,430,2929,3543,3067,1966,6701,5963,738,5963,5125,838,2019-01-01,zipcode
ZCTA5 34242,12,7465,111190,1713,719700,6946,4160,6560,197,748,1649,2134,1832,10950,3852,7098,3852,3288,564,2019-01-01,zipcode
ZCTA5 34243,12,31901,64847,1559,275000,28018,13599,25222,1471,5882,7337,6213,4319,15856,13292,2564,13292,10226,3066,2019-01-01,zipcode
ZCTA5 34251,12,7115,72500,895,352200,5509,1803,4716,531,2060,1313,543,269,2292,2028,264,2028,1890,138,2019-01-01,zipcode
ZCTA5 34266,12,32229,34078,688,83500,26273,13435,22474,6523,10063,3746,1520,622,12238,9972,2266,9972,6673,3299,2019-01-01,zipcode
ZCTA5 34268,12,157,-666666666,-666666666,-666666666,128,128,128,80,48,0,0,0,173,88,85,88,40,48,2019-01-01,zipcode
ZCTA5 34269,12,4517,43393,802,149900,4128,2716,3832,390,1475,1060,633,274,2778,2012,766,2012,1705,307,2019-01-01,zipcode
ZCTA5 34275,12,20472,65713,1153,304900,18185,10020,16396,763,5053,4647,3464,2469,11520,9339,2181,9339,7692,1647,2019-01-01,zipcode
ZCTA5 34285,12,18653,54890,1231,222400,18030,12409,17021,639,5128,4760,3779,2715,15483,9900,5583,9900,7650,2250,2019-01-01,zipcode
ZCTA5 34286,12,20178,63743,1538,184500,15742,7017,13523,1790,4748,4256,1922,807,7192,6494,698,6494,5593,901,2019-01-01,zipcode
ZCTA5 34287,12,28614,51017,1118,148900,24537,13965,22474,1978,8900,7201,2799,1596,14788,11278,3510,11278,8377,2901,2019-01-01,zipcode
ZCTA5 34288,12,11511,62469,1314,196900,9472,4246,8255,700,2892,2987,995,681,4835,4239,596,4239,3518,721,2019-01-01,zipcode
ZCTA5 34289,12,3481,59471,1240,193500,2847,844,2265,38,310,1066,457,394,2042,1337,705,1337,515,822,2019-01-01,zipcode
ZCTA5 34291,12,5626,63287,1423,199100,4647,1936,4196,341,1833,1369,460,193,1893,1893,0,1893,1580,313,2019-01-01,zipcode
ZCTA5 34292,12,15398,65991,1723,315300,14209,9963,13558,612,3379,3860,3421,2286,9869,7789,2080,7789,6238,1551,2019-01-01,zipcode
ZCTA5 34293,12,39534,63063,1331,242100,35607,20058,33362,1575,9696,10254,7217,4620,23222,18096,5126,18096,15606,2490,2019-01-01,zipcode
ZCTA5 34420,12,17749,46435,841,109700,14584,5792,12843,1865,5181,4398,1023,376,8166,6755,1411,6755,4729,2026,2019-01-01,zipcode
ZCTA5 34428,12,9043,42096,696,132600,7823,4007,6977,908,2546,2536,688,299,5059,3993,1066,3993,2975,1018,2019-01-01,zipcode
ZCTA5 34429,12,8338,44958,962,126500,7422,4328,6693,624,2275,2222,806,766,5010,3835,1175,3835,3225,610,2019-01-01,zipcode
ZCTA5 34431,12,8002,39812,790,119600,6752,3803,6204,700,2615,1921,613,355,4344,3561,783,3561,2907,654,2019-01-01,zipcode
ZCTA5 34432,12,12673,44577,889,139900,11035,7019,10402,1337,3666,3245,1463,691,6642,5542,1100,5542,4790,752,2019-01-01,zipcode
ZCTA5 34433,12,6574,53989,907,134400,5622,2956,5158,871,2053,1416,560,258,3424,2829,595,2829,2499,330,2019-01-01,zipcode
ZCTA5 34434,12,8021,46250,1103,140800,6378,3061,5959,610,2412,2043,694,200,4012,3111,901,3111,2492,619,2019-01-01,zipcode
ZCTA5 34436,12,8169,36875,706,104500,7134,4031,6293,1078,2497,1915,361,442,4543,3572,971,3572,2945,627,2019-01-01,zipcode
ZCTA5 34442,12,14752,50009,821,163500,13395,8856,12385,987,4279,3687,1783,1649,8847,6831,2016,6831,5984,847,2019-01-01,zipcode
ZCTA5 34445,12,0,-666666666,-666666666,-666666666,0,0,0,0,0,0,0,0,0,0,0,0,0,0,2019-01-01,zipcode
ZCTA5 34446,12,17454,48084,884,146000,15437,10588,14343,1358,4989,4913,2009,1074,9338,7975,1363,7975,7060,915,2019-01-01,zipcode
ZCTA5 34448,12,10394,44717,871,90500,8984,5307,8374,839,3392,3009,893,241,6448,4723,1725,4723,3778,945,2019-01-01,zipcode
ZCTA5 34449,12,3192,28333,491,81400,2906,1553,2720,440,1203,814,189,74,1858,1416,442,1416,1020,396,2019-01-01,zipcode
ZCTA5 34450,12,10692,38406,761,119800,9298,5453,8447,947,2830,3001,981,688,6371,5059,1312,5059,3700,1359,2019-01-01,zipcode
ZCTA5 34452,12,11903,44789,892,114000,10151,5540,9033,1004,3524,3236,880,389,5790,4852,938,4852,4018,834,2019-01-01,zipcode
ZCTA5 34453,12,10621,39055,858,102100,8880,5115,8248,1696,3036,2378,816,322,5546,4337,1209,4337,3428,909,2019-01-01,zipcode
ZCTA5 34461,12,11380,46939,797,182500,10445,7087,9366,1054,3872,2563,1197,680,5942,4469,1473,4469,3542,927,2019-01-01,zipcode
ZCTA5 34465,12,17455,40101,859,159000,14988,9255,13897,1411,5153,4915,1438,980,9072,7948,1124,7948,6392,1556,2019-01-01,zipcode
ZCTA5 34470,12,19794,39101,867,108500,15827,7051,13747,1690,4976,4793,1637,651,9223,7721,1502,7721,4285,3436,2019-01-01,zipcode
ZCTA5 34471,12,25734,50405,927,195500,20865,8329,17419,1327,5354,5178,3150,2410,11723,10038,1685,10038,6137,3901,2019-01-01,zipcode
ZCTA5 34472,12,31344,44925,968,116200,24293,10455,20363,2817,7659,6530,2234,1123,12116,10503,1613,10503,7412,3091,2019-01-01,zipcode
ZCTA5 34473,12,19998,56113,1068,157000,16404,7420,14513,1580,5781,4635,1953,564,7868,6729,1139,6729,5351,1378,2019-01-01,zipcode
ZCTA5 34474,12,17143,44639,1057,133000,13936,6110,12528,1344,3804,3867,2232,1281,8191,7042,1149,7042,3263,3779,2019-01-01,zipcode
ZCTA5 34475,12,13179,25893,728,90400,10408,6387,9032,2271,3499,2060,873,329,5128,4446,682,4446,2130,2316,2019-01-01,zipcode
ZCTA5 34476,12,23279,52888,989,154200,19747,11610,18464,1461,5844,6409,2807,1943,11610,10047,1563,10047,8934,1113,2019-01-01,zipcode
ZCTA5 34479,12,13603,46354,872,104900,10870,4757,9596,1131,3881,2853,1260,471,5747,5068,679,5068,3468,1600,2019-01-01,zipcode
ZCTA5 34480,12,19188,55431,845,164100,15689,6299,13296,1365,4720,3906,1816,1489,8067,6826,1241,6826,4941,1885,2019-01-01,zipcode
ZCTA5 34481,12,20963,44754,968,123900,19514,14570,18487,1456,6109,5977,3363,1582,12035,10473,1562,10473,9491,982,2019-01-01,zipcode
ZCTA5 34482,12,24352,44282,781,151400,21036,13101,18939,3825,7300,4903,2143,768,9243,7332,1911,7332,5580,1752,2019-01-01,zipcode
ZCTA5 34484,12,3637,47195,959,232500,2984,1377,2742,251,970,833,415,273,1852,1504,348,1504,1043,461,2019-01-01,zipcode
ZCTA5 34488,12,10424,38429,825,58100,8349,4663,7449,1178,3146,2171,813,141,5612,4162,1450,4162,3153,1009,2019-01-01,zipcode
ZCTA5 34491,12,26614,45945,883,168400,23262,15199,22092,2151,8669,7139,2582,1551,15015,12236,2779,12236,10728,1508,2019-01-01,zipcode
ZCTA5 34498,12,585,41094,1018,164400,453,273,428,44,152,139,70,23,528,272,256,272,207,65,2019-01-01,zipcode
ZCTA5 34601,12,22487,38389,779,94400,19024,10612,17158,2619,5802,5223,2361,1153,11982,10017,1965,10017,6940,3077,2019-01-01,zipcode
ZCTA5 34602,12,7697,55915,937,152100,6413,3248,5757,990,2127,1519,653,468,2910,2735,175,2735,2306,429,2019-01-01,zipcode
ZCTA5 34604,12,12608,60278,941,155100,10249,5036,9019,1098,3486,2865,1065,505,4552,4104,448,4104,3464,640,2019-01-01,zipcode
ZCTA5 34606,12,27209,42769,955,132100,22849,13088,20603,2179,7555,6764,2775,1330,13798,11749,2049,11749,8897,2852,2019-01-01,zipcode
ZCTA5 34607,12,8403,48779,1053,214800,7555,4489,6730,675,2022,2504,1054,475,5003,3810,1193,3810,3179,631,2019-01-01,zipcode
ZCTA5 34608,12,34802,49529,1051,136000,28675,14069,25211,3168,9064,9085,2616,1278,14800,13479,1321,13479,9790,3689,2019-01-01,zipcode
ZCTA5 34609,12,42227,57257,1147,167800,34238,16456,30300,2977,9888,11337,3997,2101,17459,15884,1575,15884,12483,3401,2019-01-01,zipcode
ZCTA5 34610,12,14698,54469,1004,158000,12193,5655,10483,1878,3742,3263,1142,458,5713,5017,696,5017,3963,1054,2019-01-01,zipcode
ZCTA5 34613,12,17924,44375,947,101200,16020,10292,15144,2003,5579,5128,1605,829,10381,8511,1870,8511,7302,1209,2019-01-01,zipcode
ZCTA5 34614,12,7195,57451,1158,160700,5970,2723,5176,718,1737,1917,436,368,2961,2628,333,2628,2495,133,2019-01-01,zipcode
ZCTA5 34637,12,8411,81981,-666666666,236300,7054,4743,6273,774,1597,1848,1215,839,2607,2174,433,2174,1916,258,2019-01-01,zipcode
ZCTA5 34638,12,28609,91543,1506,259900,20442,6194,17817,1081,3948,5676,5023,2089,9720,9117,603,9117,7376,1741,2019-01-01,zipcode
ZCTA5 34639,12,29395,88694,1348,250500,23357,7643,20307,1281,4771,6405,5345,2505,10528,10030,498,10030,8227,1803,2019-01-01,zipcode
ZCTA5 34652,12,23688,39309,926,109800,20459,10433,18348,2206,6938,6306,1944,954,14554,10721,3833,10721,6334,4387,2019-01-01,zipcode
ZCTA5 34653,12,34588,41145,1013,105400,28808,14183,25658,2887,9990,8673,2816,1292,17515,14829,2686,14829,9030,5799,2019-01-01,zipcode
ZCTA5 34654,12,22935,48000,1032,162000,19406,10231,17499,2230,6383,5814,1966,1106,10453,8880,1573,8880,6860,2020,2019-01-01,zipcode
ZCTA5 34655,12,41872,65239,1240,229400,34703,15862,31450,2053,9198,10561,6246,3392,19938,17114,2824,17114,13536,3578,2019-01-01,zipcode
ZCTA5 34661,12,104,-666666666,-666666666,159900,104,52,104,0,81,9,14,0,80,52,28,52,52,0,2019-01-01,zipcode
ZCTA5 34667,12,33272,43958,934,138800,29397,17532,27337,2738,10451,8883,3335,1930,19698,15529,4169,15529,11260,4269,2019-01-01,zipcode
ZCTA5 34668,12,48146,38087,983,94700,39831,18963,34749,4523,14123,11553,3086,1464,22892,19709,3183,19709,12170,7539,2019-01-01,zipcode
ZCTA5 34669,12,13304,49196,1022,152000,11002,5253,9622,922,4056,3161,1040,443,5845,5186,659,5186,4145,1041,2019-01-01,zipcode
ZCTA5 34677,12,22169,63385,1158,243500,18401,7142,15945,980,4131,4777,3968,2089,10062,8729,1333,8729,6279,2450,2019-01-01,zipcode
ZCTA5 34679,12,43,-666666666,-666666666,-666666666,43,37,43,0,38,5,0,0,51,33,18,33,16,17,2019-01-01,zipcode
ZCTA5 34681,12,730,55198,-666666666,384800,629,367,562,32,49,97,323,61,452,334,118,334,334,0,2019-01-01,zipcode
ZCTA5 34683,12,33514,66513,1234,275400,28323,11531,25220,1506,5813,8621,6100,3180,15663,13358,2305,13358,10122,3236,2019-01-01,zipcode
ZCTA5 34684,12,29088,54340,1344,192600,25627,11846,22958,1207,6433,8176,4932,2210,14623,12958,1665,12958,8897,4061,2019-01-01,zipcode
ZCTA5 34685,12,17998,82782,1337,354600,15141,6415,13472,536,2876,3908,3725,2427,7765,7025,740,7025,5316,1709,2019-01-01,zipcode
ZCTA5 34688,12,7443,84338,1603,363400,6393,3162,5954,307,1200,1847,1617,983,3608,3096,512,3096,2666,430,2019-01-01,zipcode
ZCTA5 34689,12,27445,48890,858,206000,23487,11516,20955,2175,6505,6839,3304,2132,13511,10814,2697,10814,7801,3013,2019-01-01,zipcode
ZCTA5 34690,12,11408,37081,1034,76500,9954,4954,8844,1057,4094,2627,801,265,6786,5387,1399,5387,3411,1976,2019-01-01,zipcode
ZCTA5 34691,12,20257,39619,1039,89800,16789,7952,15201,1391,6935,4581,1704,590,11959,8725,3234,8725,5699,3026,2019-01-01,zipcode
ZCTA5 34695,12,18382,76988,1301,263800,15305,5800,13876,629,3666,3948,3821,1812,8301,7374,927,7374,6091,1283,2019-01-01,zipcode
ZCTA5 34698,12,38720,49541,1081,199000,34437,16710,31918,2469,9327,9772,6744,3606,21624,18136,3488,18136,12420,5716,2019-01-01,zipcode
ZCTA5 34705,12,2860,59000,903,115900,2179,780,1868,339,756,623,130,20,1153,964,189,964,766,198,2019-01-01,zipcode
ZCTA5 34711,12,61594,72159,1408,237300,50255,20649,44475,3576,11348,15742,9009,4800,24566,21883,2683,21883,17117,4766,2019-01-01,zipcode
ZCTA5 34714,12,22380,53472,1241,193100,17825,5852,15003,840,4257,5337,3536,1033,10047,7830,2217,7830,3817,4013,2019-01-01,zipcode
ZCTA5 34715,12,18241,68504,1485,253800,14571,5773,12431,1054,3591,4502,2355,929,6238,5648,590,5648,3965,1683,2019-01-01,zipcode
ZCTA5 34731,12,14858,49824,944,177700,12802,6520,11885,1046,3977,4028,1664,1170,7508,6452,1056,6452,5214,1238,2019-01-01,zipcode
ZCTA5 34734,12,4591,67356,1355,304000,3359,1370,2878,252,830,835,658,303,1414,1414,0,1414,1199,215,2019-01-01,zipcode
ZCTA5 34736,12,19271,62258,1208,198500,15104,6252,13422,2151,3844,4414,2053,960,6835,6324,511,6324,5091,1233,2019-01-01,zipcode
ZCTA5 34737,12,2942,75341,1338,244400,2428,1010,2190,198,681,633,406,272,1410,1133,277,1133,915,218,2019-01-01,zipcode
ZCTA5 34739,12,243,-666666666,-666666666,95400,195,97,195,61,43,52,39,0,487,150,337,150,125,25,2019-01-01,zipcode
ZCTA5 34741,12,47710,38071,1126,162300,36380,12456,31152,4865,9647,10948,4052,1640,20833,15729,5104,15729,4580,11149,2019-01-01,zipcode
ZCTA5 34743,12,45109,47909,1294,179200,36932,13582,30463,4827,10473,10221,3531,1411,13517,12099,1418,12099,8116,3983,2019-01-01,zipcode
ZCTA5 34744,12,57134,52191,1203,219500,44814,16570,37547,5040,11032,12457,6441,2577,19070,16163,2907,16163,10005,6158,2019-01-01,zipcode
ZCTA5 34746,12,44307,56160,1412,201800,35586,12762,30369,4229,8656,9908,5200,2376,22631,13137,9494,13137,8681,4456,2019-01-01,zipcode
ZCTA5 34747,12,21354,66747,1505,325500,17722,5351,14876,416,3067,4257,4395,2741,25150,8024,17126,8024,3708,4316,2019-01-01,zipcode
ZCTA5 34748,12,39977,45059,911,156900,34452,21428,31578,3538,11682,10039,3856,2463,21359,17890,3469,17890,12883,5007,2019-01-01,zipcode
ZCTA5 34753,12,5932,42956,897,155900,4510,1822,3735,749,1648,1128,113,97,1797,1709,88,1709,1341,368,2019-01-01,zipcode
ZCTA5 34756,12,3505,75071,1125,287400,2826,1094,2363,184,516,999,436,228,1343,1208,135,1208,993,215,2019-01-01,zipcode
ZCTA5 34758,12,43143,53510,1243,172400,33376,12446,27136,4012,10709,8375,2615,1425,13648,10680,2968,10680,7276,3404,2019-01-01,zipcode
ZCTA5 34759,12,40713,50748,1291,184000,31133,15888,26630,4438,7454,8597,3846,2295,15369,11982,3387,11982,8878,3104,2019-01-01,zipcode
ZCTA5 34760,12,863,64018,1563,215100,688,139,619,46,159,326,78,10,342,299,43,299,225,74,2019-01-01,zipcode
ZCTA5 34761,12,45864,68152,1363,237100,34911,10313,30017,4429,6685,8852,6924,3127,15603,14645,958,14645,9898,4747,2019-01-01,zipcode
ZCTA5 34762,12,544,61083,-666666666,-666666666,528,310,507,136,221,107,27,16,294,249,45,249,249,0,2019-01-01,zipcode
ZCTA5 34769,12,24995,46033,1015,156600,19380,7949,16762,2557,6259,5553,1743,650,10442,8092,2350,8092,5230,2862,2019-01-01,zipcode
ZCTA5 34771,12,21052,76624,1144,297800,16883,7181,13990,1171,4125,4904,2652,1138,7537,6171,1366,6171,5555,616,2019-01-01,zipcode
ZCTA5 34772,12,31436,68343,1372,223500,23631,8234,20632,1902,6104,8295,3094,1237,10762,8953,1809,8953,7679,1274,2019-01-01,zipcode
ZCTA5 34773,12,3728,63515,1527,209600,2515,1189,2062,301,449,635,438,239,1559,1023,536,1023,760,263,2019-01-01,zipcode
ZCTA5 34785,12,38097,61341,929,296800,36666,28924,35414,3235,10958,10167,6102,4952,18647,15270,3377,15270,13649,1621,2019-01-01,zipcode
ZCTA5 34786,12,45836,105075,1814,450700,33758,10463,29769,847,3073,7731,11758,6360,16475,14778,1697,14778,10595,4183,2019-01-01,zipcode
ZCTA5 34787,12,69976,81711,1236,321200,53842,16597,46921,4533,10220,12711,11825,7632,26087,23543,2544,23543,17221,6322,2019-01-01,zipcode
ZCTA5 34788,12,18193,44404,1037,90800,16100,9339,15134,1674,5712,4987,1844,917,9943,8324,1619,8324,6927,1397,2019-01-01,zipcode
ZCTA5 34797,12,1041,77167,-666666666,197100,952,517,904,0,322,433,67,82,622,418,204,418,404,14,2019-01-01,zipcode
ZCTA5 34945,12,5187,50880,1006,178500,4450,2737,3830,875,1080,1159,490,226,1848,1432,416,1432,1217,215,2019-01-01,zipcode
ZCTA5 34946,12,6079,39361,808,88300,5347,2501,4537,739,1580,1611,455,152,3041,2397,644,2397,1684,713,2019-01-01,zipcode
ZCTA5 34947,12,14155,34055,998,110100,10250,3916,8440,1988,3603,1862,664,323,5041,4294,747,4294,1574,2720,2019-01-01,zipcode
ZCTA5 34949,12,7663,64736,1162,280200,7444,5076,7266,302,1668,2140,1750,1406,7944,4254,3690,4254,3312,942,2019-01-01,zipcode
ZCTA5 34950,12,16603,30150,827,100900,13122,5500,11078,3248,3723,2996,867,244,7195,5867,1328,5867,2187,3680,2019-01-01,zipcode
ZCTA5 34951,12,17106,43850,972,114100,15122,7981,13343,2073,4789,4184,1569,728,8854,7073,1781,7073,5898,1175,2019-01-01,zipcode
ZCTA5 34952,12,41567,47770,1242,146700,35792,16406,32427,3083,11972,11645,3936,1791,21258,17026,4232,17026,11517,5509,2019-01-01,zipcode
ZCTA5 34953,12,70705,62696,1449,211700,55059,18265,46344,6782,14892,14892,6638,3140,23888,21839,2049,21839,17866,3973,2019-01-01,zipcode
ZCTA5 34956,12,10258,39661,818,91900,8048,4365,6729,2406,2284,1517,356,166,2771,2298,473,2298,1496,802,2019-01-01,zipcode
ZCTA5 34957,12,23204,55206,1107,257900,20739,11367,19165,1303,5365,5975,4117,2405,17874,11013,6861,11013,8139,2874,2019-01-01,zipcode
ZCTA5 34972,12,20877,39875,748,105700,16528,8634,14238,4178,5438,3109,1128,385,7329,5757,1572,5757,3748,2009,2019-01-01,zipcode
ZCTA5 34974,12,23952,42500,786,105900,20249,10682,17886,2837,7195,5714,1544,596,13881,9784,4097,9784,7673,2111,2019-01-01,zipcode
ZCTA5 34981,12,5393,51159,1018,232900,4576,1763,3990,419,1792,1007,422,350,2070,1754,316,1754,1067,687,2019-01-01,zipcode
ZCTA5 34982,12,25135,40436,1055,115600,20548,9378,18109,3140,6677,5525,1871,896,11456,10000,1456,10000,7109,2891,2019-01-01,zipcode
ZCTA5 34983,12,42818,54579,1434,176600,35176,14836,30389,3850,10922,10174,3326,2117,15299,13908,1391,13908,10486,3422,2019-01-01,zipcode
ZCTA5 34984,12,16035,69556,1429,198800,13110,4791,11529,1318,3422,4363,1766,660,6338,5563,775,5563,4673,890,2019-01-01,zipcode
ZCTA5 34986,12,28265,62719,1562,262100,23432,14565,22217,2464,5595,6161,4632,3365,13924,11838,2086,11838,9440,2398,2019-01-01,zipcode
ZCTA5 34987,12,9717,72007,1813,276400,7878,4439,7451,480,2004,2199,1809,959,4353,3725,628,3725,2757,968,2019-01-01,zipcode
ZCTA5 34990,12,29999,86444,1585,367300,25397,12106,22601,1158,3809,7616,6582,3436,13715,11806,1909,11806,10290,1516,2019-01-01,zipcode
ZCTA5 34994,12,17800,48085,1125,186100,14759,7264,13190,1094,3532,4639,2344,1581,9489,7438,2051,7438,4568,2870,2019-01-01,zipcode
ZCTA5 34996,12,10741,69227,1089,284900,9826,5995,9369,442,1903,3029,2123,1872,8671,5468,3203,5468,4580,888,2019-01-01,zipcode
ZCTA5 34997,12,44632,58789,1121,253500,37992,17298,34442,3436,9745,11425,6379,3457,21168,17875,3293,17875,14071,3804,2019-01-01,zipcode
ZCTA5 35004,01,12045,62902,886,158900,9226,2899,8212,435,2909,3322,1144,402,4716,4624,92,4624,3733,891,2019-01-01,zipcode
ZCTA5 35005,01,7344,50473,859,97200,5784,2757,5163,849,1939,1641,589,145,3254,2697,557,2697,2057,640,2019-01-01,zipcode
ZCTA5 35006,01,2883,55909,788,104300,2331,1170,2046,327,959,578,108,74,1519,1018,501,1018,919,99,2019-01-01,zipcode
ZCTA5 35007,01,26332,73587,1036,168200,20097,7044,17429,1929,4390,5780,3482,1848,9891,9292,599,9292,7639,1653,2019-01-01,zipcode
ZCTA5 35010,01,20613,41954,659,99900,16590,8101,14553,2940,4658,4473,1532,950,10202,7987,2215,7987,5669,2318,2019-01-01,zipcode
ZCTA5 35013,01,46,-666666666,-666666666,-666666666,46,46,46,46,0,0,0,0,23,17,6,17,9,8,2019-01-01,zipcode
ZCTA5 35014,01,4963,47691,968,88500,4307,2498,3601,885,1283,1046,202,185,1870,1655,215,1655,1477,178,2019-01-01,zipcode
ZCTA5 35016,01,17208,46157,591,138400,13573,6317,11768,1428,3475,4437,1604,824,7388,6496,892,6496,4761,1735,2019-01-01,zipcode
ZCTA5 35019,01,2492,38080,638,136100,2056,1053,1702,259,635,579,201,28,1048,907,141,907,750,157,2019-01-01,zipcode
ZCTA5 35020,01,25757,29133,732,68800,20827,9377,17711,3428,6797,5395,1598,493,13206,10088,3118,10088,5066,5022,2019-01-01,zipcode
ZCTA5 35022,01,21587,61516,869,181500,18212,6284,15570,1315,4514,4825,3073,1843,9378,8580,798,8580,6921,1659,2019-01-01,zipcode
ZCTA5 35023,01,23523,54614,879,117900,18789,8493,16164,1967,6191,5313,1739,954,9362,8357,1005,8357,6143,2214,2019-01-01,zipcode
ZCTA5 35031,01,7779,47674,590,133600,6467,3535,5384,1187,1692,1774,432,299,3612,2806,806,2806,1993,813,2019-01-01,zipcode
ZCTA5 35032,01,44,29750,-666666666,77500,35,19,32,3,18,7,0,4,23,15,8,15,13,2,2019-01-01,zipcode
ZCTA5 35033,01,2946,50682,628,121300,2332,1181,2001,456,592,693,143,117,1508,1130,378,1130,969,161,2019-01-01,zipcode
ZCTA5 35034,01,6416,39087,770,46800,5272,3345,4496,1451,1791,827,300,127,1592,1197,395,1197,830,367,2019-01-01,zipcode
ZCTA5 35035,01,821,42167,-666666666,89300,797,388,731,61,381,146,106,37,596,334,262,334,321,13,2019-01-01,zipcode
ZCTA5 35036,01,204,16591,293,83800,141,63,117,33,66,11,7,0,131,88,43,88,26,62,2019-01-01,zipcode
ZCTA5 35040,01,17311,62508,1059,148700,12809,4017,10934,931,3019,3973,2139,872,6827,6185,642,6185,5057,1128,2019-01-01,zipcode
ZCTA5 35042,01,6078,52550,394,115700,5072,2259,4550,632,2056,1224,306,332,2869,2330,539,2330,1808,522,2019-01-01,zipcode
ZCTA5 35043,01,12153,100864,1257,238600,8802,2583,7835,224,1418,3006,2129,1058,4233,4002,231,4002,3808,194,2019-01-01,zipcode
ZCTA5 35044,01,7409,38152,501,97600,5845,2298,5073,1020,2047,1613,277,116,3551,3091,460,3091,1834,1257,2019-01-01,zipcode
ZCTA5 35045,01,15143,45853,697,127700,12218,5498,10611,1848,4539,2677,965,582,6765,5915,850,5915,4126,1789,2019-01-01,zipcode
ZCTA5 35046,01,5017,52031,768,127100,3893,1889,3416,546,1418,895,370,187,2865,2060,805,2060,1573,487,2019-01-01,zipcode
ZCTA5 35049,01,3856,47212,623,117500,3034,1195,2593,535,956,826,172,104,1659,1376,283,1376,1089,287,2019-01-01,zipcode
ZCTA5 35051,01,9838,51782,635,156000,8017,3995,6966,1125,2574,1575,1211,481,3860,3452,408,3452,2693,759,2019-01-01,zipcode
ZCTA5 35052,01,283,-666666666,-666666666,-666666666,283,217,283,71,96,92,24,0,23,23,0,23,0,23,2019-01-01,zipcode
ZCTA5 35053,01,2398,54537,825,165600,2013,1079,1850,306,557,540,308,139,2791,892,1899,892,834,58,2019-01-01,zipcode
ZCTA5 35054,01,4318,46441,750,162600,3746,2047,3278,681,1210,824,373,190,2407,1931,476,1931,1762,169,2019-01-01,zipcode
ZCTA5 35055,01,21153,46953,681,130900,16629,6934,14054,2351,4263,4719,1800,921,8725,7838,887,7838,4887,2951,2019-01-01,zipcode
ZCTA5 35057,01,14187,49786,751,146300,11096,4411,9726,1682,3444,3390,707,503,6414,4977,1437,4977,4079,898,2019-01-01,zipcode
ZCTA5 35058,01,8630,43188,756,133900,7097,3337,6441,1186,2156,2154,639,306,4025,3446,579,3446,2615,831,2019-01-01,zipcode
ZCTA5 35060,01,272,23889,-666666666,-666666666,208,137,172,34,88,23,0,27,243,132,111,132,108,24,2019-01-01,zipcode
ZCTA5 35061,01,1130,44375,980,89500,939,309,795,125,135,438,86,11,575,417,158,417,218,199,2019-01-01,zipcode
ZCTA5 35062,01,7904,52741,755,125000,6263,2765,5495,977,1825,1713,636,344,3415,3049,366,3049,2575,474,2019-01-01,zipcode
ZCTA5 35063,01,3629,56538,790,81100,2905,1445,2527,494,906,1052,63,12,1752,1264,488,1264,1123,141,2019-01-01,zipcode
ZCTA5 35064,01,11048,40570,756,98400,9091,4163,7500,745,2728,2633,915,479,5698,4581,1117,4581,2535,2046,2019-01-01,zipcode
ZCTA5 35068,01,7967,62823,1001,153200,6523,2263,5662,682,1579,2042,914,445,3449,3379,70,3379,2341,1038,2019-01-01,zipcode
ZCTA5 35070,01,296,37708,563,103700,206,81,173,50,62,61,0,0,109,103,6,103,81,22,2019-01-01,zipcode
ZCTA5 35071,01,16052,70963,933,172700,12877,5047,11120,726,3316,3973,1959,1146,6848,6328,520,6328,4979,1349,2019-01-01,zipcode
ZCTA5 35072,01,4410,37622,456,71400,3488,1728,3226,729,1399,791,149,158,2560,1700,860,1700,1339,361,2019-01-01,zipcode
ZCTA5 35073,01,2074,39826,842,91200,1725,872,1534,248,543,537,166,40,992,826,166,826,705,121,2019-01-01,zipcode
ZCTA5 35074,01,99,-666666666,-666666666,-666666666,99,0,99,46,0,53,0,0,53,53,0,53,0,53,2019-01-01,zipcode
ZCTA5 35077,01,13821,39490,647,115000,11511,5859,9732,2118,3266,3178,754,416,6179,5262,917,5262,3890,1372,2019-01-01,zipcode
ZCTA5 35078,01,1927,62557,1000,159500,1578,707,1399,310,454,443,121,71,927,733,194,733,607,126,2019-01-01,zipcode
ZCTA5 35079,01,9055,61837,833,139800,7174,3437,6352,655,2505,2383,553,256,3589,3058,531,3058,2896,162,2019-01-01,zipcode
ZCTA5 35080,01,18471,88952,1331,188500,13790,3962,12001,481,2052,3845,4040,1583,6601,6374,227,6374,5869,505,2019-01-01,zipcode
ZCTA5 35082,01,0,-666666666,-666666666,-666666666,0,0,0,0,0,0,0,0,0,0,0,0,0,0,2019-01-01,zipcode
ZCTA5 35083,01,3191,35750,736,110100,2532,1379,2235,530,856,659,138,52,1430,1273,157,1273,967,306,2019-01-01,zipcode
ZCTA5 35085,01,8901,43542,741,92400,7169,3275,5788,1156,2683,1363,380,206,3624,3191,433,3191,2465,726,2019-01-01,zipcode
ZCTA5 35087,01,2571,31789,738,115900,2112,1065,1840,437,564,736,52,51,1041,980,61,980,600,380,2019-01-01,zipcode
ZCTA5 35089,01,1954,32402,625,95500,1758,933,1558,397,587,422,97,55,1000,803,197,803,653,150,2019-01-01,zipcode
ZCTA5 35091,01,3118,82500,896,193600,2237,698,1961,119,650,658,330,204,1174,1074,100,1074,984,90,2019-01-01,zipcode
ZCTA5 35094,01,15059,60422,824,165000,11571,4346,10180,1050,2804,3415,1883,1028,6374,5646,728,5646,4533,1113,2019-01-01,zipcode
ZCTA5 35096,01,8221,55766,858,114000,6908,2882,6063,1076,1966,2096,696,229,4210,3111,1099,3111,2528,583,2019-01-01,zipcode
ZCTA5 35097,01,1884,45950,919,118400,1473,839,1323,239,556,389,89,50,651,631,20,631,571,60,2019-01-01,zipcode
ZCTA5 35098,01,1091,31429,-666666666,88600,847,363,714,164,188,264,27,71,602,428,174,428,407,21,2019-01-01,zipcode
ZCTA5 35111,01,16325,71662,799,199300,13121,4683,11123,778,3338,3884,2177,946,6476,5765,711,5765,5225,540,2019-01-01,zipcode
ZCTA5 35112,01,281,-666666666,-666666666,-666666666,234,90,234,17,125,92,0,0,124,124,0,124,109,15,2019-01-01,zipcode
ZCTA5 35114,01,8310,85183,1086,193600,6525,1965,5451,422,827,1743,1523,936,3148,2982,166,2982,2576,406,2019-01-01,zipcode
ZCTA5 35115,01,14988,42034,801,127600,12384,5018,9035,1359,3329,2388,1308,651,5978,5459,519,5459,3555,1904,2019-01-01,zipcode
ZCTA5 35116,01,4332,66414,880,167700,3499,1354,3068,200,995,1170,489,214,1831,1689,142,1689,1415,274,2019-01-01,zipcode
ZCTA5 35117,01,5478,71956,729,159000,4425,1530,3841,303,1046,1536,729,227,2258,2157,101,2157,1929,228,2019-01-01,zipcode
ZCTA5 35118,01,3467,62368,780,134700,2733,1263,2449,368,1034,764,185,98,1416,1192,224,1192,976,216,2019-01-01,zipcode
ZCTA5 35119,01,282,-666666666,-666666666,-666666666,209,68,209,108,40,61,0,0,89,89,0,89,61,28,2019-01-01,zipcode
ZCTA5 35120,01,14424,67703,698,147900,11160,3843,9293,1318,3378,3213,934,450,5453,4824,629,4824,4017,807,2019-01-01,zipcode
ZCTA5 35121,01,16123,44308,682,123300,12810,6696,11026,2941,3123,3494,921,547,6793,6014,779,6014,4027,1987,2019-01-01,zipcode
ZCTA5 35124,01,24387,79847,1115,193500,19672,6145,17357,1165,2987,5843,4714,2648,10206,9582,624,9582,8219,1363,2019-01-01,zipcode
ZCTA5 35125,01,9931,46094,818,138100,8337,3668,7455,1679,2775,2123,613,265,4830,4095,735,4095,2595,1500,2019-01-01,zipcode
ZCTA5 35126,01,20749,67823,914,149400,16906,6530,14135,1239,4900,5086,2108,802,8063,7562,501,7562,6395,1167,2019-01-01,zipcode
ZCTA5 35127,01,9651,70526,1134,157400,8062,2982,6922,463,2096,2678,1001,684,3954,3610,344,3610,3118,492,2019-01-01,zipcode
ZCTA5 35128,01,10573,61354,863,172400,8592,3378,7532,1016,2292,2623,1170,431,5010,4294,716,4294,3136,1158,2019-01-01,zipcode
ZCTA5 35130,01,2925,37977,469,85200,2436,1227,2145,555,928,538,56,68,1786,1291,495,1291,1040,251,2019-01-01,zipcode
ZCTA5 35131,01,4696,40033,606,124700,3585,1783,3017,688,1256,672,220,181,1889,1503,386,1503,1104,399,2019-01-01,zipcode
ZCTA5 35133,01,3222,50121,860,122500,2457,1292,2311,301,879,833,213,85,1466,1221,245,1221,1128,93,2019-01-01,zipcode
ZCTA5 35135,01,2514,56422,923,190500,1874,556,1649,169,571,620,202,87,1026,894,132,894,576,318,2019-01-01,zipcode
ZCTA5 35136,01,2197,41339,417,131000,1837,949,1577,203,540,579,199,56,1247,784,463,784,644,140,2019-01-01,zipcode
ZCTA5 35139,01,161,15469,-666666666,16100,161,84,127,80,39,8,0,0,108,108,0,108,65,43,2019-01-01,zipcode
ZCTA5 35143,01,2880,68355,542,155100,2441,1014,2290,286,811,783,332,78,2147,1199,948,1199,1139,60,2019-01-01,zipcode
ZCTA5 35146,01,11175,80351,767,197800,9209,4546,8267,1314,2827,2447,1037,642,3756,3340,416,3340,3048,292,2019-01-01,zipcode
ZCTA5 35147,01,6022,74593,1350,193300,4587,1505,4049,433,849,1174,1135,458,2509,2198,311,2198,1960,238,2019-01-01,zipcode
ZCTA5 35148,01,2183,41424,531,105100,1768,848,1506,230,614,591,66,5,1136,907,229,907,595,312,2019-01-01,zipcode
ZCTA5 35149,01,251,41144,-666666666,105300,251,66,169,14,155,0,0,0,172,132,40,132,93,39,2019-01-01,zipcode
ZCTA5 35150,01,16991,31819,623,106300,13292,6484,11516,2302,3805,3804,1174,431,8379,6953,1426,6953,4310,2643,2019-01-01,zipcode
ZCTA5 35151,01,7649,48820,811,110100,6350,3146,5681,1115,1832,1692,620,422,3780,2956,824,2956,2570,386,2019-01-01,zipcode
ZCTA5 35160,01,25999,34210,563,92300,21498,11755,18235,3964,6389,5162,1632,1088,12396,9948,2448,9948,6627,3321,2019-01-01,zipcode
ZCTA5 35171,01,3254,56410,776,106800,2674,1315,2341,556,901,492,288,104,1385,1242,143,1242,1056,186,2019-01-01,zipcode
ZCTA5 35172,01,3000,34052,684,83600,2511,1294,2300,441,931,736,156,36,1407,1240,167,1240,843,397,2019-01-01,zipcode
ZCTA5 35173,01,27514,89923,1193,241000,20651,7376,18333,947,3800,6273,4682,2631,10050,9320,730,9320,8357,963,2019-01-01,zipcode
ZCTA5 35175,01,5289,52938,648,141800,4285,1867,3780,704,1209,994,595,278,2478,2003,475,2003,1666,337,2019-01-01,zipcode
ZCTA5 35176,01,784,-666666666,688,77000,657,329,545,248,161,63,37,36,358,341,17,341,201,140,2019-01-01,zipcode
ZCTA5 35178,01,3202,34088,636,99000,2356,1220,2044,386,705,716,181,56,1540,1248,292,1248,1045,203,2019-01-01,zipcode
ZCTA5 35179,01,8616,47437,709,132100,6891,2917,6166,1068,2503,1908,446,241,3803,3296,507,3296,2792,504,2019-01-01,zipcode
ZCTA5 35180,01,14967,58750,582,142000,11623,5203,10151,1409,3838,3502,948,454,5999,5668,331,5668,4806,862,2019-01-01,zipcode
ZCTA5 35183,01,918,56579,-666666666,79600,777,264,698,92,385,186,28,7,398,304,94,304,254,50,2019-01-01,zipcode
ZCTA5 35184,01,4666,38313,787,81300,3808,2073,3308,848,1491,695,212,62,2410,1641,769,1641,1151,490,2019-01-01,zipcode
ZCTA5 35186,01,5085,64796,929,184400,4292,2048,3649,388,1182,1215,545,319,2344,2008,336,2008,1667,341,2019-01-01,zipcode
ZCTA5 35187,01,6,-666666666,-666666666,-666666666,6,6,6,0,0,6,0,0,3,3,0,3,3,0,2019-01-01,zipcode
ZCTA5 35188,01,3014,57750,-666666666,128100,2434,1032,2142,239,1207,537,119,40,988,894,94,894,745,149,2019-01-01,zipcode
ZCTA5 35203,01,3125,17248,551,214500,3014,1749,2650,553,885,428,453,331,1922,1688,234,1688,317,1371,2019-01-01,zipcode
ZCTA5 35204,01,9262,23027,609,63900,7666,4136,6700,1589,2306,2047,491,267,5817,4321,1496,4321,1488,2833,2019-01-01,zipcode
ZCTA5 35205,01,20857,39236,802,179900,18794,6380,13990,950,2576,3557,3986,2921,12710,9797,2913,9797,2566,7231,2019-01-01,zipcode
ZCTA5 35206,01,17713,33852,856,76900,13921,6037,12227,2048,4306,4132,1252,489,8595,6860,1735,6860,3456,3404,2019-01-01,zipcode
ZCTA5 35207,01,8696,24533,546,63300,6638,3370,5746,1083,2082,1814,468,299,4519,3544,975,3544,1993,1551,2019-01-01,zipcode
ZCTA5 35208,01,13719,36014,852,73900,10780,4791,9153,1118,3323,3551,857,304,7204,5439,1765,5439,2943,2496,2019-01-01,zipcode
ZCTA5 35209,01,28252,59931,997,344000,22235,5968,17672,854,2684,4026,4908,5200,15207,11992,3215,11992,5853,6139,2019-01-01,zipcode
ZCTA5 35210,01,14022,55394,988,146900,11672,4232,10440,986,2691,2850,2796,1117,6884,6101,783,6101,4108,1993,2019-01-01,zipcode
ZCTA5 35211,01,24745,32051,836,77900,20116,8361,17349,2678,4718,5808,2737,1408,15037,11441,3596,11441,4996,6445,2019-01-01,zipcode
ZCTA5 35212,01,11295,30240,591,133200,8714,3385,7644,1188,2275,2275,1161,745,6019,4766,1253,4766,2123,2643,2019-01-01,zipcode
ZCTA5 35213,01,14062,122379,1479,541400,10819,3675,9585,70,425,1003,4764,3323,6097,5693,404,5693,4310,1383,2019-01-01,zipcode
ZCTA5 35214,01,17789,51871,789,107700,14753,6249,13149,1072,3974,4797,2332,974,8678,7308,1370,7308,5127,2181,2019-01-01,zipcode
ZCTA5 35215,01,48680,42519,850,103700,35301,12405,29807,3826,10121,10612,3580,1668,20800,18173,2627,18173,10006,8167,2019-01-01,zipcode
ZCTA5 35216,01,36856,63348,1045,275400,28013,7374,24344,1177,3757,6268,8019,5123,16346,14819,1527,14819,8079,6740,2019-01-01,zipcode
ZCTA5 35217,01,13256,35551,699,79900,10616,4775,9066,1670,3395,2827,853,321,6182,4932,1250,4932,2703,2229,2019-01-01,zipcode
ZCTA5 35218,01,7235,27012,793,64700,5493,2329,4833,618,1619,2139,365,92,3686,2842,844,2842,1187,1655,2019-01-01,zipcode
ZCTA5 35221,01,4484,36313,844,67300,3684,1851,3192,545,1139,1164,281,63,2523,1771,752,1771,1127,644,2019-01-01,zipcode
ZCTA5 35222,01,8989,62246,767,242900,7425,2249,6654,553,868,1464,2008,1761,4799,4147,652,4147,2370,1777,2019-01-01,zipcode
ZCTA5 35223,01,11111,141604,1669,506500,8890,3550,7787,51,259,1167,3191,3119,4552,4197,355,4197,3600,597,2019-01-01,zipcode
ZCTA5 35224,01,5328,37983,772,68400,4204,1861,3530,400,1401,1308,304,117,2778,2033,745,2033,1208,825,2019-01-01,zipcode
ZCTA5 35226,01,35331,106905,1264,279600,26961,7993,24077,543,2836,4876,8717,7105,13870,13117,753,13117,10351,2766,2019-01-01,zipcode
ZCTA5 35228,01,10059,33486,866,66100,8068,3446,6892,1136,2589,2212,813,142,4653,3781,872,3781,2272,1509,2019-01-01,zipcode
ZCTA5 35229,01,1255,-666666666,-666666666,-666666666,1255,836,0,0,0,0,0,0,0,0,0,0,0,0,2019-01-01,zipcode
ZCTA5 35233,01,1730,41994,1284,188400,1701,703,1025,62,83,102,422,356,1451,921,530,921,87,834,2019-01-01,zipcode
ZCTA5 35234,01,5063,24205,597,59500,4541,2543,4157,1033,1274,1472,313,65,2632,1905,727,1905,873,1032,2019-01-01,zipcode
ZCTA5 35235,01,21340,56301,994,119100,16777,5514,14713,1349,4035,5472,2487,1370,8994,8139,855,8139,5613,2526,2019-01-01,zipcode
ZCTA5 35242,01,56340,98780,1140,355700,45562,14834,39568,898,4393,9776,15406,9095,24081,22156,1925,22156,15804,6352,2019-01-01,zipcode
ZCTA5 35243,01,17059,89007,1272,358000,14129,4375,12630,128,859,2604,5089,3950,9167,7702,1465,7702,4544,3158,2019-01-01,zipcode
ZCTA5 35244,01,31941,91323,1130,295900,25559,7537,22250,907,2832,5807,7795,4909,13550,12261,1289,12261,8593,3668,2019-01-01,zipcode
ZCTA5 35254,01,1598,-666666666,675,-666666666,1577,1113,192,49,91,0,35,17,218,155,63,155,63,92,2019-01-01,zipcode
ZCTA5 35401,01,37705,26216,784,118700,32937,18743,17092,3114,6134,3737,2112,1995,18382,11371,7011,11371,4106,7265,2019-01-01,zipcode
ZCTA5 35404,01,22345,40651,882,130000,18585,7545,13263,1830,4237,4164,2174,858,10878,7757,3121,7757,3983,3774,2019-01-01,zipcode
ZCTA5 35405,01,45391,56711,861,172800,36800,12676,29713,2592,8278,8789,6314,3740,19768,16962,2806,16962,9528,7434,2019-01-01,zipcode
ZCTA5 35406,01,17914,104172,998,353000,13813,4921,12303,385,971,2363,4580,4004,7783,6905,878,6905,5363,1542,2019-01-01,zipcode
ZCTA5 35441,01,972,41071,595,55500,754,358,677,137,236,181,82,41,832,392,440,392,356,36,2019-01-01,zipcode
ZCTA5 35442,01,6730,31921,540,77800,5568,3330,4769,1083,1531,1455,523,177,2565,2007,558,2007,1416,591,2019-01-01,zipcode
ZCTA5 35443,01,1777,15000,574,34200,1303,827,974,192,513,230,27,12,1120,534,586,534,289,245,2019-01-01,zipcode
ZCTA5 35444,01,3972,50644,870,117000,3249,1349,2761,455,1061,924,258,63,1565,1428,137,1428,1202,226,2019-01-01,zipcode
ZCTA5 35446,01,2147,42314,860,117200,1728,843,1499,320,601,389,128,61,753,721,32,721,609,112,2019-01-01,zipcode
ZCTA5 35447,01,3032,40088,432,89700,2498,1264,2195,433,845,642,192,83,1669,1164,505,1164,873,291,2019-01-01,zipcode
ZCTA5 35452,01,3416,52762,864,167500,2791,1267,2478,453,878,760,248,139,1346,1189,157,1189,958,231,2019-01-01,zipcode
ZCTA5 35453,01,10721,58750,794,140800,8292,3207,7329,1278,3061,1981,616,393,4392,3672,720,3672,3135,537,2019-01-01,zipcode
ZCTA5 35456,01,4051,50634,854,138000,3060,1407,2746,589,1216,636,180,125,1529,1300,229,1300,1034,266,2019-01-01,zipcode
ZCTA5 35457,01,0,-666666666,-666666666,-666666666,0,0,0,0,0,0,0,0,0,0,0,0,0,0,2019-01-01,zipcode
ZCTA5 35458,01,445,43875,-666666666,161100,429,153,373,15,215,83,29,31,178,161,17,161,126,35,2019-01-01,zipcode
ZCTA5 35459,01,1156,32750,636,48800,979,527,814,184,334,231,35,30,535,397,138,397,306,91,2019-01-01,zipcode
ZCTA5 35460,01,956,22396,525,99200,889,559,673,47,166,291,111,58,484,401,83,401,334,67,2019-01-01,zipcode
ZCTA5 35461,01,2093,50361,625,155400,1765,813,1591,199,583,563,161,85,1158,895,263,895,832,63,2019-01-01,zipcode
ZCTA5 35462,01,4447,23323,621,84000,3501,1983,3303,809,1012,1101,229,152,2739,1777,962,1777,1206,571,2019-01-01,zipcode
ZCTA5 35463,01,2074,55602,-666666666,132700,1637,497,1495,98,609,514,234,40,874,761,113,761,680,81,2019-01-01,zipcode
ZCTA5 35464,01,854,11731,335,-666666666,567,437,435,45,175,146,67,2,415,306,109,306,150,156,2019-01-01,zipcode
ZCTA5 35466,01,5441,44402,507,103100,4279,1998,3743,547,1442,1114,406,234,2478,2122,356,2122,1687,435,2019-01-01,zipcode
ZCTA5 35469,01,311,36012,-666666666,83700,278,255,278,27,111,90,46,4,199,88,111,88,61,27,2019-01-01,zipcode
ZCTA5 35470,01,4836,22884,554,108700,3853,1999,2401,250,796,673,287,395,2342,1850,492,1850,919,931,2019-01-01,zipcode
ZCTA5 35473,01,16294,64949,859,182000,12700,4539,10613,874,2647,2891,2457,1744,6891,6220,671,6220,4305,1915,2019-01-01,zipcode
ZCTA5 35474,01,6617,55342,804,136700,5312,1966,4471,624,1691,1232,567,357,2797,2276,521,2276,1853,423,2019-01-01,zipcode
ZCTA5 35475,01,15952,79222,741,192800,12513,4169,10932,915,3221,3441,1930,1425,6476,5557,919,5557,4975,582,2019-01-01,zipcode
ZCTA5 35476,01,7208,36821,778,140400,5520,2182,4665,673,1408,1483,661,440,3259,2732,527,2732,1278,1454,2019-01-01,zipcode
ZCTA5 35477,01,137,-666666666,-666666666,-666666666,137,83,118,5,44,57,6,6,160,62,98,62,62,0,2019-01-01,zipcode
ZCTA5 35480,01,1007,83438,-666666666,189300,840,400,831,80,360,253,92,46,410,329,81,329,293,36,2019-01-01,zipcode
ZCTA5 35481,01,3174,31458,430,81500,2755,1490,2315,501,975,668,129,42,1764,1450,314,1450,941,509,2019-01-01,zipcode
ZCTA5 35490,01,3911,56150,936,120300,3033,1156,2527,495,990,682,231,129,1618,1272,346,1272,919,353,2019-01-01,zipcode
ZCTA5 35501,01,10208,37014,593,95800,7769,3688,6612,1301,2355,2256,440,260,4877,3780,1097,3780,2202,1578,2019-01-01,zipcode
ZCTA5 35503,01,8798,53344,733,120900,7381,3132,6454,1065,2353,2293,506,237,4245,3499,746,3499,2780,719,2019-01-01,zipcode
ZCTA5 35504,01,12832,58403,641,158400,10534,4801,9090,1022,3084,3058,1353,573,6105,4949,1156,4949,3971,978,2019-01-01,zipcode
ZCTA5 35540,01,2786,42648,331,87400,2268,1181,1942,326,890,555,109,62,1325,1123,202,1123,880,243,2019-01-01,zipcode
ZCTA5 35541,01,3399,51646,438,154300,2958,1498,2695,487,931,740,247,290,2692,1514,1178,1514,1391,123,2019-01-01,zipcode
ZCTA5 35542,01,920,39583,-666666666,78400,808,447,693,156,266,202,69,0,545,417,128,417,405,12,2019-01-01,zipcode
ZCTA5 35543,01,1033,27917,593,49300,791,406,692,235,249,157,23,28,458,411,47,411,288,123,2019-01-01,zipcode
ZCTA5 35544,01,513,55500,572,45200,440,183,426,71,105,175,51,24,322,252,70,252,177,75,2019-01-01,zipcode
ZCTA5 35545,01,99,28750,-666666666,-666666666,87,53,64,33,15,14,0,2,58,50,8,50,46,4,2019-01-01,zipcode
ZCTA5 35546,01,3996,56106,359,104900,3115,1319,2611,448,1064,712,230,157,1607,1465,142,1465,1280,185,2019-01-01,zipcode
ZCTA5 35548,01,1600,37069,407,83900,1359,682,1190,345,415,328,53,49,839,694,145,694,555,139,2019-01-01,zipcode
ZCTA5 35549,01,3712,37308,589,64300,2975,1599,2613,591,1091,757,89,85,1816,1516,300,1516,1105,411,2019-01-01,zipcode
ZCTA5 35550,01,5504,39776,624,71800,4516,2299,3999,763,1614,1286,185,151,2688,2304,384,2304,1837,467,2019-01-01,zipcode
ZCTA5 35552,01,997,43715,315,66500,725,346,601,90,215,145,151,0,433,355,78,355,328,27,2019-01-01,zipcode
ZCTA5 35553,01,4111,30139,479,66000,3546,2014,3106,901,1181,691,163,170,2371,1724,647,1724,1355,369,2019-01-01,zipcode
ZCTA5 35554,01,1034,37270,603,60200,851,379,768,104,388,236,34,6,574,455,119,455,395,60,2019-01-01,zipcode
ZCTA5 35555,01,9537,40012,533,99500,7886,3794,6897,943,2769,2137,782,266,5247,3947,1300,3947,2760,1187,2019-01-01,zipcode
ZCTA5 35559,01,12,-666666666,-666666666,-666666666,12,0,12,12,0,0,0,0,6,6,0,6,6,0,2019-01-01,zipcode
ZCTA5 35563,01,4646,37778,556,106800,3796,1801,3234,417,1266,1191,182,178,2332,1896,436,1896,1353,543,2019-01-01,zipcode
ZCTA5 35564,01,2134,28370,542,104400,1745,932,1526,259,586,552,76,53,1040,894,146,894,712,182,2019-01-01,zipcode
ZCTA5 35565,01,12645,32121,538,71900,10017,4568,9092,2030,3399,2727,519,417,6243,5114,1129,5114,3999,1115,2019-01-01,zipcode
ZCTA5 35570,01,11159,37695,517,100500,9311,4762,7981,1801,2762,2315,713,390,5445,4529,916,4529,3202,1327,2019-01-01,zipcode
ZCTA5 35571,01,776,46979,656,79300,666,357,596,134,206,187,40,29,494,324,170,324,282,42,2019-01-01,zipcode
ZCTA5 35572,01,1267,31193,-666666666,180600,1064,457,870,187,269,279,66,69,976,508,468,508,466,42,2019-01-01,zipcode
ZCTA5 35574,01,1694,39261,279,108300,1347,682,1254,201,499,348,110,96,875,681,194,681,593,88,2019-01-01,zipcode
ZCTA5 35575,01,1082,39716,634,85500,832,415,722,167,271,193,60,31,496,431,65,431,308,123,2019-01-01,zipcode
ZCTA5 35576,01,2869,46127,468,92500,2552,1168,2288,329,1064,640,178,77,1639,1334,305,1334,1073,261,2019-01-01,zipcode
ZCTA5 35577,01,48,-666666666,-666666666,-666666666,41,21,27,0,10,10,7,0,52,13,39,13,13,0,2019-01-01,zipcode
ZCTA5 35578,01,6111,36485,818,91000,4968,2960,4394,997,1934,1041,292,130,2769,2293,476,2293,2039,254,2019-01-01,zipcode
ZCTA5 35579,01,3614,47417,345,85700,2846,1367,2591,518,1066,855,129,23,1767,1367,400,1367,1101,266,2019-01-01,zipcode
ZCTA5 35580,01,3564,41997,627,80800,2694,1080,2384,535,780,917,76,76,1688,1343,345,1343,1159,184,2019-01-01,zipcode
ZCTA5 35581,01,6073,44871,692,92100,4457,2275,3791,818,1121,1319,333,200,2453,1979,474,1979,1436,543,2019-01-01,zipcode
ZCTA5 35582,01,4561,38594,466,85300,3318,1384,2953,631,1352,628,224,118,2156,1770,386,1770,1269,501,2019-01-01,zipcode
ZCTA5 35584,01,365,25313,-666666666,47800,279,181,254,65,78,102,5,4,179,137,42,137,113,24,2019-01-01,zipcode
ZCTA5 35585,01,1727,45750,-666666666,151000,1351,713,1128,160,260,340,252,116,706,558,148,558,459,99,2019-01-01,zipcode
ZCTA5 35586,01,3947,32500,425,83400,3033,1501,2821,568,1018,1013,133,89,2255,1706,549,1706,1329,377,2019-01-01,zipcode
ZCTA5 35587,01,582,36750,-666666666,42500,553,345,464,111,228,109,3,13,423,281,142,281,250,31,2019-01-01,zipcode
ZCTA5 35592,01,4839,36116,404,78600,3773,1846,3183,579,1273,852,349,130,2353,1910,443,1910,1298,612,2019-01-01,zipcode
ZCTA5 35593,01,1537,45455,476,86500,1209,530,1112,232,454,261,109,56,748,592,156,592,482,110,2019-01-01,zipcode
ZCTA5 35594,01,7285,40881,515,113500,5728,2749,4992,897,1593,1793,480,229,3467,2685,782,2685,2015,670,2019-01-01,zipcode
ZCTA5 35601,01,32381,43267,662,99900,25232,11512,21822,5136,6289,5899,3212,1286,14322,12290,2032,12290,7661,4629,2019-01-01,zipcode
ZCTA5 35603,01,31653,56795,660,168900,25830,10042,22259,2061,5937,7798,4401,2062,13962,13273,689,13273,9330,3943,2019-01-01,zipcode
ZCTA5 35610,01,1823,43211,477,160900,1604,797,1491,199,744,384,110,54,896,803,93,803,652,151,2019-01-01,zipcode
ZCTA5 35611,01,27058,40257,640,126300,21900,9921,18543,3662,6371,4820,2612,1078,11616,9839,1777,9839,6054,3785,2019-01-01,zipcode
ZCTA5 35613,01,26379,79484,847,183600,21649,9774,19190,2607,5479,5699,3698,1707,8444,7937,507,7937,7122,815,2019-01-01,zipcode
ZCTA5 35614,01,7050,45276,756,120000,5567,2615,5032,1186,1639,1497,489,221,2966,2611,355,2611,2027,584,2019-01-01,zipcode
ZCTA5 35615,01,60,-666666666,-666666666,-666666666,60,60,60,60,0,0,0,0,17,17,0,17,0,17,2019-01-01,zipcode
ZCTA5 35616,01,3772,41034,719,85600,3210,1533,2747,597,1036,779,150,185,2309,1635,674,1635,1242,393,2019-01-01,zipcode
ZCTA5 35618,01,1796,29850,456,78500,1538,873,1271,308,509,329,69,56,1057,852,205,852,582,270,2019-01-01,zipcode
ZCTA5 35619,01,4860,53051,617,116600,4071,1843,3648,822,1360,1148,219,99,2174,1847,327,1847,1561,286,2019-01-01,zipcode
ZCTA5 35620,01,9694,58301,830,127200,7967,3164,6712,818,2615,2354,520,405,3703,3345,358,3345,2744,601,2019-01-01,zipcode
ZCTA5 35621,01,2647,51618,745,118400,2180,1030,1919,377,670,558,213,101,1219,1124,95,1124,989,135,2019-01-01,zipcode
ZCTA5 35622,01,7409,52217,765,90500,5577,2436,4995,730,2159,1602,272,232,3233,2535,698,2535,2008,527,2019-01-01,zipcode
ZCTA5 35630,01,33324,36405,641,119800,28131,12908,21413,3385,6586,6420,3174,1848,17839,14946,2893,14946,6624,8322,2019-01-01,zipcode
ZCTA5 35633,01,20625,59359,710,143700,16483,6933,14443,1812,4984,3776,2518,1353,9391,8349,1042,8349,7042,1307,2019-01-01,zipcode
ZCTA5 35634,01,9997,74668,867,186300,8393,3857,7430,555,2750,1962,1205,958,4304,3934,370,3934,3288,646,2019-01-01,zipcode
ZCTA5 35640,01,25654,58572,668,146100,20501,8521,17527,1826,5793,6034,2397,1477,10820,9455,1365,9455,7581,1874,2019-01-01,zipcode
ZCTA5 35643,01,3802,44754,532,104200,3188,1389,2837,951,1126,478,202,80,1657,1505,152,1505,1351,154,2019-01-01,zipcode
ZCTA5 35645,01,13654,62007,653,175800,10995,4750,9743,884,3987,2691,1389,792,5960,5223,737,5223,4451,772,2019-01-01,zipcode
ZCTA5 35646,01,4522,41894,482,105900,3938,2199,3431,572,1621,893,153,192,2420,1828,592,1828,1408,420,2019-01-01,zipcode
ZCTA5 35647,01,1177,65938,372,111300,914,322,743,80,293,170,170,30,386,368,18,368,297,71,2019-01-01,zipcode
ZCTA5 35648,01,3448,56172,522,115800,2788,1117,2315,297,1039,682,183,114,1450,1298,152,1298,1058,240,2019-01-01,zipcode
ZCTA5 35649,01,84,130000,-666666666,500000,70,28,68,3,9,11,27,18,30,30,0,30,30,0,2019-01-01,zipcode
ZCTA5 35650,01,13668,43521,541,128100,10958,5736,9660,1822,4144,2428,851,415,6039,5153,886,5153,3832,1321,2019-01-01,zipcode
ZCTA5 35651,01,1364,35438,726,88300,1049,629,911,126,526,205,38,16,573,461,112,461,343,118,2019-01-01,zipcode
ZCTA5 35652,01,8704,54135,768,133000,7085,3053,6165,697,2427,1790,861,390,4351,3479,872,3479,2793,686,2019-01-01,zipcode
ZCTA5 35653,01,10615,43547,596,83500,8535,3479,7113,1918,2745,1596,502,352,4688,3611,1077,3611,2455,1156,2019-01-01,zipcode
ZCTA5 35654,01,7771,42622,550,111800,6009,2778,5112,1107,1990,1357,409,249,3625,2778,847,2778,1849,929,2019-01-01,zipcode
ZCTA5 35660,01,8986,34194,645,90000,7310,3685,6507,1237,2159,1821,839,451,5079,4046,1033,4046,2335,1711,2019-01-01,zipcode
ZCTA5 35661,01,17027,60311,836,148000,13664,5714,12032,1134,4035,3795,2111,957,7335,6624,711,6624,5290,1334,2019-01-01,zipcode
ZCTA5 35670,01,6594,55592,590,119000,5292,2177,4595,697,1425,1478,741,254,3159,2527,632,2527,2141,386,2019-01-01,zipcode
ZCTA5 35671,01,1958,30539,634,74100,1735,683,1509,279,637,356,166,71,1096,872,224,872,574,298,2019-01-01,zipcode
ZCTA5 35672,01,5714,51505,553,104100,4302,2170,3614,526,1390,1125,287,286,2836,2211,625,2211,1717,494,2019-01-01,zipcode
ZCTA5 35673,01,7460,53822,594,129500,5923,2748,5330,1000,1945,1560,620,205,3141,2620,521,2620,2180,440,2019-01-01,zipcode
ZCTA5 35674,01,19144,49358,681,115600,15346,6878,13364,2089,5441,3842,1218,774,8828,7305,1523,7305,5211,2094,2019-01-01,zipcode
ZCTA5 35677,01,1593,38125,850,88300,1258,643,1089,197,515,238,111,28,1051,667,384,667,517,150,2019-01-01,zipcode
ZCTA5 35739,01,5076,51575,789,133700,3919,1383,3530,666,1114,1049,507,194,2220,1975,245,1975,1420,555,2019-01-01,zipcode
ZCTA5 35740,01,3056,30531,416,86400,2567,1361,2267,342,964,716,188,57,1635,1419,216,1419,950,469,2019-01-01,zipcode
ZCTA5 35741,01,2801,74569,1005,268700,2569,958,2243,158,295,434,940,416,1490,1350,140,1350,904,446,2019-01-01,zipcode
ZCTA5 35744,01,1956,36760,413,117700,1616,867,1277,257,662,211,69,78,984,737,247,737,596,141,2019-01-01,zipcode
ZCTA5 35745,01,164,30625,-666666666,155900,154,73,131,5,80,28,12,6,165,81,84,81,74,7,2019-01-01,zipcode
ZCTA5 35746,01,461,33980,-666666666,-666666666,400,230,377,135,117,112,13,0,300,213,87,213,181,32,2019-01-01,zipcode
ZCTA5 35747,01,5302,56563,663,160300,4481,2094,3919,417,1721,1033,446,302,2764,2076,688,2076,1610,466,2019-01-01,zipcode
ZCTA5 35748,01,7300,75370,582,198800,5978,2364,5199,539,1761,1247,999,653,2937,2738,199,2738,2281,457,2019-01-01,zipcode
ZCTA5 35749,01,22804,91496,1096,186500,17658,6069,15290,827,3293,4757,3782,2631,9112,8286,826,8286,7316,970,2019-01-01,zipcode
ZCTA5 35750,01,13391,56250,847,134900,10818,3708,9350,1013,3290,2932,1472,643,5879,5266,613,5266,4116,1150,2019-01-01,zipcode
ZCTA5 35751,01,238,48000,-666666666,215200,225,89,169,0,60,62,29,18,124,86,38,86,86,0,2019-01-01,zipcode
ZCTA5 35752,01,2682,47002,775,68600,2222,1156,1905,307,916,548,102,32,1203,1019,184,1019,901,118,2019-01-01,zipcode
ZCTA5 35754,01,5300,50417,613,150600,4424,1901,3869,946,1008,896,847,172,2212,1980,232,1980,1473,507,2019-01-01,zipcode
ZCTA5 35755,01,450,46364,-666666666,150000,436,206,360,20,105,109,64,62,427,218,209,218,174,44,2019-01-01,zipcode
ZCTA5 35756,01,13855,94737,1366,239500,10060,3327,8766,519,1387,2360,2823,1677,5129,4500,629,4500,3901,599,2019-01-01,zipcode
ZCTA5 35757,01,16909,91765,1147,201300,13349,4506,11365,609,1583,3277,3416,2480,6311,6021,290,6021,5139,882,2019-01-01,zipcode
ZCTA5 35758,01,46724,91900,968,240800,37250,11669,32080,942,3885,8395,10938,7920,19549,18566,983,18566,12489,6077,2019-01-01,zipcode
ZCTA5 35759,01,8113,90655,1297,192500,6528,2258,5541,209,1037,2031,1577,687,3130,3089,41,3089,2853,236,2019-01-01,zipcode
ZCTA5 35760,01,4876,53831,785,130100,3889,1528,3401,638,1396,844,416,107,2092,1831,261,1831,1446,385,2019-01-01,zipcode
ZCTA5 35761,01,12547,64521,844,153600,9952,3612,8779,1222,2616,2711,1485,745,5147,4834,313,4834,4175,659,2019-01-01,zipcode
ZCTA5 35763,01,19855,121158,2000,280700,14597,5480,12911,448,1776,2699,4209,3779,7110,6867,243,6867,6291,576,2019-01-01,zipcode
ZCTA5 35764,01,540,28750,589,77600,463,255,414,108,210,78,12,6,262,248,14,248,182,66,2019-01-01,zipcode
ZCTA5 35765,01,3633,37429,448,93200,3099,1767,2754,578,871,878,257,170,1861,1406,455,1406,1195,211,2019-01-01,zipcode
ZCTA5 35766,01,155,-666666666,-666666666,-666666666,140,58,140,19,91,16,0,14,123,67,56,67,54,13,2019-01-01,zipcode
ZCTA5 35768,01,11473,43219,588,96000,9297,4321,8049,1357,3394,2118,816,364,5385,4483,902,4483,3002,1481,2019-01-01,zipcode
ZCTA5 35769,01,9745,45677,664,143500,7998,3547,7167,762,2407,2353,1140,505,5102,4041,1061,4041,3054,987,2019-01-01,zipcode
ZCTA5 35771,01,3959,50064,677,106000,3004,1150,2785,521,993,976,209,86,1649,1422,227,1422,1048,374,2019-01-01,zipcode
ZCTA5 35772,01,4762,39556,475,83700,3633,1957,3222,535,1582,828,168,109,2316,1878,438,1878,1399,479,2019-01-01,zipcode
ZCTA5 35773,01,12323,54933,842,123200,10020,3460,8722,1176,2730,2583,1515,718,5165,4706,459,4706,3723,983,2019-01-01,zipcode
ZCTA5 35774,01,198,52750,-666666666,73000,198,136,150,7,68,48,13,14,93,67,26,67,67,0,2019-01-01,zipcode
ZCTA5 35775,01,1095,36591,-666666666,82500,884,373,839,173,317,220,112,17,422,380,42,380,290,90,2019-01-01,zipcode
ZCTA5 35776,01,3785,38448,600,93700,3140,1585,2721,507,1193,671,231,119,1731,1450,281,1450,1205,245,2019-01-01,zipcode
ZCTA5 35801,01,23947,71947,861,274300,19850,8940,17653,1614,2845,3949,5408,3837,10951,10020,931,10020,6659,3361,2019-01-01,zipcode
ZCTA5 35802,01,21853,64702,831,240800,18306,7184,16228,585,2399,4730,5002,3512,11522,10292,1230,10292,5790,4502,2019-01-01,zipcode
ZCTA5 35803,01,26242,78524,905,183800,21346,8355,19029,833,3119,5237,6128,3712,12054,11299,755,11299,9003,2296,2019-01-01,zipcode
ZCTA5 35805,01,20491,25511,642,74200,15529,5662,12317,2873,3659,4037,1367,381,10498,9146,1352,9146,2587,6559,2019-01-01,zipcode
ZCTA5 35806,01,23019,68490,965,233900,19766,5972,16447,823,2240,3972,6149,3263,11723,11056,667,11056,5134,5922,2019-01-01,zipcode
ZCTA5 35808,01,1348,90104,1377,-666666666,1044,230,678,11,113,199,216,139,369,351,18,351,5,346,2019-01-01,zipcode
ZCTA5 35810,01,29274,37488,868,86100,23791,9733,18794,3082,5479,6077,2607,1549,12906,11497,1409,11497,7345,4152,2019-01-01,zipcode
ZCTA5 35811,01,27245,65740,808,164300,22031,7914,19339,1864,5091,6084,4045,2255,11896,10947,949,10947,8749,2198,2019-01-01,zipcode
ZCTA5 35816,01,13971,25451,680,89000,11691,4148,8216,1249,2225,2609,1369,764,8001,6622,1379,6622,1648,4974,2019-01-01,zipcode
ZCTA5 35824,01,8298,83950,952,229200,6974,1501,5506,89,591,1682,1660,1484,3959,3828,131,3828,1966,1862,2019-01-01,zipcode
ZCTA5 35896,01,698,-666666666,-666666666,-666666666,698,361,0,0,0,0,0,0,0,0,0,0,0,0,2019-01-01,zipcode
ZCTA5 35901,01,19811,39688,619,117200,15986,7543,13904,2459,4100,4698,1578,1069,9362,7553,1809,7553,4789,2764,2019-01-01,zipcode
ZCTA5 35903,01,17699,37492,677,97500,14637,6459,12193,1959,4406,3993,1099,736,8423,6674,1749,6674,4197,2477,2019-01-01,zipcode
ZCTA5 35904,01,13704,35349,640,69900,11209,5472,9734,1816,3373,3143,908,494,6722,5333,1389,5333,4242,1091,2019-01-01,zipcode
ZCTA5 35905,01,6219,57989,605,135200,5103,2443,4542,522,1334,1694,427,565,2903,2349,554,2349,1907,442,2019-01-01,zipcode
ZCTA5 35906,01,9811,50929,797,167700,7751,3182,6874,542,2024,2260,1335,713,4591,3917,674,3917,2379,1538,2019-01-01,zipcode
ZCTA5 35907,01,8589,73143,942,154200,7066,2725,6193,399,1385,2559,1320,530,3570,3245,325,3245,2877,368,2019-01-01,zipcode
ZCTA5 35950,01,20867,44670,693,111000,15020,6288,12908,2894,3928,3978,1522,586,7822,7303,519,7303,4557,2746,2019-01-01,zipcode
ZCTA5 35951,01,12686,37000,634,108400,9771,4318,8167,2553,2677,2143,561,233,4996,4266,730,4266,2983,1283,2019-01-01,zipcode
ZCTA5 35952,01,7879,40991,611,90900,6239,3100,5426,1325,2035,1544,336,186,3410,2876,534,2876,2211,665,2019-01-01,zipcode
ZCTA5 35953,01,7519,46096,814,110700,6139,3103,5401,1059,2175,1825,181,161,3469,2743,726,2743,2220,523,2019-01-01,zipcode
ZCTA5 35954,01,11834,39956,578,86600,9377,4513,7998,1451,3037,2760,384,366,5800,4477,1323,4477,3621,856,2019-01-01,zipcode
ZCTA5 35956,01,8927,47016,676,114000,7230,3430,6313,1109,2208,2166,515,315,3692,3270,422,3270,2682,588,2019-01-01,zipcode
ZCTA5 35957,01,15967,40235,682,97400,12072,5535,10341,2231,3276,3240,1030,564,6597,5655,942,5655,3334,2321,2019-01-01,zipcode
ZCTA5 35958,01,3523,42885,544,137500,2954,1570,2489,492,930,608,296,163,1633,1450,183,1450,1088,362,2019-01-01,zipcode
ZCTA5 35959,01,4523,39743,520,105700,3747,1987,3313,660,1446,826,227,154,3771,1928,1843,1928,1501,427,2019-01-01,zipcode
ZCTA5 35960,01,9714,44189,623,144600,8171,4283,7284,1205,2896,2101,478,604,6576,4276,2300,4276,3146,1130,2019-01-01,zipcode
ZCTA5 35961,01,7082,39467,579,84400,5612,2597,4861,1342,1805,1415,180,119,2919,2497,422,2497,1651,846,2019-01-01,zipcode
ZCTA5 35962,01,8730,42796,706,88300,6808,2987,5758,1729,1916,1434,367,312,3587,3083,504,3083,2252,831,2019-01-01,zipcode
ZCTA5 35963,01,1201,33250,-666666666,116700,1052,500,982,158,359,325,98,42,669,514,155,514,358,156,2019-01-01,zipcode
ZCTA5 35966,01,4182,41912,744,121400,3554,1741,3023,755,1186,758,153,171,1930,1642,288,1642,1288,354,2019-01-01,zipcode
ZCTA5 35967,01,16274,39575,650,115500,12411,5320,10739,2831,3313,2933,908,754,7254,6017,1237,6017,4245,1772,2019-01-01,zipcode
ZCTA5 35968,01,5206,44185,593,111200,4055,1934,3511,937,1038,1021,356,159,1913,1655,258,1655,1150,505,2019-01-01,zipcode
ZCTA5 35971,01,5666,43472,693,93500,4552,1981,3654,856,1370,1125,189,114,2209,1953,256,1953,1406,547,2019-01-01,zipcode
ZCTA5 35972,01,1222,60398,-666666666,105400,967,432,879,145,398,197,90,49,445,437,8,437,361,76,2019-01-01,zipcode
ZCTA5 35973,01,2810,37244,814,97300,2276,1195,1995,565,712,550,125,43,1498,1127,371,1127,990,137,2019-01-01,zipcode
ZCTA5 35974,01,1744,40882,641,122600,1306,562,1159,278,341,272,172,96,801,708,93,708,408,300,2019-01-01,zipcode
ZCTA5 35975,01,629,30938,-666666666,81000,511,319,460,98,222,96,40,4,224,224,0,224,174,50,2019-01-01,zipcode
ZCTA5 35976,01,17549,50580,633,172700,14354,6782,12488,1902,3354,3754,2441,1037,8036,6882,1154,6882,5180,1702,2019-01-01,zipcode
ZCTA5 35978,01,4901,41020,553,98100,3988,1903,3611,709,1528,993,254,127,2271,1887,384,1887,1546,341,2019-01-01,zipcode
ZCTA5 35979,01,1352,35417,-666666666,127100,1065,429,924,161,491,236,16,20,668,590,78,590,445,145,2019-01-01,zipcode
ZCTA5 35980,01,5440,46198,627,93300,4151,1988,3325,685,1240,870,250,280,2128,1800,328,1800,1470,330,2019-01-01,zipcode
ZCTA5 35981,01,1802,43641,277,117600,1554,672,1281,162,677,336,66,40,840,653,187,653,482,171,2019-01-01,zipcode
ZCTA5 35983,01,3683,55052,639,160700,3030,1395,2665,243,1054,915,240,213,2331,1426,905,1426,1083,343,2019-01-01,zipcode
ZCTA5 35984,01,1492,41071,807,185500,1389,803,1344,146,336,356,360,146,1489,756,733,756,607,149,2019-01-01,zipcode
ZCTA5 35986,01,7968,36640,595,114100,6310,2806,5311,1074,1881,1833,351,172,3518,3055,463,3055,2133,922,2019-01-01,zipcode
ZCTA5 35987,01,2458,42391,808,92300,1995,962,1671,361,691,470,69,80,1066,912,154,912,745,167,2019-01-01,zipcode
ZCTA5 35988,01,2311,43679,623,90200,1701,628,1455,305,495,438,130,87,881,789,92,789,583,206,2019-01-01,zipcode
ZCTA5 35989,01,3831,39185,587,94600,2841,1343,2443,585,866,575,235,182,1736,1372,364,1372,1046,326,2019-01-01,zipcode
ZCTA5 35990,01,82,-666666666,975,-666666666,57,35,31,8,21,2,0,0,34,23,11,23,6,17,2019-01-01,zipcode
ZCTA5 36003,01,1963,37000,445,91800,1717,945,1519,384,608,375,77,75,1176,912,264,912,713,199,2019-01-01,zipcode
ZCTA5 36005,01,1438,49722,530,97700,1161,589,956,164,344,244,110,94,748,498,250,498,432,66,2019-01-01,zipcode
ZCTA5 36006,01,1108,47154,471,179300,974,411,875,153,320,199,133,70,600,483,117,483,402,81,2019-01-01,zipcode
ZCTA5 36009,01,2463,38500,477,89200,2010,949,1716,244,754,363,277,78,1312,960,352,960,678,282,2019-01-01,zipcode
ZCTA5 36010,01,4766,40345,557,80000,3996,2033,3246,763,1337,698,284,164,2348,1624,724,1624,1176,448,2019-01-01,zipcode
ZCTA5 36013,01,615,103696,-666666666,387800,523,197,449,34,75,210,75,55,210,210,0,210,210,0,2019-01-01,zipcode
ZCTA5 36016,01,4951,33263,552,73700,4332,2860,3891,1280,1484,804,228,95,1924,1495,429,1495,962,533,2019-01-01,zipcode
ZCTA5 36017,01,2897,24413,429,60700,2483,1892,2235,753,821,507,112,42,915,701,214,701,442,259,2019-01-01,zipcode
ZCTA5 36020,01,1039,41641,797,163600,836,409,723,112,254,221,89,47,450,413,37,413,306,107,2019-01-01,zipcode
ZCTA5 36022,01,13003,70200,775,176600,10361,3930,8882,849,2870,2927,1693,543,5099,4707,392,4707,3971,736,2019-01-01,zipcode
ZCTA5 36024,01,5124,53506,811,172700,4373,2002,3807,532,1350,1067,599,259,3073,2175,898,2175,1707,468,2019-01-01,zipcode
ZCTA5 36025,01,6231,44952,980,141200,5640,3914,4960,1401,1883,1049,370,257,1400,1318,82,1318,842,476,2019-01-01,zipcode
ZCTA5 36026,01,1091,44432,-666666666,287500,938,472,846,79,278,233,240,16,1079,477,602,477,347,130,2019-01-01,zipcode
ZCTA5 36027,01,14970,32767,587,104800,11676,5574,10089,2211,3415,3006,947,510,7724,6111,1613,6111,3489,2622,2019-01-01,zipcode
ZCTA5 36028,01,1438,37798,613,97500,1231,588,1090,263,368,264,142,53,895,587,308,587,495,92,2019-01-01,zipcode
ZCTA5 36029,01,1164,47216,-666666666,-666666666,920,295,833,147,357,159,120,50,434,344,90,344,305,39,2019-01-01,zipcode
ZCTA5 36030,01,605,33021,613,106800,528,331,435,17,295,85,24,14,294,177,117,177,136,41,2019-01-01,zipcode
ZCTA5 36031,01,185,-666666666,-666666666,82000,165,131,139,71,55,6,7,0,102,92,10,92,89,3,2019-01-01,zipcode
ZCTA5 36032,01,2464,34464,389,64500,1916,786,1567,297,711,334,105,120,1260,979,281,979,634,345,2019-01-01,zipcode
ZCTA5 36033,01,4262,39425,609,79500,3424,1806,3027,605,1235,798,207,182,2372,1367,1005,1367,1025,342,2019-01-01,zipcode
ZCTA5 36034,01,1132,42500,567,55100,861,400,682,67,276,202,97,40,492,358,134,358,327,31,2019-01-01,zipcode
ZCTA5 36035,01,1606,42292,670,91800,1258,473,1170,166,521,220,132,131,966,572,394,572,497,75,2019-01-01,zipcode
ZCTA5 36036,01,1688,44940,655,102100,1526,647,1257,231,446,310,170,100,988,672,316,672,571,101,2019-01-01,zipcode
ZCTA5 36037,01,12944,41733,631,96900,10231,4382,8884,1282,3980,2051,963,608,6395,4265,2130,4265,2822,1443,2019-01-01,zipcode
ZCTA5 36038,01,44,-666666666,-666666666,-666666666,44,30,44,5,15,24,0,0,13,13,0,13,13,0,2019-01-01,zipcode
ZCTA5 36039,01,232,50677,-666666666,88300,232,117,197,58,54,54,31,0,87,87,0,87,68,19,2019-01-01,zipcode
ZCTA5 36040,01,3452,24852,592,66600,2745,1519,2473,555,1139,423,227,129,1632,1414,218,1414,956,458,2019-01-01,zipcode
ZCTA5 36041,01,1344,39931,-666666666,68400,1058,498,881,200,422,206,31,22,667,497,170,497,441,56,2019-01-01,zipcode
ZCTA5 36042,01,1947,47273,643,103800,1582,742,1423,293,710,226,137,57,959,632,327,632,562,70,2019-01-01,zipcode
ZCTA5 36043,01,3626,50000,1041,186300,3092,1683,2648,723,814,529,345,237,1550,1318,232,1318,1037,281,2019-01-01,zipcode
ZCTA5 36046,01,1406,40956,727,105700,1181,506,1034,231,388,254,113,48,686,547,139,547,507,40,2019-01-01,zipcode
ZCTA5 36047,01,1084,41895,-666666666,81300,807,371,725,139,346,163,68,9,577,447,130,447,369,78,2019-01-01,zipcode
ZCTA5 36048,01,1513,31250,594,71100,1252,612,1070,403,448,162,47,10,755,565,190,565,405,160,2019-01-01,zipcode
ZCTA5 36049,01,5883,46696,549,78400,4730,2154,4132,797,1554,819,718,244,2620,2045,575,2045,1441,604,2019-01-01,zipcode
ZCTA5 36051,01,2057,70438,886,87200,1784,645,1603,263,733,373,106,128,977,853,124,853,666,187,2019-01-01,zipcode
ZCTA5 36052,01,393,106406,-666666666,582400,343,163,343,17,66,99,107,54,240,191,49,191,172,19,2019-01-01,zipcode
ZCTA5 36053,01,1732,28478,591,76600,1291,569,1183,259,431,387,46,60,1114,694,420,694,455,239,2019-01-01,zipcode
ZCTA5 36054,01,15899,58125,875,143600,12008,4022,9703,1055,3023,3123,1546,956,6241,5864,377,5864,4049,1815,2019-01-01,zipcode
ZCTA5 36064,01,10149,109082,1250,314400,7705,2185,6666,288,849,1447,2393,1689,3964,3613,351,3613,3369,244,2019-01-01,zipcode
ZCTA5 36066,01,19732,62284,1124,173300,15700,5626,13125,1124,2989,3706,3202,2104,8887,8381,506,8381,4785,3596,2019-01-01,zipcode
ZCTA5 36067,01,27601,53645,875,140400,21565,9440,18528,2445,6970,5293,2329,1491,10943,10015,928,10015,7628,2387,2019-01-01,zipcode
ZCTA5 36069,01,2028,46020,786,122000,1796,743,1517,232,467,393,204,221,1051,864,187,864,770,94,2019-01-01,zipcode
ZCTA5 36071,01,456,31635,518,80000,416,293,385,115,154,80,26,10,251,207,44,207,168,39,2019-01-01,zipcode
ZCTA5 36075,01,2240,37202,748,83400,1795,861,1611,303,511,533,201,63,1133,929,204,929,637,292,2019-01-01,zipcode
ZCTA5 36078,01,12540,54842,707,136100,10169,4331,8799,1650,2990,2645,953,561,5778,4912,866,4912,3443,1469,2019-01-01,zipcode
ZCTA5 36079,01,9932,49792,815,132200,7823,2935,6566,776,2294,1986,919,591,4465,3359,1106,3359,2668,691,2019-01-01,zipcode
ZCTA5 36080,01,2412,81250,-666666666,183800,2100,1082,1899,130,715,573,291,190,1079,855,224,855,780,75,2019-01-01,zipcode
ZCTA5 36081,01,15754,27368,639,132300,13289,6227,8277,1258,2744,2020,1261,994,8313,6074,2239,6074,2812,3262,2019-01-01,zipcode
ZCTA5 36082,01,1141,-666666666,-666666666,-666666666,1141,893,21,0,0,7,14,0,0,0,0,0,0,0,2019-01-01,zipcode
ZCTA5 36083,01,7316,32394,565,77200,6117,2888,5318,929,1410,1568,801,610,4655,3315,1340,3315,2110,1205,2019-01-01,zipcode
ZCTA5 36088,01,4646,31200,705,83800,4141,2081,1755,290,432,562,222,249,1983,1204,779,1204,549,655,2019-01-01,zipcode
ZCTA5 36089,01,7698,34417,666,72100,6305,3125,5264,1420,2102,1174,368,200,3307,2662,645,2662,1850,812,2019-01-01,zipcode
ZCTA5 36091,01,3590,39821,654,84800,2930,1527,2728,493,1220,747,148,120,1840,1538,302,1538,1191,347,2019-01-01,zipcode
ZCTA5 36092,01,20170,54861,810,141600,16371,8248,14052,2036,5422,3662,2015,917,8821,7501,1320,7501,5458,2043,2019-01-01,zipcode
ZCTA5 36093,01,11084,98438,1295,250400,8408,3105,7170,297,1292,2320,1937,1324,4107,3905,202,3905,3507,398,2019-01-01,zipcode
ZCTA5 36104,01,8465,26401,687,67100,7032,3861,5206,1289,1506,1258,539,614,4087,2932,1155,2932,906,2026,2019-01-01,zipcode
ZCTA5 36105,01,9391,31287,826,67100,7593,3652,6719,1677,2296,1722,722,302,5297,3840,1457,3840,2455,1385,2019-01-01,zipcode
ZCTA5 36106,01,14951,59985,973,160000,12203,4321,10042,695,1851,2650,2472,2374,7148,6333,815,6333,3524,2809,2019-01-01,zipcode
ZCTA5 36107,01,7669,29592,756,67700,5787,2257,4750,1040,1511,1174,566,459,4163,3084,1079,3084,1278,1806,2019-01-01,zipcode
ZCTA5 36108,01,17680,24832,634,63100,14393,7205,12593,3665,4138,3026,1243,521,9220,7243,1977,7243,4070,3173,2019-01-01,zipcode
ZCTA5 36109,01,25377,54561,957,116600,20689,8162,17351,1521,4413,5637,3584,2196,10977,10150,827,10150,7344,2806,2019-01-01,zipcode
ZCTA5 36110,01,11693,32760,839,57700,9129,4772,7830,2222,2707,1955,571,375,5435,4237,1198,4237,2236,2001,2019-01-01,zipcode
ZCTA5 36111,01,12610,51679,825,144200,9750,3564,8243,1399,1993,2072,1751,1028,5623,4909,714,4909,2918,1991,2019-01-01,zipcode
ZCTA5 36112,01,309,-666666666,-666666666,-666666666,309,11,147,0,26,99,0,22,0,0,0,0,0,0,2019-01-01,zipcode
ZCTA5 36113,01,1764,88375,1515,-666666666,1429,956,1259,97,391,393,157,221,302,263,39,263,0,263,2019-01-01,zipcode
ZCTA5 36115,01,1058,69028,1388,-666666666,693,174,485,4,85,255,65,76,295,295,0,295,0,295,2019-01-01,zipcode
ZCTA5 36116,01,43882,45883,881,109500,33828,11876,27873,3199,6980,9208,5013,3473,20090,17049,3041,17049,8412,8637,2019-01-01,zipcode
ZCTA5 36117,01,54640,64011,1003,180300,42515,13568,35954,1940,7153,10448,9648,6765,24479,22552,1927,22552,13122,9430,2019-01-01,zipcode
ZCTA5 36201,01,17482,27533,593,64400,14266,7127,12676,3469,4882,3476,644,205,9458,7104,2354,7104,4181,2923,2019-01-01,zipcode
ZCTA5 36203,01,18453,56237,862,152600,14352,4985,12380,1942,3357,4191,1691,1199,7685,6980,705,6980,4850,2130,2019-01-01,zipcode
ZCTA5 36205,01,1027,85373,733,215900,871,427,697,85,182,213,84,133,416,331,85,331,170,161,2019-01-01,zipcode
ZCTA5 36206,01,11648,45115,703,96600,9203,3996,7950,1255,2905,2483,659,648,5161,4433,728,4433,3362,1071,2019-01-01,zipcode
ZCTA5 36207,01,19614,54023,817,150100,15750,6652,13641,1199,3925,4927,1795,1795,9809,8117,1692,8117,5564,2553,2019-01-01,zipcode
ZCTA5 36250,01,4768,70813,927,128800,3835,1363,3505,259,1018,1391,536,301,2023,1834,189,1834,1557,277,2019-01-01,zipcode
ZCTA5 36251,01,4400,35671,390,83900,3841,1841,3227,780,1119,1032,182,114,2414,1818,596,1818,1307,511,2019-01-01,zipcode
ZCTA5 36255,01,944,44375,-666666666,125000,753,319,647,141,307,160,0,39,412,382,30,382,338,44,2019-01-01,zipcode
ZCTA5 36256,01,1621,41827,692,104700,1276,577,1126,214,399,385,97,31,864,665,199,665,566,99,2019-01-01,zipcode
ZCTA5 36258,01,1385,55500,540,128800,1219,603,1111,137,535,257,122,60,825,594,231,594,516,78,2019-01-01,zipcode
ZCTA5 36260,01,4259,40714,625,121500,3452,1773,3002,611,1071,1023,190,107,1867,1604,263,1604,1322,282,2019-01-01,zipcode
ZCTA5 36262,01,1326,40147,639,93300,1009,494,886,209,371,213,77,16,603,458,145,458,363,95,2019-01-01,zipcode
ZCTA5 36263,01,420,26324,715,95000,394,277,358,86,165,30,10,67,268,182,86,182,102,80,2019-01-01,zipcode
ZCTA5 36264,01,8305,41123,575,123000,6683,3500,5858,1393,1961,1580,523,401,3959,3246,713,3246,2333,913,2019-01-01,zipcode
ZCTA5 36265,01,20238,50020,667,143700,17060,7141,12614,1082,3581,4734,1806,1411,8707,7531,1176,7531,4667,2864,2019-01-01,zipcode
ZCTA5 36266,01,6106,42574,578,118800,4632,2021,4019,925,1545,1098,257,194,2963,2154,809,2154,1500,654,2019-01-01,zipcode
ZCTA5 36267,01,7,-666666666,-666666666,-666666666,7,0,7,7,0,0,0,0,7,7,0,7,7,0,2019-01-01,zipcode
ZCTA5 36268,01,5514,54286,765,107700,4293,1580,3651,630,1403,1213,244,161,2615,2216,399,2216,1863,353,2019-01-01,zipcode
ZCTA5 36269,01,1685,55216,599,82400,1143,534,1031,210,438,219,131,33,588,513,75,513,393,120,2019-01-01,zipcode
ZCTA5 36271,01,5771,54073,746,117300,4782,1845,4247,979,1421,1280,298,269,2846,2200,646,2200,1878,322,2019-01-01,zipcode
ZCTA5 36272,01,13097,41059,607,82900,10707,5491,9495,1877,3640,2676,818,484,6565,5336,1229,5336,4261,1075,2019-01-01,zipcode
ZCTA5 36273,01,3125,47625,658,123100,2611,1008,2284,415,973,532,271,93,1481,1280,201,1280,1076,204,2019-01-01,zipcode
ZCTA5 36274,01,11067,40136,594,85400,9079,4250,7802,1548,2781,2283,798,392,5441,4361,1080,4361,3279,1082,2019-01-01,zipcode
ZCTA5 36276,01,2573,35804,494,72000,2107,1034,1604,424,543,456,128,53,1130,860,270,860,677,183,2019-01-01,zipcode
ZCTA5 36277,01,5771,57250,851,106000,4480,1798,3892,540,1036,1623,502,191,2254,2011,243,2011,1660,351,2019-01-01,zipcode
ZCTA5 36278,01,4557,39235,651,154700,3551,2017,3179,547,887,1030,358,357,3008,1774,1234,1774,1422,352,2019-01-01,zipcode
ZCTA5 36279,01,2452,56851,1020,141700,2083,992,1889,335,682,540,140,192,1290,1028,262,1028,944,84,2019-01-01,zipcode
ZCTA5 36280,01,4332,55803,784,100000,3406,1666,3090,585,1205,824,239,237,2092,1624,468,1624,1256,368,2019-01-01,zipcode
ZCTA5 36301,01,37608,42140,736,119800,29615,12614,25501,3947,8761,8529,2687,1577,16966,14144,2822,14144,8605,5539,2019-01-01,zipcode
ZCTA5 36303,01,30986,44639,702,144300,24373,10565,21088,2879,5873,6987,3388,1961,14524,11667,2857,11667,6965,4702,2019-01-01,zipcode
ZCTA5 36305,01,15954,67601,965,186300,12505,4902,11023,699,2652,3828,2343,1501,6900,6076,824,6076,4265,1811,2019-01-01,zipcode
ZCTA5 36310,01,6275,39983,554,92300,5370,3055,4621,1104,1639,1264,335,279,4234,2621,1613,2621,2051,570,2019-01-01,zipcode
ZCTA5 36311,01,2426,36426,505,76300,2075,1118,1682,382,720,394,62,124,1309,993,316,993,827,166,2019-01-01,zipcode
ZCTA5 36312,01,6285,46111,676,113500,5076,2316,4308,654,1664,1409,386,195,2735,2276,459,2276,1684,592,2019-01-01,zipcode
ZCTA5 36313,01,244,72286,-666666666,135800,167,39,167,32,0,123,12,0,149,98,51,98,63,35,2019-01-01,zipcode
ZCTA5 36314,01,398,36875,522,108700,358,209,350,87,151,72,11,29,251,197,54,197,167,30,2019-01-01,zipcode
ZCTA5 36316,01,2118,64243,725,154100,1754,885,1627,199,443,694,230,61,944,811,133,811,705,106,2019-01-01,zipcode
ZCTA5 36317,01,486,28839,-666666666,67900,455,303,442,159,115,111,41,16,335,227,108,227,185,42,2019-01-01,zipcode
ZCTA5 36318,01,1481,50625,575,69400,1150,599,932,176,343,345,52,16,713,517,196,517,450,67,2019-01-01,zipcode
ZCTA5 36319,01,2200,41893,777,79700,1772,973,1630,258,518,627,135,92,1096,905,191,905,712,193,2019-01-01,zipcode
ZCTA5 36320,01,3660,40417,613,89800,2977,1291,2666,476,1099,779,248,64,1701,1366,335,1366,1100,266,2019-01-01,zipcode
ZCTA5 36321,01,1816,42500,750,102400,1370,575,1202,221,498,337,92,54,716,622,94,622,493,129,2019-01-01,zipcode
ZCTA5 36322,01,8921,41989,668,97100,7178,3132,6105,976,2146,2218,532,233,4371,3392,979,3392,1984,1408,2019-01-01,zipcode
ZCTA5 36323,01,7862,44978,639,83800,6706,3221,5757,1315,2024,1800,426,192,3792,3007,785,3007,2135,872,2019-01-01,zipcode
ZCTA5 36330,01,37144,61447,856,167400,28668,10619,24903,2697,5846,9353,4677,2330,16240,14161,2079,14161,8797,5364,2019-01-01,zipcode
ZCTA5 36340,01,5718,40828,444,105700,4504,2242,3995,932,1492,1024,277,270,2751,2281,470,2281,1567,714,2019-01-01,zipcode
ZCTA5 36343,01,1241,41518,555,70400,1088,596,939,304,323,253,43,16,734,501,233,501,436,65,2019-01-01,zipcode
ZCTA5 36344,01,5719,43273,619,118600,4702,2218,4100,733,1491,1420,305,151,2755,2074,681,2074,1405,669,2019-01-01,zipcode
ZCTA5 36345,01,8785,62117,648,141700,6887,2613,6129,985,1896,1917,836,495,3656,3157,499,3157,2655,502,2019-01-01,zipcode
ZCTA5 36346,01,1432,48424,598,94400,1108,506,956,213,332,256,98,57,657,545,112,545,465,80,2019-01-01,zipcode
ZCTA5 36350,01,6428,42634,679,137100,4975,1837,4268,647,1211,1658,494,258,3079,2646,433,2646,1578,1068,2019-01-01,zipcode
ZCTA5 36351,01,3482,49074,739,111700,2873,1321,2562,409,954,810,250,139,1671,1466,205,1466,1052,414,2019-01-01,zipcode
ZCTA5 36352,01,5433,65379,678,168200,4502,1776,3856,452,1052,1492,303,557,2068,1936,132,1936,1591,345,2019-01-01,zipcode
ZCTA5 36353,01,1683,41648,538,104000,1441,663,1134,166,334,472,114,48,903,701,202,701,621,80,2019-01-01,zipcode
ZCTA5 36360,01,19064,44112,636,115400,15548,7714,13734,2006,4530,4724,1649,825,9386,7792,1594,7792,5101,2691,2019-01-01,zipcode
ZCTA5 36362,01,5311,70024,1165,-666666666,3635,868,2406,21,406,1105,638,236,1468,1296,172,1296,8,1288,2019-01-01,zipcode
ZCTA5 36370,01,881,43125,725,89500,735,395,704,153,322,195,22,12,423,357,66,357,284,73,2019-01-01,zipcode
ZCTA5 36371,01,767,40000,763,127300,619,348,550,81,182,191,77,19,387,320,67,320,226,94,2019-01-01,zipcode
ZCTA5 36373,01,435,27102,-666666666,101300,428,278,303,117,124,62,0,0,354,191,163,191,149,42,2019-01-01,zipcode
ZCTA5 36374,01,787,59875,1272,83800,689,254,628,148,159,217,56,48,530,341,189,341,285,56,2019-01-01,zipcode
ZCTA5 36375,01,6976,46932,764,84900,5764,2604,4871,1008,1838,1269,502,254,3307,2761,546,2761,1975,786,2019-01-01,zipcode
ZCTA5 36376,01,2179,42212,733,86200,1785,894,1585,332,675,407,110,61,1089,787,302,787,621,166,2019-01-01,zipcode
ZCTA5 36401,01,7730,37856,533,86500,6315,3130,5503,721,3002,1129,419,232,4466,2919,1547,2919,2105,814,2019-01-01,zipcode
ZCTA5 36420,01,10369,44753,635,119900,8484,3845,7492,1199,2703,2170,776,644,5295,4250,1045,4250,2964,1286,2019-01-01,zipcode
ZCTA5 36421,01,9966,42560,596,97700,7705,3382,6693,856,2176,2400,925,336,5147,3818,1329,3818,2977,841,2019-01-01,zipcode
ZCTA5 36425,01,1045,26635,546,39500,892,519,731,66,391,179,68,27,657,413,244,413,331,82,2019-01-01,zipcode
ZCTA5 36426,01,15262,40511,621,96900,12294,5804,10884,1956,4287,3182,1030,429,7426,5884,1542,5884,4008,1876,2019-01-01,zipcode
ZCTA5 36432,01,2150,38125,-666666666,84000,1784,1048,1523,397,642,303,88,93,1142,648,494,648,528,120,2019-01-01,zipcode
ZCTA5 36435,01,370,35054,-666666666,69400,284,172,278,72,87,104,0,15,274,131,143,131,125,6,2019-01-01,zipcode
ZCTA5 36436,01,359,39231,-666666666,96100,334,192,245,55,109,81,0,0,212,122,90,122,115,7,2019-01-01,zipcode
ZCTA5 36439,01,502,38929,881,138800,345,165,319,33,114,102,36,34,243,192,51,192,110,82,2019-01-01,zipcode
ZCTA5 36441,01,3886,37656,651,89500,2849,1224,2652,318,1192,747,271,124,1846,1471,375,1471,1125,346,2019-01-01,zipcode
ZCTA5 36442,01,3356,35513,525,92900,2699,1386,2379,439,1016,752,108,64,1652,1252,400,1252,950,302,2019-01-01,zipcode
ZCTA5 36444,01,774,30982,-666666666,63800,632,460,577,159,285,94,19,20,586,301,285,301,201,100,2019-01-01,zipcode
ZCTA5 36445,01,4524,45316,662,101000,3552,2201,3175,529,1392,803,331,120,2315,1868,447,1868,1412,456,2019-01-01,zipcode
ZCTA5 36446,01,441,-666666666,-666666666,85000,359,231,308,54,175,63,0,16,252,155,97,155,116,39,2019-01-01,zipcode
ZCTA5 36451,01,4312,47551,548,116100,3435,1790,3107,532,1207,1103,154,111,2393,1720,673,1720,1322,398,2019-01-01,zipcode
ZCTA5 36453,01,2396,37607,613,78200,2072,1034,1769,303,671,594,131,70,1094,941,153,941,679,262,2019-01-01,zipcode
ZCTA5 36454,01,8,-666666666,-666666666,-666666666,8,8,8,0,8,0,0,0,42,5,37,5,5,0,2019-01-01,zipcode
ZCTA5 36455,01,252,37614,617,68300,215,109,205,42,94,60,7,2,174,117,57,117,84,33,2019-01-01,zipcode
ZCTA5 36456,01,1528,40481,525,50900,1144,618,992,120,478,313,44,37,782,545,237,545,428,117,2019-01-01,zipcode
ZCTA5 36460,01,10246,30511,536,124000,8275,3955,7003,893,3226,1847,715,322,4781,3776,1005,3776,2185,1591,2019-01-01,zipcode
ZCTA5 36467,01,9810,38795,602,91100,7963,3679,6957,1342,2608,2091,617,299,4871,3995,876,3995,2812,1183,2019-01-01,zipcode
ZCTA5 36470,01,51,-666666666,-666666666,-666666666,51,51,51,30,21,0,0,0,51,51,0,51,0,51,2019-01-01,zipcode
ZCTA5 36471,01,904,18203,-666666666,55400,738,518,658,94,436,85,20,23,827,413,414,413,282,131,2019-01-01,zipcode
ZCTA5 36473,01,102,60987,-666666666,116500,93,59,86,20,44,12,0,10,61,39,22,39,39,0,2019-01-01,zipcode
ZCTA5 36474,01,2647,47328,549,74100,2220,1082,1989,384,922,530,100,53,1471,1114,357,1114,1009,105,2019-01-01,zipcode
ZCTA5 36475,01,2393,28158,651,81100,1830,1013,1596,143,909,268,212,64,1306,878,428,878,660,218,2019-01-01,zipcode
ZCTA5 36476,01,16,-666666666,-666666666,-666666666,16,5,7,0,5,2,0,0,20,7,13,7,7,0,2019-01-01,zipcode
ZCTA5 36477,01,3688,32305,519,76400,2941,1452,2663,528,895,974,139,127,2108,1587,521,1587,1153,434,2019-01-01,zipcode
ZCTA5 36480,01,1682,27461,678,87800,1441,888,1200,149,489,445,46,71,1066,601,465,601,371,230,2019-01-01,zipcode
ZCTA5 36481,01,443,16161,-666666666,-666666666,358,257,253,75,123,42,0,13,293,135,158,135,56,79,2019-01-01,zipcode
ZCTA5 36482,01,1004,31711,-666666666,79900,881,493,783,224,255,227,64,13,568,386,182,386,341,45,2019-01-01,zipcode
ZCTA5 36483,01,447,42188,-666666666,106400,399,256,373,46,191,86,39,11,219,176,43,176,166,10,2019-01-01,zipcode
ZCTA5 36502,01,18113,32845,614,105800,14826,8429,12477,2582,6016,2501,833,545,7280,5837,1443,5837,3857,1980,2019-01-01,zipcode
ZCTA5 36505,01,1682,73090,1133,123000,1191,458,972,208,224,299,160,81,558,493,65,493,353,140,2019-01-01,zipcode
ZCTA5 36507,01,21360,44635,655,132200,17009,8164,14237,2328,5071,4513,1644,681,8397,7307,1090,7307,5231,2076,2019-01-01,zipcode
ZCTA5 36509,01,2054,43363,725,74900,1678,773,1427,572,413,340,83,19,804,683,121,683,438,245,2019-01-01,zipcode
ZCTA5 36511,01,221,20615,-666666666,111500,221,168,221,61,104,24,32,0,334,200,134,200,200,0,2019-01-01,zipcode
ZCTA5 36512,01,39,-666666666,-666666666,-666666666,39,39,39,13,26,0,0,0,20,20,0,20,20,0,2019-01-01,zipcode
ZCTA5 36513,01,672,27051,-666666666,126900,396,315,326,187,71,39,0,29,168,149,19,149,85,64,2019-01-01,zipcode
ZCTA5 36518,01,2744,40000,751,96800,2309,1245,1960,309,820,580,164,87,1470,1046,424,1046,764,282,2019-01-01,zipcode
ZCTA5 36521,01,6073,55610,788,118300,4853,2240,4387,749,2124,1172,234,108,2311,2162,149,2162,1853,309,2019-01-01,zipcode
ZCTA5 36522,01,7339,41319,766,101600,5373,2507,4749,882,2149,1187,399,132,2979,2609,370,2609,1933,676,2019-01-01,zipcode
ZCTA5 36523,01,2809,46420,847,118900,2310,1238,2111,611,822,427,125,126,1141,957,184,957,707,250,2019-01-01,zipcode
ZCTA5 36524,01,1328,35093,580,84400,1054,632,848,169,386,183,54,56,967,488,479,488,422,66,2019-01-01,zipcode
ZCTA5 36525,01,1914,43714,742,129600,1348,564,1187,169,497,339,136,46,699,628,71,628,463,165,2019-01-01,zipcode
ZCTA5 36526,01,34565,77739,1189,211600,26555,9295,22957,815,4821,8190,5676,3455,13673,12305,1368,12305,9336,2969,2019-01-01,zipcode
ZCTA5 36527,01,15517,94088,1248,278500,11764,3963,9989,384,1556,3259,2845,1945,5909,5724,185,5724,3996,1728,2019-01-01,zipcode
ZCTA5 36528,01,1324,87596,1111,257600,1224,592,1112,58,241,355,251,207,2060,585,1475,585,518,67,2019-01-01,zipcode
ZCTA5 36529,01,209,-666666666,-666666666,-666666666,170,105,145,8,87,28,7,15,125,77,48,77,77,0,2019-01-01,zipcode
ZCTA5 36530,01,6363,48906,853,167600,5415,2349,4589,674,1411,1559,669,276,3537,2627,910,2627,2144,483,2019-01-01,zipcode
ZCTA5 36532,01,35066,69766,1173,268700,27405,11908,24620,1644,4606,6570,7700,4100,15596,12929,2667,12929,10393,2536,2019-01-01,zipcode
ZCTA5 36535,01,33065,46753,836,171200,27586,12029,24720,2727,7951,7976,4299,1767,15704,13221,2483,13221,9544,3677,2019-01-01,zipcode
ZCTA5 36538,01,377,29000,-666666666,23500,328,219,323,162,143,6,12,0,307,182,125,182,182,0,2019-01-01,zipcode
ZCTA5 36539,01,688,32583,-666666666,-666666666,583,359,354,49,187,104,5,9,326,262,64,262,200,62,2019-01-01,zipcode
ZCTA5 36540,01,628,32870,-666666666,156000,564,296,501,116,288,81,4,12,316,246,70,246,203,43,2019-01-01,zipcode
ZCTA5 36541,01,15524,58794,1074,116100,11453,4610,9929,1822,3701,3121,803,482,5977,5086,891,5086,4592,494,2019-01-01,zipcode
ZCTA5 36542,01,14045,53792,1078,246100,12573,5044,11112,580,2623,3986,2410,1513,16634,6711,9923,6711,3951,2760,2019-01-01,zipcode
ZCTA5 36543,01,137,-666666666,-666666666,-666666666,69,8,69,0,0,41,12,16,82,41,41,41,41,0,2019-01-01,zipcode
ZCTA5 36544,01,11682,44681,852,106300,9256,3963,7973,1993,3577,1725,549,129,4680,4071,609,4071,3114,957,2019-01-01,zipcode
ZCTA5 36545,01,9743,35970,572,112000,7879,4344,6485,1311,2722,1527,508,417,4818,3413,1405,3413,2343,1070,2019-01-01,zipcode
ZCTA5 36548,01,998,-666666666,-666666666,141100,808,367,720,37,258,271,63,91,626,434,192,434,376,58,2019-01-01,zipcode
ZCTA5 36549,01,5687,50000,1109,141700,5096,3034,4629,269,1861,1483,757,259,2917,2268,649,2268,2055,213,2019-01-01,zipcode
ZCTA5 36550,01,179,118674,-666666666,-666666666,179,69,179,60,42,11,37,29,198,109,89,109,72,37,2019-01-01,zipcode
ZCTA5 36551,01,9573,58849,980,152100,7841,3303,6903,949,2505,2002,992,455,3556,3135,421,3135,2672,463,2019-01-01,zipcode
ZCTA5 36553,01,2721,45245,638,104800,2246,1333,1688,254,812,455,75,92,1260,826,434,826,787,39,2019-01-01,zipcode
ZCTA5 36555,01,806,60781,832,261900,759,366,682,23,206,199,195,59,478,347,131,347,314,33,2019-01-01,zipcode
ZCTA5 36556,01,571,-666666666,-666666666,47500,462,303,351,42,151,138,20,0,383,229,154,229,136,93,2019-01-01,zipcode
ZCTA5 36558,01,3677,49315,499,83000,2956,1423,2564,509,1022,560,252,221,2015,1485,530,1485,1321,164,2019-01-01,zipcode
ZCTA5 36559,01,213,26614,-666666666,629500,213,177,176,0,0,89,18,69,219,107,112,107,89,18,2019-01-01,zipcode
ZCTA5 36560,01,3243,36397,673,60100,2843,1502,2467,802,1019,500,106,40,1448,1263,185,1263,898,365,2019-01-01,zipcode
ZCTA5 36561,01,6843,83064,1188,337300,6158,2834,5636,254,1120,1381,2038,843,13641,3221,10420,3221,2514,707,2019-01-01,zipcode
ZCTA5 36562,01,1362,43816,822,119200,1135,554,1012,193,513,205,94,7,607,464,143,464,425,39,2019-01-01,zipcode
ZCTA5 36564,01,153,-666666666,-666666666,2000001,111,71,91,0,0,9,31,51,153,61,92,61,61,0,2019-01-01,zipcode
ZCTA5 36567,01,13980,51479,833,145300,10908,4774,9524,1622,3592,2991,945,374,5718,4976,742,4976,3579,1397,2019-01-01,zipcode
ZCTA5 36568,01,92,13750,-666666666,-666666666,92,62,76,25,21,13,0,17,68,68,0,68,55,13,2019-01-01,zipcode
ZCTA5 36569,01,570,44137,-666666666,-666666666,501,281,496,80,194,195,25,2,368,225,143,225,181,44,2019-01-01,zipcode
ZCTA5 36571,01,15474,58696,881,147200,12015,4993,10270,1439,3674,3215,1369,573,6294,5558,736,5558,4096,1462,2019-01-01,zipcode
ZCTA5 36572,01,6159,64348,885,155800,4893,2292,4316,399,1781,1197,641,298,2316,2205,111,2205,1882,323,2019-01-01,zipcode
ZCTA5 36574,01,1123,-666666666,-666666666,201800,960,609,811,84,406,169,118,34,525,352,173,352,319,33,2019-01-01,zipcode
ZCTA5 36575,01,21118,54921,779,148900,16028,6725,13869,1849,5524,4023,1677,796,8003,7372,631,7372,6028,1344,2019-01-01,zipcode
ZCTA5 36576,01,4198,57338,871,171700,3525,1212,3231,373,1284,875,590,109,2027,1753,274,1753,1363,390,2019-01-01,zipcode
ZCTA5 36578,01,1436,80313,740,240900,1111,364,1006,44,245,468,142,107,697,533,164,533,489,44,2019-01-01,zipcode
ZCTA5 36579,01,1214,48182,588,127200,966,536,940,120,367,226,160,67,1155,522,633,522,444,78,2019-01-01,zipcode
ZCTA5 36580,01,5507,47438,793,163300,4518,1908,3629,678,1351,1049,404,147,2377,1900,477,1900,1561,339,2019-01-01,zipcode
ZCTA5 36581,01,258,-666666666,-666666666,-666666666,221,101,221,0,213,8,0,0,176,106,70,106,89,17,2019-01-01,zipcode
ZCTA5 36582,01,24029,54544,735,125200,18044,7215,15782,2496,5454,4843,2225,764,9679,8548,1131,8548,6364,2184,2019-01-01,zipcode
ZCTA5 36583,01,898,41181,-666666666,165000,646,402,582,60,231,203,66,22,328,297,31,297,244,53,2019-01-01,zipcode
ZCTA5 36584,01,856,69531,-666666666,83500,671,272,621,135,246,188,47,5,570,324,246,324,260,64,2019-01-01,zipcode
ZCTA5 36585,01,1242,31154,762,91500,844,405,792,86,274,279,32,121,422,338,84,338,275,63,2019-01-01,zipcode
ZCTA5 36587,01,10317,50529,811,105700,8488,4565,6948,1620,2986,1769,389,184,4249,3252,997,3252,2813,439,2019-01-01,zipcode
ZCTA5 36590,01,0,-666666666,-666666666,-666666666,0,0,0,0,0,0,0,0,0,0,0,0,0,0,2019-01-01,zipcode
ZCTA5 36602,01,932,28750,446,203100,932,500,860,129,135,286,192,118,767,638,129,638,134,504,2019-01-01,zipcode
ZCTA5 36603,01,9552,20801,640,82500,8025,5699,6826,1893,2388,1828,517,200,3825,2847,978,2847,1079,1768,2019-01-01,zipcode
ZCTA5 36604,01,9423,47080,814,167000,7622,2571,6600,663,1331,1889,1545,1172,5165,4069,1096,4069,2193,1876,2019-01-01,zipcode
ZCTA5 36605,01,27372,35632,843,79900,21365,9642,17956,2606,7565,5277,1769,739,12949,10375,2574,10375,5711,4664,2019-01-01,zipcode
ZCTA5 36606,01,18787,40850,843,100100,14562,5393,12854,1446,4469,3266,2359,1314,9508,7937,1571,7937,4226,3711,2019-01-01,zipcode
ZCTA5 36607,01,6398,37220,799,104100,5250,2252,4625,640,1417,1184,811,573,3381,2739,642,2739,1439,1300,2019-01-01,zipcode
ZCTA5 36608,01,35336,51332,903,156800,29573,12029,23481,2008,5499,6788,5671,3515,17240,14959,2281,14959,7889,7070,2019-01-01,zipcode
ZCTA5 36609,01,23492,40363,824,151200,19249,7239,16640,1445,4368,5509,3501,1817,13293,11311,1982,11311,4952,6359,2019-01-01,zipcode
ZCTA5 36610,01,10728,25963,669,47800,8277,4754,7177,1527,3094,2002,397,157,5730,4001,1729,4001,2074,1927,2019-01-01,zipcode
ZCTA5 36611,01,5817,28611,816,75500,4013,1778,3309,509,1291,1113,245,151,2589,2134,455,2134,1101,1033,2019-01-01,zipcode
ZCTA5 36612,01,4626,22172,671,61500,3178,1793,2681,622,1130,779,69,81,1948,1618,330,1618,832,786,2019-01-01,zipcode
ZCTA5 36613,01,13583,39113,862,107400,10508,5267,8605,1484,3526,2670,679,246,5051,4173,878,4173,3170,1003,2019-01-01,zipcode
ZCTA5 36615,01,0,-666666666,-666666666,-666666666,0,0,0,0,0,0,0,0,0,0,0,0,0,0,2019-01-01,zipcode
ZCTA5 36616,01,8,-666666666,-666666666,-666666666,8,0,0,0,0,0,0,0,20,8,12,8,0,8,2019-01-01,zipcode
ZCTA5 36617,01,13306,31192,917,74200,10762,5514,9300,1402,3567,2769,916,646,5962,4941,1021,4941,2739,2202,2019-01-01,zipcode
ZCTA5 36618,01,17143,44531,858,107100,13859,6337,11571,1301,3853,3769,1656,992,7358,6653,705,6653,5188,1465,2019-01-01,zipcode
ZCTA5 36619,01,15507,50739,869,133600,12475,5235,10977,1416,4074,3240,1730,517,6549,5831,718,5831,4428,1403,2019-01-01,zipcode
ZCTA5 36688,01,237,-666666666,-666666666,-666666666,237,147,0,0,0,0,0,0,0,0,0,0,0,0,2019-01-01,zipcode
ZCTA5 36693,01,19721,61155,924,149500,16241,6257,14005,811,3666,4381,3498,1649,8836,7682,1154,7682,5158,2524,2019-01-01,zipcode
ZCTA5 36695,01,51804,69084,1040,186900,40640,14825,34242,2225,9369,10483,8337,3828,20442,18981,1461,18981,12583,6398,2019-01-01,zipcode
ZCTA5 36701,01,20558,37110,681,89900,16041,7223,13735,2032,4602,4659,1343,1099,11177,8526,2651,8526,4983,3543,2019-01-01,zipcode
ZCTA5 36703,01,12927,29990,602,78300,10065,5051,8518,1771,3481,2382,547,337,5953,5067,886,5067,2747,2320,2019-01-01,zipcode
ZCTA5 36720,01,963,17941,533,56300,771,526,523,180,137,132,58,16,454,342,112,342,266,76,2019-01-01,zipcode
ZCTA5 36722,01,441,29722,-666666666,90200,388,228,309,71,132,106,0,0,278,172,106,172,109,63,2019-01-01,zipcode
ZCTA5 36723,01,371,16343,-666666666,-666666666,193,129,176,70,42,64,0,0,225,127,98,127,65,62,2019-01-01,zipcode
ZCTA5 36726,01,4706,34205,451,84500,3615,1990,3220,703,1283,764,357,113,2453,1707,746,1707,1057,650,2019-01-01,zipcode
ZCTA5 36727,01,12,-666666666,-666666666,-666666666,12,5,12,0,5,7,0,0,60,12,48,12,12,0,2019-01-01,zipcode
ZCTA5 36728,01,214,19276,-666666666,53500,202,107,178,59,51,40,7,21,192,104,88,104,73,31,2019-01-01,zipcode
ZCTA5 36732,01,7706,28056,529,117500,6179,2872,5009,762,1612,1566,583,486,3911,3018,893,3018,1772,1246,2019-01-01,zipcode
ZCTA5 36736,01,1633,64792,943,75800,968,484,887,120,340,164,123,140,568,459,109,459,378,81,2019-01-01,zipcode
ZCTA5 36738,01,718,32765,-666666666,107400,646,422,524,56,262,130,54,22,341,245,96,245,202,43,2019-01-01,zipcode
ZCTA5 36740,01,1276,34521,590,91300,1080,619,919,186,371,251,51,60,914,472,442,472,334,138,2019-01-01,zipcode
ZCTA5 36742,01,1921,47466,583,57000,1744,1005,1399,305,566,362,84,82,1108,743,365,743,606,137,2019-01-01,zipcode
ZCTA5 36744,01,6294,29675,474,81000,5147,2655,4230,652,2011,954,439,174,3380,2537,843,2537,1684,853,2019-01-01,zipcode
ZCTA5 36748,01,2419,40208,658,84000,2138,1244,1818,204,773,607,83,151,1523,993,530,993,728,265,2019-01-01,zipcode
ZCTA5 36749,01,949,27266,-666666666,96700,851,509,687,189,289,162,27,20,462,399,63,399,250,149,2019-01-01,zipcode
ZCTA5 36750,01,2622,41944,398,110900,1942,1016,1744,349,795,478,46,76,1175,982,193,982,769,213,2019-01-01,zipcode
ZCTA5 36751,01,632,32143,659,32600,460,261,335,213,87,8,8,19,307,236,71,236,191,45,2019-01-01,zipcode
ZCTA5 36752,01,1146,-666666666,-666666666,106600,962,475,927,64,221,471,109,62,778,611,167,611,568,43,2019-01-01,zipcode
ZCTA5 36753,01,8,-666666666,-666666666,-666666666,8,8,8,8,0,0,0,0,23,8,15,8,0,8,2019-01-01,zipcode
ZCTA5 36754,01,473,-666666666,-666666666,194400,473,250,427,221,150,44,0,12,278,188,90,188,116,72,2019-01-01,zipcode
ZCTA5 36756,01,5867,25553,506,80800,4916,3044,3677,668,1303,824,449,433,2694,1866,828,1866,1302,564,2019-01-01,zipcode
ZCTA5 36758,01,1412,52212,-666666666,75000,1102,546,942,141,493,185,83,40,626,519,107,519,460,59,2019-01-01,zipcode
ZCTA5 36759,01,1831,37250,-666666666,70400,1404,720,1264,226,417,383,178,60,853,673,180,673,579,94,2019-01-01,zipcode
ZCTA5 36761,01,787,25750,832,45800,674,398,571,184,202,133,30,22,631,374,257,374,290,84,2019-01-01,zipcode
ZCTA5 36763,01,316,36250,806,-666666666,184,95,171,65,56,42,5,3,100,66,34,66,49,17,2019-01-01,zipcode
ZCTA5 36765,01,1685,22807,1005,59000,1276,797,1068,269,575,185,31,8,689,568,121,568,508,60,2019-01-01,zipcode
ZCTA5 36766,01,22,-666666666,-666666666,135000,22,11,22,6,0,0,9,7,22,16,6,16,12,4,2019-01-01,zipcode
ZCTA5 36767,01,1476,22891,504,42400,1246,679,1017,361,285,251,96,24,1056,651,405,651,444,207,2019-01-01,zipcode
ZCTA5 36768,01,900,28750,733,59200,817,403,666,64,220,283,67,32,669,344,325,344,290,54,2019-01-01,zipcode
ZCTA5 36769,01,2444,35197,526,75000,1957,1233,1650,319,808,347,128,48,1332,914,418,914,623,291,2019-01-01,zipcode
ZCTA5 36773,01,469,28507,664,109800,376,236,229,57,29,117,19,7,244,185,59,185,98,87,2019-01-01,zipcode
ZCTA5 36775,01,1025,35921,672,60800,761,354,708,100,243,316,44,5,569,402,167,402,313,89,2019-01-01,zipcode
ZCTA5 36776,01,1856,28182,-666666666,76200,1503,740,1144,136,354,477,147,30,821,576,245,576,484,92,2019-01-01,zipcode
ZCTA5 36782,01,2685,38214,339,75700,2002,1058,1810,250,687,703,146,24,1323,948,375,948,873,75,2019-01-01,zipcode
ZCTA5 36783,01,686,27143,461,73900,628,333,598,54,266,162,52,64,653,362,291,362,295,67,2019-01-01,zipcode
ZCTA5 36784,01,7181,37832,536,152400,5767,3173,5100,900,2254,1265,454,227,3680,2863,817,2863,1752,1111,2019-01-01,zipcode
ZCTA5 36785,01,1074,34079,756,93200,885,462,816,201,331,183,95,6,751,528,223,528,399,129,2019-01-01,zipcode
ZCTA5 36786,01,2474,18281,492,59100,1830,1101,1608,223,635,342,287,121,1493,921,572,921,647,274,2019-01-01,zipcode
ZCTA5 36790,01,89,-666666666,-666666666,49300,89,56,56,0,7,49,0,0,59,59,0,59,59,0,2019-01-01,zipcode
ZCTA5 36792,01,1396,69189,-666666666,113800,1009,479,943,93,379,417,17,37,745,492,253,492,410,82,2019-01-01,zipcode
ZCTA5 36793,01,279,-666666666,-666666666,154100,250,118,190,15,95,61,0,19,192,90,102,90,72,18,2019-01-01,zipcode
ZCTA5 36801,01,25071,46713,734,158300,19900,7027,17096,1669,5247,5125,2704,2351,10786,9854,932,9854,6132,3722,2019-01-01,zipcode
ZCTA5 36804,01,18535,51159,805,101900,14569,5918,12789,1672,3771,4493,1923,930,7281,6927,354,6927,5431,1496,2019-01-01,zipcode
ZCTA5 36830,01,39476,53972,887,268900,31790,11995,22794,1366,2778,5570,6969,6111,17534,15437,2097,15437,7933,7504,2019-01-01,zipcode
ZCTA5 36832,01,24596,30603,862,119900,21212,8535,11186,927,2031,3232,2896,2100,13297,10234,3063,10234,4140,6094,2019-01-01,zipcode
ZCTA5 36849,01,4185,-666666666,-666666666,-666666666,4185,3039,24,0,10,5,9,0,0,0,0,0,0,0,2019-01-01,zipcode
ZCTA5 36850,01,2612,33832,355,64900,2177,1134,1762,320,647,627,101,67,1391,1015,376,1015,810,205,2019-01-01,zipcode
ZCTA5 36852,01,2744,24718,784,89900,2139,973,1826,263,776,571,165,51,1193,956,237,956,685,271,2019-01-01,zipcode
ZCTA5 36853,01,7943,54248,705,166500,6695,3790,5928,861,1946,1508,1028,585,6025,3314,2711,3314,2726,588,2019-01-01,zipcode
ZCTA5 36854,01,15138,52093,795,117400,11971,4834,10108,1385,3483,3497,1221,522,7391,5811,1580,5811,3612,2199,2019-01-01,zipcode
ZCTA5 36855,01,1638,50016,730,139900,1328,528,1240,225,482,357,130,46,806,649,157,649,495,154,2019-01-01,zipcode
ZCTA5 36856,01,7811,72580,1433,198000,5660,2251,5041,487,1079,2035,1039,401,2746,2631,115,2631,2198,433,2019-01-01,zipcode
ZCTA5 36858,01,330,37917,632,96300,277,152,262,49,112,35,38,28,211,152,59,152,125,27,2019-01-01,zipcode
ZCTA5 36859,01,16,-666666666,-666666666,-666666666,16,16,16,16,0,0,0,0,8,8,0,8,8,0,2019-01-01,zipcode
ZCTA5 36860,01,1728,32209,671,67500,1492,805,1272,378,442,368,48,36,981,668,313,668,470,198,2019-01-01,zipcode
ZCTA5 36861,01,3013,49250,665,144200,2605,1191,2437,546,804,579,341,167,2050,1351,699,1351,1149,202,2019-01-01,zipcode
ZCTA5 36862,01,5868,34531,595,94800,4822,2450,4266,1006,1581,1295,261,123,2842,2326,516,2326,1610,716,2019-01-01,zipcode
ZCTA5 36863,01,11847,38538,722,98900,9753,4182,8492,1712,3070,2473,857,380,6239,4899,1340,4899,3461,1438,2019-01-01,zipcode
ZCTA5 36865,01,30,43750,-666666666,112500,30,13,21,0,11,9,1,0,20,12,8,12,9,3,2019-01-01,zipcode
ZCTA5 36866,01,3581,39409,605,79800,2956,1165,2701,431,1114,764,273,119,2007,1616,391,1616,1256,360,2019-01-01,zipcode
ZCTA5 36867,01,22239,45702,835,141500,17815,6283,14998,1826,4237,5318,2082,1535,10845,9428,1417,9428,4694,4734,2019-01-01,zipcode
ZCTA5 36869,01,20986,36333,802,105200,16103,7061,13468,2703,4447,4358,1279,681,9971,8162,1809,8162,4828,3334,2019-01-01,zipcode
ZCTA5 36870,01,19413,54067,798,137600,15275,5579,12933,1699,3510,5420,1166,1138,8192,7284,908,7284,5326,1958,2019-01-01,zipcode
ZCTA5 36871,01,1175,27197,393,84700,1003,565,947,92,477,198,148,32,692,496,196,496,429,67,2019-01-01,zipcode
ZCTA5 36874,01,9973,62722,1058,161500,7720,3268,6676,465,2420,2264,817,710,3941,3425,516,3425,2971,454,2019-01-01,zipcode
ZCTA5 36875,01,3782,54239,797,130900,3181,1448,2911,402,889,1196,262,162,1867,1638,229,1638,1226,412,2019-01-01,zipcode
ZCTA5 36877,01,12848,52076,893,154700,10321,3944,8961,986,2524,3488,1118,845,5412,4851,561,4851,3314,1537,2019-01-01,zipcode
ZCTA5 36879,01,2521,99489,930,250100,1940,617,1802,126,391,392,478,415,1081,903,178,903,819,84,2019-01-01,zipcode
ZCTA5 36901,01,369,30580,-666666666,50000,369,256,332,69,215,48,0,0,181,181,0,181,110,71,2019-01-01,zipcode
ZCTA5 36904,01,3734,36194,493,84600,3046,1632,2601,339,977,836,314,135,2111,1512,599,1512,1093,419,2019-01-01,zipcode
ZCTA5 36907,01,1597,23590,684,76600,1343,832,1097,111,430,185,207,164,1013,736,277,736,641,95,2019-01-01,zipcode
ZCTA5 36908,01,2176,55164,444,78100,1774,1008,1582,248,627,560,117,30,1128,839,289,839,755,84,2019-01-01,zipcode
ZCTA5 36910,01,63,-666666666,-666666666,-666666666,63,63,63,0,31,32,0,0,66,31,35,31,0,31,2019-01-01,zipcode
ZCTA5 36912,01,2069,32634,703,69500,1773,1106,1604,239,626,586,69,84,1155,829,326,829,659,170,2019-01-01,zipcode
ZCTA5 36913,01,36,-666666666,-666666666,-666666666,36,36,36,28,0,8,0,0,17,17,0,17,17,0,2019-01-01,zipcode
ZCTA5 36915,01,654,33125,-666666666,52700,503,265,418,40,133,172,72,1,387,241,146,241,165,76,2019-01-01,zipcode
ZCTA5 36916,01,797,30000,438,49400,676,468,641,155,268,176,9,33,510,334,176,334,265,69,2019-01-01,zipcode
ZCTA5 36919,01,1652,29333,558,71200,1341,794,1177,297,451,329,59,41,993,722,271,722,590,132,2019-01-01,zipcode
ZCTA5 36921,01,771,25238,675,74600,726,433,648,176,256,159,50,7,544,416,128,416,400,16,2019-01-01,zipcode
ZCTA5 36922,01,600,36136,-666666666,62100,482,266,374,186,113,67,0,8,323,230,93,230,199,31,2019-01-01,zipcode
ZCTA5 36925,01,3001,30904,498,45700,2451,1178,2182,349,704,761,208,160,1583,1246,337,1246,804,442,2019-01-01,zipcode
ZCTA5 34773,12,3883,59205,1792,214500,2673,1346,2377,334,541,740,494,268,1518,1161,357,1161,961,200,2020-01-01,zipcode
ZCTA5 34785,12,37555,60267,916,306800,35455,27514,34492,3232,10678,9421,6200,4961,18184,15192,2992,15192,13057,2135,2020-01-01,zipcode
ZCTA5 34987,12,10816,71547,1728,285300,8911,4685,8333,375,2135,2286,2156,1381,4995,4311,684,4311,3275,1036,2020-01-01,zipcode
ZCTA5 34996,12,11287,69248,1168,328300,10321,5903,9917,456,2134,3136,2098,2093,8969,5783,3186,5783,4815,968,2020-01-01,zipcode
ZCTA5 34491,12,29998,48187,947,181200,24961,15573,23407,2323,9579,7195,2569,1741,14772,12738,2034,12738,11039,1699,2020-01-01,zipcode
ZCTA5 34695,12,18442,83020,1281,285300,15284,5875,13602,350,3608,3734,3985,1925,8096,7229,867,7229,6042,1187,2020-01-01,zipcode
ZCTA5 34737,12,3016,75833,1398,286800,2592,1158,2324,168,670,756,428,302,1402,1200,202,1200,959,241,2020-01-01,zipcode
ZCTA5 34242,12,7643,111653,2011,729500,7119,4348,6747,233,588,1562,2418,1946,10696,3939,6757,3939,3429,510,2020-01-01,zipcode
ZCTA5 34266,12,31733,34770,741,90100,25994,12975,22349,6312,9915,3861,1442,819,12207,10112,2095,10112,6567,3545,2020-01-01,zipcode
ZCTA5 34287,12,27620,52793,1124,160100,23776,13817,21898,1752,7910,7782,2791,1663,15470,11295,4175,11295,8700,2595,2020-01-01,zipcode
ZCTA5 34431,12,8116,40582,769,128700,6997,4257,6464,1101,2482,1970,551,360,4537,3713,824,3713,3126,587,2020-01-01,zipcode
ZCTA5 34433,12,6998,56232,930,157200,5927,2842,5175,748,2139,1512,488,288,3594,2913,681,2913,2613,300,2020-01-01,zipcode
ZCTA5 34434,12,8233,49769,1137,139900,6524,3318,6249,551,2763,2061,696,178,3924,3121,803,3121,2647,474,2020-01-01,zipcode
ZCTA5 34446,12,17878,48271,892,143900,15754,11167,14702,1414,5431,5136,1744,977,9100,7861,1239,7861,7054,807,2020-01-01,zipcode
ZCTA5 34465,12,16652,47099,881,148400,14470,8956,13155,1257,4874,4657,1310,1057,8529,7555,974,7555,6158,1397,2020-01-01,zipcode
ZCTA5 34481,12,21462,44052,978,132100,20272,15287,19246,1494,6472,5799,3361,2120,12455,11414,1041,11414,10099,1315,2020-01-01,zipcode
ZCTA5 34484,12,3361,39050,3248,221500,2925,1715,2713,509,894,730,256,324,1978,1614,364,1614,886,728,2020-01-01,zipcode
ZCTA5 34652,12,24549,42595,948,134400,21380,10635,19341,2436,7642,6044,2257,962,14808,10982,3826,10982,6687,4295,2020-01-01,zipcode
ZCTA5 34669,12,14022,47226,1100,157300,11653,5877,10224,1107,4510,3219,992,396,6159,5439,720,5439,4448,991,2020-01-01,zipcode
ZCTA5 34681,12,589,48472,-666666666,474000,442,235,440,28,49,100,237,26,407,298,109,298,298,0,2020-01-01,zipcode
ZCTA5 34684,12,28058,56682,1439,196300,24780,11721,22531,1277,6193,7612,5032,2417,14579,13173,1406,13173,9332,3841,2020-01-01,zipcode
ZCTA5 34691,12,20473,40537,1020,107200,16949,7738,15436,1326,7496,4361,1719,534,11949,8946,3003,8946,5642,3304,2020-01-01,zipcode
ZCTA5 34114,12,17856,62694,1318,303200,15784,9324,14776,1518,4159,4072,3146,1881,13190,7829,5361,7829,6530,1299,2020-01-01,zipcode
ZCTA5 34141,12,110,-666666666,-666666666,-666666666,91,68,78,0,55,8,3,12,12,12,0,12,4,8,2020-01-01,zipcode
ZCTA5 34698,12,39317,51432,1108,218300,35258,16769,32772,2364,8943,10985,6348,4132,22099,18732,3367,18732,13120,5612,2020-01-01,zipcode
ZCTA5 34734,12,4529,79773,1422,322700,3080,1061,2657,138,611,789,804,315,1304,1304,0,1304,1061,243,2020-01-01,zipcode
ZCTA5 34235,12,14269,58879,1439,241600,13147,6300,11631,529,2966,3939,2251,1946,8052,6502,1550,6502,4986,1516,2020-01-01,zipcode
ZCTA5 34448,12,10140,45119,823,101600,8857,5091,8431,1097,3484,2689,927,234,6221,4625,1596,4625,3684,941,2020-01-01,zipcode
ZCTA5 34202,12,23759,103226,1788,454200,19546,9371,17404,515,2842,4513,4922,4612,10904,8812,2092,8812,6827,1985,2020-01-01,zipcode
ZCTA5 34432,12,12793,43798,858,147000,11066,6822,10427,1132,3840,3273,1483,699,6498,5672,826,5672,4996,676,2020-01-01,zipcode
ZCTA5 34450,12,11074,38600,793,136000,9881,6113,8753,793,2949,3161,1109,741,6583,5218,1365,5218,4004,1214,2020-01-01,zipcode
ZCTA5 34461,12,12154,45598,874,197600,10915,7076,9741,1112,4053,2308,1279,989,5839,4542,1297,4542,3829,713,2020-01-01,zipcode
ZCTA5 34472,12,31271,49590,983,124700,24473,10301,20741,3127,7307,6686,2315,1306,12597,11106,1491,11106,8395,2711,2020-01-01,zipcode
ZCTA5 34476,12,22857,52827,945,162300,19863,11873,18526,1232,6534,6138,2792,1830,11920,10605,1315,10605,9585,1020,2020-01-01,zipcode
ZCTA5 34609,12,43374,57924,1173,182400,35259,16502,31206,3205,9207,12362,4226,2206,17613,16170,1443,16170,13100,3070,2020-01-01,zipcode
ZCTA5 34667,12,32360,43363,966,147500,28739,17143,26984,2970,10798,8267,3062,1887,20091,15736,4355,15736,11462,4274,2020-01-01,zipcode
ZCTA5 34679,12,33,-666666666,-666666666,-666666666,33,33,33,0,33,0,0,0,41,22,19,22,10,12,2020-01-01,zipcode
ZCTA5 34689,12,27428,51753,918,225800,23611,11544,21400,1915,6339,6576,4004,2566,14012,11823,2189,11823,9037,2786,2020-01-01,zipcode
ZCTA5 34705,12,3010,54135,868,151900,2303,904,1915,379,724,554,209,49,1148,1000,148,1000,806,194,2020-01-01,zipcode
ZCTA5 34739,12,551,82361,-666666666,96000,447,75,306,189,23,58,36,0,450,263,187,263,112,151,2020-01-01,zipcode
ZCTA5 34104,12,24106,54957,1367,262600,19545,9469,18116,2226,4710,5592,3318,2270,14984,10404,4580,10404,7143,3261,2020-01-01,zipcode
ZCTA5 34112,12,28702,60313,1145,234400,26023,14934,23886,2257,7389,6876,4296,3068,20179,12986,7193,12986,10343,2643,2020-01-01,zipcode
ZCTA5 34116,12,37138,55488,1310,266900,29066,8554,24708,6261,8348,6246,2527,1326,10447,9666,781,9666,5199,4467,2020-01-01,zipcode
ZCTA5 34142,12,33029,38082,790,203800,24399,9131,19067,9073,5252,2786,1301,655,8744,7532,1212,7532,3451,4081,2020-01-01,zipcode
ZCTA5 34210,12,16799,50621,1169,219600,14922,7620,12943,843,3983,3900,2774,1443,11179,7293,3886,7293,4449,2844,2020-01-01,zipcode
ZCTA5 34215,12,633,27444,-666666666,817300,619,481,574,0,80,217,164,113,525,299,226,299,287,12,2020-01-01,zipcode
ZCTA5 34216,12,1092,80865,-666666666,911300,1032,701,1015,43,150,274,360,188,1679,607,1072,607,572,35,2020-01-01,zipcode
ZCTA5 34223,12,18500,55797,1074,254100,17343,12216,16856,596,5620,4951,3460,2229,14012,9666,4346,9666,8096,1570,2020-01-01,zipcode
ZCTA5 34239,12,15178,59010,1388,300400,13210,5321,12236,1018,2621,3629,3115,1853,8318,6978,1340,6978,5086,1892,2020-01-01,zipcode
ZCTA5 33573,12,25132,49368,1783,186700,23453,17565,22874,1085,7111,7460,4495,2723,15427,13440,1987,13440,10706,2734,2020-01-01,zipcode
ZCTA5 33602,12,15860,71894,1656,368100,13970,4403,12813,1106,2045,2710,3603,3349,10051,8599,1452,8599,3097,5502,2020-01-01,zipcode
ZCTA5 33624,12,39750,71668,1321,255600,32506,9610,28744,1627,6994,8026,7913,4184,15730,15043,687,15043,9636,5407,2020-01-01,zipcode
ZCTA5 33710,12,35695,61970,1231,208900,29977,10593,26952,1875,7841,8184,6429,2623,16478,14369,2109,14369,11316,3053,2020-01-01,zipcode
ZCTA5 33759,12,18303,53611,1428,188600,14814,6022,13325,1358,3621,4142,2688,1516,8844,7820,1024,7820,4218,3602,2020-01-01,zipcode
ZCTA5 33762,12,8542,67134,1408,245400,7901,4384,7180,876,2141,1983,1390,790,3100,2633,467,2633,2014,619,2020-01-01,zipcode
ZCTA5 33771,12,29868,47114,1112,83400,25707,11381,23402,2186,7712,8220,3993,1291,17118,13316,3802,13316,7768,5548,2020-01-01,zipcode
ZCTA5 33773,12,17290,59305,1079,192300,15044,5411,13457,1216,3743,4622,2980,896,8116,6831,1285,6831,5160,1671,2020-01-01,zipcode
ZCTA5 33774,12,19270,63370,1104,243700,15609,6581,14406,1237,3744,5703,2402,1320,10291,7988,2303,7988,6124,1864,2020-01-01,zipcode
ZCTA5 33810,12,51595,58100,1116,168600,41856,18332,36429,4982,12848,12338,3898,2363,20623,17958,2665,17958,13762,4196,2020-01-01,zipcode
ZCTA5 33813,12,38080,85383,1270,245600,29547,11083,25827,1384,6347,8255,6252,3589,13993,12939,1054,12939,10241,2698,2020-01-01,zipcode
ZCTA5 33830,12,30242,46112,820,154100,23631,9015,20235,2489,8170,5491,2880,1205,11366,9829,1537,9829,6326,3503,2020-01-01,zipcode
ZCTA5 33834,12,7451,48287,766,81000,5944,3507,5065,1230,2483,887,337,128,2153,1728,425,1728,1163,565,2020-01-01,zipcode
ZCTA5 33837,12,32185,60531,1405,209200,25562,10791,22920,2597,6221,8103,4216,1783,14436,10313,4123,10313,8183,2130,2020-01-01,zipcode
ZCTA5 33838,12,4552,38889,855,150400,3302,1660,2862,760,1205,728,121,48,1671,1356,315,1356,843,513,2020-01-01,zipcode
ZCTA5 33908,12,35798,58556,1431,271500,33206,20332,31323,1486,8567,8384,7421,5465,31582,18163,13419,18163,12864,5299,2020-01-01,zipcode
ZCTA5 33922,12,4057,50603,988,229400,3510,2121,3389,372,949,1121,451,496,2714,1674,1040,1674,1452,222,2020-01-01,zipcode
ZCTA5 33931,12,10984,64742,1192,373800,10820,7292,10484,555,3043,3044,2011,1831,15338,5537,9801,5537,5023,514,2020-01-01,zipcode
ZCTA5 33935,12,23872,37155,815,113100,18201,7273,15184,4782,4926,3931,995,550,8337,7109,1228,7109,5146,1963,2020-01-01,zipcode
ZCTA5 33945,12,6,-666666666,-666666666,-666666666,6,6,6,0,0,0,6,0,202,6,196,6,6,0,2020-01-01,zipcode
ZCTA5 33952,12,35285,44456,983,159700,30623,15848,27894,3383,10024,9352,3549,1586,16848,14495,2353,14495,10498,3997,2020-01-01,zipcode
ZCTA5 33980,12,13461,50018,897,161700,11912,8051,11017,823,3974,3775,1475,970,8210,6101,2109,6101,4697,1404,2020-01-01,zipcode
ZCTA5 33027,12,66467,58063,1455,316800,55764,23292,49930,3212,14901,14116,10209,7492,26072,24319,1753,24319,18806,5513,2020-01-01,zipcode
ZCTA5 33013,12,30524,41177,1171,278800,26754,10779,23435,7023,8418,4340,2743,911,9615,9293,322,9293,5403,3890,2020-01-01,zipcode
ZCTA5 33033,12,58869,55174,1417,248500,42483,14316,34659,7645,9083,9741,5722,2468,16780,15906,874,15906,8631,7275,2020-01-01,zipcode
ZCTA5 33050,12,9530,58120,1352,559100,8078,2859,7290,712,1919,2151,1684,824,7252,4183,3069,4183,2229,1954,2020-01-01,zipcode
ZCTA5 33063,12,54916,47800,1413,208500,47963,17227,44129,5008,15358,12838,8094,2831,27673,24451,3222,24451,17341,7110,2020-01-01,zipcode
ZCTA5 33067,12,26294,106890,1783,457200,20516,6067,17638,659,3028,5209,4877,3865,8697,8269,428,8269,5946,2323,2020-01-01,zipcode
ZCTA5 33069,12,29321,50975,1354,178400,23899,10568,21235,2855,6065,6302,3967,2046,14561,10500,4061,10500,4818,5682,2020-01-01,zipcode
ZCTA5 33125,12,60347,31371,1076,265500,51918,22974,45521,15529,14799,6930,5742,2521,23037,21716,1321,21716,5793,15923,2020-01-01,zipcode
ZCTA5 33127,12,30795,32688,1055,247900,24232,10634,21090,6245,7385,4457,1990,1013,11158,9800,1358,9800,2827,6973,2020-01-01,zipcode
ZCTA5 35211,01,24876,31785,876,81300,20336,8597,17537,2486,5291,5951,2609,1200,14923,11493,3430,11493,5183,6310,2020-01-01,zipcode
ZCTA5 35214,01,17021,54800,785,118700,14317,6319,12638,996,3542,4287,2594,1219,8522,7259,1263,7259,5204,2055,2020-01-01,zipcode
ZCTA5 35242,01,56713,98055,1142,364400,46446,15440,40129,1185,4351,9432,16026,9135,24719,22832,1887,22832,16191,6641,2020-01-01,zipcode
ZCTA5 35470,01,5123,23467,705,130900,4154,1915,2306,240,759,791,200,316,2437,1952,485,1952,911,1041,2020-01-01,zipcode
ZCTA5 35481,01,3208,40352,394,90000,2745,1450,2304,429,1041,628,122,84,1778,1451,327,1451,957,494,2020-01-01,zipcode
ZCTA5 35504,01,12420,60714,659,162300,10091,4559,8858,1243,2644,3027,1383,561,5737,4904,833,4904,4037,867,2020-01-01,zipcode
ZCTA5 35555,01,10050,41599,543,102900,8370,3967,7184,834,3041,2246,816,247,5404,4131,1273,4131,2834,1297,2020-01-01,zipcode
ZCTA5 35581,01,6206,41500,673,87100,4451,2189,3786,759,1335,1200,316,176,2535,2012,523,2012,1483,529,2020-01-01,zipcode
ZCTA5 35582,01,4871,34602,439,84300,3781,1554,3369,593,1368,682,583,143,2397,2002,395,2002,1428,574,2020-01-01,zipcode
ZCTA5 35611,01,27293,45195,641,135700,22414,9837,19432,3585,6141,5850,2683,1173,11851,10290,1561,10290,6185,4105,2020-01-01,zipcode
ZCTA5 35620,01,10668,68667,878,141900,8607,3105,6995,590,2624,2719,514,548,3902,3536,366,3536,3050,486,2020-01-01,zipcode
ZCTA5 35621,01,3113,55000,944,109000,2355,1057,2052,472,630,548,339,63,1234,1186,48,1186,1054,132,2020-01-01,zipcode
ZCTA5 35755,01,435,41875,-666666666,385700,419,220,335,19,93,110,75,38,420,203,217,203,148,55,2020-01-01,zipcode
ZCTA5 35773,01,13688,54119,914,130600,11171,3939,10175,1042,2975,3268,1869,1021,5537,5115,422,5115,4128,987,2020-01-01,zipcode
ZCTA5 35802,01,22301,62231,871,243200,18760,7115,16535,621,2333,5415,4840,3326,11871,10707,1164,10707,5842,4865,2020-01-01,zipcode
ZCTA5 35805,01,19761,26598,667,77300,15317,5612,12374,3144,3161,4105,1420,544,10031,8954,1077,8954,2515,6439,2020-01-01,zipcode
ZCTA5 35904,01,14130,38173,665,77200,11320,5344,9942,1663,3727,3255,865,432,6717,5338,1379,5338,4066,1272,2020-01-01,zipcode
ZCTA5 35980,01,5925,49549,631,112700,4634,2064,3632,788,1251,992,277,324,2186,1952,234,1952,1583,369,2020-01-01,zipcode
ZCTA5 35031,01,7460,42121,594,123900,6146,3051,5200,977,1707,1819,404,293,3373,2630,743,2630,1735,895,2020-01-01,zipcode
ZCTA5 35956,01,8608,52324,667,132800,6882,3248,5914,964,2069,2009,492,380,3667,3091,576,3091,2490,601,2020-01-01,zipcode
ZCTA5 35966,01,3951,49479,685,122700,3319,1560,2858,819,961,744,214,120,1944,1485,459,1485,1261,224,2020-01-01,zipcode
ZCTA5 35981,01,2040,43250,579,95500,1736,644,1453,281,532,423,189,28,891,667,224,667,482,185,2020-01-01,zipcode
ZCTA5 35010,01,20208,44690,612,105900,16277,7407,14263,2723,5000,4234,1266,1040,10407,8055,2352,8055,5566,2489,2020-01-01,zipcode
ZCTA5 35064,01,10858,41540,809,95100,8835,3671,7107,472,2734,2397,1048,456,5463,4425,1038,4425,2417,2008,2020-01-01,zipcode
ZCTA5 35046,01,5002,56223,740,130300,3781,1610,3282,452,1607,765,308,150,2801,1953,848,1953,1594,359,2020-01-01,zipcode
ZCTA5 35053,01,2457,72000,807,222700,1918,902,1803,265,503,551,341,143,2371,854,1517,854,808,46,2020-01-01,zipcode
ZCTA5 35063,01,3130,57829,779,79900,2648,1165,2338,545,858,848,67,20,1724,1258,466,1258,1149,109,2020-01-01,zipcode
ZCTA5 35072,01,4835,39118,540,80200,3795,2039,3441,585,1687,782,259,128,2645,1808,837,1808,1441,367,2020-01-01,zipcode
ZCTA5 35078,01,2057,62321,792,167000,1636,659,1467,214,459,535,152,107,1092,787,305,787,685,102,2020-01-01,zipcode
ZCTA5 35087,01,2684,31270,898,106900,2206,993,1971,469,516,784,145,57,1125,1069,56,1069,866,203,2020-01-01,zipcode
ZCTA5 35097,01,1900,41563,1101,134100,1554,878,1417,237,578,421,121,60,715,695,20,695,642,53,2020-01-01,zipcode
ZCTA5 35114,01,8170,83458,1034,195100,6053,1864,5089,255,1002,1635,1295,902,3058,2859,199,2859,2532,327,2020-01-01,zipcode
ZCTA5 35117,01,5203,73750,706,160300,4180,1544,3493,291,991,1347,638,226,2157,1979,178,1979,1768,211,2020-01-01,zipcode
ZCTA5 35119,01,138,-666666666,-666666666,-666666666,138,65,138,103,35,0,0,0,30,30,0,30,0,30,2020-01-01,zipcode
ZCTA5 35127,01,9625,64087,1099,157400,8114,2864,6760,358,1902,3029,827,644,3975,3668,307,3668,3013,655,2020-01-01,zipcode
ZCTA5 35136,01,2047,36612,-666666666,143600,1767,1059,1493,159,519,576,212,27,1273,785,488,785,651,134,2020-01-01,zipcode
ZCTA5 35149,01,249,40964,-666666666,103900,249,74,179,15,164,0,0,0,162,125,37,125,81,44,2020-01-01,zipcode
ZCTA5 35180,01,14305,61037,643,148400,11031,5029,9447,1224,3492,3510,815,406,5457,5003,454,5003,4235,768,2020-01-01,zipcode
ZCTA5 35188,01,2351,55568,641,128600,1832,748,1509,291,697,413,80,28,888,715,173,715,547,168,2020-01-01,zipcode
ZCTA5 35228,01,10558,39330,877,68500,8368,3455,7126,1203,2538,2066,1047,272,4730,3937,793,3937,2430,1507,2020-01-01,zipcode
ZCTA5 35401,01,37909,25358,780,114600,33489,18214,17518,2721,5766,4309,2613,2109,18610,12191,6419,12191,4014,8177,2020-01-01,zipcode
ZCTA5 35447,01,3328,33750,435,112600,2761,1508,2447,429,1035,758,143,82,1794,1314,480,1314,951,363,2020-01-01,zipcode
ZCTA5 35453,01,11738,64021,809,138400,8870,2899,7632,1234,2912,2251,761,474,4580,3937,643,3937,3391,546,2020-01-01,zipcode
ZCTA5 35457,01,28,-666666666,-666666666,-666666666,28,0,28,0,28,0,0,0,28,28,0,28,28,0,2020-01-01,zipcode
ZCTA5 35462,01,4355,27565,527,95300,3346,1886,3178,741,988,1076,237,136,2481,1742,739,1742,1127,615,2020-01-01,zipcode
ZCTA5 35466,01,4999,46466,616,105000,3959,1916,3313,425,1147,1089,412,240,2421,2036,385,2036,1708,328,2020-01-01,zipcode
ZCTA5 35476,01,6833,46728,810,143700,5485,2057,4874,610,1410,1735,683,436,3197,2675,522,2675,1080,1595,2020-01-01,zipcode
ZCTA5 35543,01,1308,27188,592,61300,935,524,812,339,236,157,58,22,618,499,119,499,329,170,2020-01-01,zipcode
ZCTA5 35550,01,5322,43267,532,74700,4375,2332,3906,767,1426,1268,303,142,2597,2195,402,2195,1861,334,2020-01-01,zipcode
ZCTA5 35585,01,1139,42950,-666666666,168800,936,500,794,112,167,250,201,64,524,414,110,414,329,85,2020-01-01,zipcode
ZCTA5 35587,01,538,35682,-666666666,87300,517,319,510,141,248,108,2,11,437,304,133,304,270,34,2020-01-01,zipcode
ZCTA5 35622,01,7138,48409,770,104300,5230,2337,4619,669,1954,1430,375,191,3014,2506,508,2506,1857,649,2020-01-01,zipcode
ZCTA5 35633,01,20593,58832,786,141000,16734,7368,14586,1749,4794,4152,2586,1305,9356,8236,1120,8236,7065,1171,2020-01-01,zipcode
ZCTA5 35643,01,3501,45395,562,102400,3110,1424,2817,950,1081,479,214,93,1652,1450,202,1450,1281,169,2020-01-01,zipcode
ZCTA5 35648,01,3226,59135,561,117100,2580,988,2180,226,945,672,147,190,1325,1164,161,1164,953,211,2020-01-01,zipcode
ZCTA5 35651,01,1614,52348,728,-666666666,1320,675,1115,148,463,225,273,6,640,537,103,537,420,117,2020-01-01,zipcode
ZCTA5 32812,12,35174,58665,1166,257500,29216,9254,25541,2306,6018,8499,6223,2495,15195,13889,1306,13889,7899,5990,2020-01-01,zipcode
ZCTA5 32821,12,19220,51993,1419,226500,16569,4180,14102,594,2762,4757,4728,1261,14128,8111,6017,8111,2632,5479,2020-01-01,zipcode
ZCTA5 32043,12,28501,61295,1002,198000,22165,8739,19412,1833,6367,6402,3635,1175,11514,10382,1132,10382,8140,2242,2020-01-01,zipcode
ZCTA5 32130,12,5393,51250,1071,185900,4399,2228,3961,523,1672,1088,435,243,2161,1793,368,1793,1462,331,2020-01-01,zipcode
ZCTA5 32009,12,3841,65250,861,141100,3146,976,2487,205,1190,831,209,52,1490,1384,106,1384,1211,173,2020-01-01,zipcode
ZCTA5 32011,12,13910,63203,818,169700,11438,5058,10071,1651,4150,2949,882,439,5868,5318,550,5318,4566,752,2020-01-01,zipcode
ZCTA5 32024,12,18957,56216,902,144300,15726,6782,13868,1869,5179,4336,1852,632,7695,7016,679,7016,5917,1099,2020-01-01,zipcode
ZCTA5 32063,12,13495,63728,798,179100,10715,5039,9033,967,3363,2773,1251,679,5018,4417,601,4417,3115,1302,2020-01-01,zipcode
ZCTA5 32082,12,28503,111746,1447,546100,24041,10259,21387,466,2350,4511,8846,5214,14708,11719,2989,11719,9467,2252,2020-01-01,zipcode
ZCTA5 32083,12,4188,58750,841,115700,3756,3269,3533,1055,1301,1003,118,56,663,574,89,574,388,186,2020-01-01,zipcode
ZCTA5 32087,12,6541,65211,688,110100,5242,3108,4472,1124,2063,1093,140,52,1605,1386,219,1386,965,421,2020-01-01,zipcode
ZCTA5 32091,12,15026,41633,756,107600,12026,5499,10777,1650,4727,3242,768,390,7018,5900,1118,5900,3571,2329,2020-01-01,zipcode
ZCTA5 32092,12,39858,90668,1775,298600,31927,12104,28382,2234,6365,7556,7995,4232,15616,13656,1960,13656,12015,1641,2020-01-01,zipcode
ZCTA5 32134,12,7712,36716,659,87000,6654,4064,6120,1021,2744,1767,408,180,5867,3277,2590,3277,2902,375,2020-01-01,zipcode
ZCTA5 32206,12,16118,31526,758,90300,12508,5030,10879,2259,3677,3416,925,602,8749,6587,2162,6587,2889,3698,2020-01-01,zipcode
ZCTA5 32218,12,65878,57327,1118,182100,49722,17987,42469,4051,12866,15736,6594,3222,25091,22441,2650,22441,14266,8175,2020-01-01,zipcode
ZCTA5 34234,12,22330,41933,1045,154000,18393,8477,15894,2661,5734,3940,2245,1314,10255,8646,1609,8646,4890,3756,2020-01-01,zipcode
ZCTA5 33967,12,26277,73084,1374,241000,21135,6277,17285,1747,4614,5564,3911,1449,10123,8494,1629,8494,6379,2115,2020-01-01,zipcode
ZCTA5 33973,12,16595,44116,1103,221200,10846,3749,8761,1661,3557,2343,756,444,4311,4025,286,4025,888,3137,2020-01-01,zipcode
ZCTA5 33974,12,19304,51669,1309,172900,14748,5283,12536,2031,4625,3818,1382,680,5504,4909,595,4909,2962,1947,2020-01-01,zipcode
ZCTA5 33976,12,16933,52778,1316,166700,12172,3439,9981,2439,3242,3006,1015,279,4857,4541,316,4541,3031,1510,2020-01-01,zipcode
ZCTA5 33076,12,41884,138816,2565,543300,30141,10753,25499,816,4466,4886,7996,7335,13290,12372,918,12372,10298,2074,2020-01-01,zipcode
ZCTA5 32210,12,62457,48756,1000,144900,48581,15835,42246,4954,14684,13598,6023,2987,27506,24886,2620,24886,13127,11759,2020-01-01,zipcode
ZCTA5 32250,12,27612,94219,1494,378300,23504,7147,21087,1078,3459,4939,7315,4296,14457,12469,1988,12469,8716,3753,2020-01-01,zipcode
ZCTA5 32277,12,32446,48818,1041,183200,25686,8605,21168,1982,7192,7137,3654,1203,13331,12259,1072,12259,5783,6476,2020-01-01,zipcode
ZCTA5 32320,12,4035,52665,729,187100,3408,1580,3105,716,983,792,376,238,2319,1832,487,1832,1237,595,2020-01-01,zipcode
ZCTA5 32346,12,1709,44097,1636,188100,1315,650,1275,261,394,445,146,29,1674,776,898,776,627,149,2020-01-01,zipcode
ZCTA5 32351,12,18095,36950,600,86300,14119,7955,11839,2665,4121,3191,1178,684,7345,5934,1411,5934,3939,1995,2020-01-01,zipcode
ZCTA5 32025,12,24317,42848,851,126900,19589,10305,16057,2716,5566,5373,1559,843,9281,7959,1322,7959,4755,3204,2020-01-01,zipcode
ZCTA5 32046,12,10615,59302,861,171200,8579,3842,7623,981,3884,2163,405,190,4001,3550,451,3550,2715,835,2020-01-01,zipcode
ZCTA5 32054,12,11802,54931,625,112100,9730,6040,8572,1843,3307,2371,693,358,3937,3497,440,3497,2548,949,2020-01-01,zipcode
ZCTA5 32068,12,56217,67247,1189,168600,44047,15743,37625,3417,13853,13149,5330,1876,20934,19078,1856,19078,14720,4358,2020-01-01,zipcode
ZCTA5 32179,12,7843,31463,824,104700,6803,3747,6111,1005,2305,1895,495,411,4704,3571,1133,3571,2886,685,2020-01-01,zipcode
ZCTA5 32181,12,2696,41000,750,86300,2159,1115,1679,242,680,506,167,84,1473,1088,385,1088,729,359,2020-01-01,zipcode
ZCTA5 32207,12,35659,51030,935,175900,28867,9424,25111,4146,6176,6316,5363,3110,17670,15566,2104,15566,7550,8016,2020-01-01,zipcode
ZCTA5 32220,12,12703,68526,970,155100,9906,3233,8590,1117,3446,2680,884,463,4859,4554,305,4554,3919,635,2020-01-01,zipcode
ZCTA5 32233,12,25318,65873,1194,313200,21326,6422,18312,1052,4558,5643,4656,2403,11271,10003,1268,10003,5795,4208,2020-01-01,zipcode
ZCTA5 32246,12,55325,61730,1222,206300,43542,12246,37460,3175,9726,11280,9314,3965,23804,21387,2417,21387,11478,9909,2020-01-01,zipcode
ZCTA5 32301,12,32552,45890,992,162000,27318,9073,18848,1839,3501,5461,4808,3239,15550,13163,2387,13163,3813,9350,2020-01-01,zipcode
ZCTA5 32321,12,6534,36461,717,74100,5594,3686,4741,1109,2124,910,374,224,2475,1721,754,1721,1371,350,2020-01-01,zipcode
ZCTA5 32324,12,4858,32500,705,62800,4326,2846,3893,771,1971,848,171,132,2299,1918,381,1918,1232,686,2020-01-01,zipcode
ZCTA5 32328,12,3682,48478,866,219300,3009,1324,2660,386,886,646,420,322,3173,1553,1620,1553,1275,278,2020-01-01,zipcode
ZCTA5 32330,12,743,41429,816,83800,499,247,444,169,169,96,10,0,345,272,73,272,156,116,2020-01-01,zipcode
ZCTA5 32332,12,1103,26220,-666666666,72600,939,525,772,223,339,122,72,16,572,505,67,505,294,211,2020-01-01,zipcode
ZCTA5 32334,12,1799,45758,736,110300,1475,606,1268,119,581,350,131,87,1019,792,227,792,606,186,2020-01-01,zipcode
ZCTA5 32428,12,17807,40084,698,124500,14618,7991,13002,2185,5417,3605,1236,559,7292,6066,1226,6066,4796,1270,2020-01-01,zipcode
ZCTA5 32430,12,935,33548,-666666666,152700,836,364,735,147,366,201,21,0,526,364,162,364,264,100,2020-01-01,zipcode
ZCTA5 32432,12,0,-666666666,-666666666,-666666666,0,0,0,0,0,0,0,0,0,0,0,0,0,0,2020-01-01,zipcode
ZCTA5 32439,12,10545,68076,1056,207100,8423,2889,7311,445,2216,2540,1490,620,5028,4024,1004,4024,3163,861,2020-01-01,zipcode
ZCTA5 32442,12,3291,40717,673,121000,2639,1101,2302,439,944,664,144,111,1785,1513,272,1513,1032,481,2020-01-01,zipcode
ZCTA5 32443,12,3405,34318,675,92900,2589,1477,2180,345,871,688,148,128,1562,1236,326,1236,939,297,2020-01-01,zipcode
ZCTA5 32447,12,169,-666666666,-666666666,-666666666,114,114,0,0,0,0,0,0,0,0,0,0,0,0,2020-01-01,zipcode
ZCTA5 32465,12,7429,41571,765,96000,6812,4604,6151,1340,2367,1722,532,190,3563,2516,1047,2516,1962,554,2020-01-01,zipcode
ZCTA5 32536,12,24601,72985,1100,203000,19011,6953,15556,1614,3924,5598,2484,1936,9041,8134,907,8134,5450,2684,2020-01-01,zipcode
ZCTA5 32548,12,22818,55062,1006,206300,18961,6742,16839,1193,4980,6288,2716,1662,13462,9826,3636,9826,5769,4057,2020-01-01,zipcode
ZCTA5 35661,01,17576,60714,780,154500,14412,5815,12893,1354,4057,4620,1847,1015,7946,6932,1014,6932,5595,1337,2020-01-01,zipcode
ZCTA5 32361,12,358,-666666666,-666666666,-666666666,242,56,242,3,87,144,8,0,169,169,0,169,149,20,2020-01-01,zipcode
ZCTA5 32399,12,0,-666666666,-666666666,-666666666,0,0,0,0,0,0,0,0,0,0,0,0,0,0,2020-01-01,zipcode
ZCTA5 32409,12,9913,56789,921,153700,7834,3265,6994,857,2486,2653,724,274,4393,3791,602,3791,3369,422,2020-01-01,zipcode
ZCTA5 32459,12,18160,85652,1609,408300,14946,5513,13829,816,2601,4196,4218,1998,15388,7730,7658,7730,6110,1620,2020-01-01,zipcode
ZCTA5 32460,12,6124,39712,764,96300,5213,3718,4723,969,2003,1380,213,158,2018,1747,271,1747,1235,512,2020-01-01,zipcode
ZCTA5 32463,12,212,46875,648,83000,180,71,143,20,50,73,0,0,91,82,9,82,36,46,2020-01-01,zipcode
ZCTA5 32531,12,5128,52378,954,195100,4431,1959,4172,422,1464,1457,402,427,2852,2404,448,2404,2192,212,2020-01-01,zipcode
ZCTA5 32547,12,34071,53236,1083,203100,27606,9263,23898,2416,6108,8914,4474,1986,15435,14232,1203,14232,7246,6986,2020-01-01,zipcode
ZCTA5 32561,12,10296,95906,1419,416800,8412,3711,7670,236,805,2247,2464,1918,6909,4543,2366,4543,3586,957,2020-01-01,zipcode
ZCTA5 32565,12,4793,57436,986,117800,3940,1706,3550,372,1324,1171,549,134,2345,2010,335,2010,1623,387,2020-01-01,zipcode
ZCTA5 32570,12,32341,60933,1018,165200,26524,11081,23155,2030,7282,8889,3544,1410,14255,12776,1479,12776,8628,4148,2020-01-01,zipcode
ZCTA5 32606,12,23748,61177,1212,237900,19199,6794,16787,454,2561,4258,4274,5240,11616,10012,1604,10012,4768,5244,2020-01-01,zipcode
ZCTA5 32615,12,13669,63580,1034,205400,10795,3871,9682,440,2664,2906,2364,1308,6100,5430,670,5430,4166,1264,2020-01-01,zipcode
ZCTA5 32617,12,4768,42377,647,124000,4169,2265,3711,255,1971,845,495,145,1874,1662,212,1662,1289,373,2020-01-01,zipcode
ZCTA5 32639,12,270,34353,-666666666,-666666666,213,147,213,23,131,0,29,30,153,129,24,129,116,13,2020-01-01,zipcode
ZCTA5 32653,12,14363,63333,948,202100,11516,4816,10437,431,2140,2855,2690,2321,6410,6106,304,6106,4775,1331,2020-01-01,zipcode
ZCTA5 32680,12,10428,41935,625,85900,8899,5221,7967,1599,3746,1773,471,378,6060,4361,1699,4361,3634,727,2020-01-01,zipcode
ZCTA5 32693,12,11997,40060,713,115700,9723,4889,8018,1223,3118,2657,752,268,4948,4305,643,4305,3372,933,2020-01-01,zipcode
ZCTA5 32127,12,29082,52438,1124,211300,24986,11826,22615,1865,6897,7936,3404,2513,15955,12582,3373,12582,9372,3210,2020-01-01,zipcode
ZCTA5 32136,12,8372,52708,1206,281100,7590,4492,7304,281,1946,2632,1522,923,5424,3981,1443,3981,3218,763,2020-01-01,zipcode
ZCTA5 32193,12,969,29054,834,204900,793,560,684,112,377,133,31,31,767,514,253,514,400,114,2020-01-01,zipcode
ZCTA5 32195,12,3291,39007,1580,122100,3101,1566,2766,579,817,928,321,121,1635,1433,202,1433,1269,164,2020-01-01,zipcode
ZCTA5 32040,12,8450,60155,851,118200,6441,2731,5658,790,2590,1669,453,156,3300,2920,380,2920,2580,340,2020-01-01,zipcode
ZCTA5 32044,12,2263,39000,1051,68200,1651,943,1440,379,473,497,65,26,941,822,119,822,475,347,2020-01-01,zipcode
ZCTA5 32112,12,7342,33038,627,107100,5820,2982,4986,1674,1744,1019,391,158,3750,2809,941,2809,1936,873,2020-01-01,zipcode
ZCTA5 32140,12,1575,48036,-666666666,74800,1442,632,1239,202,467,509,55,6,750,599,151,599,506,93,2020-01-01,zipcode
ZCTA5 32147,12,597,103564,-666666666,-666666666,442,71,321,42,118,46,115,0,239,150,89,150,103,47,2020-01-01,zipcode
ZCTA5 32508,12,5144,50625,1385,-666666666,4794,435,1136,10,154,486,413,73,661,543,118,543,0,543,2020-01-01,zipcode
ZCTA5 32535,12,5683,36855,675,72500,5083,3298,4512,989,2068,1168,188,99,2007,1700,307,1700,1137,563,2020-01-01,zipcode
ZCTA5 32542,12,3725,47250,1674,-666666666,2805,255,1328,60,200,557,399,112,1064,842,222,842,0,842,2020-01-01,zipcode
ZCTA5 35020,01,24821,28129,746,73700,19958,9588,17161,2952,6869,5222,1658,460,13117,10438,2679,10438,5745,4693,2020-01-01,zipcode
ZCTA5 35034,01,6907,33571,705,69800,5586,3884,4679,1280,2244,820,212,123,2012,1702,310,1702,1067,635,2020-01-01,zipcode
ZCTA5 33170,12,13254,51778,1285,283900,10638,4405,9202,1989,3042,2201,1462,508,4040,3680,360,3680,2219,1461,2020-01-01,zipcode
ZCTA5 33316,12,10447,80694,1346,635100,9320,3530,8643,449,1175,2247,2730,2042,7897,5042,2855,5042,3138,1904,2020-01-01,zipcode
ZCTA5 33470,12,28587,92217,2057,363700,23900,8216,20528,2755,5397,7438,3417,1521,9567,8669,898,8669,7755,914,2020-01-01,zipcode
ZCTA5 33034,12,23356,36250,1119,139900,15984,8316,13384,5093,3823,3336,882,250,5819,5056,763,5056,1639,3417,2020-01-01,zipcode
ZCTA5 33334,12,30333,58346,1247,321000,25841,7252,22897,2791,5993,6321,4485,3307,13712,12353,1359,12353,7190,5163,2020-01-01,zipcode
ZCTA5 33446,12,26415,60607,1305,302500,24031,15705,23331,1167,4792,6311,5914,5147,17521,13280,4241,13280,11552,1728,2020-01-01,zipcode
ZCTA5 33570,12,29576,54977,929,178000,23012,9084,19883,3149,6540,6514,2354,1326,11932,9788,2144,9788,6937,2851,2020-01-01,zipcode
ZCTA5 33634,12,23071,60237,1343,187600,18867,6038,16178,2183,4620,4470,3491,1414,8003,7544,459,7544,4314,3230,2020-01-01,zipcode
ZCTA5 33890,12,5274,38700,765,91900,3904,1782,3308,795,1675,535,249,54,2039,1636,403,1636,1224,412,2020-01-01,zipcode
ZCTA5 33843,12,11976,46776,794,68500,10563,6694,9234,2427,3446,2100,665,596,5665,3945,1720,3945,3278,667,2020-01-01,zipcode
ZCTA5 32569,12,12789,58832,1058,213500,10595,3194,9316,488,2352,3255,2253,968,5464,5001,463,5001,3553,1448,2020-01-01,zipcode
ZCTA5 32312,12,32380,102480,1298,312300,25865,8674,21988,369,1929,5385,7767,6538,13287,12466,821,12466,10624,1842,2020-01-01,zipcode
ZCTA5 32577,12,4978,71600,876,139300,4078,1742,3445,259,965,1350,618,253,2076,1942,134,1942,1744,198,2020-01-01,zipcode
ZCTA5 32578,12,33846,90964,1389,296200,26653,9571,23139,689,4593,7892,5155,4810,13923,12684,1239,12684,9670,3014,2020-01-01,zipcode
ZCTA5 32603,12,7096,18116,982,252500,6895,4136,1262,54,104,157,339,608,2294,1753,541,1753,224,1529,2020-01-01,zipcode
ZCTA5 32619,12,5540,47233,597,113200,4564,1894,3679,497,1622,1155,270,135,2359,2032,327,2032,1755,277,2020-01-01,zipcode
ZCTA5 32648,12,399,54545,-666666666,169300,279,132,222,47,90,74,11,0,530,114,416,114,111,3,2020-01-01,zipcode
ZCTA5 32681,12,30,-666666666,-666666666,-666666666,30,30,30,0,30,0,0,0,15,15,0,15,15,0,2020-01-01,zipcode
ZCTA5 32708,12,46542,76542,1383,264700,39327,13424,34308,1382,5343,11452,11134,4997,19566,18514,1052,18514,14118,4396,2020-01-01,zipcode
ZCTA5 32724,12,37856,54234,1053,191200,31328,14991,26540,1980,7443,9200,5096,2821,16301,14929,1372,14929,10854,4075,2020-01-01,zipcode
ZCTA5 32735,12,4133,55861,1350,140600,3546,2142,3248,283,1248,1133,433,151,2063,1779,284,1779,1393,386,2020-01-01,zipcode
ZCTA5 32764,12,3043,75882,-666666666,287400,2756,1173,2390,215,884,797,410,84,1442,1150,292,1150,1070,80,2020-01-01,zipcode
ZCTA5 32778,12,22486,46451,988,159800,19052,10505,17419,1822,5244,5897,3160,1296,11814,9974,1840,9974,7457,2517,2020-01-01,zipcode
ZCTA5 32963,12,15383,126643,1342,660300,14579,9582,13862,165,1471,2863,4888,4475,12511,7574,4937,7574,7073,501,2020-01-01,zipcode
ZCTA5 32970,12,246,-666666666,-666666666,-666666666,246,183,246,14,209,23,0,0,119,69,50,69,46,23,2020-01-01,zipcode
ZCTA5 32350,12,1414,39125,802,70900,1261,739,1189,163,413,382,212,19,795,693,102,693,590,103,2020-01-01,zipcode
ZCTA5 32404,12,40300,55363,1004,166300,32376,13267,28220,3501,9059,10898,2827,1935,17880,15098,2782,15098,11112,3986,2020-01-01,zipcode
ZCTA5 32420,12,2263,40909,676,93600,2006,971,1831,365,724,566,137,39,1550,1162,388,1162,1068,94,2020-01-01,zipcode
ZCTA5 32424,12,7643,39102,521,101900,6274,4077,5777,1283,2564,1343,391,196,2987,2216,771,2216,1642,574,2020-01-01,zipcode
ZCTA5 32455,12,4138,41637,692,89600,3597,1676,3124,649,1566,627,231,51,2060,1663,397,1663,1324,339,2020-01-01,zipcode
ZCTA5 32534,12,14759,50690,1074,120500,12210,4500,10613,605,3014,4606,1757,631,6899,6321,578,6321,4114,2207,2020-01-01,zipcode
ZCTA5 32462,12,3835,31421,704,119700,3335,1811,2889,542,1397,754,97,99,1818,1462,356,1462,1190,272,2020-01-01,zipcode
ZCTA5 32466,12,4927,56219,1316,118500,3925,1896,3331,412,1279,1370,144,126,2272,1808,464,1808,1546,262,2020-01-01,zipcode
ZCTA5 32514,12,43323,53275,1066,155700,35024,13034,27924,2489,6633,9853,5835,3114,19006,17294,1712,17294,8438,8856,2020-01-01,zipcode
ZCTA5 32567,12,3325,53125,574,120400,2564,1228,2384,320,930,932,165,37,1709,1398,311,1398,1082,316,2020-01-01,zipcode
ZCTA5 32605,12,26305,70517,1244,210100,22072,7815,19155,965,2535,4894,5677,5084,11716,10815,901,10815,7920,2895,2020-01-01,zipcode
ZCTA5 33147,12,46765,37619,1095,169200,36356,15298,31019,7905,11463,7560,2881,1210,15290,13966,1324,13966,6372,7594,2020-01-01,zipcode
ZCTA5 33149,12,12955,162175,2584,1412800,9433,3771,8129,245,678,1258,3074,2874,6950,4079,2871,4079,2834,1245,2020-01-01,zipcode
ZCTA5 33161,12,56446,42846,1185,269900,43961,15387,37666,8080,12589,9848,4707,2442,18509,16822,1687,16822,6898,9924,2020-01-01,zipcode
ZCTA5 33172,12,42232,52003,1635,180000,35458,11636,31635,6880,7765,7472,5953,3565,15314,13754,1560,13754,6228,7526,2020-01-01,zipcode
ZCTA5 33175,12,52885,60630,1709,330200,46195,17651,40704,7463,11901,9577,8045,3718,17091,16670,421,16670,12561,4109,2020-01-01,zipcode
ZCTA5 33190,12,17252,63938,1403,277200,13184,4056,11267,1548,2194,4335,2577,613,5180,5053,127,5053,2280,2773,2020-01-01,zipcode
ZCTA5 33315,12,13490,78367,1409,335400,11673,3344,10645,696,3533,2660,2406,1350,6569,5778,791,5778,3277,2501,2020-01-01,zipcode
ZCTA5 33405,12,20838,60199,1198,294100,17249,5890,15284,2984,3570,4036,2557,2137,8592,7645,947,7645,4385,3260,2020-01-01,zipcode
ZCTA5 33409,12,32607,54391,1336,186200,25992,7713,20830,3621,5412,6044,3935,1818,12568,10781,1787,10781,4576,6205,2020-01-01,zipcode
ZCTA5 33413,12,16904,66977,1645,275000,12822,3747,10632,1446,2876,3604,1662,1044,5482,4993,489,4993,3247,1746,2020-01-01,zipcode
ZCTA5 33426,12,23797,63061,1662,222400,20852,7075,18500,1339,5694,6324,3435,1708,11093,9760,1333,9760,5972,3788,2020-01-01,zipcode
ZCTA5 33469,12,14848,83985,1538,393600,12912,6862,12115,419,2409,3567,3565,2155,8706,6689,2017,6689,5938,751,2020-01-01,zipcode
ZCTA5 33471,12,7061,39243,664,69200,6183,4264,5445,1777,1942,1028,468,230,3456,2428,1028,2428,1891,537,2020-01-01,zipcode
ZCTA5 33484,12,27210,44362,1384,156600,25364,15981,23977,1728,6408,7067,4902,3872,18624,14456,4168,14456,11446,3010,2020-01-01,zipcode
ZCTA5 33004,12,16234,42780,1230,225100,13517,4401,12555,1210,3468,4233,2509,1135,8371,6716,1655,6716,2990,3726,2020-01-01,zipcode
ZCTA5 33010,12,45454,32642,1072,269000,39717,16796,35404,12537,11309,6186,3864,1508,16505,15885,620,15885,4798,11087,2020-01-01,zipcode
ZCTA5 33021,12,49859,57849,1394,302300,40601,14594,35666,3911,8986,10975,6922,4872,21319,18677,2642,18677,11883,6794,2020-01-01,zipcode
ZCTA5 33023,12,74913,54759,1308,242800,59000,18425,50392,7951,17407,17050,5378,2606,22011,20634,1377,20634,13816,6818,2020-01-01,zipcode
ZCTA5 33025,12,73180,58595,1468,249200,59605,19201,52483,3071,20239,16602,7834,4737,28638,26049,2589,26049,11964,14085,2020-01-01,zipcode
ZCTA5 33857,12,1710,31827,480,73400,1593,945,1515,318,772,291,114,20,1375,901,474,901,681,220,2020-01-01,zipcode
ZCTA5 33947,12,9455,55610,1165,253500,8906,5714,8279,624,2961,2820,1168,706,5987,4401,1586,4401,3651,750,2020-01-01,zipcode
ZCTA5 33066,12,17382,52493,1325,144500,15498,7225,14352,1087,3798,4637,2807,2023,10752,8697,2055,8697,7216,1481,2020-01-01,zipcode
ZCTA5 33168,12,23996,49381,1283,235100,20189,7642,17314,4304,6245,4252,1798,715,6770,6353,417,6353,4745,1608,2020-01-01,zipcode
ZCTA5 33313,12,62945,40781,1225,150700,47980,16943,39680,6770,14789,11902,4236,1983,23614,20084,3530,20084,8614,11470,2020-01-01,zipcode
ZCTA5 33437,12,37420,65117,1526,303500,34544,20753,32765,1414,7286,9536,7998,6531,21450,18026,3424,18026,15567,2459,2020-01-01,zipcode
ZCTA5 33185,12,30165,86366,2311,381700,24241,8902,20875,2278,4726,5756,5440,2675,8843,8627,216,8627,7073,1554,2020-01-01,zipcode
ZCTA5 33415,12,51932,43561,1262,155400,41005,14100,34473,7790,12086,8899,4201,1497,19564,17195,2369,17195,9937,7258,2020-01-01,zipcode
ZCTA5 33540,12,9126,35601,763,89800,8135,4762,7456,1013,3110,2334,741,258,5293,4175,1118,4175,3338,837,2020-01-01,zipcode
ZCTA5 33619,12,40257,47677,1210,138300,31629,12493,26311,4898,9704,6765,3201,1743,14463,13347,1116,13347,6776,6571,2020-01-01,zipcode
ZCTA5 33755,12,26937,42389,1019,206100,21366,8038,18688,2551,6131,6177,2628,1201,11205,9977,1228,9977,5451,4526,2020-01-01,zipcode
ZCTA5 33182,12,16484,94386,1820,354000,14228,7138,12286,2459,3312,2628,2902,985,4071,3985,86,3985,3292,693,2020-01-01,zipcode
ZCTA5 33039,12,378,66571,-666666666,324200,358,199,338,100,63,112,0,63,138,138,0,138,138,0,2020-01-01,zipcode
ZCTA5 33051,12,523,91899,1234,578900,523,321,523,11,119,134,186,73,1367,321,1046,321,261,60,2020-01-01,zipcode
ZCTA5 33101,12,0,-666666666,-666666666,-666666666,0,0,0,0,0,0,0,0,0,0,0,0,0,0,2020-01-01,zipcode
ZCTA5 33449,12,11783,128712,2244,477500,9030,3771,7686,447,1022,1845,2043,2329,4058,3765,293,3765,3466,299,2020-01-01,zipcode
ZCTA5 33472,12,19874,76749,2122,307900,17326,9466,16060,922,3464,5165,3632,2877,8871,7908,963,7908,7391,517,2020-01-01,zipcode
ZCTA5 33473,12,11868,122069,3215,593100,9074,4654,8471,32,806,2667,2323,2643,4867,4249,618,4249,3931,318,2020-01-01,zipcode
ZCTA5 33503,12,222,-666666666,-666666666,361100,222,58,105,24,28,53,0,0,58,58,0,58,45,13,2020-01-01,zipcode
ZCTA5 33542,12,22744,36239,858,84100,19760,12201,17750,2388,7070,5995,1515,782,13395,10301,3094,10301,7287,3014,2020-01-01,zipcode
ZCTA5 33545,12,22515,83757,1669,239000,17425,5102,14597,726,3657,5312,3126,1776,7021,6634,387,6634,4949,1685,2020-01-01,zipcode
ZCTA5 33548,12,7335,125521,1589,384800,5800,2025,5035,75,858,1288,1661,1153,2846,2718,128,2718,2438,280,2020-01-01,zipcode
ZCTA5 33558,12,25429,85281,1116,355300,19765,6919,17229,608,3191,4366,5180,3884,9673,9168,505,9168,6674,2494,2020-01-01,zipcode
ZCTA5 33559,12,18744,71724,1173,212000,15560,4463,12467,834,3546,3654,2771,1662,7409,6871,538,6871,3954,2917,2020-01-01,zipcode
ZCTA5 33563,12,27807,44969,976,142100,21600,7673,18424,4020,6034,5343,2277,750,11049,9967,1082,9967,5481,4486,2020-01-01,zipcode
ZCTA5 33578,12,54143,65142,1352,213100,42178,11251,36484,2438,9424,12211,8220,4191,22366,20742,1624,20742,11180,9562,2020-01-01,zipcode
ZCTA5 33579,12,37920,86439,1693,240100,28621,7770,25405,2868,5901,8720,5129,2787,12757,12030,727,12030,9040,2990,2020-01-01,zipcode
ZCTA5 33596,12,31000,102627,1826,288000,25127,8254,21798,1053,4578,6207,6905,3055,10573,10047,526,10047,8394,1653,2020-01-01,zipcode
ZCTA5 33744,12,101,-666666666,-666666666,-666666666,101,89,89,11,78,0,0,0,0,0,0,0,0,0,2020-01-01,zipcode
ZCTA5 33812,12,13478,79076,1234,203500,10347,3661,8960,582,2906,3040,1398,1034,5182,4216,966,4216,3343,873,2020-01-01,zipcode
ZCTA5 33854,12,366,48929,616,48200,338,220,319,66,88,104,51,10,626,188,438,188,101,87,2020-01-01,zipcode
ZCTA5 33855,12,0,-666666666,-666666666,-666666666,0,0,0,0,0,0,0,0,0,0,0,0,0,0,2020-01-01,zipcode
ZCTA5 33856,12,299,24443,533,-666666666,299,183,299,0,75,196,28,0,466,251,215,251,8,243,2020-01-01,zipcode
ZCTA5 33859,12,10987,48345,886,149900,8999,4662,7835,925,2683,2903,847,477,5611,4325,1286,4325,3268,1057,2020-01-01,zipcode
ZCTA5 33867,12,148,36250,-666666666,85400,148,135,148,14,53,68,13,0,209,95,114,95,95,0,2020-01-01,zipcode
ZCTA5 33875,12,10787,57410,793,154900,9453,5230,8963,719,3466,2462,1588,728,5970,4883,1087,4883,3985,898,2020-01-01,zipcode
ZCTA5 33876,12,5808,51193,834,119200,5237,3383,4982,607,1758,1777,640,200,2797,2282,515,2282,1873,409,2020-01-01,zipcode
ZCTA5 33896,12,13735,60056,1632,217700,11180,3220,9132,806,2299,3758,1499,770,6010,4245,1765,4245,2157,2088,2020-01-01,zipcode
ZCTA5 33897,12,22769,56419,1674,200500,18524,7026,16324,1333,5913,5554,2544,980,12122,7246,4876,7246,5219,2027,2020-01-01,zipcode
ZCTA5 33898,12,16829,45471,941,119200,13671,7104,12508,2025,4543,4020,1337,583,9399,6479,2920,6479,5300,1179,2020-01-01,zipcode
ZCTA5 33965,12,1359,-666666666,-666666666,-666666666,1359,689,30,0,0,30,0,0,0,0,0,0,0,0,2020-01-01,zipcode
ZCTA5 33966,12,9576,67757,1248,284000,8151,3688,7280,193,1400,2188,2173,1326,5764,4263,1501,4263,2894,1369,2020-01-01,zipcode
ZCTA5 36854,01,14863,52469,823,114600,11914,4724,9838,1304,3380,3364,1280,510,7365,5865,1500,5865,3712,2153,2020-01-01,zipcode
ZCTA5 36861,01,2726,55072,679,122100,2392,1094,2223,464,711,539,338,171,1923,1201,722,1201,1093,108,2020-01-01,zipcode
ZCTA5 36915,01,645,32813,-666666666,52600,533,283,430,44,168,147,70,1,374,220,154,220,168,52,2020-01-01,zipcode
ZCTA5 36604,01,9670,50079,784,172100,7939,2809,6860,552,1562,1780,1761,1205,5111,3999,1112,3999,2235,1764,2020-01-01,zipcode
ZCTA5 36322,01,8951,38794,663,105700,7437,3311,6393,1024,2317,2223,606,223,4678,3922,756,3922,2180,1742,2020-01-01,zipcode
ZCTA5 36340,01,5745,39478,598,103500,4512,2476,3992,1043,1453,1016,186,294,2751,2333,418,2333,1760,573,2020-01-01,zipcode
ZCTA5 36343,01,1174,47569,830,86300,1050,611,948,217,336,293,93,9,719,503,216,503,428,75,2020-01-01,zipcode
ZCTA5 36360,01,18922,44880,677,126600,15269,7629,13399,2024,4171,4878,1432,894,9227,7789,1438,7789,4954,2835,2020-01-01,zipcode
ZCTA5 36376,01,2167,40451,732,80800,1779,869,1618,328,634,493,99,64,1164,839,325,839,690,149,2020-01-01,zipcode
ZCTA5 36425,01,1086,32500,-666666666,-666666666,881,520,654,101,325,158,61,9,556,332,224,332,268,64,2020-01-01,zipcode
ZCTA5 36426,01,15404,41668,619,97300,12321,5469,10915,1963,4067,3247,1205,433,7167,5527,1640,5527,3781,1746,2020-01-01,zipcode
ZCTA5 36436,01,356,38333,-666666666,88200,326,196,260,54,105,101,0,0,216,118,98,118,117,1,2020-01-01,zipcode
ZCTA5 36535,01,34542,53606,823,192400,29147,12584,26267,2899,8506,8539,4316,2007,16236,13926,2310,13926,10743,3183,2020-01-01,zipcode
ZCTA5 36545,01,9222,37137,582,114000,7668,4153,6285,1104,2555,1482,716,428,4816,3480,1336,3480,2505,975,2020-01-01,zipcode
ZCTA5 36556,01,396,-666666666,-666666666,47800,396,222,277,15,122,121,19,0,431,196,235,196,134,62,2020-01-01,zipcode
ZCTA5 36578,01,2682,109735,719,304600,1413,298,1325,29,426,438,179,253,800,663,137,663,626,37,2020-01-01,zipcode
ZCTA5 36581,01,336,42250,-666666666,-666666666,287,151,287,20,253,14,0,0,173,138,35,138,138,0,2020-01-01,zipcode
ZCTA5 36607,01,6417,40074,813,97000,5418,2524,4846,818,1547,1134,865,482,3276,2727,549,2727,1335,1392,2020-01-01,zipcode
ZCTA5 36608,01,36317,51544,911,163700,29961,12372,23518,2059,4886,6972,5758,3843,17232,15009,2223,15009,8041,6968,2020-01-01,zipcode
ZCTA5 36613,01,13746,40631,1037,116500,10214,5027,8311,1225,3516,2552,680,338,5286,4218,1068,4218,2976,1242,2020-01-01,zipcode
ZCTA5 36619,01,15262,50533,882,139400,12139,5274,10718,1261,3607,3452,1663,735,6482,5670,812,5670,4217,1453,2020-01-01,zipcode
ZCTA5 36722,01,344,47917,-666666666,93000,292,161,261,91,74,96,0,0,253,141,112,141,75,66,2020-01-01,zipcode
ZCTA5 36759,01,1724,32321,-666666666,56000,1296,556,1119,151,431,353,173,11,785,607,178,607,499,108,2020-01-01,zipcode
ZCTA5 36784,01,6802,39028,587,143300,5233,2472,4542,671,2104,1282,232,253,3440,2627,813,2627,1610,1017,2020-01-01,zipcode
ZCTA5 36855,01,1592,50768,802,127900,1281,484,1208,173,505,366,138,26,757,704,53,704,576,128,2020-01-01,zipcode
ZCTA5 36856,01,7944,59542,1631,193800,5728,2770,5121,598,871,2629,636,387,2863,2659,204,2659,2326,333,2020-01-01,zipcode
ZCTA5 36867,01,22239,41627,808,139300,17705,6318,14916,1931,4098,5355,2138,1394,11238,9608,1630,9608,4247,5361,2020-01-01,zipcode
ZCTA5 36871,01,1081,35625,760,128600,903,536,828,115,366,152,142,53,716,455,261,455,364,91,2020-01-01,zipcode
ZCTA5 36910,01,45,-666666666,-666666666,-666666666,45,45,45,0,21,24,0,0,33,21,12,21,0,21,2020-01-01,zipcode
ZCTA5 36916,01,1030,33333,326,68500,820,495,750,173,231,296,13,37,605,452,153,452,319,133,2020-01-01,zipcode
ZCTA5 36441,01,3828,35088,550,100700,2727,1308,2485,260,1130,699,274,122,1940,1424,516,1424,1014,410,2020-01-01,zipcode
ZCTA5 33844,12,40078,47050,941,135100,32178,14715,28142,5451,9804,8645,2751,1491,18521,13179,5342,13179,9111,4068,2020-01-01,zipcode
ZCTA5 33847,12,154,73125,-666666666,-666666666,124,46,94,17,27,30,12,8,50,50,0,50,41,9,2020-01-01,zipcode
ZCTA5 33860,12,28372,57110,971,147900,21455,8201,18664,2847,7400,6030,1595,792,9383,8217,1166,8217,6114,2103,2020-01-01,zipcode
ZCTA5 33873,12,13394,38375,744,104000,9999,4400,8245,1910,3967,1656,468,244,5355,4417,938,4417,2791,1626,2020-01-01,zipcode
ZCTA5 33884,12,33008,60359,1152,198900,28079,12383,24298,2097,6747,8495,4416,2543,14673,12348,2325,12348,9206,3142,2020-01-01,zipcode
ZCTA5 33921,12,947,100804,-666666666,1155200,928,694,894,55,114,304,242,179,1895,416,1479,416,378,38,2020-01-01,zipcode
ZCTA5 33924,12,181,-666666666,-666666666,-666666666,181,80,156,75,14,19,33,15,1914,31,1883,31,31,0,2020-01-01,zipcode
ZCTA5 33629,12,27059,126363,1373,590600,20375,6383,18237,501,1674,3209,6836,6017,11535,10441,1094,10441,8230,2211,2020-01-01,zipcode
ZCTA5 33703,12,26980,87032,1331,270200,22492,7840,20069,1006,3523,5958,5498,4084,12250,11120,1130,11120,8942,2178,2020-01-01,zipcode
ZCTA5 33712,12,24802,51569,1110,201700,20658,7707,17501,1560,4815,5780,3692,1654,12446,9178,3268,9178,5122,4056,2020-01-01,zipcode
ZCTA5 33513,12,13982,42304,882,140300,11664,7385,10062,1822,4130,3086,619,405,5403,4094,1309,4094,3184,910,2020-01-01,zipcode
ZCTA5 33538,12,5371,38231,819,109800,4586,2283,4235,700,1783,1153,375,224,2985,2203,782,2203,1733,470,2020-01-01,zipcode
ZCTA5 33547,12,25676,104513,1820,327000,18025,6053,15563,665,3521,3864,4578,2935,8346,7704,642,7704,6691,1013,2020-01-01,zipcode
ZCTA5 33606,12,21789,95799,1576,581700,19111,6507,13833,344,1237,2058,5976,4218,10201,8894,1307,8894,3861,5033,2020-01-01,zipcode
ZCTA5 33616,12,15373,64274,1311,224100,12526,3493,11043,668,3300,2966,2488,1621,7006,6265,741,6265,2961,3304,2020-01-01,zipcode
ZCTA5 33068,12,52691,47536,1493,199600,41583,11956,34424,5592,12864,9836,4143,1989,18498,17013,1485,17013,9876,7137,2020-01-01,zipcode
ZCTA5 33109,12,390,228304,-666666666,2000001,373,249,373,0,26,13,149,185,795,213,582,213,200,13,2020-01-01,zipcode
ZCTA5 33142,12,59773,28105,966,207900,46547,19043,39988,13470,13746,7709,3760,1303,21928,20142,1786,20142,5471,14671,2020-01-01,zipcode
ZCTA5 33144,12,30343,51341,1392,318800,26687,10320,23983,4918,6963,6308,4334,1460,10129,9720,409,9720,5463,4257,2020-01-01,zipcode
ZCTA5 33189,12,24802,56845,1314,280300,19566,6411,17131,2807,5449,4662,2917,1296,8423,7813,610,7813,4508,3305,2020-01-01,zipcode
ZCTA5 33323,12,21612,93586,1976,351900,18100,5184,15504,1210,2663,5142,4337,2152,8536,7576,960,7576,5388,2188,2020-01-01,zipcode
ZCTA5 33332,12,12111,139317,2585,643000,9892,3383,7914,442,779,1636,2412,2645,3612,3395,217,3395,3137,258,2020-01-01,zipcode
ZCTA5 33411,12,74554,76804,1547,295900,59914,20976,52278,5052,13425,15493,11326,6982,28690,25446,3244,25446,18570,6876,2020-01-01,zipcode
ZCTA5 33431,12,23329,88430,1860,418100,19115,8545,14805,626,2124,3370,5449,3236,9870,8253,1617,8253,5356,2897,2020-01-01,zipcode
ZCTA5 33441,12,27963,47746,1272,267500,23239,7805,20691,3075,6309,6457,3265,1585,13789,11166,2623,11166,5839,5327,2020-01-01,zipcode
ZCTA5 33594,12,36685,68026,1372,201800,30357,10100,26541,2324,7966,8557,5156,2538,14015,13214,801,13214,10259,2955,2020-01-01,zipcode
ZCTA5 33549,12,18132,71490,1239,239900,15089,5727,13267,765,3206,4361,2664,2271,7212,6883,329,6883,5549,1334,2020-01-01,zipcode
ZCTA5 33569,12,28342,76560,1423,233100,22140,7698,19413,1458,4723,6458,4295,2479,11120,10181,939,10181,7921,2260,2020-01-01,zipcode
ZCTA5 36009,01,2257,46250,431,96800,1865,973,1613,228,646,269,337,133,1206,893,313,893,677,216,2020-01-01,zipcode
ZCTA5 36025,01,6722,41193,972,149700,6000,4296,5327,1682,2037,983,412,213,1400,1314,86,1314,894,420,2020-01-01,zipcode
ZCTA5 36047,01,1117,46429,-666666666,70000,969,357,899,129,323,357,77,13,541,466,75,466,422,44,2020-01-01,zipcode
ZCTA5 36078,01,13433,54802,717,142800,11309,5194,9222,1683,3020,2769,1158,592,5923,5213,710,5213,3780,1433,2020-01-01,zipcode
ZCTA5 36079,01,9789,51250,794,140500,7940,3474,6739,694,2118,2010,894,1023,4535,3462,1073,3462,2825,637,2020-01-01,zipcode
ZCTA5 36080,01,1997,78365,-666666666,191000,1611,771,1484,246,484,355,247,152,925,737,188,737,601,136,2020-01-01,zipcode
ZCTA5 36113,01,1781,93594,1569,-666666666,1526,1008,1347,195,308,474,190,180,333,287,46,287,0,287,2020-01-01,zipcode
ZCTA5 36201,01,17431,32315,621,66300,14499,6936,12695,3329,5005,3634,552,175,9781,7313,2468,7313,4463,2850,2020-01-01,zipcode
ZCTA5 36206,01,10539,48842,805,97200,8313,3576,7121,1108,2721,2116,523,653,4940,4055,885,4055,2835,1220,2020-01-01,zipcode
ZCTA5 36251,01,4755,40734,378,112400,4106,1789,3272,668,1143,1040,322,99,2336,1847,489,1847,1320,527,2020-01-01,zipcode
ZCTA5 36274,01,10617,40124,619,91800,8803,4212,7753,1422,2866,2444,713,308,5436,4220,1216,4220,3259,961,2020-01-01,zipcode
ZCTA5 36314,01,576,50516,516,59000,462,171,458,54,224,138,11,31,291,237,54,237,208,29,2020-01-01,zipcode
ZCTA5 36346,01,1379,44318,688,97000,1133,497,975,203,340,253,89,90,812,576,236,576,525,51,2020-01-01,zipcode
ZCTA5 36351,01,3199,56067,743,124900,2620,1174,2328,376,754,748,216,234,1520,1337,183,1337,1057,280,2020-01-01,zipcode
ZCTA5 36523,01,3054,51250,896,166100,2489,1339,2189,678,760,368,226,157,1238,1046,192,1046,749,297,2020-01-01,zipcode
ZCTA5 36532,01,35728,77260,1160,305100,28399,12070,25500,1613,4452,6946,7742,4747,15925,13497,2428,13497,11364,2133,2020-01-01,zipcode
ZCTA5 36540,01,738,23140,-666666666,-666666666,619,303,562,222,258,70,12,0,435,328,107,328,267,61,2020-01-01,zipcode
ZCTA5 36542,01,14937,52214,1093,258600,13558,5778,11977,1016,3041,3898,2616,1406,17818,7276,10542,7276,4468,2808,2020-01-01,zipcode
ZCTA5 36559,01,182,-666666666,-666666666,630200,182,151,151,0,0,76,15,60,200,92,108,92,76,16,2020-01-01,zipcode
ZCTA5 36564,01,278,-666666666,-666666666,-666666666,178,78,127,0,0,0,52,75,134,75,59,75,75,0,2020-01-01,zipcode
ZCTA5 36567,01,13590,52773,885,139300,11251,5036,9829,1587,3646,2854,1283,459,5654,5055,599,5055,3893,1162,2020-01-01,zipcode
ZCTA5 36571,01,15500,58446,809,157900,11973,4644,10672,1215,4123,3074,1615,645,6656,5937,719,5937,4637,1300,2020-01-01,zipcode
ZCTA5 36862,01,5691,32500,511,110300,4694,2441,4212,913,1616,1194,373,116,2963,2374,589,2374,1595,779,2020-01-01,zipcode
ZCTA5 36904,01,3983,36708,585,100900,3247,1634,2729,286,1092,873,321,157,2164,1614,550,1614,1220,394,2020-01-01,zipcode
ZCTA5 36925,01,2935,36275,658,42200,2320,1101,2146,367,679,807,164,129,1609,1293,316,1293,830,463,2020-01-01,zipcode
ZCTA5 36016,01,5360,38750,587,58100,4553,2880,4168,1162,1726,994,216,70,2046,1630,416,1630,1081,549,2020-01-01,zipcode
ZCTA5 36024,01,4234,51196,605,179500,3688,1774,3286,347,1221,989,490,239,3012,1874,1138,1874,1533,341,2020-01-01,zipcode
ZCTA5 36031,01,129,65417,-666666666,121400,109,78,80,29,39,5,7,0,64,54,10,54,50,4,2020-01-01,zipcode
ZCTA5 36043,01,3788,70425,1048,152100,3270,1564,2681,606,860,598,357,260,1618,1353,265,1353,1068,285,2020-01-01,zipcode
ZCTA5 35019,01,2007,43563,596,112800,1620,790,1344,204,544,429,128,39,999,829,170,829,666,163,2020-01-01,zipcode
ZCTA5 35023,01,23633,55979,934,121000,18895,8130,16532,1895,5665,5649,2446,877,9696,8410,1286,8410,6281,2129,2020-01-01,zipcode
ZCTA5 35040,01,17611,68620,1175,155900,13123,3581,11320,738,2863,4262,2497,960,6880,6379,501,6379,5192,1187,2020-01-01,zipcode
ZCTA5 35054,01,4459,59688,1014,209800,3509,1721,3019,377,1038,960,346,298,2110,1744,366,1744,1556,188,2020-01-01,zipcode
ZCTA5 35057,01,14535,54335,746,153100,11247,4256,9775,1782,3029,3575,855,534,6229,5053,1176,5053,4176,877,2020-01-01,zipcode
ZCTA5 35070,01,298,41429,-666666666,108900,220,116,190,36,69,69,16,0,113,106,7,106,98,8,2020-01-01,zipcode
ZCTA5 35079,01,9398,69038,809,158500,7226,3083,6158,543,2459,2211,649,296,3568,3124,444,3124,2961,163,2020-01-01,zipcode
ZCTA5 35098,01,928,64712,-666666666,154300,787,353,696,135,173,309,66,13,555,415,140,415,363,52,2020-01-01,zipcode
ZCTA5 35143,01,3078,76380,534,159700,2532,1005,2220,190,750,803,409,68,2144,1201,943,1201,1054,147,2020-01-01,zipcode
ZCTA5 35146,01,11551,83002,-666666666,194300,9544,4812,8600,1438,2685,2392,1427,658,4111,3695,416,3695,3361,334,2020-01-01,zipcode
ZCTA5 35204,01,9907,26618,605,63200,8217,4360,7191,1426,2823,1988,621,333,5976,4615,1361,4615,1885,2730,2020-01-01,zipcode
ZCTA5 35207,01,7901,26070,627,64900,6192,3318,5356,1089,1855,1688,451,273,4327,3506,821,3506,1913,1593,2020-01-01,zipcode
ZCTA5 35217,01,13133,36092,787,87900,10669,4708,9137,1736,3345,3003,708,345,6380,5124,1256,5124,2923,2201,2020-01-01,zipcode
ZCTA5 35404,01,22578,40776,920,136000,18414,6975,13244,1645,4802,3969,1796,1032,10438,7449,2989,7449,3864,3585,2020-01-01,zipcode
ZCTA5 35405,01,44449,56446,886,176100,36760,12202,30476,2418,8051,9611,6466,3930,20053,17462,2591,17462,9721,7741,2020-01-01,zipcode
ZCTA5 35406,01,18391,106653,1066,376200,14126,5109,12457,388,1091,2380,4556,4042,7843,6964,879,6964,5475,1489,2020-01-01,zipcode
ZCTA5 35443,01,1702,18206,570,53000,1392,909,1134,153,633,260,29,59,1327,754,573,754,548,206,2020-01-01,zipcode
ZCTA5 35464,01,916,11775,418,-666666666,578,430,403,70,161,105,67,0,407,283,124,283,103,180,2020-01-01,zipcode
ZCTA5 35474,01,7056,56250,769,139500,5598,1991,4452,647,1422,1273,520,590,2764,2251,513,2251,1901,350,2020-01-01,zipcode
ZCTA5 35545,01,90,25000,-666666666,-666666666,79,52,64,33,18,12,0,1,44,40,4,40,38,2,2020-01-01,zipcode
ZCTA5 35546,01,3765,58389,361,105100,2934,1261,2503,341,1120,682,187,173,1674,1431,243,1431,1275,156,2020-01-01,zipcode
ZCTA5 35572,01,1700,55781,-666666666,253800,1520,679,1336,356,557,278,81,64,1253,783,470,783,731,52,2020-01-01,zipcode
ZCTA5 35575,01,1097,41429,663,82000,874,444,804,192,285,233,51,43,530,468,62,468,355,113,2020-01-01,zipcode
ZCTA5 35580,01,3682,45167,628,86300,2840,1119,2532,533,755,945,171,128,1750,1462,288,1462,1287,175,2020-01-01,zipcode
ZCTA5 35586,01,3746,33520,429,82300,2837,1422,2575,460,863,1013,136,103,2077,1541,536,1541,1174,367,2020-01-01,zipcode
ZCTA5 35592,01,4590,38299,442,108000,3810,2121,3364,709,1435,803,262,155,2558,1949,609,1949,1195,754,2020-01-01,zipcode
ZCTA5 35593,01,1443,54500,529,89600,1173,470,1044,173,453,213,113,92,714,518,196,518,428,90,2020-01-01,zipcode
ZCTA5 35603,01,31509,60078,695,176600,25813,10709,22283,1966,6464,7842,3904,2107,14273,13476,797,13476,9667,3809,2020-01-01,zipcode
ZCTA5 35616,01,3643,34526,680,97000,2919,1432,2529,483,929,775,130,212,2172,1459,713,1459,972,487,2020-01-01,zipcode
ZCTA5 35630,01,33685,34898,651,122000,27967,12401,21460,3090,7064,6255,3272,1779,17790,15057,2733,15057,6514,8543,2020-01-01,zipcode
ZCTA5 35674,01,19187,47738,695,121300,15371,6753,13164,1959,5426,3598,1454,727,8504,7006,1498,7006,4890,2116,2020-01-01,zipcode
ZCTA5 35748,01,6612,79185,622,246900,5509,2309,4919,373,1649,1199,1156,542,2756,2523,233,2523,2221,302,2020-01-01,zipcode
ZCTA5 35757,01,17972,92152,1299,230100,13779,4291,11985,724,1415,3438,3886,2522,6581,6261,320,6261,5328,933,2020-01-01,zipcode
ZCTA5 35824,01,8352,86599,898,237900,7299,1587,6073,96,674,1869,1443,1991,4348,4173,175,4173,2286,1887,2020-01-01,zipcode
ZCTA5 35975,01,999,24101,-666666666,151100,819,453,735,85,478,131,40,1,381,381,0,381,333,48,2020-01-01,zipcode
ZCTA5 36258,01,1258,43125,531,96500,1111,609,1015,165,394,310,122,24,760,592,168,592,518,74,2020-01-01,zipcode
ZCTA5 36345,01,8449,61677,831,145100,6602,2706,5953,869,1799,1892,1005,388,3593,3128,465,3128,2695,433,2020-01-01,zipcode
ZCTA5 36271,01,6237,43801,738,87800,4698,1907,4248,686,1617,1342,328,275,2879,2280,599,2280,1988,292,2020-01-01,zipcode
ZCTA5 36276,01,2684,36202,567,69800,2231,1178,1764,340,693,464,215,52,1151,917,234,917,732,185,2020-01-01,zipcode
ZCTA5 36316,01,2260,65000,675,155400,1843,777,1655,156,377,748,277,97,938,816,122,816,701,115,2020-01-01,zipcode
ZCTA5 36352,01,4757,68889,674,177300,4011,1535,3476,342,1150,1272,338,374,1867,1766,101,1766,1488,278,2020-01-01,zipcode
ZCTA5 36370,01,922,50000,829,85400,777,356,727,155,363,181,19,9,420,346,74,346,290,56,2020-01-01,zipcode
ZCTA5 36444,01,747,45294,-666666666,47100,618,443,577,183,303,50,14,27,558,268,290,268,227,41,2020-01-01,zipcode
ZCTA5 36446,01,512,19600,-666666666,83800,410,275,343,54,204,71,0,14,270,184,86,184,132,52,2020-01-01,zipcode
ZCTA5 36477,01,3615,36707,533,83200,2912,1351,2711,642,873,956,157,83,2095,1587,508,1587,1212,375,2020-01-01,zipcode
ZCTA5 36505,01,1062,73056,1066,136300,822,348,708,141,197,278,49,43,399,390,9,390,316,74,2020-01-01,zipcode
ZCTA5 36509,01,1634,43634,735,80000,1384,671,1181,437,360,291,75,18,692,565,127,565,348,217,2020-01-01,zipcode
ZCTA5 36544,01,11523,46585,766,119600,9101,3996,7860,1935,3464,1734,590,137,4484,3885,599,3885,2977,908,2020-01-01,zipcode
ZCTA5 36574,01,1271,-666666666,-666666666,201700,1068,671,926,66,508,181,122,49,564,430,134,430,392,38,2020-01-01,zipcode
ZCTA5 36576,01,3899,44313,844,177400,3355,1111,2969,260,995,988,568,158,2121,1791,330,1791,1405,386,2020-01-01,zipcode
ZCTA5 36612,01,4460,22500,681,65100,3180,1842,2715,756,1173,558,96,132,1875,1620,255,1620,936,684,2020-01-01,zipcode
ZCTA5 36693,01,19806,64370,960,158200,16019,6188,13937,818,3521,4226,3727,1645,8924,7763,1161,7763,5319,2444,2020-01-01,zipcode
ZCTA5 36728,01,212,19740,-666666666,-666666666,176,100,167,55,62,25,9,16,186,97,89,97,69,28,2020-01-01,zipcode
ZCTA5 36738,01,719,27041,-666666666,66800,655,480,618,50,311,161,50,46,381,278,103,278,231,47,2020-01-01,zipcode
ZCTA5 36752,01,1066,46176,-666666666,108800,919,398,787,35,195,404,92,61,741,526,215,526,488,38,2020-01-01,zipcode
ZCTA5 36763,01,111,77596,-666666666,57200,101,41,91,14,43,28,3,3,70,41,29,41,39,2,2020-01-01,zipcode
ZCTA5 36767,01,1513,25085,319,68000,970,537,786,163,315,187,97,24,989,487,502,487,347,140,2020-01-01,zipcode
ZCTA5 36768,01,923,32634,840,75000,802,340,655,77,204,272,70,32,634,345,289,345,252,93,2020-01-01,zipcode
ZCTA5 33786,12,1568,94688,2288,709400,1405,766,1347,48,197,317,459,326,1164,731,433,731,648,83,2020-01-01,zipcode
ZCTA5 33954,12,9876,61683,1340,220700,8492,3848,7658,760,2313,2648,1248,689,4084,3777,307,3777,2970,807,2020-01-01,zipcode
ZCTA5 32169,12,10732,81164,1370,363100,10147,5802,9759,276,1909,3551,2298,1725,11982,5840,6142,5840,4796,1044,2020-01-01,zipcode
ZCTA5 32180,12,5184,54612,933,136000,3713,1811,3112,613,1060,1124,238,77,1519,1364,155,1364,1103,261,2020-01-01,zipcode
ZCTA5 32187,12,1454,36318,-666666666,117100,1294,710,1190,186,514,377,98,15,701,659,42,659,580,79,2020-01-01,zipcode
ZCTA5 32190,12,1310,52462,625,-666666666,1214,638,946,213,493,115,69,56,546,443,103,443,357,86,2020-01-01,zipcode
ZCTA5 32217,12,19785,50442,928,224100,16444,5310,14317,1143,3583,4049,3567,1975,9308,8595,713,8595,4436,4159,2020-01-01,zipcode
ZCTA5 32219,12,12760,53469,918,123200,10378,4514,9072,1193,3517,2667,1174,521,4849,4367,482,4367,3754,613,2020-01-01,zipcode
ZCTA5 32257,12,39154,65440,1155,219600,31555,10637,28016,2481,6952,8593,6553,3437,17388,16015,1373,16015,10321,5694,2020-01-01,zipcode
ZCTA5 36442,01,3783,37027,545,89200,3053,1498,2678,477,1083,962,91,65,1731,1336,395,1336,1002,334,2020-01-01,zipcode
ZCTA5 36445,01,5647,33218,670,100500,4715,2710,4342,877,2164,871,295,135,2777,2181,596,2181,1656,525,2020-01-01,zipcode
ZCTA5 36456,01,1621,41250,438,28300,1254,730,1047,152,519,272,67,37,844,598,246,598,482,116,2020-01-01,zipcode
ZCTA5 36474,01,2770,45750,657,81800,2300,1028,1944,302,851,585,121,85,1547,1197,350,1197,1046,151,2020-01-01,zipcode
ZCTA5 36475,01,2063,36420,519,117800,1612,843,1470,181,713,273,231,72,1174,731,443,731,595,136,2020-01-01,zipcode
ZCTA5 36483,01,471,49219,-666666666,113700,417,221,393,41,225,63,48,16,240,183,57,183,155,28,2020-01-01,zipcode
ZCTA5 36502,01,17775,30853,602,108100,14621,8725,12499,2783,5998,2449,873,396,7585,6073,1512,6073,3876,2197,2020-01-01,zipcode
ZCTA5 36522,01,6759,43482,751,102800,5046,2548,4465,779,1968,1242,333,143,2810,2386,424,2386,1681,705,2020-01-01,zipcode
ZCTA5 36530,01,5848,48993,812,171300,5183,2254,4512,609,1380,1635,626,262,3642,2732,910,2732,2248,484,2020-01-01,zipcode
ZCTA5 36539,01,605,35909,-666666666,-666666666,501,307,355,43,192,94,12,14,324,234,90,234,209,25,2020-01-01,zipcode
ZCTA5 36558,01,3755,45357,498,95400,3002,1504,2622,539,987,516,212,368,2193,1540,653,1540,1404,136,2020-01-01,zipcode
ZCTA5 36562,01,1230,43836,-666666666,103800,1027,500,904,184,521,112,69,18,567,439,128,439,401,38,2020-01-01,zipcode
ZCTA5 36579,01,1425,53239,588,155900,1231,711,1145,155,489,234,258,9,1037,557,480,557,505,52,2020-01-01,zipcode
ZCTA5 36587,01,11049,51709,735,119800,8765,4595,7161,1525,2964,2046,420,206,4430,3594,836,3594,2888,706,2020-01-01,zipcode
ZCTA5 36602,01,919,23063,398,215900,919,506,844,95,142,332,177,98,780,641,139,641,115,526,2020-01-01,zipcode
ZCTA5 36606,01,18507,43058,857,126300,14143,4893,12345,1366,4480,2774,2348,1377,9147,7839,1308,7839,3764,4075,2020-01-01,zipcode
ZCTA5 36609,01,23043,38894,832,160300,19053,7351,16205,1250,4349,5353,3484,1769,13278,11255,2023,11255,4731,6524,2020-01-01,zipcode
ZCTA5 36610,01,10273,25126,657,45500,8054,4664,7167,1482,3290,1789,423,183,5705,3978,1727,3978,1857,2121,2020-01-01,zipcode
ZCTA5 36611,01,5757,32332,834,73900,4083,1689,3341,469,1240,1149,346,137,2662,2139,523,2139,1038,1101,2020-01-01,zipcode
ZCTA5 36695,01,52524,70786,1059,185600,40951,14789,34699,2248,9181,11013,8612,3645,20920,19345,1575,19345,12964,6381,2020-01-01,zipcode
ZCTA5 36701,01,20513,35204,714,92600,16193,7166,13605,1757,4565,4384,1697,1202,11046,8221,2825,8221,4602,3619,2020-01-01,zipcode
ZCTA5 36726,01,4828,36483,722,82100,3737,2014,3341,619,1267,983,332,140,2579,1802,777,1802,1183,619,2020-01-01,zipcode
ZCTA5 36756,01,4949,24834,433,87800,4152,3065,3103,785,1020,643,374,281,2451,1699,752,1699,1306,393,2020-01-01,zipcode
ZCTA5 36793,01,313,-666666666,-666666666,-666666666,295,89,221,16,113,92,0,0,207,105,102,105,65,40,2020-01-01,zipcode
ZCTA5 36853,01,8241,55107,744,171700,7057,3577,6435,937,1764,2012,1146,576,6138,3454,2684,3454,2764,690,2020-01-01,zipcode
ZCTA5 36863,01,11718,36680,595,100000,9766,4462,8588,1797,3057,2661,790,283,6147,4822,1325,4822,3329,1493,2020-01-01,zipcode
ZCTA5 36869,01,21191,40574,836,112500,16420,7212,14102,2371,4452,4972,1579,728,10038,8545,1493,8545,5266,3279,2020-01-01,zipcode
ZCTA5 36908,01,1820,48929,-666666666,79900,1492,863,1307,163,449,524,130,41,1079,732,347,732,648,84,2020-01-01,zipcode
ZCTA5 32113,12,5341,39967,-666666666,89000,4399,1884,3677,587,1542,1209,177,162,2619,2036,583,2036,1524,512,2020-01-01,zipcode
ZCTA5 32034,12,38189,85854,1059,353600,32701,15212,30344,1390,6345,8338,8738,5533,21212,16291,4921,16291,13404,2887,2020-01-01,zipcode
ZCTA5 32055,12,16313,40838,780,108100,12794,6044,11026,1819,4210,3424,1011,562,7005,5914,1091,5914,3965,1949,2020-01-01,zipcode
ZCTA5 32061,12,442,87273,-666666666,190100,400,153,229,10,141,45,33,0,116,116,0,116,103,13,2020-01-01,zipcode
ZCTA5 32066,12,7455,51886,622,98800,6272,3569,5264,1522,2130,1092,239,281,2499,1963,536,1963,1525,438,2020-01-01,zipcode
ZCTA5 32071,12,3559,47540,631,106400,2822,1421,2124,337,728,734,234,91,1562,1167,395,1167,1016,151,2020-01-01,zipcode
ZCTA5 32079,12,426,55313,1551,-666666666,426,394,426,55,66,68,124,113,242,196,46,196,22,174,2020-01-01,zipcode
ZCTA5 32110,12,8537,37599,843,123500,6946,3640,6190,1069,2873,1409,560,279,3719,3123,596,3123,2029,1094,2020-01-01,zipcode
ZCTA5 32119,12,22431,43038,1108,149600,19452,9381,16794,1700,5500,5715,2356,1523,11728,10033,1695,10033,5980,4053,2020-01-01,zipcode
ZCTA5 32124,12,6589,71042,1627,242400,5793,3530,5198,1146,1572,1216,734,530,2068,1934,134,1934,1536,398,2020-01-01,zipcode
ZCTA5 36117,01,53594,66349,1040,181900,41647,13921,34840,1988,6548,9975,9510,6819,23969,21914,2055,21914,12752,9162,2020-01-01,zipcode
ZCTA5 36255,01,974,45714,-666666666,118300,820,377,716,143,324,203,7,39,497,410,87,410,380,30,2020-01-01,zipcode
ZCTA5 36264,01,8270,46221,648,135600,6692,3488,5908,1084,2052,1757,687,328,3782,3179,603,3179,2325,854,2020-01-01,zipcode
ZCTA5 36280,01,4532,62468,785,149200,3536,1703,3118,478,1106,719,339,476,2025,1621,404,1621,1343,278,2020-01-01,zipcode
ZCTA5 36301,01,37951,42045,745,122900,30109,12936,25964,3986,8846,8657,2892,1583,17403,14687,2716,14687,8940,5747,2020-01-01,zipcode
ZCTA5 36455,01,179,31625,575,70500,161,80,150,34,78,36,0,2,165,95,70,95,63,32,2020-01-01,zipcode
ZCTA5 36460,01,9029,30083,533,111600,7275,3433,6081,905,2611,1623,619,323,4587,3571,1016,3571,2164,1407,2020-01-01,zipcode
ZCTA5 36511,01,173,-666666666,-666666666,115000,173,76,173,109,16,22,26,0,344,157,187,157,157,0,2020-01-01,zipcode
ZCTA5 36524,01,1314,45152,568,88300,1118,635,980,188,401,252,63,76,947,532,415,532,477,55,2020-01-01,zipcode
ZCTA5 36041,01,1336,42531,-666666666,76200,1103,560,919,181,378,245,86,29,725,539,186,539,494,45,2020-01-01,zipcode
ZCTA5 36053,01,1896,31518,568,72500,1599,782,1284,214,519,460,45,46,1162,729,433,729,548,181,2020-01-01,zipcode
ZCTA5 36066,01,20283,66243,1128,186500,16101,5694,13622,1036,2906,3609,3524,2547,8789,8522,267,8522,5133,3389,2020-01-01,zipcode
ZCTA5 36071,01,479,31518,569,83100,450,295,446,158,160,64,44,20,326,229,97,229,166,63,2020-01-01,zipcode
ZCTA5 36035,01,1691,51429,745,103900,1268,492,1134,133,512,191,188,110,1036,632,404,632,565,67,2020-01-01,zipcode
ZCTA5 36048,01,1373,30592,567,70800,1157,555,998,334,371,227,55,11,891,629,262,629,478,151,2020-01-01,zipcode
ZCTA5 36049,01,5965,44307,576,82300,4777,2128,4201,824,1757,746,627,247,2522,1960,562,1960,1474,486,2020-01-01,zipcode
ZCTA5 36067,01,27682,52343,906,134400,22046,9827,18769,2656,6574,5470,2383,1686,11043,10025,1018,10025,7645,2380,2020-01-01,zipcode
ZCTA5 36069,01,1714,48125,775,120600,1539,776,1359,179,398,407,179,196,1056,785,271,785,703,82,2020-01-01,zipcode
ZCTA5 36075,01,2206,39659,838,85700,1808,946,1700,350,571,454,232,93,1157,924,233,924,722,202,2020-01-01,zipcode
ZCTA5 36081,01,15701,31046,712,148100,13274,5860,7978,948,2362,1839,1533,1296,8240,6025,2215,6025,2785,3240,2020-01-01,zipcode
ZCTA5 36088,01,4511,31801,675,91800,4033,2059,1757,223,441,519,319,255,2043,1287,756,1287,692,595,2020-01-01,zipcode
ZCTA5 36091,01,3177,45313,716,71000,2701,1277,2573,491,1220,605,96,161,1755,1375,380,1375,1080,295,2020-01-01,zipcode
ZCTA5 36109,01,24802,53884,959,117600,20163,7906,17012,1464,4488,5788,3315,1957,10968,10144,824,10144,7115,3029,2020-01-01,zipcode
ZCTA5 36266,01,6064,46875,570,126400,4610,2104,4119,757,1773,1125,268,196,3125,2208,917,2208,1631,577,2020-01-01,zipcode
ZCTA5 36017,01,3042,24850,425,68700,2617,1955,2389,802,953,480,105,49,1047,779,268,779,459,320,2020-01-01,zipcode
ZCTA5 36036,01,2045,44569,667,116500,1885,928,1460,289,484,323,243,121,1103,764,339,764,665,99,2020-01-01,zipcode
ZCTA5 36040,01,3516,27056,674,65500,2850,1567,2560,472,1138,573,217,160,1760,1562,198,1562,1017,545,2020-01-01,zipcode
ZCTA5 36051,01,2363,56691,893,84700,2013,681,1773,197,785,594,96,101,1015,907,108,907,756,151,2020-01-01,zipcode
ZCTA5 36064,01,10574,104327,1456,310300,7709,2332,6782,268,1088,1677,2115,1634,3969,3635,334,3635,3378,257,2020-01-01,zipcode
ZCTA5 36083,01,7187,35324,582,72100,6038,2815,5149,838,1412,1642,584,673,4710,3468,1242,3468,2063,1405,2020-01-01,zipcode
ZCTA5 36107,01,7782,28825,783,64700,5909,2455,4947,1024,1435,1368,591,529,4321,3271,1050,3271,1228,2043,2020-01-01,zipcode
ZCTA5 36110,01,11864,38981,856,62700,9210,4486,7948,1859,2982,2203,590,314,5293,4062,1231,4062,2301,1761,2020-01-01,zipcode
ZCTA5 36205,01,718,-666666666,708,214000,566,344,541,112,124,211,29,65,439,339,100,339,207,132,2020-01-01,zipcode
ZCTA5 36272,01,13012,42804,612,90200,10712,5379,9298,1763,3764,2474,641,656,6470,5210,1260,5210,3983,1227,2020-01-01,zipcode
ZCTA5 36278,01,4271,35741,635,170400,3424,1966,3149,485,877,1150,299,338,3114,1794,1320,1794,1441,353,2020-01-01,zipcode
ZCTA5 36310,01,6258,41818,542,94600,5410,3154,4688,1104,1651,1264,382,287,4236,2542,1694,2542,1905,637,2020-01-01,zipcode
ZCTA5 36312,01,6352,46383,708,128000,5078,2404,4452,598,1584,1598,446,226,2874,2331,543,2331,1727,604,2020-01-01,zipcode
ZCTA5 36313,01,201,59569,-666666666,158800,144,8,144,27,0,117,0,0,163,114,49,114,95,19,2020-01-01,zipcode
ZCTA5 36344,01,5564,42801,680,146500,4511,2119,3999,630,1389,1477,347,156,2761,2180,581,2180,1516,664,2020-01-01,zipcode
ZCTA5 36373,01,476,21364,-666666666,62000,468,323,325,145,131,49,0,0,427,200,227,200,176,24,2020-01-01,zipcode
ZCTA5 36375,01,6884,42928,730,93500,5656,2583,4921,801,2043,1409,422,246,3211,2674,537,2674,1976,698,2020-01-01,zipcode
ZCTA5 34429,12,8439,46808,887,150600,7602,4614,6985,573,2568,1929,1183,732,5241,3928,1313,3928,3402,526,2020-01-01,zipcode
ZCTA5 34607,12,8666,45041,1120,226500,7665,4490,6864,620,2071,2729,903,541,4997,3841,1156,3841,3171,670,2020-01-01,zipcode
ZCTA5 34209,12,35148,63629,1309,245300,31120,15174,28631,1606,9403,8676,5519,3427,18536,14763,3773,14763,11492,3271,2020-01-01,zipcode
ZCTA5 34241,12,15222,83882,1722,351800,12781,5772,11251,389,2680,3333,2879,1970,6561,5870,691,5870,5121,749,2020-01-01,zipcode
ZCTA5 34661,12,186,-666666666,-666666666,158300,186,114,186,0,114,58,14,0,110,110,0,110,86,24,2020-01-01,zipcode
ZCTA5 34945,12,5265,53611,641,204800,4453,2905,3930,713,1177,1136,658,246,1867,1466,401,1466,1312,154,2020-01-01,zipcode
ZCTA5 32258,12,39963,84146,1457,241200,30437,8831,26636,792,5061,9364,7374,4045,14699,13967,732,13967,9875,4092,2020-01-01,zipcode
ZCTA5 32259,12,57223,121868,1954,358800,42036,14317,36514,492,6914,10092,12149,6867,18388,17407,981,17407,15206,2201,2020-01-01,zipcode
ZCTA5 32310,12,15265,37804,842,94000,12486,5292,8714,1312,3264,2068,1429,641,7844,5797,2047,5797,2763,3034,2020-01-01,zipcode
ZCTA5 32311,12,20897,74273,1236,221500,17124,5344,14961,544,2906,3871,3962,3678,9332,8232,1100,8232,5337,2895,2020-01-01,zipcode
ZCTA5 32331,12,4687,39542,813,59200,3841,2383,3390,590,1617,768,266,149,2197,1757,440,1757,1454,303,2020-01-01,zipcode
ZCTA5 32336,12,1144,32005,850,94700,861,456,831,98,342,238,95,58,773,463,310,463,351,112,2020-01-01,zipcode
ZCTA5 32355,12,340,60404,925,306800,315,230,303,14,80,180,18,11,243,167,76,167,139,28,2020-01-01,zipcode
ZCTA5 32403,12,2072,66116,1707,-666666666,1411,308,811,9,72,315,265,150,587,441,146,441,0,441,2020-01-01,zipcode
ZCTA5 36553,01,3361,47461,420,128500,2816,1511,1801,157,1035,383,62,164,1341,859,482,859,833,26,2020-01-01,zipcode
ZCTA5 36582,01,24115,55794,737,132800,18796,8396,16651,2744,5643,5046,2212,1006,10006,8949,1057,8949,6864,2085,2020-01-01,zipcode
ZCTA5 36584,01,650,-666666666,-666666666,72500,542,279,526,93,239,135,52,7,501,299,202,299,292,7,2020-01-01,zipcode
ZCTA5 36585,01,1412,46080,776,82600,902,453,826,27,389,269,23,118,512,359,153,359,272,87,2020-01-01,zipcode
ZCTA5 36603,01,9239,25516,664,86500,7585,5196,6545,1526,2571,1665,475,308,3978,2934,1044,2934,1102,1832,2020-01-01,zipcode
ZCTA5 36605,01,27035,36815,869,84400,21009,9167,17446,2540,6884,5225,1878,919,12487,10090,2397,10090,5373,4717,2020-01-01,zipcode
ZCTA5 36744,01,5972,28946,605,106800,4844,2467,3990,847,1623,919,432,169,3269,2347,922,2347,1514,833,2020-01-01,zipcode
ZCTA5 36761,01,715,24609,548,32300,601,384,536,196,185,116,8,31,611,356,255,356,246,110,2020-01-01,zipcode
ZCTA5 36765,01,2207,24135,1014,63400,1926,1087,1449,357,538,485,54,15,745,597,148,597,570,27,2020-01-01,zipcode
ZCTA5 36783,01,633,30913,557,56900,565,298,536,37,251,175,51,22,588,295,293,295,233,62,2020-01-01,zipcode
ZCTA5 36785,01,1037,44118,755,85600,853,355,782,121,349,232,74,6,720,504,216,504,398,106,2020-01-01,zipcode
ZCTA5 36792,01,1109,-666666666,-666666666,105100,781,460,781,132,284,338,0,27,723,465,258,465,331,134,2020-01-01,zipcode
ZCTA5 32159,12,30459,46163,1078,207600,28079,19535,26738,1815,8528,9747,3550,3098,18921,15819,3102,15819,12892,2927,2020-01-01,zipcode
ZCTA5 32208,12,30648,35296,938,90600,24083,11509,21129,3620,7792,7055,1735,927,14709,12550,2159,12550,6749,5801,2020-01-01,zipcode
ZCTA5 32209,12,35919,26568,783,63800,27524,13304,23621,4921,10468,6174,1421,637,17125,13824,3301,13824,6415,7409,2020-01-01,zipcode
ZCTA5 32176,12,14821,50196,1229,251500,13467,6858,12427,763,3214,4290,2440,1720,10684,7165,3519,7165,5447,1718,2020-01-01,zipcode
ZCTA5 32177,12,28343,40800,778,112700,22050,10729,19447,2767,9075,5334,1428,843,12522,11092,1430,11092,7263,3829,2020-01-01,zipcode
ZCTA5 34715,12,21032,71117,1629,265600,16787,6611,14976,1739,4422,4995,2328,1492,7243,6747,496,6747,5041,1706,2020-01-01,zipcode
ZCTA5 34638,12,30182,97056,1669,275200,21536,6526,18895,1127,4341,6120,5152,2155,9934,9524,410,9524,7787,1737,2020-01-01,zipcode
ZCTA5 34688,12,7779,84017,1346,369400,6693,3295,6219,286,1175,1888,1700,1170,3507,3197,310,3197,2847,350,2020-01-01,zipcode
ZCTA5 34714,12,24227,55406,1420,199200,19172,6099,16270,866,4776,6143,3380,1105,9799,7638,2161,7638,3861,3777,2020-01-01,zipcode
ZCTA5 34772,12,31830,73358,1370,248200,24093,9138,20717,1358,5730,8807,3762,1060,10799,9105,1694,9105,7584,1521,2020-01-01,zipcode
ZCTA5 34653,12,36166,40264,1030,117200,30105,14786,27032,2780,11174,8656,3139,1283,17567,15210,2357,15210,9535,5675,2020-01-01,zipcode
ZCTA5 34982,12,26034,42971,1030,144300,21173,9677,18876,3033,7021,5688,2201,933,11478,10262,1216,10262,7724,2538,2020-01-01,zipcode
ZCTA5 34233,12,18560,66469,1477,250300,15579,6474,14429,848,4468,3716,3309,2088,9235,8160,1075,8160,5745,2415,2020-01-01,zipcode
ZCTA5 36860,01,1890,40190,544,71700,1690,843,1406,293,433,553,100,27,1082,795,287,795,589,206,2020-01-01,zipcode
ZCTA5 36801,01,25127,51697,739,163900,19736,7362,17341,1902,4624,5104,3230,2481,11091,9973,1118,9973,6397,3576,2020-01-01,zipcode
ZCTA5 36804,01,20356,52629,723,118700,15922,6805,14052,1933,4020,4837,2030,1232,7931,7343,588,7343,5808,1535,2020-01-01,zipcode
ZCTA5 36830,01,40141,56595,894,268900,32628,12339,23598,1490,2690,5960,7256,6202,18117,15986,2131,15986,8582,7404,2020-01-01,zipcode
ZCTA5 36852,01,3314,42927,917,130700,2329,959,1947,181,893,774,57,42,1231,972,259,972,734,238,2020-01-01,zipcode
ZCTA5 36870,01,18435,63797,856,141400,15119,5297,12838,1616,3126,5333,1433,1330,7653,7051,602,7051,5529,1522,2020-01-01,zipcode
ZCTA5 32580,12,4924,69702,1140,268500,3790,1171,3283,196,779,1414,617,277,2203,1808,395,1808,1171,637,2020-01-01,zipcode
ZCTA5 32668,12,5144,48530,1050,230200,4424,2322,4005,687,1835,1064,270,149,2519,2017,502,2017,1751,266,2020-01-01,zipcode
ZCTA5 32703,12,55239,53762,1172,216900,43944,15886,38217,5649,10833,11642,7386,2707,21379,19623,1756,19623,12844,6779,2020-01-01,zipcode
ZCTA5 32060,12,23437,46662,706,116200,18941,9616,16778,2854,6427,4373,1797,1327,10498,8456,2042,8456,6631,1825,2020-01-01,zipcode
ZCTA5 32094,12,3909,73825,828,103200,3377,2222,3157,830,1582,559,87,99,992,693,299,693,570,123,2020-01-01,zipcode
ZCTA5 32139,12,1028,39760,-666666666,74700,935,724,891,198,493,94,85,21,626,367,259,367,324,43,2020-01-01,zipcode
ZCTA5 32145,12,5788,47180,919,121300,4469,1970,3832,636,1330,1299,485,82,2360,2016,344,2016,1678,338,2020-01-01,zipcode
ZCTA5 32148,12,10766,36224,634,65700,8462,4717,7447,1286,3831,1429,696,205,5379,4343,1036,4343,3188,1155,2020-01-01,zipcode
ZCTA5 34951,12,16896,47965,961,144700,15132,8244,13513,1910,4325,4830,1763,685,8654,7051,1603,7051,6051,1000,2020-01-01,zipcode
ZCTA5 34956,12,10195,43527,719,85600,8355,4354,6567,2172,2207,1650,416,122,2848,2393,455,2393,1645,748,2020-01-01,zipcode
ZCTA5 34972,12,20132,43851,851,136100,16375,8659,14027,3335,5688,3014,1415,575,7327,5994,1333,5994,4075,1919,2020-01-01,zipcode
ZCTA5 34974,12,24871,46610,823,105500,20753,10927,18526,3072,6876,5976,1929,673,13748,10109,3639,10109,8150,1959,2020-01-01,zipcode
ZCTA5 34744,12,60555,53598,1170,226700,48467,17182,40682,6642,11241,12994,6735,3070,20670,17975,2695,17975,12019,5956,2020-01-01,zipcode
ZCTA5 34753,12,6014,55933,965,165400,4706,1671,3803,1139,1393,1020,147,104,1752,1675,77,1675,1238,437,2020-01-01,zipcode
ZCTA5 34787,12,74842,94038,1405,337000,56549,17208,49459,4266,10407,13348,13732,7706,26915,24677,2238,24677,17911,6766,2020-01-01,zipcode
ZCTA5 34236,12,13384,80761,1325,697200,12707,7859,12392,857,1693,2630,3417,3795,11453,7652,3801,7652,4713,2939,2020-01-01,zipcode
ZCTA5 34292,12,15090,68765,1455,321800,14031,9671,13500,691,3085,3991,3454,2279,9810,7747,2063,7747,6265,1482,2020-01-01,zipcode
ZCTA5 34420,12,18592,46383,836,122100,14903,6356,13230,1834,5130,4891,942,433,8031,7122,909,7122,4771,2351,2020-01-01,zipcode
ZCTA5 34452,12,12538,46216,897,127200,10503,5397,9542,864,3612,3657,1060,349,5896,5197,699,5197,4197,1000,2020-01-01,zipcode
ZCTA5 34470,12,20000,41166,910,122500,16175,7210,13990,1805,4809,4753,1766,857,9085,7989,1096,7989,4509,3480,2020-01-01,zipcode
ZCTA5 34474,12,17358,51325,1134,147800,14254,5528,12787,1198,3616,3640,3141,1192,8099,7270,829,7270,3377,3893,2020-01-01,zipcode
ZCTA5 34482,12,23576,52506,822,166100,20755,13395,18959,3695,7054,4991,2310,909,9022,7091,1931,7091,5632,1459,2020-01-01,zipcode
ZCTA5 34602,12,8320,61549,944,164100,7118,3407,6427,964,2326,1871,707,559,3188,2904,284,2904,2572,332,2020-01-01,zipcode
ZCTA5 34606,12,27014,45125,959,146700,22788,12574,20733,2126,7301,7030,2875,1401,13677,11854,1823,11854,9089,2765,2020-01-01,zipcode
ZCTA5 34102,12,11930,95654,1300,1007100,10649,6120,10002,687,1575,2348,3190,2202,9836,5743,4093,5743,3988,1755,2020-01-01,zipcode
ZCTA5 34113,12,22573,61682,1444,307700,19863,9499,17138,2258,5178,4050,3648,2004,14069,8811,5258,8811,6221,2590,2020-01-01,zipcode
ZCTA5 34119,12,31355,94957,1560,481000,25845,12803,23772,686,5131,6916,6152,4887,16768,13192,3576,13192,10567,2625,2020-01-01,zipcode
ZCTA5 34208,12,43397,50050,1126,204300,33431,13990,28746,6154,10139,6664,3669,2120,15814,13429,2385,13429,7790,5639,2020-01-01,zipcode
ZCTA5 36912,01,1813,43232,907,63600,1580,924,1464,136,486,581,104,157,1024,752,272,752,622,130,2020-01-01,zipcode
ZCTA5 36921,01,814,28100,-666666666,109900,805,501,725,256,250,162,47,10,691,504,187,504,489,15,2020-01-01,zipcode
ZCTA5 36922,01,651,40741,-666666666,66900,574,256,472,157,157,152,0,6,341,220,121,220,200,20,2020-01-01,zipcode
ZCTA5 36481,01,258,15652,-666666666,-666666666,219,155,170,41,99,12,0,18,223,98,125,98,54,44,2020-01-01,zipcode
ZCTA5 36569,01,445,47262,-666666666,68200,442,277,442,38,165,219,19,1,370,212,158,212,212,0,2020-01-01,zipcode
ZCTA5 36732,01,7628,33136,543,142100,6119,2790,5216,564,1986,1594,606,466,3977,3217,760,3217,1878,1339,2020-01-01,zipcode
ZCTA5 36849,01,4228,-666666666,-666666666,-666666666,4228,3003,15,0,0,5,10,0,0,0,0,0,0,0,2020-01-01,zipcode
ZCTA5 36919,01,1707,30648,433,59200,1388,775,1261,316,499,358,53,35,982,716,266,716,585,131,2020-01-01,zipcode
ZCTA5 36006,01,1571,19792,784,174200,1417,731,1278,132,487,475,125,59,851,691,160,691,622,69,2020-01-01,zipcode
ZCTA5 36374,01,643,63813,-666666666,65200,591,241,578,127,161,209,49,32,521,283,238,283,254,29,2020-01-01,zipcode
ZCTA5 36507,01,21598,44206,730,130400,17268,7685,14383,2615,4870,4757,1291,850,8307,7414,893,7414,5482,1932,2020-01-01,zipcode
ZCTA5 36052,01,620,123342,-666666666,710000,554,174,472,19,88,92,197,76,342,290,52,290,276,14,2020-01-01,zipcode
ZCTA5 36092,01,20805,59034,869,155300,16629,7689,14933,1839,5662,4268,2278,886,9387,8068,1319,8068,5951,2117,2020-01-01,zipcode
ZCTA5 36273,01,3132,51205,665,106600,2560,1057,2118,426,859,501,182,150,1524,1303,221,1303,1110,193,2020-01-01,zipcode
ZCTA5 36038,01,19,-666666666,-666666666,-666666666,19,19,19,0,19,0,0,0,10,10,0,10,10,0,2020-01-01,zipcode
ZCTA5 36082,01,1004,-666666666,-666666666,-666666666,1004,790,14,0,8,6,0,0,0,0,0,0,0,0,2020-01-01,zipcode
ZCTA5 36112,01,262,-666666666,-666666666,-666666666,262,10,174,0,48,126,0,0,0,0,0,0,0,0,2020-01-01,zipcode
ZCTA5 36321,01,1898,49659,758,150700,1456,677,1292,232,482,403,99,76,765,691,74,691,563,128,2020-01-01,zipcode
ZCTA5 36421,01,10870,47153,617,108700,8296,3902,7248,886,2441,2587,873,461,5335,4027,1308,4027,2990,1037,2020-01-01,zipcode
ZCTA5 36439,01,508,56875,837,157200,322,132,280,17,111,75,40,37,214,163,51,163,113,50,2020-01-01,zipcode
ZCTA5 36454,01,7,-666666666,-666666666,-666666666,7,7,7,0,7,0,0,0,41,4,37,4,4,0,2020-01-01,zipcode
ZCTA5 36512,01,12,-666666666,-666666666,-666666666,12,12,12,12,0,0,0,0,6,6,0,6,6,0,2020-01-01,zipcode
ZCTA5 36543,01,55,-666666666,-666666666,-666666666,21,0,21,0,0,7,0,14,11,11,0,11,11,0,2020-01-01,zipcode
ZCTA5 36555,01,870,81375,853,291100,782,364,676,6,138,198,189,145,442,337,105,337,296,41,2020-01-01,zipcode
ZCTA5 36568,01,108,-666666666,-666666666,-666666666,108,55,95,23,19,10,0,43,74,74,0,74,64,10,2020-01-01,zipcode
ZCTA5 36590,01,0,-666666666,-666666666,-666666666,0,0,0,0,0,0,0,0,0,0,0,0,0,0,2020-01-01,zipcode
ZCTA5 36615,01,0,-666666666,-666666666,-666666666,0,0,0,0,0,0,0,0,0,0,0,0,0,0,2020-01-01,zipcode
ZCTA5 36616,01,8,-666666666,-666666666,-666666666,8,0,0,0,0,0,0,0,21,8,13,8,0,8,2020-01-01,zipcode
ZCTA5 36688,01,232,-666666666,-666666666,-666666666,232,163,0,0,0,0,0,0,0,0,0,0,0,0,2020-01-01,zipcode
ZCTA5 36753,01,26,-666666666,-666666666,-666666666,26,26,26,8,0,0,0,18,33,26,7,26,18,8,2020-01-01,zipcode
ZCTA5 36766,01,23,-666666666,-666666666,141700,23,13,23,5,0,0,12,6,28,14,14,14,10,4,2020-01-01,zipcode
ZCTA5 36859,01,14,-666666666,-666666666,-666666666,14,4,14,0,0,4,10,0,4,4,0,4,4,0,2020-01-01,zipcode
ZCTA5 36865,01,59,55750,-666666666,116700,59,13,37,0,13,17,7,0,28,22,6,22,12,10,2020-01-01,zipcode
ZCTA5 36913,01,50,-666666666,-666666666,-666666666,50,50,50,37,0,13,0,0,21,21,0,21,21,0,2020-01-01,zipcode
ZCTA5 36108,01,16247,23431,638,64100,13199,7121,11541,3115,3869,2858,1154,545,8827,6609,2218,6609,3843,2766,2020-01-01,zipcode
ZCTA5 36256,01,1325,49620,588,100500,1074,505,978,132,328,360,77,81,774,601,173,601,522,79,2020-01-01,zipcode
ZCTA5 36115,01,994,72708,1367,-666666666,649,166,466,0,55,253,87,71,266,266,0,266,0,266,2020-01-01,zipcode
ZCTA5 36323,01,7863,41292,627,83900,6806,3584,5994,1450,2065,1754,507,218,3788,2990,798,2990,2234,756,2020-01-01,zipcode
ZCTA5 36528,01,1610,65481,1096,309100,1521,802,1401,58,196,616,347,184,2143,679,1464,679,630,49,2020-01-01,zipcode
ZCTA5 32669,12,13457,71880,965,230000,10229,3635,9043,378,1920,3479,2050,1216,5347,4854,493,4854,4046,808,2020-01-01,zipcode
ZCTA5 32692,12,126,-666666666,-666666666,-666666666,79,42,79,37,27,0,15,0,646,42,604,42,42,0,2020-01-01,zipcode
ZCTA5 32701,12,24060,57778,1251,192500,20404,6428,18213,934,3323,7549,4694,1713,12038,10808,1230,10808,5345,5463,2020-01-01,zipcode
ZCTA5 32709,12,1601,57150,-666666666,190600,1441,410,1325,136,551,385,212,41,707,661,46,661,584,77,2020-01-01,zipcode
ZCTA5 32052,12,8727,42523,666,94900,7451,5086,6588,1830,3212,1214,255,77,2902,2147,755,2147,1476,671,2020-01-01,zipcode
ZCTA5 32058,12,4728,42382,841,118600,3963,2095,3324,859,1502,809,97,57,1501,1292,209,1292,1009,283,2020-01-01,zipcode
ZCTA5 32038,12,10639,37896,778,115000,8786,4520,7834,915,2979,3021,641,278,4871,3973,898,3973,3318,655,2020-01-01,zipcode
ZCTA5 32059,12,2507,41831,750,77800,2145,1098,1930,407,715,671,77,60,1257,1028,229,1028,834,194,2020-01-01,zipcode
ZCTA5 32102,12,2081,45395,1151,162500,1782,1124,1662,318,612,419,215,98,1591,980,611,980,827,153,2020-01-01,zipcode
ZCTA5 32114,12,33731,33474,928,122500,28599,13501,22389,3339,7277,7496,3036,1241,15758,13290,2468,13290,4405,8885,2020-01-01,zipcode
ZCTA5 32117,12,28266,40659,1084,120000,23178,10115,20510,2011,7698,7116,2572,1113,13098,11249,1849,11249,5565,5684,2020-01-01,zipcode
ZCTA5 32118,12,17492,43385,1066,250700,15640,7660,14433,1091,4209,4668,2793,1672,15292,9111,6181,9111,5456,3655,2020-01-01,zipcode
ZCTA5 32132,12,7954,41724,858,174300,7226,3408,6765,441,2617,2793,521,393,4156,3887,269,3887,3194,693,2020-01-01,zipcode
ZCTA5 32137,12,44396,65573,1386,258600,38662,20413,34715,2374,11072,10838,6389,4042,22642,17568,5074,17568,14741,2827,2020-01-01,zipcode
ZCTA5 32174,12,52115,56383,1091,222000,44726,22704,40711,2920,11832,13630,7963,4366,25696,23090,2606,23090,18340,4750,2020-01-01,zipcode
ZCTA5 32204,12,7507,47513,965,220000,6700,2034,5813,698,1028,1447,1688,952,4847,4123,724,4123,993,3130,2020-01-01,zipcode
ZCTA5 32205,12,30349,48292,942,178900,25013,7910,22764,2703,6171,6598,4508,2784,15584,13859,1725,13859,6979,6880,2020-01-01,zipcode
ZCTA5 32211,12,35160,44186,920,138800,26730,8457,22840,2614,8324,7664,3097,1141,15142,13606,1536,13606,6552,7054,2020-01-01,zipcode
ZCTA5 32216,12,37867,52915,1068,178900,30514,10785,26602,2611,7655,7858,5801,2677,17922,16152,1770,16152,7448,8704,2020-01-01,zipcode
ZCTA5 32224,12,41017,76428,1303,323900,33714,11501,25585,1284,4569,7444,8013,4275,16302,14907,1395,14907,8693,6214,2020-01-01,zipcode
ZCTA5 32226,12,16407,85000,1689,243100,12738,4762,11492,827,3362,3999,2361,943,6712,5730,982,5730,5130,600,2020-01-01,zipcode
ZCTA5 32323,12,113,-666666666,-666666666,-666666666,113,113,113,0,51,19,20,23,368,71,297,71,42,29,2020-01-01,zipcode
ZCTA5 32347,12,7240,53344,664,117200,5453,2691,4868,526,1945,1610,560,227,3491,2583,908,2583,2134,449,2020-01-01,zipcode
ZCTA5 32408,12,19463,57202,1100,257300,16038,5757,14648,613,3485,5689,3458,1403,18149,8702,9447,8702,5833,2869,2020-01-01,zipcode
ZCTA5 32713,12,21212,70421,1123,230400,18029,7805,16270,783,5502,5748,3130,1107,9195,8366,829,8366,6974,1392,2020-01-01,zipcode
ZCTA5 32714,12,37983,54611,1263,202900,31092,9669,27305,1848,6256,9160,7195,2846,16914,15224,1690,15224,7351,7873,2020-01-01,zipcode
ZCTA5 32784,12,10869,56250,911,153000,8839,3885,7828,1171,2545,2999,635,478,4932,3962,970,3962,2989,973,2020-01-01,zipcode
ZCTA5 32789,12,25767,79907,1353,500300,22083,9285,18707,701,2748,3849,6142,5267,12520,11187,1333,11187,7317,3870,2020-01-01,zipcode
ZCTA5 32796,12,20738,52135,961,161700,17692,8666,15815,1368,5681,5090,2220,1456,9776,8208,1568,8208,6625,1583,2020-01-01,zipcode
ZCTA5 32806,12,26964,72533,1203,304500,22050,6216,19919,1129,4076,4992,5802,3920,12179,10922,1257,10922,6768,4154,2020-01-01,zipcode
ZCTA5 32825,12,60254,64400,1329,235900,49406,15672,40753,4466,9803,14492,7810,4182,21827,19123,2704,19123,12544,6579,2020-01-01,zipcode
ZCTA5 32826,12,37297,57023,1194,180000,35007,20622,15029,1693,3580,4326,3324,2106,9708,8672,1036,8672,4309,4363,2020-01-01,zipcode
ZCTA5 32421,12,4793,37377,596,86500,3851,2033,3341,755,1197,1060,289,40,1961,1592,369,1592,1329,263,2020-01-01,zipcode
ZCTA5 32433,12,19459,47311,813,97400,15262,6900,13660,2764,5401,4026,930,539,8238,6875,1363,6875,5088,1787,2020-01-01,zipcode
ZCTA5 32437,12,763,31618,619,107600,543,231,501,71,261,148,20,1,349,310,39,310,204,106,2020-01-01,zipcode
ZCTA5 32438,12,3842,38878,481,75000,3477,1697,2927,612,1141,898,250,26,1854,1613,241,1613,1515,98,2020-01-01,zipcode
ZCTA5 32444,12,21922,73258,1312,225900,16788,5461,14140,667,3740,5214,2914,1605,8961,7936,1025,7936,5610,2326,2020-01-01,zipcode
ZCTA5 32446,12,10745,47554,731,127400,9023,4409,7742,906,2443,2832,742,819,4631,4063,568,4063,2741,1322,2020-01-01,zipcode
ZCTA5 32449,12,751,-666666666,-666666666,65600,501,182,469,126,215,128,0,0,306,218,88,218,195,23,2020-01-01,zipcode
ZCTA5 32062,12,1666,52917,-666666666,138800,1361,732,1194,250,521,246,57,120,1030,582,448,582,569,13,2020-01-01,zipcode
ZCTA5 32072,12,114,94728,-666666666,-666666666,114,41,114,0,32,34,39,9,136,59,77,59,59,0,2020-01-01,zipcode
ZCTA5 32073,12,42153,62688,1124,183700,34319,12113,30081,2640,8270,11621,5084,2466,16027,15094,933,15094,9890,5204,2020-01-01,zipcode
ZCTA5 32084,12,36415,54519,1062,214800,31161,13099,26545,2327,9258,7436,4590,2934,16571,13011,3560,13011,8998,4013,2020-01-01,zipcode
ZCTA5 32086,12,30392,58714,1176,246300,26053,11353,23269,1867,5908,9095,4176,2223,13930,11575,2355,11575,8814,2761,2020-01-01,zipcode
ZCTA5 32095,12,13155,76846,1076,372000,9992,3296,8669,374,2014,2168,2165,1948,4761,4483,278,4483,3699,784,2020-01-01,zipcode
ZCTA5 32096,12,2870,41629,594,94400,2328,1315,2140,529,868,471,200,72,1449,1189,260,1189,897,292,2020-01-01,zipcode
ZCTA5 32097,12,19139,69980,1315,208600,14810,5082,12937,1379,4667,3977,1926,988,7510,6890,620,6890,5523,1367,2020-01-01,zipcode
ZCTA5 36028,01,1474,38821,524,104800,1203,601,1008,187,308,339,129,45,989,621,368,621,402,219,2020-01-01,zipcode
ZCTA5 36030,01,540,48345,608,151500,519,221,466,21,303,88,45,9,294,173,121,173,139,34,2020-01-01,zipcode
ZCTA5 36034,01,1141,41912,542,57200,869,358,659,72,242,213,77,55,440,324,116,324,287,37,2020-01-01,zipcode
ZCTA5 36042,01,1645,56433,-666666666,105700,1301,619,1153,180,565,256,113,39,951,577,374,577,534,43,2020-01-01,zipcode
ZCTA5 36046,01,1345,40885,-666666666,88000,1092,446,952,254,288,260,97,53,599,485,114,485,458,27,2020-01-01,zipcode
ZCTA5 36054,01,15559,56593,861,143600,11674,4038,9717,1133,2947,3010,1635,992,6164,5735,429,5735,4071,1664,2020-01-01,zipcode
ZCTA5 36089,01,7683,31596,569,80100,5948,3036,5051,1356,2036,1141,325,193,3417,2610,807,2610,1849,761,2020-01-01,zipcode
ZCTA5 36104,01,9084,31717,694,86100,7474,3949,5695,1192,1662,1427,731,683,4742,3451,1291,3451,972,2479,2020-01-01,zipcode
ZCTA5 36105,01,9636,32588,841,81800,8169,4113,7363,1899,2196,2166,714,388,5487,4113,1374,4113,2474,1639,2020-01-01,zipcode
ZCTA5 36116,01,45027,51124,901,98600,34602,12071,28904,3431,6916,9082,5464,4011,20543,17838,2705,17838,8622,9216,2020-01-01,zipcode
ZCTA5 36207,01,19737,59832,835,166800,16018,6698,13727,979,3931,4813,2066,1938,9706,8118,1588,8118,5957,2161,2020-01-01,zipcode
ZCTA5 36260,01,4286,59228,607,144400,3276,1729,3021,353,1184,868,341,275,1769,1539,230,1539,1236,303,2020-01-01,zipcode
ZCTA5 36263,01,385,-666666666,710,101400,368,205,320,46,149,68,10,47,254,163,91,163,99,64,2020-01-01,zipcode
ZCTA5 36265,01,20299,47152,647,144300,17124,7413,12993,1451,4138,4055,1911,1438,9376,8209,1167,8209,5122,3087,2020-01-01,zipcode
ZCTA5 36267,01,239,-666666666,-666666666,-666666666,97,85,97,0,74,23,0,0,12,12,0,12,12,0,2020-01-01,zipcode
ZCTA5 35951,01,12226,45073,603,112400,9382,4422,8020,2275,2417,2308,737,283,4894,4241,653,4241,3177,1064,2020-01-01,zipcode
ZCTA5 35957,01,15861,41773,589,96900,12061,5363,10162,1739,3455,3574,915,479,6469,5649,820,5649,3588,2061,2020-01-01,zipcode
ZCTA5 35963,01,1076,33451,-666666666,111000,962,475,924,126,267,431,74,26,669,518,151,518,371,147,2020-01-01,zipcode
ZCTA5 35972,01,1196,-666666666,-666666666,77600,963,531,869,245,322,186,89,27,554,499,55,499,445,54,2020-01-01,zipcode
ZCTA5 35973,01,3368,41694,-666666666,89000,2734,1435,2374,614,785,747,185,43,1546,1224,322,1224,1072,152,2020-01-01,zipcode
ZCTA5 35022,01,20684,63434,898,185700,17495,6228,14902,1061,4697,5004,2807,1333,9028,8492,536,8492,6584,1908,2020-01-01,zipcode
ZCTA5 35036,01,255,-666666666,256,65000,233,158,157,40,100,13,4,0,155,121,34,121,33,88,2020-01-01,zipcode
ZCTA5 35043,01,13297,93731,1099,244700,9697,3509,8390,246,1709,3117,2309,1009,4433,4103,330,4103,3698,405,2020-01-01,zipcode
ZCTA5 35058,01,9216,44514,764,126100,7578,3197,6847,1136,2516,2261,601,333,4194,3610,584,3610,2721,889,2020-01-01,zipcode
ZCTA5 35061,01,1593,52989,947,150400,1475,517,1188,108,404,559,92,25,664,479,185,479,310,169,2020-01-01,zipcode
ZCTA5 35062,01,8347,51657,693,124200,6573,3075,5857,800,2079,1867,787,324,3602,3267,335,3267,2632,635,2020-01-01,zipcode
ZCTA5 35074,01,91,-666666666,-666666666,-666666666,91,0,91,48,0,43,0,0,43,43,0,43,0,43,2020-01-01,zipcode
ZCTA5 35077,01,13935,41282,669,123200,11752,5866,10171,2153,3380,3260,781,597,6582,5624,958,5624,3988,1636,2020-01-01,zipcode
ZCTA5 35080,01,19047,93176,1366,197400,14377,4350,12318,537,2083,3744,4236,1718,6820,6416,404,6416,5996,420,2020-01-01,zipcode
ZCTA5 35089,01,1776,52810,768,86200,1621,744,1445,255,530,528,69,63,852,691,161,691,597,94,2020-01-01,zipcode
ZCTA5 35091,01,3179,93042,859,209900,2277,668,2016,108,566,850,295,197,1269,1109,160,1109,1056,53,2020-01-01,zipcode
ZCTA5 35096,01,8695,59619,858,131100,6933,2633,5935,1068,1882,1993,734,258,4130,3113,1017,3113,2688,425,2020-01-01,zipcode
ZCTA5 35112,01,198,145739,-666666666,-666666666,157,17,157,8,66,83,0,0,93,93,0,93,83,10,2020-01-01,zipcode
ZCTA5 35126,01,20761,67992,889,145500,16687,6330,13893,1366,4862,4946,1978,741,8067,7533,534,7533,6398,1135,2020-01-01,zipcode
ZCTA5 35130,01,3421,46786,470,100700,2874,1590,2579,555,1108,744,97,75,1954,1500,454,1500,1233,267,2020-01-01,zipcode
ZCTA5 35133,01,3295,49764,-666666666,143100,2619,1326,2437,377,868,974,144,74,1433,1229,204,1229,1162,67,2020-01-01,zipcode
ZCTA5 35151,01,7827,61507,844,126700,6349,2921,5711,868,1913,1784,636,510,3688,2823,865,2823,2560,263,2020-01-01,zipcode
ZCTA5 35172,01,2941,37361,765,99500,2477,1224,2301,276,1124,713,148,40,1284,1155,129,1155,840,315,2020-01-01,zipcode
ZCTA5 35178,01,3126,33530,767,118600,2407,1275,2159,342,950,588,197,82,1581,1277,304,1277,1061,216,2020-01-01,zipcode
ZCTA5 35739,01,4380,49306,742,144100,3636,1359,3282,528,1326,918,390,120,2144,1916,228,1916,1533,383,2020-01-01,zipcode
ZCTA5 35746,01,558,34948,-666666666,-666666666,558,411,535,172,223,130,10,0,432,299,133,299,266,33,2020-01-01,zipcode
ZCTA5 35756,01,14757,102135,1425,240600,10859,3766,9376,500,1498,2713,3013,1652,5229,4677,552,4677,4178,499,2020-01-01,zipcode
ZCTA5 35758,01,47979,86495,1023,252700,38042,12554,32980,823,3870,7849,11671,8767,20654,19804,850,19804,13602,6202,2020-01-01,zipcode
ZCTA5 35760,01,4797,66042,782,134500,3422,1231,3076,567,945,849,642,73,1817,1619,198,1619,1339,280,2020-01-01,zipcode
ZCTA5 35764,01,554,26657,580,77500,511,244,464,195,197,60,11,1,288,275,13,275,214,61,2020-01-01,zipcode
ZCTA5 35772,01,4722,36607,626,84700,3753,1971,3383,608,1477,824,337,137,2348,1844,504,1844,1386,458,2020-01-01,zipcode
ZCTA5 32583,12,30135,66200,1044,164100,26321,13124,23093,4070,7685,7664,2558,1116,10573,9608,965,9608,7458,2150,2020-01-01,zipcode
ZCTA5 32601,12,19805,24916,865,189000,18097,7340,9011,495,1469,2346,2573,2128,9965,8200,1765,8200,2131,6069,2020-01-01,zipcode
ZCTA5 32626,12,8583,35345,694,106400,7166,3893,6304,677,3046,1878,526,177,4529,3686,843,3686,2807,879,2020-01-01,zipcode
ZCTA5 32643,12,11453,57404,940,173900,9122,3915,7780,871,2377,3180,864,488,4551,4094,457,4094,3399,695,2020-01-01,zipcode
ZCTA5 32656,12,14538,54631,896,142500,11535,5026,9995,1204,3589,3597,1059,546,6348,5423,925,5423,4362,1061,2020-01-01,zipcode
ZCTA5 32664,12,379,51196,-666666666,152100,311,190,294,22,79,83,67,43,200,166,34,166,110,56,2020-01-01,zipcode
ZCTA5 32666,12,6620,56544,1125,164900,6016,3251,5341,374,2058,1583,540,786,3712,2737,975,2737,2379,358,2020-01-01,zipcode
ZCTA5 32697,12,226,42031,844,56900,164,73,111,31,50,25,3,2,150,87,63,87,11,76,2020-01-01,zipcode
ZCTA5 32725,12,49802,55888,1198,173500,39551,17719,34344,4199,11272,12839,4485,1549,18339,16823,1516,16823,12974,3849,2020-01-01,zipcode
ZCTA5 32751,12,21478,78337,1395,317800,17750,6026,15427,651,2052,4214,5151,3359,9891,8731,1160,8731,5709,3022,2020-01-01,zipcode
ZCTA5 32763,12,23837,49566,1160,155600,19806,8393,17659,1779,6062,6359,2046,1413,10596,9473,1123,9473,5915,3558,2020-01-01,zipcode
ZCTA5 32766,12,16415,118395,1948,384100,12537,4243,10588,578,1911,2649,2873,2577,5069,4925,144,4925,4382,543,2020-01-01,zipcode
ZCTA5 32798,12,2583,51399,-666666666,104000,2404,1437,2331,184,888,980,180,99,1554,1329,225,1329,1281,48,2020-01-01,zipcode
ZCTA5 32805,12,19764,33433,825,158100,16285,6398,14903,3211,5583,3115,2129,865,9538,7385,2153,7385,2899,4486,2020-01-01,zipcode
ZCTA5 32817,12,35332,64043,1316,239000,30117,11096,20942,1606,5084,6855,4834,2563,13009,11083,1926,11083,6134,4949,2020-01-01,zipcode
ZCTA5 32839,12,53012,42124,1137,152500,42179,14587,35060,6938,11095,10843,4538,1646,23385,17392,5993,17392,4208,13184,2020-01-01,zipcode
ZCTA5 32948,12,6594,42312,794,115000,4848,1800,3688,1398,1087,707,419,77,2014,1559,455,1559,982,577,2020-01-01,zipcode
ZCTA5 32952,12,20553,79720,1015,313900,17439,7482,15556,727,3306,4959,4177,2387,10030,8273,1757,8273,7039,1234,2020-01-01,zipcode
ZCTA5 32953,12,23829,66834,1104,291800,20131,8370,17856,1080,4025,6162,4332,2257,11480,9507,1973,9507,7156,2351,2020-01-01,zipcode
ZCTA5 32955,12,39846,72969,1358,247500,33217,13090,29834,1728,7490,10001,6607,4008,18117,15284,2833,15284,12110,3174,2020-01-01,zipcode
ZCTA5 32967,12,22819,51777,959,255800,19293,10422,17097,2208,5241,5008,2487,2153,10575,8009,2566,8009,6317,1692,2020-01-01,zipcode
ZCTA5 32456,12,8113,57872,1159,233200,6766,2819,6130,433,1598,1970,1273,856,6553,3619,2934,3619,2654,965,2020-01-01,zipcode
ZCTA5 32504,12,21467,62254,1070,187900,16679,6466,14333,975,2887,4503,3311,2657,9723,8985,738,8985,5437,3548,2020-01-01,zipcode
ZCTA5 32505,12,27369,37673,912,72200,21634,9143,19014,2955,7329,6377,1645,708,13198,11025,2173,11025,5111,5914,2020-01-01,zipcode
ZCTA5 32506,12,37604,51477,1092,135300,30208,12122,25416,3263,6834,10050,3382,1887,16301,14283,2018,14283,8476,5807,2020-01-01,zipcode
ZCTA5 32507,12,33689,51842,963,172200,27051,10116,22959,2115,5403,8857,4338,2246,18716,13631,5085,13631,8273,5358,2020-01-01,zipcode
ZCTA5 32541,12,19085,84865,1622,381600,16100,5131,14500,940,2557,4410,4361,2232,16749,8317,8432,8317,5459,2858,2020-01-01,zipcode
ZCTA5 32564,12,2832,69643,1103,146200,2240,1024,2213,227,660,954,279,93,1185,1100,85,1100,1015,85,2020-01-01,zipcode
ZCTA5 32568,12,2806,58295,681,170000,2307,888,2078,213,729,864,135,137,1255,1101,154,1101,942,159,2020-01-01,zipcode
ZCTA5 32579,12,10796,84375,1266,321500,8882,3557,7853,444,1683,1944,1963,1819,4797,4382,415,4382,3085,1297,2020-01-01,zipcode
ZCTA5 32609,12,19495,37725,953,115300,16371,6797,13777,2058,3883,4803,1930,1103,8287,7160,1127,7160,3838,3322,2020-01-01,zipcode
ZCTA5 32628,12,5377,38500,633,80100,4449,2919,3955,763,2003,913,230,46,1875,1524,351,1524,1203,321,2020-01-01,zipcode
ZCTA5 36262,01,1402,43750,641,90900,1087,614,1008,247,454,207,86,14,629,498,131,498,414,84,2020-01-01,zipcode
ZCTA5 36279,01,2864,57886,933,133500,2243,1110,2077,329,713,685,149,201,1240,1039,201,1039,900,139,2020-01-01,zipcode
ZCTA5 36319,01,2212,54196,770,89800,1718,830,1568,230,586,531,129,92,1036,848,188,848,700,148,2020-01-01,zipcode
ZCTA5 36320,01,3208,37420,675,94400,2656,1342,2364,369,912,771,256,56,1641,1291,350,1291,1035,256,2020-01-01,zipcode
ZCTA5 36330,01,38010,62545,846,169200,29454,11213,25599,2886,6150,9907,4365,2291,16479,14439,2040,14439,9121,5318,2020-01-01,zipcode
ZCTA5 36401,01,7900,33026,567,85100,6296,3497,5513,697,2667,1469,304,376,4462,2989,1473,2989,2110,879,2020-01-01,zipcode
ZCTA5 36013,01,631,101167,-666666666,367300,541,230,477,53,86,233,66,39,228,228,0,228,228,0,2020-01-01,zipcode
ZCTA5 36037,01,13172,44609,640,96300,10415,4580,8960,1268,4060,2152,914,566,6346,4338,2008,4338,2982,1356,2020-01-01,zipcode
ZCTA5 36039,01,139,49375,-666666666,-666666666,139,62,126,39,31,43,13,0,54,54,0,54,33,21,2020-01-01,zipcode
ZCTA5 36093,01,10839,106233,1080,256500,8599,3037,7092,200,1317,2143,1986,1446,3878,3735,143,3735,3558,177,2020-01-01,zipcode
ZCTA5 36111,01,12500,54613,893,161800,9861,3658,8069,1066,1805,2193,1922,1083,5606,4779,827,4779,2780,1999,2020-01-01,zipcode
ZCTA5 36203,01,17705,61182,841,141400,14082,5160,12283,2022,3136,4243,1526,1356,7514,6733,781,6733,4675,2058,2020-01-01,zipcode
ZCTA5 36250,01,5258,77721,915,125200,4319,1721,3789,339,1368,1412,416,254,1874,1698,176,1698,1529,169,2020-01-01,zipcode
ZCTA5 36317,01,700,49583,-666666666,92300,666,352,567,136,135,139,91,66,382,313,69,313,269,44,2020-01-01,zipcode
ZCTA5 36318,01,1254,52143,588,106000,984,479,804,132,265,316,70,21,698,494,204,494,440,54,2020-01-01,zipcode
ZCTA5 36866,01,3795,44554,563,84200,2975,1156,2757,460,1049,933,216,99,1894,1554,340,1554,1215,339,2020-01-01,zipcode
ZCTA5 36877,01,13340,57857,887,153900,10458,3925,8670,868,2400,3385,1066,951,5057,4432,625,4432,3235,1197,2020-01-01,zipcode
ZCTA5 36901,01,316,31296,-666666666,60900,316,206,266,65,157,44,0,0,199,174,25,174,109,65,2020-01-01,zipcode
ZCTA5 36005,01,1411,39063,578,91700,1156,583,952,204,346,213,108,81,743,530,213,530,469,61,2020-01-01,zipcode
ZCTA5 36010,01,5047,39643,691,100700,4069,2063,3380,706,1429,735,333,177,2442,1594,848,1594,1165,429,2020-01-01,zipcode
ZCTA5 36027,01,14282,34969,597,112000,11176,5273,9592,2065,3090,2977,873,587,7353,5804,1549,5804,3348,2456,2020-01-01,zipcode
ZCTA5 32256,12,47883,65549,1235,282700,41237,12558,35054,1581,5966,8955,12115,6437,23734,21791,1943,21791,8545,13246,2020-01-01,zipcode
ZCTA5 32304,12,50298,23704,955,104100,47407,19090,16168,2173,3727,5070,2926,2272,22831,19099,3732,19099,2507,16592,2020-01-01,zipcode
ZCTA5 32308,12,21870,63018,1099,231600,18446,6503,16311,470,2715,3958,4606,4562,11343,10547,796,10547,5456,5091,2020-01-01,zipcode
ZCTA5 32901,12,26014,42822,1028,161800,22870,11379,18468,1928,4938,6056,3385,2161,13064,10658,2406,10658,4860,5798,2020-01-01,zipcode
ZCTA5 32926,12,22862,54366,1020,191300,20102,9610,18387,2279,6156,6378,2261,1313,10331,8923,1408,8923,7259,1664,2020-01-01,zipcode
ZCTA5 32940,12,43046,73601,1571,303200,35292,17106,31927,978,5323,9805,8782,7039,19205,17828,1377,17828,14892,2936,2020-01-01,zipcode
ZCTA5 32950,12,4422,83400,1295,302400,3856,1665,3471,164,1163,1096,815,233,1854,1788,66,1788,1637,151,2020-01-01,zipcode
ZCTA5 32968,12,14705,79811,1423,281300,12392,5831,10670,487,3160,3423,2512,1088,5607,4904,703,4904,4592,312,2020-01-01,zipcode
ZCTA5 32780,12,35908,51665,968,171200,30550,15011,27217,2363,7654,10321,4480,2399,19460,15211,4249,15211,10953,4258,2020-01-01,zipcode
ZCTA5 32934,12,18298,81106,1370,274000,16092,8082,14306,1090,3160,4840,3098,2118,7561,7159,402,7159,6347,812,2020-01-01,zipcode
ZCTA5 32033,12,4771,67031,1446,199300,4340,2034,3834,319,907,1663,549,396,2200,1924,276,1924,1647,277,2020-01-01,zipcode
ZCTA5 32003,12,30582,101685,1464,278300,25209,9798,21532,876,3852,6975,6015,3814,11573,11093,480,11093,9552,1541,2020-01-01,zipcode
ZCTA5 32026,12,2026,-666666666,-666666666,-666666666,2026,2026,1896,901,709,252,23,11,0,0,0,0,0,0,2020-01-01,zipcode
ZCTA5 32064,12,6929,44505,725,96700,5824,2389,5013,445,2141,1508,571,348,3068,2450,618,2450,1402,1048,2020-01-01,zipcode
ZCTA5 32080,12,22237,78678,1310,392100,19848,9563,17967,672,3263,5033,5631,3368,16453,9976,6477,9976,7901,2075,2020-01-01,zipcode
ZCTA5 32081,12,16914,124821,1974,419400,12396,5169,11079,96,1397,2753,3339,3494,6495,5476,1019,5476,4883,593,2020-01-01,zipcode
ZCTA5 32128,12,22046,76814,1609,278200,18570,8668,16256,715,3527,5160,4343,2511,9462,8695,767,8695,7279,1416,2020-01-01,zipcode
ZCTA5 32129,12,23383,51834,1185,175200,20517,8412,17691,1484,5413,6799,2872,1123,11493,10088,1405,10088,7019,3069,2020-01-01,zipcode
ZCTA5 32133,12,0,-666666666,-666666666,-666666666,0,0,0,0,0,0,0,0,47,0,47,0,0,0,2020-01-01,zipcode
ZCTA5 32162,12,55828,64578,1372,273400,55299,49124,55084,1134,14019,17132,13137,9662,38134,31260,6874,31260,29944,1316,2020-01-01,zipcode
ZCTA5 32228,12,509,-666666666,-666666666,-666666666,509,0,114,0,0,81,33,0,0,0,0,0,0,0,2020-01-01,zipcode
ZCTA5 32305,12,21533,43876,857,112200,16827,6281,13248,2096,4159,4460,1592,941,8995,7802,1193,7802,4814,2988,2020-01-01,zipcode
ZCTA5 32309,12,33359,83744,1091,269200,26104,9481,22762,642,3061,5489,7981,5589,13541,13089,452,13089,10365,2724,2020-01-01,zipcode
ZCTA5 32317,12,14636,91574,1236,274700,11642,4303,10043,324,1931,2583,2825,2380,5754,5402,352,5402,4888,514,2020-01-01,zipcode
ZCTA5 32348,12,12980,38963,732,69100,11186,7490,9717,2353,4655,1775,513,421,5202,3761,1441,3761,2784,977,2020-01-01,zipcode
ZCTA5 32352,12,6030,41250,834,89300,4694,1872,4292,495,1867,1319,384,227,2935,2415,520,2415,1910,505,2020-01-01,zipcode
ZCTA5 32435,12,7039,45650,813,149200,5827,2295,4966,430,1873,1514,786,363,3331,2772,559,2772,2000,772,2020-01-01,zipcode
ZCTA5 32461,12,16,-666666666,-666666666,-666666666,16,0,16,0,0,0,16,0,112,16,96,16,16,0,2020-01-01,zipcode
ZCTA5 32502,12,3483,52737,1026,168600,2725,970,2536,281,605,833,429,388,1922,1555,367,1555,795,760,2020-01-01,zipcode
ZCTA5 32509,12,642,-666666666,-666666666,-666666666,642,642,642,79,223,255,12,73,0,0,0,0,0,0,2020-01-01,zipcode
ZCTA5 32511,12,1080,-666666666,-666666666,-666666666,1080,51,142,0,11,83,48,0,0,0,0,0,0,0,2020-01-01,zipcode
ZCTA5 32530,12,39,-666666666,-666666666,-666666666,14,0,14,0,0,14,0,0,4,4,0,4,4,0,2020-01-01,zipcode
ZCTA5 32550,12,8310,70842,1609,400800,7260,3500,6422,138,980,1875,2094,1335,13901,3915,9986,3915,2763,1152,2020-01-01,zipcode
ZCTA5 32563,12,27807,79157,1354,261600,22599,8841,19812,795,4713,6967,4569,2768,11592,10520,1072,10520,8216,2304,2020-01-01,zipcode
ZCTA5 32612,12,6517,2499,-666666666,-666666666,6517,5066,30,0,4,15,1,10,26,26,0,26,0,26,2020-01-01,zipcode
ZCTA5 32631,12,298,59013,-666666666,262200,285,141,285,0,72,97,106,10,169,169,0,169,169,0,2020-01-01,zipcode
ZCTA5 32814,12,8405,98750,1881,525600,6623,1421,5895,170,497,618,2290,2320,4118,3417,701,3417,1414,2003,2020-01-01,zipcode
ZCTA5 32830,12,0,-666666666,-666666666,-666666666,0,0,0,0,0,0,0,0,0,0,0,0,0,0,2020-01-01,zipcode
ZCTA5 32405,12,31875,58520,1109,185300,25449,9458,22231,1457,6318,8130,3882,2444,14893,13232,1661,13232,8132,5100,2020-01-01,zipcode
ZCTA5 32131,12,4558,50000,840,165800,3940,1937,3693,740,1307,927,454,265,2215,1832,383,1832,1387,445,2020-01-01,zipcode
ZCTA5 32822,12,64013,43930,1247,154600,52254,18774,45108,5377,15282,13920,7308,3221,26002,22655,3347,22655,9272,13383,2020-01-01,zipcode
ZCTA5 32909,12,31734,53651,1129,186000,24586,9344,21449,2211,6598,8139,2940,1561,11908,10655,1253,10655,8987,1668,2020-01-01,zipcode
ZCTA5 32616,12,1198,-666666666,927,96200,804,285,684,133,228,232,47,44,364,352,12,352,168,184,2020-01-01,zipcode
ZCTA5 32750,12,25639,75089,1314,258900,21113,6737,18873,1065,5040,6253,4410,2105,10178,9469,709,9469,6778,2691,2020-01-01,zipcode
ZCTA5 32828,12,69913,80746,1581,305600,54565,17124,44627,3857,7600,11353,14429,7388,24636,23465,1171,23465,14616,8849,2020-01-01,zipcode
ZCTA5 32641,12,16258,36126,885,103400,12251,5610,10670,1766,3905,3381,1134,484,6087,5130,957,5130,2854,2276,2020-01-01,zipcode
ZCTA5 32464,12,3640,47536,-666666666,83800,3056,1490,2750,521,959,770,360,140,2080,1609,471,1609,1430,179,2020-01-01,zipcode
ZCTA5 32667,12,4135,64683,855,256500,3530,1613,2980,186,560,961,571,702,2050,1728,322,1728,1360,368,2020-01-01,zipcode
ZCTA5 32765,12,63800,84643,1579,302300,51070,16726,40588,1238,5932,12191,13623,7604,23230,21663,1567,21663,15579,6084,2020-01-01,zipcode
ZCTA5 32824,12,51946,64216,1518,246600,40083,12027,34923,4025,10020,11847,5922,3109,18067,13767,4300,13767,10106,3661,2020-01-01,zipcode
ZCTA5 32962,12,25229,52537,995,157600,21173,9539,18532,2920,5149,6810,2739,914,12658,8723,3935,8723,7273,1450,2020-01-01,zipcode
ZCTA5 32356,12,0,-666666666,-666666666,-666666666,0,0,0,0,0,0,0,0,21,0,21,0,0,0,2020-01-01,zipcode
ZCTA5 32266,12,7214,95819,1262,427800,6105,1644,5345,155,588,1330,2111,1161,3595,3143,452,3143,2267,876,2020-01-01,zipcode
ZCTA5 32065,12,37905,74406,1201,202800,29713,10117,25252,1555,6290,10398,4790,2219,13226,12482,744,12482,9773,2709,2020-01-01,zipcode
ZCTA5 34101,12,0,-666666666,-666666666,-666666666,0,0,0,0,0,0,0,0,0,0,0,0,0,0,2020-01-01,zipcode
ZCTA5 34140,12,217,-666666666,-666666666,-666666666,155,116,131,0,39,61,31,0,321,70,251,70,31,39,2020-01-01,zipcode
ZCTA5 34211,12,10897,127000,1700,428600,9192,4607,8306,178,1405,2931,2187,1605,5740,3972,1768,3972,3569,403,2020-01-01,zipcode
ZCTA5 34212,12,22119,92847,1622,362200,17797,7644,15840,606,2726,5526,4164,2818,9409,7735,1674,7735,6302,1433,2020-01-01,zipcode
ZCTA5 34269,12,5272,45015,757,141400,4678,3125,4425,480,1774,1148,756,267,2957,2195,762,2195,1916,279,2020-01-01,zipcode
ZCTA5 34288,12,11973,60990,1258,217700,9861,3999,8073,608,2078,3221,1380,786,4892,4560,332,4560,3830,730,2020-01-01,zipcode
ZCTA5 34289,12,4097,100181,1259,260800,3480,1262,2692,54,910,983,250,495,1662,1238,424,1238,732,506,2020-01-01,zipcode
ZCTA5 34291,12,6165,55615,1379,227500,4838,2045,4646,270,2165,1605,397,209,2332,2332,0,2332,1939,393,2020-01-01,zipcode
ZCTA5 34445,12,0,-666666666,-666666666,-666666666,0,0,0,0,0,0,0,0,0,0,0,0,0,0,2020-01-01,zipcode
ZCTA5 33706,12,16404,76277,1176,445300,15536,8283,14820,598,2420,4936,4180,2686,14037,8805,5232,8805,6601,2204,2020-01-01,zipcode
ZCTA5 33713,12,32084,58830,1038,182100,27224,8821,24478,2508,6223,8347,5133,2267,15629,13782,1847,13782,9789,3993,2020-01-01,zipcode
ZCTA5 33715,12,8010,93877,2309,383000,7102,4132,6760,75,839,1895,1903,2048,7045,3794,3251,3794,3402,392,2020-01-01,zipcode
ZCTA5 33756,12,32554,45521,1027,212900,27193,11505,24481,2661,7069,7537,4921,2293,15450,13230,2220,13230,7714,5516,2020-01-01,zipcode
ZCTA5 33764,12,27273,53416,1297,222500,23575,9580,21190,1564,6754,7104,3808,1960,14822,11852,2970,11852,8328,3524,2020-01-01,zipcode
ZCTA5 33785,12,5501,73786,1240,477900,5188,2399,4923,154,771,1641,1511,846,6160,2874,3286,2874,2125,749,2020-01-01,zipcode
ZCTA5 33801,12,34406,37848,881,90000,27822,14140,20828,4233,7794,6004,1825,972,14781,11736,3045,11736,5884,5852,2020-01-01,zipcode
ZCTA5 33809,12,30646,54919,1140,171900,25551,10571,22387,2381,6933,7865,3212,1996,12623,11094,1529,11094,7405,3689,2020-01-01,zipcode
ZCTA5 33825,12,28151,40034,744,107800,22866,12741,19281,3743,7169,5903,1544,922,11864,9629,2235,9629,6825,2804,2020-01-01,zipcode
ZCTA5 33194,12,8757,106402,1946,372300,7297,3483,6499,1109,1471,1603,1548,768,1712,1712,0,1712,1286,426,2020-01-01,zipcode
ZCTA5 33305,12,12976,72451,1394,418700,11900,4197,11408,476,1903,3088,3554,2387,8090,6815,1275,6815,4411,2404,2020-01-01,zipcode
ZCTA5 33827,12,3022,63325,1304,157100,2503,1339,1903,210,576,712,257,148,1259,955,304,955,865,90,2020-01-01,zipcode
ZCTA5 33850,12,8608,41895,907,117800,7059,3349,6117,1058,2164,1943,486,466,4508,3440,1068,3440,2354,1086,2020-01-01,zipcode
ZCTA5 33872,12,15740,52003,898,118900,13919,8864,12906,968,3652,4944,2161,1181,9224,7062,2162,7062,5955,1107,2020-01-01,zipcode
ZCTA5 33877,12,529,-666666666,-666666666,-666666666,377,254,178,57,87,34,0,0,119,87,32,87,35,52,2020-01-01,zipcode
ZCTA5 33133,12,35445,74398,1577,695500,28415,9349,26574,1784,5738,4887,7593,6572,16986,14081,2905,14081,7222,6859,2020-01-01,zipcode
ZCTA5 33135,12,36678,30112,1065,312700,31498,12539,28033,7931,9660,5179,3640,1623,15333,14278,1055,14278,3013,11265,2020-01-01,zipcode
ZCTA5 33138,12,29163,50863,1125,444500,23726,7856,20862,2811,4699,5185,4341,3826,13782,12053,1729,12053,5733,6320,2020-01-01,zipcode
ZCTA5 33140,12,21248,87384,1643,667500,17253,5944,15866,1490,1861,3406,4532,4577,17478,9002,8476,9002,5125,3877,2020-01-01,zipcode
ZCTA5 33157,12,67268,68832,1245,340400,53200,18780,45342,5798,13036,11391,10210,4907,20553,19184,1369,19184,12910,6274,2020-01-01,zipcode
ZCTA5 33020,12,44655,48504,1159,233600,37803,10725,32985,4817,9824,9825,5561,2958,21844,18655,3189,18655,6320,12335,2020-01-01,zipcode
ZCTA5 33024,12,75701,61959,1426,271000,59566,17716,50895,5704,15763,16470,9387,3571,25530,23519,2011,23519,15339,8180,2020-01-01,zipcode
ZCTA5 33036,12,3264,75439,1427,810500,2897,1289,2692,44,794,739,644,471,3688,1592,2096,1592,1286,306,2020-01-01,zipcode
ZCTA5 33040,12,34401,73982,1814,630400,29369,8595,26047,2470,7388,7384,5597,3208,18304,14487,3817,14487,6452,8035,2020-01-01,zipcode
ZCTA5 33122,12,432,94318,2220,-666666666,358,153,296,104,11,28,104,49,166,166,0,166,0,166,2020-01-01,zipcode
ZCTA5 33128,12,8729,21332,957,230800,7311,2843,6668,2514,2199,1030,683,242,3734,3461,273,3461,157,3304,2020-01-01,zipcode
ZCTA5 33143,12,32055,69992,1459,575200,26840,9352,23716,1130,3831,5436,7708,5611,14240,12855,1385,12855,7297,5558,2020-01-01,zipcode
ZCTA5 33162,12,47855,45996,1191,230800,36996,12702,31064,6475,9626,8685,4408,1870,15089,13541,1548,13541,7231,6310,2020-01-01,zipcode
ZCTA5 33179,12,46620,47974,1315,179100,38660,13031,33770,3832,9821,10683,5408,4026,19000,16919,2081,16919,9649,7270,2020-01-01,zipcode
ZCTA5 33186,12,69459,72109,1768,321000,55641,19924,48060,4204,11371,16243,10674,5568,22749,21711,1038,21711,14598,7113,2020-01-01,zipcode
ZCTA5 33196,12,55829,80915,1847,355900,44397,15770,37696,4107,8104,10849,10390,4246,15961,15370,591,15370,10490,4880,2020-01-01,zipcode
ZCTA5 33301,12,15250,101321,2000,530400,14233,4567,12990,429,1454,3112,4777,3218,11388,8380,3008,8380,3581,4799,2020-01-01,zipcode
ZCTA5 33304,12,17630,60665,1327,434500,15462,4782,14093,952,2435,3819,4277,2610,12087,8980,3107,8980,3435,5545,2020-01-01,zipcode
ZCTA5 33401,12,30315,48958,1432,275400,26033,9616,21298,2617,4597,6013,4756,3315,16753,12537,4216,12537,4515,8022,2020-01-01,zipcode
ZCTA5 33407,12,31124,44042,1221,201300,25240,9116,21995,4320,6509,5694,3388,2084,13636,11084,2552,11084,5094,5990,2020-01-01,zipcode
ZCTA5 33410,12,35410,76488,1696,354200,29986,11020,26814,1324,5828,8060,7683,3919,16958,14701,2257,14701,10519,4182,2020-01-01,zipcode
ZCTA5 33442,12,28934,47437,1674,143800,24811,11645,23092,1925,6423,7546,4897,2301,19344,13835,5509,13835,9051,4784,2020-01-01,zipcode
ZCTA5 33461,12,46574,48806,1260,172100,37330,12072,31710,7608,10566,8045,3459,2032,17229,14629,2600,14629,7058,7571,2020-01-01,zipcode
ZCTA5 33019,12,14307,76793,1620,486100,12572,5078,11370,408,1645,3668,2865,2784,12202,6444,5758,6444,4765,1679,2020-01-01,zipcode
ZCTA5 33029,12,45142,112537,2508,422900,34975,10619,29073,1330,6738,8719,7624,4662,13601,12870,731,12870,11297,1573,2020-01-01,zipcode
ZCTA5 33042,12,6512,91352,1896,498200,5826,2281,5463,145,1249,1644,1563,862,4850,2971,1879,2971,2285,686,2020-01-01,zipcode
ZCTA5 33065,12,58637,57287,1438,291300,44646,12827,37714,3362,9962,13206,7590,3594,20097,18697,1400,18697,9750,8947,2020-01-01,zipcode
ZCTA5 33458,12,59098,85862,1661,381400,47625,14769,41498,3113,7579,11421,11727,7658,24039,21850,2189,21850,16052,5798,2020-01-01,zipcode
ZCTA5 33486,12,23729,91883,1678,468500,19016,7332,16654,600,2912,4545,5511,3086,10579,9253,1326,9253,6913,2340,2020-01-01,zipcode
ZCTA5 33498,12,16280,106606,2767,432900,13087,5460,11375,449,1353,2947,3827,2799,5725,5555,170,5555,5098,457,2020-01-01,zipcode
ZCTA5 33956,12,3510,53839,1260,235000,3474,2209,3280,200,1162,1102,322,494,3418,1737,1681,1737,1659,78,2020-01-01,zipcode
ZCTA5 33972,12,15656,64604,1210,190100,12217,4722,10221,1324,4340,3080,1127,350,5149,4423,726,4423,3247,1176,2020-01-01,zipcode
ZCTA5 33983,12,15161,61858,1047,250200,13162,7145,12053,815,3899,4162,2087,1090,8024,6232,1792,6232,5315,917,2020-01-01,zipcode
ZCTA5 33169,12,40221,46656,1227,236200,31236,11304,26662,4765,8752,7546,3975,1624,13240,11984,1256,11984,6344,5640,2020-01-01,zipcode
ZCTA5 33309,12,39928,59045,1371,212700,31856,8802,28064,3949,9178,7749,4503,2685,14594,13517,1077,13517,8221,5296,2020-01-01,zipcode
ZCTA5 33319,12,49218,46312,1305,160700,39794,14116,35284,4908,10901,10494,6017,2964,23988,19166,4822,19166,12353,6813,2020-01-01,zipcode
ZCTA5 33321,12,48061,52263,1511,189900,41184,17221,37217,4170,10685,12282,6271,3809,22195,19943,2252,19943,14837,5106,2020-01-01,zipcode
ZCTA5 33403,12,12458,53410,1195,228600,10159,3493,8676,1403,2477,2493,1514,789,5152,4345,807,4345,2051,2294,2020-01-01,zipcode
ZCTA5 33404,12,29357,46436,1197,186100,23375,9435,20398,2767,7197,5728,2996,1710,15323,10437,4886,10437,5731,4706,2020-01-01,zipcode
ZCTA5 33418,12,41737,100590,1896,425600,35301,15658,32746,1325,4819,8656,10501,7445,21246,17185,4061,17185,13598,3587,2020-01-01,zipcode
ZCTA5 33435,12,36406,52785,1546,204300,31234,11540,27472,4169,7728,8294,4931,2350,19086,13961,5125,13961,8246,5715,2020-01-01,zipcode
ZCTA5 33440,12,21254,39792,831,96300,16577,5834,14193,4060,4899,4064,917,253,8180,6967,1213,6967,4893,2074,2020-01-01,zipcode
ZCTA5 33455,12,22031,59724,1056,276800,19275,9895,18055,1447,4991,5575,3902,2140,11988,9574,2414,9574,8104,1470,2020-01-01,zipcode
ZCTA5 33476,12,8123,21986,619,112900,6124,2960,4855,1836,1440,983,530,66,2648,2366,282,2366,758,1608,2020-01-01,zipcode
ZCTA5 33477,12,12875,89717,1814,428600,12355,7251,11921,350,2071,2733,3707,3060,11910,7188,4722,7188,6188,1000,2020-01-01,zipcode
ZCTA5 33478,12,14745,121275,1411,435000,12050,4214,10958,490,2434,3389,3050,1595,5320,4888,432,4888,4794,94,2020-01-01,zipcode
ZCTA5 33527,12,15593,57834,797,228000,13132,5285,10922,2463,3877,2765,1317,500,5552,5037,515,5037,3794,1243,2020-01-01,zipcode
ZCTA5 33585,12,1060,53977,850,179500,943,605,877,181,286,344,44,22,434,411,23,411,289,122,2020-01-01,zipcode
ZCTA5 33597,12,9075,49242,813,113600,7687,3641,6338,1042,2544,2061,577,114,3781,2987,794,2987,2411,576,2020-01-01,zipcode
ZCTA5 33603,12,21084,50607,1037,226700,16941,4875,15067,1922,4042,3994,3239,1870,9693,8753,940,8753,4978,3775,2020-01-01,zipcode
ZCTA5 33613,12,36388,35755,948,181000,31274,11453,21164,3459,5890,5599,4325,1891,16976,14911,2065,14911,4292,10619,2020-01-01,zipcode
ZCTA5 33621,12,2655,85000,2277,-666666666,1628,489,1030,0,221,386,175,248,612,538,74,538,0,538,2020-01-01,zipcode
ZCTA5 33626,12,29337,113550,1590,370600,22634,7193,20098,854,2734,4188,7974,4348,11991,11059,932,11059,7674,3385,2020-01-01,zipcode
ZCTA5 33782,12,23671,57150,1306,173700,19615,8414,18092,1928,5708,5540,3153,1763,10427,9273,1154,9273,6730,2543,2020-01-01,zipcode
ZCTA5 33803,12,29875,54263,1088,170900,24405,10064,21507,1745,6105,6500,4382,2775,14795,11867,2928,11867,7239,4628,2020-01-01,zipcode
ZCTA5 33805,12,26189,37952,996,107800,20740,9609,17977,3569,6573,5097,1952,786,10782,9236,1546,9236,4262,4974,2020-01-01,zipcode
ZCTA5 33907,12,25813,45066,1173,170600,21858,8164,19556,2397,6381,5819,3155,1804,13172,10115,3057,10115,4271,5844,2020-01-01,zipcode
ZCTA5 33912,12,20037,86531,1428,283900,17967,9756,16499,594,3432,4831,4631,3011,11619,8628,2991,8628,7378,1250,2020-01-01,zipcode
ZCTA5 33920,12,6709,78654,920,272100,5526,2378,4982,495,1294,1945,744,504,2684,2288,396,2288,2103,185,2020-01-01,zipcode
ZCTA5 33928,12,26303,84092,1696,322000,23145,13441,22125,1034,4573,6384,5981,4153,17889,11815,6074,11815,10140,1675,2020-01-01,zipcode
ZCTA5 33936,12,26157,40129,996,142900,21476,9423,18250,4104,6734,4943,1733,736,9684,8319,1365,8319,5389,2930,2020-01-01,zipcode
ZCTA5 33957,12,7378,92875,1100,703800,6965,4437,6785,136,1437,1410,1934,1868,9057,3919,5138,3919,3359,560,2020-01-01,zipcode
ZCTA5 33982,12,11553,46756,930,140300,10304,6471,9667,1551,3478,3047,888,703,5157,4187,970,4187,3578,609,2020-01-01,zipcode
ZCTA5 33598,12,22776,66709,835,251500,16955,7474,14684,3625,4744,3051,1857,1407,7511,6726,785,6726,5573,1153,2020-01-01,zipcode
ZCTA5 33480,12,10631,141328,1702,903600,10071,6449,9956,248,842,2376,3400,3090,11821,6065,5756,6065,5071,994,2020-01-01,zipcode
ZCTA5 33576,12,4512,62000,1021,216600,4183,2795,3943,188,1106,1452,601,596,2447,2212,235,2212,2009,203,2020-01-01,zipcode
ZCTA5 33612,12,51347,35746,991,160800,40406,16705,32871,6909,11357,8298,4665,1642,21022,19021,2001,19021,6608,12413,2020-01-01,zipcode
ZCTA5 33614,12,49652,43951,1041,189000,41379,12802,35898,7611,12782,8076,5510,1919,19463,18229,1234,18229,7194,11035,2020-01-01,zipcode
ZCTA5 33615,12,49048,53516,1207,195900,40243,11858,35510,4313,12023,9768,6495,2911,20057,18028,2029,18028,9644,8384,2020-01-01,zipcode
ZCTA5 33620,12,5286,-666666666,-666666666,-666666666,5286,4007,36,11,0,15,10,0,23,11,12,11,0,11,2020-01-01,zipcode
ZCTA5 33709,12,23690,45276,1064,138500,20721,9376,18692,2414,6849,5657,2675,1097,13986,10305,3681,10305,7620,2685,2020-01-01,zipcode
ZCTA5 33714,12,21049,36130,1059,113900,17477,6764,15614,2791,5680,5062,1676,405,9760,7926,1834,7926,5047,2879,2020-01-01,zipcode
ZCTA5 34604,12,13026,69974,889,184200,11057,5375,9779,1262,3598,3226,1043,650,4746,4311,435,4311,3736,575,2020-01-01,zipcode
ZCTA5 34637,12,8411,88574,1403,255200,6489,3536,5794,555,1218,1642,1310,1069,2931,2521,410,2521,2219,302,2020-01-01,zipcode
ZCTA5 33181,12,20242,47009,1260,263100,16307,5348,13601,1572,3501,3886,2589,2053,9170,7768,1402,7768,3148,4620,2020-01-01,zipcode
ZCTA5 33184,12,21472,60146,1653,273100,18786,7157,16809,4798,4517,2625,3615,1254,6442,6126,316,6126,4600,1526,2020-01-01,zipcode
ZCTA5 33308,12,27226,73818,1502,440400,24930,11281,23500,1206,4227,5880,6797,5390,22846,14957,7889,14957,10366,4591,2020-01-01,zipcode
ZCTA5 33314,12,27895,55562,1608,199100,22683,7531,18566,2924,5711,4748,3752,1431,10222,9195,1027,9195,3596,5599,2020-01-01,zipcode
ZCTA5 33317,12,38256,72163,1463,323700,30437,9339,26807,3169,6622,7305,6329,3382,13220,12453,767,12453,9594,2859,2020-01-01,zipcode
ZCTA5 33322,12,40832,46994,1778,165500,35446,15490,32577,3047,9023,10484,6393,3630,20574,17901,2673,17901,15079,2822,2020-01-01,zipcode
ZCTA5 33325,12,30985,85789,1671,315600,24847,6730,20900,1915,4925,6217,5373,2470,10808,9933,875,9933,7601,2332,2020-01-01,zipcode
ZCTA5 33430,12,23428,29682,631,114200,17311,8377,14545,5533,4856,2790,1088,278,8263,7219,1044,7219,2450,4769,2020-01-01,zipcode
ZCTA5 33434,12,20685,62047,1203,260300,18412,11142,17476,1232,3159,4169,4791,4125,13411,10008,3403,10008,8096,1912,2020-01-01,zipcode
ZCTA5 33467,12,55279,70917,1373,308800,46042,20182,40633,3193,9944,11655,9741,6100,23907,20539,3368,20539,17613,2926,2020-01-01,zipcode
ZCTA5 33496,12,23442,93561,1910,391400,20027,10649,18574,666,2624,4167,6610,4507,11623,9994,1629,9994,8480,1514,2020-01-01,zipcode
ZCTA5 33510,12,29831,62259,1182,193400,24491,8749,21414,1647,7056,6835,4467,1409,11671,10857,814,10857,6716,4141,2020-01-01,zipcode
ZCTA5 33541,12,22432,41521,1091,76500,19591,12702,18167,2784,6732,6139,1682,830,13354,9813,3541,9813,8019,1794,2020-01-01,zipcode
ZCTA5 33572,12,21889,97058,1579,290000,17585,5968,15930,680,3322,4898,4308,2722,8993,8239,754,8239,6831,1408,2020-01-01,zipcode
ZCTA5 33607,12,25018,46587,1374,190200,21614,7233,19130,3248,5760,4179,4046,1897,12847,10932,1915,10932,4519,6413,2020-01-01,zipcode
ZCTA5 33609,12,18972,85174,1278,382500,15795,4099,14010,1035,1630,3175,4517,3653,9307,8497,810,8497,5134,3363,2020-01-01,zipcode
ZCTA5 33617,12,48456,39830,1029,192500,38524,12807,31293,4026,9454,9084,5496,3233,20942,19281,1661,19281,7601,11680,2020-01-01,zipcode
ZCTA5 33647,12,74066,89270,1435,309100,57073,16736,48174,2294,6905,11156,16044,11775,27179,25565,1614,25565,14396,11169,2020-01-01,zipcode
ZCTA5 33702,12,32968,54196,1091,195200,28051,10314,25122,2291,6676,7798,5916,2441,16476,14139,2337,14139,9392,4747,2020-01-01,zipcode
ZCTA5 33705,12,28013,56914,1126,196700,24141,9650,21125,2155,5676,6848,4246,2200,14860,11210,3650,11210,6537,4673,2020-01-01,zipcode
ZCTA5 33707,12,25148,51861,1097,236400,23266,11709,21807,1349,5673,6842,5133,2810,16343,12512,3831,12512,8470,4042,2020-01-01,zipcode
ZCTA5 33711,12,19291,52902,1200,177400,15814,7250,12488,1041,4271,3864,2021,1291,9167,6410,2757,6410,3898,2512,2020-01-01,zipcode
ZCTA5 33009,12,42070,39834,1280,223900,35642,13961,32105,4402,8552,8292,6096,4763,29273,18988,10285,18988,10265,8723,2020-01-01,zipcode
ZCTA5 33012,12,74603,34175,1223,253000,65080,28625,57865,17928,18506,12115,6557,2759,26292,25596,696,25596,12510,13086,2020-01-01,zipcode
ZCTA5 33018,12,53575,70226,1678,298200,44269,13199,38511,7205,12263,9287,6748,3008,15974,15539,435,15539,11640,3899,2020-01-01,zipcode
ZCTA5 33312,12,55149,59810,1334,276100,44050,15690,38116,5698,10547,11121,6905,3845,20755,18201,2554,18201,10854,7347,2020-01-01,zipcode
ZCTA5 33331,12,25829,126104,2353,517800,20549,7073,17006,809,1791,4575,6016,3815,7680,7357,323,7357,6170,1187,2020-01-01,zipcode
ZCTA5 33324,12,49350,69996,1713,256700,41312,12643,36703,2453,6394,11654,9768,6434,21934,19331,2603,19331,11006,8325,2020-01-01,zipcode
ZCTA5 33327,12,24221,131908,2647,580000,16784,5955,14176,271,1830,2368,5104,4603,6812,6681,131,6681,5139,1542,2020-01-01,zipcode
ZCTA5 33328,12,29355,101007,1694,388800,23839,7502,19761,1172,3948,5747,5600,3294,10817,10179,638,10179,8005,2174,2020-01-01,zipcode
ZCTA5 33408,12,18251,73427,1532,378900,16620,8222,15596,526,3509,3743,4940,2878,13184,9380,3804,9380,7330,2050,2020-01-01,zipcode
ZCTA5 33412,12,15012,91875,1777,393500,12658,5132,11248,486,2968,3281,2735,1778,6246,5227,1019,5227,4293,934,2020-01-01,zipcode
ZCTA5 33414,12,60452,86716,1890,388500,46742,15161,40542,2421,8342,12908,10621,6250,22797,19720,3077,19720,14434,5286,2020-01-01,zipcode
ZCTA5 33417,12,34044,39498,1188,101500,28824,11187,25818,4060,8173,7267,4839,1479,19563,15284,4279,15284,8902,6382,2020-01-01,zipcode
ZCTA5 33433,12,40655,58788,1902,308300,34342,16653,30925,1166,5839,7552,9615,6753,23303,18917,4386,18917,13350,5567,2020-01-01,zipcode
ZCTA5 33436,12,46812,61388,1493,258000,38960,15204,35374,3153,8742,11585,7492,4402,22947,18492,4455,18492,13540,4952,2020-01-01,zipcode
ZCTA5 33444,12,24970,62621,1378,316900,20978,6684,18364,3399,4980,5139,3245,1601,9799,8807,992,8807,4689,4118,2020-01-01,zipcode
ZCTA5 33445,12,31025,55945,1662,216600,27384,11182,24447,1830,5921,6482,6498,3716,17365,13922,3443,13922,9383,4539,2020-01-01,zipcode
ZCTA5 33462,12,34068,55285,1292,237500,28962,9600,25822,4191,7687,6845,4790,2309,15943,12838,3105,12838,7994,4844,2020-01-01,zipcode
ZCTA5 33463,12,64116,55713,1379,231000,49759,15190,42046,8698,12233,11266,6652,3197,21537,18935,2602,18935,13236,5699,2020-01-01,zipcode
ZCTA5 33483,12,13233,100500,1894,634300,12183,5376,11401,592,1693,2506,4038,2572,9474,6476,2998,6476,4400,2076,2020-01-01,zipcode
ZCTA5 33487,12,20794,76073,1883,415500,18223,8599,16382,459,2255,4054,5723,3891,12681,9538,3143,9538,7208,2330,2020-01-01,zipcode
ZCTA5 33493,12,6681,39432,929,91700,5988,4715,5497,2359,1955,842,280,61,963,795,168,795,435,360,2020-01-01,zipcode
ZCTA5 33521,12,719,33438,706,98500,586,276,536,87,285,131,28,5,370,240,130,240,167,73,2020-01-01,zipcode
ZCTA5 33525,12,20337,56706,846,166100,16664,8379,13490,1569,4679,4188,2095,959,8282,6875,1407,6875,5003,1872,2020-01-01,zipcode
ZCTA5 33544,12,28417,86707,1545,271600,21688,6218,19058,1632,4038,5154,5143,3091,10320,9689,631,9689,6790,2899,2020-01-01,zipcode
ZCTA5 33514,12,2954,41654,825,109700,2215,1010,1940,360,767,578,149,86,1037,808,229,808,514,294,2020-01-01,zipcode
ZCTA5 33523,12,18834,51028,824,153300,15631,6262,12941,2245,5062,3345,1555,734,7870,6460,1410,6460,4632,1828,2020-01-01,zipcode
ZCTA5 33543,12,27933,84375,1534,237000,21939,8108,19088,1032,3534,6062,5018,3442,10816,9822,994,9822,8273,1549,2020-01-01,zipcode
ZCTA5 33566,12,21920,65531,1131,225700,17138,6207,14853,2339,5692,3332,2308,1182,7647,7342,305,7342,5310,2032,2020-01-01,zipcode
ZCTA5 33592,12,11706,45064,861,146500,9739,4576,8442,1599,3034,1989,1094,726,4623,3963,660,3963,2612,1351,2020-01-01,zipcode
ZCTA5 33605,12,17945,23632,967,134100,14235,5910,12438,3021,4551,2980,1377,509,8938,7585,1353,7585,2755,4830,2020-01-01,zipcode
ZCTA5 33610,12,48490,38733,1060,136800,35576,13871,30075,5376,11365,8682,3233,1419,18262,16771,1491,16771,7756,9015,2020-01-01,zipcode
ZCTA5 33611,12,34615,66495,1226,298700,28733,9180,26598,1445,5412,6138,8381,5222,17800,16269,1531,16269,9213,7056,2020-01-01,zipcode
ZCTA5 33625,12,28619,62539,1426,262300,24141,8565,20715,1414,5675,6249,4501,2876,11871,11232,639,11232,7673,3559,2020-01-01,zipcode
ZCTA5 33511,12,59776,61149,1319,216600,48621,17022,41862,3891,9994,13604,10425,3948,24080,22334,1746,22334,11998,10336,2020-01-01,zipcode
ZCTA5 33534,12,16608,66295,1009,203600,11816,3533,10051,1920,3552,2744,1275,560,5575,5058,517,5058,3603,1455,2020-01-01,zipcode
ZCTA5 33815,12,15265,32708,844,22700,11851,5850,9743,1985,4112,2732,664,250,7438,5693,1745,5693,3269,2424,2020-01-01,zipcode
ZCTA5 33839,12,3565,57204,870,130100,2717,954,2379,545,850,634,279,71,1303,1063,240,1063,765,298,2020-01-01,zipcode
ZCTA5 33848,12,908,59293,917,58500,806,376,625,235,227,123,0,40,442,172,270,172,119,53,2020-01-01,zipcode
ZCTA5 33851,12,1245,50000,947,161800,1020,515,885,139,394,218,126,8,428,342,86,342,305,37,2020-01-01,zipcode
ZCTA5 33865,12,1130,57813,-666666666,-666666666,980,474,902,222,373,180,109,18,303,274,29,274,212,62,2020-01-01,zipcode
ZCTA5 33880,12,42268,44615,893,130700,32961,13478,28567,6590,10738,7917,2192,1130,16373,13688,2685,13688,9127,4561,2020-01-01,zipcode
ZCTA5 33881,12,33577,44281,909,95000,27448,14487,24262,3592,8297,8275,2610,1488,15526,12482,3044,12482,8749,3733,2020-01-01,zipcode
ZCTA5 33905,12,38304,56025,1170,168900,31284,13794,27202,5583,9293,6928,3302,2096,15489,12616,2873,12616,8458,4158,2020-01-01,zipcode
ZCTA5 33909,12,32183,57302,1368,191900,25621,9567,22329,1676,9786,6599,2988,1280,12009,10678,1331,10678,6892,3786,2020-01-01,zipcode
ZCTA5 33914,12,40422,66185,1235,289500,36743,16423,33552,1990,11949,11123,4927,3563,21073,16168,4905,16168,12765,3403,2020-01-01,zipcode
ZCTA5 33930,12,631,-666666666,-666666666,111800,422,93,352,58,184,70,0,40,362,288,74,288,233,55,2020-01-01,zipcode
ZCTA5 33955,12,10645,66239,1134,250000,9795,5970,9130,1122,2608,2675,1738,987,6628,4562,2066,4562,4163,399,2020-01-01,zipcode
ZCTA5 33770,12,26979,47908,1092,168500,23172,9278,20430,2375,6803,6696,2875,1681,13710,11561,2149,11561,6987,4574,2020-01-01,zipcode
ZCTA5 33772,12,23413,60843,1152,224100,19905,8114,17673,1427,4815,6176,3697,1558,11828,9801,2027,9801,7225,2576,2020-01-01,zipcode
ZCTA5 33028,12,27314,101439,2185,412700,21676,5910,18386,1005,3627,4652,5457,3645,8977,8407,570,8407,6436,1971,2020-01-01,zipcode
ZCTA5 33037,12,10541,68164,1691,490700,9361,4019,8832,797,2401,2545,1707,1382,10335,4758,5577,4758,3575,1183,2020-01-01,zipcode
ZCTA5 33054,12,32735,31508,990,189300,25651,11522,20955,5972,8396,4861,1409,317,10143,9518,625,9518,4415,5103,2020-01-01,zipcode
ZCTA5 33060,12,38637,47957,1171,245200,30986,11975,27109,5505,8422,7384,3765,2033,15232,13531,1701,13531,6883,6648,2020-01-01,zipcode
ZCTA5 33062,12,23303,68526,1438,375200,21957,10594,20967,1234,4742,5866,4875,4250,21662,12839,8823,12839,8798,4041,2020-01-01,zipcode
ZCTA5 34949,12,7740,69954,1322,311600,7516,4736,7382,324,1518,2175,1925,1440,8142,4333,3809,4333,3423,910,2020-01-01,zipcode
ZCTA5 34105,12,16185,90011,1658,486900,14345,6984,13261,597,2571,3578,4084,2431,10819,7233,3586,7233,4519,2714,2020-01-01,zipcode
ZCTA5 34135,12,49455,68440,1319,287800,43679,22377,40012,5638,9390,11331,8146,5507,29533,20275,9258,20275,16174,4101,2020-01-01,zipcode
ZCTA5 34137,12,339,-666666666,-666666666,-666666666,150,60,150,0,110,40,0,0,93,93,0,93,66,27,2020-01-01,zipcode
ZCTA5 34145,12,17963,84288,1507,669200,16828,10859,16316,1072,3446,4493,4566,2739,18630,9056,9574,9056,8042,1014,2020-01-01,zipcode
ZCTA5 34207,12,36677,39549,1006,94900,30922,14345,27062,4765,10554,7506,2800,1437,19125,14983,4142,14983,9014,5969,2020-01-01,zipcode
ZCTA5 34741,12,48520,39182,1177,187800,37225,13284,32074,5260,9417,11150,4408,1839,20834,16278,4556,16278,5360,10918,2020-01-01,zipcode
ZCTA5 34748,12,39265,44876,940,162000,34186,21126,31493,3253,11773,10344,3828,2295,21534,17561,3973,17561,12524,5037,2020-01-01,zipcode
ZCTA5 34759,12,38406,49691,1346,203200,30513,16033,26053,4830,6749,7597,4285,2592,15625,12142,3483,12142,9146,2996,2020-01-01,zipcode
ZCTA5 34771,12,21715,77963,1210,318800,17348,7072,14764,1273,4300,4880,3093,1218,8051,6618,1433,6618,5753,865,2020-01-01,zipcode
ZCTA5 34984,12,17072,69143,1557,222200,13888,5363,12324,1674,3410,4869,1635,736,6595,5822,773,5822,4758,1064,2020-01-01,zipcode
ZCTA5 34134,12,15208,100052,1396,519000,14526,9969,14132,294,2275,3986,3816,3761,14203,7772,6431,7772,6543,1229,2020-01-01,zipcode
ZCTA5 34237,12,19169,51502,1203,174000,16077,5874,14135,1972,5001,4088,2063,1011,8619,7283,1336,7283,3573,3710,2020-01-01,zipcode
ZCTA5 34103,12,12848,102632,1482,781400,11797,6456,10750,393,2152,2615,3245,2345,10814,5828,4986,5828,4754,1074,2020-01-01,zipcode
ZCTA5 34110,12,24713,69858,1641,400000,22124,12879,20523,826,4153,5403,5731,4410,16919,11904,5015,11904,8909,2995,2020-01-01,zipcode
ZCTA5 34120,12,34431,67448,1666,317800,28328,9409,25067,3001,8704,6309,3853,3200,14684,11617,3067,11617,10140,1477,2020-01-01,zipcode
ZCTA5 34201,12,3729,96824,1920,448400,3372,2195,3124,176,431,678,808,1031,2282,1666,616,1666,1551,115,2020-01-01,zipcode
ZCTA5 34203,12,39350,52186,1107,210100,33242,15381,30513,4429,10838,7931,4328,2987,19238,15615,3623,15615,11709,3906,2020-01-01,zipcode
ZCTA5 34205,12,31871,46190,1022,163100,26381,11098,23644,3859,7848,6879,3473,1585,15981,12775,3206,12775,7518,5257,2020-01-01,zipcode
ZCTA5 34221,12,50857,57820,1175,198100,42305,20544,38014,4728,12502,11243,6257,3284,22155,17455,4700,17455,13644,3811,2020-01-01,zipcode
ZCTA5 34449,12,3650,30808,470,88200,3266,1618,3056,424,1467,870,221,74,1987,1532,455,1532,1146,386,2020-01-01,zipcode
ZCTA5 34601,12,22644,40996,839,100600,19149,10282,17109,2314,6075,5360,2359,1001,11932,10043,1889,10043,7043,3000,2020-01-01,zipcode
ZCTA5 34747,12,24445,70744,1548,334000,19547,5419,16208,581,3035,4947,4837,2808,26878,9160,17718,9160,4215,4945,2020-01-01,zipcode
ZCTA5 34788,12,19344,44703,1122,91000,17061,9044,16151,1655,6395,5050,1982,1069,10327,8422,1905,8422,7053,1369,2020-01-01,zipcode
ZCTA5 34997,12,45382,61661,1189,264900,39019,17604,35163,3313,9807,12443,6089,3511,21375,17886,3489,17886,14475,3411,2020-01-01,zipcode
ZCTA5 32607,12,30139,41656,973,222200,26039,9362,15615,690,2643,4278,3855,4149,15127,12236,2891,12236,4145,8091,2020-01-01,zipcode
ZCTA5 32622,12,1076,49444,802,135400,841,345,806,163,255,172,96,120,534,462,72,462,273,189,2020-01-01,zipcode
ZCTA5 32658,12,327,51429,-666666666,98800,283,153,252,47,105,75,25,0,112,92,20,92,77,15,2020-01-01,zipcode
ZCTA5 35184,01,4638,42642,640,82600,3824,1952,3291,662,1537,893,164,35,2310,1635,675,1635,1254,381,2020-01-01,zipcode
ZCTA5 33635,12,19590,71768,1411,216500,15803,4874,14275,940,3848,3949,3455,2083,8125,7240,885,7240,4621,2619,2020-01-01,zipcode
ZCTA5 32696,12,12783,44328,748,153600,10235,4916,9224,1287,3615,2743,1136,443,5784,5139,645,5139,4203,936,2020-01-01,zipcode
ZCTA5 32702,12,2378,49327,2693,85500,2135,1267,1866,293,626,535,285,127,1516,1099,417,1099,624,475,2020-01-01,zipcode
ZCTA5 32726,12,23354,50439,834,166400,18687,7108,16492,2157,6722,4671,2035,907,10331,9101,1230,9101,5908,3193,2020-01-01,zipcode
ZCTA5 32730,12,6656,41662,1191,192700,5680,1913,5098,341,1291,2087,1025,354,2993,2809,184,2809,1025,1784,2020-01-01,zipcode
ZCTA5 32736,12,11229,69083,977,288100,8803,3340,7710,590,2103,2792,1519,706,4077,3690,387,3690,3276,414,2020-01-01,zipcode
ZCTA5 32757,12,29295,59987,1086,236400,24502,11025,21632,1929,6528,6233,3958,2984,13619,11765,1854,11765,8450,3315,2020-01-01,zipcode
ZCTA5 32759,12,3230,48722,941,175700,2732,1515,2559,297,1084,755,288,135,1599,1226,373,1226,981,245,2020-01-01,zipcode
ZCTA5 32779,12,29618,95005,1586,352100,24334,8951,21493,419,3424,6302,6965,4383,11796,11209,587,11209,9083,2126,2020-01-01,zipcode
ZCTA5 32792,12,52670,57214,1262,247600,44261,14939,36486,2643,7330,11748,9067,5698,23766,21236,2530,21236,10105,11131,2020-01-01,zipcode
ZCTA5 32829,12,20903,76103,1568,238300,15840,4598,13886,1391,2782,4209,3633,1871,7520,6428,1092,6428,5145,1283,2020-01-01,zipcode
ZCTA5 32903,12,14693,81488,1368,356700,12008,5211,10915,385,1716,3364,3169,2281,7264,6165,1099,6165,5102,1063,2020-01-01,zipcode
ZCTA5 32904,12,33869,72981,1364,236700,27692,11191,23721,1538,5436,7995,5548,3204,14165,12791,1374,12791,10453,2338,2020-01-01,zipcode
ZCTA5 32907,12,46911,55322,1160,178200,38701,17258,33667,3880,10703,12953,3924,2207,16944,15617,1327,15617,12931,2686,2020-01-01,zipcode
ZCTA5 32966,12,19957,53750,1115,172700,17291,10310,16327,1174,4811,5581,2852,1909,11239,8559,2680,8559,6680,1879,2020-01-01,zipcode
ZCTA5 32958,12,29057,53395,1137,198600,25657,14192,23886,1903,8420,7184,3663,2716,14771,12414,2357,12414,10264,2150,2020-01-01,zipcode
ZCTA5 32960,12,22974,44648,905,173300,19438,8440,17080,1757,5416,5645,2901,1361,11729,9148,2581,9148,5540,3608,2020-01-01,zipcode
ZCTA5 32221,12,28809,66485,1301,171000,22612,8241,19320,2445,6479,6098,3176,1122,10807,10169,638,10169,7657,2512,2020-01-01,zipcode
ZCTA5 32225,12,53414,74712,1352,237400,43006,13751,37025,1869,9398,11653,9748,4357,21791,19878,1913,19878,13252,6626,2020-01-01,zipcode
ZCTA5 32234,12,6475,70420,782,119500,4996,1727,4450,680,2092,1217,327,134,2588,2382,206,2382,1889,493,2020-01-01,zipcode
ZCTA5 32244,12,61190,54770,1152,141600,47347,14622,41506,4201,13506,14760,7025,2014,24655,22539,2116,22539,12630,9909,2020-01-01,zipcode
ZCTA5 32254,12,13572,31425,889,59900,10238,4756,8908,2485,3612,2133,516,162,6067,5022,1045,5022,2511,2511,2020-01-01,zipcode
ZCTA5 32937,12,27054,76548,1316,312900,22718,9780,20226,527,4121,6315,5257,4006,12876,10881,1995,10881,8691,2190,2020-01-01,zipcode
ZCTA5 32807,12,34239,48469,1167,165600,28044,8613,24087,4575,7720,7181,3215,1396,13184,12012,1172,12012,5845,6167,2020-01-01,zipcode
ZCTA5 32920,12,10387,52948,878,265300,9836,4558,9307,491,2552,3172,1970,1122,9101,5939,3162,5939,3517,2422,2020-01-01,zipcode
ZCTA5 32925,12,1642,51513,1639,-666666666,1215,461,861,56,125,332,205,143,508,487,21,487,0,487,2020-01-01,zipcode
ZCTA5 32951,12,12150,68544,1385,364100,10923,6513,10497,393,1560,3280,3272,1992,7762,5928,1834,5928,5059,869,2020-01-01,zipcode
ZCTA5 32303,12,49073,52992,1078,157900,40291,10814,31624,1784,6128,10059,8468,5185,22864,20933,1931,20933,10716,10217,2020-01-01,zipcode
ZCTA5 32327,12,29688,70660,916,172300,24278,10194,21446,2504,7613,7272,2450,1607,11413,10018,1395,10018,8474,1544,2020-01-01,zipcode
ZCTA5 32343,12,3153,51397,939,162200,2206,441,1910,221,499,700,237,253,1275,1147,128,1147,909,238,2020-01-01,zipcode
ZCTA5 34240,12,12143,94046,2140,419200,9871,4393,8916,283,2121,2136,2408,1968,5939,4393,1546,4393,4285,108,2020-01-01,zipcode
ZCTA5 34743,12,45456,53902,1257,206600,37378,12529,31114,5261,9636,11015,3852,1350,13945,12257,1688,12257,8661,3596,2020-01-01,zipcode
ZCTA5 34760,12,805,80536,1553,259500,666,222,620,22,126,372,92,8,289,255,34,255,216,39,2020-01-01,zipcode
ZCTA5 34761,12,45749,72069,1348,256800,35257,10601,30384,5453,6985,8609,6589,2748,14826,14030,796,14030,9413,4617,2020-01-01,zipcode
ZCTA5 34950,12,17039,33839,918,96100,13582,6362,11583,3601,3703,3168,814,297,7259,5977,1282,5977,2132,3845,2020-01-01,zipcode
ZCTA5 34983,12,44005,57495,1395,195100,35912,14259,31662,3036,10950,10372,5038,2266,16077,14674,1403,14674,11659,3015,2020-01-01,zipcode
ZCTA5 34994,12,17782,52527,1187,188300,14581,7265,13545,1121,3765,4644,2597,1418,9280,7445,1835,7445,4504,2941,2020-01-01,zipcode
ZCTA5 34736,12,20564,62186,1290,225900,16594,6916,14906,2102,3934,4577,2517,1776,7916,7531,385,7531,6299,1232,2020-01-01,zipcode
ZCTA5 34108,12,17177,98681,1520,744800,16061,10046,15389,570,2757,3371,4709,3982,14657,8196,6461,8196,6818,1378,2020-01-01,zipcode
ZCTA5 32222,12,13933,67289,1235,214000,10941,2789,9656,705,2025,4884,1727,315,5488,4725,763,4725,3662,1063,2020-01-01,zipcode
ZCTA5 32223,12,24615,83782,1229,275600,20675,7759,18299,719,3725,6726,4341,2788,10287,9979,308,9979,8378,1601,2020-01-01,zipcode
ZCTA5 32227,12,3599,69984,1728,-666666666,2684,265,1079,27,310,557,124,61,593,481,112,481,0,481,2020-01-01,zipcode
ZCTA5 34471,12,24635,51334,991,195900,20247,8320,17055,985,5395,5067,3017,2591,11432,10279,1153,10279,6149,4130,2020-01-01,zipcode
ZCTA5 34475,12,13291,24202,732,94200,10325,5904,8933,1959,3481,2398,804,291,5360,4770,590,4770,1967,2803,2020-01-01,zipcode
ZCTA5 34479,12,13887,42880,980,119300,11001,4760,9403,1357,3740,2759,1114,433,5849,5280,569,5280,3302,1978,2020-01-01,zipcode
ZCTA5 34480,12,21173,58189,855,196800,16735,6603,14213,1444,4900,4330,2306,1233,8994,7864,1130,7864,5795,2069,2020-01-01,zipcode
ZCTA5 34655,12,44192,71199,1320,251000,36572,15895,32629,2026,8905,10984,6905,3809,20359,17882,2477,17882,14476,3406,2020-01-01,zipcode
ZCTA5 34677,12,22703,69861,1176,255700,19113,7401,16754,992,4382,5041,3982,2357,9734,8566,1168,8566,6373,2193,2020-01-01,zipcode
ZCTA5 34711,12,61189,75015,1434,259600,49078,19678,42845,3111,10674,14783,8806,5471,23807,21279,2528,21279,16595,4684,2020-01-01,zipcode
ZCTA5 34756,12,3641,86607,1140,320200,2837,1149,2334,170,529,976,433,226,1279,1167,112,1167,972,195,2020-01-01,zipcode
ZCTA5 34762,12,435,73021,-666666666,151500,417,262,408,104,163,94,29,18,317,187,130,187,187,0,2020-01-01,zipcode
ZCTA5 34769,12,25524,47805,1077,178600,19628,7802,16326,2404,5837,5137,2023,925,10849,8603,2246,8603,5642,2961,2020-01-01,zipcode
ZCTA5 34117,12,20129,74346,1451,316800,16508,5380,13998,1955,4624,4611,1990,818,5766,5396,370,5396,4591,805,2020-01-01,zipcode
ZCTA5 34138,12,1136,81287,-666666666,-666666666,805,404,805,0,354,383,68,0,700,367,333,367,306,61,2020-01-01,zipcode
ZCTA5 34139,12,247,49750,725,215000,194,47,194,9,35,56,50,44,507,122,385,122,107,15,2020-01-01,zipcode
ZCTA5 34217,12,5178,62159,1220,575600,4848,3024,4722,82,695,1486,1320,1139,6632,2875,3757,2875,2366,509,2020-01-01,zipcode
ZCTA5 34219,12,23970,85477,1718,292300,19869,8594,17960,629,4937,6063,4411,1920,9838,8600,1238,8600,7731,869,2020-01-01,zipcode
ZCTA5 34228,12,7299,108015,2208,724600,7230,5805,7130,189,726,1550,2221,2444,9174,3939,5235,3939,3741,198,2020-01-01,zipcode
ZCTA5 34232,12,35486,69075,1464,237000,30006,10590,26787,2232,8923,7955,5089,2588,16061,14386,1675,14386,9944,4442,2020-01-01,zipcode
ZCTA5 34243,12,31700,64853,1628,289200,27574,12878,24512,1342,5640,7790,5625,4115,15397,12873,2524,12873,9878,2995,2020-01-01,zipcode
ZCTA5 34285,12,18117,56234,1183,250200,17390,11543,16491,601,5083,4455,3397,2955,15313,9832,5481,9832,7786,2046,2020-01-01,zipcode
ZCTA5 34293,12,43988,70357,1382,265900,39621,21994,37397,2146,9795,11654,7846,5956,25303,20250,5053,20250,17857,2393,2020-01-01,zipcode
ZCTA5 34436,12,8189,44164,707,123300,7233,4112,6699,886,2508,2350,449,506,4947,3821,1126,3821,3190,631,2020-01-01,zipcode
ZCTA5 34488,12,11472,34964,865,55800,9250,4396,7901,1107,3177,2228,1147,242,6172,4680,1492,4680,3370,1310,2020-01-01,zipcode
ZCTA5 34498,12,570,37734,1000,167500,433,274,383,27,170,117,44,25,501,249,252,249,181,68,2020-01-01,zipcode
ZCTA5 34610,12,15679,54078,1020,170400,12596,5259,11012,1929,3533,3423,1715,412,5835,5216,619,5216,4171,1045,2020-01-01,zipcode
ZCTA5 34685,12,17549,77020,1375,359700,14994,7063,13642,608,3078,4179,3641,2136,7852,7282,570,7282,5664,1618,2020-01-01,zipcode
ZCTA5 34731,12,16508,54005,967,187600,14358,7782,13173,1078,4888,4031,1725,1451,8451,6983,1468,6983,5774,1209,2020-01-01,zipcode
ZCTA5 34797,12,1455,88989,-666666666,271000,1307,876,1255,0,484,418,226,127,793,602,191,602,579,23,2020-01-01,zipcode
ZCTA5 34952,12,43317,47419,1279,163000,36812,16605,33334,3285,12454,11503,4402,1690,21620,17668,3952,17668,12229,5439,2020-01-01,zipcode
ZCTA5 34981,12,5626,54692,1193,257500,4516,1696,3985,327,1721,908,659,370,1908,1621,287,1621,1038,583,2020-01-01,zipcode
ZCTA5 34986,12,28354,66782,1660,275100,24526,13787,22060,2191,5461,6979,4485,2944,13669,11932,1737,11932,9672,2260,2020-01-01,zipcode
ZCTA5 34251,12,7586,73119,860,363400,6025,2295,4852,429,2019,1652,550,202,2374,2151,223,2151,1993,158,2020-01-01,zipcode
ZCTA5 34275,12,20475,67063,1294,318600,18445,10595,16642,799,4664,4666,3676,2837,11416,9529,1887,9529,7851,1678,2020-01-01,zipcode
ZCTA5 34453,12,10236,38624,847,108300,8512,4989,7863,1382,2981,2359,779,362,5424,4282,1142,4282,3597,685,2020-01-01,zipcode
ZCTA5 34608,12,36327,50786,1059,151300,29610,14135,26274,3083,9135,9518,3212,1326,15362,14076,1286,14076,10434,3642,2020-01-01,zipcode
ZCTA5 34109,12,26562,76144,1476,415800,22745,12029,21020,808,5251,5491,5762,3708,15138,11515,3623,11515,8012,3503,2020-01-01,zipcode
ZCTA5 34953,12,72636,63483,1568,227900,56562,18923,47802,5669,15456,17068,6832,2777,24815,23064,1751,23064,19279,3785,2020-01-01,zipcode
ZCTA5 34222,12,12466,57047,1108,120200,10671,5284,9589,948,3175,3806,1090,570,7399,5286,2113,5286,4264,1022,2020-01-01,zipcode
ZCTA5 34224,12,16369,43863,950,174200,15094,9162,13766,1146,5196,4265,1929,1230,10913,7631,3282,7631,5994,1637,2020-01-01,zipcode
ZCTA5 34229,12,7934,88542,-666666666,509200,6941,4258,6575,204,1131,1083,2082,2075,4643,3487,1156,3487,3011,476,2020-01-01,zipcode
ZCTA5 34231,12,32762,56096,1245,278800,28040,12445,25904,1789,7103,8287,5233,3492,18991,15116,3875,15116,9861,5255,2020-01-01,zipcode
ZCTA5 34238,12,20095,78912,1684,385300,18542,11360,17663,349,3450,4429,4449,4986,13048,10385,2663,10385,8173,2212,2020-01-01,zipcode
ZCTA5 34268,12,366,23077,-666666666,-666666666,332,258,243,120,123,0,0,0,143,114,29,114,72,42,2020-01-01,zipcode
ZCTA5 34286,12,19700,61246,1595,198500,16365,7344,13995,2083,4614,3962,2068,1268,7730,6801,929,6801,5859,942,2020-01-01,zipcode
ZCTA5 34428,12,9334,43417,679,198200,7879,3787,7109,636,2701,2480,780,512,5169,4057,1112,4057,3002,1055,2020-01-01,zipcode
ZCTA5 34442,12,15479,46275,808,178100,14175,9571,13325,1032,4730,3972,1843,1748,9438,7327,2111,7327,6448,879,2020-01-01,zipcode
ZCTA5 34473,12,21424,57524,1062,161300,17053,7146,15098,1398,6028,5096,2037,539,8104,7158,946,7158,5767,1391,2020-01-01,zipcode
ZCTA5 34668,12,48452,37262,1022,102100,39590,19418,34471,4455,14631,10488,3498,1399,23128,20119,3009,20119,11948,8171,2020-01-01,zipcode
ZCTA5 34683,12,33699,70375,1277,293500,28677,10940,25631,1755,6317,8468,5921,3170,15280,13380,1900,13380,10301,3079,2020-01-01,zipcode
ZCTA5 34690,12,11367,36809,1053,83000,9712,4776,8729,1026,4178,2489,746,290,6630,5168,1462,5168,3354,1814,2020-01-01,zipcode
ZCTA5 34758,12,44155,55733,1292,186800,33679,10763,27618,3619,10377,8761,2870,1991,14329,11315,3014,11315,8409,2906,2020-01-01,zipcode
ZCTA5 34946,12,6292,36383,760,103600,5456,2648,4720,1174,1615,1292,450,189,3185,2565,620,2565,1692,873,2020-01-01,zipcode
ZCTA5 34957,12,22900,55982,1098,274200,20462,11369,18641,1267,4931,5993,4008,2442,17364,10713,6651,10713,7892,2821,2020-01-01,zipcode
ZCTA5 34990,12,30138,99219,1720,405500,25352,11916,22712,1025,4135,7281,6542,3729,13687,11834,1853,11834,10556,1278,2020-01-01,zipcode
ZCTA5 34613,12,17760,46955,959,116700,15817,10210,14996,1791,5279,5215,1856,855,10264,8451,1813,8451,7309,1142,2020-01-01,zipcode
ZCTA5 34614,12,7710,63596,639,184100,6297,2759,5270,667,1509,2066,464,564,2973,2642,331,2642,2488,154,2020-01-01,zipcode
ZCTA5 34639,12,29728,88723,1446,263400,23512,8083,20589,1062,5553,6282,5277,2415,10617,10195,422,10195,8446,1749,2020-01-01,zipcode
ZCTA5 34654,12,25182,51036,1139,178300,21697,11536,19279,2626,7220,5902,2254,1277,10323,8980,1343,8980,6970,2010,2020-01-01,zipcode
ZCTA5 34746,12,46725,58635,1404,224800,37715,14026,32273,4923,8803,10111,5701,2735,23986,14223,9763,14223,10061,4162,2020-01-01,zipcode
ZCTA5 34786,12,46044,103163,1879,449000,34590,10208,30723,950,3171,8842,11372,6388,17238,14966,2272,14966,10677,4289,2020-01-01,zipcode
ZCTA5 34947,12,13399,31398,951,139800,10056,4096,8345,2155,2757,2301,527,605,4753,4057,696,4057,1481,2576,2020-01-01,zipcode
ZCTA5 35183,01,663,58317,-666666666,96700,561,236,526,117,263,122,24,0,353,239,114,239,178,61,2020-01-01,zipcode
ZCTA5 35210,01,13955,60318,912,158200,11572,4313,10505,939,2900,2803,2684,1179,6804,6025,779,6025,4032,1993,2020-01-01,zipcode
ZCTA5 32935,12,42463,53207,1086,171400,35420,13275,31312,2588,9803,10988,5555,2378,19209,16797,2412,16797,9926,6871,2020-01-01,zipcode
ZCTA5 32976,12,9109,40992,821,108100,8950,6209,8658,475,3278,3536,982,387,6972,5165,1807,5165,4910,255,2020-01-01,zipcode
ZCTA5 32694,12,2118,32125,555,111300,1814,641,1552,176,761,363,159,93,1289,1082,207,1082,763,319,2020-01-01,zipcode
ZCTA5 32754,12,11398,53338,931,199200,9625,4967,8581,917,3195,3023,1027,419,5675,4402,1273,4402,3897,505,2020-01-01,zipcode
ZCTA5 32801,12,12945,66350,1400,348000,12106,3236,11408,735,1544,1819,4499,2811,10210,7967,2243,7967,2057,5910,2020-01-01,zipcode
ZCTA5 32803,12,20771,82111,1410,302300,18436,3991,16978,663,2458,4132,6172,3553,11305,9764,1541,9764,5287,4477,2020-01-01,zipcode
ZCTA5 32811,12,39905,40594,1168,111300,31626,9130,26531,3601,7501,8854,4486,2089,17832,14402,3430,14402,3753,10649,2020-01-01,zipcode
ZCTA5 35035,01,959,53818,-666666666,67400,780,260,729,49,297,230,105,48,637,457,180,457,440,17,2020-01-01,zipcode
ZCTA5 35042,01,5732,55572,601,121800,4972,2197,4465,588,2037,1112,358,370,2601,2185,416,2185,1818,367,2020-01-01,zipcode
ZCTA5 35082,01,0,-666666666,-666666666,-666666666,0,0,0,0,0,0,0,0,0,0,0,0,0,0,2020-01-01,zipcode
ZCTA5 35121,01,16542,45943,677,135300,13344,6949,11381,2569,3204,3766,1252,590,7097,6365,732,6365,4231,2134,2020-01-01,zipcode
ZCTA5 35139,01,132,11429,-666666666,16100,132,64,88,55,26,7,0,0,126,92,34,92,51,41,2020-01-01,zipcode
ZCTA5 35147,01,5825,76875,1401,196700,4430,1486,3809,447,746,1062,1095,459,2178,1970,208,1970,1799,171,2020-01-01,zipcode
ZCTA5 35148,01,2209,53214,575,114100,1902,810,1676,265,688,655,43,25,1180,972,208,972,696,276,2020-01-01,zipcode
ZCTA5 35176,01,683,21425,697,-666666666,579,327,474,222,126,85,17,24,331,311,20,311,188,123,2020-01-01,zipcode
ZCTA5 35216,01,37828,66540,1096,286000,28960,8458,24890,1586,4068,6392,8063,4781,16119,14781,1338,14781,8154,6627,2020-01-01,zipcode
ZCTA5 35221,01,4112,32017,834,67700,3402,1766,3067,574,959,1210,259,65,2375,1764,611,1764,1125,639,2020-01-01,zipcode
ZCTA5 35223,01,10388,137400,2031,579400,8442,3683,7480,50,186,1109,3231,2904,4570,4140,430,4140,3654,486,2020-01-01,zipcode
ZCTA5 35224,01,5362,47450,819,67600,4273,1902,3668,273,1521,1486,301,87,2892,2079,813,2079,1171,908,2020-01-01,zipcode
ZCTA5 35750,01,13317,54321,866,139500,10617,3875,9301,1308,2945,2610,1699,739,5827,5183,644,5183,4129,1054,2020-01-01,zipcode
ZCTA5 35903,01,18240,41103,676,114700,15199,6402,12675,1735,4257,4676,1207,800,8767,6926,1841,6926,4510,2416,2020-01-01,zipcode
ZCTA5 35754,01,5806,68673,611,160900,5023,2185,4309,962,980,1209,823,335,2537,2287,250,2287,1685,602,2020-01-01,zipcode
ZCTA5 35811,01,26198,65938,815,172800,21354,7624,18458,1695,4154,6412,4056,2141,11745,10698,1047,10698,8305,2393,2020-01-01,zipcode
ZCTA5 35901,01,18903,39732,633,132400,15265,7050,13288,2121,3774,4401,1864,1128,9267,7426,1841,7426,4742,2684,2020-01-01,zipcode
ZCTA5 35954,01,12095,43715,575,105200,9835,4370,8295,1371,3056,3073,418,377,5719,4568,1151,4568,3673,895,2020-01-01,zipcode
ZCTA5 35958,01,3237,38165,521,124000,2575,1459,2143,427,832,512,230,142,1356,1212,144,1212,992,220,2020-01-01,zipcode
ZCTA5 35961,01,6623,39244,550,90400,5316,2533,4650,1437,1587,1301,180,145,2882,2387,495,2387,1652,735,2020-01-01,zipcode
ZCTA5 35971,01,6344,37123,665,107500,5213,2553,4256,788,1675,1446,225,122,2482,2299,183,2299,1631,668,2020-01-01,zipcode
ZCTA5 35751,01,227,48500,-666666666,165000,216,77,156,0,68,53,20,15,108,82,26,82,82,0,2020-01-01,zipcode
ZCTA5 35771,01,3681,55662,639,114600,2784,1054,2546,482,851,890,187,136,1533,1245,288,1245,1002,243,2020-01-01,zipcode
ZCTA5 35806,01,24132,62355,1029,221600,20033,5535,16117,721,2239,4352,5433,3372,12346,11621,725,11621,5425,6196,2020-01-01,zipcode
ZCTA5 35808,01,1308,94896,1371,-666666666,1037,248,780,3,132,295,187,163,381,371,10,371,13,358,2020-01-01,zipcode
ZCTA5 35775,01,726,37758,-666666666,80300,541,290,511,117,147,172,45,30,319,277,42,277,265,12,2020-01-01,zipcode
ZCTA5 35803,01,26504,79214,997,189600,21675,8323,19161,750,3309,5207,6082,3813,12244,11424,820,11424,9096,2328,2020-01-01,zipcode
ZCTA5 35044,01,7149,41098,584,95800,5830,2211,4913,725,1839,1928,186,235,3516,3188,328,3188,2011,1177,2020-01-01,zipcode
ZCTA5 35055,01,21535,51479,752,139000,17022,7160,14485,2206,4111,4914,2301,953,9251,8367,884,8367,5329,3038,2020-01-01,zipcode
ZCTA5 35071,01,15591,73854,986,183400,12105,4349,10679,755,3216,3565,2047,1096,6650,5996,654,5996,4562,1434,2020-01-01,zipcode
ZCTA5 35986,01,7833,46558,593,145500,6221,2640,5268,929,1579,1934,646,180,3473,3099,374,3099,2278,821,2020-01-01,zipcode
ZCTA5 35004,01,11944,64987,964,165600,9453,3272,8658,408,3305,3266,1273,406,4776,4677,99,4677,3635,1042,2020-01-01,zipcode
ZCTA5 35005,01,8815,49702,889,103600,7217,3063,6669,840,2978,2067,568,216,3644,3170,474,3170,2524,646,2020-01-01,zipcode
ZCTA5 35045,01,14383,44842,685,124000,11492,5333,10056,1664,4235,2553,955,649,6409,5759,650,5759,4029,1730,2020-01-01,zipcode
ZCTA5 35052,01,257,-666666666,-666666666,-666666666,257,203,257,75,110,61,11,0,20,20,0,20,0,20,2020-01-01,zipcode
ZCTA5 35186,01,5068,73010,929,206700,4262,1857,3659,426,1102,1105,664,362,2276,1988,288,1988,1634,354,2020-01-01,zipcode
ZCTA5 35213,01,13963,128059,1440,558900,10851,3420,9719,74,378,848,4860,3559,6121,5756,365,5756,4437,1319,2020-01-01,zipcode
ZCTA5 35215,01,47438,41940,870,111800,34516,13432,29177,3789,9535,11132,3229,1492,20327,17816,2511,17816,9867,7949,2020-01-01,zipcode
ZCTA5 35442,01,6386,35000,498,87000,5304,3287,4639,1019,1600,1302,480,238,2459,1978,481,1978,1351,627,2020-01-01,zipcode
ZCTA5 35456,01,4332,50244,876,117700,3382,1495,3042,626,1316,860,139,101,1737,1472,265,1472,1037,435,2020-01-01,zipcode
ZCTA5 35118,01,3157,61900,783,134800,2497,1126,2141,300,907,698,124,112,1271,1088,183,1088,863,225,2020-01-01,zipcode
ZCTA5 35073,01,2544,54464,853,92000,2158,967,1930,282,628,719,269,32,1222,1063,159,1063,752,311,2020-01-01,zipcode
ZCTA5 35085,01,8479,53438,727,97100,6892,3075,5626,1158,2476,1283,491,218,3638,3216,422,3216,2632,584,2020-01-01,zipcode
ZCTA5 35111,01,17512,70897,1043,207500,14154,5231,12119,688,3841,3865,2412,1313,7215,6440,775,6440,5814,626,2020-01-01,zipcode
ZCTA5 35124,01,24044,78647,1164,201700,19502,6308,17223,1008,3053,5540,4721,2901,10188,9645,543,9645,8080,1565,2020-01-01,zipcode
ZCTA5 35150,01,17326,34718,661,113300,13475,6426,11807,2192,3745,4293,1042,535,8432,7104,1328,7104,4485,2619,2020-01-01,zipcode
ZCTA5 35203,01,3026,25030,670,262000,2907,1585,2623,487,918,374,428,416,1893,1595,298,1595,348,1247,2020-01-01,zipcode
ZCTA5 35206,01,17211,33256,916,90200,14109,6221,12351,1905,4389,4030,1291,736,8552,6757,1795,6757,3393,3364,2020-01-01,zipcode
ZCTA5 35209,01,29262,64307,1087,358000,23103,6613,18200,815,2479,3484,6269,5153,15595,12445,3150,12445,6263,6182,2020-01-01,zipcode
ZCTA5 35218,01,7283,29545,823,63400,5629,2550,4960,969,1575,2053,279,84,3662,2868,794,2868,1025,1843,2020-01-01,zipcode
ZCTA5 35226,01,35256,108368,1279,293200,26641,7957,23901,554,2315,5102,9156,6774,14026,13214,812,13214,10383,2831,2020-01-01,zipcode
ZCTA5 35235,01,21419,54564,1082,124200,16352,5883,14455,1109,3845,5588,2420,1493,9130,8295,835,8295,5577,2718,2020-01-01,zipcode
ZCTA5 35444,01,4007,48194,733,124600,3206,1315,2720,375,1052,889,335,69,1624,1447,177,1447,1218,229,2020-01-01,zipcode
ZCTA5 35461,01,2140,43750,-666666666,152200,1779,828,1614,186,668,498,191,71,1140,906,234,906,856,50,2020-01-01,zipcode
ZCTA5 35473,01,16498,64232,807,188000,12594,4130,10778,845,2509,3406,2370,1648,7101,6483,618,6483,4270,2213,2020-01-01,zipcode
ZCTA5 35490,01,4179,58158,915,141000,3356,1090,2556,497,995,727,216,121,1677,1350,327,1350,982,368,2020-01-01,zipcode
ZCTA5 35501,01,9719,41276,665,112000,7472,3294,6200,1086,2084,2171,448,411,4662,3591,1071,3591,2070,1521,2020-01-01,zipcode
ZCTA5 35540,01,2413,43558,473,86100,1963,917,1733,307,746,528,104,48,1148,961,187,961,809,152,2020-01-01,zipcode
ZCTA5 35541,01,3399,49283,716,132100,3037,1551,2731,387,881,880,311,272,2745,1593,1152,1593,1371,222,2020-01-01,zipcode
ZCTA5 35463,01,2183,56652,-666666666,157800,1705,620,1426,191,562,405,210,58,814,727,87,727,653,74,2020-01-01,zipcode
ZCTA5 35469,01,49,-666666666,-666666666,-666666666,49,25,49,25,13,0,5,6,186,43,143,43,18,25,2020-01-01,zipcode
ZCTA5 35503,01,9817,49497,672,128500,8017,3522,7023,1179,2330,2396,681,437,4764,3925,839,3925,3112,813,2020-01-01,zipcode
ZCTA5 32526,12,37484,60917,1108,147600,31145,13138,27399,2008,7828,10860,4664,2039,16054,14676,1378,14676,11680,2996,2020-01-01,zipcode
ZCTA5 32533,12,29024,75985,994,186700,23321,9471,20656,1476,5573,7547,3940,2120,11454,10553,901,10553,8906,1647,2020-01-01,zipcode
ZCTA5 32539,12,30357,56597,1016,180300,23499,10026,19864,1859,6290,7626,2895,1194,11062,10096,966,10096,7681,2415,2020-01-01,zipcode
ZCTA5 35233,01,2244,42284,1336,261200,2212,636,1435,55,91,87,324,878,1941,1431,510,1431,185,1246,2020-01-01,zipcode
ZCTA5 35243,01,16155,89891,1327,361600,13460,4301,12153,97,918,2266,4924,3948,9475,7798,1677,7798,4281,3517,2020-01-01,zipcode
ZCTA5 35441,01,1058,43750,-666666666,61200,750,286,694,96,253,184,66,95,855,355,500,355,325,30,2020-01-01,zipcode
ZCTA5 35446,01,1662,42969,817,76900,1343,675,1223,252,424,372,125,50,579,579,0,579,489,90,2020-01-01,zipcode
ZCTA5 35452,01,3225,55694,960,163800,2749,1257,2328,341,882,713,211,181,1361,1198,163,1198,1049,149,2020-01-01,zipcode
ZCTA5 35458,01,279,-666666666,-666666666,167900,240,90,240,12,66,139,12,11,150,135,15,135,83,52,2020-01-01,zipcode
ZCTA5 35475,01,17518,87883,778,207500,13280,4254,11827,797,3518,3885,2169,1458,7068,6129,939,6129,5591,538,2020-01-01,zipcode
ZCTA5 35477,01,132,-666666666,-666666666,-666666666,132,78,104,7,35,57,5,0,92,54,38,54,54,0,2020-01-01,zipcode
ZCTA5 35549,01,3667,38907,573,57400,2956,1461,2590,503,985,973,90,39,1976,1567,409,1567,1150,417,2020-01-01,zipcode
ZCTA5 35554,01,1050,37348,546,59700,873,415,779,117,363,258,35,6,541,461,80,461,413,48,2020-01-01,zipcode
ZCTA5 35579,01,3349,46792,423,87600,2663,1387,2449,476,1023,775,153,22,1660,1315,345,1315,1059,256,2020-01-01,zipcode
ZCTA5 35640,01,26308,56773,701,146400,21040,9113,18373,2026,6621,6074,2342,1310,10878,9787,1091,9787,7721,2066,2020-01-01,zipcode
ZCTA5 35653,01,10621,45297,683,92800,8352,3257,7045,2016,2639,1654,447,289,4584,3370,1214,3370,2271,1099,2020-01-01,zipcode
ZCTA5 35660,01,8925,36774,695,100500,7277,3617,6336,1037,2142,2097,659,401,5087,4118,969,4118,2373,1745,2020-01-01,zipcode
ZCTA5 35677,01,2099,36908,822,108800,1747,871,1334,172,560,392,103,107,1156,777,379,777,665,112,2020-01-01,zipcode
ZCTA5 35749,01,23239,99767,945,191700,18005,5768,15530,1088,3180,4756,3948,2558,8913,8303,610,8303,7668,635,2020-01-01,zipcode
ZCTA5 35179,01,8128,51921,705,146100,6630,2991,5667,769,2254,1969,432,243,3610,3101,509,3101,2580,521,2020-01-01,zipcode
ZCTA5 35950,01,20728,48535,716,115500,14870,5940,12735,2634,3735,4064,1648,654,7603,7143,460,7143,4495,2648,2020-01-01,zipcode
ZCTA5 35953,01,6944,53679,1053,127100,5931,2917,5285,1116,2029,1818,197,125,3216,2536,680,2536,2060,476,2020-01-01,zipcode
ZCTA5 35967,01,15993,41973,598,120500,12176,5108,10590,2248,3096,3486,957,803,7526,6194,1332,6194,4406,1788,2020-01-01,zipcode
ZCTA5 35979,01,1032,48261,-666666666,135000,868,327,725,103,396,184,18,24,552,450,102,450,409,41,2020-01-01,zipcode
ZCTA5 35987,01,2421,60306,632,105500,1927,812,1673,312,766,440,82,73,1065,938,127,938,759,179,2020-01-01,zipcode
ZCTA5 35988,01,2355,41287,547,85300,1748,606,1550,324,518,411,201,96,1015,872,143,872,622,250,2020-01-01,zipcode
ZCTA5 35049,01,3914,39750,691,125500,2975,1228,2550,409,1233,678,145,85,1902,1581,321,1581,973,608,2020-01-01,zipcode
ZCTA5 35051,01,9609,55021,728,167500,7725,3822,6879,1188,2399,1800,1057,435,3597,3208,389,3208,2483,725,2020-01-01,zipcode
ZCTA5 35060,01,187,33468,-666666666,97900,127,67,99,0,54,22,0,23,193,84,109,84,84,0,2020-01-01,zipcode
ZCTA5 35115,01,16737,41585,706,132700,13547,5504,10345,1708,3485,3043,1602,507,6691,6198,493,6198,4186,2012,2020-01-01,zipcode
ZCTA5 35116,01,4768,73111,938,178800,3804,1382,3483,232,989,1235,811,216,1992,1896,96,1896,1674,222,2020-01-01,zipcode
ZCTA5 35120,01,16072,64679,746,161100,12364,4042,10174,1334,3729,3381,1231,499,6062,5583,479,5583,4612,971,2020-01-01,zipcode
ZCTA5 35160,01,25622,32986,588,103200,21598,11843,18439,4123,6425,5324,1497,1070,12801,10312,2489,10312,6444,3868,2020-01-01,zipcode
ZCTA5 35171,01,3557,65611,-666666666,120800,3038,1753,2754,719,831,694,190,320,1585,1399,186,1399,1165,234,2020-01-01,zipcode
ZCTA5 35175,01,5218,62667,636,150000,4377,1963,3870,572,1566,911,537,284,2449,2012,437,2012,1697,315,2020-01-01,zipcode
ZCTA5 35968,01,5033,57765,626,120200,3936,1676,3260,784,966,1058,287,165,1712,1506,206,1506,1075,431,2020-01-01,zipcode
ZCTA5 35989,01,4063,42652,586,94200,3022,1379,2539,521,813,818,216,171,1651,1391,260,1391,1109,282,2020-01-01,zipcode
ZCTA5 35083,01,3394,42188,710,129700,2742,1257,2329,476,863,778,180,32,1454,1254,200,1254,963,291,2020-01-01,zipcode
ZCTA5 35094,01,15392,59772,906,172400,11673,4344,10307,1261,2869,3511,1674,992,6358,5587,771,5587,4381,1206,2020-01-01,zipcode
ZCTA5 35125,01,10945,52340,905,154500,8911,3858,7952,1663,2619,2276,992,402,5007,4412,595,4412,2861,1551,2020-01-01,zipcode
ZCTA5 35128,01,10859,67101,887,183100,8686,3039,7631,859,2172,2892,1220,488,4969,4336,633,4336,3377,959,2020-01-01,zipcode
ZCTA5 35135,01,1820,47083,947,195100,1398,513,1268,198,431,409,164,66,886,752,134,752,559,193,2020-01-01,zipcode
ZCTA5 35173,01,27312,101644,1157,258200,21099,7270,18403,744,3786,6120,5088,2665,10222,9574,648,9574,8638,936,2020-01-01,zipcode
ZCTA5 35459,01,913,30313,658,61100,810,466,659,150,282,167,46,14,491,392,99,392,273,119,2020-01-01,zipcode
ZCTA5 35460,01,750,24221,-666666666,92500,699,425,505,13,130,167,152,43,428,360,68,360,330,30,2020-01-01,zipcode
ZCTA5 35480,01,1108,58393,-666666666,179000,959,416,950,69,374,350,115,42,494,427,67,427,367,60,2020-01-01,zipcode
ZCTA5 35552,01,1031,45685,-666666666,59900,780,346,609,62,225,187,135,0,501,381,120,381,332,49,2020-01-01,zipcode
ZCTA5 35559,01,75,-666666666,-666666666,-666666666,75,8,67,14,44,9,0,0,17,17,0,17,8,9,2020-01-01,zipcode
ZCTA5 35563,01,4287,40507,556,103100,3480,1626,2929,387,1011,1162,198,171,2045,1634,411,1634,1278,356,2020-01-01,zipcode
ZCTA5 35570,01,11516,43041,513,100200,9736,4885,8261,1560,2855,2617,721,508,5608,4549,1059,4549,3171,1378,2020-01-01,zipcode
ZCTA5 36874,01,8892,56489,1046,172300,7061,3131,6278,542,2111,2383,753,489,4022,3317,705,3317,2917,400,2020-01-01,zipcode
ZCTA5 36875,01,3488,55070,761,154800,2966,1384,2682,244,805,1269,179,185,1718,1499,219,1499,1185,314,2020-01-01,zipcode
ZCTA5 36879,01,2637,120110,579,267100,1988,625,1792,146,331,316,546,453,1071,916,155,916,798,118,2020-01-01,zipcode
ZCTA5 36907,01,1531,29231,843,66400,1294,847,1106,216,399,223,127,141,1076,788,288,788,698,90,2020-01-01,zipcode
ZCTA5 36033,01,3824,48482,589,93500,3091,1508,2860,451,1332,626,293,158,2259,1336,923,1336,1074,262,2020-01-01,zipcode
ZCTA5 36277,01,5804,57274,841,109000,4531,1933,3979,562,1209,1471,457,280,2166,1981,185,1981,1598,383,2020-01-01,zipcode
ZCTA5 36362,01,5715,61769,1176,-666666666,3822,961,2462,33,356,1119,787,167,1510,1427,83,1427,9,1418,2020-01-01,zipcode
ZCTA5 36541,01,15135,63566,1056,121900,11240,4295,9783,1631,3646,3359,689,458,5996,5262,734,5262,4794,468,2020-01-01,zipcode
ZCTA5 36482,01,785,35438,-666666666,83600,712,451,638,198,198,136,86,20,508,345,163,345,302,43,2020-01-01,zipcode
ZCTA5 36538,01,356,29500,-666666666,-666666666,317,235,312,148,119,33,12,0,328,178,150,178,178,0,2020-01-01,zipcode
ZCTA5 36548,01,1019,102542,-666666666,162500,800,371,706,38,186,329,48,105,541,397,144,397,389,8,2020-01-01,zipcode
ZCTA5 36549,01,5825,51285,1035,156700,4977,2798,4458,301,1560,1515,867,215,2732,2235,497,2235,1883,352,2020-01-01,zipcode
ZCTA5 36550,01,198,-666666666,-666666666,-666666666,198,83,198,39,75,20,33,31,156,116,40,116,83,33,2020-01-01,zipcode
ZCTA5 36560,01,3246,38164,749,69000,2824,1431,2446,701,1059,454,175,57,1372,1183,189,1183,877,306,2020-01-01,zipcode
ZCTA5 36561,01,6774,85503,1351,356800,6028,2572,5530,231,1158,1349,1950,842,13520,3219,10301,3219,2501,718,2020-01-01,zipcode
ZCTA5 36580,01,5730,47664,804,183000,4487,1981,3762,866,989,1174,528,205,2535,2089,446,2089,1774,315,2020-01-01,zipcode
ZCTA5 36618,01,16948,46716,1037,112600,13976,5878,11530,1082,3743,3649,1955,1101,7212,6579,633,6579,4949,1630,2020-01-01,zipcode
ZCTA5 36720,01,993,19762,-666666666,-666666666,759,455,485,146,195,99,41,4,413,310,103,310,252,58,2020-01-01,zipcode
ZCTA5 36750,01,2616,54013,658,123900,1945,977,1719,186,848,555,49,81,1111,916,195,916,704,212,2020-01-01,zipcode
ZCTA5 36769,01,2229,32727,533,66000,1803,1076,1564,262,817,338,99,48,1251,928,323,928,648,280,2020-01-01,zipcode
ZCTA5 36773,01,294,25385,725,-666666666,245,158,192,38,32,98,18,6,237,142,95,142,74,68,2020-01-01,zipcode
ZCTA5 36775,01,1274,47500,946,80800,1033,618,988,271,342,320,51,4,809,600,209,600,376,224,2020-01-01,zipcode
ZCTA5 36786,01,2442,20281,346,54900,1691,942,1597,273,718,312,230,64,1600,1041,559,1041,789,252,2020-01-01,zipcode
ZCTA5 36305,01,17018,72571,986,183200,13361,5023,11610,678,2711,4025,2444,1752,6989,6209,780,6209,4351,1858,2020-01-01,zipcode
ZCTA5 36268,01,5980,54737,763,97300,4508,1700,3844,386,1584,1435,286,153,2731,2280,451,2280,1977,303,2020-01-01,zipcode
ZCTA5 36269,01,1836,55640,810,114200,1232,491,1140,136,514,313,126,51,718,654,64,654,498,156,2020-01-01,zipcode
ZCTA5 36303,01,31096,46961,727,145300,24444,10956,21157,2613,6222,7017,3380,1925,14384,11620,2764,11620,7029,4591,2020-01-01,zipcode
ZCTA5 36311,01,2369,38235,585,76500,1958,975,1539,320,627,383,76,133,1286,966,320,966,777,189,2020-01-01,zipcode
ZCTA5 36350,01,6677,39033,705,130300,5248,2010,4471,848,1349,1410,643,221,3113,2691,422,2691,1654,1037,2020-01-01,zipcode
ZCTA5 36420,01,9552,46315,609,119700,7869,3505,6988,968,2264,2228,800,728,5043,4091,952,4091,2928,1163,2020-01-01,zipcode
ZCTA5 36451,01,4665,49815,626,104000,3789,1875,3398,506,1358,1124,300,110,2538,1906,632,1906,1493,413,2020-01-01,zipcode
ZCTA5 36470,01,35,-666666666,-666666666,-666666666,35,35,35,17,18,0,0,0,35,35,0,35,0,35,2020-01-01,zipcode
ZCTA5 36473,01,96,62976,-666666666,113300,90,62,82,17,54,11,0,0,106,40,66,40,40,0,2020-01-01,zipcode
ZCTA5 36518,01,2547,41512,757,131700,2168,1248,1846,352,698,569,145,82,1370,956,414,956,731,225,2020-01-01,zipcode
ZCTA5 36526,01,34788,72997,1156,222300,26339,9601,23235,1227,5173,8038,5051,3746,14115,12975,1140,12975,9584,3391,2020-01-01,zipcode
ZCTA5 36527,01,15586,96688,1275,267600,11693,4114,9790,423,1655,3137,2550,2025,5916,5577,339,5577,3994,1583,2020-01-01,zipcode
ZCTA5 36551,01,10892,60746,883,164900,8715,3191,7572,588,2549,2701,1104,630,3908,3276,632,3276,2658,618,2020-01-01,zipcode
ZCTA5 33073,12,35407,81727,1808,342800,27291,7162,22895,1682,6116,7275,6131,1691,12479,11776,703,11776,6633,5143,2020-01-01,zipcode
ZCTA5 33134,12,39420,70983,1488,502400,32734,11973,29761,3035,5239,5988,8011,7488,18411,16297,2114,16297,8807,7490,2020-01-01,zipcode
ZCTA5 33136,12,17065,29897,981,253100,14060,5545,12570,2982,3839,3238,1697,814,7411,6497,914,6497,789,5708,2020-01-01,zipcode
ZCTA5 33145,12,30450,56239,1462,396800,26373,10239,23900,4099,6054,5205,4918,3624,12911,11710,1201,11710,6095,5615,2020-01-01,zipcode
ZCTA5 33156,12,33223,126688,1739,868600,25989,10096,22283,782,2832,4332,7030,7307,12726,11004,1722,11004,8100,2904,2020-01-01,zipcode
ZCTA5 33158,12,6233,159219,2205,690000,4774,1883,3991,57,330,561,1298,1745,2221,1983,238,1983,1893,90,2020-01-01,zipcode
ZCTA5 33811,12,23623,71224,1103,200100,19141,7082,16288,1592,5071,4883,3572,1170,9161,8064,1097,8064,6215,1849,2020-01-01,zipcode
ZCTA5 33841,12,9650,39663,783,107200,7667,3723,6550,1335,2839,1531,462,383,4121,3207,914,3207,2396,811,2020-01-01,zipcode
ZCTA5 33160,12,39704,50660,1585,286200,34126,14606,31488,2096,5064,10290,8213,5825,35825,19405,16420,19405,10855,8550,2020-01-01,zipcode
ZCTA5 33183,12,36673,60616,1603,281900,30968,11237,26288,3718,6931,7675,5468,2496,12593,12243,350,12243,7772,4471,2020-01-01,zipcode
ZCTA5 33306,12,3286,71159,1144,482200,3034,1010,2889,82,464,720,958,665,2188,1729,459,1729,1213,516,2020-01-01,zipcode
ZCTA5 33311,12,75705,40684,1120,185500,57259,22892,47991,10865,17107,13401,4371,2247,26989,24216,2773,24216,10475,13741,2020-01-01,zipcode
ZCTA5 33326,12,32586,93333,1893,404300,25588,8765,22215,857,3348,5919,6689,5402,13152,10632,2520,10632,7427,3205,2020-01-01,zipcode
ZCTA5 33330,12,15355,131222,2628,528300,12380,4284,10162,787,1644,2801,2537,2393,4878,4569,309,4569,4167,402,2020-01-01,zipcode
ZCTA5 33351,12,34774,56937,1519,244600,27178,7516,24136,2663,6519,7590,5365,1999,12698,11911,787,11911,6455,5456,2020-01-01,zipcode
ZCTA5 33406,12,26653,64608,1309,229700,22052,7940,18231,3500,5942,4816,2862,1111,8870,8173,697,8173,5348,2825,2020-01-01,zipcode
ZCTA5 33428,12,43566,67202,1704,319000,34988,12310,30509,2674,7605,8524,7662,4044,16672,15030,1642,15030,10498,4532,2020-01-01,zipcode
ZCTA5 33432,12,21017,77952,1765,661500,19179,8209,17261,1001,2545,4522,5343,3850,15142,10751,4391,10751,6607,4144,2020-01-01,zipcode
ZCTA5 33438,12,388,-666666666,-666666666,131300,352,86,284,27,140,57,29,31,134,87,47,87,72,15,2020-01-01,zipcode
ZCTA5 33460,12,32848,41561,1116,230400,25570,8995,22171,6778,5427,5663,2524,1779,12697,10887,1810,10887,4625,6262,2020-01-01,zipcode
ZCTA5 33849,12,728,39375,-666666666,88200,609,321,544,139,300,98,0,7,312,196,116,196,167,29,2020-01-01,zipcode
ZCTA5 33868,12,13051,48882,944,128800,10567,6057,9562,1933,3654,2571,938,466,4921,3873,1048,3873,3302,571,2020-01-01,zipcode
ZCTA5 33870,12,22664,36619,781,91100,18955,10583,16973,3386,6349,4802,1595,841,11195,8700,2495,8700,5619,3081,2020-01-01,zipcode
ZCTA5 33903,12,22616,48710,911,102500,20376,12140,19073,2183,6086,6617,2284,1903,15899,11394,4505,11394,9147,2247,2020-01-01,zipcode
ZCTA5 33917,12,30270,47441,935,114500,26850,14755,25395,3232,9019,8194,3103,1847,17650,13204,4446,13204,10711,2493,2020-01-01,zipcode
ZCTA5 33948,12,18322,50391,1127,197700,16541,9062,15486,1543,5156,5678,1952,1157,9071,7315,1756,7315,6150,1165,2020-01-01,zipcode
ZCTA5 33991,12,23620,66088,1690,262000,18846,7938,16668,992,6195,5161,2939,1381,10198,8620,1578,8620,6903,1717,2020-01-01,zipcode
ZCTA5 33761,12,19239,57232,1284,188200,16690,8141,15753,989,4020,4889,3871,1984,9931,8736,1195,8736,6975,1761,2020-01-01,zipcode
ZCTA5 33765,12,15076,48400,1117,216500,13091,4925,11976,1417,3809,3837,1841,1072,6918,6372,546,6372,3571,2801,2020-01-01,zipcode
ZCTA5 33767,12,7493,87340,1750,526100,7048,4353,6703,266,1447,1630,1963,1397,8740,4049,4691,4049,3185,864,2020-01-01,zipcode
ZCTA5 33776,12,13043,78596,1534,313900,11037,4794,9776,295,2303,2808,2865,1505,5354,4805,549,4805,4366,439,2020-01-01,zipcode
ZCTA5 33781,12,26265,43692,938,164500,21854,8485,19542,3765,6410,5529,2578,1260,11739,9974,1765,9974,6263,3711,2020-01-01,zipcode
ZCTA5 33853,12,11674,41031,835,156800,9097,4021,8019,1547,2534,2461,951,526,5156,4408,748,4408,2194,2214,2020-01-01,zipcode
ZCTA5 33913,12,26232,86649,1480,314200,22373,11375,18487,1082,3937,5063,4916,3489,13486,9244,4242,9244,7834,1410,2020-01-01,zipcode
ZCTA5 33556,12,23679,112459,1265,402600,18567,6797,16427,590,2679,4665,5334,3159,9159,8310,849,8310,7459,851,2020-01-01,zipcode
ZCTA5 33565,12,17922,55410,983,179900,13686,5931,12534,2040,4389,3769,1730,606,6697,6187,510,6187,4923,1264,2020-01-01,zipcode
ZCTA5 33567,12,12349,73403,1082,215700,9919,3131,8528,1756,2743,1984,1499,546,4088,3868,220,3868,3062,806,2020-01-01,zipcode
ZCTA5 33584,12,27006,54970,1102,189500,21322,8514,18811,2453,5644,6028,3402,1284,10155,9440,715,9440,7219,2221,2020-01-01,zipcode
ZCTA5 33604,12,40309,44192,1000,174300,33051,10869,28784,4373,10446,8188,3926,1851,17282,15811,1471,15811,8710,7101,2020-01-01,zipcode
ZCTA5 33618,12,28544,68245,1136,292500,23917,8447,21648,686,4912,6255,6177,3618,12967,12100,867,12100,8131,3969,2020-01-01,zipcode
ZCTA5 33637,12,17919,50518,1148,167400,14493,4162,11872,1295,2883,3517,2582,1595,7746,7071,675,7071,3085,3986,2020-01-01,zipcode
ZCTA5 33701,12,16632,46786,1097,380500,15162,6106,13707,651,2264,3744,3790,3258,12440,9120,3320,9120,3429,5691,2020-01-01,zipcode
ZCTA5 33704,12,17202,84295,1015,432900,14951,4898,13785,404,2222,3415,4426,3318,9327,8038,1289,8038,5780,2258,2020-01-01,zipcode
ZCTA5 36525,01,1702,50179,828,133000,1236,502,1130,156,458,342,144,30,628,577,51,577,435,142,2020-01-01,zipcode
ZCTA5 36529,01,259,2499,-666666666,-666666666,195,144,133,0,67,31,10,25,162,79,83,79,79,0,2020-01-01,zipcode
ZCTA5 36583,01,678,41731,-666666666,126500,529,332,465,31,179,160,51,44,268,268,0,268,252,16,2020-01-01,zipcode
ZCTA5 36749,01,741,22800,-666666666,97100,681,415,595,196,246,118,35,0,510,370,140,370,250,120,2020-01-01,zipcode
ZCTA5 36617,01,12871,35450,902,70600,10618,5758,9313,1262,3532,2960,992,567,5986,5039,947,5039,2705,2334,2020-01-01,zipcode
ZCTA5 36723,01,414,15227,-666666666,81700,225,139,181,92,29,60,0,0,233,138,95,138,86,52,2020-01-01,zipcode
ZCTA5 36748,01,2357,40742,680,79700,1921,1032,1640,215,714,498,88,125,1408,875,533,875,588,287,2020-01-01,zipcode
ZCTA5 36776,01,2016,14552,-666666666,44500,1584,844,1197,253,313,422,209,0,951,630,321,630,432,198,2020-01-01,zipcode
ZCTA5 36782,01,2578,38173,-666666666,72300,1855,945,1618,195,573,691,139,20,1277,901,376,901,836,65,2020-01-01,zipcode
ZCTA5 36353,01,1564,38950,658,88400,1320,601,1026,141,277,461,95,52,825,591,234,591,530,61,2020-01-01,zipcode
ZCTA5 36371,01,805,36985,611,124600,624,350,563,102,173,206,61,21,364,343,21,343,225,118,2020-01-01,zipcode
ZCTA5 36453,01,2475,39940,600,79800,2161,1079,1812,308,686,584,156,78,1067,914,153,914,697,217,2020-01-01,zipcode
ZCTA5 36467,01,9538,35855,608,92900,7882,3676,7050,1199,2906,2086,553,306,4986,4106,880,4106,3010,1096,2020-01-01,zipcode
ZCTA5 36790,01,471,-666666666,-666666666,-666666666,414,137,277,30,74,173,0,0,208,169,39,169,139,30,2020-01-01,zipcode
ZCTA5 36832,01,25386,30068,861,154800,21741,9412,11954,959,2473,2953,2898,2671,13675,10274,3401,10274,4314,5960,2020-01-01,zipcode
ZCTA5 36858,01,354,31458,-666666666,117900,283,175,283,54,100,68,33,28,195,178,17,178,163,15,2020-01-01,zipcode
ZCTA5 36521,01,6482,56964,773,120700,5301,2302,4646,836,2275,1024,371,140,2548,2436,112,2436,2181,255,2020-01-01,zipcode
ZCTA5 36471,01,942,21607,-666666666,44600,820,611,714,94,443,132,30,15,841,431,410,431,219,212,2020-01-01,zipcode
ZCTA5 36476,01,3,-666666666,-666666666,-666666666,3,0,3,0,0,3,0,0,21,3,18,3,3,0,2020-01-01,zipcode
ZCTA5 36480,01,1853,40417,727,131500,1538,869,1253,131,431,506,58,127,1138,683,455,683,544,139,2020-01-01,zipcode
ZCTA5 36513,01,388,-666666666,-666666666,76500,286,97,286,0,126,145,0,15,64,64,0,64,64,0,2020-01-01,zipcode
ZCTA5 36703,01,11880,28003,625,71800,9466,4945,8088,1399,3237,2563,535,354,5991,4927,1064,4927,2581,2346,2020-01-01,zipcode
ZCTA5 36572,01,6183,79955,954,158400,4980,2021,4350,331,1685,1145,829,360,2232,2173,59,2173,1719,454,2020-01-01,zipcode
ZCTA5 36575,01,22268,57777,866,151500,17362,7375,15172,1627,6029,4630,2029,857,8446,7763,683,7763,6310,1453,2020-01-01,zipcode
ZCTA5 36727,01,138,26280,-666666666,9999,124,92,124,25,8,90,0,1,140,98,42,98,98,0,2020-01-01,zipcode
ZCTA5 36736,01,1492,-666666666,-666666666,76400,823,347,763,56,334,133,136,104,540,413,127,413,353,60,2020-01-01,zipcode
ZCTA5 36740,01,1523,35391,579,106000,1349,798,1056,199,447,305,58,47,955,517,438,517,361,156,2020-01-01,zipcode
ZCTA5 36742,01,2663,31338,347,90500,2458,1393,1925,342,496,674,233,180,1401,1093,308,1093,829,264,2020-01-01,zipcode
ZCTA5 36751,01,411,40613,-666666666,31900,334,195,235,99,89,17,16,14,312,176,136,176,148,28,2020-01-01,zipcode
ZCTA5 36754,01,643,-666666666,-666666666,-666666666,584,292,514,299,170,26,0,19,269,198,71,198,169,29,2020-01-01,zipcode
ZCTA5 36758,01,1448,51759,399,84600,1010,516,875,168,398,166,96,47,537,460,77,460,372,88,2020-01-01,zipcode
ZCTA5 36850,01,2982,37500,370,64400,2436,1392,2087,493,718,630,181,65,1424,1156,268,1156,939,217,2020-01-01,zipcode
ZCTA5 36003,01,1830,22292,435,101900,1558,959,1420,295,528,446,66,85,1177,935,242,935,760,175,2020-01-01,zipcode
ZCTA5 36022,01,12833,67733,770,173600,9822,3500,8317,518,2662,3047,1552,538,5025,4590,435,4590,3906,684,2020-01-01,zipcode
ZCTA5 36026,01,976,60472,1358,255100,932,555,870,71,234,280,285,0,1108,475,633,475,436,39,2020-01-01,zipcode
ZCTA5 36032,01,2522,35938,-666666666,62300,1963,935,1593,312,768,353,60,100,1322,1000,322,1000,728,272,2020-01-01,zipcode
ZCTA5 36020,01,988,40441,743,161000,736,373,633,95,217,216,71,34,391,352,39,352,251,101,2020-01-01,zipcode
ZCTA5 36029,01,1008,55744,-666666666,-666666666,812,225,707,146,317,111,75,58,342,285,57,285,239,46,2020-01-01,zipcode
ZCTA5 36432,01,1795,38941,495,86900,1529,856,1301,346,490,312,102,51,1054,578,476,578,429,149,2020-01-01,zipcode
ZCTA5 36435,01,362,54583,-666666666,-666666666,324,160,314,71,102,131,5,5,249,148,101,148,146,2,2020-01-01,zipcode
ZCTA5 36106,01,14575,61753,956,157400,11851,4099,9891,667,1734,2771,2238,2481,6924,6031,893,6031,3378,2653,2020-01-01,zipcode
ZCTA5 32141,12,19414,51875,1126,177400,16970,7981,15649,1284,5697,5700,1851,1117,9540,8633,907,8633,7340,1293,2020-01-01,zipcode
ZCTA5 32157,12,340,53000,844,143000,308,120,278,114,66,75,23,0,234,148,86,148,82,66,2020-01-01,zipcode
ZCTA5 32164,12,49642,57835,1385,218300,40984,18989,36951,3560,12036,13450,5267,2638,19883,18365,1518,18365,12766,5599,2020-01-01,zipcode
ZCTA5 32168,12,28284,54692,1213,245300,24776,12925,22636,2013,6638,7696,4671,1618,14370,12310,2060,12310,9594,2716,2020-01-01,zipcode
ZCTA5 32189,12,5541,38828,642,90800,4885,2624,4414,787,1459,1583,517,68,3910,2674,1236,2674,1894,780,2020-01-01,zipcode
ZCTA5 32202,12,6965,35947,863,102900,6466,4474,5461,1239,1556,1539,780,347,2701,2265,436,2265,202,2063,2020-01-01,zipcode
ZCTA5 32212,12,2327,39628,1706,-666666666,1909,79,507,15,52,300,81,59,229,222,7,222,3,219,2020-01-01,zipcode
ZCTA5 32333,12,11805,49583,763,125000,9917,4560,8999,1426,2753,2344,1769,707,5956,5116,840,5116,4203,913,2020-01-01,zipcode
ZCTA5 32340,12,11058,29057,701,108600,9314,5520,8150,1736,2970,2258,706,480,4863,3923,940,3923,2622,1301,2020-01-01,zipcode
ZCTA5 32344,12,12580,46168,767,148500,10969,5910,9817,1783,3323,2376,1519,816,6042,4963,1079,4963,3693,1270,2020-01-01,zipcode
ZCTA5 32358,12,1481,62850,857,142400,1260,665,1231,125,366,411,248,81,1348,658,690,658,593,65,2020-01-01,zipcode
ZCTA5 33070,12,5138,65286,1743,577400,4492,1683,3987,307,1156,1099,860,565,4287,2238,2049,2238,1601,637,2020-01-01,zipcode
ZCTA5 33126,12,50886,42589,1331,252100,43563,16083,38942,7965,11605,9146,7695,2531,19250,18035,1215,18035,6588,11447,2020-01-01,zipcode
ZCTA5 33129,12,14220,86922,2102,463100,12405,3613,11148,483,1185,1720,3891,3869,8219,6680,1539,6680,2964,3716,2020-01-01,zipcode
ZCTA5 33130,12,33938,45040,1229,338500,30439,9584,27074,5517,6494,5194,5437,4432,18949,15856,3093,15856,1770,14086,2020-01-01,zipcode
ZCTA5 33131,12,20558,102862,2330,487100,18249,3358,16663,259,1180,2490,6330,6404,16894,11265,5629,11265,3753,7512,2020-01-01,zipcode
ZCTA5 33137,12,22835,64106,1783,394400,19549,5234,17498,2149,2796,4149,5123,3281,12479,9900,2579,9900,2288,7612,2020-01-01,zipcode
ZCTA5 32008,12,4887,34864,689,97300,3956,2151,3738,696,1855,815,307,65,3012,2123,889,2123,1756,367,2020-01-01,zipcode
ZCTA5 32053,12,3990,29688,724,79600,3172,1772,2688,612,1130,625,202,119,1999,1463,536,1463,1171,292,2020-01-01,zipcode
ZCTA5 32359,12,986,34106,-666666666,113500,931,699,911,153,416,295,0,47,2180,558,1622,558,379,179,2020-01-01,zipcode
ZCTA5 32401,12,21045,40217,869,146700,17253,7404,15263,2193,5225,5084,1729,1032,11249,9662,1587,9662,4944,4718,2020-01-01,zipcode
ZCTA5 32413,12,14551,72275,1184,279500,12882,5208,11700,677,2922,4147,2587,1367,18615,6558,12057,6558,4913,1645,2020-01-01,zipcode
ZCTA5 32423,12,955,47656,1702,123000,887,538,822,64,325,299,127,7,570,471,99,471,446,25,2020-01-01,zipcode
ZCTA5 32426,12,798,30745,725,72200,697,430,629,201,279,111,18,20,456,332,124,332,305,27,2020-01-01,zipcode
ZCTA5 32448,12,7232,30853,673,85700,5885,2895,5310,673,2224,1796,351,266,4163,3473,690,3473,2334,1139,2020-01-01,zipcode
ZCTA5 32503,12,33163,54708,952,175500,27735,10391,20983,1501,4645,7253,4263,3321,14029,12484,1545,12484,8292,4192,2020-01-01,zipcode
ZCTA5 32544,12,2268,35899,1446,-666666666,1603,138,760,12,97,213,386,52,445,379,66,379,0,379,2020-01-01,zipcode
ZCTA5 32571,12,35905,69451,980,193200,27886,11275,24076,1583,6272,9275,4534,2412,13979,12965,1014,12965,10621,2344,2020-01-01,zipcode
ZCTA5 32608,12,50431,50786,1058,251900,42938,16185,29709,1651,3733,7132,8115,9078,24032,19909,4123,19909,8364,11545,2020-01-01,zipcode
ZCTA5 32621,12,4672,38217,642,82100,3922,2125,3497,658,1394,1057,336,52,2280,2061,219,2061,1513,548,2020-01-01,zipcode
ZCTA5 32640,12,10647,43610,827,116100,8821,4885,8133,1325,2970,2499,804,535,5444,4141,1303,4141,3465,676,2020-01-01,zipcode
ZCTA5 32683,12,409,47083,-666666666,-666666666,252,171,251,47,130,74,0,0,120,103,17,103,80,23,2020-01-01,zipcode
ZCTA5 32686,12,5193,36212,644,209600,4419,2302,3936,837,1127,1315,325,332,2773,2301,472,2301,1531,770,2020-01-01,zipcode
ZCTA5 32618,12,8954,63601,653,174500,7429,2678,6387,702,1684,2129,817,1055,3785,3383,402,3383,2978,405,2020-01-01,zipcode
ZCTA5 32804,12,18695,84471,1321,355000,16148,4941,14697,573,2990,3163,4530,3441,9419,8201,1218,8201,5481,2720,2020-01-01,zipcode
ZCTA5 32931,12,14131,67894,1247,346200,13124,6714,12327,323,2194,3801,3514,2495,10939,7451,3488,7451,5339,2112,2020-01-01,zipcode
ZCTA5 32707,12,37106,55387,1192,198700,31168,11472,27624,1862,6457,10240,6284,2781,16803,15680,1123,15680,10591,5089,2020-01-01,zipcode
ZCTA5 32712,12,48987,80336,1476,275200,38394,13311,33715,4146,8624,10389,7096,3460,16986,15684,1302,15684,12501,3183,2020-01-01,zipcode
ZCTA5 32720,12,33485,56118,926,207900,28490,13241,23892,2550,7766,7868,3631,2077,13784,12430,1354,12430,8501,3929,2020-01-01,zipcode
ZCTA5 32732,12,5345,86277,1058,335700,4324,1474,3650,163,995,1245,764,483,2228,1868,360,1868,1780,88,2020-01-01,zipcode
ZCTA5 32738,12,46727,59548,1186,170800,36704,13315,31358,3404,11169,11737,3967,1081,15964,14966,998,14966,11681,3285,2020-01-01,zipcode
ZCTA5 32771,12,57030,67453,1198,241900,44569,15445,38913,3716,9291,13110,8280,4516,22272,20486,1786,20486,12812,7674,2020-01-01,zipcode
ZCTA5 32773,12,31090,48089,1167,167600,24210,8526,21539,2110,7403,6853,3778,1395,12346,11327,1019,11327,6239,5088,2020-01-01,zipcode
ZCTA5 32776,12,12191,73424,1084,274000,9944,3190,8846,680,2137,4370,1154,505,4475,4183,292,4183,3638,545,2020-01-01,zipcode
ZCTA5 32808,12,60450,39187,1058,150900,45137,14666,37067,7941,12600,11918,3284,1324,20344,18603,1741,18603,7559,11044,2020-01-01,zipcode
ZCTA5 32809,12,30100,45205,1083,175900,23568,8850,20647,4501,6628,5087,3036,1395,11133,9457,1676,9457,4895,4562,2020-01-01,zipcode
ZCTA5 32819,12,27849,76118,1463,351300,22899,7758,19608,1619,3389,5630,6002,2968,14382,9814,4568,9814,5786,4028,2020-01-01,zipcode
ZCTA5 32831,12,3022,36250,-666666666,9999,3022,2994,2635,1067,1077,383,53,55,46,28,18,28,28,0,2020-01-01,zipcode
ZCTA5 32835,12,47867,57480,1358,266700,38783,10668,32340,2530,7300,9994,8462,4054,18953,17323,1630,17323,7308,10015,2020-01-01,zipcode
ZCTA5 32836,12,19640,111271,1680,478500,15965,5089,14146,331,1857,3502,4969,3487,9171,7117,2054,7117,4626,2491,2020-01-01,zipcode
ZCTA5 32905,12,23410,44056,1031,136400,19374,8763,16913,1854,5538,5480,2905,1136,11101,9379,1722,9379,5191,4188,2020-01-01,zipcode
ZCTA5 32322,12,3721,38727,770,178900,3314,2447,3074,657,1342,715,185,175,1912,998,914,998,773,225,2020-01-01,zipcode
ZCTA5 32440,12,7640,40612,681,98100,6801,4151,5707,1247,2291,1496,452,221,2452,2106,346,2106,1418,688,2020-01-01,zipcode
ZCTA5 32566,12,41165,83848,1419,256700,31480,11692,26802,1657,6340,11010,4597,3198,16852,14623,2229,14623,11677,2946,2020-01-01,zipcode
ZCTA5 32625,12,1568,53281,836,215500,1275,593,1123,63,399,387,101,173,1250,625,625,625,487,138,2020-01-01,zipcode
ZCTA5 32746,12,46816,89609,1523,318500,38666,12639,34177,1073,5218,10654,10509,6723,20102,19018,1084,19018,12034,6984,2020-01-01,zipcode
ZCTA5 32908,12,12605,53174,1138,163600,10034,3770,8282,1321,2614,3084,727,536,4145,3785,360,3785,3165,620,2020-01-01,zipcode
ZCTA5 32832,12,29359,94718,1747,349900,21704,6659,19293,927,1548,4900,7524,4394,12474,10108,2366,10108,6876,3232,2020-01-01,zipcode
ZCTA5 32833,12,9659,74340,1124,281500,7886,3019,6804,742,1728,2266,1385,683,3742,3154,588,3154,2509,645,2020-01-01,zipcode
ZCTA5 32837,12,50780,63143,1451,263600,41686,13226,35302,3457,8389,10165,8535,4756,20975,16191,4784,16191,9660,6531,2020-01-01,zipcode
ZCTA5 33155,12,44659,66753,1657,378400,37840,13703,34331,4481,8436,9465,7769,4180,15133,14375,758,14375,9812,4563,2020-01-01,zipcode
ZCTA5 33165,12,54497,65005,1435,348100,47141,18321,40976,7177,12573,10094,7344,3788,17196,16649,547,16649,11719,4930,2020-01-01,zipcode
ZCTA5 33708,12,15377,63351,1521,350700,14350,7608,13573,671,2944,4568,3227,2163,13639,7929,5710,7929,5872,2057,2020-01-01,zipcode
ZCTA5 33760,12,18438,50486,1140,154800,15394,4654,12831,1706,3602,4448,2267,808,8208,7162,1046,7162,3193,3969,2020-01-01,zipcode
ZCTA5 33763,12,19987,46289,1158,144700,17257,8879,16162,1451,5492,4949,2670,1600,11224,9403,1821,9403,6619,2784,2020-01-01,zipcode
ZCTA5 33030,12,35743,38730,1055,257000,24978,9147,20745,8355,5944,3999,1725,722,9734,9091,643,9091,3404,5687,2020-01-01,zipcode
ZCTA5 33035,12,14509,65907,1458,198800,10594,2724,9097,908,2250,3216,1977,746,5105,4533,572,4533,2040,2493,2020-01-01,zipcode
ZCTA5 33064,12,59942,52740,1388,215600,48925,15883,43248,7866,13358,10593,7796,3635,24491,21303,3188,21303,13220,8083,2020-01-01,zipcode
ZCTA5 33071,12,39433,90849,1666,393200,31288,8773,26183,1219,5456,8127,7240,4141,13624,12985,639,12985,8614,4371,2020-01-01,zipcode
ZCTA5 33132,12,15496,90759,2078,485800,14424,3800,13083,814,1430,2465,4468,3906,10431,7631,2800,7631,2205,5426,2020-01-01,zipcode
ZCTA5 33139,12,38488,56227,1503,397900,33718,9951,30767,3587,5325,6533,8615,6707,31360,20559,10801,20559,6481,14078,2020-01-01,zipcode
ZCTA5 33141,12,38442,52913,1403,313100,33424,8832,30334,2643,7448,8195,6790,5258,22752,17387,5365,17387,5703,11684,2020-01-01,zipcode
ZCTA5 33150,12,31637,30311,944,245800,23532,10149,20203,5301,6265,5253,2279,1105,11496,10221,1275,10221,2812,7409,2020-01-01,zipcode
ZCTA5 33154,12,14511,75702,1736,663200,11052,4326,9942,288,1703,2336,2914,2701,10214,5800,4414,5800,3471,2329,2020-01-01,zipcode
ZCTA5 33166,12,25097,60645,1358,397000,21049,7546,18597,3211,4075,4463,3820,3028,9684,8592,1092,8592,4256,4336,2020-01-01,zipcode
ZCTA5 33167,12,22618,45879,1146,215700,17688,7223,14914,3844,5338,3565,1619,548,6465,6140,325,6140,3505,2635,2020-01-01,zipcode
ZCTA5 33176,12,53934,74246,1413,437900,44395,15615,38703,3515,8215,11631,9368,5974,19441,18160,1281,18160,11689,6471,2020-01-01,zipcode
ZCTA5 33177,12,56862,61341,1663,288400,47202,19453,40321,6409,14772,10572,6127,2441,16015,15423,592,15423,11280,4143,2020-01-01,zipcode
ZCTA5 33178,12,52885,75907,2161,410400,39930,13154,34183,3171,4440,7867,10450,8255,19352,15834,3518,15834,7814,8020,2020-01-01,zipcode
ZCTA5 33180,12,32136,78234,1983,391400,26926,11139,24293,1114,2785,7117,7910,5367,21844,14121,7723,14121,8976,5145,2020-01-01,zipcode
ZCTA5 33919,12,30485,58138,1223,220500,26905,12562,25117,1309,5723,7827,6156,4102,18997,14049,4948,14049,10481,3568,2020-01-01,zipcode
ZCTA5 33953,12,6408,63020,1574,232300,5840,3869,5538,463,1652,2073,818,532,3818,2809,1009,2809,2637,172,2020-01-01,zipcode
ZCTA5 33001,12,300,44297,2014,-666666666,291,178,291,16,172,51,44,8,739,167,572,167,113,54,2020-01-01,zipcode
ZCTA5 33014,12,42153,48450,1323,303200,35118,12616,30804,5641,9250,7958,5025,2930,14609,14076,533,14076,6194,7882,2020-01-01,zipcode
ZCTA5 33015,12,67952,58972,1484,286800,55261,17435,47007,6780,13855,14789,7891,3692,22934,22066,868,22066,11157,10909,2020-01-01,zipcode
ZCTA5 33016,12,50269,47929,1399,224300,41314,15206,35283,7291,11238,7896,6481,2377,16231,15816,415,15816,8503,7313,2020-01-01,zipcode
ZCTA5 33026,12,32882,79741,1660,287500,27016,9225,23917,2184,5470,7505,5319,3439,12500,11956,544,11956,9740,2216,2020-01-01,zipcode
ZCTA5 33055,12,38509,46914,1303,222900,31976,13860,27430,7103,10969,5633,2842,883,11570,10985,585,10985,8509,2476,2020-01-01,zipcode
ZCTA5 33056,12,36822,48204,1367,213000,28913,11508,24623,4169,8893,7348,2611,1602,10854,10161,693,10161,6895,3266,2020-01-01,zipcode
ZCTA5 33716,12,18243,55063,1339,214400,16039,3346,13855,669,2451,4877,3853,2005,10985,9360,1625,9360,1821,7539,2020-01-01,zipcode
ZCTA5 33777,12,17186,76278,1515,208600,14530,5341,13232,669,3714,4318,2850,1681,8207,6956,1251,6956,5664,1292,2020-01-01,zipcode
ZCTA5 33778,12,15836,50774,1062,174900,13195,5831,12173,1073,3683,4742,1601,1074,7808,6218,1590,6218,5032,1186,2020-01-01,zipcode
ZCTA5 33823,12,35712,53767,809,155600,28527,12631,24628,3785,9179,6845,3525,1294,13227,11571,1656,11571,8119,3452,2020-01-01,zipcode
ZCTA5 33852,12,20839,41713,829,143500,17733,10718,16459,2592,7081,4400,1449,937,12853,8826,4027,8826,7457,1369,2020-01-01,zipcode
ZCTA5 33901,12,22907,41352,1015,215100,18879,8444,16895,2964,5529,4265,2437,1700,10797,9036,1761,9036,3755,5281,2020-01-01,zipcode
ZCTA5 33904,12,31388,50695,1212,246300,28026,14414,26336,1749,8937,8456,4918,2276,19752,13958,5794,13958,10784,3174,2020-01-01,zipcode
ZCTA5 33916,12,26013,37743,1044,121400,19841,8007,17018,3835,5861,4184,2020,1118,11641,9000,2641,9000,2906,6094,2020-01-01,zipcode
ZCTA5 33950,12,23948,58560,1085,299400,21447,14382,19917,1106,4816,6946,4409,2640,15586,11367,4219,11367,9510,1857,2020-01-01,zipcode
ZCTA5 33960,12,586,39917,-666666666,127800,525,255,506,39,246,150,57,14,452,278,174,278,262,16,2020-01-01,zipcode
ZCTA5 33944,12,415,-666666666,-666666666,-666666666,302,138,302,0,214,88,0,0,176,138,38,138,138,0,2020-01-01,zipcode
ZCTA5 33946,12,2368,57984,-666666666,512000,2325,1329,2325,43,748,704,561,269,2931,1256,1675,1256,1132,124,2020-01-01,zipcode
ZCTA5 33971,12,28101,55548,1272,181600,20596,6858,17132,3302,6145,5429,1421,835,8040,7446,594,7446,5570,1876,2020-01-01,zipcode
ZCTA5 33981,12,12009,55152,1213,268300,10730,6285,10420,767,3880,3357,1396,1020,6686,5027,1659,5027,4437,590,2020-01-01,zipcode
ZCTA5 33990,12,35396,61019,1335,223000,30226,11983,27133,2954,10122,8514,4001,1542,14806,12337,2469,12337,9069,3268,2020-01-01,zipcode
ZCTA5 33993,12,29328,78348,1575,226800,23117,8192,19772,1738,8004,5982,2752,1296,10484,9249,1235,9249,7874,1375,2020-01-01,zipcode
ZCTA5 33173,12,32469,70541,1658,331500,27457,9503,24190,2347,4688,7358,6251,3546,11754,11056,698,11056,7473,3583,2020-01-01,zipcode
ZCTA5 33174,12,35938,50387,1412,280600,31575,13301,25747,8049,5657,5115,4796,2130,11299,10902,397,10902,5756,5146,2020-01-01,zipcode
ZCTA5 33187,12,18381,87848,2090,371000,15128,5452,12969,1937,3277,3544,3216,995,5478,5224,254,5224,4532,692,2020-01-01,zipcode
ZCTA5 33193,12,49083,67779,1546,311300,41453,14274,34936,7423,8759,7698,8457,2599,15573,15108,465,15108,9260,5848,2020-01-01,zipcode
ZCTA5 33031,12,9148,89450,1720,392000,7482,3011,6023,712,2409,1676,579,647,2554,2490,64,2490,2185,305,2020-01-01,zipcode
ZCTA5 33032,12,52073,59878,1294,270400,38903,12109,32722,6112,8886,9810,5933,1981,15302,14559,743,14559,8383,6176,2020-01-01,zipcode
ZCTA5 33043,12,4911,75957,1703,376800,4234,1738,3821,277,1064,1379,698,403,2923,2063,860,2063,1582,481,2020-01-01,zipcode
ZCTA5 33146,12,16171,110596,2255,919400,13991,6791,7870,193,548,1363,2390,3376,5622,4841,781,4841,3404,1437,2020-01-01,zipcode
ZCTA5 35553,01,4359,31813,463,67900,3622,1954,2958,776,1286,581,177,138,2359,1655,704,1655,1332,323,2020-01-01,zipcode
ZCTA5 35565,01,12115,38917,570,60400,9493,4578,8676,2092,3280,2388,505,411,6092,4891,1201,4891,3849,1042,2020-01-01,zipcode
ZCTA5 35574,01,1632,45250,291,117400,1282,706,1217,217,564,330,41,65,839,609,230,609,530,79,2020-01-01,zipcode
ZCTA5 35578,01,5691,38237,861,93200,4647,2692,4029,853,1691,973,335,177,2738,2256,482,2256,1944,312,2020-01-01,zipcode
ZCTA5 35584,01,283,19844,833,49500,232,160,204,86,67,45,0,6,131,97,34,97,82,15,2020-01-01,zipcode
ZCTA5 35618,01,2003,29608,475,81200,1627,924,1313,276,556,357,69,55,1016,813,203,813,556,257,2020-01-01,zipcode
ZCTA5 35647,01,1143,63967,355,113800,885,337,725,115,268,164,160,18,349,335,14,335,279,56,2020-01-01,zipcode
ZCTA5 35649,01,87,146250,-666666666,350000,76,52,75,1,7,30,22,15,23,23,0,23,23,0,2020-01-01,zipcode
ZCTA5 35652,01,9104,60733,714,139300,7330,2997,6632,803,2392,1790,1058,589,4515,3653,862,3653,3026,627,2020-01-01,zipcode
ZCTA5 35670,01,6443,52763,628,127200,5049,1969,4529,777,1173,1679,688,212,3199,2410,789,2410,1876,534,2020-01-01,zipcode
ZCTA5 35542,01,681,37969,-666666666,80000,593,392,488,99,201,141,45,2,419,337,82,337,320,17,2020-01-01,zipcode
ZCTA5 35544,01,635,47484,768,46400,573,212,562,72,193,184,98,15,345,311,34,311,162,149,2020-01-01,zipcode
ZCTA5 35564,01,2100,28667,573,101600,1754,939,1512,244,538,604,63,63,1172,948,224,948,759,189,2020-01-01,zipcode
ZCTA5 35601,01,32299,43485,690,103300,25158,11012,21642,5111,6608,5672,3066,1185,14137,12167,1970,12167,7445,4722,2020-01-01,zipcode
ZCTA5 35610,01,1721,45000,481,165000,1530,738,1442,177,673,356,119,117,806,732,74,732,616,116,2020-01-01,zipcode
ZCTA5 35619,01,4534,51508,690,130400,3751,1668,3317,891,1201,885,266,74,2095,1703,392,1703,1362,341,2020-01-01,zipcode
ZCTA5 35646,01,4414,45677,516,89200,3857,2099,3334,603,1529,906,155,141,2449,1859,590,1859,1470,389,2020-01-01,zipcode
ZCTA5 35654,01,8023,37063,544,133100,6349,3144,5521,1027,2477,1231,517,269,3733,3018,715,3018,2116,902,2020-01-01,zipcode
ZCTA5 35672,01,5191,51118,568,106800,3761,1873,3304,422,1356,977,258,291,2621,1961,660,1961,1495,466,2020-01-01,zipcode
ZCTA5 35744,01,1720,38672,-666666666,111500,1537,809,1308,213,725,255,53,62,854,669,185,669,535,134,2020-01-01,zipcode
ZCTA5 35761,01,13229,62888,913,147000,10171,3585,9163,1158,2583,3070,1698,654,5452,5023,429,5023,4323,700,2020-01-01,zipcode
ZCTA5 35763,01,18422,120629,1484,273300,13815,4631,12367,582,1857,2169,4286,3473,6703,6565,138,6565,5976,589,2020-01-01,zipcode
ZCTA5 35765,01,4112,58365,592,112300,3335,1818,2972,448,922,880,360,362,1994,1576,418,1576,1353,223,2020-01-01,zipcode
ZCTA5 35768,01,12224,42059,549,103100,9834,5028,8382,1518,3480,2167,759,458,5539,4602,937,4602,3137,1465,2020-01-01,zipcode
ZCTA5 35769,01,9376,44969,671,150900,7672,3628,6955,720,1883,2438,1414,500,5075,3992,1083,3992,3153,839,2020-01-01,zipcode
ZCTA5 35776,01,3596,43661,492,99800,2933,1455,2594,379,1111,741,226,137,1689,1382,307,1382,1165,217,2020-01-01,zipcode
ZCTA5 35905,01,5852,55265,677,147300,4704,2375,4251,497,1350,1546,277,581,2964,2283,681,2283,1892,391,2020-01-01,zipcode
ZCTA5 35907,01,8692,70383,951,158300,7020,2954,6306,553,1692,2516,1036,509,3278,3004,274,3004,2693,311,2020-01-01,zipcode
ZCTA5 35960,01,9039,42604,652,158600,7793,4050,6974,1116,2796,2071,426,565,6289,4074,2215,4074,3028,1046,2020-01-01,zipcode
ZCTA5 35131,01,3784,39375,611,86500,2942,1478,2490,437,1063,632,215,143,1647,1278,369,1278,986,292,2020-01-01,zipcode
ZCTA5 35741,01,3829,81654,1038,264300,3713,1437,3310,202,495,406,1797,410,1855,1817,38,1817,1509,308,2020-01-01,zipcode
ZCTA5 35752,01,2192,41359,839,78000,1866,1012,1670,184,784,532,96,74,1168,981,187,981,756,225,2020-01-01,zipcode
ZCTA5 35759,01,8479,83779,1191,193200,6995,2101,6119,473,1497,1725,1700,724,3490,3434,56,3434,3218,216,2020-01-01,zipcode
ZCTA5 35766,01,171,-666666666,-666666666,-666666666,150,54,150,16,109,5,7,13,112,69,43,69,47,22,2020-01-01,zipcode
ZCTA5 35801,01,24337,80276,936,295500,20261,8690,17911,1859,2724,3914,5774,3640,10938,10085,853,10085,6688,3397,2020-01-01,zipcode
ZCTA5 35810,01,30243,38450,896,87300,24558,10617,19314,2983,5463,6588,2972,1308,12775,11487,1288,11487,7374,4113,2020-01-01,zipcode
ZCTA5 35816,01,14219,25424,710,90500,12069,4557,8295,1377,1975,2649,1474,820,7771,6701,1070,6701,1944,4757,2020-01-01,zipcode
ZCTA5 35952,01,8318,40055,622,97900,6658,3050,5980,1271,2409,1701,420,179,3679,3161,518,3161,2384,777,2020-01-01,zipcode
ZCTA5 35962,01,8327,48700,700,121500,6613,2614,5640,1377,1883,1590,422,368,3632,3150,482,3150,2317,833,2020-01-01,zipcode
ZCTA5 35974,01,1641,46339,668,104500,1212,509,1096,265,314,326,108,83,759,651,108,651,419,232,2020-01-01,zipcode
ZCTA5 35976,01,17655,57885,641,189200,14708,7143,12839,1761,3395,3712,2771,1200,7981,6810,1171,6810,5301,1509,2020-01-01,zipcode
ZCTA5 35990,01,69,18598,-666666666,-666666666,69,65,67,33,32,2,0,0,60,41,19,41,39,2,2020-01-01,zipcode
ZCTA5 35068,01,8431,69543,1028,162100,6552,2344,5900,644,1415,2324,860,657,3802,3645,157,3645,2701,944,2020-01-01,zipcode
ZCTA5 35645,01,13335,73103,691,187000,10808,4122,9621,555,3598,2970,1702,796,6026,5259,767,5259,4382,877,2020-01-01,zipcode
ZCTA5 35745,01,137,31250,-666666666,162500,129,76,117,5,81,19,5,7,154,74,80,74,65,9,2020-01-01,zipcode
ZCTA5 35774,01,175,51250,-666666666,-666666666,175,125,134,0,59,51,12,12,77,63,14,63,63,0,2020-01-01,zipcode
ZCTA5 35984,01,1623,37420,803,159300,1480,790,1458,178,368,280,373,259,1572,833,739,833,629,204,2020-01-01,zipcode
ZCTA5 35978,01,5435,43917,809,96700,4117,1857,3710,703,1593,1039,254,121,2208,1806,402,1806,1475,331,2020-01-01,zipcode
ZCTA5 35634,01,9606,73967,875,198100,8228,3841,7237,528,2488,1925,1317,979,4482,3819,663,3819,3155,664,2020-01-01,zipcode
ZCTA5 35906,01,9926,49222,846,164700,7862,3420,6960,761,2206,2075,1224,694,4593,3746,847,3746,2383,1363,2020-01-01,zipcode
ZCTA5 35983,01,3827,60324,595,155500,3170,1410,2807,204,1019,1139,253,192,2384,1536,848,1536,1310,226,2020-01-01,zipcode
ZCTA5 35013,01,72,-666666666,-666666666,-666666666,72,6,72,55,0,17,0,0,28,23,5,23,6,17,2020-01-01,zipcode
ZCTA5 35032,01,41,-666666666,-666666666,69400,35,19,31,9,19,3,0,0,28,19,9,19,17,2,2020-01-01,zipcode
ZCTA5 35187,01,5,-666666666,-666666666,-666666666,5,5,5,0,0,5,0,0,2,2,0,2,2,0,2020-01-01,zipcode
ZCTA5 35229,01,816,-666666666,-666666666,-666666666,816,491,0,0,0,0,0,0,0,0,0,0,0,0,2020-01-01,zipcode
ZCTA5 35254,01,1698,-666666666,685,-666666666,1677,1123,175,38,81,0,29,27,239,134,105,134,50,84,2020-01-01,zipcode
ZCTA5 35577,01,61,46111,-666666666,74400,53,25,37,0,15,13,9,0,45,18,27,18,18,0,2020-01-01,zipcode
ZCTA5 35615,01,162,-666666666,-666666666,-666666666,162,162,162,162,0,0,0,0,33,33,0,33,0,33,2020-01-01,zipcode
ZCTA5 35896,01,615,-666666666,-666666666,-666666666,615,319,0,0,0,0,0,0,0,0,0,0,0,0,2020-01-01,zipcode
ZCTA5 35033,01,2860,39978,525,117800,2223,1126,1974,592,457,653,171,101,1505,1145,360,1145,1007,138,2020-01-01,zipcode
ZCTA5 35244,01,31935,95647,1149,295700,25126,7523,21690,855,2702,5537,7222,5374,13253,11845,1408,11845,8605,3240,2020-01-01,zipcode
ZCTA5 35548,01,1864,42283,380,59200,1647,760,1422,362,519,393,81,67,971,855,116,855,671,184,2020-01-01,zipcode
ZCTA5 35747,01,5828,57276,655,179000,4730,2141,4101,469,1507,1243,624,258,3112,2259,853,2259,1795,464,2020-01-01,zipcode
ZCTA5 35959,01,4348,36038,501,143300,3638,1909,3259,451,1446,889,217,256,3837,1872,1965,1872,1500,372,2020-01-01,zipcode
ZCTA5 35205,01,20145,42071,852,200100,18651,6489,13652,801,2180,3248,4332,3091,12454,9978,2476,9978,2884,7094,2020-01-01,zipcode
ZCTA5 35208,01,13752,31480,875,78000,11018,5484,9170,1176,3251,3467,885,391,7229,5585,1644,5585,3286,2299,2020-01-01,zipcode
ZCTA5 35212,01,10498,28990,583,146300,7745,2878,6903,1078,1852,1991,1145,837,5718,4430,1288,4430,1927,2503,2020-01-01,zipcode
ZCTA5 35222,01,9299,62670,825,282100,7647,2258,6903,444,885,1561,2099,1914,4620,4081,539,4081,2310,1771,2020-01-01,zipcode
ZCTA5 35234,01,5545,20256,621,57200,4888,2822,4457,1090,1558,1362,362,85,2954,2254,700,2254,1143,1111,2020-01-01,zipcode
ZCTA5 35007,01,26510,75372,1096,172300,20512,6661,17712,1694,4161,5666,3917,2274,10138,9566,572,9566,7826,1740,2020-01-01,zipcode
ZCTA5 35016,01,17066,49046,606,151900,13380,6132,11532,1380,3579,4300,1534,739,7178,6319,859,6319,4826,1493,2020-01-01,zipcode
ZCTA5 35006,01,3170,52788,-666666666,79600,2647,1238,2318,341,1185,652,94,46,1526,1133,393,1133,1061,72,2020-01-01,zipcode
ZCTA5 35014,01,4803,48284,1051,87900,4238,2449,3466,859,1309,990,171,137,1855,1582,273,1582,1466,116,2020-01-01,zipcode
ZCTA5 35571,01,794,47202,681,83800,611,255,520,98,190,168,44,20,433,265,168,265,219,46,2020-01-01,zipcode
ZCTA5 35576,01,3135,59028,491,113700,2497,1019,2205,214,991,700,165,135,1607,1227,380,1227,1063,164,2020-01-01,zipcode
ZCTA5 35594,01,6784,47860,562,118700,5404,2499,4829,825,1674,1683,412,235,3223,2469,754,2469,1860,609,2020-01-01,zipcode
ZCTA5 35613,01,25936,81618,962,202200,21375,9971,19235,2774,4882,6215,3945,1419,8333,7884,449,7884,6932,952,2020-01-01,zipcode
ZCTA5 35614,01,7570,47961,768,132800,5415,2456,4780,833,1693,1545,476,233,2914,2487,427,2487,1978,509,2020-01-01,zipcode
ZCTA5 35650,01,13534,51683,523,130100,10912,5509,9581,1580,3817,2455,987,742,6072,5137,935,5137,4156,981,2020-01-01,zipcode
ZCTA5 35671,01,2621,51903,1258,81000,2419,871,2130,395,885,328,410,112,1391,1125,266,1125,537,588,2020-01-01,zipcode
ZCTA5 35673,01,7971,55213,611,124700,6416,2747,5613,939,2139,1695,587,253,3350,2816,534,2816,2182,634,2020-01-01,zipcode
ZCTA5 35740,01,3342,37866,338,104200,2909,1596,2537,370,1123,766,225,53,1772,1553,219,1553,1024,529,2020-01-01,zipcode
ZCTA5 32744,12,3478,55446,1089,189400,2708,1078,2467,357,795,743,408,164,1442,1241,201,1241,1089,152,2020-01-01,zipcode
ZCTA5 32767,12,3226,56250,1044,97500,2737,1128,2392,437,1237,630,37,51,1340,1064,276,1064,898,166,2020-01-01,zipcode
ZCTA5 32810,12,38248,53551,1229,175600,30030,8191,26158,3418,7912,8237,4975,1616,14325,13410,915,13410,7012,6398,2020-01-01,zipcode
ZCTA5 32818,12,61027,48478,1131,189000,46967,13701,39099,6876,12236,12453,5417,2117,18679,17456,1223,17456,10016,7440,2020-01-01,zipcode
ZCTA5 32820,12,10934,87054,1432,312900,8365,2253,6758,649,1831,1611,1301,1366,3291,2992,299,2992,2477,515,2020-01-01,zipcode
ZCTA5 32827,12,9775,81545,1838,289400,7866,2851,6608,225,1184,1763,1987,1449,4609,3561,1048,3561,2150,1411,2020-01-01,zipcode
ZCTA5 32922,12,17384,36397,835,112100,13150,4995,11383,1720,3722,4316,1033,592,8600,6982,1618,6982,3028,3954,2020-01-01,zipcode
ZCTA5 32927,12,27344,64940,1067,178400,22398,8226,20210,2075,5748,8099,2949,1339,11660,10005,1655,10005,8706,1299,2020-01-01,zipcode
ZCTA5 32949,12,2711,87250,-666666666,353000,2386,1133,2122,153,609,657,464,239,1149,954,195,954,906,48,2020-01-01,zipcode
ZCTA5 32407,12,11277,61450,1489,236300,9614,3140,8336,659,2168,2821,1718,970,8372,4976,3396,4976,2814,2162,2020-01-01,zipcode
ZCTA5 32410,12,901,52607,1396,265300,887,470,852,12,148,355,171,166,1346,507,839,507,378,129,2020-01-01,zipcode
ZCTA5 32425,12,14330,36866,700,89800,11663,6697,10243,2283,4475,2689,593,203,6067,4958,1109,4958,3615,1343,2020-01-01,zipcode
ZCTA5 32427,12,888,30625,591,104200,790,436,605,200,186,159,28,32,443,403,40,403,275,128,2020-01-01,zipcode
ZCTA5 32431,12,4154,45234,658,113100,3447,1604,3118,587,1255,840,282,154,2345,1816,529,1816,1371,445,2020-01-01,zipcode
ZCTA5 32445,12,2427,44643,690,98100,2159,1706,1976,631,691,549,70,35,598,472,126,472,307,165,2020-01-01,zipcode
ZCTA5 32501,12,11422,28479,730,155800,9006,4448,7762,1381,2319,1997,1157,908,5461,4516,945,4516,2106,2410,2020-01-01,zipcode
ZCTA5 32003,12,29505,103019,1684,292800,24621,9840,21129,681,3678,6860,6017,3893,11736,11090,646,11090,9586,1504,2021-01-01,zipcode
ZCTA5 32008,12,5920,42802,820,96000,4499,2252,4063,692,2022,810,447,92,3212,2354,858,2354,1873,481,2021-01-01,zipcode
ZCTA5 32009,12,3372,65850,864,149600,2877,1036,2367,275,982,861,161,88,1448,1383,65,1383,1200,183,2021-01-01,zipcode
ZCTA5 32011,12,14791,67087,873,185700,12002,5135,10410,1655,4273,3123,852,507,5983,5480,503,5480,4613,867,2021-01-01,zipcode
ZCTA5 32024,12,18712,57636,1022,159000,15388,6644,13535,1566,5084,4663,1701,521,7963,7220,743,7220,6067,1153,2021-01-01,zipcode
ZCTA5 32025,12,23649,47439,858,148400,19257,10131,15688,2353,5440,5321,1687,887,9291,8127,1164,8127,4797,3330,2021-01-01,zipcode
ZCTA5 32026,12,3368,-666666666,-666666666,-666666666,3368,3368,3185,1259,1208,639,51,28,0,0,0,0,0,0,2021-01-01,zipcode
ZCTA5 32033,12,4666,71360,1069,252000,4446,1937,3910,313,918,1763,540,376,2199,1915,284,1915,1646,269,2021-01-01,zipcode
ZCTA5 32034,12,38747,87047,1008,365900,33214,15289,30737,1195,6487,7984,9519,5552,21065,16526,4539,16526,13872,2654,2021-01-01,zipcode
ZCTA5 32038,12,9905,45188,792,146000,8163,3801,7396,838,2713,2860,710,275,4662,3824,838,3824,3239,585,2021-01-01,zipcode
ZCTA5 32040,12,8006,61040,968,147800,6122,2359,5295,739,2595,1507,335,119,3037,2663,374,2663,2338,325,2021-01-01,zipcode
ZCTA5 32043,12,30249,64973,1133,217900,23601,9565,20449,1879,6033,6948,4129,1460,12336,11018,1318,11018,8718,2300,2021-01-01,zipcode
ZCTA5 32044,12,2268,41214,1073,66400,1720,939,1452,296,528,553,66,9,877,813,64,813,554,259,2021-01-01,zipcode
ZCTA5 32046,12,10745,64338,766,189400,8413,3792,7605,928,3636,2248,617,176,4012,3602,410,3602,2742,860,2021-01-01,zipcode
ZCTA5 32052,12,8712,43330,685,95600,7446,5037,6714,1905,3096,1213,410,90,2982,2245,737,2245,1558,687,2021-01-01,zipcode
ZCTA5 32053,12,3729,34267,740,74300,2852,1530,2567,454,1139,693,169,112,1808,1289,519,1289,1001,288,2021-01-01,zipcode
ZCTA5 32054,12,12757,54696,699,133400,10408,6512,9061,1928,3343,2577,848,365,4004,3567,437,3567,2535,1032,2021-01-01,zipcode
ZCTA5 32055,12,16184,41065,788,122800,12442,5618,10528,1545,4110,3387,894,592,7338,6190,1148,6190,4014,2176,2021-01-01,zipcode
ZCTA5 32058,12,5411,53529,867,136100,4387,2160,3706,824,1683,1036,101,62,1694,1494,200,1494,1141,353,2021-01-01,zipcode
ZCTA5 32059,12,2670,43634,728,74600,2285,1063,2039,427,686,748,113,65,1377,1109,268,1109,806,303,2021-01-01,zipcode
ZCTA5 32060,12,23078,49604,631,123700,18640,9777,16456,3098,6160,4178,1744,1276,9519,7754,1765,7754,6152,1602,2021-01-01,zipcode
ZCTA5 32061,12,344,-666666666,-666666666,184400,308,137,157,6,93,25,33,0,85,85,0,85,72,13,2021-01-01,zipcode
ZCTA5 32062,12,1862,56311,-666666666,149600,1566,795,1265,241,646,211,86,81,984,668,316,668,521,147,2021-01-01,zipcode
ZCTA5 32063,12,14024,64533,901,183200,10939,4659,9298,1024,3507,2541,1292,934,5098,4523,575,4523,3269,1254,2021-01-01,zipcode
ZCTA5 32064,12,7433,40871,797,120800,6285,2913,5141,507,2058,1603,578,395,3516,2865,651,2865,1326,1539,2021-01-01,zipcode
ZCTA5 32065,12,39146,79984,1373,221500,30258,10670,25843,1722,6337,10497,5365,1922,14195,13336,859,13336,10305,3031,2021-01-01,zipcode
ZCTA5 32066,12,6973,57747,675,112800,6016,3264,5057,1445,2070,1182,272,88,2452,1978,474,1978,1519,459,2021-01-01,zipcode
ZCTA5 32068,12,57231,73178,1237,185300,44763,15706,38458,3383,13896,13928,5242,2009,21551,19950,1601,19950,15333,4617,2021-01-01,zipcode
ZCTA5 32071,12,2987,39531,-666666666,116700,2598,1415,2078,329,771,700,176,102,1576,1173,403,1173,994,179,2021-01-01,zipcode
ZCTA5 32072,12,80,142557,-666666666,251100,80,29,80,0,12,39,21,8,43,43,0,43,43,0,2021-01-01,zipcode
ZCTA5 32073,12,42278,67370,1200,196500,34638,12304,30566,2938,7511,12086,5377,2654,16472,15600,872,15600,9857,5743,2021-01-01,zipcode
ZCTA5 32079,12,384,52500,1564,-666666666,384,363,384,90,43,64,88,99,196,172,24,172,17,155,2021-01-01,zipcode
ZCTA5 32080,12,21001,82231,1400,400300,18808,8825,17080,574,2820,4949,5632,3105,15990,9618,6372,9618,7613,2005,2021-01-01,zipcode
ZCTA5 32081,12,20867,128570,2491,442500,15122,6561,13768,141,1616,2903,4776,4332,8158,7113,1045,7113,6295,818,2021-01-01,zipcode
ZCTA5 32082,12,28721,114291,1606,574800,23944,10356,21371,407,2314,4518,8786,5346,14627,11696,2931,11696,9529,2167,2021-01-01,zipcode
ZCTA5 32083,12,2159,55800,893,112600,1697,1124,1557,279,600,559,94,25,712,616,96,616,397,219,2021-01-01,zipcode
ZCTA5 32084,12,35618,61025,1129,228400,30543,12768,26712,2198,9335,7258,5052,2869,16668,13125,3543,13125,8972,4153,2021-01-01,zipcode
ZCTA5 32086,12,32753,63840,1309,260400,28186,11805,25388,1934,6744,9218,4497,2995,14489,12531,1958,12531,9386,3145,2021-01-01,zipcode
ZCTA5 32087,12,5605,69375,730,133500,4676,2963,4073,892,2066,978,63,74,1500,1209,291,1209,809,400,2021-01-01,zipcode
ZCTA5 32091,12,15618,48175,805,109800,12703,5706,11302,1551,5019,3443,834,455,6712,5457,1255,5457,3316,2141,2021-01-01,zipcode
ZCTA5 32092,12,42245,91116,1864,335100,33670,12577,29412,2579,6691,7118,8093,4931,16337,14569,1768,14569,12889,1680,2021-01-01,zipcode
ZCTA5 32094,12,3358,58086,808,109200,2776,1382,2557,444,1259,657,84,113,1140,925,215,925,724,201,2021-01-01,zipcode
ZCTA5 32095,12,15021,92941,1193,377300,11529,4155,10094,501,2191,2569,2579,2254,5436,5218,218,5218,4524,694,2021-01-01,zipcode
ZCTA5 32096,12,2793,41192,558,93300,2237,1310,2014,470,862,456,184,42,1410,1142,268,1142,902,240,2021-01-01,zipcode
ZCTA5 32097,12,20752,73779,1423,223500,16424,5838,14215,1492,4802,4615,2225,1081,8212,7650,562,7650,5962,1688,2021-01-01,zipcode
ZCTA5 32102,12,2319,48500,1172,159600,2013,1205,1876,452,715,380,234,95,1749,1120,629,1120,980,140,2021-01-01,zipcode
ZCTA5 32110,12,8909,40526,936,135600,7290,3518,6413,807,3206,1392,693,315,3872,3272,600,3272,2323,949,2021-01-01,zipcode
ZCTA5 32112,12,7501,38913,674,113800,6073,2964,5207,2053,1609,995,414,136,3644,2767,877,2767,1909,858,2021-01-01,zipcode
ZCTA5 32113,12,4966,38526,811,101500,3969,1935,3408,501,1517,993,195,202,2525,1927,598,1927,1494,433,2021-01-01,zipcode
ZCTA5 32114,12,34560,36034,1004,136500,29187,13529,22825,3210,7466,7599,3126,1424,16681,14270,2411,14270,4592,9678,2021-01-01,zipcode
ZCTA5 32117,12,29100,44139,1157,132300,23941,10221,21115,2303,7640,7028,2987,1157,14177,12399,1778,12399,6042,6357,2021-01-01,zipcode
ZCTA5 32118,12,18123,45962,1095,269900,16251,8179,15083,1034,4460,4868,2843,1878,16232,9639,6593,9639,5986,3653,2021-01-01,zipcode
ZCTA5 32119,12,22677,46606,1172,159700,19446,8937,17055,1674,5268,5859,2696,1558,12026,10403,1623,10403,6414,3989,2021-01-01,zipcode
ZCTA5 32124,12,7449,70455,1417,271500,6663,4119,6077,1039,2108,1375,927,628,2571,2312,259,2312,1890,422,2021-01-01,zipcode
ZCTA5 32127,12,28136,57760,1147,230200,24526,11321,22270,1615,6327,7773,3894,2661,15986,12799,3187,12799,9477,3322,2021-01-01,zipcode
ZCTA5 32128,12,21811,82553,1470,303200,18246,8952,15953,617,3679,5103,4524,2030,9372,8901,471,8901,7299,1602,2021-01-01,zipcode
ZCTA5 32129,12,22670,53091,1244,189100,20198,8220,17119,1510,5478,6333,2639,1159,11490,10166,1324,10166,7180,2986,2021-01-01,zipcode
ZCTA5 32130,12,4756,52889,1179,206200,3941,1895,3517,329,1564,1045,383,196,1894,1661,233,1661,1410,251,2021-01-01,zipcode
ZCTA5 32131,12,4273,56553,864,173700,3696,1834,3467,563,1264,951,425,264,2042,1665,377,1665,1323,342,2021-01-01,zipcode
ZCTA5 32132,12,7667,43709,896,182300,6948,3323,6503,487,2424,2604,502,486,4122,3741,381,3741,3119,622,2021-01-01,zipcode
ZCTA5 32133,12,711,123985,-666666666,592900,711,181,546,0,48,16,223,259,345,294,51,294,264,30,2021-01-01,zipcode
ZCTA5 32134,12,7147,39586,653,95900,6399,3960,5919,878,2682,1788,429,142,5792,3198,2594,3198,2887,311,2021-01-01,zipcode
ZCTA5 32136,12,8209,58433,1168,334700,7488,4689,7183,187,2000,2547,1485,964,5566,3905,1661,3905,3239,666,2021-01-01,zipcode
ZCTA5 32137,12,44687,66902,1491,270600,38905,20234,35137,2169,10424,11050,7301,4193,23313,18346,4967,18346,15523,2823,2021-01-01,zipcode
ZCTA5 32139,12,853,52606,-666666666,78600,801,637,784,162,442,70,75,35,533,338,195,338,317,21,2021-01-01,zipcode
ZCTA5 32140,12,1802,54032,902,73100,1473,657,1226,242,457,461,60,6,700,570,130,570,495,75,2021-01-01,zipcode
ZCTA5 32141,12,18859,54326,1151,187900,16369,7675,15365,1271,5421,5699,1964,1010,9540,8592,948,8592,7567,1025,2021-01-01,zipcode
ZCTA5 32145,12,5539,66075,933,162300,4294,1728,3771,627,1263,1297,478,106,2357,1989,368,1989,1536,453,2021-01-01,zipcode
ZCTA5 32147,12,1961,31398,-666666666,82700,1505,495,1210,77,802,182,149,0,796,796,0,796,666,130,2021-01-01,zipcode
ZCTA5 32148,12,10552,36008,679,63100,8442,4887,7564,1478,3770,1483,664,169,5346,4359,987,4359,3401,958,2021-01-01,zipcode
ZCTA5 32157,12,376,52292,884,139300,333,133,306,106,63,102,35,0,278,163,115,163,93,70,2021-01-01,zipcode
ZCTA5 32159,12,29613,49198,1106,214700,27349,18661,26073,1756,8528,9040,3559,3190,18858,15676,3182,15676,12663,3013,2021-01-01,zipcode
ZCTA5 32162,12,51373,66366,1541,281600,51257,46032,51233,1253,12856,15336,13252,8536,35958,29994,5964,29994,28334,1660,2021-01-01,zipcode
ZCTA5 32164,12,50008,63091,1451,231600,41226,19054,37206,3491,12054,13307,5770,2584,20840,18982,1858,18982,13620,5362,2021-01-01,zipcode
ZCTA5 32168,12,30060,58750,1267,252300,26105,13230,23970,2155,7138,7837,4844,1996,15682,13517,2165,13517,10643,2874,2021-01-01,zipcode
ZCTA5 32169,12,10400,80503,1531,375000,9861,5833,9585,261,1851,3459,2240,1774,12612,5889,6723,5889,4954,935,2021-01-01,zipcode
ZCTA5 32174,12,51319,60911,1131,238700,43862,21775,39957,3342,10343,14072,8075,4125,25294,22934,2360,22934,18094,4840,2021-01-01,zipcode
ZCTA5 32176,12,13741,54958,1257,272000,12651,6298,11679,673,2895,3960,2417,1734,10358,6885,3473,6885,5407,1478,2021-01-01,zipcode
ZCTA5 32177,12,26087,39133,762,127000,20150,10556,17844,2405,8467,5026,1212,734,11271,10055,1216,10055,6246,3809,2021-01-01,zipcode
ZCTA5 32179,12,8043,38671,923,103000,7054,3631,6325,937,2316,2054,586,432,5053,3665,1388,3665,2951,714,2021-01-01,zipcode
ZCTA5 32180,12,5144,63476,860,177400,3664,1746,3089,663,1006,1127,199,94,1563,1409,154,1409,1065,344,2021-01-01,zipcode
ZCTA5 32181,12,3119,37898,797,88100,2465,1323,1885,253,782,631,143,76,1492,1159,333,1159,780,379,2021-01-01,zipcode
ZCTA5 32187,12,1337,35951,950,128300,1183,778,1075,157,368,326,208,16,654,615,39,615,520,95,2021-01-01,zipcode
ZCTA5 32189,12,5287,37075,672,79000,4539,2515,4140,878,1282,1474,446,60,3562,2449,1113,2449,1663,786,2021-01-01,zipcode
ZCTA5 32190,12,1524,62837,686,208900,1178,595,1010,143,477,167,129,94,617,513,104,513,397,116,2021-01-01,zipcode
ZCTA5 32193,12,1057,44125,832,207500,890,590,795,148,363,171,68,45,886,560,326,560,464,96,2021-01-01,zipcode
ZCTA5 32195,12,2984,55000,-666666666,141500,2713,1280,2345,493,874,804,139,35,1270,1114,156,1114,1049,65,2021-01-01,zipcode
ZCTA5 32202,12,6717,33224,850,153600,6244,4439,5281,1204,1644,1513,638,282,2645,2149,496,2149,224,1925,2021-01-01,zipcode
ZCTA5 32204,12,7750,49879,972,222400,6812,1904,6051,534,1200,1546,1707,1064,4995,4314,681,4314,1086,3228,2021-01-01,zipcode
ZCTA5 32205,12,31398,53488,1015,203700,25824,8075,23592,2671,6027,6815,5078,3001,16342,14447,1895,14447,7522,6925,2021-01-01,zipcode
ZCTA5 32206,12,16406,31783,822,102600,12739,5123,10968,2130,3780,3242,1224,592,9187,6840,2347,6840,3191,3649,2021-01-01,zipcode
ZCTA5 32207,12,36711,52846,954,189500,29388,9479,25732,3533,6225,6731,5712,3531,18478,15890,2588,15890,7857,8033,2021-01-01,zipcode
ZCTA5 32208,12,32244,36707,1036,99500,24867,11436,22116,3811,7898,7600,1855,952,15392,13365,2027,13365,7114,6251,2021-01-01,zipcode
ZCTA5 32209,12,35915,26890,853,68300,27883,13776,24274,4876,10380,6694,1632,692,17671,14517,3154,14517,6680,7837,2021-01-01,zipcode
ZCTA5 32210,12,66824,51262,1049,157100,52024,17283,45220,5613,15671,14149,6741,3046,28915,26474,2441,26474,14017,12457,2021-01-01,zipcode
ZCTA5 32211,12,35668,49205,971,153100,27224,8758,23570,2776,8795,7584,3191,1224,14858,13301,1557,13301,6844,6457,2021-01-01,zipcode
ZCTA5 32212,12,2275,44241,1741,-666666666,1899,95,513,15,83,312,54,49,242,237,5,237,2,235,2021-01-01,zipcode
ZCTA5 32216,12,39762,54739,1076,192200,32519,11339,28556,2972,8361,8325,6002,2896,19346,17224,2122,17224,7763,9461,2021-01-01,zipcode
ZCTA5 32217,12,20303,54036,999,240400,16564,5584,14812,910,3604,4407,3825,2066,9498,8807,691,8807,4860,3947,2021-01-01,zipcode
ZCTA5 32218,12,68534,59938,1174,196900,51605,17910,44458,4548,13566,15436,7415,3493,26129,23743,2386,23743,15356,8387,2021-01-01,zipcode
ZCTA5 32219,12,14169,56195,917,156500,11263,5031,9680,1234,3948,2604,1335,559,5384,5019,365,5019,4121,898,2021-01-01,zipcode
ZCTA5 32220,12,12020,66808,1092,166800,9567,3286,8629,824,3658,2883,756,508,4898,4604,294,4604,3850,754,2021-01-01,zipcode
ZCTA5 32221,12,29346,66846,1374,182400,23268,8711,19569,2377,6491,6252,3067,1382,11041,10397,644,10397,7764,2633,2021-01-01,zipcode
ZCTA5 32222,12,14879,71077,1407,221400,12050,3178,10889,917,2763,4907,1772,530,6009,5450,559,5450,4043,1407,2021-01-01,zipcode
ZCTA5 32223,12,25824,88364,1324,292000,21351,8159,18960,725,3849,6804,4810,2772,10610,10311,299,10311,8600,1711,2021-01-01,zipcode
ZCTA5 32224,12,41366,81185,1391,347000,34549,11605,25782,872,4428,7101,8341,5040,16575,15366,1209,15366,8797,6569,2021-01-01,zipcode
ZCTA5 32225,12,55401,78411,1430,251800,44166,14115,38239,1732,9083,12340,10363,4721,22923,21065,1858,21065,14131,6934,2021-01-01,zipcode
ZCTA5 32226,12,18097,88070,1792,262900,14305,5518,12988,1250,3599,4271,2526,1342,7329,6389,940,6389,5910,479,2021-01-01,zipcode
ZCTA5 32227,12,3510,71667,1759,-666666666,2598,327,1177,23,320,622,121,91,659,544,115,544,0,544,2021-01-01,zipcode
ZCTA5 32228,12,412,-666666666,-666666666,-666666666,412,0,73,0,0,54,19,0,0,0,0,0,0,0,2021-01-01,zipcode
ZCTA5 32233,12,24489,70781,1251,337800,20663,6280,17555,1016,4129,5159,4771,2480,11240,9901,1339,9901,5902,3999,2021-01-01,zipcode
ZCTA5 32234,12,7780,72825,799,171400,5804,1872,5045,813,2102,1391,559,180,2978,2750,228,2750,2272,478,2021-01-01,zipcode
ZCTA5 32244,12,63709,55700,1206,163800,48854,15535,43213,3659,15447,14970,6822,2315,25494,23759,1735,23759,13088,10671,2021-01-01,zipcode
ZCTA5 32246,12,56222,68500,1352,225800,45195,12815,39021,2912,9378,11992,10360,4379,24852,22370,2482,22370,12366,10004,2021-01-01,zipcode
ZCTA5 32250,12,28859,95474,1615,398500,24129,7597,21342,1362,3690,4962,6886,4442,14294,12403,1891,12403,8386,4017,2021-01-01,zipcode
ZCTA5 32254,12,13798,34159,924,65400,10606,4815,9108,2503,3757,2089,588,171,6177,5100,1077,5100,2521,2579,2021-01-01,zipcode
ZCTA5 32256,12,48988,64543,1319,279500,41274,12171,34563,1265,5830,8857,12365,6246,24489,22519,1970,22519,8446,14073,2021-01-01,zipcode
ZCTA5 32257,12,41487,67739,1199,235400,33440,10928,29613,2467,7444,9315,6761,3626,18147,16968,1179,16968,10527,6441,2021-01-01,zipcode
ZCTA5 32258,12,41004,89671,1669,261700,31118,9239,26772,656,4835,8980,8459,3842,15366,14831,535,14831,9898,4933,2021-01-01,zipcode
ZCTA5 32259,12,62354,134552,2013,372100,46110,15127,39739,760,7443,10193,13108,8235,20370,19000,1370,19000,16458,2542,2021-01-01,zipcode
ZCTA5 32266,12,6880,98856,1365,462200,5847,1542,5083,145,597,1176,2013,1152,3407,2957,450,2957,2092,865,2021-01-01,zipcode
ZCTA5 32277,12,33948,51545,1074,188000,27042,9148,21795,1994,7409,7337,3736,1319,13784,12859,925,12859,6196,6663,2021-01-01,zipcode
ZCTA5 32301,12,32425,46241,1037,166000,27265,8248,19690,1733,3585,5560,5231,3581,16627,14163,2464,14163,4184,9979,2021-01-01,zipcode
ZCTA5 32303,12,50598,52450,1132,166300,42353,11667,31088,1742,6290,9434,8106,5516,24005,21986,2019,21986,10783,11203,2021-01-01,zipcode
ZCTA5 32304,12,45853,26060,996,129700,42534,15574,16071,2013,3592,5256,3122,2088,22038,18175,3863,18175,2600,15575,2021-01-01,zipcode
ZCTA5 32305,12,20815,47602,870,117800,15782,6004,13273,2249,4267,4113,1482,1162,8727,7603,1124,7603,4687,2916,2021-01-01,zipcode
ZCTA5 32308,12,22415,65726,1138,240400,19093,7148,16571,521,2737,4047,4704,4562,11655,10827,828,10827,5669,5158,2021-01-01,zipcode
ZCTA5 32309,12,33505,90858,1135,288500,26116,9333,22495,613,3106,5549,7530,5697,13614,13011,603,13011,10276,2735,2021-01-01,zipcode
ZCTA5 32310,12,14090,37225,859,89800,11360,4781,8551,1438,2947,2121,1378,667,7556,5775,1781,5775,2913,2862,2021-01-01,zipcode
ZCTA5 32311,12,21231,76494,1284,239000,17188,5125,14948,700,2968,3300,4293,3687,9548,8555,993,8555,5459,3096,2021-01-01,zipcode
ZCTA5 32312,12,31956,107615,1335,327900,25440,8301,21567,464,1962,5247,7759,6135,12931,12229,702,12229,10430,1799,2021-01-01,zipcode
ZCTA5 32317,12,14492,102318,1250,286900,11750,4413,10172,391,1700,2703,2906,2472,5697,5353,344,5353,4966,387,2021-01-01,zipcode
ZCTA5 32320,12,4010,55390,872,188400,3541,1550,3286,773,1012,826,389,286,2229,1801,428,1801,1297,504,2021-01-01,zipcode
ZCTA5 32321,12,6443,41723,805,99200,5502,3481,4703,1191,1955,904,406,247,2289,1662,627,1662,1294,368,2021-01-01,zipcode
ZCTA5 32322,12,3824,36197,871,173700,3312,2470,3073,801,1222,687,224,139,1902,951,951,951,771,180,2021-01-01,zipcode
ZCTA5 32323,12,104,-666666666,-666666666,-666666666,104,104,104,0,31,32,20,21,299,53,246,53,42,11,2021-01-01,zipcode
ZCTA5 32324,12,5039,47448,573,63400,4518,2880,4191,743,2001,958,307,182,2228,1843,385,1843,1221,622,2021-01-01,zipcode
ZCTA5 32327,12,29946,74075,968,184000,24529,10262,21543,2459,7797,6906,2569,1812,11276,9942,1334,9942,8311,1631,2021-01-01,zipcode
ZCTA5 32328,12,3889,52157,971,251900,3145,1382,2750,452,692,813,433,360,3027,1508,1519,1508,1222,286,2021-01-01,zipcode
ZCTA5 32330,12,779,41850,725,96100,558,311,445,178,144,96,27,0,271,212,59,212,97,115,2021-01-01,zipcode
ZCTA5 32331,12,4775,39831,738,69500,3894,2389,3390,571,1656,853,265,45,2320,1725,595,1725,1461,264,2021-01-01,zipcode
ZCTA5 32332,12,1178,26538,651,75300,1003,595,865,276,312,126,89,62,612,520,92,520,231,289,2021-01-01,zipcode
ZCTA5 32333,12,11695,53814,808,159600,9706,4435,8784,1254,2395,2383,2025,727,5091,4494,597,4494,3696,798,2021-01-01,zipcode
ZCTA5 32334,12,1494,48386,707,104600,1334,551,999,120,390,368,72,49,769,581,188,581,466,115,2021-01-01,zipcode
ZCTA5 32336,12,1553,33295,805,68200,1224,766,1071,174,409,253,160,75,842,531,311,531,389,142,2021-01-01,zipcode
ZCTA5 32340,12,10456,35230,712,113400,8807,5182,7832,1583,2835,2340,639,435,4472,3526,946,3526,2386,1140,2021-01-01,zipcode
ZCTA5 32343,12,3416,56288,940,164500,2385,649,1952,254,544,693,262,199,1191,1098,93,1098,936,162,2021-01-01,zipcode
ZCTA5 32344,12,12151,50635,675,162500,10436,5200,9285,1568,3178,2460,1365,714,5660,4577,1083,4577,3488,1089,2021-01-01,zipcode
ZCTA5 32346,12,2049,45647,1418,201500,1700,1005,1600,296,555,560,132,57,1670,873,797,873,716,157,2021-01-01,zipcode
ZCTA5 32347,12,7072,49430,724,112500,5327,2449,4608,483,1729,1592,586,218,3178,2455,723,2455,1738,717,2021-01-01,zipcode
ZCTA5 32348,12,13032,44735,853,73100,11113,7303,9870,2247,4555,2057,669,342,5362,3920,1442,3920,3030,890,2021-01-01,zipcode
ZCTA5 32350,12,1421,41139,648,77900,1292,809,1181,136,443,388,196,18,851,681,170,681,558,123,2021-01-01,zipcode
ZCTA5 32351,12,17508,35456,655,85200,13759,7528,11730,2722,4444,2768,1002,794,7088,5792,1296,5792,3967,1825,2021-01-01,zipcode
ZCTA5 32352,12,4618,44461,913,107600,3613,1611,3184,560,1245,949,274,156,2228,1810,418,1810,1400,410,2021-01-01,zipcode
ZCTA5 32355,12,298,43125,880,218800,282,189,270,14,88,153,15,0,280,152,128,152,122,30,2021-01-01,zipcode
ZCTA5 32356,12,0,-666666666,-666666666,-666666666,0,0,0,0,0,0,0,0,20,0,20,0,0,0,2021-01-01,zipcode
ZCTA5 32358,12,1256,69712,888,172100,1090,544,1072,80,271,336,322,63,1206,545,661,545,502,43,2021-01-01,zipcode
ZCTA5 32359,12,958,44175,-666666666,109700,919,542,898,84,322,375,66,51,2096,497,1599,497,443,54,2021-01-01,zipcode
ZCTA5 32361,12,430,-666666666,908,80200,315,79,295,31,111,134,19,0,207,207,0,207,183,24,2021-01-01,zipcode
ZCTA5 32399,12,0,-666666666,-666666666,-666666666,0,0,0,0,0,0,0,0,0,0,0,0,0,0,2021-01-01,zipcode
ZCTA5 32401,12,19208,41484,925,152300,15805,6892,14157,2197,4691,4525,1704,1040,10116,8804,1312,8804,4714,4090,2021-01-01,zipcode
ZCTA5 32403,12,1416,67500,1715,-666666666,1037,210,493,0,69,201,132,91,383,266,117,266,0,266,2021-01-01,zipcode
ZCTA5 32404,12,39832,58853,1139,173100,32182,13256,27960,3859,8755,10460,2958,1928,16870,14273,2597,14273,10167,4106,2021-01-01,zipcode
ZCTA5 32405,12,29999,61947,1219,191600,24030,9213,20642,1705,5564,7348,3519,2506,13602,12216,1386,12216,7482,4734,2021-01-01,zipcode
ZCTA5 32407,12,14355,64102,1667,279500,12033,3870,10559,900,2220,3746,2374,1319,11234,6153,5081,6153,3550,2603,2021-01-01,zipcode
ZCTA5 32408,12,19821,62386,1149,271400,16452,5771,15167,724,3362,5756,3660,1665,16854,8706,8148,8706,6157,2549,2021-01-01,zipcode
ZCTA5 32409,12,10004,53811,1015,158200,8054,3510,7176,806,2737,2273,988,372,4248,3729,519,3729,3208,521,2021-01-01,zipcode
ZCTA5 32410,12,517,56875,1423,262200,497,242,497,7,91,235,101,63,881,279,602,279,209,70,2021-01-01,zipcode
ZCTA5 32413,12,14472,71125,1247,280900,13071,5147,11710,718,3044,4293,2290,1365,15340,6835,8505,6835,5028,1807,2021-01-01,zipcode
ZCTA5 32420,12,2275,41267,640,115300,2030,973,1864,334,748,606,145,31,1497,1178,319,1178,1090,88,2021-01-01,zipcode
ZCTA5 32421,12,4197,37029,646,83500,3287,1741,2971,589,1155,987,211,29,1797,1445,352,1445,1291,154,2021-01-01,zipcode
ZCTA5 32423,12,974,48958,1660,146900,887,507,828,30,335,309,146,8,635,487,148,487,446,41,2021-01-01,zipcode
ZCTA5 32424,12,7208,39907,527,113900,6081,3905,5428,1220,2399,1160,432,217,2797,2179,618,2179,1587,592,2021-01-01,zipcode
ZCTA5 32425,12,14135,39515,774,99600,11590,6710,10196,2232,4562,2625,568,209,5909,4766,1143,4766,3447,1319,2021-01-01,zipcode
ZCTA5 32426,12,802,32239,-666666666,78200,711,482,668,264,249,123,27,5,384,294,90,294,276,18,2021-01-01,zipcode
ZCTA5 32427,12,1088,31250,701,108200,901,418,706,213,218,212,28,35,488,469,19,469,269,200,2021-01-01,zipcode
ZCTA5 32428,12,17578,43542,729,130200,14365,8051,12874,1989,5356,3716,1221,592,7167,5936,1231,5936,4704,1232,2021-01-01,zipcode
ZCTA5 32430,12,837,52685,-666666666,119100,677,172,645,123,314,202,6,0,334,326,8,326,246,80,2021-01-01,zipcode
ZCTA5 32431,12,4412,52436,709,113500,3664,1845,3310,447,1632,778,271,182,2201,1780,421,1780,1397,383,2021-01-01,zipcode
ZCTA5 32432,12,0,-666666666,-666666666,-666666666,0,0,0,0,0,0,0,0,0,0,0,0,0,0,2021-01-01,zipcode
ZCTA5 32433,12,19500,45734,873,97500,14947,6964,13496,2273,5524,3906,1067,726,8013,6971,1042,6971,5271,1700,2021-01-01,zipcode
ZCTA5 32435,12,6638,47175,764,143100,5343,2161,4539,481,1548,1497,705,308,3137,2694,443,2694,1900,794,2021-01-01,zipcode
ZCTA5 32437,12,601,38750,806,108900,511,204,471,61,243,147,18,2,326,282,44,282,207,75,2021-01-01,zipcode
ZCTA5 32438,12,4920,38490,772,68100,3772,1803,3057,681,1067,972,293,44,1936,1756,180,1756,1549,207,2021-01-01,zipcode
ZCTA5 32439,12,13306,68341,1137,257700,10745,3989,9543,522,2458,3522,2132,909,6253,5303,950,5303,4225,1078,2021-01-01,zipcode
ZCTA5 32440,12,7731,46592,710,88600,6751,4138,5711,1266,2388,1363,393,301,2361,1999,362,1999,1357,642,2021-01-01,zipcode
ZCTA5 32442,12,3568,41667,682,122800,2793,1399,2408,294,1052,810,125,127,1689,1396,293,1396,886,510,2021-01-01,zipcode
ZCTA5 32443,12,3082,40430,673,100000,2396,1325,2070,308,739,711,174,138,1369,1109,260,1109,946,163,2021-01-01,zipcode
ZCTA5 32444,12,21148,76712,1367,235600,15968,5146,13578,825,3349,5198,2916,1290,8544,7600,944,7600,5504,2096,2021-01-01,zipcode
ZCTA5 32445,12,2483,46333,696,69800,2176,1726,2013,697,724,478,68,46,571,474,97,474,313,161,2021-01-01,zipcode
ZCTA5 32446,12,11161,50822,792,130200,9124,4119,7866,758,2764,2726,865,753,4515,3916,599,3916,2661,1255,2021-01-01,zipcode
ZCTA5 32448,12,7524,33614,660,88000,6116,3444,5113,635,2307,1673,343,155,3882,3349,533,3349,2309,1040,2021-01-01,zipcode
ZCTA5 32449,12,998,-666666666,-666666666,66300,699,280,699,258,227,135,72,7,485,340,145,340,309,31,2021-01-01,zipcode
ZCTA5 32455,12,3953,43034,687,84500,3440,1614,3002,573,1578,586,222,43,2139,1694,445,1694,1382,312,2021-01-01,zipcode
ZCTA5 32456,12,8088,64456,1241,262400,6777,3096,6304,338,1620,2070,1397,879,6374,3655,2719,3655,2782,873,2021-01-01,zipcode
ZCTA5 32459,12,18544,94648,1727,432800,15358,5131,14020,736,2667,3962,4476,2179,15661,7880,7781,7880,6211,1669,2021-01-01,zipcode
ZCTA5 32460,12,5891,43942,742,95200,5256,3790,4759,1009,1775,1494,253,228,1976,1690,286,1690,1284,406,2021-01-01,zipcode
ZCTA5 32461,12,2158,127148,2235,677700,1833,944,1813,64,310,496,643,300,5097,953,4144,953,783,170,2021-01-01,zipcode
ZCTA5 32462,12,3691,33507,750,112000,3136,1737,2715,506,1182,787,111,129,1854,1376,478,1376,1198,178,2021-01-01,zipcode
ZCTA5 32463,12,191,45250,698,151400,167,61,136,14,49,68,0,5,90,81,9,81,45,36,2021-01-01,zipcode
ZCTA5 32464,12,3729,50506,727,75400,3150,1404,2866,446,1154,771,293,202,1991,1565,426,1565,1411,154,2021-01-01,zipcode
ZCTA5 32465,12,7873,42394,677,118000,7066,4891,6179,1263,2387,1857,455,217,3224,2273,951,2273,1841,432,2021-01-01,zipcode
ZCTA5 32466,12,5718,60548,950,130000,4538,2207,4025,441,1550,1739,179,116,2444,2019,425,2019,1666,353,2021-01-01,zipcode
ZCTA5 32501,12,10985,32541,825,195100,8793,4356,7517,1144,2324,2059,1173,817,5518,4474,1044,4474,2043,2431,2021-01-01,zipcode
ZCTA5 32502,12,3799,60113,1046,209700,3106,1030,2717,249,597,887,539,445,2192,1725,467,1725,891,834,2021-01-01,zipcode
ZCTA5 32503,12,32950,56486,1039,204300,27364,9938,21106,1384,4775,7069,4652,3226,14457,12984,1473,12984,8617,4367,2021-01-01,zipcode
ZCTA5 32504,12,21687,64147,1118,203500,17588,6914,15121,1055,2825,5103,3371,2767,10182,9608,574,9608,5817,3791,2021-01-01,zipcode
ZCTA5 32505,12,27661,38863,954,76400,21196,9274,18774,2925,7307,6163,1455,924,12998,10852,2146,10852,5232,5620,2021-01-01,zipcode
ZCTA5 32506,12,37202,54391,1090,154500,30134,11728,25276,3227,6912,9582,3791,1764,16438,14482,1956,14482,8662,5820,2021-01-01,zipcode
ZCTA5 32507,12,33615,58443,1039,192000,26916,10025,22894,2069,5390,8857,4359,2219,18859,13618,5241,13618,8397,5221,2021-01-01,zipcode
ZCTA5 32508,12,5423,53063,1424,-666666666,5004,315,1168,6,218,433,423,88,659,555,104,555,0,555,2021-01-01,zipcode
ZCTA5 32509,12,566,-666666666,-666666666,-666666666,566,566,566,113,189,225,0,39,0,0,0,0,0,0,2021-01-01,zipcode
ZCTA5 32511,12,1292,-666666666,-666666666,-666666666,1292,36,186,0,27,105,54,0,0,0,0,0,0,0,2021-01-01,zipcode
ZCTA5 32514,12,42059,57018,1143,170600,33900,12208,27703,2129,7090,9484,5703,3297,19013,17435,1578,17435,8239,9196,2021-01-01,zipcode
ZCTA5 32526,12,39318,64543,1162,162800,32019,13285,28101,2143,8225,10936,4748,2049,16388,15004,1384,15004,11933,3071,2021-01-01,zipcode
ZCTA5 32530,12,92,-666666666,-666666666,-666666666,54,30,54,0,0,54,0,0,20,20,0,20,20,0,2021-01-01,zipcode
ZCTA5 32531,12,6452,72668,869,218300,5095,2059,4830,274,1946,1566,577,467,3143,2748,395,2748,2349,399,2021-01-01,zipcode
ZCTA5 32533,12,29568,80973,932,201300,23704,9166,20765,1605,5669,7827,3585,2079,11584,10783,801,10783,9156,1627,2021-01-01,zipcode
ZCTA5 32534,12,15931,53828,1132,139900,13081,4529,11479,722,3499,4802,1787,669,7329,6778,551,6778,4224,2554,2021-01-01,zipcode
ZCTA5 32535,12,5689,37076,627,74100,5032,3286,4363,1001,2032,1042,161,127,2023,1669,354,1669,1148,521,2021-01-01,zipcode
ZCTA5 32536,12,24643,72818,1165,211700,19354,6827,15902,1428,4359,5792,2486,1837,9584,8780,804,8780,5718,3062,2021-01-01,zipcode
ZCTA5 32539,12,30924,62129,1108,200800,24253,10219,20239,1927,5792,7863,3181,1476,11588,10637,951,10637,8030,2607,2021-01-01,zipcode
ZCTA5 32541,12,20559,84319,1669,397700,17272,5658,15662,911,2710,4838,4941,2262,17665,9104,8561,9104,6007,3097,2021-01-01,zipcode
ZCTA5 32542,12,4244,57553,1814,-666666666,3214,325,1545,71,208,721,427,118,1105,881,224,881,0,881,2021-01-01,zipcode
ZCTA5 32544,12,2169,36408,1615,-666666666,1495,174,782,0,111,202,427,42,456,416,40,416,0,416,2021-01-01,zipcode
ZCTA5 32547,12,32556,55853,1157,209800,26451,8578,23072,2107,5893,8933,4145,1994,15485,14313,1172,14313,7652,6661,2021-01-01,zipcode
ZCTA5 32548,12,22938,55726,1103,225200,18784,6387,16524,1265,4707,5703,3012,1837,13638,9937,3701,9937,5717,4220,2021-01-01,zipcode
ZCTA5 32550,12,8648,74683,1546,432800,7776,3858,7094,118,1147,2035,2190,1604,13969,4251,9718,4251,3034,1217,2021-01-01,zipcode
ZCTA5 32561,12,9610,108205,1684,463800,7818,3503,7188,202,711,2099,2261,1915,6583,4123,2460,4123,3240,883,2021-01-01,zipcode
ZCTA5 32563,12,28186,87054,1402,284200,23044,8887,19946,792,4608,6769,5101,2676,11992,10811,1181,10811,8674,2137,2021-01-01,zipcode
ZCTA5 32564,12,2577,64118,866,116700,2183,1071,1835,185,480,891,194,85,1071,992,79,992,860,132,2021-01-01,zipcode
ZCTA5 32565,12,5192,65313,1045,145300,4086,1727,3602,393,1262,1284,541,122,2455,2039,416,2039,1663,376,2021-01-01,zipcode
ZCTA5 32566,12,42753,90381,1541,270400,32896,11758,28369,1337,6415,11800,5188,3629,17366,15286,2080,15286,12358,2928,2021-01-01,zipcode
ZCTA5 32567,12,4554,63289,704,162500,3320,1580,2727,339,859,1228,184,117,1883,1574,309,1574,1251,323,2021-01-01,zipcode
ZCTA5 32568,12,3269,67125,917,173800,2636,1072,2315,213,694,990,268,150,1322,1214,108,1214,1052,162,2021-01-01,zipcode
ZCTA5 32569,12,12184,61201,1092,234500,10380,3240,9209,629,2238,2886,2419,1037,5336,4828,508,4828,3467,1361,2021-01-01,zipcode
ZCTA5 32570,12,33099,66310,1147,182600,27482,11140,23764,1938,7494,8591,4137,1604,15005,13445,1560,13445,9019,4426,2021-01-01,zipcode
ZCTA5 32571,12,37727,73760,1075,213100,29314,12304,25141,1810,6891,8827,5120,2493,14374,13461,913,13461,11188,2273,2021-01-01,zipcode
ZCTA5 32577,12,4453,62980,880,165800,3643,1441,3115,242,904,1093,697,179,2096,1855,241,1855,1593,262,2021-01-01,zipcode
ZCTA5 32578,12,34015,93706,1440,324500,26548,9800,23228,652,4919,7594,5307,4756,14189,12862,1327,12862,9498,3364,2021-01-01,zipcode
ZCTA5 32579,12,10452,88722,1422,329100,8581,3226,7591,403,1491,1915,1998,1784,4923,4452,471,4452,3105,1347,2021-01-01,zipcode
ZCTA5 32580,12,3860,73211,1177,285900,2978,874,2634,159,550,1152,572,201,1834,1535,299,1535,968,567,2021-01-01,zipcode
ZCTA5 32583,12,30379,72348,1023,177200,25967,12988,23383,3552,7898,7554,2737,1642,10478,9570,908,9570,7642,1928,2021-01-01,zipcode
ZCTA5 32601,12,21460,29422,943,203400,19561,7800,9630,356,1498,2436,2861,2479,10208,8603,1605,8603,2173,6430,2021-01-01,zipcode
ZCTA5 32603,12,5625,18380,953,227700,5499,3126,1192,60,83,222,324,503,2369,1740,629,1740,185,1555,2021-01-01,zipcode
ZCTA5 32605,12,28058,73145,1241,216800,23829,8267,20450,796,2499,4984,6533,5638,12163,11298,865,11298,8259,3039,2021-01-01,zipcode
ZCTA5 32606,12,23682,66777,1356,254100,19504,6845,16653,396,3117,3629,4377,5134,11714,10323,1391,10323,4873,5450,2021-01-01,zipcode
ZCTA5 32607,12,30445,43278,1056,231800,26362,9249,16665,847,2957,4483,4009,4369,15359,12175,3184,12175,4274,7901,2021-01-01,zipcode
ZCTA5 32608,12,51317,53688,1170,276700,43374,15880,30094,1527,3920,7255,7939,9453,24775,20707,4068,20707,8753,11954,2021-01-01,zipcode
ZCTA5 32609,12,19542,40619,937,126000,15928,6502,13711,1973,3747,4632,2076,1283,8456,7463,993,7463,3976,3487,2021-01-01,zipcode
ZCTA5 32612,12,7152,-666666666,-666666666,-666666666,7152,5770,16,0,4,6,2,4,4,4,0,4,0,4,2021-01-01,zipcode
ZCTA5 32615,12,14933,65588,1046,211500,11868,4496,10684,589,2799,3214,2478,1604,6737,5984,753,5984,4634,1350,2021-01-01,zipcode
ZCTA5 32616,12,149,-666666666,-666666666,-666666666,138,58,122,54,28,29,11,0,79,79,0,79,18,61,2021-01-01,zipcode
ZCTA5 32617,12,4090,41953,655,126900,3732,2155,3318,220,1605,799,595,99,1732,1432,300,1432,1253,179,2021-01-01,zipcode
ZCTA5 32618,12,8640,55129,735,169500,7234,2777,6212,725,1856,2102,735,794,3514,3229,285,3229,2635,594,2021-01-01,zipcode
ZCTA5 32619,12,5139,50370,593,106700,4356,1754,3541,501,1570,1133,234,103,2226,2013,213,2013,1735,278,2021-01-01,zipcode
ZCTA5 32621,12,4703,45870,673,92300,3977,2040,3513,424,1523,1134,360,72,2185,2016,169,2016,1591,425,2021-01-01,zipcode
ZCTA5 32622,12,1510,60984,638,167500,1167,439,1033,152,322,303,136,120,628,575,53,575,360,215,2021-01-01,zipcode
ZCTA5 32625,12,1527,51447,878,212900,1333,650,1134,84,355,336,161,198,1310,682,628,682,528,154,2021-01-01,zipcode
ZCTA5 32626,12,8950,40037,733,122900,7182,3876,6451,750,3004,1839,623,235,4593,3781,812,3781,2888,893,2021-01-01,zipcode
ZCTA5 32628,12,5262,38787,753,82900,4377,2844,3824,696,1938,835,310,45,1903,1581,322,1581,1264,317,2021-01-01,zipcode
ZCTA5 32631,12,366,-666666666,-666666666,139400,333,174,333,0,112,124,97,0,235,183,52,183,183,0,2021-01-01,zipcode
ZCTA5 32639,12,248,37056,-666666666,-666666666,194,137,194,20,118,0,31,25,182,127,55,127,114,13,2021-01-01,zipcode
ZCTA5 32640,12,10543,49560,917,129200,8759,4644,7990,1398,2888,2455,683,566,5225,4028,1197,4028,3385,643,2021-01-01,zipcode
ZCTA5 32641,12,17035,38530,907,105700,12888,5872,11194,1719,4169,3340,1401,565,6122,5142,980,5142,2898,2244,2021-01-01,zipcode
ZCTA5 32643,12,12260,67490,939,190400,9271,4084,8062,958,2374,3088,1110,532,4722,4171,551,4171,3523,648,2021-01-01,zipcode
ZCTA5 32648,12,369,71750,-666666666,171300,254,112,196,40,75,73,8,0,528,103,425,103,103,0,2021-01-01,zipcode
ZCTA5 32653,12,15799,74386,935,208400,12295,4822,11084,424,1965,3376,2705,2614,6747,6383,364,6383,5253,1130,2021-01-01,zipcode
ZCTA5 32656,12,13900,52758,895,154300,11062,5113,9408,1107,3266,3431,1024,580,6279,5103,1176,5103,4145,958,2021-01-01,zipcode
ZCTA5 32658,12,446,64063,-666666666,68500,404,177,280,43,98,120,19,0,79,73,6,73,58,15,2021-01-01,zipcode
ZCTA5 32664,12,290,54663,1109,173600,223,119,223,0,59,68,62,34,175,139,36,139,106,33,2021-01-01,zipcode
ZCTA5 32666,12,6804,58929,569,164000,5839,2825,5316,368,2007,1690,520,731,3591,2746,845,2746,2493,253,2021-01-01,zipcode
ZCTA5 32667,12,4399,66950,953,257900,3853,1900,3383,154,661,1169,603,796,2197,1865,332,1865,1467,398,2021-01-01,zipcode
ZCTA5 32668,12,5694,48438,862,167400,4910,2515,4511,659,2134,1162,380,176,2555,2279,276,2279,2000,279,2021-01-01,zipcode
ZCTA5 32669,12,15125,81846,1126,243100,11668,4408,9874,402,2143,3444,2217,1668,5788,5282,506,5282,4583,699,2021-01-01,zipcode
ZCTA5 32680,12,10682,44616,483,84000,9045,5110,8119,1540,3796,1862,406,515,5936,4197,1739,4197,3653,544,2021-01-01,zipcode
ZCTA5 32681,12,255,-666666666,-666666666,-666666666,255,165,255,63,192,0,0,0,114,63,51,63,63,0,2021-01-01,zipcode
ZCTA5 32683,12,281,56128,-666666666,-666666666,184,114,142,28,95,13,6,0,128,99,29,99,54,45,2021-01-01,zipcode
ZCTA5 32686,12,5232,47870,713,255700,4566,2203,4057,573,1225,1481,347,431,2719,2344,375,2344,1529,815,2021-01-01,zipcode
ZCTA5 32692,12,40,-666666666,-666666666,-666666666,40,40,40,22,0,0,18,0,588,40,548,40,40,0,2021-01-01,zipcode
ZCTA5 32693,12,10872,46490,768,131100,9188,4767,7608,1081,2897,2642,694,294,4648,3978,670,3978,3213,765,2021-01-01,zipcode
ZCTA5 32694,12,1753,38576,635,111500,1476,586,1354,238,610,279,130,97,1206,975,231,975,619,356,2021-01-01,zipcode
ZCTA5 32696,12,13955,51477,771,158600,11109,5056,9890,1256,3879,3095,1212,448,5937,5302,635,5302,4200,1102,2021-01-01,zipcode
ZCTA5 32697,12,147,-666666666,1030,76000,113,37,90,23,24,30,8,5,127,68,59,68,10,58,2021-01-01,zipcode
ZCTA5 32701,12,24931,60212,1316,202300,21185,6766,18827,1026,3420,7776,4912,1693,12389,11274,1115,11274,5500,5774,2021-01-01,zipcode
ZCTA5 32702,12,2576,45000,2742,69800,2249,1294,2022,331,726,569,253,143,1591,1228,363,1228,763,465,2021-01-01,zipcode
ZCTA5 32703,12,54551,54744,1279,225400,43098,15814,37429,5556,11207,10883,7204,2579,20826,19247,1579,19247,12765,6482,2021-01-01,zipcode
ZCTA5 32707,12,37495,59894,1274,226500,31218,10590,27736,2125,6489,9565,6733,2824,16547,15695,852,15695,10818,4877,2021-01-01,zipcode
ZCTA5 32708,12,48218,79320,1477,279500,40199,13448,35303,1492,5802,10867,11334,5808,20376,19422,954,19422,14498,4924,2021-01-01,zipcode
ZCTA5 32709,12,1310,74250,-666666666,286700,1153,409,1041,119,255,377,243,47,591,546,45,546,479,67,2021-01-01,zipcode
ZCTA5 32712,12,49441,91771,1638,301800,39083,13290,34426,3648,8553,10635,7601,3989,17238,15902,1336,15902,12847,3055,2021-01-01,zipcode
ZCTA5 32713,12,22154,75415,1290,251900,18885,7934,16886,913,5206,6115,3407,1245,9870,9149,721,9149,8122,1027,2021-01-01,zipcode
ZCTA5 32714,12,37957,56155,1354,220100,30857,9157,27106,1866,5841,9337,7275,2787,17225,15818,1407,15818,7711,8107,2021-01-01,zipcode
ZCTA5 32720,12,33239,61356,1036,225200,27682,11879,23274,2476,7804,7253,3476,2265,13634,12271,1363,12271,8310,3961,2021-01-01,zipcode
ZCTA5 32724,12,40157,59460,1073,211300,33086,15811,28202,2070,7954,9468,5534,3176,17567,16055,1512,16055,11614,4441,2021-01-01,zipcode
ZCTA5 32725,12,50336,61502,1262,188900,40320,17343,35319,3698,11743,13019,5046,1813,19237,18035,1202,18035,13921,4114,2021-01-01,zipcode
ZCTA5 32726,12,23236,52240,902,174000,18498,6776,16246,1909,6427,5019,2034,857,10667,9424,1243,9424,6110,3314,2021-01-01,zipcode
ZCTA5 32730,12,6536,46344,1274,215000,5518,1785,5063,324,1366,2023,984,366,3109,2865,244,2865,1056,1809,2021-01-01,zipcode
ZCTA5 32732,12,5394,99321,1112,368200,4338,1146,3790,78,895,1286,991,540,2156,1817,339,1817,1745,72,2021-01-01,zipcode
ZCTA5 32735,12,5050,63714,1510,175300,4286,2170,3921,333,1529,1257,586,216,2547,2169,378,2169,1789,380,2021-01-01,zipcode
ZCTA5 32736,12,11748,78074,1187,296300,9473,3162,8356,598,2556,3139,1506,557,4509,4120,389,4120,3690,430,2021-01-01,zipcode
ZCTA5 32738,12,47559,64716,1213,183900,37292,13679,31918,2752,12399,12010,3584,1173,16618,15798,820,15798,12456,3342,2021-01-01,zipcode
ZCTA5 32744,12,3487,61550,1095,227800,2652,1143,2451,380,772,792,356,151,1382,1197,185,1197,1022,175,2021-01-01,zipcode
ZCTA5 32746,12,45145,95610,1606,331300,37715,12609,33055,1018,5371,9560,10456,6650,19603,18501,1102,18501,11862,6639,2021-01-01,zipcode
ZCTA5 32750,12,25189,75313,1362,271900,20667,6807,18620,1314,4905,5916,4491,1994,10143,9522,621,9522,7009,2513,2021-01-01,zipcode
ZCTA5 32751,12,22671,83142,1441,346800,18879,5932,16397,554,2319,4718,5335,3471,10380,9243,1137,9243,5915,3328,2021-01-01,zipcode
ZCTA5 32754,12,12159,59525,958,214900,10414,5342,9290,1049,3242,3217,1233,549,5788,4664,1124,4664,4246,418,2021-01-01,zipcode
ZCTA5 32757,12,29950,65259,1244,257700,24823,11528,22593,1733,6697,6548,4600,3015,13975,12268,1707,12268,8908,3360,2021-01-01,zipcode
ZCTA5 32759,12,2544,50054,1055,189300,2198,1281,2071,210,902,618,222,119,1366,1014,352,1014,843,171,2021-01-01,zipcode
ZCTA5 32763,12,23839,58261,1236,174100,19816,8028,17180,1817,5382,6051,2531,1399,10894,9817,1077,9817,6125,3692,2021-01-01,zipcode
ZCTA5 32764,12,2687,73634,998,272300,2409,1135,2076,214,778,664,359,61,1253,1032,221,1032,945,87,2021-01-01,zipcode
ZCTA5 32765,12,62675,88156,1667,320600,50258,16547,40188,1268,5957,11612,14146,7205,23017,21830,1187,21830,15894,5936,2021-01-01,zipcode
ZCTA5 32766,12,16523,125451,1860,411400,12738,4120,10701,579,1872,2783,3007,2460,5087,5087,0,5087,4444,643,2021-01-01,zipcode
ZCTA5 32767,12,3156,63641,1025,93400,2748,1145,2455,499,1143,760,34,19,1314,1110,204,1110,966,144,2021-01-01,zipcode
ZCTA5 32771,12,57074,65746,1289,261800,45000,15515,38724,3849,9089,12418,8584,4784,22246,20680,1566,20680,13088,7592,2021-01-01,zipcode
ZCTA5 32773,12,31903,53391,1269,184100,24959,8550,22311,2269,7941,6777,3865,1459,12557,11807,750,11807,6529,5278,2021-01-01,zipcode
ZCTA5 32776,12,12620,77476,1335,299200,10494,3781,9154,424,2358,4395,1021,956,4812,4493,319,4493,3701,792,2021-01-01,zipcode
ZCTA5 32778,12,23210,52076,1048,181500,19841,10663,18094,2134,5000,6208,3365,1387,12375,10458,1917,10458,7904,2554,2021-01-01,zipcode
ZCTA5 32779,12,28948,101546,1732,368800,23713,8619,21171,437,3193,5965,6991,4585,11625,11083,542,11083,8925,2158,2021-01-01,zipcode
ZCTA5 32780,12,37301,52066,1047,183200,31922,15140,28332,2381,8024,10799,4715,2413,20133,16126,4007,16126,11493,4633,2021-01-01,zipcode
ZCTA5 32784,12,10929,61952,788,168800,8853,3963,7836,1208,2701,2691,613,623,5231,4258,973,4258,3202,1056,2021-01-01,zipcode
ZCTA5 32789,12,25801,89875,1407,526300,22191,9131,18898,644,2819,3951,6029,5455,12397,11035,1362,11035,7313,3722,2021-01-01,zipcode
ZCTA5 32792,12,51929,59653,1366,274000,43165,14708,35312,2475,6734,11391,8937,5775,23144,20913,2231,20913,10102,10811,2021-01-01,zipcode
ZCTA5 32796,12,20953,52660,1047,168500,17765,8828,16028,1478,5994,4988,2238,1330,9835,8419,1416,8419,6840,1579,2021-01-01,zipcode
ZCTA5 32798,12,2235,48023,991,116300,2069,1304,2042,157,787,821,185,92,1380,1117,263,1117,1044,73,2021-01-01,zipcode
ZCTA5 32801,12,13589,67954,1407,374600,12694,3673,11833,696,1978,1743,4302,3114,10934,8621,2313,8621,2393,6228,2021-01-01,zipcode
ZCTA5 32803,12,22136,87635,1546,324200,19635,4472,18317,672,2847,4483,6463,3852,11658,10420,1238,10420,5610,4810,2021-01-01,zipcode
ZCTA5 32804,12,20073,97695,1427,388700,17328,4996,15541,536,2774,3288,4937,4006,9921,8676,1245,8676,5715,2961,2021-01-01,zipcode
ZCTA5 32805,12,18547,35179,859,177000,15575,6358,14285,2850,5458,3602,1561,814,9463,6944,2519,6944,2893,4051,2021-01-01,zipcode
ZCTA5 32806,12,27050,78816,1269,341300,22247,6057,20287,1011,3872,4922,6327,4155,12458,11120,1338,11120,6947,4173,2021-01-01,zipcode
ZCTA5 32807,12,35638,51645,1217,181100,28914,8574,25344,4230,8186,7905,3204,1819,13590,12429,1161,12429,6215,6214,2021-01-01,zipcode
ZCTA5 32808,12,64001,42259,1154,164900,47505,15098,38800,8305,13386,12388,3412,1309,20723,19218,1505,19218,7854,11364,2021-01-01,zipcode
ZCTA5 32809,12,30744,45840,1111,197200,23955,9296,21131,4458,7267,5100,2891,1415,10761,9259,1502,9259,4772,4487,2021-01-01,zipcode
ZCTA5 32810,12,39602,54407,1310,200300,30807,8634,27207,3495,7539,9039,5291,1843,14696,13830,866,13830,7034,6796,2021-01-01,zipcode
ZCTA5 32811,12,40402,42028,1233,129900,31710,9598,27166,3337,8119,8738,4901,2071,18312,14154,4158,14154,3830,10324,2021-01-01,zipcode
ZCTA5 32812,12,37241,59278,1238,273200,30340,9842,26111,2275,6900,8167,6221,2548,15274,14091,1183,14091,7834,6257,2021-01-01,zipcode
ZCTA5 32814,12,9293,109710,1970,588900,7410,1685,6714,20,500,698,2629,2867,4429,3941,488,3941,1602,2339,2021-01-01,zipcode
ZCTA5 32817,12,35491,70273,1432,247700,30357,11106,21642,1454,5372,7026,4980,2810,13048,11123,1925,11123,6518,4605,2021-01-01,zipcode
ZCTA5 32818,12,62693,51060,1211,206500,47856,13664,39855,7006,12466,12957,5140,2286,18621,17486,1135,17486,9831,7655,2021-01-01,zipcode
ZCTA5 32819,12,28765,76218,1590,364100,23571,8527,20475,1446,3866,5844,6182,3137,14666,10034,4632,10034,5978,4056,2021-01-01,zipcode
ZCTA5 32820,12,11162,100433,1819,331900,8580,2151,6969,421,1950,1623,1524,1451,3427,3123,304,3123,2692,431,2021-01-01,zipcode
ZCTA5 32821,12,20618,58461,1542,234700,17519,4343,14789,545,3062,5249,4452,1481,15272,8437,6835,8437,2823,5614,2021-01-01,zipcode
ZCTA5 32822,12,67238,45613,1347,169100,55155,19890,47537,5550,15635,14961,8027,3364,26504,23119,3385,23119,9697,13422,2021-01-01,zipcode
ZCTA5 32824,12,53049,68083,1561,263100,41698,12570,36510,4042,11397,11301,6598,3172,18678,14440,4238,14440,10823,3617,2021-01-01,zipcode
ZCTA5 32825,12,60846,68524,1450,251900,50496,15405,41532,4213,9648,14812,8365,4494,21704,19278,2426,19278,12883,6395,2021-01-01,zipcode
ZCTA5 32826,12,25763,58323,1269,187300,23427,9840,15155,1440,3832,4542,3165,2176,9729,8632,1097,8632,4382,4250,2021-01-01,zipcode
ZCTA5 32827,12,16007,104613,2026,397300,12552,4481,10672,309,1679,2864,3139,2681,7009,5401,1608,5401,3284,2117,2021-01-01,zipcode
ZCTA5 32828,12,70039,88668,1623,315900,56050,17231,45713,2861,9080,12070,14520,7182,24738,23591,1147,23591,14906,8685,2021-01-01,zipcode
ZCTA5 32829,12,19331,78967,1653,260200,15133,4466,13208,1353,2560,4124,3584,1587,7387,6142,1245,6142,4566,1576,2021-01-01,zipcode
ZCTA5 32830,12,44,111346,-666666666,95400,43,7,43,0,5,17,18,3,32,22,10,22,22,0,2021-01-01,zipcode
ZCTA5 32831,12,2679,41094,-666666666,10000,2679,2644,2437,904,1049,387,61,36,52,35,17,35,28,7,2021-01-01,zipcode
ZCTA5 32832,12,27072,97167,1819,344600,20797,5952,18028,759,1961,4986,6686,3636,11646,9545,2101,9545,6355,3190,2021-01-01,zipcode
ZCTA5 32833,12,10299,82859,1180,291100,8507,3432,7351,708,1901,2515,1412,815,3680,3271,409,3271,2542,729,2021-01-01,zipcode
ZCTA5 32835,12,50115,62777,1454,274400,40462,11225,33400,2554,6946,10601,9075,4224,19141,17730,1411,17730,7641,10089,2021-01-01,zipcode
ZCTA5 32836,12,21868,109918,1851,523200,17803,5646,15704,319,2157,4122,5393,3713,9654,7751,1903,7751,4764,2987,2021-01-01,zipcode
ZCTA5 32837,12,49669,71114,1637,278000,41077,13492,35392,3561,8119,10614,8292,4806,20610,15618,4992,15618,9264,6354,2021-01-01,zipcode
ZCTA5 32839,12,52756,44592,1197,165700,42425,14330,34770,6583,11473,10337,4396,1981,23550,16899,6651,16899,4307,12592,2021-01-01,zipcode
ZCTA5 32901,12,25176,41890,1099,174300,22372,11466,18117,1814,4911,6163,3324,1905,12857,10648,2209,10648,5116,5532,2021-01-01,zipcode
ZCTA5 32903,12,14347,88388,1466,387100,11826,5165,10832,356,1637,3356,2910,2573,7422,6233,1189,6233,5224,1009,2021-01-01,zipcode
ZCTA5 32904,12,35079,75801,1474,255200,28446,11553,24231,1363,5690,8095,5636,3447,14793,13444,1349,13444,11024,2420,2021-01-01,zipcode
ZCTA5 32905,12,26073,48299,1174,152000,21413,9380,18880,1639,6180,6027,3450,1584,12431,10685,1746,10685,5935,4750,2021-01-01,zipcode
ZCTA5 32907,12,47209,59364,1339,193000,38995,17152,33652,3861,10923,12579,4166,2123,17356,16193,1163,16193,13762,2431,2021-01-01,zipcode
ZCTA5 32908,12,13351,56373,1260,182500,10599,3505,8864,1222,2253,3655,1135,599,4514,4270,244,4270,3740,530,2021-01-01,zipcode
ZCTA5 32909,12,34156,56811,1179,195700,26673,10091,23090,2321,6731,8761,3470,1807,12794,11530,1264,11530,9534,1996,2021-01-01,zipcode
ZCTA5 32920,12,9979,58396,938,270100,9418,4293,8927,474,2410,2932,2089,1022,8983,5906,3077,5906,3535,2371,2021-01-01,zipcode
ZCTA5 32922,12,15108,40359,893,121100,11429,4215,10311,1521,3248,3676,1330,536,8075,6505,1570,6505,3185,3320,2021-01-01,zipcode
ZCTA5 32925,12,1609,66250,1734,-666666666,1236,456,821,54,120,316,188,143,508,484,24,484,0,484,2021-01-01,zipcode
ZCTA5 32926,12,23193,55687,1070,206600,20478,9351,18706,2403,6164,6229,2585,1325,10531,9333,1198,9333,7461,1872,2021-01-01,zipcode
ZCTA5 32927,12,28618,72276,1107,197400,23488,9348,21023,1961,6197,8240,3091,1534,11799,10224,1575,10224,9048,1176,2021-01-01,zipcode
ZCTA5 32931,12,13469,75126,1327,369500,12416,6359,11688,316,1987,3608,3369,2408,10626,7179,3447,7179,5111,2068,2021-01-01,zipcode
ZCTA5 32934,12,18901,91600,1452,301400,16556,8228,14340,942,3274,4563,3418,2143,7693,7309,384,7309,6544,765,2021-01-01,zipcode
ZCTA5 32935,12,41744,56749,1147,182400,34597,12605,31120,2368,9372,11501,5454,2425,19619,17254,2365,17254,10385,6869,2021-01-01,zipcode
ZCTA5 32937,12,27557,77359,1483,328400,22508,10149,20123,561,3513,6552,5181,4316,13110,11227,1883,11227,8861,2366,2021-01-01,zipcode
ZCTA5 32940,12,45050,86347,1718,335400,36867,16980,33446,1049,5398,10084,8781,8134,20155,18599,1556,18599,15538,3061,2021-01-01,zipcode
ZCTA5 32948,12,6079,38221,873,152400,4618,1515,3852,1221,1285,883,427,36,2050,1735,315,1735,1203,532,2021-01-01,zipcode
ZCTA5 32949,12,2616,94792,-666666666,382300,2374,1262,2175,182,774,545,406,268,1158,962,196,962,923,39,2021-01-01,zipcode
ZCTA5 32950,12,4565,72969,1269,334800,4037,1849,3583,150,1139,1207,820,267,1862,1821,41,1821,1645,176,2021-01-01,zipcode
ZCTA5 32951,12,11814,75094,1421,393500,10629,6362,10172,406,1522,3175,3189,1880,7717,5826,1891,5826,4878,948,2021-01-01,zipcode
ZCTA5 32952,12,20515,85120,1084,334400,17487,7552,15476,600,3256,4802,4065,2753,10043,8228,1815,8228,6970,1258,2021-01-01,zipcode
ZCTA5 32953,12,23853,75188,1077,321000,20091,8671,17878,1026,4210,6143,4063,2436,11414,9322,2092,9322,7166,2156,2021-01-01,zipcode
ZCTA5 32955,12,38892,76701,1380,262500,32519,12155,28999,1706,7360,9501,6151,4281,18605,15437,3168,15437,12067,3370,2021-01-01,zipcode
ZCTA5 32958,12,28339,59700,1185,217600,25251,13174,23590,1467,7863,7153,4113,2994,14659,12440,2219,12440,10221,2219,2021-01-01,zipcode
ZCTA5 32960,12,23085,45111,985,192900,19251,7804,16703,1473,4897,5896,3067,1370,11639,9367,2272,9367,5641,3726,2021-01-01,zipcode
ZCTA5 32962,12,25958,55884,1058,168100,21844,10240,19243,2879,5158,7152,2971,1083,12691,9314,3377,9314,7832,1482,2021-01-01,zipcode
ZCTA5 32963,12,15182,126650,1543,678100,14416,9665,14016,161,1501,2714,5068,4572,12302,7594,4708,7594,7155,439,2021-01-01,zipcode
ZCTA5 32966,12,18916,57851,1193,204800,16487,9648,15677,719,4691,5559,2879,1829,11484,8651,2833,8651,6683,1968,2021-01-01,zipcode
ZCTA5 32967,12,24405,63047,1039,292900,20274,10841,18004,2307,5349,5420,2641,2287,11412,8791,2621,8791,6695,2096,2021-01-01,zipcode
ZCTA5 32968,12,15825,82326,1714,299300,13584,5764,11318,633,3011,3762,2597,1315,6273,5440,833,5440,4978,462,2021-01-01,zipcode
ZCTA5 32970,12,213,-666666666,-666666666,-666666666,213,146,213,15,171,27,0,0,45,45,0,45,18,27,2021-01-01,zipcode
ZCTA5 32976,12,8759,43918,983,119000,8537,5965,8390,445,3002,3494,964,485,6925,5048,1877,5048,4842,206,2021-01-01,zipcode
ZCTA5 33001,12,341,46397,1981,-666666666,331,200,331,19,200,50,51,11,730,179,551,179,121,58,2021-01-01,zipcode
ZCTA5 33004,12,15876,43138,1379,251100,13091,4573,12001,1220,3266,4004,2380,1131,8827,7003,1824,7003,3025,3978,2021-01-01,zipcode
ZCTA5 33009,12,43547,41580,1352,225700,36739,14426,33264,4365,9346,8078,6680,4795,30991,20180,10811,20180,10741,9439,2021-01-01,zipcode
ZCTA5 33010,12,42246,36703,1142,286900,36583,15240,32525,11082,10830,4920,4039,1654,16235,15483,752,15483,4630,10853,2021-01-01,zipcode
ZCTA5 33012,12,70485,36594,1311,277500,60671,26445,54028,16233,17145,11808,6235,2607,25681,24959,722,24959,12205,12754,2021-01-01,zipcode
ZCTA5 33013,12,30706,49197,1273,307100,26765,10156,23262,6259,8862,4387,2650,1104,9823,9481,342,9481,5723,3758,2021-01-01,zipcode
ZCTA5 33014,12,41021,57213,1434,336100,34011,11281,29968,5259,8223,8508,4894,3084,14911,14311,600,14311,6158,8153,2021-01-01,zipcode
ZCTA5 33015,12,69023,61784,1597,306700,56106,16884,47791,6672,13286,14515,9130,4188,23923,23078,845,23078,11746,11332,2021-01-01,zipcode
ZCTA5 33016,12,46498,50418,1464,233500,38533,13935,33120,6166,11020,7663,5883,2388,16026,15606,420,15606,7995,7611,2021-01-01,zipcode
ZCTA5 33018,12,55079,76986,1777,330800,45319,13202,39474,6335,12259,10322,7210,3348,17192,16681,511,16681,12295,4386,2021-01-01,zipcode
ZCTA5 33019,12,13613,80510,1647,490500,12062,5275,10743,568,1279,2887,2963,3046,12467,6371,6096,6371,4790,1581,2021-01-01,zipcode
ZCTA5 33020,12,45416,48372,1243,242300,37976,10417,33070,4929,9538,9508,5656,3439,22290,19434,2856,19434,6372,13062,2021-01-01,zipcode
ZCTA5 33021,12,49788,62314,1470,319400,40009,13291,34813,3580,8418,10789,6839,5187,21515,18969,2546,18969,12176,6793,2021-01-01,zipcode
ZCTA5 33023,12,71463,58020,1381,263200,55985,16939,48000,7513,16422,16219,5266,2580,22198,20812,1386,20812,13648,7164,2021-01-01,zipcode
ZCTA5 33024,12,74017,64467,1472,286300,58096,17543,49706,4954,15969,16760,8598,3425,26056,24329,1727,24329,15640,8689,2021-01-01,zipcode
ZCTA5 33025,12,71690,59970,1542,268400,58142,17142,51356,2787,21398,14964,7138,5069,29409,26946,2463,26946,12103,14843,2021-01-01,zipcode
ZCTA5 33026,12,31671,82645,1693,297200,26114,9034,23393,1788,5503,7355,5529,3218,12558,12071,487,12071,9672,2399,2021-01-01,zipcode
ZCTA5 33027,12,63068,62606,1459,330400,53081,21309,47422,3076,13563,12084,11337,7362,25725,24219,1506,24219,19076,5143,2021-01-01,zipcode
ZCTA5 33028,12,27530,107412,2158,426700,21646,5530,18330,910,3514,4226,5730,3950,9177,8730,447,8730,6613,2117,2021-01-01,zipcode
ZCTA5 33029,12,45177,125817,2318,443000,35409,9914,29556,1297,7261,8319,7893,4786,13805,13150,655,13150,11903,1247,2021-01-01,zipcode
ZCTA5 33030,12,37225,36687,1157,270900,25930,9654,21463,8817,6223,3820,1970,633,10949,10199,750,10199,3800,6399,2021-01-01,zipcode
ZCTA5 33031,12,9190,98088,1137,408200,7394,3017,6275,547,2390,1948,732,658,2755,2690,65,2690,2417,273,2021-01-01,zipcode
ZCTA5 33032,12,54545,64109,1411,279500,41027,12488,34470,6360,9365,9870,6560,2315,16761,16043,718,16043,9401,6642,2021-01-01,zipcode
ZCTA5 33033,12,67265,57779,1468,274000,48975,16135,40334,8701,10237,11447,6805,3144,19676,19036,640,19036,10562,8474,2021-01-01,zipcode
ZCTA5 33034,12,23044,42771,1166,158700,15601,8024,12958,4749,3782,3320,817,290,6022,5448,574,5448,1801,3647,2021-01-01,zipcode
ZCTA5 33035,12,16127,60053,1704,205200,12144,3089,10256,1078,2395,3788,2038,957,5828,5287,541,5287,2585,2702,2021-01-01,zipcode
ZCTA5 33036,12,3810,77123,1622,801000,3360,1492,3161,103,872,892,734,560,3651,1792,1859,1792,1428,364,2021-01-01,zipcode
ZCTA5 33037,12,12090,67236,1702,562000,10553,4634,9831,710,2574,2784,2151,1612,10165,5159,5006,5159,3986,1173,2021-01-01,zipcode
ZCTA5 33039,12,0,-666666666,-666666666,-666666666,0,0,0,0,0,0,0,0,0,0,0,0,0,0,2021-01-01,zipcode
ZCTA5 33040,12,37404,73884,1880,679100,32002,9332,28574,2525,8170,7779,6220,3880,18696,14608,4088,14608,6885,7723,2021-01-01,zipcode
ZCTA5 33042,12,7054,95365,2249,591300,6233,2390,5729,181,1320,1838,1450,940,4818,2908,1910,2908,2274,634,2021-01-01,zipcode
ZCTA5 33043,12,4801,71364,1728,406400,4065,1781,3721,306,982,1367,691,375,2729,1896,833,1896,1498,398,2021-01-01,zipcode
ZCTA5 33050,12,10423,65014,1391,619800,8972,3009,8065,887,2346,2346,1560,926,7308,4299,3009,4299,2362,1937,2021-01-01,zipcode
ZCTA5 33051,12,744,94485,1491,574800,735,442,726,23,170,215,227,91,1287,410,877,410,281,129,2021-01-01,zipcode
ZCTA5 33054,12,32390,36911,1103,216100,25911,11687,21558,6298,8242,5182,1389,447,10598,10164,434,10164,4740,5424,2021-01-01,zipcode
ZCTA5 33055,12,38817,51577,1368,265400,31753,13777,27871,6919,10944,5947,2910,1151,11939,11464,475,11464,8897,2567,2021-01-01,zipcode
ZCTA5 33056,12,37579,52538,1428,245900,29604,11980,25310,4379,9380,7203,2634,1714,11582,10925,657,10925,7176,3749,2021-01-01,zipcode
ZCTA5 33060,12,37826,51374,1218,273100,30796,11399,26886,5495,7935,7465,3866,2125,15795,13959,1836,13959,7074,6885,2021-01-01,zipcode
ZCTA5 33062,12,23763,72329,1584,404500,22375,10623,21257,1163,4561,5789,5335,4409,22026,13274,8752,13274,9118,4156,2021-01-01,zipcode
ZCTA5 33063,12,54907,53594,1470,223300,47959,16418,43687,4529,14867,12858,8124,3309,27923,24961,2962,24961,17789,7172,2021-01-01,zipcode
ZCTA5 33064,12,60586,57565,1469,231300,49384,15015,44394,7780,13310,10935,8247,4122,26040,22668,3372,22668,14100,8568,2021-01-01,zipcode
ZCTA5 33065,12,60590,63184,1548,317100,45938,13568,38826,3288,10954,12818,8351,3415,20943,19546,1397,19546,9810,9736,2021-01-01,zipcode
ZCTA5 33066,12,16163,49568,1490,154400,14112,6464,13201,1025,3368,4249,2647,1912,10420,8453,1967,8453,7067,1386,2021-01-01,zipcode
ZCTA5 33067,12,25649,115397,1754,479000,20202,5878,17602,610,2709,5025,5235,4023,8843,8380,463,8380,6149,2231,2021-01-01,zipcode
ZCTA5 33068,12,52541,50463,1645,215100,41958,11597,34956,4964,13215,10340,4233,2204,19901,18539,1362,18539,10720,7819,2021-01-01,zipcode
ZCTA5 33069,12,29089,52715,1417,191000,23667,10589,21155,2655,6067,5833,4110,2490,15505,11115,4390,11115,5079,6036,2021-01-01,zipcode
ZCTA5 33070,12,5559,65933,1688,605000,4888,1904,4296,359,1256,1177,871,633,4301,2378,1923,2378,1765,613,2021-01-01,zipcode
ZCTA5 33071,12,39182,91934,1739,424300,30964,8747,26131,1060,5468,8412,7266,3925,13973,13401,572,13401,9051,4350,2021-01-01,zipcode
ZCTA5 33073,12,34243,87591,1889,356200,26747,7791,22250,1548,5460,7135,5990,2117,12543,11655,888,11655,6538,5117,2021-01-01,zipcode
ZCTA5 33076,12,42044,148680,2587,566100,30584,10782,25859,582,4783,4715,7974,7805,13641,12833,808,12833,11176,1657,2021-01-01,zipcode
ZCTA5 33101,12,0,-666666666,-666666666,-666666666,0,0,0,0,0,0,0,0,0,0,0,0,0,0,2021-01-01,zipcode
ZCTA5 33109,12,568,250001,-666666666,2000001,493,319,493,0,30,54,129,280,772,258,514,258,242,16,2021-01-01,zipcode
ZCTA5 33122,12,1771,78232,2184,1089800,1369,427,1126,194,94,194,367,277,933,724,209,724,79,645,2021-01-01,zipcode
ZCTA5 33125,12,55161,33172,1175,289200,47689,20379,42259,13454,13750,6977,5568,2510,22200,20956,1244,20956,5388,15568,2021-01-01,zipcode
ZCTA5 33126,12,48130,45660,1428,261000,41536,14600,37273,7810,10913,8409,7378,2763,19307,18017,1290,18017,6597,11420,2021-01-01,zipcode
ZCTA5 33127,12,29097,34102,1161,298300,23087,10130,19984,5998,6716,4413,1831,1026,11449,9891,1558,9891,2939,6952,2021-01-01,zipcode
ZCTA5 33128,12,8665,25984,1045,266300,7081,2597,6429,2459,2120,972,693,185,3985,3577,408,3577,117,3460,2021-01-01,zipcode
ZCTA5 33129,12,14390,78316,1977,456000,12765,3833,11482,472,1759,1750,4422,3079,8330,6906,1424,6906,3112,3794,2021-01-01,zipcode
ZCTA5 33130,12,31835,50305,1399,370900,28799,8789,25719,4839,6121,4598,5741,4420,19345,16124,3221,16124,1695,14429,2021-01-01,zipcode
ZCTA5 33131,12,22529,107171,2324,488900,19869,3486,18296,268,1236,2954,6875,6963,18297,12296,6001,12296,3804,8492,2021-01-01,zipcode
ZCTA5 33132,12,15834,90160,2217,504300,14933,3916,13454,916,1335,2971,4207,4025,10592,8126,2466,8126,2132,5994,2021-01-01,zipcode
ZCTA5 33133,12,34434,76560,1655,718200,27662,8588,25753,1624,4605,4834,8214,6476,16936,14203,2733,14203,7314,6889,2021-01-01,zipcode
ZCTA5 33134,12,39082,79544,1598,549800,32370,11400,29038,2502,5099,5602,8307,7528,18610,16171,2439,16171,8964,7207,2021-01-01,zipcode
ZCTA5 33135,12,35115,32460,1133,324400,29998,11559,26831,7766,8592,5353,3528,1592,15508,14245,1263,14245,3110,11135,2021-01-01,zipcode
ZCTA5 33136,12,16190,30036,1078,289200,13664,5148,12243,3385,3540,3006,1497,815,7494,6634,860,6634,731,5903,2021-01-01,zipcode
ZCTA5 33137,12,22768,66225,1922,407000,19670,5082,17732,1854,3017,3971,5204,3686,13257,10405,2852,10405,2592,7813,2021-01-01,zipcode
ZCTA5 33138,12,30029,57063,1243,510900,24537,8007,21387,2673,4353,4987,4908,4466,14392,12766,1626,12766,6227,6539,2021-01-01,zipcode
ZCTA5 33139,12,35393,56548,1600,393100,31433,9478,28583,2970,4649,6136,8291,6537,30329,19898,10431,19898,5933,13965,2021-01-01,zipcode
ZCTA5 33140,12,20672,90812,1797,689800,16454,5655,15094,1225,1617,3243,4568,4441,16718,8709,8009,8709,4839,3870,2021-01-01,zipcode
ZCTA5 33141,12,35855,55306,1471,337600,31136,8672,28261,2753,6172,7757,7005,4574,21544,16538,5006,16538,5566,10972,2021-01-01,zipcode
ZCTA5 33142,12,57733,30915,1066,242200,45623,18771,39275,13468,12948,7851,3572,1436,21774,20091,1683,20091,5500,14591,2021-01-01,zipcode
ZCTA5 33143,12,31012,74254,1585,624000,25624,9360,22542,1216,3644,4851,7109,5722,14140,12669,1471,12669,7191,5478,2021-01-01,zipcode
ZCTA5 33144,12,28606,55647,1456,340400,24820,9450,22480,3611,7098,5696,4384,1691,10073,9535,538,9535,5242,4293,2021-01-01,zipcode
ZCTA5 33145,12,28944,62806,1597,429200,24875,9060,22359,3625,4415,5427,5282,3610,12682,11459,1223,11459,5752,5707,2021-01-01,zipcode
ZCTA5 33146,12,16507,116312,2338,982400,14351,7019,8203,160,522,1406,2519,3596,6083,5160,923,5160,3533,1627,2021-01-01,zipcode
ZCTA5 33147,12,46363,39861,1119,192900,36415,15990,31575,7575,11866,7586,3150,1398,15998,14747,1251,14747,6957,7790,2021-01-01,zipcode
ZCTA5 33149,12,14611,167438,2697,1238000,10703,4351,9001,329,722,1357,3438,3155,7516,4601,2915,4601,3185,1416,2021-01-01,zipcode
ZCTA5 33150,12,33116,33770,1000,275800,24436,9972,21095,5344,6981,5690,2078,1002,12219,11030,1189,11030,3151,7879,2021-01-01,zipcode
ZCTA5 33154,12,14636,75350,1895,649400,10781,3914,9738,204,1934,2106,2757,2737,10294,5687,4607,5687,3431,2256,2021-01-01,zipcode
ZCTA5 33155,12,44440,71646,1701,411900,37453,13221,33718,4231,8209,8745,8348,4185,15720,14866,854,14866,10052,4814,2021-01-01,zipcode
ZCTA5 33156,12,33111,123991,1809,846000,25911,9159,22518,877,2841,4308,6920,7572,13193,11749,1444,11749,8462,3287,2021-01-01,zipcode
ZCTA5 33157,12,69212,71824,1318,363100,55155,19354,47393,5972,13591,12133,10374,5323,21923,20554,1369,20554,13612,6942,2021-01-01,zipcode
ZCTA5 33158,12,6351,163565,2375,715300,4895,2080,4153,36,393,549,1494,1681,2266,2017,249,2017,1915,102,2021-01-01,zipcode
ZCTA5 33160,12,42053,53393,1724,271100,35805,15523,32745,2203,5570,9962,8748,6262,36480,20050,16430,20050,11792,8258,2021-01-01,zipcode
ZCTA5 33161,12,54241,44779,1254,293100,42652,15006,36673,7534,13123,8776,5003,2237,18887,17264,1623,17264,7279,9985,2021-01-01,zipcode
ZCTA5 33162,12,47698,50751,1296,255500,36733,12609,31661,6275,10030,8482,4999,1875,16003,14605,1398,14605,7709,6896,2021-01-01,zipcode
ZCTA5 33165,12,53198,67982,1587,374000,46257,17814,40428,7406,11991,9947,7463,3621,17683,17042,641,17042,12329,4713,2021-01-01,zipcode
ZCTA5 33166,12,25177,65902,1431,419600,21418,7380,18909,3050,3701,4485,4271,3402,10217,9418,799,9418,4880,4538,2021-01-01,zipcode
ZCTA5 33167,12,22081,51581,1164,240400,17550,7083,14371,3496,5215,3434,1563,663,6846,6537,309,6537,3901,2636,2021-01-01,zipcode
ZCTA5 33168,12,23938,52192,1346,245600,19725,7671,16981,4189,6513,3963,1629,687,7068,6687,381,6687,5020,1667,2021-01-01,zipcode
ZCTA5 33169,12,41417,50611,1331,265900,31948,11289,27495,4089,9111,8295,4244,1756,14073,12858,1215,12858,6932,5926,2021-01-01,zipcode
ZCTA5 33170,12,13788,52463,1277,311500,11031,4127,9476,2415,2791,2122,1353,795,4575,4201,374,4201,2471,1730,2021-01-01,zipcode
ZCTA5 33172,12,40897,53740,1702,194000,34707,11260,30922,7268,7228,6968,6078,3380,16091,14604,1487,14604,6709,7895,2021-01-01,zipcode
ZCTA5 33173,12,33089,77108,1794,352900,27617,10038,24509,1910,4765,7720,6473,3641,12252,11644,608,11644,8012,3632,2021-01-01,zipcode
ZCTA5 33174,12,34114,51959,1530,293500,30033,12310,24399,7361,5866,4523,4499,2150,11426,11170,256,11170,5748,5422,2021-01-01,zipcode
ZCTA5 33175,12,51693,66052,1708,358200,45323,17023,40442,7654,11546,9483,7775,3984,17494,17019,475,17019,12823,4196,2021-01-01,zipcode
ZCTA5 33176,12,52932,73960,1465,460600,43815,15520,38187,3380,8028,11278,9764,5737,19869,18635,1234,18635,11907,6728,2021-01-01,zipcode
ZCTA5 33177,12,57167,66492,1784,309300,47445,19042,40878,6534,14498,10935,6061,2850,16517,16052,465,16052,11957,4095,2021-01-01,zipcode
ZCTA5 33178,12,64366,79532,2277,414500,49703,17521,42108,5197,5297,9560,11978,10076,22185,19069,3116,19069,9169,9900,2021-01-01,zipcode
ZCTA5 33179,12,46858,52902,1460,193000,38699,12844,33522,3343,9256,10382,5993,4548,20183,17863,2320,17863,10156,7707,2021-01-01,zipcode
ZCTA5 33180,12,32925,79449,2063,391400,27310,10804,24659,1200,3022,7006,7694,5737,22583,14528,8055,14528,9559,4969,2021-01-01,zipcode
ZCTA5 33181,12,20180,46726,1355,266000,16674,5406,13822,1437,3944,3732,2771,1938,9393,8164,1229,8164,3350,4814,2021-01-01,zipcode
ZCTA5 33182,12,13060,81585,2147,369400,11131,4111,9596,1245,2213,2248,2946,944,4237,4106,131,4106,3369,737,2021-01-01,zipcode
ZCTA5 33183,12,34662,61806,1649,299300,29673,11321,25128,3580,7130,6856,5224,2338,12802,12472,330,12472,7926,4546,2021-01-01,zipcode
ZCTA5 33184,12,21528,65536,1698,303700,18743,6635,16266,4637,3895,2621,3653,1460,6808,6455,353,6455,4592,1863,2021-01-01,zipcode
ZCTA5 33185,12,29599,93002,2328,396000,23729,8730,20468,2648,4570,5309,5081,2860,8989,8799,190,8799,7200,1599,2021-01-01,zipcode
ZCTA5 33186,12,67686,75699,1865,337800,54830,19965,47382,3762,11852,15394,10535,5839,23693,22617,1076,22617,15414,7203,2021-01-01,zipcode
ZCTA5 33187,12,18781,97524,2124,394000,15331,5245,13360,1766,3331,3790,3467,1006,5771,5523,248,5523,4849,674,2021-01-01,zipcode
ZCTA5 33189,12,24120,54286,1342,306900,18907,6584,16685,2955,5323,4169,2907,1331,8663,8156,507,8156,4564,3592,2021-01-01,zipcode
ZCTA5 33190,12,17230,66546,1523,295000,13001,3859,11126,1485,2499,4047,2448,647,5250,5118,132,5118,2472,2646,2021-01-01,zipcode
ZCTA5 33193,12,47571,67418,1612,321800,40517,14109,34319,7315,8713,7370,8103,2818,15987,15548,439,15548,9491,6057,2021-01-01,zipcode
ZCTA5 33194,12,9388,119740,2317,402300,7926,3682,6998,1046,1486,1818,1855,793,2093,2093,0,2093,1608,485,2021-01-01,zipcode
ZCTA5 33196,12,55287,82422,1920,375400,44265,15529,37511,3657,8684,10929,9820,4421,17104,16601,503,16601,11335,5266,2021-01-01,zipcode
ZCTA5 33301,12,16261,104436,2061,587100,15287,4746,14007,492,1714,3410,4979,3412,12636,9170,3466,9170,3644,5526,2021-01-01,zipcode
ZCTA5 33304,12,18085,69343,1411,465500,16132,5177,14862,1178,2452,3584,5022,2626,12683,9530,3153,9530,3642,5888,2021-01-01,zipcode
ZCTA5 33305,12,12634,85800,1467,453400,11359,3779,10856,480,1707,2565,3473,2631,8065,6640,1425,6640,4505,2135,2021-01-01,zipcode
ZCTA5 33306,12,3111,66367,1197,445900,2926,932,2846,69,474,812,844,647,2285,1843,442,1843,1349,494,2021-01-01,zipcode
ZCTA5 33308,12,28428,73390,1622,438000,25681,11303,24106,1005,4309,5956,7217,5619,23703,15638,8065,15638,10975,4663,2021-01-01,zipcode
ZCTA5 33309,12,40100,61898,1495,235400,32191,8420,27698,3717,9449,7569,4376,2587,15101,14066,1035,14066,8246,5820,2021-01-01,zipcode
ZCTA5 33311,12,73388,43007,1172,215500,55208,22541,45851,9853,15508,12970,5013,2507,27714,24737,2977,24737,11141,13596,2021-01-01,zipcode
ZCTA5 33312,12,53855,63240,1427,299000,43077,15073,37248,5245,9978,10911,6699,4415,21379,18490,2889,18490,11267,7223,2021-01-01,zipcode
ZCTA5 33313,12,63715,42177,1312,175900,48462,17221,40400,6288,15985,12030,4281,1816,25213,21780,3433,21780,9381,12399,2021-01-01,zipcode
ZCTA5 33314,12,28730,55317,1689,228900,23198,7383,18940,2949,5264,4984,3888,1855,11483,10435,1048,10435,3889,6546,2021-01-01,zipcode
ZCTA5 33315,12,13178,81501,1426,356700,11410,3534,10583,708,3551,2585,2193,1546,6991,5895,1096,5895,3510,2385,2021-01-01,zipcode
ZCTA5 33316,12,11194,82973,1557,660200,9878,3533,9246,407,1239,2426,3160,2014,8498,5552,2946,5552,3168,2384,2021-01-01,zipcode
ZCTA5 33317,12,37161,75767,1556,350400,29773,9443,26518,3019,7176,7152,5844,3327,13550,12762,788,12762,9621,3141,2021-01-01,zipcode
ZCTA5 33319,12,50703,49770,1387,173600,41497,14198,36732,4739,11365,11151,6015,3462,25170,20733,4437,20733,13417,7316,2021-01-01,zipcode
ZCTA5 33321,12,50513,54428,1632,199900,43287,18191,38664,4189,10537,13150,6771,4017,23867,21625,2242,21625,15877,5748,2021-01-01,zipcode
ZCTA5 33322,12,40244,55281,1790,201400,34815,14161,32573,2972,8292,10748,6946,3615,21244,18399,2845,18399,15467,2932,2021-01-01,zipcode
ZCTA5 33323,12,23099,100478,2139,362700,19321,5133,16658,1107,2842,5266,5034,2409,9104,8319,785,8319,5754,2565,2021-01-01,zipcode
ZCTA5 33324,12,49343,73772,1830,267700,40226,12898,35455,2151,6326,10836,9837,6305,22019,19516,2503,19516,11296,8220,2021-01-01,zipcode
ZCTA5 33325,12,31410,85607,1770,331600,25035,6692,21199,1884,4990,6489,5158,2678,11155,10364,791,10364,7839,2525,2021-01-01,zipcode
ZCTA5 33326,12,31687,99828,2023,423600,24602,8328,21368,706,2929,5552,6821,5360,12967,10655,2312,10655,7642,3013,2021-01-01,zipcode
ZCTA5 33327,12,23593,147103,2735,592000,16644,5967,14022,254,1721,2348,5025,4674,6617,6557,60,6557,5182,1375,2021-01-01,zipcode
ZCTA5 33328,12,28373,108569,1752,417100,23074,6907,19210,1055,3745,5480,5685,3245,10562,9940,622,9940,8009,1931,2021-01-01,zipcode
ZCTA5 33330,12,14450,126782,2541,567400,11377,3827,9736,706,1491,2392,2489,2658,4848,4614,234,4614,4359,255,2021-01-01,zipcode
ZCTA5 33331,12,25150,128421,2416,538400,20121,7273,16701,798,1874,4417,5885,3727,7740,7454,286,7454,6278,1176,2021-01-01,zipcode
ZCTA5 33332,12,11484,144625,2738,643900,9101,3413,7524,304,728,1538,2348,2606,3519,3393,126,3393,2973,420,2021-01-01,zipcode
ZCTA5 33334,12,29497,61013,1332,348200,24774,7067,22007,2424,5866,5995,4455,3267,14033,12730,1303,12730,7351,5379,2021-01-01,zipcode
ZCTA5 33351,12,34699,63941,1670,261000,27604,7429,24656,2146,6415,8164,5476,2455,13527,12589,938,12589,7229,5360,2021-01-01,zipcode
ZCTA5 33401,12,31144,49554,1480,297700,26675,9954,21892,2724,4474,5955,5140,3599,17766,13578,4188,13578,4704,8874,2021-01-01,zipcode
ZCTA5 33403,12,14139,59516,1261,248000,11340,3739,9750,1365,3108,2831,1469,977,5798,4922,876,4922,2181,2741,2021-01-01,zipcode
ZCTA5 33404,12,30431,49433,1245,216200,24215,9498,20937,2875,7121,5827,3258,1856,16262,11356,4906,11356,6016,5340,2021-01-01,zipcode
ZCTA5 33405,12,21138,68079,1192,305700,17565,5772,15762,3075,3430,4448,2813,1996,9245,8368,877,8368,4898,3470,2021-01-01,zipcode
ZCTA5 33406,12,26006,65035,1397,241500,21568,7609,17582,3319,5879,4591,2663,1130,9181,8451,730,8451,5683,2768,2021-01-01,zipcode
ZCTA5 33407,12,32422,46638,1313,214200,26536,9638,23166,4470,6536,6305,3758,2097,14657,12174,2483,12174,5748,6426,2021-01-01,zipcode
ZCTA5 33408,12,18522,82162,1585,394000,16908,8251,15771,502,3029,4106,5109,3025,13349,9535,3814,9535,7517,2018,2021-01-01,zipcode
ZCTA5 33409,12,33146,55687,1401,210000,26436,7816,21462,3980,5462,5843,4322,1855,13369,11569,1800,11569,5080,6489,2021-01-01,zipcode
ZCTA5 33410,12,35711,85747,1786,371200,30128,11039,27151,1294,5599,7829,8064,4365,17555,15085,2470,15085,10629,4456,2021-01-01,zipcode
ZCTA5 33411,12,74923,77190,1621,306800,60742,21933,53279,5463,12462,15736,11851,7767,29662,27024,2638,27024,20452,6572,2021-01-01,zipcode
ZCTA5 33412,12,15234,107822,1764,423200,13062,5239,11805,528,2939,3349,3071,1918,6489,5551,938,5551,4699,852,2021-01-01,zipcode
ZCTA5 33413,12,16910,65276,1726,293500,12781,3763,10784,1506,2815,3658,1654,1151,5901,5421,480,5421,3634,1787,2021-01-01,zipcode
ZCTA5 33414,12,58505,95941,1923,413400,45225,14634,38948,2536,7173,12334,10225,6680,22262,19306,2956,19306,14587,4719,2021-01-01,zipcode
ZCTA5 33415,12,51913,47815,1330,169100,41407,14397,35173,7494,11995,9548,4441,1695,20321,18184,2137,18184,10640,7544,2021-01-01,zipcode
ZCTA5 33417,12,35443,43599,1279,114200,29824,11592,27060,4465,7872,7659,5109,1955,20280,16050,4230,16050,9014,7036,2021-01-01,zipcode
ZCTA5 33418,12,42372,110482,1970,449900,35803,15862,32943,1135,4756,8746,10117,8189,21731,18010,3721,18010,14028,3982,2021-01-01,zipcode
ZCTA5 33426,12,23591,66186,1696,234500,20687,6768,18384,1592,5382,6041,3544,1825,11464,9992,1472,9992,6134,3858,2021-01-01,zipcode
ZCTA5 33428,12,44551,71594,1815,332300,35353,12256,30942,2809,7291,8583,7817,4442,17259,15775,1484,15775,10922,4853,2021-01-01,zipcode
ZCTA5 33430,12,20628,34178,684,116800,15197,6680,12978,4831,4349,2546,967,285,7509,6524,985,6524,2289,4235,2021-01-01,zipcode
ZCTA5 33431,12,21554,93636,1942,434800,17795,7898,13299,895,1824,3070,4450,3060,9099,7546,1553,7546,5406,2140,2021-01-01,zipcode
ZCTA5 33432,12,20263,81566,1830,680500,18299,7564,16333,671,2106,4190,5657,3709,14797,10287,4510,10287,6166,4121,2021-01-01,zipcode
ZCTA5 33433,12,42684,65716,1958,326600,35606,16648,32163,1115,6464,7826,9443,7315,23320,19372,3948,19372,13796,5576,2021-01-01,zipcode
ZCTA5 33434,12,21017,63472,1336,259900,18657,11292,17791,1088,2928,4059,5100,4616,13499,10331,3168,10331,8110,2221,2021-01-01,zipcode
ZCTA5 33435,12,36644,57925,1611,230600,30849,11481,27273,3768,7889,8069,5301,2246,19286,14236,5050,14236,8551,5685,2021-01-01,zipcode
ZCTA5 33436,12,47089,64205,1669,266200,38954,14677,34996,3154,8809,10771,7825,4437,23204,19144,4060,19144,14071,5073,2021-01-01,zipcode
ZCTA5 33437,12,37997,66272,1647,315000,34973,21074,32473,1250,7015,9537,7834,6837,21636,18053,3583,18053,15676,2377,2021-01-01,zipcode
ZCTA5 33438,12,431,95188,-666666666,88600,405,158,355,51,180,68,29,27,234,153,81,153,116,37,2021-01-01,zipcode
ZCTA5 33440,12,20438,41351,829,101200,16195,6274,13569,4081,4549,3775,947,217,8155,6985,1170,6985,4878,2107,2021-01-01,zipcode
ZCTA5 33441,12,29347,48132,1292,295500,24780,8682,21735,3327,6273,6921,3451,1763,15411,12682,2729,12682,6548,6134,2021-01-01,zipcode
ZCTA5 33442,12,31680,48571,1721,157200,27209,12231,25409,2042,6594,8342,5712,2719,21310,15358,5952,15358,10250,5108,2021-01-01,zipcode
ZCTA5 33444,12,23842,60706,1424,342800,19875,6161,17601,2866,4721,4963,3241,1810,10099,8984,1115,8984,4694,4290,2021-01-01,zipcode
ZCTA5 33445,12,30309,58948,1733,235600,26374,10878,24291,1869,5802,6493,6600,3527,17395,13796,3599,13796,9690,4106,2021-01-01,zipcode
ZCTA5 33446,12,26791,64217,1373,310600,24290,15990,23395,829,4730,6520,6004,5312,17696,13680,4016,13680,12113,1567,2021-01-01,zipcode
ZCTA5 33449,12,9799,142056,2811,491800,7878,3322,6644,244,1256,1717,1704,1723,3649,3265,384,3265,3103,162,2021-01-01,zipcode
ZCTA5 33455,12,21068,63351,1106,295000,18237,9506,17131,1122,4829,5360,3864,1956,11721,9399,2322,9399,8007,1392,2021-01-01,zipcode
ZCTA5 33458,12,56174,89515,1799,416100,44968,13986,39138,2758,6881,10333,11777,7389,22759,20913,1846,20913,15471,5442,2021-01-01,zipcode
ZCTA5 33460,12,36346,51272,1229,255000,28191,9448,23847,6741,5863,6156,2960,2127,14002,12328,1674,12328,5358,6970,2021-01-01,zipcode
ZCTA5 33461,12,47633,52621,1333,193300,37956,11684,32611,8101,10465,7870,3774,2401,18212,15771,2441,15771,7644,8127,2021-01-01,zipcode
ZCTA5 33462,12,32371,59868,1400,251700,27674,8997,24723,3712,7274,7262,4247,2228,15652,12727,2925,12727,7847,4880,2021-01-01,zipcode
ZCTA5 33463,12,65754,59791,1469,244900,51323,15746,43557,8198,12628,12157,7076,3498,22817,20371,2446,20371,14336,6035,2021-01-01,zipcode
ZCTA5 33467,12,54790,75617,1452,326400,46019,19990,40951,2997,10026,11955,10168,5805,24669,21173,3496,21173,18510,2663,2021-01-01,zipcode
ZCTA5 33469,12,14754,90920,1785,430600,12675,6559,11741,302,2299,3443,3609,2088,8598,6711,1887,6711,5884,827,2021-01-01,zipcode
ZCTA5 33470,12,28800,97741,2207,383700,23816,8038,20383,2322,5670,7457,3308,1626,9639,8961,678,8961,8116,845,2021-01-01,zipcode
ZCTA5 33471,12,6571,36912,675,79400,5796,4030,5316,1807,1760,994,512,243,3368,2380,988,2380,1815,565,2021-01-01,zipcode
ZCTA5 33472,12,19422,78828,1988,322200,17102,9277,15747,807,3496,5028,3503,2913,8871,8020,851,8020,7558,462,2021-01-01,zipcode
ZCTA5 33473,12,11454,131484,3205,594400,8834,4328,8002,105,874,2191,1745,3087,4735,4116,619,4116,3958,158,2021-01-01,zipcode
ZCTA5 33476,12,7001,22079,674,97700,5343,2690,4329,1409,1401,924,526,69,2319,2083,236,2083,731,1352,2021-01-01,zipcode
ZCTA5 33477,12,11712,99865,1978,473400,11165,6792,10747,278,1663,2656,3553,2597,11015,6532,4483,6532,5694,838,2021-01-01,zipcode
ZCTA5 33478,12,15064,130041,2518,470200,12204,4104,11136,459,2243,3428,3304,1702,5587,5132,455,5132,4984,148,2021-01-01,zipcode
ZCTA5 33480,12,11050,144300,1720,1008600,10487,6984,10360,208,984,2428,3380,3360,12325,6436,5889,6436,5361,1075,2021-01-01,zipcode
ZCTA5 33483,12,12795,106108,2088,625000,11883,5236,11124,550,1412,2540,3904,2718,9620,6584,3036,6584,4510,2074,2021-01-01,zipcode
ZCTA5 33484,12,26457,47056,1420,167900,24678,15069,23554,1418,6163,7294,4852,3827,18998,14639,4359,14639,11709,2930,2021-01-01,zipcode
ZCTA5 33486,12,22515,94338,1925,505800,17891,6407,15428,547,2644,4249,5224,2764,9967,8816,1151,8816,6464,2352,2021-01-01,zipcode
ZCTA5 33487,12,21691,80034,1912,442200,18754,8587,16909,533,2040,4221,5911,4204,13457,9859,3598,9859,7196,2663,2021-01-01,zipcode
ZCTA5 33493,12,6298,50125,988,99500,5646,4334,5187,2223,1834,782,266,82,969,860,109,860,488,372,2021-01-01,zipcode
ZCTA5 33496,12,23144,97855,2274,384900,19806,10345,18114,700,2448,3808,6611,4547,11962,10121,1841,10121,8507,1614,2021-01-01,zipcode
ZCTA5 33498,12,16769,110440,2484,446200,13310,5281,11755,849,1528,2804,3705,2869,6034,5742,292,5742,5158,584,2021-01-01,zipcode
ZCTA5 33503,12,269,-666666666,-666666666,332100,269,56,135,49,27,44,15,0,77,77,0,77,57,20,2021-01-01,zipcode
ZCTA5 33510,12,29629,62579,1184,213500,24417,8886,21322,1728,7162,6810,4275,1347,11965,11312,653,11312,6859,4453,2021-01-01,zipcode
ZCTA5 33511,12,59118,63863,1398,237600,47808,17150,41380,3603,10023,13231,10531,3992,24098,22233,1865,22233,11906,10327,2021-01-01,zipcode
ZCTA5 33513,12,12781,47535,927,156500,10577,6673,9208,1668,3709,2747,650,434,5222,4138,1084,4138,3237,901,2021-01-01,zipcode
ZCTA5 33514,12,2391,56198,856,119100,1832,782,1640,401,715,339,107,78,835,761,74,761,461,300,2021-01-01,zipcode
ZCTA5 33521,12,596,50114,838,108600,481,218,412,77,205,109,15,6,322,206,116,206,147,59,2021-01-01,zipcode
ZCTA5 33523,12,18684,53775,836,179200,15477,6203,12908,2223,5011,3059,1633,982,7794,6552,1242,6552,4748,1804,2021-01-01,zipcode
ZCTA5 33525,12,17940,60452,872,184600,14627,7147,12903,1452,4438,3769,2261,983,8046,6860,1186,6860,5010,1850,2021-01-01,zipcode
ZCTA5 33527,12,16814,62641,802,256200,13717,5543,11594,2419,4065,2866,1480,764,5777,5359,418,5359,4004,1355,2021-01-01,zipcode
ZCTA5 33534,12,17859,73443,1147,214400,12428,3661,10572,1875,3557,3134,1378,628,5985,5520,465,5520,3810,1710,2021-01-01,zipcode
ZCTA5 33538,12,4983,40199,690,121400,4236,2174,3861,674,1514,1040,430,203,3019,2305,714,2305,1789,516,2021-01-01,zipcode
ZCTA5 33540,12,10223,43569,858,97200,9007,5197,8060,1031,3210,2724,774,321,5476,4539,937,4539,3665,874,2021-01-01,zipcode
ZCTA5 33541,12,22459,44324,1117,82500,19393,12366,17994,2579,6391,6165,1950,909,13715,9991,3724,9991,8254,1737,2021-01-01,zipcode
ZCTA5 33542,12,23134,40765,933,94400,19693,11567,17639,2191,6756,6134,1702,856,13458,10393,3065,10393,7268,3125,2021-01-01,zipcode
ZCTA5 33543,12,32610,93289,1686,256300,25159,8577,21695,1200,3738,6476,5878,4403,12350,11371,979,11371,9592,1779,2021-01-01,zipcode
ZCTA5 33544,12,28270,91647,1727,286800,21442,6300,18451,1796,3752,5270,4538,3095,9967,9437,530,9437,6553,2884,2021-01-01,zipcode
ZCTA5 33545,12,23118,90118,1711,248300,18028,4846,15232,744,3061,5758,3548,2121,7678,7199,479,7199,5717,1482,2021-01-01,zipcode
ZCTA5 33547,12,29236,107883,1927,360800,20799,6909,18041,542,4002,5030,5034,3433,9759,9100,659,9100,7340,1760,2021-01-01,zipcode
ZCTA5 33548,12,7385,123060,1558,405400,5874,1874,5148,137,884,1268,1616,1243,2766,2688,78,2688,2340,348,2021-01-01,zipcode
ZCTA5 33549,12,18677,72618,1348,249600,15713,6047,13976,766,3320,4542,3004,2344,7732,7376,356,7376,5801,1575,2021-01-01,zipcode
ZCTA5 33556,12,27729,128333,1419,445700,21606,7577,19148,560,3045,5009,6263,4271,10444,9714,730,9714,8497,1217,2021-01-01,zipcode
ZCTA5 33558,12,27309,92650,1202,372000,21236,7212,18393,479,3514,4365,5671,4364,10548,9958,590,9958,7295,2663,2021-01-01,zipcode
ZCTA5 33559,12,17355,76075,1341,236700,14356,4260,11082,901,3173,2984,2473,1551,6651,6335,316,6335,4002,2333,2021-01-01,zipcode
ZCTA5 33563,12,27097,48675,1015,147600,21220,7321,18025,4029,5820,5162,2223,791,10867,9940,927,9940,5638,4302,2021-01-01,zipcode
ZCTA5 33565,12,17394,53434,977,189700,13416,5703,12139,2110,4045,3686,1555,743,6696,6086,610,6086,4915,1171,2021-01-01,zipcode
ZCTA5 33566,12,22415,65550,1177,232600,17624,6223,15161,2035,5750,3731,2419,1226,8059,7752,307,7752,5423,2329,2021-01-01,zipcode
ZCTA5 33567,12,11821,83763,1108,230100,9607,2964,8275,1771,2831,1724,1378,571,4057,3769,288,3769,3091,678,2021-01-01,zipcode
ZCTA5 33569,12,25960,83073,1690,251700,20472,6705,18119,1368,4730,5752,4090,2179,10049,9421,628,9421,7742,1679,2021-01-01,zipcode
ZCTA5 33570,12,30088,61112,1044,189300,23199,8697,19880,2685,6535,6536,2617,1507,12549,10296,2253,10296,7465,2831,2021-01-01,zipcode
ZCTA5 33572,12,22771,101828,1738,311900,18193,6149,16491,513,3262,5292,4471,2953,9423,8767,656,8767,7376,1391,2021-01-01,zipcode
ZCTA5 33573,12,26042,55912,1697,200400,24247,17637,23510,1197,6693,7523,4988,3109,15736,13640,2096,13640,11133,2507,2021-01-01,zipcode
ZCTA5 33576,12,4698,68750,895,231400,4371,2750,4134,147,1066,1529,816,576,2563,2317,246,2317,2122,195,2021-01-01,zipcode
ZCTA5 33578,12,54136,64993,1455,226200,42664,11917,37143,2328,9927,12506,8319,4063,24060,22071,1989,22071,12443,9628,2021-01-01,zipcode
ZCTA5 33579,12,39551,90018,1869,261400,29971,8536,26660,3182,6255,8798,5861,2564,13313,12506,807,12506,9413,3093,2021-01-01,zipcode
ZCTA5 33584,12,26711,58025,1195,218900,21222,8671,18875,2676,5586,6017,3229,1367,10301,9582,719,9582,7148,2434,2021-01-01,zipcode
ZCTA5 33585,12,1350,59400,868,190200,1167,673,1044,226,333,357,75,53,608,484,124,484,380,104,2021-01-01,zipcode
ZCTA5 33592,12,11771,50817,862,160800,9898,4613,8536,1606,3246,1898,1008,778,4712,4055,657,4055,2672,1383,2021-01-01,zipcode
ZCTA5 33594,12,36154,80437,1521,222500,29774,9594,25469,2352,7245,7964,5537,2371,13755,13077,678,13077,10174,2903,2021-01-01,zipcode
ZCTA5 33596,12,30103,101813,1935,306800,24375,8138,21317,1224,4086,6054,6817,3136,10649,10198,451,10198,8519,1679,2021-01-01,zipcode
ZCTA5 33597,12,8414,52319,835,138900,7172,3033,6047,979,2428,1960,605,75,3888,3187,701,3187,2600,587,2021-01-01,zipcode
ZCTA5 33598,12,26115,77790,965,266400,19303,8694,16549,3660,5050,3870,2246,1723,8353,7705,648,7705,6485,1220,2021-01-01,zipcode
ZCTA5 33602,12,16044,82755,1778,407100,14168,3871,12961,1053,1894,2490,4237,3287,10344,8892,1452,8892,3072,5820,2021-01-01,zipcode
ZCTA5 33603,12,20245,54650,1100,249500,16456,4408,14642,1505,3813,3920,3421,1983,9494,8560,934,8560,5050,3510,2021-01-01,zipcode
ZCTA5 33604,12,38743,46617,1061,199800,31335,10427,27619,4081,9221,7874,4425,2018,16771,15302,1469,15302,8620,6682,2021-01-01,zipcode
ZCTA5 33605,12,16139,28219,972,165800,13032,5519,11427,2781,4061,2835,1222,528,8557,7140,1417,7140,2502,4638,2021-01-01,zipcode
ZCTA5 33606,12,21281,100386,1617,669500,18557,6130,13137,214,1161,1960,5845,3957,10058,8693,1365,8693,3752,4941,2021-01-01,zipcode
ZCTA5 33607,12,24171,50241,1511,217000,20898,7071,18553,3255,5252,4002,3840,2204,12485,10694,1791,10694,4462,6232,2021-01-01,zipcode
ZCTA5 33609,12,18117,88794,1434,419600,15152,4464,13466,1022,1544,2670,4545,3685,9085,8330,755,8330,5121,3209,2021-01-01,zipcode
ZCTA5 33610,12,47068,40085,1107,153800,34397,13388,29109,5568,10460,8272,3110,1699,18098,16775,1323,16775,7749,9026,2021-01-01,zipcode
ZCTA5 33611,12,34295,68602,1291,324300,28107,8914,25967,1320,5136,6086,7986,5439,17580,16136,1444,16136,8914,7222,2021-01-01,zipcode
ZCTA5 33612,12,49352,38023,1047,177900,38394,15489,31611,6807,10847,7967,4458,1532,20643,18746,1897,18746,6640,12106,2021-01-01,zipcode
ZCTA5 33613,12,36941,38085,1000,187900,31672,11292,21393,3172,6032,5855,4077,2257,17860,15808,2052,15808,4700,11108,2021-01-01,zipcode
ZCTA5 33614,12,47591,46740,1111,213200,40252,12325,35051,7349,12154,7935,5675,1938,19547,18410,1137,18410,7364,11046,2021-01-01,zipcode
ZCTA5 33615,12,47969,56352,1320,225200,39145,10661,35015,3937,12344,9252,6615,2867,20242,18494,1748,18494,9917,8577,2021-01-01,zipcode
ZCTA5 33616,12,14531,74245,1402,273700,11837,3112,10452,540,2652,2823,2470,1967,6651,6086,565,6086,3097,2989,2021-01-01,zipcode
ZCTA5 33617,12,47472,41961,1099,212600,39113,13258,30479,4138,8741,8879,5544,3177,20854,19168,1686,19168,7675,11493,2021-01-01,zipcode
ZCTA5 33618,12,27396,69313,1172,312900,23062,7885,20756,813,4621,5880,5976,3466,12656,11957,699,11957,7932,4025,2021-01-01,zipcode
ZCTA5 33619,12,41225,50967,1319,151100,31965,12526,27005,4588,9491,7416,3398,2112,15102,14074,1028,14074,7323,6751,2021-01-01,zipcode
ZCTA5 33620,12,4743,-666666666,-666666666,-666666666,4743,3496,43,10,0,33,0,0,22,10,12,10,0,10,2021-01-01,zipcode
ZCTA5 33621,12,2599,82188,2349,-666666666,1716,508,1050,0,240,308,236,266,611,536,75,536,0,536,2021-01-01,zipcode
ZCTA5 33624,12,40904,73107,1405,265500,33252,9979,29506,1887,6777,8271,8246,4325,16100,15533,567,15533,10104,5429,2021-01-01,zipcode
ZCTA5 33625,12,28577,76694,1599,280600,23856,8028,20788,1372,5185,6240,5062,2929,11746,11133,613,11133,7519,3614,2021-01-01,zipcode
ZCTA5 33626,12,29944,114449,1719,381200,23554,7421,20735,890,2804,4408,7933,4700,12188,11518,670,11518,8022,3496,2021-01-01,zipcode
ZCTA5 33629,12,26175,139158,1415,629800,19670,6322,17746,431,1291,2894,6777,6353,11059,10163,896,10163,7971,2192,2021-01-01,zipcode
ZCTA5 33634,12,23662,62334,1405,219100,19063,6251,16142,1836,4754,4524,3606,1422,8307,7839,468,7839,4418,3421,2021-01-01,zipcode
ZCTA5 33635,12,20075,74867,1433,231000,16283,4958,14578,913,3676,4157,4009,1823,8466,7624,842,7624,4624,3000,2021-01-01,zipcode
ZCTA5 33637,12,18522,52280,1209,171400,14597,4520,12359,1412,2758,3775,2844,1570,7833,7236,597,7236,3190,4046,2021-01-01,zipcode
ZCTA5 33647,12,71767,96843,1545,330100,55173,16198,47521,1938,6785,10983,15685,12130,26694,25206,1488,25206,14554,10652,2021-01-01,zipcode
ZCTA5 33701,12,16802,54192,1227,413300,15358,5889,14017,572,2248,3777,4266,3154,13113,9405,3708,9405,3627,5778,2021-01-01,zipcode
ZCTA5 33702,12,32150,57512,1139,213900,27263,10150,24386,2145,6340,7371,5942,2588,16399,14241,2158,14241,9350,4891,2021-01-01,zipcode
ZCTA5 33703,12,26709,90641,1304,310100,22052,7420,20087,694,3263,5805,5723,4602,12335,11132,1203,11132,8868,2264,2021-01-01,zipcode
ZCTA5 33704,12,16059,89120,1165,468400,13877,4177,12875,307,2023,3131,4289,3125,8905,7689,1216,7689,5374,2315,2021-01-01,zipcode
ZCTA5 33705,12,26749,62672,1223,222100,22803,8420,20210,1710,5266,6277,4666,2291,15031,11145,3886,11145,6656,4489,2021-01-01,zipcode
ZCTA5 33706,12,15478,88219,1308,478700,14717,7481,13992,496,2330,4340,4316,2510,13764,8273,5491,8273,6284,1989,2021-01-01,zipcode
ZCTA5 33707,12,25260,56393,1217,262900,23325,11894,21783,1244,5325,7262,4959,2993,16645,12659,3986,12659,8597,4062,2021-01-01,zipcode
ZCTA5 33708,12,14826,66959,1571,363300,13813,7297,13013,523,2892,4308,3134,2156,13596,7747,5849,7747,5793,1954,2021-01-01,zipcode
ZCTA5 33709,12,23264,46290,1140,150900,20375,9153,18519,2279,6892,5606,2633,1109,14037,10493,3544,10493,7936,2557,2021-01-01,zipcode
ZCTA5 33710,12,34462,65195,1315,227200,28921,10293,26007,1828,7394,7553,6668,2564,16487,14176,2311,14176,11411,2765,2021-01-01,zipcode
ZCTA5 33711,12,18409,60488,1313,200300,15217,6889,12007,549,4256,3750,2191,1261,9046,6180,2866,6180,4109,2071,2021-01-01,zipcode
ZCTA5 33712,12,24495,52507,1183,213100,19629,7615,16698,1330,4965,5440,3447,1516,12692,9340,3352,9340,5301,4039,2021-01-01,zipcode
ZCTA5 33713,12,32572,62088,1132,201400,27447,8746,25063,2742,6500,7914,5667,2240,15722,14053,1669,14053,9714,4339,2021-01-01,zipcode
ZCTA5 33714,12,20163,41239,1113,125300,16865,7042,15055,2278,5880,4302,2032,563,9959,8172,1787,8172,5177,2995,2021-01-01,zipcode
ZCTA5 33715,12,7653,96250,2316,390600,6768,3891,6500,88,838,2006,1631,1937,7041,3672,3369,3672,3289,383,2021-01-01,zipcode
ZCTA5 33716,12,18396,63434,1446,138700,16171,3136,13910,628,2239,5031,4020,1992,11115,9557,1558,9557,1879,7678,2021-01-01,zipcode
ZCTA5 33744,12,73,-666666666,-666666666,-666666666,73,73,61,20,41,0,0,0,0,0,0,0,0,0,2021-01-01,zipcode
ZCTA5 33755,12,27437,47013,1068,214000,22260,8256,19775,2743,6395,5995,2993,1649,11823,10529,1294,10529,5969,4560,2021-01-01,zipcode
ZCTA5 33756,12,32899,49911,1077,232300,27495,11584,24813,2837,7642,7068,4900,2366,15581,13378,2203,13378,7887,5491,2021-01-01,zipcode
ZCTA5 33759,12,17370,57259,1500,211800,14537,6192,12925,1136,3187,4032,2856,1714,8814,7746,1068,7746,4154,3592,2021-01-01,zipcode
ZCTA5 33760,12,21304,51224,1176,159200,18506,7682,15756,2477,4962,4925,2309,1083,8641,7524,1117,7524,3374,4150,2021-01-01,zipcode
ZCTA5 33761,12,19308,61001,1373,206200,16608,8119,15551,957,3788,4964,3560,2282,9954,8881,1073,8881,6897,1984,2021-01-01,zipcode
ZCTA5 33762,12,5402,71268,1459,248900,4769,1463,4504,98,834,1301,1450,821,3179,2655,524,2655,2069,586,2021-01-01,zipcode
ZCTA5 33763,12,20657,45589,1233,154300,17851,9128,16502,1507,5139,5274,2799,1783,11464,9755,1709,9755,7059,2696,2021-01-01,zipcode
ZCTA5 33764,12,27600,56530,1351,236300,23761,9243,21247,1307,6410,6775,4399,2356,14902,12091,2811,12091,8280,3811,2021-01-01,zipcode
ZCTA5 33765,12,15257,53892,1264,222700,13130,4665,11824,1664,3461,3468,2149,1082,7028,6526,502,6526,3555,2971,2021-01-01,zipcode
ZCTA5 33767,12,7615,94167,1778,557200,7224,4497,6881,231,1350,1645,2030,1625,8923,4120,4803,4120,3358,762,2021-01-01,zipcode
ZCTA5 33770,12,25880,51968,1160,189800,22562,9068,19385,2041,6068,6310,2986,1980,13312,11275,2037,11275,6895,4380,2021-01-01,zipcode
ZCTA5 33771,12,28174,51138,1186,92300,24315,10892,22186,1968,7374,7575,3930,1339,16772,12788,3984,12788,7713,5075,2021-01-01,zipcode
ZCTA5 33772,12,23559,65775,1247,243600,20109,8342,18024,1451,4776,6101,4127,1569,11953,9904,2049,9904,7235,2669,2021-01-01,zipcode
ZCTA5 33773,12,17135,64017,1287,212600,14835,5062,13340,1345,3487,4417,3188,903,8265,7043,1222,7043,5387,1656,2021-01-01,zipcode
ZCTA5 33774,12,19691,64717,1236,243000,16165,6787,14799,1006,3898,5979,2490,1426,10445,8330,2115,8330,6438,1892,2021-01-01,zipcode
ZCTA5 33776,12,13181,86951,1822,343800,10984,4705,9825,300,2331,2601,2937,1656,5506,5004,502,5004,4555,449,2021-01-01,zipcode
ZCTA5 33777,12,17214,78330,1501,218300,14535,5284,13112,699,3485,4129,3101,1698,8299,7057,1242,7057,5972,1085,2021-01-01,zipcode
ZCTA5 33778,12,15912,57697,1161,206600,13212,5366,12053,1028,3434,4491,1804,1296,7865,6219,1646,6219,5130,1089,2021-01-01,zipcode
ZCTA5 33781,12,26887,47210,959,175200,22582,8666,20224,3805,6046,6081,3088,1204,12252,10384,1868,10384,6507,3877,2021-01-01,zipcode
ZCTA5 33782,12,22457,58548,1375,186700,19041,8218,17351,1909,5205,5679,3051,1507,10579,9249,1330,9249,6868,2381,2021-01-01,zipcode
ZCTA5 33785,12,4873,85391,1371,496900,4556,1989,4180,115,632,1335,1291,807,5856,2477,3379,2477,1879,598,2021-01-01,zipcode
ZCTA5 33786,12,1607,106250,2353,769000,1438,738,1366,65,150,347,472,332,1162,718,444,718,647,71,2021-01-01,zipcode
ZCTA5 33801,12,32411,41008,930,98200,26012,12689,20360,3417,8188,5969,1771,1015,15078,11630,3448,11630,5786,5844,2021-01-01,zipcode
ZCTA5 33803,12,29942,58437,1149,179700,24544,10038,21157,1642,6123,6117,4328,2947,14737,11878,2859,11878,7328,4550,2021-01-01,zipcode
ZCTA5 33805,12,25229,41818,1050,122000,20115,9291,17643,3340,6822,4780,1838,863,11003,9473,1530,9473,4408,5065,2021-01-01,zipcode
ZCTA5 33809,12,30368,58037,1226,186100,24974,10312,21744,2085,6923,7367,3475,1894,12510,11272,1238,11272,7321,3951,2021-01-01,zipcode
ZCTA5 33810,12,51505,60228,1233,180300,42065,17765,36504,4542,12823,12850,4278,2011,21356,18926,2430,18926,14258,4668,2021-01-01,zipcode
ZCTA5 33811,12,24186,75483,1138,218700,19445,7037,16758,1532,4694,5340,3845,1347,9586,8554,1032,8554,6612,1942,2021-01-01,zipcode
ZCTA5 33812,12,14241,87885,1366,228200,11413,3798,9465,531,2899,2961,1702,1372,5399,4556,843,4556,3525,1031,2021-01-01,zipcode
ZCTA5 33813,12,38103,89774,1430,262100,29247,10630,25313,1288,6101,8313,6209,3402,14325,13391,934,13391,10401,2990,2021-01-01,zipcode
ZCTA5 33815,12,14965,33422,907,23000,11795,6180,10056,2372,3936,2754,707,287,7543,6004,1539,6004,3384,2620,2021-01-01,zipcode
ZCTA5 33823,12,36098,57879,885,173200,29084,12175,25142,4085,9508,6752,3525,1272,13779,12068,1711,12068,8475,3593,2021-01-01,zipcode
ZCTA5 33825,12,25264,41275,766,113400,21157,11875,18506,3600,6520,5688,1786,912,12098,9905,2193,9905,7206,2699,2021-01-01,zipcode
ZCTA5 33827,12,2770,59464,1597,180000,2331,1197,1791,240,649,579,198,125,1257,879,378,879,774,105,2021-01-01,zipcode
ZCTA5 33830,12,29151,50298,901,161500,23050,9219,20000,2495,7704,5757,2927,1117,11419,9917,1502,9917,6537,3380,2021-01-01,zipcode
ZCTA5 33834,12,6799,41981,797,84500,5481,3290,4605,1087,2198,881,285,154,2092,1652,440,1652,1088,564,2021-01-01,zipcode
ZCTA5 33837,12,34428,63266,1544,226800,27190,11987,24290,2299,7550,7993,4402,2046,15979,11775,4204,11775,9461,2314,2021-01-01,zipcode
ZCTA5 33838,12,5070,40737,993,166000,3758,1847,3368,1030,1209,936,143,50,1864,1492,372,1492,1007,485,2021-01-01,zipcode
ZCTA5 33839,12,4221,65417,1002,142300,3198,1124,2678,646,841,797,328,66,1571,1260,311,1260,941,319,2021-01-01,zipcode
ZCTA5 33841,12,8149,39708,800,121800,6643,3403,5664,1012,2528,1402,418,304,3651,2841,810,2841,2160,681,2021-01-01,zipcode
ZCTA5 33843,12,11034,49726,796,76900,9736,6185,8554,1993,3210,2202,598,551,5817,3942,1875,3942,3297,645,2021-01-01,zipcode
ZCTA5 33844,12,43911,51748,1021,156600,35229,15109,29987,5287,10840,9212,3113,1535,19852,14563,5289,14563,10157,4406,2021-01-01,zipcode
ZCTA5 33847,12,288,60000,675,112500,236,114,171,16,34,96,18,7,102,102,0,102,78,24,2021-01-01,zipcode
ZCTA5 33848,12,1062,61594,905,-666666666,915,417,743,255,340,120,0,28,342,209,133,209,130,79,2021-01-01,zipcode
ZCTA5 33849,12,534,28810,-666666666,148200,481,350,420,110,266,34,0,10,262,168,94,168,126,42,2021-01-01,zipcode
ZCTA5 33850,12,8535,43886,939,165700,7180,3219,6567,946,2784,1753,601,483,4309,3175,1134,3175,2263,912,2021-01-01,zipcode
ZCTA5 33851,12,805,52109,-666666666,174400,665,377,596,131,219,176,54,16,355,255,100,255,228,27,2021-01-01,zipcode
ZCTA5 33852,12,20813,46525,913,148000,17472,9942,16305,2525,6582,4341,1750,1107,13031,8995,4036,8995,7208,1787,2021-01-01,zipcode
ZCTA5 33853,12,11530,40423,890,167100,8960,4270,8007,1354,2806,2409,933,505,5277,4452,825,4452,2364,2088,2021-01-01,zipcode
ZCTA5 33854,12,530,35139,645,74200,505,364,482,122,89,155,79,37,671,273,398,273,85,188,2021-01-01,zipcode
ZCTA5 33855,12,112,51250,-666666666,275000,112,72,112,27,68,17,0,0,37,37,0,37,37,0,2021-01-01,zipcode
ZCTA5 33856,12,297,24538,568,-666666666,297,203,297,19,91,159,28,0,497,235,262,235,6,229,2021-01-01,zipcode
ZCTA5 33857,12,1200,32304,-666666666,70100,1121,639,1087,99,670,212,93,13,1095,619,476,619,473,146,2021-01-01,zipcode
ZCTA5 33859,12,10573,50879,949,167000,8819,4774,7739,921,2646,2740,822,610,5589,4263,1326,4263,3219,1044,2021-01-01,zipcode
ZCTA5 33860,12,26338,56770,1003,166800,19861,7119,16925,2924,5851,5682,1621,847,9747,8556,1191,8556,5756,2800,2021-01-01,zipcode
ZCTA5 33865,12,1006,58345,596,135700,919,487,859,208,287,240,91,33,291,291,0,291,211,80,2021-01-01,zipcode
ZCTA5 33867,12,139,38958,-666666666,86400,139,127,139,14,50,62,13,0,125,90,35,90,90,0,2021-01-01,zipcode
ZCTA5 33868,12,13718,57051,971,154200,11073,6178,9888,1614,3800,2898,1052,524,5282,4146,1136,4146,3606,540,2021-01-01,zipcode
ZCTA5 33870,12,25301,38610,844,108100,21237,12070,18830,3106,6870,5846,1979,1029,13995,10974,3021,10974,7398,3576,2021-01-01,zipcode
ZCTA5 33872,12,12916,63706,974,137800,11384,7228,10441,778,2934,3718,1882,1129,7638,5834,1804,5834,5081,753,2021-01-01,zipcode
ZCTA5 33873,12,13273,35082,816,105900,9778,4705,8279,1934,3839,1655,637,214,5619,4741,878,4741,2996,1745,2021-01-01,zipcode
ZCTA5 33875,12,10616,61481,797,171600,9062,4833,8488,774,2952,2610,1460,692,5403,4734,669,4734,3783,951,2021-01-01,zipcode
ZCTA5 33876,12,6098,49026,933,126300,5307,3351,5018,593,2008,1728,485,204,3173,2501,672,2501,2129,372,2021-01-01,zipcode
ZCTA5 33877,12,158,-666666666,-666666666,167200,158,43,158,0,91,67,0,0,195,125,70,125,125,0,2021-01-01,zipcode
ZCTA5 33880,12,43354,50502,939,150700,33149,13269,28239,5722,10606,8360,2564,987,16830,14590,2240,14590,9202,5388,2021-01-01,zipcode
ZCTA5 33881,12,35142,45910,1010,113600,28257,15116,25134,3299,8818,8702,2844,1471,16665,13437,3228,13437,9371,4066,2021-01-01,zipcode
ZCTA5 33884,12,36300,62203,1278,211500,30406,13743,26571,2346,7466,9388,4950,2421,15782,13607,2175,13607,10354,3253,2021-01-01,zipcode
ZCTA5 33890,12,4750,46750,813,99900,3564,1485,2945,711,1449,495,186,104,1841,1400,441,1400,1079,321,2021-01-01,zipcode
ZCTA5 33896,12,17830,59858,1646,233800,14920,4071,12245,809,2802,4702,2656,1276,9565,6471,3094,6471,3078,3393,2021-01-01,zipcode
ZCTA5 33897,12,25842,59636,1698,213500,20580,6897,18028,1289,6249,6388,3039,1063,13281,8803,4478,8803,5959,2844,2021-01-01,zipcode
ZCTA5 33898,12,16194,48185,968,123400,13300,6976,12167,2216,4257,3665,1416,613,9446,6670,2776,6670,5494,1176,2021-01-01,zipcode
ZCTA5 33901,12,23531,43565,1076,238500,18948,8610,16524,2814,5535,3892,2567,1716,11163,9246,1917,9246,3772,5474,2021-01-01,zipcode
ZCTA5 33903,12,21509,51758,969,106300,19446,11214,18082,1861,5744,6538,2397,1542,15362,10902,4460,10902,8739,2163,2021-01-01,zipcode
ZCTA5 33904,12,31594,55026,1296,256900,28176,14460,26820,1516,9535,9015,4577,2177,20255,14605,5650,14605,11214,3391,2021-01-01,zipcode
ZCTA5 33905,12,37700,59081,1303,175900,30838,13667,26816,5484,9026,7073,3356,1877,15910,13046,2864,13046,8575,4471,2021-01-01,zipcode
ZCTA5 33907,12,25268,47108,1233,185900,21439,7984,19008,2181,5943,5724,3271,1889,13757,10805,2952,10805,4427,6378,2021-01-01,zipcode
ZCTA5 33908,12,36555,61875,1446,267900,33908,20629,31859,1448,8734,8094,7829,5754,31475,18899,12576,18899,13211,5688,2021-01-01,zipcode
ZCTA5 33909,12,33658,67325,1456,214700,27064,9781,23485,1623,9412,7266,3227,1957,12846,11751,1095,11751,8274,3477,2021-01-01,zipcode
ZCTA5 33912,12,19521,90633,1476,294400,17580,9667,16152,544,3407,4583,4413,3205,11752,8609,3143,8609,7361,1248,2021-01-01,zipcode
ZCTA5 33913,12,26117,94881,1496,331600,22074,11466,19174,1207,4151,5175,5032,3609,14145,10000,4145,10000,8706,1294,2021-01-01,zipcode
ZCTA5 33914,12,42036,67034,1353,310700,37838,16242,34896,1918,12130,12014,5310,3524,21985,17216,4769,17216,13901,3315,2021-01-01,zipcode
ZCTA5 33916,12,25429,39477,1091,154500,19984,7958,17069,3455,6347,3870,2294,1103,11873,9339,2534,9339,3175,6164,2021-01-01,zipcode
ZCTA5 33917,12,30120,48005,983,130900,26977,14575,25236,3054,9168,8418,2944,1652,18124,13709,4415,13709,11209,2500,2021-01-01,zipcode
ZCTA5 33919,12,28787,62778,1357,230300,25775,12458,24224,1214,5484,7565,6031,3930,18996,14015,4981,14015,10603,3412,2021-01-01,zipcode
ZCTA5 33920,12,6488,77051,869,254400,5282,2359,4793,415,1285,1814,836,443,2799,2401,398,2401,2224,177,2021-01-01,zipcode
ZCTA5 33921,12,925,120208,-666666666,2000001,923,706,905,28,94,302,280,201,1803,435,1368,435,410,25,2021-01-01,zipcode
ZCTA5 33922,12,4236,50216,1098,238900,3599,2218,3430,460,1014,935,513,508,2829,1779,1050,1779,1497,282,2021-01-01,zipcode
ZCTA5 33924,12,173,-666666666,-666666666,-666666666,173,81,145,59,16,22,42,6,1856,35,1821,35,35,0,2021-01-01,zipcode
ZCTA5 33928,12,28600,89220,1763,323500,25218,14515,24055,910,4813,7468,6231,4633,19687,13072,6615,13072,11142,1930,2021-01-01,zipcode
ZCTA5 33930,12,577,-666666666,-666666666,110300,430,96,346,57,161,84,0,44,384,292,92,292,226,66,2021-01-01,zipcode
ZCTA5 33931,12,9186,66898,1384,358700,8945,6110,8645,461,2663,2535,1585,1401,14661,4695,9966,4695,4231,464,2021-01-01,zipcode
ZCTA5 33935,12,22083,39283,906,130800,16544,6434,13922,4359,4832,3181,1052,498,8079,6924,1155,6924,4993,1931,2021-01-01,zipcode
ZCTA5 33936,12,27178,41634,1089,152700,21723,9716,18733,3966,7342,4862,1716,847,10400,9360,1040,9360,5925,3435,2021-01-01,zipcode
ZCTA5 33944,12,182,-666666666,-666666666,-666666666,182,106,182,0,91,91,0,0,144,106,38,106,106,0,2021-01-01,zipcode
ZCTA5 33946,12,2830,90625,-666666666,509000,2698,1512,2578,45,693,871,535,434,3037,1374,1663,1374,1267,107,2021-01-01,zipcode
ZCTA5 33947,12,9486,55720,1155,261500,8926,5784,8614,565,2780,3214,1341,714,6508,4885,1623,4885,3827,1058,2021-01-01,zipcode
ZCTA5 33948,12,17523,54487,1182,217300,15931,8855,14985,1391,5121,5492,1914,1067,9351,7666,1685,7666,6523,1143,2021-01-01,zipcode
ZCTA5 33950,12,24039,64856,1172,311200,21417,13682,20008,901,4901,7229,4292,2685,15867,11693,4174,11693,9581,2112,2021-01-01,zipcode
ZCTA5 33952,12,34214,48992,1048,169300,29938,15183,27031,2981,10062,8856,3393,1739,17126,14601,2525,14601,10767,3834,2021-01-01,zipcode
ZCTA5 33953,12,7084,66287,985,250000,6574,4093,5996,490,1762,2092,1072,580,3967,3037,930,3037,2946,91,2021-01-01,zipcode
ZCTA5 33954,12,10355,73098,1377,248700,9071,3880,8273,707,2419,3183,1386,578,4402,4108,294,4108,3183,925,2021-01-01,zipcode
ZCTA5 33955,12,10429,69461,1131,260500,9507,5932,8957,986,2500,2734,1713,1024,6746,4684,2062,4684,4413,271,2021-01-01,zipcode
ZCTA5 33956,12,3551,59098,2139,238700,3370,2121,3244,240,1165,1099,332,408,3529,1719,1810,1719,1531,188,2021-01-01,zipcode
ZCTA5 33957,12,6437,103413,794,730400,6292,3979,6134,59,1251,1257,1715,1852,8611,3471,5140,3471,3114,357,2021-01-01,zipcode
ZCTA5 33960,12,603,37647,-666666666,181900,483,247,476,47,191,155,58,25,505,304,201,304,263,41,2021-01-01,zipcode
ZCTA5 33965,12,2530,-666666666,-666666666,-666666666,2530,1370,36,0,0,33,3,0,0,0,0,0,0,0,2021-01-01,zipcode
ZCTA5 33966,12,9738,70949,1338,297000,8057,3414,7491,254,1348,2359,2240,1290,6165,4491,1674,4491,3118,1373,2021-01-01,zipcode
ZCTA5 33967,12,26690,75641,1419,255200,21580,6617,17961,1711,4639,6313,3570,1728,10775,9185,1590,9185,6816,2369,2021-01-01,zipcode
ZCTA5 33971,12,28061,61465,1386,193700,20814,6934,16953,3448,5961,5112,1615,817,8333,7847,486,7847,5996,1851,2021-01-01,zipcode
ZCTA5 33972,12,14883,61908,1275,219300,11455,4727,9921,1159,4131,2974,1195,462,5013,4405,608,4405,3418,987,2021-01-01,zipcode
ZCTA5 33973,12,15048,44429,1166,243800,10040,3834,8141,1767,2908,2461,557,448,4342,4037,305,4037,830,3207,2021-01-01,zipcode
ZCTA5 33974,12,19187,55456,1377,193700,14606,5318,12080,1860,4636,3572,1365,647,5627,5180,447,5180,3384,1796,2021-01-01,zipcode
ZCTA5 33976,12,17137,58269,1364,186200,12267,3373,10063,2144,3161,3154,1220,384,4995,4708,287,4708,3225,1483,2021-01-01,zipcode
ZCTA5 33980,12,13173,54011,951,167700,11629,7369,10696,685,4139,3204,1661,1007,8139,6038,2101,6038,4740,1298,2021-01-01,zipcode
ZCTA5 33981,12,12683,61544,1338,273700,11267,6789,10972,729,3870,3576,1622,1175,6980,5448,1532,5448,4882,566,2021-01-01,zipcode
ZCTA5 33982,12,11016,50654,961,168100,9871,6286,9346,1554,3439,2757,861,735,5194,4157,1037,4157,3564,593,2021-01-01,zipcode
ZCTA5 33983,12,15487,60954,1061,265500,13334,6750,12139,629,4316,4151,2116,927,8424,6812,1612,6812,5660,1152,2021-01-01,zipcode
ZCTA5 33990,12,35283,63249,1400,246100,30076,11854,26801,2612,10223,7905,4404,1657,15336,12993,2343,12993,9306,3687,2021-01-01,zipcode
ZCTA5 33991,12,23899,70457,1706,269100,19328,7987,16779,894,5900,5647,3139,1199,10715,9004,1711,9004,7159,1845,2021-01-01,zipcode
ZCTA5 33993,12,29502,74807,1688,247300,23658,9214,20404,2117,7852,6318,2611,1506,11098,9987,1111,9987,8403,1584,2021-01-01,zipcode
ZCTA5 34101,12,0,-666666666,-666666666,-666666666,0,0,0,0,0,0,0,0,0,0,0,0,0,0,2021-01-01,zipcode
ZCTA5 34102,12,10723,101944,1273,1025800,9556,5464,8956,516,1281,2051,2845,2263,9434,5334,4100,5334,3864,1470,2021-01-01,zipcode
ZCTA5 34103,12,11310,104309,1461,790400,10420,5851,9509,302,1734,2252,2998,2223,10413,5535,4878,5535,4580,955,2021-01-01,zipcode
ZCTA5 34104,12,23813,58333,1464,269700,19641,9510,18302,1899,5267,5527,3673,1936,15398,10888,4510,10888,7271,3617,2021-01-01,zipcode
ZCTA5 34105,12,16530,90260,1785,473900,14598,6993,13523,402,2708,3475,4149,2789,11415,7766,3649,7766,4963,2803,2021-01-01,zipcode
ZCTA5 34108,12,16631,106290,1694,783400,15684,9697,14993,560,2386,3270,5091,3686,14995,8389,6606,8389,7103,1286,2021-01-01,zipcode
ZCTA5 34109,12,26000,81140,1466,447300,21860,11178,20178,904,4867,4639,5657,4111,15618,11908,3710,11908,8396,3512,2021-01-01,zipcode
ZCTA5 34110,12,24773,78133,1790,402200,22097,12686,20548,672,3952,5286,6246,4392,17724,12584,5140,12584,9146,3438,2021-01-01,zipcode
ZCTA5 34112,12,26789,63191,1226,236800,24510,13406,22480,2214,6755,6042,4304,3165,20038,12938,7100,12938,10014,2924,2021-01-01,zipcode
ZCTA5 34113,12,24383,67715,1452,355600,21509,11005,19228,2343,5354,4454,4384,2693,15564,10341,5223,10341,7241,3100,2021-01-01,zipcode
ZCTA5 34114,12,18599,72481,1573,331100,16574,9932,15572,1431,3999,4236,3362,2544,14198,8634,5564,8634,7142,1492,2021-01-01,zipcode
ZCTA5 34116,12,35705,62366,1369,282100,28297,7947,23971,4903,9190,5775,2588,1515,11304,10541,763,10541,5697,4844,2021-01-01,zipcode
ZCTA5 34117,12,18927,91241,1529,332300,15241,4734,13247,1745,4266,4378,2032,826,5763,5331,432,5331,4407,924,2021-01-01,zipcode
ZCTA5 34119,12,31714,96692,1481,512500,25770,12771,23629,735,4796,6186,6671,5241,17114,13477,3637,13477,10686,2791,2021-01-01,zipcode
ZCTA5 34120,12,35117,78015,1803,327300,29328,9523,25587,2852,8813,6883,4064,2975,15781,12228,3553,12228,10619,1609,2021-01-01,zipcode
ZCTA5 34134,12,14859,111258,1451,528600,14196,9551,13844,281,2026,3830,3972,3735,14392,7754,6638,7754,6351,1403,2021-01-01,zipcode
ZCTA5 34135,12,45996,76355,1418,324300,40368,20548,37170,4995,7890,10483,8224,5578,29075,19189,9886,19189,14997,4192,2021-01-01,zipcode
ZCTA5 34137,12,492,-666666666,-666666666,135200,236,60,236,0,159,77,0,0,139,139,0,139,114,25,2021-01-01,zipcode
ZCTA5 34138,12,958,83779,-666666666,-666666666,693,370,693,0,316,318,59,0,682,326,356,326,272,54,2021-01-01,zipcode
ZCTA5 34139,12,110,82750,-666666666,350000,102,37,102,0,32,29,15,26,547,61,486,61,61,0,2021-01-01,zipcode
ZCTA5 34140,12,168,-666666666,-666666666,-666666666,122,89,93,0,33,33,27,0,255,60,195,60,27,33,2021-01-01,zipcode
ZCTA5 34141,12,110,-666666666,-666666666,-666666666,61,29,46,0,14,13,4,15,16,16,0,16,3,13,2021-01-01,zipcode
ZCTA5 34142,12,33241,45870,842,218500,24614,8735,19250,7854,5952,2887,1652,905,9935,8598,1337,8598,4069,4529,2021-01-01,zipcode
ZCTA5 34145,12,15929,93134,1775,689000,14931,9794,14324,650,3145,4137,3795,2597,17943,8131,9812,8131,7290,841,2021-01-01,zipcode
ZCTA5 34201,12,3695,106014,1835,484900,3435,2348,3214,114,385,595,998,1122,2361,1706,655,1706,1617,89,2021-01-01,zipcode
ZCTA5 34202,12,24920,104907,1810,468200,20670,9765,18529,683,2764,5074,5295,4713,11710,9519,2191,9519,7227,2292,2021-01-01,zipcode
ZCTA5 34203,12,38698,60603,1200,227900,32887,14821,30023,3739,10957,7732,4852,2743,19922,16032,3890,16032,12187,3845,2021-01-01,zipcode
ZCTA5 34205,12,31061,47533,1093,176300,26055,10707,23180,3772,7503,6749,3476,1680,16043,12856,3187,12856,7737,5119,2021-01-01,zipcode
ZCTA5 34207,12,35394,42846,1093,96200,29741,13630,26010,4290,10138,7197,2939,1446,19292,14881,4411,14881,8983,5898,2021-01-01,zipcode
ZCTA5 34208,12,41102,51210,1207,208800,31489,13208,27476,5949,8781,6830,3730,2186,16339,13860,2479,13860,8022,5838,2021-01-01,zipcode
ZCTA5 34209,12,34848,70356,1409,269800,30499,15108,28061,1634,8190,8704,5713,3820,19009,15080,3929,15080,11916,3164,2021-01-01,zipcode
ZCTA5 34210,12,16579,51242,1226,222800,14690,7778,12901,849,3904,3704,2780,1664,11690,7618,4072,7618,4798,2820,2021-01-01,zipcode
ZCTA5 34211,12,13251,111952,1807,428300,11066,4785,9881,447,1629,3026,2982,1797,6983,5004,1979,5004,4423,581,2021-01-01,zipcode
ZCTA5 34212,12,22962,98293,1703,379900,18606,7977,16827,534,2748,5404,4788,3353,10385,8462,1923,8462,6926,1536,2021-01-01,zipcode
ZCTA5 34215,12,778,45125,-666666666,766000,766,513,730,0,75,348,180,127,596,357,239,357,338,19,2021-01-01,zipcode
ZCTA5 34216,12,1021,88472,-666666666,991900,997,689,976,25,119,238,375,219,1814,610,1204,610,584,26,2021-01-01,zipcode
ZCTA5 34217,12,3927,66944,1652,553900,3557,2123,3472,56,516,937,1154,809,5830,2042,3788,2042,1655,387,2021-01-01,zipcode
ZCTA5 34219,12,25658,96813,1754,320900,21030,8477,19127,491,4968,6271,5083,2314,10538,9253,1285,9253,8316,937,2021-01-01,zipcode
ZCTA5 34221,12,51531,63311,1190,219500,42853,19614,38220,4369,13270,10812,6300,3469,22795,18247,4548,18247,14366,3881,2021-01-01,zipcode
ZCTA5 34222,12,13076,58915,1194,150900,10924,5686,9817,689,3206,3817,1189,916,7800,5552,2248,5552,4624,928,2021-01-01,zipcode
ZCTA5 34223,12,18760,60342,1137,283100,17592,12151,16980,622,5497,4955,3620,2286,14106,9827,4279,9827,8266,1561,2021-01-01,zipcode
ZCTA5 34224,12,15387,49637,1002,182500,14305,8736,13239,982,5056,4119,1934,1148,10956,7624,3332,7624,6173,1451,2021-01-01,zipcode
ZCTA5 34228,12,7446,121797,2509,756500,7370,5848,7302,166,785,1474,2305,2572,9707,4106,5601,4106,3850,256,2021-01-01,zipcode
ZCTA5 34229,12,7820,86761,1175,547600,6950,4002,6510,184,1033,1205,2207,1881,4639,3534,1105,3534,3103,431,2021-01-01,zipcode
ZCTA5 34231,12,32460,61937,1347,294000,27642,12165,25657,1581,7412,7781,5253,3630,19041,15069,3972,15069,9881,5188,2021-01-01,zipcode
ZCTA5 34232,12,34108,73212,1587,249800,28916,10086,26028,2062,8104,7960,5174,2728,16636,14658,1978,14658,10106,4552,2021-01-01,zipcode
ZCTA5 34233,12,19195,68972,1523,295200,16021,6349,14721,776,4425,3969,3567,1984,9385,8415,970,8415,5841,2574,2021-01-01,zipcode
ZCTA5 34234,12,21692,46772,1150,159000,17804,8310,15664,2526,5292,3809,2535,1502,10312,8696,1616,8696,5134,3562,2021-01-01,zipcode
ZCTA5 34235,12,14349,63364,1467,260500,12934,6326,11836,597,3314,3581,2600,1744,8185,6935,1250,6935,5125,1810,2021-01-01,zipcode
ZCTA5 34236,12,12523,87679,1543,741800,11863,7314,11498,645,1504,2431,3280,3638,11102,7186,3916,7186,4188,2998,2021-01-01,zipcode
ZCTA5 34237,12,17742,55828,1302,200500,14782,5125,12774,1617,4419,3885,1927,926,8584,6940,1644,6940,3111,3829,2021-01-01,zipcode
ZCTA5 34238,12,21148,85881,1622,408000,19342,11377,18262,357,3385,4533,4537,5450,13343,10711,2632,10711,8337,2374,2021-01-01,zipcode
ZCTA5 34239,12,14203,63413,1472,325200,12310,4949,11474,926,2496,3415,2935,1702,7913,6708,1205,6708,4936,1772,2021-01-01,zipcode
ZCTA5 34240,12,12713,110143,1237,449300,10617,4738,9663,246,2209,2710,2628,1870,6527,4975,1552,4975,4558,417,2021-01-01,zipcode
ZCTA5 34241,12,15737,92874,1660,376700,12889,5853,11295,401,2382,3403,3184,1925,6633,5865,768,5865,5079,786,2021-01-01,zipcode
ZCTA5 34242,12,7387,116033,1827,768700,6979,4389,6670,189,676,1529,2342,1934,10523,3962,6561,3962,3451,511,2021-01-01,zipcode
ZCTA5 34243,12,31400,70875,1722,307900,27582,12258,24676,971,5775,7690,5444,4796,16026,13301,2725,13301,10491,2810,2021-01-01,zipcode
ZCTA5 34251,12,7659,78261,850,385200,6092,2220,4997,379,2090,1766,512,250,2411,2322,89,2322,2112,210,2021-01-01,zipcode
ZCTA5 34266,12,28317,37251,781,103900,23275,11958,20078,5644,8506,3810,1375,743,12078,9826,2252,9826,6516,3310,2021-01-01,zipcode
ZCTA5 34268,12,392,24292,-666666666,23100,392,247,265,134,53,17,61,0,143,86,57,86,83,3,2021-01-01,zipcode
ZCTA5 34269,12,5199,48955,921,156000,4546,2669,4228,437,1746,1083,742,220,3193,2256,937,2256,2025,231,2021-01-01,zipcode
ZCTA5 34275,12,19555,72715,1323,332900,17930,10243,16489,696,4285,4822,3702,2984,11817,9789,2028,9789,8227,1562,2021-01-01,zipcode
ZCTA5 34285,12,18746,59670,1197,251000,17905,11678,17045,580,5157,4546,3609,3153,15708,10348,5360,10348,8195,2153,2021-01-01,zipcode
ZCTA5 34286,12,20264,64728,1612,211200,16838,7065,13731,1614,3890,4976,1973,1278,8202,7418,784,7418,6154,1264,2021-01-01,zipcode
ZCTA5 34287,12,28218,52641,1156,167000,24027,14043,22203,1970,8138,7615,2771,1709,15616,11635,3981,11635,8792,2843,2021-01-01,zipcode
ZCTA5 34288,12,13476,68881,1421,214400,10897,4145,8842,834,2024,3161,2025,798,5274,5010,264,5010,4249,761,2021-01-01,zipcode
ZCTA5 34289,12,4511,82362,1338,282600,3906,1425,3226,342,942,1129,557,256,1816,1434,382,1434,779,655,2021-01-01,zipcode
ZCTA5 34291,12,6786,82873,1419,241600,5761,2161,5088,272,2344,1923,348,201,2514,2460,54,2460,2117,343,2021-01-01,zipcode
ZCTA5 34292,12,15676,74136,1793,328000,14559,9892,13897,598,3260,4209,3195,2635,10167,7919,2248,7919,6264,1655,2021-01-01,zipcode
ZCTA5 34293,12,44643,75516,1475,283200,40432,21996,38342,1895,9279,12597,8058,6513,26197,21260,4937,21260,18758,2502,2021-01-01,zipcode
ZCTA5 34420,12,18060,44813,804,126400,14784,6496,12519,1305,4913,4482,1275,544,8095,7081,1014,7081,5007,2074,2021-01-01,zipcode
ZCTA5 34428,12,9164,42800,761,207700,7941,4174,6921,868,2315,2428,885,425,4994,4028,966,4028,2903,1125,2021-01-01,zipcode
ZCTA5 34429,12,8903,50690,892,159400,7880,5019,7453,683,2817,2006,1228,719,5364,4057,1307,4057,3474,583,2021-01-01,zipcode
ZCTA5 34431,12,7933,39974,736,133100,6875,4191,6433,1038,2225,2124,749,297,4630,3701,929,3701,3228,473,2021-01-01,zipcode
ZCTA5 34432,12,12657,43884,820,159000,10934,6821,10267,1140,3857,3171,1269,830,6614,5699,915,5699,4884,815,2021-01-01,zipcode
ZCTA5 34433,12,7604,60292,1055,165200,6262,3187,5431,776,2154,1581,606,314,3685,2973,712,2973,2755,218,2021-01-01,zipcode
ZCTA5 34434,12,9424,54816,1098,148900,7415,3802,7054,735,2745,2310,931,333,4158,3421,737,3421,2881,540,2021-01-01,zipcode
ZCTA5 34436,12,7694,46049,636,143700,6760,4152,6401,715,2503,2223,460,500,4893,3645,1248,3645,3120,525,2021-01-01,zipcode
ZCTA5 34442,12,16532,47807,873,208900,15141,10309,14147,969,5129,4076,2057,1916,9767,7673,2094,7673,6677,996,2021-01-01,zipcode
ZCTA5 34445,12,0,-666666666,-666666666,-666666666,0,0,0,0,0,0,0,0,0,0,0,0,0,0,2021-01-01,zipcode
ZCTA5 34446,12,18033,47008,882,159000,15815,11136,14557,1487,5375,5287,1403,1005,9299,8033,1266,8033,7194,839,2021-01-01,zipcode
ZCTA5 34448,12,10180,49072,839,117200,9059,5173,8624,1091,3611,2666,970,286,6257,4699,1558,4699,3860,839,2021-01-01,zipcode
ZCTA5 34449,12,3273,41570,478,102600,2958,1421,2707,337,1359,677,255,79,1856,1394,462,1394,1041,353,2021-01-01,zipcode
ZCTA5 34450,12,10066,39774,885,154300,9214,5837,8201,657,2740,2989,1229,586,6369,4984,1385,4984,3910,1074,2021-01-01,zipcode
ZCTA5 34452,12,13206,51683,1009,144600,11028,5391,10223,1121,3861,3890,1104,247,6145,5378,767,5378,4353,1025,2021-01-01,zipcode
ZCTA5 34453,12,9835,45781,893,121600,8370,4993,7843,1110,3446,2241,753,293,5362,4194,1168,4194,3547,647,2021-01-01,zipcode
ZCTA5 34461,12,12397,52755,885,214700,10973,6760,9737,954,4188,2407,1186,1002,5622,4557,1065,4557,3909,648,2021-01-01,zipcode
ZCTA5 34465,12,18483,50903,1009,180800,15835,9369,14136,1065,5100,5024,1543,1404,8854,8026,828,8026,6390,1636,2021-01-01,zipcode
ZCTA5 34470,12,20707,43308,955,126200,16621,7467,14496,1914,4776,4840,1943,1023,9593,8723,870,8723,4871,3852,2021-01-01,zipcode
ZCTA5 34471,12,26420,54723,1073,215800,21210,8775,18237,1231,5148,5492,3424,2942,11740,10885,855,10885,6770,4115,2021-01-01,zipcode
ZCTA5 34472,12,32035,50308,1070,140300,24979,10956,21608,3258,7454,7183,2304,1409,13107,11911,1196,11911,9245,2666,2021-01-01,zipcode
ZCTA5 34473,12,22441,63213,1172,161700,17650,7218,15764,1477,5998,5750,1772,767,8367,7397,970,7397,6305,1092,2021-01-01,zipcode
ZCTA5 34474,12,17686,54886,1237,157000,14529,5710,12880,1327,3696,3777,2910,1170,8299,7418,881,7418,3238,4180,2021-01-01,zipcode
ZCTA5 34475,12,14387,27421,753,95500,10992,6204,9586,1929,4114,2462,716,365,5669,4788,881,4788,2093,2695,2021-01-01,zipcode
ZCTA5 34476,12,23924,56786,1068,189100,20539,11561,19040,1412,6386,6200,3196,1846,12233,10931,1302,10931,9868,1063,2021-01-01,zipcode
ZCTA5 34479,12,14205,55225,1037,152800,11482,4919,10099,1399,4332,3030,917,421,6160,5542,618,5542,3695,1847,2021-01-01,zipcode
ZCTA5 34480,12,22352,64851,941,199500,17794,6601,14702,1203,4888,4378,2948,1285,9425,8398,1027,8398,6519,1879,2021-01-01,zipcode
ZCTA5 34481,12,22890,46325,1093,145700,21617,16434,20385,1440,6867,6324,3404,2350,12851,11958,893,11958,10720,1238,2021-01-01,zipcode
ZCTA5 34482,12,23415,55461,942,174000,20481,13642,18563,3596,6902,5048,2193,824,9220,7422,1798,7422,6084,1338,2021-01-01,zipcode
ZCTA5 34484,12,5399,59720,-666666666,308100,4717,2019,4295,798,1235,1040,590,632,3199,2769,430,2769,1626,1143,2021-01-01,zipcode
ZCTA5 34488,12,11878,41969,932,62900,9486,4423,8347,1058,3526,2332,1186,245,6246,4886,1360,4886,3392,1494,2021-01-01,zipcode
ZCTA5 34491,12,31192,60831,981,191200,26144,15171,24277,2547,9313,7517,2905,1995,15134,13125,2009,13125,11511,1614,2021-01-01,zipcode
ZCTA5 34498,12,614,44318,917,208300,487,323,454,22,190,114,78,50,523,292,231,292,223,69,2021-01-01,zipcode
ZCTA5 34601,12,22995,44244,899,108900,19395,10316,17456,2190,6343,5581,2282,1060,12131,10336,1795,10336,7115,3221,2021-01-01,zipcode
ZCTA5 34602,12,8590,67708,1021,190400,7225,3398,6605,905,2527,1846,790,537,3323,2980,343,2980,2593,387,2021-01-01,zipcode
ZCTA5 34604,12,13398,74118,1061,196400,11332,5567,9988,1269,3425,3557,1077,660,4809,4425,384,4425,3895,530,2021-01-01,zipcode
ZCTA5 34606,12,28162,46250,1001,161900,23789,12707,21449,1913,7807,7203,3141,1385,13935,12399,1536,12399,9494,2905,2021-01-01,zipcode
ZCTA5 34607,12,8300,50574,1117,252100,7294,3897,6586,499,1827,2729,999,532,4822,3701,1121,3701,3103,598,2021-01-01,zipcode
ZCTA5 34608,12,35708,53764,1091,167000,29389,13820,26055,3208,8631,9723,3054,1439,15196,14207,989,14207,10674,3533,2021-01-01,zipcode
ZCTA5 34609,12,43429,63063,1295,199800,35468,16473,31376,3020,9234,12633,4299,2190,17735,16397,1338,16397,13249,3148,2021-01-01,zipcode
ZCTA5 34610,12,16566,63938,1061,183300,13035,4895,11535,1833,3654,3692,1874,482,6215,5531,684,5531,4473,1058,2021-01-01,zipcode
ZCTA5 34613,12,17388,47874,1042,127600,15308,9547,14619,1604,5130,5124,2018,743,10283,8360,1923,8360,7200,1160,2021-01-01,zipcode
ZCTA5 34614,12,8072,69129,696,215100,6411,2675,5286,634,1504,1986,547,615,3056,2719,337,2719,2581,138,2021-01-01,zipcode
ZCTA5 34637,12,10548,104004,1633,293000,7962,4179,7036,431,1471,2000,1914,1220,3409,3075,334,3075,2762,313,2021-01-01,zipcode
ZCTA5 34638,12,32345,104038,1880,290400,23400,7161,20472,1042,4992,6386,5545,2507,10700,10292,408,10292,8423,1869,2021-01-01,zipcode
ZCTA5 34639,12,29652,86861,1536,275500,23614,7979,20623,1221,5160,6596,5234,2412,10783,10454,329,10454,8513,1941,2021-01-01,zipcode
ZCTA5 34652,12,25101,45872,1000,149900,21841,10501,19436,2393,7778,5673,2481,1111,14722,11249,3473,11249,6902,4347,2021-01-01,zipcode
ZCTA5 34653,12,33790,42666,1095,131700,28654,14457,25976,2377,10920,8264,3062,1353,17287,15021,2266,15021,9752,5269,2021-01-01,zipcode
ZCTA5 34654,12,24321,57973,1279,187700,20775,10017,18545,2438,6790,5765,2212,1340,10251,8938,1313,8938,6938,2000,2021-01-01,zipcode
ZCTA5 34655,12,44069,71553,1384,269900,36594,15764,32910,1988,8578,11030,7237,4077,20366,18283,2083,18283,14597,3686,2021-01-01,zipcode
ZCTA5 34661,12,289,26538,-666666666,159900,247,141,247,39,128,66,14,0,266,166,100,166,94,72,2021-01-01,zipcode
ZCTA5 34667,12,31137,45874,1054,156000,27779,16467,26264,2794,10809,7740,3087,1834,19862,15467,4395,15467,11497,3970,2021-01-01,zipcode
ZCTA5 34668,12,49271,39682,1087,117900,40601,20195,35114,4305,15466,10516,3382,1445,23859,21043,2816,21043,12566,8477,2021-01-01,zipcode
ZCTA5 34669,12,13915,51139,1145,166400,11639,5880,10168,1079,4551,3050,1109,379,6423,5467,956,5467,4629,838,2021-01-01,zipcode
ZCTA5 34677,12,22528,76217,1230,276600,18824,7164,16764,824,4306,5153,3978,2503,10048,8788,1260,8788,6747,2041,2021-01-01,zipcode
ZCTA5 34679,12,77,-666666666,-666666666,-666666666,77,54,77,0,54,23,0,0,133,33,100,33,33,0,2021-01-01,zipcode
ZCTA5 34681,12,923,59250,-666666666,413300,734,331,683,1,130,241,278,33,529,422,107,422,422,0,2021-01-01,zipcode
ZCTA5 34683,12,33490,75189,1348,317700,28514,10108,25550,1285,5881,8595,6372,3417,15482,13571,1911,13571,10384,3187,2021-01-01,zipcode
ZCTA5 34684,12,27304,57768,1454,214500,23866,10950,21833,1142,5998,7590,4774,2329,14501,13090,1411,13090,9394,3696,2021-01-01,zipcode
ZCTA5 34685,12,17555,79968,1435,378500,14870,6885,13617,643,2864,4192,3756,2162,7845,7345,500,7345,5523,1822,2021-01-01,zipcode
ZCTA5 34688,12,8689,103997,1191,389400,7527,3547,6798,254,1376,1932,1926,1310,3668,3399,269,3399,3109,290,2021-01-01,zipcode
ZCTA5 34689,12,26393,56155,996,236400,22803,10986,20822,1552,6028,6644,4123,2475,13674,11529,2145,11529,8966,2563,2021-01-01,zipcode
ZCTA5 34690,12,11285,39235,1100,89300,9505,4622,8737,914,4228,2521,753,321,6746,5163,1583,5163,3156,2007,2021-01-01,zipcode
ZCTA5 34691,12,20625,39891,1055,123600,16897,7413,15548,1329,7558,4596,1454,611,12323,9391,2932,9391,5744,3647,2021-01-01,zipcode
ZCTA5 34695,12,17778,92019,1386,297600,14616,5229,13191,367,3188,3819,3912,1905,7861,7116,745,7116,5964,1152,2021-01-01,zipcode
ZCTA5 34698,12,38390,56118,1148,247700,34885,16452,32351,2035,8566,10645,6525,4580,22596,18883,3713,18883,13695,5188,2021-01-01,zipcode
ZCTA5 34705,12,3141,49405,867,172900,2444,1023,2028,363,775,601,233,56,1243,1122,121,1122,943,179,2021-01-01,zipcode
ZCTA5 34711,12,66167,77866,1629,281600,53829,22733,46747,2870,11640,16179,10148,5910,26881,24097,2784,24097,18599,5498,2021-01-01,zipcode
ZCTA5 34714,12,24200,66258,1390,237500,19183,5945,16148,1355,4480,6187,2644,1482,10109,8159,1950,8159,4070,4089,2021-01-01,zipcode
ZCTA5 34715,12,23642,81222,1591,310900,18344,6980,16441,1750,4863,5529,2668,1631,8006,7537,469,7537,5696,1841,2021-01-01,zipcode
ZCTA5 34731,12,11546,51438,1065,146800,9799,4215,8677,685,3740,2630,1031,591,6107,4754,1353,4754,3799,955,2021-01-01,zipcode
ZCTA5 34734,12,4581,66591,1631,301300,3113,1067,2732,30,736,999,709,258,1327,1300,27,1300,1081,219,2021-01-01,zipcode
ZCTA5 34736,12,23734,71250,1543,247200,19171,7746,16946,1982,4494,5478,3141,1851,9865,9232,633,9232,7831,1401,2021-01-01,zipcode
ZCTA5 34737,12,3715,62083,1363,253000,3267,1233,2965,500,600,1035,522,308,1836,1654,182,1654,1421,233,2021-01-01,zipcode
ZCTA5 34739,12,581,107686,-666666666,122900,554,198,415,136,210,51,18,0,444,247,197,247,133,114,2021-01-01,zipcode
ZCTA5 34741,12,52998,40153,1281,204200,40541,14109,34223,4987,10167,11703,5129,2237,20306,16380,3926,16380,5257,11123,2021-01-01,zipcode
ZCTA5 34743,12,46292,53455,1389,217000,37686,11403,31485,5311,9906,10905,3991,1372,12952,11739,1213,11739,8528,3211,2021-01-01,zipcode
ZCTA5 34744,12,60324,58452,1200,246600,48657,16303,40559,6192,12096,12315,6558,3398,19998,17589,2409,17589,12021,5568,2021-01-01,zipcode
ZCTA5 34746,12,50514,60564,1485,251100,40477,15318,35103,4669,9395,11233,6353,3453,23433,14803,8630,14803,10714,4089,2021-01-01,zipcode
ZCTA5 34747,12,22109,74865,1614,356800,17173,5011,14777,414,2625,4813,4429,2496,21857,8069,13788,8069,4251,3818,2021-01-01,zipcode
ZCTA5 34748,12,42457,46806,961,172100,36593,22313,33518,3328,11954,11354,4503,2379,23566,19237,4329,19237,13901,5336,2021-01-01,zipcode
ZCTA5 34753,12,6563,59657,1220,184900,4796,1505,3883,1095,1100,1205,341,142,1933,1885,48,1885,1506,379,2021-01-01,zipcode
ZCTA5 34756,12,3879,91100,1211,366700,3215,1375,2610,185,560,1052,529,284,1476,1298,178,1298,1036,262,2021-01-01,zipcode
ZCTA5 34758,12,42974,54284,1418,199700,32632,11145,27150,3722,9989,9219,2638,1582,13581,10796,2785,10796,8423,2373,2021-01-01,zipcode
ZCTA5 34759,12,39453,54264,1403,216600,31836,15921,26534,4689,7264,8344,3967,2270,15954,12708,3246,12708,9376,3332,2021-01-01,zipcode
ZCTA5 34760,12,989,120781,1542,311500,860,335,775,38,173,408,125,31,353,304,49,304,251,53,2021-01-01,zipcode
ZCTA5 34761,12,46585,80786,1430,283100,36121,11121,31257,5540,7066,9420,6250,2981,14690,14022,668,14022,9896,4126,2021-01-01,zipcode
ZCTA5 34762,12,315,66181,-666666666,-666666666,315,200,315,89,118,76,14,18,277,143,134,143,143,0,2021-01-01,zipcode
ZCTA5 34769,12,29985,54887,1114,212900,22518,9086,19254,3047,6396,5784,2805,1222,11031,8879,2152,8879,6157,2722,2021-01-01,zipcode
ZCTA5 34771,12,23948,85549,1356,336700,19376,7640,16240,1707,4135,5026,3856,1516,8562,7042,1520,7042,6156,886,2021-01-01,zipcode
ZCTA5 34772,12,31178,76327,1448,265300,24197,9437,20513,1432,6089,7726,3879,1387,10346,8931,1415,8931,7681,1250,2021-01-01,zipcode
ZCTA5 34773,12,4074,69337,2028,242600,2877,1444,2576,377,595,805,447,352,1438,1220,218,1220,1051,169,2021-01-01,zipcode
ZCTA5 34785,12,19972,39545,1054,99700,17405,11638,16589,2849,7652,4280,1217,591,7355,6249,1106,6249,3951,2298,2021-01-01,zipcode
ZCTA5 34786,12,46817,105774,1916,471200,34475,10578,31059,926,2898,9394,11961,5880,16916,14869,2047,14869,10673,4196,2021-01-01,zipcode
ZCTA5 34787,12,81398,96033,1627,367400,60707,17918,53226,4120,10254,15141,14819,8892,28750,26245,2505,26245,19198,7047,2021-01-01,zipcode
ZCTA5 34788,12,20689,48708,1209,110600,17938,8820,16784,1776,6642,5132,2180,1054,10970,8832,2138,8832,7256,1576,2021-01-01,zipcode
ZCTA5 34797,12,1473,92652,-666666666,261600,1306,827,1260,14,402,449,253,142,864,641,223,641,619,22,2021-01-01,zipcode
ZCTA5 34945,12,5314,56794,637,222100,4474,2985,3998,599,1244,1210,611,334,1790,1461,329,1461,1359,102,2021-01-01,zipcode
ZCTA5 34946,12,5916,37425,749,108100,5036,2262,4342,1212,1344,1228,372,186,3207,2523,684,2523,1508,1015,2021-01-01,zipcode
ZCTA5 34947,12,13216,33962,979,151000,10022,4197,7835,2076,2428,2230,411,690,4667,4076,591,4076,1413,2663,2021-01-01,zipcode
ZCTA5 34949,12,7960,82644,1322,323000,7813,4440,7395,324,1446,2157,2022,1446,8001,4435,3566,4435,3450,985,2021-01-01,zipcode
ZCTA5 34950,12,16675,33204,933,116900,13457,6584,11352,3515,3849,2715,1015,258,7474,6250,1224,6250,2317,3933,2021-01-01,zipcode
ZCTA5 34951,12,16275,51375,1068,160700,14360,7463,12911,1617,3967,4538,2158,631,8355,6997,1358,6997,6142,855,2021-01-01,zipcode
ZCTA5 34952,12,42196,51552,1358,183900,35998,16270,32541,3103,11257,11620,4709,1852,21393,17478,3915,17478,12090,5388,2021-01-01,zipcode
ZCTA5 34953,12,74414,75226,1676,245400,58262,18366,50126,5181,15623,17918,7828,3576,25862,24483,1379,24483,20642,3841,2021-01-01,zipcode
ZCTA5 34956,12,9751,45234,921,101800,7953,4072,6336,2025,1891,1777,562,81,2884,2484,400,2484,1687,797,2021-01-01,zipcode
ZCTA5 34957,12,22583,62441,1243,297300,20090,11091,18581,1314,4722,5806,3996,2743,16915,10730,6185,10730,7863,2867,2021-01-01,zipcode
ZCTA5 34972,12,19728,46258,895,150500,15906,8313,13599,3002,5125,3242,1424,806,7237,6085,1152,6085,4006,2079,2021-01-01,zipcode
ZCTA5 34974,12,23055,46575,876,115200,19334,10359,17273,2839,6402,5320,1939,773,13451,10109,3342,10109,7989,2120,2021-01-01,zipcode
ZCTA5 34981,12,6167,62381,1243,268000,4709,1676,4088,296,1577,1116,564,535,1896,1662,234,1662,943,719,2021-01-01,zipcode
ZCTA5 34982,12,25825,45135,1076,167400,21223,9168,18512,2806,6495,6167,2100,944,11950,10768,1182,10768,8044,2724,2021-01-01,zipcode
ZCTA5 34983,12,44999,63890,1501,221700,36252,13847,32538,3091,11081,9968,5732,2666,16699,15387,1312,15387,12798,2589,2021-01-01,zipcode
ZCTA5 34984,12,18333,70854,1678,258900,14835,5743,13455,1881,3827,5379,1724,644,6783,6161,622,6161,4963,1198,2021-01-01,zipcode
ZCTA5 34986,12,28438,71141,1659,284900,23974,14015,21412,1408,5942,6287,4618,3157,13731,11487,2244,11487,9635,1852,2021-01-01,zipcode
ZCTA5 34987,12,12818,71923,1812,309800,11202,6533,10591,526,3006,3003,2381,1675,5953,5464,489,5464,4157,1307,2021-01-01,zipcode
ZCTA5 34990,12,30156,105527,1712,430900,25271,11176,22792,789,3849,7375,6751,4028,13696,12039,1657,12039,10713,1326,2021-01-01,zipcode
ZCTA5 34994,12,18187,51706,1200,189600,14997,7449,13762,1143,3876,4609,2784,1350,9538,7841,1697,7841,4731,3110,2021-01-01,zipcode
ZCTA5 34996,12,11062,73350,1177,356400,10091,5766,9716,410,2182,3044,2121,1959,8935,5825,3110,5825,4807,1018,2021-01-01,zipcode
ZCTA5 34997,12,44630,64594,1239,271300,38416,17665,34613,2997,9834,12079,6385,3318,21878,18365,3513,18365,14975,3390,2021-01-01,zipcode
ZCTA5 35004,01,11917,68086,1114,170600,9408,3596,8518,459,3069,3266,1188,536,4745,4616,129,4616,3423,1193,2021-01-01,zipcode
ZCTA5 35005,01,8180,48583,914,104700,6871,3110,6359,1045,2885,1726,489,214,3460,2869,591,2869,2359,510,2021-01-01,zipcode
ZCTA5 35006,01,3386,58799,-666666666,102400,2827,1301,2444,365,1317,641,83,38,1646,1190,456,1190,1093,97,2021-01-01,zipcode
ZCTA5 35007,01,27323,74741,1111,182100,21056,6554,18279,1557,4975,5264,4175,2308,10421,9896,525,9896,8334,1562,2021-01-01,zipcode
ZCTA5 35010,01,20899,48874,628,104900,16812,7725,14753,2702,5038,4618,1425,970,10636,8082,2554,8082,5871,2211,2021-01-01,zipcode
ZCTA5 35013,01,99,-666666666,-666666666,-666666666,99,9,99,81,0,18,0,0,27,27,0,27,9,18,2021-01-01,zipcode
ZCTA5 35014,01,4212,50893,1010,99600,3700,1834,3095,634,1150,891,154,266,2005,1683,322,1683,1520,163,2021-01-01,zipcode
ZCTA5 35016,01,16906,49813,658,151800,13389,5992,11554,1310,3867,4195,1389,793,7274,6446,828,6446,4738,1708,2021-01-01,zipcode
ZCTA5 35019,01,2289,53639,672,113200,1821,720,1520,273,604,438,174,31,1049,867,182,867,686,181,2021-01-01,zipcode
ZCTA5 35020,01,25763,28812,755,76600,20123,9758,17485,3192,7058,5269,1412,554,12890,10145,2745,10145,5521,4624,2021-01-01,zipcode
ZCTA5 35022,01,22211,68139,930,200700,18572,6960,16323,1211,4594,5586,3227,1705,9831,9062,769,9062,7151,1911,2021-01-01,zipcode
ZCTA5 35023,01,24780,61632,1048,122900,19519,7929,17006,1753,6188,5705,2455,905,9889,8632,1257,8632,6656,1976,2021-01-01,zipcode
ZCTA5 35031,01,7379,50186,635,119800,5975,2603,5177,763,1785,1768,422,439,3263,2601,662,2601,1898,703,2021-01-01,zipcode
ZCTA5 35032,01,50,-666666666,-666666666,65600,44,31,36,19,15,2,0,0,31,22,9,22,18,4,2021-01-01,zipcode
ZCTA5 35033,01,3235,41989,905,120700,2479,1200,2179,496,529,850,226,78,1532,1250,282,1250,1065,185,2021-01-01,zipcode
ZCTA5 35034,01,5451,43929,763,87500,4356,3138,3682,1000,1841,468,235,138,1532,1276,256,1276,906,370,2021-01-01,zipcode
ZCTA5 35035,01,991,56416,-666666666,67300,828,373,666,34,333,158,127,14,432,364,68,364,330,34,2021-01-01,zipcode
ZCTA5 35036,01,153,-666666666,264,-666666666,143,110,92,0,79,11,2,0,79,75,4,75,0,75,2021-01-01,zipcode
ZCTA5 35040,01,18433,68848,1306,159100,13878,3617,11754,862,2903,4293,2617,1079,7132,6688,444,6688,5357,1331,2021-01-01,zipcode
ZCTA5 35042,01,6221,62778,504,117300,5304,2381,4826,735,1918,1325,481,367,2778,2248,530,2248,1827,421,2021-01-01,zipcode
ZCTA5 35043,01,14054,94959,1087,258900,10499,3911,9155,322,2033,3274,2627,899,4610,4325,285,4325,3890,435,2021-01-01,zipcode
ZCTA5 35044,01,7960,38081,683,89400,6616,3173,5676,1117,1996,2034,231,298,3614,3310,304,3310,2097,1213,2021-01-01,zipcode
ZCTA5 35045,01,14576,52056,783,140900,11651,5652,10377,1568,4300,2759,841,909,6429,5676,753,5676,3785,1891,2021-01-01,zipcode
ZCTA5 35046,01,5106,58851,746,136600,3824,1581,3338,505,1643,739,266,185,2651,1895,756,1895,1478,417,2021-01-01,zipcode
ZCTA5 35049,01,3643,44984,694,135000,2801,1044,2405,439,1022,699,148,97,1560,1373,187,1373,957,416,2021-01-01,zipcode
ZCTA5 35051,01,8627,55899,734,172800,7116,3393,6317,1217,2257,1622,854,367,3170,2897,273,2897,2201,696,2021-01-01,zipcode
ZCTA5 35052,01,224,-666666666,-666666666,-666666666,224,196,224,84,93,31,12,4,19,19,0,19,0,19,2021-01-01,zipcode
ZCTA5 35053,01,2833,72031,842,225200,2168,1108,2076,250,638,694,334,160,2402,1039,1363,1039,973,66,2021-01-01,zipcode
ZCTA5 35054,01,4233,79569,1021,263100,3268,1446,2631,257,708,999,437,230,1889,1538,351,1538,1388,150,2021-01-01,zipcode
ZCTA5 35055,01,22597,53810,807,150800,18326,7498,15509,1857,4139,5345,2796,1372,10117,9088,1029,9088,5880,3208,2021-01-01,zipcode
ZCTA5 35057,01,14165,59731,763,157400,11142,4139,9651,1576,3166,3550,835,524,6157,5022,1135,5022,4087,935,2021-01-01,zipcode
ZCTA5 35058,01,10112,50564,778,144100,8323,3316,7504,1254,2863,2468,627,292,4384,3862,522,3862,2907,955,2021-01-01,zipcode
ZCTA5 35060,01,184,25662,-666666666,108000,140,73,116,0,79,21,0,16,201,99,102,99,99,0,2021-01-01,zipcode
ZCTA5 35061,01,1517,62788,1049,155500,1409,492,1159,75,463,488,110,23,616,427,189,427,269,158,2021-01-01,zipcode
ZCTA5 35062,01,8698,55341,694,148500,6904,3216,5961,816,2193,1918,737,297,3593,3152,441,3152,2546,606,2021-01-01,zipcode
ZCTA5 35063,01,3085,54722,913,84900,2660,1325,2369,544,791,911,100,23,1579,1178,401,1178,1059,119,2021-01-01,zipcode
ZCTA5 35064,01,10083,44039,871,99400,8141,3400,6407,350,2452,2179,1003,423,4911,3917,994,3917,2071,1846,2021-01-01,zipcode
ZCTA5 35068,01,8205,72881,1032,164600,6299,2106,5529,536,1382,2013,962,636,3565,3461,104,3461,2570,891,2021-01-01,zipcode
ZCTA5 35070,01,112,58438,-666666666,115500,89,61,89,6,26,41,16,0,42,42,0,42,40,2,2021-01-01,zipcode
ZCTA5 35071,01,17487,74507,934,193200,13803,5326,11966,915,3650,3915,2323,1163,7378,6837,541,6837,5270,1567,2021-01-01,zipcode
ZCTA5 35072,01,4791,44599,548,84400,3688,1995,3302,494,1580,817,274,137,2477,1745,732,1745,1403,342,2021-01-01,zipcode
ZCTA5 35073,01,3082,46000,824,93500,2647,1097,2264,445,680,796,254,89,1464,1260,204,1260,868,392,2021-01-01,zipcode
ZCTA5 35074,01,114,-666666666,-666666666,-666666666,114,0,114,64,0,50,0,0,50,50,0,50,0,50,2021-01-01,zipcode
ZCTA5 35077,01,14184,44825,757,123500,11664,5499,10117,2097,3449,3360,668,543,6407,5578,829,5578,3977,1601,2021-01-01,zipcode
ZCTA5 35078,01,1951,66922,-666666666,163500,1553,614,1420,198,443,530,157,92,1053,781,272,781,655,126,2021-01-01,zipcode
ZCTA5 35079,01,9469,77500,868,164900,7632,3382,6587,513,2683,2322,745,324,3711,3250,461,3250,3070,180,2021-01-01,zipcode
ZCTA5 35080,01,19266,97993,1334,212800,14471,4390,12425,450,2179,3916,4134,1746,6879,6466,413,6466,6000,466,2021-01-01,zipcode
ZCTA5 35082,01,0,-666666666,-666666666,-666666666,0,0,0,0,0,0,0,0,0,0,0,0,0,0,2021-01-01,zipcode
ZCTA5 35083,01,4024,51875,780,151900,3067,1246,2637,559,864,970,163,81,1501,1381,120,1381,1124,257,2021-01-01,zipcode
ZCTA5 35085,01,8140,61123,763,103400,6400,2400,5228,1175,2102,1252,483,216,3406,2894,512,2894,2325,569,2021-01-01,zipcode
ZCTA5 35087,01,2702,43698,823,119600,2194,801,1949,205,543,902,202,97,1025,987,38,987,818,169,2021-01-01,zipcode
ZCTA5 35089,01,1546,55040,703,-666666666,1454,706,1253,186,542,495,9,21,664,559,105,559,480,79,2021-01-01,zipcode
ZCTA5 35091,01,3193,97882,1219,219300,2407,733,2099,126,540,885,261,287,1277,1071,206,1071,1012,59,2021-01-01,zipcode
ZCTA5 35094,01,15206,64154,819,177000,11859,4345,10547,1312,2744,3540,1879,1072,6508,5690,818,5690,4503,1187,2021-01-01,zipcode
ZCTA5 35096,01,8644,63582,942,141600,6746,2540,5681,816,1975,1930,678,282,3885,2975,910,2975,2574,401,2021-01-01,zipcode
ZCTA5 35097,01,1940,44688,1069,125000,1633,863,1403,309,537,402,113,42,843,709,134,709,648,61,2021-01-01,zipcode
ZCTA5 35098,01,1337,53750,793,-666666666,1075,460,865,169,239,382,58,17,625,533,92,533,348,185,2021-01-01,zipcode
ZCTA5 35111,01,17103,72217,883,215600,13781,4842,12061,712,3408,4270,2351,1320,6996,6445,551,6445,5826,619,2021-01-01,zipcode
ZCTA5 35112,01,0,-666666666,-666666666,-666666666,0,0,0,0,0,0,0,0,53,0,53,0,0,0,2021-01-01,zipcode
ZCTA5 35114,01,8156,93438,1095,212600,6158,1947,5230,192,1023,1679,1299,1037,3045,2869,176,2869,2491,378,2021-01-01,zipcode
ZCTA5 35115,01,17448,47500,743,137500,13930,5957,10586,1740,3374,3212,1789,471,6518,6046,472,6046,4153,1893,2021-01-01,zipcode
ZCTA5 35116,01,4885,73250,946,177000,3814,1316,3501,247,1113,1146,780,215,1998,1865,133,1865,1685,180,2021-01-01,zipcode
ZCTA5 35117,01,5866,79210,784,166300,4716,1686,3966,282,952,1726,745,261,2522,2275,247,2275,2111,164,2021-01-01,zipcode
ZCTA5 35118,01,3477,62054,875,122600,2659,1367,2245,376,901,713,168,87,1231,1069,162,1069,840,229,2021-01-01,zipcode
ZCTA5 35119,01,136,-666666666,-666666666,-666666666,136,64,136,100,36,0,0,0,28,28,0,28,0,28,2021-01-01,zipcode
ZCTA5 35120,01,17106,65795,870,156300,13303,4390,11612,1574,4228,3774,1364,672,6690,6239,451,6239,5218,1021,2021-01-01,zipcode
ZCTA5 35121,01,16441,49083,672,136300,13203,6756,11380,2482,3187,3766,1157,788,6974,6224,750,6224,4421,1803,2021-01-01,zipcode
ZCTA5 35124,01,24594,80261,1190,222600,19887,6100,17778,903,3380,5527,4959,3009,10108,9752,356,9752,8230,1522,2021-01-01,zipcode
ZCTA5 35125,01,10752,49030,894,144300,8623,3901,7372,1600,2774,1885,810,303,4578,3961,617,3961,2588,1373,2021-01-01,zipcode
ZCTA5 35126,01,21997,71303,892,156000,17503,6178,14581,1381,5131,5360,1963,746,8288,7508,780,7508,6469,1039,2021-01-01,zipcode
ZCTA5 35127,01,9638,67000,1076,160600,7849,2983,6728,416,1662,3092,1036,522,3808,3398,410,3398,2725,673,2021-01-01,zipcode
ZCTA5 35128,01,10831,69503,968,189500,8710,3224,7536,806,2471,2731,1015,513,4698,4177,521,4177,3218,959,2021-01-01,zipcode
ZCTA5 35130,01,3509,42939,532,102900,2798,1676,2409,440,1135,663,96,75,1926,1411,515,1411,1197,214,2021-01-01,zipcode
ZCTA5 35131,01,3347,40938,672,85500,2609,1341,2278,441,921,566,220,130,1650,1252,398,1252,940,312,2021-01-01,zipcode
ZCTA5 35133,01,3406,52137,743,144100,2687,1348,2522,423,853,963,186,97,1482,1272,210,1272,1126,146,2021-01-01,zipcode
ZCTA5 35135,01,2075,49091,959,196800,1629,676,1481,256,515,370,232,108,952,842,110,842,650,192,2021-01-01,zipcode
ZCTA5 35136,01,2153,47500,325,159800,1831,973,1535,153,479,602,268,33,1196,764,432,764,583,181,2021-01-01,zipcode
ZCTA5 35143,01,3238,73367,659,217200,2752,1217,2400,167,865,793,545,30,2121,1244,877,1244,1026,218,2021-01-01,zipcode
ZCTA5 35146,01,12049,73230,642,211500,10020,4962,8756,1288,2932,2455,1375,706,4310,3915,395,3915,3347,568,2021-01-01,zipcode
ZCTA5 35147,01,5752,78432,1529,221900,4446,1368,3743,288,612,1258,1116,469,2172,2004,168,2004,1788,216,2021-01-01,zipcode
ZCTA5 35148,01,2419,56500,558,113800,2041,836,1752,298,677,667,74,36,1190,956,234,956,663,293,2021-01-01,zipcode
ZCTA5 35149,01,127,-666666666,-666666666,-666666666,127,26,101,0,101,0,0,0,80,80,0,80,54,26,2021-01-01,zipcode
ZCTA5 35150,01,17421,37402,643,114600,13495,6535,11835,1996,3918,4226,1051,644,8253,7029,1224,7029,4286,2743,2021-01-01,zipcode
ZCTA5 35151,01,7893,61875,907,124700,6510,2823,5831,759,1694,2131,755,492,3693,2979,714,2979,2612,367,2021-01-01,zipcode
ZCTA5 35160,01,26369,36762,629,110300,22268,11858,18972,4028,7017,5207,1695,1025,12831,10192,2639,10192,6486,3706,2021-01-01,zipcode
ZCTA5 35171,01,3556,55764,-666666666,122700,2885,1638,2616,553,882,805,264,112,1331,1215,116,1215,1008,207,2021-01-01,zipcode
ZCTA5 35172,01,2761,44821,769,89900,2291,1070,2027,179,1131,574,107,36,1185,1024,161,1024,755,269,2021-01-01,zipcode
ZCTA5 35173,01,30218,103097,1327,269500,23289,8127,20071,1094,4443,6456,5322,2756,10956,10343,613,10343,9356,987,2021-01-01,zipcode
ZCTA5 35175,01,5054,64167,806,154000,4167,1920,3652,590,1271,963,550,278,2420,2040,380,2040,1731,309,2021-01-01,zipcode
ZCTA5 35176,01,766,22235,759,107000,636,370,524,233,126,110,20,35,355,355,0,355,210,145,2021-01-01,zipcode
ZCTA5 35178,01,2894,34216,-666666666,124500,2290,1331,2027,368,869,503,225,62,1549,1190,359,1190,995,195,2021-01-01,zipcode
ZCTA5 35179,01,8602,54205,690,156800,7037,3073,5831,787,2189,1999,586,270,3555,3033,522,3033,2546,487,2021-01-01,zipcode
ZCTA5 35180,01,14615,66285,753,158400,11234,5176,9681,1090,3452,3710,982,447,5462,4968,494,4968,4133,835,2021-01-01,zipcode
ZCTA5 35183,01,949,64107,-666666666,103000,910,500,910,174,439,263,7,27,431,312,119,312,272,40,2021-01-01,zipcode
ZCTA5 35184,01,5788,54102,823,90000,4677,2029,3940,811,1994,956,135,44,2522,1891,631,1891,1577,314,2021-01-01,zipcode
ZCTA5 35186,01,5151,89118,1025,226600,4215,1799,3665,389,1014,1239,661,362,2127,1924,203,1924,1558,366,2021-01-01,zipcode
ZCTA5 35188,01,2745,49308,847,142600,2095,995,1787,344,848,513,51,31,1012,829,183,829,691,138,2021-01-01,zipcode
ZCTA5 35203,01,3160,36847,543,273000,2992,1677,2806,604,922,388,423,469,1889,1563,326,1563,405,1158,2021-01-01,zipcode
ZCTA5 35204,01,9287,27140,682,65200,7894,4385,6765,1279,2706,1925,587,268,5455,4167,1288,4167,1835,2332,2021-01-01,zipcode
ZCTA5 35205,01,18709,43277,894,226500,17444,6179,12626,663,1942,3161,3835,3025,11671,9251,2420,9251,2713,6538,2021-01-01,zipcode
ZCTA5 35206,01,16447,33366,932,92600,13451,5957,11967,1742,4587,3839,1176,623,8027,6388,1639,6388,3053,3335,2021-01-01,zipcode
ZCTA5 35207,01,7153,26967,691,67100,5635,2861,4818,970,1635,1554,370,289,3949,3131,818,3131,1703,1428,2021-01-01,zipcode
ZCTA5 35208,01,14112,32277,852,78200,11496,5801,9802,1346,3700,3346,1012,398,7284,5663,1621,5663,3385,2278,2021-01-01,zipcode
ZCTA5 35209,01,29287,67814,1115,372100,22816,6302,18550,820,2579,3710,6435,5006,15227,12457,2770,12457,6488,5969,2021-01-01,zipcode
ZCTA5 35210,01,13457,63784,938,169100,11578,4071,10610,767,2714,2872,2757,1500,6803,6074,729,6074,4290,1784,2021-01-01,zipcode
ZCTA5 35211,01,24762,33043,885,82700,19744,8570,17153,2377,5224,5809,2583,1160,14330,11273,3057,11273,4812,6461,2021-01-01,zipcode
ZCTA5 35212,01,10626,30113,624,162700,7435,2617,6656,871,1787,1870,1221,907,5425,4245,1180,4245,1831,2414,2021-01-01,zipcode
ZCTA5 35213,01,14807,125060,1497,576100,11617,3582,10253,58,418,919,5040,3818,6406,6153,253,6153,4651,1502,2021-01-01,zipcode
ZCTA5 35214,01,18106,54180,854,119600,15321,6643,13120,1153,3787,4741,2295,1144,8364,7171,1193,7171,4860,2311,2021-01-01,zipcode
ZCTA5 35215,01,46817,41814,924,115100,33796,13727,28650,3426,10102,10055,3459,1608,19640,17142,2498,17142,9568,7574,2021-01-01,zipcode
ZCTA5 35216,01,38829,65803,1157,299400,29679,8494,25416,1260,4020,6757,8423,4956,16844,15492,1352,15492,8661,6831,2021-01-01,zipcode
ZCTA5 35217,01,12906,39388,808,95700,10200,4506,8636,1664,3107,2795,661,409,5776,4759,1017,4759,2498,2261,2021-01-01,zipcode
ZCTA5 35218,01,7622,30725,855,64000,6226,3023,5459,970,1759,2207,368,155,3613,2755,858,2755,1123,1632,2021-01-01,zipcode
ZCTA5 35221,01,3787,34531,885,65200,3206,1684,2944,520,907,1219,250,48,2188,1517,671,1517,1030,487,2021-01-01,zipcode
ZCTA5 35222,01,8739,65665,861,332500,7173,2080,6464,334,772,1547,2001,1810,4335,3768,567,3768,2091,1677,2021-01-01,zipcode
ZCTA5 35223,01,11432,138438,2047,621100,9286,3961,8309,62,309,1066,3658,3214,4788,4514,274,4514,3972,542,2021-01-01,zipcode
ZCTA5 35224,01,5535,45679,876,67600,4348,1881,3606,323,1516,1393,293,81,2791,1971,820,1971,1072,899,2021-01-01,zipcode
ZCTA5 35226,01,38064,114509,1286,313800,29103,8560,26034,612,2287,5759,9607,7769,15036,14283,753,14283,11237,3046,2021-01-01,zipcode
ZCTA5 35228,01,10152,43283,877,71200,8223,3269,7055,891,2495,2206,1104,359,4579,3820,759,3820,2436,1384,2021-01-01,zipcode
ZCTA5 35229,01,1985,-666666666,-666666666,-666666666,1985,1177,5,0,0,5,0,0,0,0,0,0,0,0,2021-01-01,zipcode
ZCTA5 35233,01,2469,44394,1368,255100,2422,679,1503,38,148,84,343,890,2112,1596,516,1596,221,1375,2021-01-01,zipcode
ZCTA5 35234,01,4887,22774,639,59100,4312,2598,3949,930,1359,1290,329,41,2648,1941,707,1941,998,943,2021-01-01,zipcode
ZCTA5 35235,01,21357,58246,1131,129000,16194,5990,14328,861,4055,5403,2488,1521,9069,8290,779,8290,5630,2660,2021-01-01,zipcode
ZCTA5 35242,01,57077,107191,1211,380400,47124,15836,40402,1296,4119,8878,16692,9417,24789,23129,1660,23129,16847,6282,2021-01-01,zipcode
ZCTA5 35243,01,17532,93317,1416,394600,14468,4511,13289,118,1301,2486,5360,4024,10014,8474,1540,8474,4814,3660,2021-01-01,zipcode
ZCTA5 35244,01,36121,97668,1271,315400,28552,8980,24867,915,3434,6289,8229,6000,14710,13462,1248,13462,9611,3851,2021-01-01,zipcode
ZCTA5 35254,01,1395,-666666666,-666666666,-666666666,1395,934,0,0,0,0,0,0,0,0,0,0,0,0,2021-01-01,zipcode
ZCTA5 35401,01,36403,24209,827,115200,31969,17148,17352,2798,5803,4208,2538,2005,18856,12352,6504,12352,4150,8202,2021-01-01,zipcode
ZCTA5 35404,01,23644,42387,934,137300,18779,7263,13555,1757,4942,3972,1684,1200,10942,8051,2891,8051,4331,3720,2021-01-01,zipcode
ZCTA5 35405,01,47828,58695,942,185700,39016,12557,32189,2655,9076,9815,6822,3821,21729,18842,2887,18842,10292,8550,2021-01-01,zipcode
ZCTA5 35406,01,18228,108188,1178,374500,14219,5361,12426,462,1200,2285,4242,4237,8155,7178,977,7178,5485,1693,2021-01-01,zipcode
ZCTA5 35441,01,1170,45391,-666666666,66900,891,337,797,104,292,224,48,129,852,353,499,353,321,32,2021-01-01,zipcode
ZCTA5 35442,01,5798,30589,544,94400,4899,3129,4396,1042,1547,1161,482,164,2227,1713,514,1713,1033,680,2021-01-01,zipcode
ZCTA5 35443,01,1170,18578,491,54500,933,649,869,67,599,156,20,27,996,471,525,471,365,106,2021-01-01,zipcode
ZCTA5 35444,01,4216,52875,787,132000,3357,1308,2884,385,1084,983,374,58,1761,1570,191,1570,1261,309,2021-01-01,zipcode
ZCTA5 35446,01,2168,49146,920,103800,1698,788,1520,285,558,501,137,39,751,724,27,724,608,116,2021-01-01,zipcode
ZCTA5 35447,01,3173,39635,606,118800,2746,1459,2430,360,1188,642,156,84,1646,1220,426,1220,926,294,2021-01-01,zipcode
ZCTA5 35452,01,3886,57157,1285,160700,3196,1437,2701,363,936,1054,237,111,1708,1494,214,1494,1349,145,2021-01-01,zipcode
ZCTA5 35453,01,12163,65119,899,132500,9546,3518,8421,1252,3411,2470,755,533,5073,4294,779,4294,3543,751,2021-01-01,zipcode
ZCTA5 35456,01,4855,54135,862,153200,3739,1442,3165,529,1498,908,101,129,2002,1712,290,1712,1181,531,2021-01-01,zipcode
ZCTA5 35457,01,57,-666666666,-666666666,-666666666,57,0,57,0,57,0,0,0,57,57,0,57,57,0,2021-01-01,zipcode
ZCTA5 35458,01,742,-666666666,-666666666,409700,532,158,361,16,15,112,15,203,260,210,50,210,177,33,2021-01-01,zipcode
ZCTA5 35459,01,976,31413,716,63700,873,504,705,149,273,185,55,43,522,432,90,432,329,103,2021-01-01,zipcode
ZCTA5 35460,01,782,25300,-666666666,92400,601,403,478,8,197,208,65,0,382,322,60,322,255,67,2021-01-01,zipcode
ZCTA5 35461,01,1949,42100,1092,152200,1649,787,1451,181,652,403,148,67,1045,836,209,836,794,42,2021-01-01,zipcode
ZCTA5 35462,01,4408,29817,600,90300,3476,2059,3307,660,835,1368,294,150,2326,1813,513,1813,1172,641,2021-01-01,zipcode
ZCTA5 35463,01,2143,56918,1087,165000,1763,535,1585,133,815,337,222,78,894,725,169,725,641,84,2021-01-01,zipcode
ZCTA5 35464,01,642,13986,486,-666666666,458,291,264,27,88,88,61,0,252,158,94,158,52,106,2021-01-01,zipcode
ZCTA5 35466,01,5310,55572,571,108200,4098,1869,3499,401,1335,1200,307,256,2405,2015,390,2015,1751,264,2021-01-01,zipcode
ZCTA5 35469,01,432,-666666666,-666666666,58400,337,210,299,25,29,143,85,17,217,217,0,217,166,51,2021-01-01,zipcode
ZCTA5 35470,01,5067,22586,639,126000,4159,2227,2457,223,785,826,262,361,2067,1632,435,1632,921,711,2021-01-01,zipcode
ZCTA5 35473,01,19138,71931,791,190900,14657,4438,12227,1172,2746,3888,2767,1654,8234,7590,644,7590,4865,2725,2021-01-01,zipcode
ZCTA5 35474,01,7335,61053,826,134400,5760,1961,4648,638,1664,1134,615,597,2763,2244,519,2244,1977,267,2021-01-01,zipcode
ZCTA5 35475,01,19533,90953,774,239400,14757,5136,13078,627,3955,4098,2715,1683,7771,6762,1009,6762,6262,500,2021-01-01,zipcode
ZCTA5 35476,01,7755,48805,865,156600,6283,2165,5532,601,1606,1955,821,549,3554,3071,483,3071,1238,1833,2021-01-01,zipcode
ZCTA5 35477,01,137,59531,-666666666,-666666666,89,29,89,0,46,37,6,0,48,33,15,33,33,0,2021-01-01,zipcode
ZCTA5 35480,01,1926,75545,-666666666,190700,1524,702,1156,197,399,378,161,21,581,505,76,505,443,62,2021-01-01,zipcode
ZCTA5 35481,01,3308,42664,427,86300,2789,1396,2288,388,1106,593,112,89,1554,1300,254,1300,897,403,2021-01-01,zipcode
ZCTA5 35490,01,5445,62542,955,142400,4593,1657,3496,583,1426,1069,309,109,2148,1833,315,1833,1454,379,2021-01-01,zipcode
ZCTA5 35501,01,10045,41618,689,135900,7794,3569,6523,963,2212,2289,563,496,4550,3548,1002,3548,2121,1427,2021-01-01,zipcode
ZCTA5 35503,01,9450,51314,646,126400,7712,3405,6882,1069,2202,2499,702,410,4320,3674,646,3674,3034,640,2021-01-01,zipcode
ZCTA5 35504,01,13582,60547,614,165900,10780,4799,9385,1426,2577,3331,1329,722,5917,5207,710,5207,4010,1197,2021-01-01,zipcode
ZCTA5 35540,01,2410,47180,521,107300,1857,755,1695,213,689,591,145,57,1139,969,170,969,811,158,2021-01-01,zipcode
ZCTA5 35541,01,3707,52008,753,153600,3205,1707,2847,410,976,922,308,231,2576,1480,1096,1480,1271,209,2021-01-01,zipcode
ZCTA5 35542,01,888,27609,708,60300,736,405,584,109,210,231,32,2,439,372,67,372,337,35,2021-01-01,zipcode
ZCTA5 35543,01,1266,22361,569,67300,929,530,797,312,262,141,56,26,596,472,124,472,342,130,2021-01-01,zipcode
ZCTA5 35544,01,794,49009,773,-666666666,745,376,734,162,208,217,118,29,368,330,38,330,225,105,2021-01-01,zipcode
ZCTA5 35545,01,165,41250,-666666666,92900,139,83,117,44,36,32,3,2,62,59,3,59,44,15,2021-01-01,zipcode
ZCTA5 35546,01,3784,53663,516,114200,2968,1469,2555,378,1030,815,190,142,1649,1380,269,1380,1190,190,2021-01-01,zipcode
ZCTA5 35548,01,2066,42018,356,62900,1767,785,1494,377,478,496,106,37,974,849,125,849,702,147,2021-01-01,zipcode
ZCTA5 35549,01,3152,40357,607,58200,2653,1242,2290,433,830,908,72,47,1836,1446,390,1446,1096,350,2021-01-01,zipcode
ZCTA5 35550,01,5184,45000,439,83000,4142,2252,3747,604,1393,1343,251,156,2389,1956,433,1956,1607,349,2021-01-01,zipcode
ZCTA5 35552,01,1331,49344,335,68200,1028,319,826,63,352,249,148,14,586,464,122,464,406,58,2021-01-01,zipcode
ZCTA5 35553,01,4882,43676,522,75900,3872,1964,3102,727,1270,707,170,228,2408,1772,636,1772,1433,339,2021-01-01,zipcode
ZCTA5 35554,01,1074,40761,596,79400,854,409,756,115,336,266,33,6,523,408,115,408,343,65,2021-01-01,zipcode
ZCTA5 35555,01,9688,47923,546,103100,8012,3862,7045,964,2886,2133,773,289,4866,3693,1173,3693,2525,1168,2021-01-01,zipcode
ZCTA5 35559,01,64,-666666666,-666666666,-666666666,61,9,48,0,38,10,0,0,12,12,0,12,2,10,2021-01-01,zipcode
ZCTA5 35563,01,3816,43605,656,96700,3088,1390,2587,304,933,1020,181,149,1898,1386,512,1386,1103,283,2021-01-01,zipcode
ZCTA5 35564,01,2114,32485,548,90000,1657,844,1437,245,484,565,106,37,1098,851,247,851,644,207,2021-01-01,zipcode
ZCTA5 35565,01,11431,40682,601,78000,9197,4442,8343,2011,3250,2264,371,447,5712,4448,1264,4448,3371,1077,2021-01-01,zipcode
ZCTA5 35570,01,11097,45154,536,96800,9509,4966,8133,1621,2961,2522,641,388,5276,4281,995,4281,2832,1449,2021-01-01,zipcode
ZCTA5 35571,01,754,56458,-666666666,82500,568,260,492,77,199,147,45,24,388,248,140,248,211,37,2021-01-01,zipcode
ZCTA5 35572,01,1426,60243,-666666666,268200,1364,662,1217,308,569,223,76,41,1076,677,399,677,633,44,2021-01-01,zipcode
ZCTA5 35574,01,1411,54375,313,116800,1124,615,1099,218,575,247,27,32,713,520,193,520,457,63,2021-01-01,zipcode
ZCTA5 35575,01,1020,43289,691,77500,820,421,788,149,298,253,39,49,527,434,93,434,356,78,2021-01-01,zipcode
ZCTA5 35576,01,3356,60815,498,113100,2733,1147,2355,308,987,794,158,108,1623,1233,390,1233,1066,167,2021-01-01,zipcode
ZCTA5 35577,01,3,-666666666,-666666666,-666666666,3,3,3,0,1,2,0,0,2,2,0,2,2,0,2021-01-01,zipcode
ZCTA5 35578,01,5331,42420,921,97600,4215,2202,3624,730,1450,976,265,203,2478,2014,464,2014,1742,272,2021-01-01,zipcode
ZCTA5 35579,01,3597,42298,458,94100,2894,1653,2650,507,1190,784,145,24,1610,1267,343,1267,1062,205,2021-01-01,zipcode
ZCTA5 35580,01,3817,50053,624,88700,3056,1280,2792,677,1017,742,204,152,1788,1426,362,1426,1220,206,2021-01-01,zipcode
ZCTA5 35581,01,5925,46034,649,85600,4463,2221,3852,770,1609,1057,259,157,2359,1858,501,1858,1372,486,2021-01-01,zipcode
ZCTA5 35582,01,4590,35336,477,82700,3549,1599,3258,574,1257,674,599,154,2326,1880,446,1880,1312,568,2021-01-01,zipcode
ZCTA5 35584,01,262,20592,890,48700,196,143,173,69,59,41,0,4,126,91,35,91,68,23,2021-01-01,zipcode
ZCTA5 35585,01,1728,46351,-666666666,206400,1133,587,1003,176,198,299,263,67,633,502,131,502,391,111,2021-01-01,zipcode
ZCTA5 35586,01,3851,38172,473,78800,2935,1260,2568,434,986,927,119,102,1936,1468,468,1468,1094,374,2021-01-01,zipcode
ZCTA5 35587,01,616,37292,719,-666666666,532,309,532,200,231,89,0,12,373,258,115,258,193,65,2021-01-01,zipcode
ZCTA5 35592,01,4127,36019,436,114100,3403,2011,3041,613,1358,770,179,121,2410,1698,712,1698,970,728,2021-01-01,zipcode
ZCTA5 35593,01,1713,52895,588,88400,1446,685,1280,169,651,261,98,101,803,614,189,614,507,107,2021-01-01,zipcode
ZCTA5 35594,01,7198,56125,635,127600,5730,2556,5216,769,1759,1870,415,403,3308,2565,743,2565,1936,629,2021-01-01,zipcode
ZCTA5 35601,01,34682,45776,723,110300,27039,11339,23193,5426,6914,6293,3204,1356,14937,13231,1706,13231,7934,5297,2021-01-01,zipcode
ZCTA5 35603,01,32186,65453,729,182600,26120,10914,22940,2137,6489,7843,4216,2255,14444,13724,720,13724,10038,3686,2021-01-01,zipcode
ZCTA5 35610,01,1799,63472,542,157900,1644,665,1343,146,568,355,114,160,762,687,75,687,581,106,2021-01-01,zipcode
ZCTA5 35611,01,26761,48178,701,149800,22099,9646,19305,3332,5723,6167,2821,1262,13176,11416,1760,11416,6975,4441,2021-01-01,zipcode
ZCTA5 35613,01,20475,84512,1003,225000,16788,6699,15090,1548,3505,5048,3514,1475,8151,7803,348,7803,6745,1058,2021-01-01,zipcode
ZCTA5 35614,01,6950,49722,885,131900,5423,2349,4650,766,1851,1249,474,310,3040,2592,448,2592,2005,587,2021-01-01,zipcode
ZCTA5 35615,01,0,-666666666,-666666666,-666666666,0,0,0,0,0,0,0,0,0,0,0,0,0,0,2021-01-01,zipcode
ZCTA5 35616,01,3519,45326,754,85200,2794,1184,2473,485,987,683,140,178,2109,1438,671,1438,1013,425,2021-01-01,zipcode
ZCTA5 35618,01,2148,41415,527,88700,1730,1021,1487,219,596,441,120,111,1000,834,166,834,614,220,2021-01-01,zipcode
ZCTA5 35619,01,4703,53879,873,139500,3795,1728,3348,795,1321,898,229,105,2205,1723,482,1723,1326,397,2021-01-01,zipcode
ZCTA5 35620,01,11572,73232,841,148500,9517,3249,7764,891,2799,3044,541,489,4692,4248,444,4248,3655,593,2021-01-01,zipcode
ZCTA5 35621,01,2932,71125,930,139700,2170,778,1909,285,516,621,395,92,1078,1032,46,1032,888,144,2021-01-01,zipcode
ZCTA5 35622,01,7331,51062,770,115800,5336,2378,4746,587,2171,1406,388,194,2931,2461,470,2461,1732,729,2021-01-01,zipcode
ZCTA5 35630,01,32632,36164,693,127400,26987,11852,21463,2863,7497,5904,3264,1935,17175,14573,2602,14573,5990,8583,2021-01-01,zipcode
ZCTA5 35633,01,20454,58758,735,141500,16716,7288,14601,1755,4896,4160,2365,1425,9211,8210,1001,8210,6882,1328,2021-01-01,zipcode
ZCTA5 35634,01,10375,73188,811,206800,8535,3812,7658,491,2576,2177,1497,917,4826,4084,742,4084,3332,752,2021-01-01,zipcode
ZCTA5 35640,01,26780,61193,692,150300,21577,9278,18474,1946,6386,5939,2770,1433,11114,9942,1172,9942,8015,1927,2021-01-01,zipcode
ZCTA5 35643,01,4061,46594,663,102600,3298,1509,2981,1018,1064,538,218,143,1743,1542,201,1542,1351,191,2021-01-01,zipcode
ZCTA5 35645,01,13206,74809,698,192600,10337,3862,9320,619,3329,2791,1732,849,5611,4929,682,4929,4145,784,2021-01-01,zipcode
ZCTA5 35646,01,4327,50714,626,98300,3768,1934,3385,659,1563,922,130,111,2360,1814,546,1814,1521,293,2021-01-01,zipcode
ZCTA5 35647,01,1191,69757,694,127200,883,363,705,109,279,155,132,30,386,379,7,379,338,41,2021-01-01,zipcode
ZCTA5 35648,01,3325,60920,594,115800,2774,1215,2322,353,855,701,201,212,1429,1223,206,1223,993,230,2021-01-01,zipcode
ZCTA5 35649,01,83,-666666666,-666666666,296400,74,41,71,2,8,12,30,19,35,32,3,32,32,0,2021-01-01,zipcode
ZCTA5 35650,01,12996,55199,558,133800,10482,5037,9176,1456,3765,2283,1000,672,5905,4980,925,4980,3988,992,2021-01-01,zipcode
ZCTA5 35651,01,1441,60893,-666666666,173400,1256,659,1029,137,414,188,280,10,611,474,137,474,398,76,2021-01-01,zipcode
ZCTA5 35652,01,9350,59861,784,149300,7625,3048,6610,847,2421,1752,1048,542,4568,3664,904,3664,2945,719,2021-01-01,zipcode
ZCTA5 35653,01,10904,44067,598,90100,8445,3153,7056,1987,2863,1477,477,252,4603,3536,1067,3536,2397,1139,2021-01-01,zipcode
ZCTA5 35654,01,7939,40997,556,138300,6244,3092,5397,982,2571,1220,443,181,3629,2903,726,2903,1966,937,2021-01-01,zipcode
ZCTA5 35660,01,9438,37372,725,106300,7851,3862,6759,1078,2370,2177,696,438,5271,4282,989,4282,2484,1798,2021-01-01,zipcode
ZCTA5 35661,01,18799,63319,898,151700,15336,6002,13775,1302,4490,5068,1854,1061,8597,7466,1131,7466,6054,1412,2021-01-01,zipcode
ZCTA5 35670,01,6667,55559,664,155000,5233,2179,4654,865,1317,1562,732,178,3119,2383,736,2383,1792,591,2021-01-01,zipcode
ZCTA5 35671,01,1874,46218,384,85800,1596,663,1346,253,619,255,151,68,889,654,235,654,517,137,2021-01-01,zipcode
ZCTA5 35672,01,5391,52996,567,120600,4118,1964,3547,376,1520,1199,273,179,2630,2009,621,2009,1461,548,2021-01-01,zipcode
ZCTA5 35673,01,7350,63278,671,150900,5912,2318,5191,441,2199,1860,470,221,3269,2685,584,2685,2042,643,2021-01-01,zipcode
ZCTA5 35674,01,19841,53087,731,130200,15678,6671,13430,1660,5606,3591,1638,935,8640,7321,1319,7321,5043,2278,2021-01-01,zipcode
ZCTA5 35677,01,2120,42466,-666666666,-666666666,1799,959,1412,215,574,414,104,105,1159,771,388,771,699,72,2021-01-01,zipcode
ZCTA5 35739,01,4887,54260,716,157200,4129,1786,3674,547,1587,904,347,289,2288,2129,159,2129,1727,402,2021-01-01,zipcode
ZCTA5 35740,01,3371,39925,380,104300,2815,1570,2440,379,1060,705,229,67,1719,1493,226,1493,942,551,2021-01-01,zipcode
ZCTA5 35741,01,3415,81857,1009,274300,3267,1281,2932,170,466,402,1419,475,1789,1703,86,1703,1352,351,2021-01-01,zipcode
ZCTA5 35744,01,1995,40938,691,121600,1809,853,1547,274,691,462,63,57,829,705,124,705,526,179,2021-01-01,zipcode
ZCTA5 35745,01,100,34000,-666666666,168800,100,59,88,5,59,12,6,6,138,56,82,56,48,8,2021-01-01,zipcode
ZCTA5 35746,01,570,37250,-666666666,-666666666,570,376,552,177,233,82,32,28,380,272,108,272,272,0,2021-01-01,zipcode
ZCTA5 35747,01,5930,75903,706,180100,4702,1840,4089,496,1289,1202,728,374,3211,2287,924,2287,2017,270,2021-01-01,zipcode
ZCTA5 35748,01,7338,85855,690,257600,6070,2432,5257,453,1558,1192,1270,784,3077,2834,243,2834,2455,379,2021-01-01,zipcode
ZCTA5 35749,01,27196,101941,1046,204700,22187,8717,18734,2049,3852,5731,4461,2641,9573,8869,704,8869,8033,836,2021-01-01,zipcode
ZCTA5 35750,01,13349,60610,917,148700,10762,3982,9317,1329,3091,2507,1771,619,5492,5003,489,5003,3824,1179,2021-01-01,zipcode
ZCTA5 35751,01,264,41875,-666666666,208100,230,83,170,0,75,47,35,13,118,94,24,94,94,0,2021-01-01,zipcode
ZCTA5 35752,01,2091,38182,815,76400,1781,894,1604,215,716,466,98,109,1138,936,202,936,646,290,2021-01-01,zipcode
ZCTA5 35754,01,5699,73824,656,170600,4886,2011,4224,797,980,1167,786,494,2515,2260,255,2260,1785,475,2021-01-01,zipcode
ZCTA5 35755,01,455,39449,486,-666666666,420,227,328,18,68,159,49,34,420,205,215,205,139,66,2021-01-01,zipcode
ZCTA5 35756,01,22410,111070,1333,237600,16200,5291,14197,614,1638,3770,4975,3200,8417,7855,562,7855,6663,1192,2021-01-01,zipcode
ZCTA5 35757,01,17829,95239,1210,225800,13617,4165,12061,808,1590,3510,3831,2322,6617,6344,273,6344,5282,1062,2021-01-01,zipcode
ZCTA5 35758,01,47184,94132,1106,264500,36887,12440,32493,1010,3950,7311,11135,9087,19710,19142,568,19142,13168,5974,2021-01-01,zipcode
ZCTA5 35759,01,10557,89165,1281,207700,8381,2606,7363,624,1780,1966,2149,844,4087,3967,120,3967,3770,197,2021-01-01,zipcode
ZCTA5 35760,01,5077,59297,728,136200,3591,1281,3187,573,969,890,633,122,1885,1731,154,1731,1372,359,2021-01-01,zipcode
ZCTA5 35761,01,13187,68864,910,163600,9891,3409,8646,1007,2087,3176,1824,552,5130,4780,350,4780,4006,774,2021-01-01,zipcode
ZCTA5 35763,01,19328,118683,1719,295500,14537,5309,13158,537,2028,2505,4518,3570,7139,7010,129,7010,6429,581,2021-01-01,zipcode
ZCTA5 35764,01,557,35605,625,75600,519,316,473,135,277,51,8,2,310,259,51,259,223,36,2021-01-01,zipcode
ZCTA5 35765,01,4768,49777,573,122000,3723,1997,3332,661,988,948,336,399,2051,1681,370,1681,1409,272,2021-01-01,zipcode
ZCTA5 35766,01,231,77788,-666666666,75800,205,49,191,23,136,22,6,4,119,79,40,79,56,23,2021-01-01,zipcode
ZCTA5 35768,01,12851,43621,633,113000,10444,5451,8948,1593,3733,2305,784,533,5639,4743,896,4743,3115,1628,2021-01-01,zipcode
ZCTA5 35769,01,9810,48660,685,137300,8000,3680,7188,740,2034,2491,1275,648,4935,4123,812,4123,3307,816,2021-01-01,zipcode
ZCTA5 35771,01,3071,56453,635,98000,2315,935,2117,462,698,684,181,92,1444,1102,342,1102,920,182,2021-01-01,zipcode
ZCTA5 35772,01,4895,37231,696,95900,3816,2078,3478,792,1317,863,358,148,2325,1856,469,1856,1372,484,2021-01-01,zipcode
ZCTA5 35773,01,14089,56635,798,138800,11598,4008,10844,937,3553,3585,1711,1058,5801,5475,326,5475,4756,719,2021-01-01,zipcode
ZCTA5 35774,01,199,78077,-666666666,90000,199,123,160,0,73,60,13,14,71,58,13,58,58,0,2021-01-01,zipcode
ZCTA5 35775,01,554,40559,-666666666,82700,431,214,399,79,136,128,34,22,256,207,49,207,197,10,2021-01-01,zipcode
ZCTA5 35776,01,3447,44868,516,111600,2801,1425,2452,340,982,746,258,126,1609,1322,287,1322,1112,210,2021-01-01,zipcode
ZCTA5 35801,01,25145,85880,986,312300,21405,8751,18816,2042,2906,3906,6088,3874,11518,10555,963,10555,6885,3670,2021-01-01,zipcode
ZCTA5 35802,01,23629,64208,924,249700,19738,7511,17452,729,2347,5738,5049,3589,12352,11209,1143,11209,5918,5291,2021-01-01,zipcode
ZCTA5 35803,01,27990,84951,998,196100,22761,9022,20241,773,3582,5465,6368,4053,12738,11846,892,11846,9537,2309,2021-01-01,zipcode
ZCTA5 35805,01,20033,28232,702,83500,15452,5825,12690,2910,3299,4138,1591,752,10305,9252,1053,9252,2916,6336,2021-01-01,zipcode
ZCTA5 35806,01,26199,66702,1090,237500,22054,6186,17609,821,2102,4567,6079,4040,13423,12886,537,12886,6113,6773,2021-01-01,zipcode
ZCTA5 35808,01,1218,105781,1578,-666666666,980,268,715,0,125,274,154,162,388,379,9,379,13,366,2021-01-01,zipcode
ZCTA5 35810,01,31735,40395,942,91800,24689,10555,20760,3022,5655,7353,3202,1528,13194,12067,1127,12067,7870,4197,2021-01-01,zipcode
ZCTA5 35811,01,28129,75303,878,196900,23715,8893,19196,1422,4106,7372,4259,2037,12002,11011,991,11011,8308,2703,2021-01-01,zipcode
ZCTA5 35816,01,14440,29162,764,91200,12310,4633,8477,1264,1910,2782,1648,873,7736,6758,978,6758,1948,4810,2021-01-01,zipcode
ZCTA5 35824,01,9129,93857,1000,267700,7905,2001,6674,118,733,1711,1898,2214,4464,4218,246,4218,2239,1979,2021-01-01,zipcode
ZCTA5 35896,01,619,-666666666,-666666666,-666666666,619,351,0,0,0,0,0,0,0,0,0,0,0,0,2021-01-01,zipcode
ZCTA5 35901,01,18827,40350,659,144600,15065,6984,12846,1914,3739,4109,1888,1196,9047,7123,1924,7123,4606,2517,2021-01-01,zipcode
ZCTA5 35903,01,18240,44003,720,127200,15537,6183,13014,1759,4148,4998,1261,848,8758,7051,1707,7051,4579,2472,2021-01-01,zipcode
ZCTA5 35904,01,13571,39267,690,79900,10847,5317,9562,1335,3869,3104,809,445,6435,5056,1379,5056,3856,1200,2021-01-01,zipcode
ZCTA5 35905,01,5934,59576,718,158200,4690,2114,4175,283,1284,1522,473,613,2836,2196,640,2196,1865,331,2021-01-01,zipcode
ZCTA5 35906,01,10309,51975,847,169200,8013,3392,7180,759,2197,2332,1262,630,4689,3882,807,3882,2305,1577,2021-01-01,zipcode
ZCTA5 35907,01,9138,66730,999,161500,7179,2844,6553,547,1967,2604,868,567,3272,2971,301,2971,2696,275,2021-01-01,zipcode
ZCTA5 35950,01,20816,49508,772,121300,15092,5817,12972,2838,3594,4056,1675,809,7724,7185,539,7185,4731,2454,2021-01-01,zipcode
ZCTA5 35951,01,13348,45543,663,123400,10308,4825,8822,2269,2882,2500,819,352,5327,4526,801,4526,3387,1139,2021-01-01,zipcode
ZCTA5 35952,01,8682,42615,639,107000,6967,3240,6277,1450,2395,1725,507,200,3716,3221,495,3221,2574,647,2021-01-01,zipcode
ZCTA5 35953,01,6967,53657,951,151300,6082,3149,5590,1067,2340,1866,165,152,3513,2770,743,2770,2252,518,2021-01-01,zipcode
ZCTA5 35954,01,12551,46985,623,101300,10342,4682,8911,1499,3530,3050,478,354,5801,4642,1159,4642,3782,860,2021-01-01,zipcode
ZCTA5 35956,01,8562,53497,721,146800,6765,3147,5735,873,1990,1971,498,403,3730,2983,747,2983,2365,618,2021-01-01,zipcode
ZCTA5 35957,01,16240,42411,596,104100,12184,5286,10351,1658,3669,3479,1027,518,6871,5961,910,5961,4020,1941,2021-01-01,zipcode
ZCTA5 35958,01,3403,47763,540,134900,2653,1386,2264,435,947,473,257,152,1335,1186,149,1186,979,207,2021-01-01,zipcode
ZCTA5 35959,01,4212,37717,557,156400,3466,1912,3221,546,1256,897,251,271,3411,1774,1637,1774,1428,346,2021-01-01,zipcode
ZCTA5 35960,01,8459,40672,697,155700,7409,3844,6730,1394,2353,2011,418,554,5381,3452,1929,3452,2579,873,2021-01-01,zipcode
ZCTA5 35961,01,6144,38714,604,77700,4898,2261,4141,1297,1438,1094,116,196,2540,2049,491,2049,1481,568,2021-01-01,zipcode
ZCTA5 35962,01,8139,48100,758,125700,6514,2825,5575,1642,1877,1390,320,346,3411,2846,565,2846,2099,747,2021-01-01,zipcode
ZCTA5 35963,01,1137,50938,-666666666,-666666666,979,331,913,84,309,430,63,27,548,495,53,495,375,120,2021-01-01,zipcode
ZCTA5 35966,01,3336,43355,494,113900,2827,1424,2417,769,754,683,159,52,1732,1259,473,1259,1070,189,2021-01-01,zipcode
ZCTA5 35967,01,16649,44027,645,122400,12628,5419,11072,2300,3421,3400,1086,865,7603,6287,1316,6287,4319,1968,2021-01-01,zipcode
ZCTA5 35968,01,5237,43068,634,110000,4188,1996,3552,801,1399,935,261,156,2088,1766,322,1766,1341,425,2021-01-01,zipcode
ZCTA5 35971,01,5661,41800,709,104200,4691,2355,3903,758,1547,1292,190,116,2067,1928,139,1928,1369,559,2021-01-01,zipcode
ZCTA5 35972,01,1036,-666666666,-666666666,76600,813,435,722,194,226,185,54,63,557,463,94,463,417,46,2021-01-01,zipcode
ZCTA5 35973,01,3577,48750,954,79100,2771,1336,2235,541,753,761,149,31,1408,1120,288,1120,935,185,2021-01-01,zipcode
ZCTA5 35974,01,1749,58632,634,158500,1341,430,1204,154,381,408,133,128,711,644,67,644,443,201,2021-01-01,zipcode
ZCTA5 35975,01,1306,32917,673,152600,1058,495,866,46,487,252,51,30,449,449,0,449,411,38,2021-01-01,zipcode
ZCTA5 35976,01,17292,60315,678,199400,14319,6978,12514,1725,3207,3601,2962,1019,7696,6683,1013,6683,5219,1464,2021-01-01,zipcode
ZCTA5 35978,01,5538,48182,901,119400,4137,1850,3804,594,1660,1095,299,156,2210,1804,406,1804,1443,361,2021-01-01,zipcode
ZCTA5 35979,01,1005,-666666666,-666666666,132800,779,348,610,113,269,194,14,20,464,382,82,382,346,36,2021-01-01,zipcode
ZCTA5 35980,01,6208,52677,703,121600,4689,2187,3822,829,1449,887,354,303,2167,1915,252,1915,1571,344,2021-01-01,zipcode
ZCTA5 35981,01,2015,37560,-666666666,97600,1759,796,1459,294,620,325,206,14,856,649,207,649,502,147,2021-01-01,zipcode
ZCTA5 35983,01,3966,58867,634,151700,3257,1588,2863,291,1150,1034,213,175,2192,1488,704,1488,1261,227,2021-01-01,zipcode
ZCTA5 35984,01,1401,37837,830,161300,1309,714,1287,174,344,281,237,251,1542,747,795,747,560,187,2021-01-01,zipcode
ZCTA5 35986,01,7844,52467,578,161300,6296,2585,5373,986,1399,1956,782,250,3458,3075,383,3075,2372,703,2021-01-01,zipcode
ZCTA5 35987,01,2483,62703,-666666666,119500,1935,869,1672,348,708,446,123,47,1083,932,151,932,738,194,2021-01-01,zipcode
ZCTA5 35988,01,2423,45081,587,91200,1934,706,1493,269,479,417,244,84,900,802,98,802,553,249,2021-01-01,zipcode
ZCTA5 35989,01,3750,43684,612,78300,2790,1442,2363,518,770,751,201,123,1452,1288,164,1288,1078,210,2021-01-01,zipcode
ZCTA5 35990,01,0,-666666666,-666666666,-666666666,0,0,0,0,0,0,0,0,12,0,12,0,0,0,2021-01-01,zipcode
ZCTA5 36003,01,2397,28023,410,108700,1962,1231,1792,402,687,530,60,113,1267,1056,211,1056,851,205,2021-01-01,zipcode
ZCTA5 36005,01,1486,41797,847,118100,1267,617,1045,193,363,261,142,86,874,563,311,563,479,84,2021-01-01,zipcode
ZCTA5 36006,01,1685,-666666666,1043,171900,1396,623,1319,125,530,520,120,24,813,699,114,699,643,56,2021-01-01,zipcode
ZCTA5 36009,01,2233,44762,562,89200,1846,939,1617,169,806,303,217,122,1189,866,323,866,628,238,2021-01-01,zipcode
ZCTA5 36010,01,5316,36384,620,109000,4238,2133,3666,660,1732,717,365,192,2767,1852,915,1852,1243,609,2021-01-01,zipcode
ZCTA5 36013,01,395,105200,-666666666,368900,323,167,291,54,58,148,14,17,164,148,16,148,148,0,2021-01-01,zipcode
ZCTA5 36016,01,4990,48289,594,56700,4270,2642,3924,1031,1655,1000,178,60,1969,1484,485,1484,975,509,2021-01-01,zipcode
ZCTA5 36017,01,3257,29637,414,56000,2825,2080,2595,942,949,539,115,50,1018,791,227,791,498,293,2021-01-01,zipcode
ZCTA5 36020,01,1119,48750,1009,156700,906,431,767,107,268,245,98,49,481,414,67,414,307,107,2021-01-01,zipcode
ZCTA5 36022,01,15336,74158,1018,180900,11773,3819,10129,653,3242,3626,1819,789,5888,5373,515,5373,4717,656,2021-01-01,zipcode
ZCTA5 36024,01,5152,51684,728,218100,4478,2078,4046,366,1587,1268,566,259,3450,2208,1242,2208,1744,464,2021-01-01,zipcode
ZCTA5 36025,01,7267,46227,1032,150400,6452,4434,5860,1772,2135,1108,608,237,1733,1581,152,1581,1129,452,2021-01-01,zipcode
ZCTA5 36026,01,1239,89375,-666666666,283700,1163,591,1099,77,314,412,287,9,973,541,432,541,522,19,2021-01-01,zipcode
ZCTA5 36027,01,14825,36761,621,109200,11604,5568,9817,1958,3294,3100,828,637,7188,5768,1420,5768,3370,2398,2021-01-01,zipcode
ZCTA5 36028,01,1501,38269,525,109600,1310,771,1138,253,290,330,199,66,867,588,279,588,384,204,2021-01-01,zipcode
ZCTA5 36029,01,1188,57800,-666666666,153800,950,341,892,175,356,163,131,67,393,334,59,334,277,57,2021-01-01,zipcode
ZCTA5 36030,01,425,-666666666,659,113300,377,233,335,9,242,59,18,7,256,126,130,126,103,23,2021-01-01,zipcode
ZCTA5 36031,01,107,-666666666,-666666666,-666666666,87,62,58,0,52,6,0,0,26,26,0,26,26,0,2021-01-01,zipcode
ZCTA5 36032,01,2355,30671,416,62600,1759,926,1500,311,747,305,55,82,1100,862,238,862,631,231,2021-01-01,zipcode
ZCTA5 36033,01,3544,37967,635,77300,2851,1484,2634,412,1206,655,246,115,2198,1306,892,1306,1021,285,2021-01-01,zipcode
ZCTA5 36034,01,975,34917,575,77800,745,338,604,45,251,176,85,47,431,309,122,309,266,43,2021-01-01,zipcode
ZCTA5 36035,01,1972,46518,800,101900,1510,671,1292,148,561,273,202,108,1125,733,392,733,632,101,2021-01-01,zipcode
ZCTA5 36036,01,1933,43897,828,119000,1812,994,1490,376,488,344,127,155,1038,743,295,743,634,109,2021-01-01,zipcode
ZCTA5 36037,01,13194,47467,684,96600,10471,4612,9064,1340,4028,2404,684,608,6263,4345,1918,4345,2984,1361,2021-01-01,zipcode
ZCTA5 36038,01,80,76250,-666666666,-666666666,73,41,71,5,26,29,11,0,33,25,8,25,23,2,2021-01-01,zipcode
ZCTA5 36039,01,279,50761,-666666666,-666666666,279,147,240,57,89,78,16,0,137,92,45,92,46,46,2021-01-01,zipcode
ZCTA5 36040,01,3762,30521,717,67600,3092,1644,2645,440,1175,603,235,192,1519,1345,174,1345,879,466,2021-01-01,zipcode
ZCTA5 36041,01,1423,40407,615,100300,1101,556,916,181,366,251,101,17,746,530,216,530,474,56,2021-01-01,zipcode
ZCTA5 36042,01,1188,65833,-666666666,98800,901,334,814,112,352,217,93,40,789,404,385,404,370,34,2021-01-01,zipcode
ZCTA5 36043,01,3805,79044,1054,199900,3304,1465,2651,433,888,680,341,309,1564,1307,257,1307,1097,210,2021-01-01,zipcode
ZCTA5 36046,01,1556,43229,-666666666,112100,1205,509,1027,260,337,308,62,60,581,491,90,491,470,21,2021-01-01,zipcode
ZCTA5 36047,01,940,-666666666,-666666666,54400,900,395,834,112,292,347,57,26,532,385,147,385,375,10,2021-01-01,zipcode
ZCTA5 36048,01,1243,25625,575,-666666666,1121,545,1022,252,469,226,58,17,796,581,215,581,403,178,2021-01-01,zipcode
ZCTA5 36049,01,5984,46909,623,83400,4835,2215,4288,814,1763,917,582,212,2593,1941,652,1941,1452,489,2021-01-01,zipcode
ZCTA5 36051,01,3080,71314,949,59200,2338,723,2122,226,1009,731,85,71,1145,1004,141,1004,846,158,2021-01-01,zipcode
ZCTA5 36052,01,668,113594,-666666666,591300,616,224,537,23,102,111,187,114,382,357,25,357,325,32,2021-01-01,zipcode
ZCTA5 36053,01,2419,31196,491,82800,2069,1127,1668,335,623,581,51,78,1280,910,370,910,696,214,2021-01-01,zipcode
ZCTA5 36054,01,15362,53877,868,142300,11503,4558,9418,1010,3030,3018,1542,818,6180,5706,474,5706,3867,1839,2021-01-01,zipcode
ZCTA5 36064,01,12737,108385,1338,301500,9130,2486,8045,296,1298,2031,2552,1868,4753,4305,448,4305,3668,637,2021-01-01,zipcode
ZCTA5 36066,01,21383,67166,1166,184900,17436,6383,14260,954,3342,3699,3601,2664,8957,8677,280,8677,5238,3439,2021-01-01,zipcode
ZCTA5 36067,01,27717,57554,892,143600,22148,9553,19015,2384,6734,5663,2473,1761,11197,9971,1226,9971,7510,2461,2021-01-01,zipcode
ZCTA5 36069,01,1950,41549,822,99500,1772,898,1540,256,536,453,176,119,1213,919,294,919,704,215,2021-01-01,zipcode
ZCTA5 36071,01,356,39659,630,101000,293,183,286,49,142,32,43,20,256,163,93,163,131,32,2021-01-01,zipcode
ZCTA5 36075,01,1770,41875,808,83900,1586,931,1449,267,549,454,104,75,913,731,182,731,629,102,2021-01-01,zipcode
ZCTA5 36078,01,13346,58470,785,152800,11118,4751,9297,1368,3275,3072,1065,517,5840,5207,633,5207,3646,1561,2021-01-01,zipcode
ZCTA5 36079,01,9397,51472,879,127000,7498,3225,6534,900,2274,1635,891,834,4305,3340,965,3340,2646,694,2021-01-01,zipcode
ZCTA5 36080,01,2413,73517,876,199300,1907,858,1803,333,658,403,277,132,1058,843,215,843,680,163,2021-01-01,zipcode
ZCTA5 36081,01,15653,33829,680,152200,13154,6178,7808,734,2487,1890,1618,1079,7736,5606,2130,5606,2493,3113,2021-01-01,zipcode
ZCTA5 36082,01,979,-666666666,-666666666,-666666666,979,800,13,0,8,5,0,0,0,0,0,0,0,0,2021-01-01,zipcode
ZCTA5 36083,01,9145,38653,612,75200,7766,3723,5825,914,1623,1874,707,707,4572,3399,1173,3399,2059,1340,2021-01-01,zipcode
ZCTA5 36088,01,3561,36164,730,89400,3137,1460,1649,218,357,482,310,282,1846,1105,741,1105,604,501,2021-01-01,zipcode
ZCTA5 36089,01,7743,22917,553,73600,5778,3209,4928,1231,1953,1143,440,161,3381,2547,834,2547,1560,987,2021-01-01,zipcode
ZCTA5 36091,01,3670,42708,782,104900,3232,1733,2935,629,1291,731,135,149,2009,1532,477,1532,1195,337,2021-01-01,zipcode
ZCTA5 36092,01,20457,66484,919,160800,16291,7231,14177,1667,5508,4313,1959,730,8882,7752,1130,7752,5865,1887,2021-01-01,zipcode
ZCTA5 36093,01,12291,106367,797,266400,9786,3488,8089,401,1402,2607,2184,1495,4540,4235,305,4235,3896,339,2021-01-01,zipcode
ZCTA5 36104,01,9291,32863,700,77800,7666,3808,5957,1194,1772,1566,758,667,5147,3825,1322,3825,1025,2800,2021-01-01,zipcode
ZCTA5 36105,01,10559,36788,897,71700,8760,4221,8057,2004,2384,2356,869,444,5674,4383,1291,4383,2710,1673,2021-01-01,zipcode
ZCTA5 36106,01,15276,62482,988,157200,12450,4429,10199,715,2048,2735,2216,2485,7013,6220,793,6220,3478,2742,2021-01-01,zipcode
ZCTA5 36107,01,7965,29156,788,62000,6015,2777,5022,1110,1400,1566,580,366,4106,3095,1011,3095,1169,1926,2021-01-01,zipcode
ZCTA5 36108,01,15588,25028,660,64800,12616,6887,11118,2896,3871,2617,1118,616,8686,6363,2323,6363,3848,2515,2021-01-01,zipcode
ZCTA5 36109,01,24344,54884,950,117900,19889,7985,16805,1516,5001,5101,3263,1924,11116,10058,1058,10058,6635,3423,2021-01-01,zipcode
ZCTA5 36110,01,11932,38100,914,63900,9413,4769,8103,1743,3225,2359,533,243,5241,3952,1289,3952,2139,1813,2021-01-01,zipcode
ZCTA5 36111,01,13058,56523,961,149800,10230,4154,8569,1168,2164,1876,2007,1354,5665,4790,875,4790,2916,1874,2021-01-01,zipcode
ZCTA5 36112,01,217,36563,913,-666666666,202,13,96,0,4,62,26,4,17,17,0,17,0,17,2021-01-01,zipcode
ZCTA5 36113,01,1807,110304,1665,-666666666,1535,1000,1303,211,275,450,188,179,313,270,43,270,0,270,2021-01-01,zipcode
ZCTA5 36115,01,1278,87647,1394,-666666666,758,161,507,0,88,225,110,84,250,242,8,242,0,242,2021-01-01,zipcode
ZCTA5 36116,01,44722,47620,941,113300,34653,12929,28696,3077,7789,8884,5126,3820,19932,17215,2717,17215,7971,9244,2021-01-01,zipcode
ZCTA5 36117,01,52622,69422,1037,188500,40750,13573,34265,1793,6296,10028,9673,6475,23426,21303,2123,21303,12807,8496,2021-01-01,zipcode
ZCTA5 36201,01,17748,30610,624,66400,15050,7303,13156,2985,5481,3949,547,194,9753,7388,2365,7388,4554,2834,2021-01-01,zipcode
ZCTA5 36203,01,18895,58934,849,140500,15127,5748,13287,2062,3461,4519,1728,1517,7794,7026,768,7026,4872,2154,2021-01-01,zipcode
ZCTA5 36205,01,1030,23944,726,224800,836,468,726,127,181,306,49,63,518,423,95,423,225,198,2021-01-01,zipcode
ZCTA5 36206,01,11019,51474,820,99400,8504,3223,7378,1104,2580,2302,725,667,4821,4172,649,4172,2681,1491,2021-01-01,zipcode
ZCTA5 36207,01,18940,62334,918,171600,15130,6417,13018,1022,3746,4311,2201,1738,9130,7663,1467,7663,5616,2047,2021-01-01,zipcode
ZCTA5 36250,01,4650,78984,920,140700,3800,1483,3457,225,1268,1277,427,260,1671,1534,137,1534,1312,222,2021-01-01,zipcode
ZCTA5 36251,01,5413,44121,380,114900,4466,1924,3677,715,1303,1250,338,71,2469,2035,434,2035,1515,520,2021-01-01,zipcode
ZCTA5 36255,01,1016,67727,-666666666,122700,872,409,679,136,239,233,9,62,500,402,98,402,378,24,2021-01-01,zipcode
ZCTA5 36256,01,1478,46932,563,112500,1130,530,994,123,312,409,60,90,754,625,129,625,548,77,2021-01-01,zipcode
ZCTA5 36258,01,1303,43167,-666666666,113800,1125,671,985,132,353,373,119,8,752,550,202,550,493,57,2021-01-01,zipcode
ZCTA5 36260,01,4386,50529,621,129900,3358,1767,3056,488,1119,935,348,166,1601,1398,203,1398,1141,257,2021-01-01,zipcode
ZCTA5 36262,01,1647,48385,767,89300,1322,726,1162,287,554,211,89,21,691,567,124,567,495,72,2021-01-01,zipcode
ZCTA5 36263,01,482,50455,-666666666,115500,375,174,298,129,99,56,0,14,271,156,115,156,121,35,2021-01-01,zipcode
ZCTA5 36264,01,8731,48388,695,123900,6968,3493,6163,1151,2086,1896,766,264,3809,3142,667,3142,2245,897,2021-01-01,zipcode
ZCTA5 36265,01,21422,49246,698,140800,18384,7925,13802,1573,4420,4070,2256,1483,9578,8338,1240,8338,5501,2837,2021-01-01,zipcode
ZCTA5 36266,01,6159,45461,575,133300,4775,2308,4365,703,1886,1157,423,196,3229,2377,852,2377,1686,691,2021-01-01,zipcode
ZCTA5 36267,01,228,-666666666,-666666666,-666666666,83,70,83,0,65,18,0,0,13,13,0,13,13,0,2021-01-01,zipcode
ZCTA5 36268,01,5944,56399,822,91600,4410,1774,3690,395,1622,1267,178,228,2646,2135,511,2135,1900,235,2021-01-01,zipcode
ZCTA5 36269,01,1492,41538,834,110800,1015,422,949,130,425,234,120,40,629,544,85,544,399,145,2021-01-01,zipcode
ZCTA5 36271,01,6056,47281,765,99900,4641,2073,4215,623,1718,1266,332,276,2849,2300,549,2300,2109,191,2021-01-01,zipcode
ZCTA5 36272,01,13091,46014,679,90300,10849,5158,9391,1978,3729,2455,640,589,6518,5134,1384,5134,3982,1152,2021-01-01,zipcode
ZCTA5 36273,01,2851,50577,740,113700,2217,1032,1903,298,694,553,240,118,1421,1150,271,1150,987,163,2021-01-01,zipcode
ZCTA5 36274,01,10187,36471,650,90200,8447,4307,7370,1381,2892,2241,605,251,5227,4123,1104,4123,3140,983,2021-01-01,zipcode
ZCTA5 36276,01,2817,41494,609,85600,2333,1178,1832,269,676,594,230,63,1184,997,187,997,788,209,2021-01-01,zipcode
ZCTA5 36277,01,5912,59271,811,112500,4518,2008,4005,640,1166,1381,508,310,2292,1924,368,1924,1614,310,2021-01-01,zipcode
ZCTA5 36278,01,3985,41149,603,172700,3266,1926,3065,555,726,1134,256,394,3319,1740,1579,1740,1469,271,2021-01-01,zipcode
ZCTA5 36279,01,2921,58636,950,125000,2101,921,1924,297,766,568,160,133,1092,914,178,914,776,138,2021-01-01,zipcode
ZCTA5 36280,01,4237,67961,757,139800,3291,1461,2908,470,1012,698,315,413,2056,1585,471,1585,1349,236,2021-01-01,zipcode
ZCTA5 36301,01,37699,43054,792,127900,29978,12994,26142,3667,9053,8944,2892,1586,17681,15084,2597,15084,9101,5983,2021-01-01,zipcode
ZCTA5 36303,01,31269,48141,749,148300,24477,10775,21104,2402,6070,6988,3627,2017,14747,11898,2849,11898,7166,4732,2021-01-01,zipcode
ZCTA5 36305,01,16878,75365,996,193200,13261,5010,11520,705,2772,3756,2507,1780,7118,6350,768,6350,4396,1954,2021-01-01,zipcode
ZCTA5 36310,01,5929,38672,526,102300,5145,2965,4566,1043,1752,1076,426,269,4144,2408,1736,2408,1853,555,2021-01-01,zipcode
ZCTA5 36311,01,2280,42604,658,103200,1840,889,1529,267,650,457,60,95,1183,912,271,912,735,177,2021-01-01,zipcode
ZCTA5 36312,01,6095,46707,736,134000,4925,2253,4249,605,1569,1437,461,177,2806,2339,467,2339,1697,642,2021-01-01,zipcode
ZCTA5 36313,01,166,61554,-666666666,162200,140,0,140,46,0,74,0,20,179,140,39,140,116,24,2021-01-01,zipcode
ZCTA5 36314,01,531,50762,519,59200,391,178,388,22,171,158,37,0,263,207,56,207,178,29,2021-01-01,zipcode
ZCTA5 36316,01,2138,66658,771,148700,1801,751,1607,161,399,699,267,81,963,790,173,790,687,103,2021-01-01,zipcode
ZCTA5 36317,01,651,54688,-666666666,104000,614,333,555,129,134,124,101,67,327,266,61,266,239,27,2021-01-01,zipcode
ZCTA5 36318,01,1505,54063,588,106600,1186,599,992,158,312,364,106,52,758,554,204,554,504,50,2021-01-01,zipcode
ZCTA5 36319,01,2385,55962,739,114200,1844,837,1601,173,653,548,149,78,1047,878,169,878,714,164,2021-01-01,zipcode
ZCTA5 36320,01,3250,38182,695,95800,2785,1418,2528,480,1058,685,250,55,1655,1304,351,1304,1076,228,2021-01-01,zipcode
ZCTA5 36321,01,2133,51708,753,132700,1600,747,1425,241,537,485,90,72,852,761,91,761,604,157,2021-01-01,zipcode
ZCTA5 36322,01,8437,43836,679,96800,7035,2949,6080,1009,2140,2032,627,272,4613,3922,691,3922,2264,1658,2021-01-01,zipcode
ZCTA5 36323,01,7865,42939,708,85000,6646,3346,5714,1360,1940,1681,500,233,3805,2970,835,2970,2295,675,2021-01-01,zipcode
ZCTA5 36330,01,37874,65814,905,179700,29606,11917,25582,2737,6540,9590,4289,2426,16554,14726,1828,14726,9531,5195,2021-01-01,zipcode
ZCTA5 36340,01,5533,38222,607,112400,4258,2423,3977,932,1498,991,293,263,2669,2327,342,2327,1533,794,2021-01-01,zipcode
ZCTA5 36343,01,1300,41125,928,81600,1132,636,1033,206,404,351,63,9,721,535,186,535,417,118,2021-01-01,zipcode
ZCTA5 36344,01,6176,47888,716,152700,4697,2188,4137,546,1521,1518,394,158,2716,2100,616,2100,1533,567,2021-01-01,zipcode
ZCTA5 36345,01,8630,64812,806,154100,6582,2496,5911,847,1611,1799,1171,483,3571,3146,425,3146,2669,477,2021-01-01,zipcode
ZCTA5 36346,01,1150,52500,675,113900,941,429,836,187,278,201,90,80,724,474,250,474,424,50,2021-01-01,zipcode
ZCTA5 36350,01,7634,46023,689,137000,6000,2314,5217,1245,1608,1397,730,237,3355,2940,415,2940,1795,1145,2021-01-01,zipcode
ZCTA5 36351,01,3678,60313,675,119000,2883,1241,2510,353,760,904,290,203,1800,1509,291,1509,1232,277,2021-01-01,zipcode
ZCTA5 36352,01,5442,64762,730,157400,4485,1927,3768,341,1206,1601,340,280,2052,1882,170,1882,1622,260,2021-01-01,zipcode
ZCTA5 36353,01,1614,44345,728,96200,1400,652,1143,167,370,445,116,45,811,581,230,581,533,48,2021-01-01,zipcode
ZCTA5 36360,01,19022,45400,676,125400,15323,7856,13401,1971,4169,4865,1398,998,9087,7823,1264,7823,5036,2787,2021-01-01,zipcode
ZCTA5 36362,01,5912,67574,1211,-666666666,3971,956,2655,24,336,1219,875,201,1519,1461,58,1461,10,1451,2021-01-01,zipcode
ZCTA5 36370,01,990,38000,543,84100,820,425,757,154,363,186,50,4,485,398,87,398,370,28,2021-01-01,zipcode
ZCTA5 36371,01,434,35750,631,106600,364,159,316,36,97,145,26,12,206,195,11,195,147,48,2021-01-01,zipcode
ZCTA5 36373,01,665,45063,-666666666,60900,637,353,408,166,155,87,0,0,466,217,249,217,192,25,2021-01-01,zipcode
ZCTA5 36374,01,534,70625,864,65700,456,167,405,102,70,122,45,66,457,222,235,222,180,42,2021-01-01,zipcode
ZCTA5 36375,01,6882,45275,747,113600,5673,2766,4843,729,1921,1570,442,181,3095,2611,484,2611,1913,698,2021-01-01,zipcode
ZCTA5 36376,01,2276,43418,767,79300,1850,893,1691,296,790,466,72,67,1121,915,206,915,745,170,2021-01-01,zipcode
ZCTA5 36401,01,7398,36551,642,82000,5974,3401,5152,486,2459,1655,222,330,3969,2577,1392,2577,2002,575,2021-01-01,zipcode
ZCTA5 36420,01,10367,44819,629,135800,8408,3903,7401,1133,2436,2236,862,734,5126,4076,1050,4076,2971,1105,2021-01-01,zipcode
ZCTA5 36421,01,9720,53966,665,122300,7434,3454,6473,873,2076,2334,728,462,4938,3581,1357,3581,2606,975,2021-01-01,zipcode
ZCTA5 36425,01,843,35375,-666666666,60000,710,395,537,79,281,129,42,6,491,293,198,293,214,79,2021-01-01,zipcode
ZCTA5 36426,01,15351,43942,630,103900,12167,5371,10542,1659,4067,3107,1217,492,7053,5328,1725,5328,3668,1660,2021-01-01,zipcode
ZCTA5 36432,01,2073,40175,707,81700,1787,937,1678,334,771,348,160,65,1052,665,387,665,463,202,2021-01-01,zipcode
ZCTA5 36435,01,493,38843,-666666666,103700,449,252,437,112,138,164,6,17,286,167,119,167,140,27,2021-01-01,zipcode
ZCTA5 36436,01,619,59063,-666666666,116400,532,250,427,116,108,203,0,0,333,202,131,202,182,20,2021-01-01,zipcode
ZCTA5 36439,01,82,-666666666,-666666666,206300,65,40,51,8,11,20,9,3,70,34,36,34,21,13,2021-01-01,zipcode
ZCTA5 36441,01,3824,34547,572,107300,2836,1329,2588,364,1166,742,207,109,2057,1461,596,1461,1044,417,2021-01-01,zipcode
ZCTA5 36442,01,3631,41719,707,94100,2901,1412,2576,425,1103,873,104,71,1698,1231,467,1231,889,342,2021-01-01,zipcode
ZCTA5 36444,01,653,40000,-666666666,70000,573,382,563,185,260,93,14,11,458,252,206,252,200,52,2021-01-01,zipcode
ZCTA5 36445,01,5339,41953,680,99200,4442,2552,3888,883,1778,892,202,133,2329,1901,428,1901,1531,370,2021-01-01,zipcode
ZCTA5 36446,01,451,51000,-666666666,86800,334,157,284,34,134,86,30,0,214,136,78,136,99,37,2021-01-01,zipcode
ZCTA5 36451,01,4706,44872,705,102800,3786,2007,3338,513,1297,1115,301,112,2363,1800,563,1800,1361,439,2021-01-01,zipcode
ZCTA5 36453,01,2472,42609,621,81400,2172,1118,1839,276,751,571,152,89,1088,940,148,940,738,202,2021-01-01,zipcode
ZCTA5 36454,01,23,-666666666,-666666666,-666666666,23,3,23,0,23,0,0,0,57,22,35,22,22,0,2021-01-01,zipcode
ZCTA5 36455,01,261,31591,613,73000,228,130,213,31,131,38,5,8,190,116,74,116,71,45,2021-01-01,zipcode
ZCTA5 36456,01,1725,55417,450,60000,1322,737,1152,145,556,309,112,30,907,648,259,648,526,122,2021-01-01,zipcode
ZCTA5 36460,01,9960,29428,533,108600,7972,4143,6596,1128,2869,1546,696,357,4912,3735,1177,3735,2469,1266,2021-01-01,zipcode
ZCTA5 36467,01,9829,40734,638,94900,8013,3489,7131,1145,3069,2131,515,271,4824,3958,866,3958,2983,975,2021-01-01,zipcode
ZCTA5 36470,01,0,-666666666,-666666666,-666666666,0,0,0,0,0,0,0,0,0,0,0,0,0,0,2021-01-01,zipcode
ZCTA5 36471,01,716,26528,673,68000,624,450,554,16,376,97,18,47,563,310,253,310,156,154,2021-01-01,zipcode
ZCTA5 36473,01,323,50417,-666666666,121700,187,103,177,40,87,39,0,11,140,74,66,74,52,22,2021-01-01,zipcode
ZCTA5 36474,01,2682,43672,668,88100,2198,932,1762,243,936,409,94,80,1460,1051,409,1051,931,120,2021-01-01,zipcode
ZCTA5 36475,01,1662,35610,646,108700,1432,664,1302,128,631,263,205,75,912,623,289,623,560,63,2021-01-01,zipcode
ZCTA5 36476,01,26,-666666666,-666666666,-666666666,20,11,14,11,3,0,0,0,34,11,23,11,3,8,2021-01-01,zipcode
ZCTA5 36477,01,3647,42277,580,86600,3070,1443,2792,712,870,970,164,76,1923,1511,412,1511,1133,378,2021-01-01,zipcode
ZCTA5 36480,01,1669,43711,-666666666,134200,1449,809,1151,61,426,520,64,80,931,575,356,575,510,65,2021-01-01,zipcode
ZCTA5 36481,01,258,-666666666,-666666666,154500,221,155,192,64,83,31,0,14,138,69,69,69,57,12,2021-01-01,zipcode
ZCTA5 36482,01,995,-666666666,-666666666,86900,930,532,818,246,348,128,96,0,514,363,151,363,319,44,2021-01-01,zipcode
ZCTA5 36483,01,545,51350,-666666666,140600,492,276,466,39,256,92,63,16,277,211,66,211,179,32,2021-01-01,zipcode
ZCTA5 36502,01,16285,35205,623,120600,12948,6774,11196,1876,5552,2592,740,436,7513,6053,1460,6053,3871,2182,2021-01-01,zipcode
ZCTA5 36505,01,920,61563,803,138100,731,355,603,119,238,115,69,62,377,366,11,366,331,35,2021-01-01,zipcode
ZCTA5 36507,01,20910,44918,780,143500,16908,7571,13843,2451,4832,4581,1164,815,7976,7121,855,7121,5390,1731,2021-01-01,zipcode
ZCTA5 36509,01,1596,33173,774,73400,1384,668,1199,489,337,309,57,7,771,593,178,593,378,215,2021-01-01,zipcode
ZCTA5 36511,01,355,53795,-666666666,119200,355,92,355,150,95,26,84,0,534,271,263,271,271,0,2021-01-01,zipcode
ZCTA5 36512,01,13,-666666666,-666666666,-666666666,13,13,13,13,0,0,0,0,7,7,0,7,7,0,2021-01-01,zipcode
ZCTA5 36513,01,298,26340,-666666666,93600,248,156,248,0,152,96,0,0,126,104,22,104,104,0,2021-01-01,zipcode
ZCTA5 36518,01,2497,49279,607,150500,2160,1135,1908,421,630,642,106,109,1148,785,363,785,628,157,2021-01-01,zipcode
ZCTA5 36521,01,5165,58871,767,135100,4218,1843,3729,585,1917,846,231,150,2121,1949,172,1949,1763,186,2021-01-01,zipcode
ZCTA5 36522,01,7063,48421,661,119700,5195,2421,4554,622,1960,1542,284,146,2918,2454,464,2454,1726,728,2021-01-01,zipcode
ZCTA5 36523,01,2913,53021,1025,160400,2254,1238,1976,498,780,390,207,101,1092,932,160,932,675,257,2021-01-01,zipcode
ZCTA5 36524,01,1165,50764,450,108200,961,593,860,214,336,197,36,77,866,428,438,428,355,73,2021-01-01,zipcode
ZCTA5 36525,01,2335,55526,821,138100,1667,718,1534,219,613,478,181,43,806,744,62,744,574,170,2021-01-01,zipcode
ZCTA5 36526,01,34627,76810,1239,230400,25839,8996,22888,1029,5189,7829,5709,3132,13800,12682,1118,12682,9214,3468,2021-01-01,zipcode
ZCTA5 36527,01,17146,103882,1351,285000,12288,4066,10420,238,1680,3351,2828,2323,6579,5926,653,5926,4316,1610,2021-01-01,zipcode
ZCTA5 36528,01,1771,62560,1094,310900,1663,916,1539,64,259,637,370,209,2157,773,1384,773,736,37,2021-01-01,zipcode
ZCTA5 36529,01,256,-666666666,-666666666,-666666666,211,142,144,0,73,22,24,25,191,86,105,86,86,0,2021-01-01,zipcode
ZCTA5 36530,01,6411,50905,906,184700,5659,2416,4949,733,1575,1667,707,267,3821,2870,951,2870,2258,612,2021-01-01,zipcode
ZCTA5 36532,01,35688,79061,1264,328300,28413,12338,25457,1528,4391,6655,7832,5051,15921,13481,2440,13481,11442,2039,2021-01-01,zipcode
ZCTA5 36535,01,36605,56426,911,202500,31376,13257,28285,3140,9368,8965,4445,2367,17850,15286,2564,15286,11818,3468,2021-01-01,zipcode
ZCTA5 36538,01,363,31063,-666666666,44500,313,240,308,47,214,24,11,12,269,146,123,146,106,40,2021-01-01,zipcode
ZCTA5 36539,01,542,53523,-666666666,113000,434,261,295,30,147,82,16,20,317,203,114,203,196,7,2021-01-01,zipcode
ZCTA5 36540,01,863,25824,-666666666,-666666666,600,309,552,174,295,78,1,4,360,257,103,257,208,49,2021-01-01,zipcode
ZCTA5 36541,01,15048,66840,944,126400,11308,4742,10148,1353,4026,3735,599,435,6188,5214,974,5214,4557,657,2021-01-01,zipcode
ZCTA5 36542,01,16699,53327,1132,272800,14982,5819,13039,854,3290,4249,2785,1861,18322,7926,10396,7926,5094,2832,2021-01-01,zipcode
ZCTA5 36543,01,8,-666666666,-666666666,-666666666,8,0,8,0,0,8,0,0,5,5,0,5,5,0,2021-01-01,zipcode
ZCTA5 36544,01,12049,46828,741,114700,9591,4111,8306,2243,3354,1974,616,119,4884,4263,621,4263,3146,1117,2021-01-01,zipcode
ZCTA5 36545,01,9006,47997,660,120900,7446,3908,6309,1124,2562,1491,694,438,4369,3151,1218,3151,2275,876,2021-01-01,zipcode
ZCTA5 36548,01,1018,61250,-666666666,150000,671,316,604,58,213,214,48,71,459,319,140,319,306,13,2021-01-01,zipcode
ZCTA5 36549,01,5759,55714,1015,152600,5103,2873,4608,265,1714,1560,791,278,2901,2314,587,2314,1968,346,2021-01-01,zipcode
ZCTA5 36550,01,349,-666666666,-666666666,-666666666,306,146,256,36,139,72,0,9,194,143,51,143,101,42,2021-01-01,zipcode
ZCTA5 36551,01,12635,59395,973,175500,9652,3249,8542,564,2931,3071,1233,743,4523,3873,650,3873,3143,730,2021-01-01,zipcode
ZCTA5 36553,01,3361,44929,625,154100,2817,1496,1867,138,815,636,80,198,1459,1007,452,1007,958,49,2021-01-01,zipcode
ZCTA5 36555,01,1351,86591,1050,334600,1139,471,996,5,96,410,322,163,647,446,201,446,403,43,2021-01-01,zipcode
ZCTA5 36556,01,133,29677,-666666666,66100,133,108,106,13,25,68,0,0,316,54,262,54,54,0,2021-01-01,zipcode
ZCTA5 36558,01,3969,51895,523,112300,3143,1682,2762,532,1021,669,219,321,1945,1421,524,1421,1319,102,2021-01-01,zipcode
ZCTA5 36559,01,150,-666666666,-666666666,628000,150,136,134,0,0,67,13,54,184,69,115,69,69,0,2021-01-01,zipcode
ZCTA5 36560,01,2936,37972,679,74800,2507,1383,2144,542,872,463,228,39,1313,1075,238,1075,800,275,2021-01-01,zipcode
ZCTA5 36561,01,8801,85694,1199,376500,7795,3165,7031,229,1560,1949,2263,1030,15689,4029,11660,4029,2993,1036,2021-01-01,zipcode
ZCTA5 36562,01,1404,34096,-666666666,106800,1089,576,1023,236,538,148,82,19,647,532,115,532,437,95,2021-01-01,zipcode
ZCTA5 36564,01,0,-666666666,-666666666,-666666666,0,0,0,0,0,0,0,0,0,0,0,0,0,0,2021-01-01,zipcode
ZCTA5 36567,01,14005,57217,978,164300,11304,4984,9919,1592,3540,2856,1516,415,5564,5051,513,5051,3901,1150,2021-01-01,zipcode
ZCTA5 36568,01,99,-666666666,-666666666,-666666666,99,44,72,17,0,21,0,34,55,55,0,55,34,21,2021-01-01,zipcode
ZCTA5 36569,01,710,45208,-666666666,67500,679,494,679,49,386,203,24,17,340,231,109,231,225,6,2021-01-01,zipcode
ZCTA5 36571,01,16543,60998,918,163200,12878,5371,11666,1270,4810,3072,1737,777,7245,6421,824,6421,5001,1420,2021-01-01,zipcode
ZCTA5 36572,01,6725,88241,1118,161500,5407,2189,4894,502,1763,1267,873,489,2543,2395,148,2395,1958,437,2021-01-01,zipcode
ZCTA5 36574,01,1559,41589,976,137500,1324,852,1079,68,554,264,153,40,626,485,141,485,405,80,2021-01-01,zipcode
ZCTA5 36575,01,22027,63531,963,152700,17231,6887,14956,1270,6300,4279,2103,1004,8144,7610,534,7610,6227,1383,2021-01-01,zipcode
ZCTA5 36576,01,4285,60063,1016,191500,3513,1041,3089,264,947,1139,500,239,1981,1701,280,1701,1381,320,2021-01-01,zipcode
ZCTA5 36578,01,1215,85341,-666666666,217100,988,314,939,35,331,334,120,119,552,448,104,448,427,21,2021-01-01,zipcode
ZCTA5 36579,01,1252,59189,592,236100,1106,591,1018,129,475,161,253,0,955,430,525,430,389,41,2021-01-01,zipcode
ZCTA5 36580,01,5919,46845,1045,188000,4465,2052,4082,1129,995,1129,571,258,2506,2072,434,2072,1743,329,2021-01-01,zipcode
ZCTA5 36581,01,303,-666666666,-666666666,233300,283,170,283,17,206,60,0,0,165,132,33,132,132,0,2021-01-01,zipcode
ZCTA5 36582,01,24274,56658,794,144600,18895,8120,16624,2458,5827,5146,2114,1079,10254,9216,1038,9216,7029,2187,2021-01-01,zipcode
ZCTA5 36583,01,834,70667,-666666666,157300,700,342,639,23,266,302,33,15,340,304,36,304,293,11,2021-01-01,zipcode
ZCTA5 36584,01,449,-666666666,-666666666,76600,404,272,381,124,126,93,31,7,426,272,154,272,237,35,2021-01-01,zipcode
ZCTA5 36585,01,996,54792,853,63900,729,320,618,18,366,120,38,76,402,297,105,297,262,35,2021-01-01,zipcode
ZCTA5 36587,01,12279,55210,800,133900,9803,5092,7768,1658,3349,1952,509,300,4809,3942,867,3942,3145,797,2021-01-01,zipcode
ZCTA5 36602,01,861,23750,345,192700,853,500,787,96,181,249,161,100,743,588,155,588,120,468,2021-01-01,zipcode
ZCTA5 36603,01,8438,24754,684,89000,6730,4510,5862,1185,2295,1611,428,343,4007,2971,1036,2971,1036,1935,2021-01-01,zipcode
ZCTA5 36604,01,9158,49927,816,181300,7434,2704,6580,546,1606,1638,1610,1180,4992,3825,1167,3825,2146,1679,2021-01-01,zipcode
ZCTA5 36605,01,26830,38503,919,84300,20872,9486,17445,2615,7299,4983,1694,854,12098,9965,2133,9965,5125,4840,2021-01-01,zipcode
ZCTA5 36606,01,18697,44662,895,125100,14421,5009,12960,1494,4643,2950,2480,1393,9143,7943,1200,7943,3945,3998,2021-01-01,zipcode
ZCTA5 36607,01,6004,38520,846,114200,5237,2526,4639,678,1484,1098,961,418,3177,2545,632,2545,1220,1325,2021-01-01,zipcode
ZCTA5 36608,01,35268,53217,945,169200,28677,11225,23216,1833,5010,7010,5486,3877,17428,15134,2294,15134,7918,7216,2021-01-01,zipcode
ZCTA5 36609,01,23413,41851,912,163500,18864,6992,16192,1264,4354,5054,3385,2135,12809,11099,1710,11099,4733,6366,2021-01-01,zipcode
ZCTA5 36610,01,9948,25805,691,46900,7814,4561,6600,1346,2952,1755,395,152,5293,3671,1622,3671,1637,2034,2021-01-01,zipcode
ZCTA5 36611,01,6421,36196,834,78600,4617,1867,3761,482,1409,1378,350,142,2785,2316,469,2316,1095,1221,2021-01-01,zipcode
ZCTA5 36612,01,4208,30388,719,68200,3008,1691,2510,614,1072,545,119,160,1725,1414,311,1414,861,553,2021-01-01,zipcode
ZCTA5 36613,01,12659,43137,1022,126900,9721,4933,7893,1192,3256,2369,672,404,5094,4140,954,4140,2993,1147,2021-01-01,zipcode
ZCTA5 36615,01,0,-666666666,-666666666,-666666666,0,0,0,0,0,0,0,0,0,0,0,0,0,0,2021-01-01,zipcode
ZCTA5 36617,01,12409,38067,986,69700,10581,5915,9234,1333,3194,3019,1084,604,5834,5012,822,5012,2383,2629,2021-01-01,zipcode
ZCTA5 36618,01,18204,46800,1021,116700,14932,6019,11926,1182,3881,3941,1935,987,7281,6801,480,6801,4991,1810,2021-01-01,zipcode
ZCTA5 36619,01,15334,50146,945,140500,12158,5063,10846,1246,3683,3797,1461,659,6298,5606,692,5606,3865,1741,2021-01-01,zipcode
ZCTA5 36688,01,1275,5761,594,-666666666,1275,608,105,46,0,50,0,9,173,96,77,96,0,96,2021-01-01,zipcode
ZCTA5 36693,01,19528,64619,981,166200,15569,5871,13451,756,3613,4180,3389,1513,8779,7609,1170,7609,5314,2295,2021-01-01,zipcode
ZCTA5 36695,01,52433,72074,1113,198800,40692,14720,34732,2230,9732,11391,7433,3946,20955,19367,1588,19367,13025,6342,2021-01-01,zipcode
ZCTA5 36701,01,21247,40226,752,93100,16590,6846,14208,1493,5211,4439,1879,1186,10334,7746,2588,7746,4716,3030,2021-01-01,zipcode
ZCTA5 36703,01,12471,28513,637,72700,10237,5532,8574,1402,3421,2940,403,408,5919,4756,1163,4756,2676,2080,2021-01-01,zipcode
ZCTA5 36720,01,668,14750,-666666666,63700,540,393,420,125,210,54,22,9,316,237,79,237,196,41,2021-01-01,zipcode
ZCTA5 36722,01,118,-666666666,-666666666,56300,90,50,82,8,6,68,0,0,170,66,104,66,45,21,2021-01-01,zipcode
ZCTA5 36723,01,444,33319,-666666666,-666666666,297,167,149,50,30,69,0,0,240,123,117,123,113,10,2021-01-01,zipcode
ZCTA5 36726,01,4986,38687,802,84100,3874,2211,3505,687,1279,1089,324,126,2411,1734,677,1734,1259,475,2021-01-01,zipcode
ZCTA5 36727,01,108,28877,-666666666,9999,100,70,100,23,1,75,0,1,113,76,37,76,76,0,2021-01-01,zipcode
ZCTA5 36728,01,539,-666666666,-666666666,9999,301,179,261,81,94,73,7,6,248,137,111,137,113,24,2021-01-01,zipcode
ZCTA5 36732,01,7425,41603,606,159000,5803,2384,5107,379,1808,1614,843,463,3927,3178,749,3178,1937,1241,2021-01-01,zipcode
ZCTA5 36736,01,1725,38333,1000,73700,1084,579,916,97,405,161,106,147,549,424,125,424,374,50,2021-01-01,zipcode
ZCTA5 36738,01,1021,22685,673,62500,945,729,801,104,372,150,42,133,409,284,125,284,198,86,2021-01-01,zipcode
ZCTA5 36740,01,1083,-666666666,640,100900,967,633,736,129,367,102,99,39,686,361,325,361,239,122,2021-01-01,zipcode
ZCTA5 36742,01,2917,32150,631,64100,2686,1639,1822,347,404,703,182,186,1238,1029,209,1029,851,178,2021-01-01,zipcode
ZCTA5 36744,01,5681,29876,612,122900,4618,2326,3921,846,1593,810,454,218,3070,2194,876,2194,1468,726,2021-01-01,zipcode
ZCTA5 36748,01,2520,42470,694,85600,2122,1133,1856,246,760,627,93,130,1374,893,481,893,639,254,2021-01-01,zipcode
ZCTA5 36749,01,734,17455,-666666666,86500,646,395,553,189,254,110,0,0,407,297,110,297,180,117,2021-01-01,zipcode
ZCTA5 36750,01,2320,55729,1007,135100,1715,827,1592,227,845,379,68,73,1032,844,188,844,723,121,2021-01-01,zipcode
ZCTA5 36751,01,538,44500,-666666666,24700,430,243,319,86,165,29,25,14,248,136,112,136,119,17,2021-01-01,zipcode
ZCTA5 36752,01,1014,32321,-666666666,116700,832,408,800,26,265,378,86,45,673,498,175,498,464,34,2021-01-01,zipcode
ZCTA5 36753,01,27,-666666666,-666666666,-666666666,27,27,27,0,0,0,0,27,34,27,7,27,27,0,2021-01-01,zipcode
ZCTA5 36754,01,594,-666666666,-666666666,-666666666,472,234,411,276,112,9,0,14,146,136,10,136,110,26,2021-01-01,zipcode
ZCTA5 36756,01,5180,29543,604,81800,4192,2843,3149,860,1031,555,459,244,2069,1490,579,1490,1049,441,2021-01-01,zipcode
ZCTA5 36758,01,1367,66625,-666666666,82700,1015,484,925,209,346,240,101,29,543,453,90,453,396,57,2021-01-01,zipcode
ZCTA5 36759,01,2106,31111,657,65300,1576,716,1385,220,546,455,127,37,927,716,211,716,596,120,2021-01-01,zipcode
ZCTA5 36761,01,667,24653,743,31400,510,375,463,116,193,119,10,25,491,303,188,303,201,102,2021-01-01,zipcode
ZCTA5 36763,01,126,71250,-666666666,57100,120,40,109,14,57,29,4,5,69,38,31,38,35,3,2021-01-01,zipcode
ZCTA5 36765,01,1554,24338,1063,70600,1314,630,984,225,508,194,50,7,596,513,83,513,471,42,2021-01-01,zipcode
ZCTA5 36766,01,24,-666666666,-666666666,142500,24,15,24,7,0,0,12,5,30,16,14,16,11,5,2021-01-01,zipcode
ZCTA5 36767,01,1383,28201,318,69400,849,468,685,142,276,165,82,20,715,371,344,371,302,69,2021-01-01,zipcode
ZCTA5 36768,01,990,36435,840,64500,890,355,730,129,225,270,61,45,542,325,217,325,232,93,2021-01-01,zipcode
ZCTA5 36769,01,2037,34395,-666666666,65300,1692,1054,1428,239,720,345,106,18,1145,829,316,829,661,168,2021-01-01,zipcode
ZCTA5 36773,01,290,27788,623,-666666666,254,165,246,60,20,156,6,4,201,99,102,99,55,44,2021-01-01,zipcode
ZCTA5 36775,01,1319,55014,1113,87400,997,612,908,274,332,239,56,7,763,584,179,584,379,205,2021-01-01,zipcode
ZCTA5 36776,01,1986,-666666666,-666666666,43200,1495,719,1150,221,388,368,173,0,861,569,292,569,442,127,2021-01-01,zipcode
ZCTA5 36782,01,2140,39583,729,73900,1625,724,1355,133,442,661,98,21,1156,776,380,776,699,77,2021-01-01,zipcode
ZCTA5 36783,01,708,37875,618,61300,617,385,547,48,237,149,69,44,562,324,238,324,207,117,2021-01-01,zipcode
ZCTA5 36784,01,6019,44688,718,129900,4648,2161,3897,543,1810,1062,226,256,3032,2040,992,2040,1294,746,2021-01-01,zipcode
ZCTA5 36785,01,916,37292,843,100800,797,415,770,74,375,267,38,16,590,426,164,426,322,104,2021-01-01,zipcode
ZCTA5 36786,01,2396,22880,399,61400,1916,980,1804,247,909,364,182,102,1349,981,368,981,668,313,2021-01-01,zipcode
ZCTA5 36790,01,579,58309,-666666666,-666666666,497,198,395,83,119,193,0,0,276,238,38,238,178,60,2021-01-01,zipcode
ZCTA5 36792,01,1246,72762,-666666666,108400,996,484,996,136,433,380,4,43,753,469,284,469,395,74,2021-01-01,zipcode
ZCTA5 36793,01,680,77257,-666666666,165100,580,248,443,25,196,196,26,0,265,191,74,191,143,48,2021-01-01,zipcode
ZCTA5 36801,01,23566,50224,786,158300,19142,7854,16542,1819,4567,4921,2939,2296,10640,9454,1186,9454,6208,3246,2021-01-01,zipcode
ZCTA5 36804,01,19307,51699,655,121200,15544,7162,13297,1902,3611,4158,2144,1482,7826,6961,865,6961,5698,1263,2021-01-01,zipcode
ZCTA5 36830,01,48282,63012,926,283000,39646,15059,29463,1127,3627,7031,9229,8449,22519,19492,3027,19492,10485,9007,2021-01-01,zipcode
ZCTA5 36832,01,27384,32618,905,173800,22555,9498,13687,1221,2921,3445,3014,3086,13506,10248,3258,10248,4895,5353,2021-01-01,zipcode
ZCTA5 36849,01,4339,-666666666,-666666666,-666666666,4339,2989,28,0,0,19,9,0,0,0,0,0,0,0,2021-01-01,zipcode
ZCTA5 36850,01,2799,38290,387,62600,2357,1388,2044,497,730,636,135,46,1473,1117,356,1117,888,229,2021-01-01,zipcode
ZCTA5 36852,01,2862,60625,933,140300,1887,671,1605,134,542,825,83,21,961,761,200,761,542,219,2021-01-01,zipcode
ZCTA5 36853,01,8163,56727,760,193700,6930,3722,6322,995,1478,2181,1091,577,5827,3238,2589,3238,2582,656,2021-01-01,zipcode
ZCTA5 36854,01,16226,53528,891,115700,12916,5066,10761,1660,3546,3687,1311,557,7724,6201,1523,6201,4085,2116,2021-01-01,zipcode
ZCTA5 36855,01,1305,53442,876,134400,1121,461,1075,135,376,440,87,37,651,561,90,561,487,74,2021-01-01,zipcode
ZCTA5 36856,01,8606,61527,1619,200800,6062,2935,5512,674,858,2767,904,309,2897,2737,160,2737,2492,245,2021-01-01,zipcode
ZCTA5 36858,01,473,30759,-666666666,146500,365,207,365,50,153,73,39,50,241,224,17,224,213,11,2021-01-01,zipcode
ZCTA5 36860,01,1854,41910,586,63000,1703,892,1422,324,427,510,91,70,1026,775,251,775,560,215,2021-01-01,zipcode
ZCTA5 36861,01,2816,60000,668,161400,2503,1107,2297,451,663,648,294,241,2030,1218,812,1218,1143,75,2021-01-01,zipcode
ZCTA5 36862,01,5380,39077,601,122500,4473,2284,4102,797,1648,1141,396,120,2658,2115,543,2115,1516,599,2021-01-01,zipcode
ZCTA5 36863,01,12408,44543,670,105700,10233,4492,9011,1831,3192,2982,758,248,5826,4549,1277,4549,3140,1409,2021-01-01,zipcode
ZCTA5 36865,01,42,58542,-666666666,121900,42,8,24,0,7,12,5,0,19,13,6,13,7,6,2021-01-01,zipcode
ZCTA5 36866,01,4145,52123,638,86700,3407,1367,2997,739,1039,823,277,119,1948,1670,278,1670,1264,406,2021-01-01,zipcode
ZCTA5 36867,01,21298,42914,877,144400,17088,6818,14185,1752,3995,4977,1988,1473,10384,8852,1532,8852,4070,4782,2021-01-01,zipcode
ZCTA5 36869,01,22109,42004,808,112000,17390,7330,14943,2588,4621,5279,1591,864,10190,8732,1458,8732,5284,3448,2021-01-01,zipcode
ZCTA5 36870,01,19581,66082,998,158800,15561,5396,13344,1291,3527,5652,1512,1362,8021,7254,767,7254,5429,1825,2021-01-01,zipcode
ZCTA5 36871,01,1085,35083,830,95000,885,559,836,228,345,151,61,51,676,435,241,435,392,43,2021-01-01,zipcode
ZCTA5 36874,01,9488,59985,857,163100,7504,3175,6681,573,2172,2481,933,522,4180,3487,693,3487,3191,296,2021-01-01,zipcode
ZCTA5 36875,01,3732,56553,684,156400,3093,1365,2677,229,742,1388,158,160,1642,1445,197,1445,1134,311,2021-01-01,zipcode
ZCTA5 36877,01,12904,56117,927,151500,9757,3480,8111,794,2417,3321,769,810,4479,4020,459,4020,3090,930,2021-01-01,zipcode
ZCTA5 36879,01,2583,118929,666,268100,1958,653,1722,120,336,384,541,341,960,826,134,826,685,141,2021-01-01,zipcode
ZCTA5 36901,01,74,-666666666,-666666666,-666666666,74,65,74,18,9,47,0,0,57,34,23,34,34,0,2021-01-01,zipcode
ZCTA5 36904,01,3842,37898,633,100100,3088,1517,2686,352,1081,919,277,57,2141,1582,559,1582,1241,341,2021-01-01,zipcode
ZCTA5 36907,01,1800,35000,1026,58300,1500,959,1282,280,422,290,166,124,1104,794,310,794,678,116,2021-01-01,zipcode
ZCTA5 36908,01,1824,61875,713,76300,1504,750,1294,160,446,476,193,19,1068,682,386,682,594,88,2021-01-01,zipcode
ZCTA5 36910,01,14,-666666666,-666666666,-666666666,14,14,14,0,0,14,0,0,6,6,0,6,6,0,2021-01-01,zipcode
ZCTA5 36912,01,1814,50500,1074,71200,1585,833,1455,142,389,722,66,136,949,640,309,640,543,97,2021-01-01,zipcode
ZCTA5 36913,01,50,-666666666,-666666666,-666666666,50,50,50,38,0,12,0,0,23,23,0,23,23,0,2021-01-01,zipcode
ZCTA5 36915,01,741,30473,-666666666,57600,639,292,507,57,202,161,86,1,380,290,90,290,227,63,2021-01-01,zipcode
ZCTA5 36916,01,770,27006,326,72400,617,369,556,133,161,212,9,41,406,307,99,307,245,62,2021-01-01,zipcode
ZCTA5 36919,01,1730,36111,438,71000,1464,919,1325,354,607,264,62,38,926,700,226,700,584,116,2021-01-01,zipcode
ZCTA5 36921,01,969,24489,397,115000,911,622,821,348,328,125,20,0,721,641,80,641,566,75,2021-01-01,zipcode
ZCTA5 36922,01,724,41553,-666666666,73600,531,348,449,208,158,71,12,0,372,205,167,205,178,27,2021-01-01,zipcode
ZCTA5 36925,01,2863,31966,497,41100,2350,1060,2194,271,752,812,217,142,1681,1337,344,1337,802,535,2021-01-01,zipcode
ZCTA5 32003,12,29810,117414,1909,355200,25078,10331,21538,646,3779,6706,5905,4502,11996,11291,705,11291,9616,1675,2022-01-01,zipcode
ZCTA5 32008,12,6338,45118,822,142300,4899,2466,4399,679,2166,995,412,147,3375,2554,821,2554,2051,503,2022-01-01,zipcode
ZCTA5 32009,12,3582,74098,908,196300,3058,1121,2360,287,927,808,234,104,1458,1413,45,1413,1223,190,2022-01-01,zipcode
ZCTA5 32011,12,15006,70215,892,217800,12320,5390,10672,1601,4251,3534,773,513,6182,5681,501,5681,4723,958,2022-01-01,zipcode
ZCTA5 32024,12,20155,63013,954,179600,16219,6987,14330,1786,5396,4713,1697,738,8435,7747,688,7747,6679,1068,2022-01-01,zipcode
ZCTA5 32025,12,23193,51081,944,165100,18969,9581,15685,2218,5574,5376,1754,763,9088,8229,859,8229,4648,3581,2022-01-01,zipcode
ZCTA5 32026,12,2269,-666666666,-666666666,-666666666,2269,2269,2137,822,825,408,63,19,0,0,0,0,0,0,2022-01-01,zipcode
ZCTA5 32033,12,4704,81160,1610,271800,4404,1878,3904,270,1251,1658,415,310,2288,2027,261,2027,1813,214,2022-01-01,zipcode
ZCTA5 32034,12,40026,95869,1209,427700,34132,15711,31896,1146,6024,8886,9868,5972,21421,17262,4159,17262,14797,2465,2022-01-01,zipcode
ZCTA5 32038,12,10208,50098,825,157200,8430,3977,7677,1016,2675,2804,831,351,4872,3934,938,3934,3406,528,2022-01-01,zipcode
ZCTA5 32040,12,8235,66182,1015,173500,6414,2394,5484,715,2553,1686,385,145,3068,2841,227,2841,2442,399,2022-01-01,zipcode
ZCTA5 32043,12,31705,76405,1270,263200,24866,9946,21460,1724,6244,7359,4683,1450,12808,11697,1111,11697,9445,2252,2022-01-01,zipcode
ZCTA5 32044,12,2026,42693,1089,80900,1553,898,1341,309,458,498,73,3,823,749,74,749,464,285,2022-01-01,zipcode
ZCTA5 32046,12,11042,69153,808,213500,8542,3596,7569,933,3582,2197,643,214,4139,3717,422,3717,2785,932,2022-01-01,zipcode
ZCTA5 32052,12,8053,50284,694,106000,6832,4729,6243,1692,2858,1255,376,62,2880,2210,670,2210,1595,615,2022-01-01,zipcode
ZCTA5 32053,12,3706,37965,852,94600,2814,1444,2487,459,986,719,177,146,1880,1358,522,1358,1075,283,2022-01-01,zipcode
ZCTA5 32054,12,12598,65893,765,154800,10045,6035,8732,1837,3454,2469,597,375,4078,3662,416,3662,2660,1002,2022-01-01,zipcode
ZCTA5 32055,12,16175,50461,871,155400,12436,5759,10661,1693,4025,3222,1027,694,7374,6305,1069,6305,4061,2244,2022-01-01,zipcode
ZCTA5 32058,12,4607,57716,945,161400,3833,1670,3225,744,1412,912,104,53,1566,1397,169,1397,1091,306,2022-01-01,zipcode
ZCTA5 32059,12,2641,48362,842,90700,2332,1205,2049,471,625,756,122,75,1354,1068,286,1068,755,313,2022-01-01,zipcode
ZCTA5 32060,12,22505,52463,685,137600,18617,9330,16337,2901,6285,4071,1641,1439,9423,7820,1603,7820,6314,1506,2022-01-01,zipcode
ZCTA5 32061,12,59,-666666666,-666666666,-666666666,59,37,59,0,22,37,0,0,19,19,0,19,5,14,2022-01-01,zipcode
ZCTA5 32062,12,1783,41200,-666666666,186400,1379,771,1058,214,500,220,72,52,991,636,355,636,492,144,2022-01-01,zipcode
ZCTA5 32063,12,14289,68750,998,207000,11148,4554,9266,1258,3491,2589,1090,838,5208,4759,449,4759,3658,1101,2022-01-01,zipcode
ZCTA5 32064,12,7641,39931,834,156300,6107,2651,5301,490,2143,1881,529,258,3500,2835,665,2835,1382,1453,2022-01-01,zipcode
ZCTA5 32065,12,40035,91770,1556,259800,30459,10665,25896,2059,6467,10148,5247,1975,14389,13601,788,13601,10391,3210,2022-01-01,zipcode
ZCTA5 32066,12,6875,58845,855,119800,5939,3133,5006,1060,2471,1069,295,111,2445,2026,419,2026,1626,400,2022-01-01,zipcode
ZCTA5 32068,12,57372,81030,1303,233100,45639,15455,38979,2920,13458,14651,5850,2100,21501,20307,1194,20307,16032,4275,2022-01-01,zipcode
ZCTA5 32071,12,3219,43510,525,139300,2841,1711,2248,336,741,821,247,103,1565,1295,270,1295,1100,195,2022-01-01,zipcode
ZCTA5 32072,12,37,-666666666,-666666666,-666666666,37,15,37,0,0,22,9,6,22,22,0,22,22,0,2022-01-01,zipcode
ZCTA5 32073,12,42135,70975,1322,234300,34763,12268,30789,2632,7579,12676,5237,2665,16788,16087,701,16087,10121,5966,2022-01-01,zipcode
ZCTA5 32079,12,439,56250,1689,-666666666,439,421,439,106,79,57,92,105,195,180,15,180,0,180,2022-01-01,zipcode
ZCTA5 32080,12,21167,87285,1448,456200,19163,9324,17698,662,3061,5057,5746,3172,16526,10086,6440,10086,8203,1883,2022-01-01,zipcode
ZCTA5 32081,12,24368,129875,3501,518000,17877,7759,16503,392,1916,3168,6439,4588,9051,8250,801,8250,7122,1128,2022-01-01,zipcode
ZCTA5 32082,12,28697,121484,1739,676300,24351,10787,21892,527,2290,4339,9043,5693,14765,12160,2605,12160,10035,2125,2022-01-01,zipcode
ZCTA5 32083,12,2392,58438,950,119600,2034,1569,1939,445,693,639,87,75,674,541,133,541,354,187,2022-01-01,zipcode
ZCTA5 32084,12,36129,67727,1267,266800,31343,13227,27127,2362,8533,7642,5410,3180,17037,13780,3257,13780,9369,4411,2022-01-01,zipcode
ZCTA5 32086,12,33817,70571,1417,300600,29194,12296,26461,1834,6961,9556,4874,3236,15194,13441,1753,13441,10211,3230,2022-01-01,zipcode
ZCTA5 32087,12,5240,66056,783,206900,4272,2841,3872,802,1837,1080,85,68,1513,1303,210,1303,993,310,2022-01-01,zipcode
ZCTA5 32091,12,16729,51890,849,130700,13605,6424,11961,1730,4930,3724,988,589,6959,5714,1245,5714,3539,2175,2022-01-01,zipcode
ZCTA5 32092,12,45098,113589,1976,417800,35611,12590,30321,2077,6189,7421,9581,5053,16975,15283,1692,15283,13526,1757,2022-01-01,zipcode
ZCTA5 32094,12,3718,64559,866,118600,3049,1542,2742,373,1356,730,149,134,1274,1074,200,1074,834,240,2022-01-01,zipcode
ZCTA5 32095,12,16419,111084,1281,461900,12575,4247,11132,394,2329,2817,2867,2725,6177,5791,386,5791,5246,545,2022-01-01,zipcode
ZCTA5 32096,12,2875,46875,715,101300,2236,1270,2018,453,774,624,121,46,1363,1169,194,1169,971,198,2022-01-01,zipcode
ZCTA5 32097,12,21778,83933,1585,266400,17466,6102,15255,1565,5053,5269,2312,1056,8850,8210,640,8210,6466,1744,2022-01-01,zipcode
ZCTA5 32102,12,2224,52415,975,152700,1929,1103,1792,450,703,423,173,43,1736,1086,650,1086,947,139,2022-01-01,zipcode
ZCTA5 32110,12,9424,50528,1048,171800,7898,3842,6871,824,3336,1782,586,343,4050,3478,572,3478,2408,1070,2022-01-01,zipcode
ZCTA5 32112,12,8002,42459,787,121500,6545,3340,5417,1777,1878,1203,395,164,3771,2861,910,2861,2058,803,2022-01-01,zipcode
ZCTA5 32113,12,5386,41750,-666666666,134200,4479,2297,3838,472,1500,1353,281,232,2702,2238,464,2238,1843,395,2022-01-01,zipcode
ZCTA5 32114,12,35583,40726,1139,157800,30852,15098,22787,2773,7994,7464,3009,1547,17118,14562,2556,14562,4739,9823,2022-01-01,zipcode
ZCTA5 32117,12,29720,49848,1308,158200,24620,10383,21733,2230,7577,7528,3154,1244,14243,12440,1803,12440,6293,6147,2022-01-01,zipcode
ZCTA5 32118,12,18141,52765,1172,305800,16402,8436,15485,1168,4586,4983,2753,1995,16421,9885,6536,9885,6090,3795,2022-01-01,zipcode
ZCTA5 32119,12,22935,51484,1276,189900,19950,9273,17526,1643,5233,6220,2714,1716,12325,10750,1575,10750,6663,4087,2022-01-01,zipcode
ZCTA5 32124,12,7992,83354,1596,348400,7346,4702,6855,672,2314,1802,1251,816,3018,2726,292,2726,2375,351,2022-01-01,zipcode
ZCTA5 32127,12,27908,65230,1253,276200,24221,11441,22311,1428,6322,7887,4048,2626,15921,12874,3047,12874,9967,2907,2022-01-01,zipcode
ZCTA5 32128,12,21829,77589,1532,345400,18480,9160,16021,839,3264,5527,4298,2093,9928,9297,631,9297,7550,1747,2022-01-01,zipcode
ZCTA5 32129,12,23543,60390,1363,226500,20748,8424,17734,1431,5655,6527,2703,1418,11955,10688,1267,10688,7529,3159,2022-01-01,zipcode
ZCTA5 32130,12,5561,56579,1498,238400,4449,2057,3900,456,1574,1208,452,210,2038,1888,150,1888,1573,315,2022-01-01,zipcode
ZCTA5 32131,12,4381,60850,957,217600,3796,2020,3548,638,1310,995,419,186,2085,1732,353,1732,1360,372,2022-01-01,zipcode
ZCTA5 32132,12,8012,48925,1100,210700,7113,3400,6521,489,2293,2591,721,427,4094,3776,318,3776,3145,631,2022-01-01,zipcode
ZCTA5 32133,12,732,134187,-666666666,582400,732,189,576,0,44,21,212,299,361,305,56,305,305,0,2022-01-01,zipcode
ZCTA5 32134,12,7076,42788,664,108300,6366,3856,5718,886,2582,1722,371,157,5711,3202,2509,3202,2875,327,2022-01-01,zipcode
ZCTA5 32136,12,8349,65772,1362,392300,7623,4699,7172,249,2038,2416,1451,1018,5498,3900,1598,3900,3310,590,2022-01-01,zipcode
ZCTA5 32137,12,46970,73689,1679,324700,40707,21043,37036,2291,10372,11288,8485,4600,24087,19504,4583,19504,16701,2803,2022-01-01,zipcode
ZCTA5 32139,12,791,58385,-666666666,143400,712,558,685,54,379,112,98,42,428,284,144,284,267,17,2022-01-01,zipcode
ZCTA5 32140,12,1727,-666666666,1076,87000,1396,707,1097,148,441,452,50,6,815,623,192,623,511,112,2022-01-01,zipcode
ZCTA5 32141,12,18683,61456,1355,223900,16119,7392,14992,1000,5198,5865,2030,899,9402,8396,1006,8396,7618,778,2022-01-01,zipcode
ZCTA5 32145,12,5553,64868,1038,195400,4288,1665,3852,615,1398,1239,492,108,2433,2108,325,2108,1687,421,2022-01-01,zipcode
ZCTA5 32147,12,1427,29671,-666666666,91700,1121,285,976,63,623,132,158,0,686,686,0,686,610,76,2022-01-01,zipcode
ZCTA5 32148,12,10923,43891,753,83800,8749,5089,7680,1296,3750,1620,859,155,5318,4333,985,4333,3609,724,2022-01-01,zipcode
ZCTA5 32157,12,876,36042,953,122900,751,357,702,136,300,219,47,0,455,350,105,350,272,78,2022-01-01,zipcode
ZCTA5 32159,12,30111,55244,1285,251600,27886,19467,26735,1719,8078,9638,3839,3461,19340,16184,3156,16184,13242,2942,2022-01-01,zipcode
ZCTA5 32162,12,52752,71894,1682,330200,52481,46650,52428,1229,12965,16130,13104,9000,36989,30880,6109,30880,28894,1986,2022-01-01,zipcode
ZCTA5 32164,12,50721,70064,1589,275000,42235,19473,37960,3602,11929,13757,5895,2777,21640,19649,1991,19649,14327,5322,2022-01-01,zipcode
ZCTA5 32168,12,30074,68964,1541,283800,26490,12855,24176,1781,7428,7703,5178,2086,15924,13727,2197,13727,10356,3371,2022-01-01,zipcode
ZCTA5 32169,12,10383,86670,1589,444900,9710,5800,9447,225,1778,3128,2357,1959,12333,5813,6520,5813,4900,913,2022-01-01,zipcode
ZCTA5 32174,12,52140,65503,1185,288800,44420,22202,40476,3013,10375,14167,8763,4158,25735,23205,2530,23205,18583,4622,2022-01-01,zipcode
ZCTA5 32176,12,13882,63975,1391,328100,12654,6397,11641,582,2791,3881,2601,1786,10397,6880,3517,6880,5443,1437,2022-01-01,zipcode
ZCTA5 32177,12,26290,45455,840,150700,20498,10293,18132,2704,8104,5153,1419,752,11563,10440,1123,10440,6646,3794,2022-01-01,zipcode
ZCTA5 32179,12,8523,48108,953,147900,7440,3762,6626,1005,2463,2160,516,482,5166,3858,1308,3858,3195,663,2022-01-01,zipcode
ZCTA5 32180,12,5000,68236,882,212500,3643,1704,3067,850,939,977,151,150,1547,1369,178,1369,1039,330,2022-01-01,zipcode
ZCTA5 32181,12,3163,38851,776,93300,2379,1104,1853,388,850,479,86,50,1376,1148,228,1148,720,428,2022-01-01,zipcode
ZCTA5 32187,12,1221,40111,-666666666,119000,1146,669,983,124,439,291,100,29,695,695,0,695,614,81,2022-01-01,zipcode
ZCTA5 32189,12,5108,42212,735,112300,4535,2588,4178,959,1321,1354,468,76,3314,2394,920,2394,1504,890,2022-01-01,zipcode
ZCTA5 32190,12,1774,69186,-666666666,-666666666,1379,681,1116,78,499,316,109,114,642,528,114,528,486,42,2022-01-01,zipcode
ZCTA5 32193,12,1122,47237,937,256500,989,677,881,133,413,179,100,56,939,616,323,616,516,100,2022-01-01,zipcode
ZCTA5 32195,12,3183,85396,-666666666,184700,2869,1336,2518,448,985,811,200,74,1360,1169,191,1169,1108,61,2022-01-01,zipcode
ZCTA5 32202,12,6393,38042,935,230200,5997,4129,5279,1278,1543,1497,631,330,2763,2204,559,2204,239,1965,2022-01-01,zipcode
ZCTA5 32204,12,8270,61609,1174,346400,7363,2206,6586,648,1257,1698,1977,1006,5134,4359,775,4359,1120,3239,2022-01-01,zipcode
ZCTA5 32205,12,30913,57758,1097,243200,25464,8045,23006,2461,5749,6778,4921,3097,16277,14491,1786,14491,7848,6643,2022-01-01,zipcode
ZCTA5 32206,12,16210,35313,834,123600,12641,5016,11018,2079,3774,3155,1298,712,9266,7027,2239,7027,3206,3821,2022-01-01,zipcode
ZCTA5 32207,12,35392,59883,1082,229800,28491,9304,25241,3291,6041,6669,5628,3612,18592,15907,2685,15907,8145,7762,2022-01-01,zipcode
ZCTA5 32208,12,31368,39511,1125,124600,24967,11498,21891,3797,7665,7506,1791,1132,15415,13531,1884,13531,7480,6051,2022-01-01,zipcode
ZCTA5 32209,12,36062,28534,956,82100,27674,13608,23485,4685,9538,6873,1708,681,17834,14492,3342,14492,6775,7717,2022-01-01,zipcode
ZCTA5 32210,12,67110,55910,1142,185600,52154,16865,45102,5446,15535,14091,6912,3118,29003,26800,2203,26800,14180,12620,2022-01-01,zipcode
ZCTA5 32211,12,35863,54058,1090,185200,27385,9061,23684,2642,8523,8043,3278,1198,15038,13533,1505,13533,7306,6227,2022-01-01,zipcode
ZCTA5 32212,12,1872,45366,1845,-666666666,1528,114,464,9,87,240,42,86,222,222,0,222,2,220,2022-01-01,zipcode
ZCTA5 32216,12,41010,61536,1228,226600,33315,11866,29441,3247,8789,8034,6426,2945,19510,17684,1826,17684,8390,9294,2022-01-01,zipcode
ZCTA5 32217,12,20219,58975,1063,272600,16631,5631,14767,870,3577,4376,4053,1891,9487,8820,667,8820,4965,3855,2022-01-01,zipcode
ZCTA5 32218,12,68996,64298,1364,235500,52647,18480,45029,4431,13711,15467,7659,3761,26939,24313,2626,24313,15485,8828,2022-01-01,zipcode
ZCTA5 32219,12,14145,60100,1017,193700,10711,4435,9361,1076,3587,3111,1160,427,5365,4945,420,4945,4237,708,2022-01-01,zipcode
ZCTA5 32220,12,12078,77038,1167,189500,9798,3360,8866,781,3847,2806,810,622,4965,4590,375,4590,3913,677,2022-01-01,zipcode
ZCTA5 32221,12,30597,75865,1554,223700,24043,9126,20472,2222,7359,6533,2915,1443,11478,10732,746,10732,8248,2484,2022-01-01,zipcode
ZCTA5 32222,12,16869,81045,1635,277300,13717,3461,12313,948,3267,5333,1974,791,6807,6327,480,6327,4512,1815,2022-01-01,zipcode
ZCTA5 32223,12,25604,90833,1444,358400,21355,8540,19167,748,4167,6377,4773,3102,10673,10348,325,10348,8400,1948,2022-01-01,zipcode
ZCTA5 32224,12,41919,82055,1557,383200,35538,13040,25767,1001,4954,6482,8644,4686,16855,15579,1276,15579,8595,6984,2022-01-01,zipcode
ZCTA5 32225,12,54073,83324,1500,296100,43463,13681,37831,1373,8757,11773,10751,5177,23005,21391,1614,21391,14458,6933,2022-01-01,zipcode
ZCTA5 32226,12,18892,97625,2069,310600,14716,5709,13150,1153,3626,4163,2682,1526,7263,6618,645,6618,6027,591,2022-01-01,zipcode
ZCTA5 32227,12,3497,79375,1818,-666666666,2615,339,1198,26,317,621,131,103,654,561,93,561,0,561,2022-01-01,zipcode
ZCTA5 32228,12,224,-666666666,-666666666,-666666666,224,0,45,0,0,36,9,0,0,0,0,0,0,0,2022-01-01,zipcode
ZCTA5 32233,12,24041,79363,1462,384700,20086,6844,17188,1340,3942,4694,4827,2385,11141,9802,1339,9802,5769,4033,2022-01-01,zipcode
ZCTA5 32234,12,8692,78997,912,205000,6409,2202,5519,684,2535,1461,680,159,3265,3055,210,3055,2527,528,2022-01-01,zipcode
ZCTA5 32244,12,65499,59848,1321,201100,50189,15877,44088,3952,15222,15054,7568,2292,25827,24400,1427,24400,13581,10819,2022-01-01,zipcode
ZCTA5 32246,12,58684,74401,1552,265200,47253,13269,40209,2892,9317,12557,11346,4097,25424,23275,2149,23275,13069,10206,2022-01-01,zipcode
ZCTA5 32250,12,28619,104943,1753,474800,24577,7882,21658,1090,4034,4868,6754,4912,14572,12654,1918,12654,8547,4107,2022-01-01,zipcode
ZCTA5 32254,12,14338,35295,1016,76700,10875,4665,8971,2500,3683,2127,552,109,6204,5265,939,5265,2705,2560,2022-01-01,zipcode
ZCTA5 32256,12,51638,69895,1446,323300,43256,12671,36662,1230,6373,9434,12659,6966,26255,24284,1971,24284,9292,14992,2022-01-01,zipcode
ZCTA5 32257,12,42271,80644,1323,282300,34509,11252,30444,2318,7479,9259,7398,3990,18394,17305,1089,17305,10629,6676,2022-01-01,zipcode
ZCTA5 32258,12,41595,95926,1816,311700,32280,9822,27460,910,5489,8886,8318,3857,15897,15436,461,15436,9918,5518,2022-01-01,zipcode
ZCTA5 32259,12,66518,142263,2198,440400,49844,16427,42645,804,7738,11273,13936,8894,21918,20520,1398,20520,18014,2506,2022-01-01,zipcode
ZCTA5 32266,12,6743,109375,1459,559300,5866,1538,5205,156,674,1274,2077,1024,3473,3020,453,3020,2114,906,2022-01-01,zipcode
ZCTA5 32277,12,34880,53931,1194,233300,27739,9767,21856,2278,7381,6983,3635,1579,13962,12792,1170,12792,6137,6655,2022-01-01,zipcode
ZCTA5 32301,12,33803,47222,1137,189700,28219,9589,20447,1919,3864,5764,5251,3649,16893,14465,2428,14465,4191,10274,2022-01-01,zipcode
ZCTA5 32303,12,49824,58592,1190,192300,41617,11566,31051,1721,6611,8810,8105,5804,24304,21661,2643,21661,10779,10882,2022-01-01,zipcode
ZCTA5 32304,12,48568,27876,1070,139200,45650,17453,16390,1934,3694,5057,3194,2511,22793,18685,4108,18685,2545,16140,2022-01-01,zipcode
ZCTA5 32305,12,20265,49093,918,139100,15621,5759,12948,2341,4185,4002,1337,1083,8614,7513,1101,7513,4555,2958,2022-01-01,zipcode
ZCTA5 32308,12,23125,72383,1273,279800,19663,7211,17081,615,3113,3996,4903,4454,11875,11014,861,11014,5762,5252,2022-01-01,zipcode
ZCTA5 32309,12,33675,96879,1228,325400,26319,9394,22417,568,3050,5617,7700,5482,13607,13023,584,13023,10310,2713,2022-01-01,zipcode
ZCTA5 32310,12,14407,37675,949,105100,11598,4759,8398,1255,2970,2258,1249,666,7552,5793,1759,5793,2795,2998,2022-01-01,zipcode
ZCTA5 32311,12,20442,82392,1449,268400,16497,4359,14264,446,2418,3171,4321,3908,9727,8913,814,8913,5686,3227,2022-01-01,zipcode
ZCTA5 32312,12,32244,113131,1438,377800,25436,9104,21823,537,2044,5395,7607,6240,13140,12408,732,12408,10426,1982,2022-01-01,zipcode
ZCTA5 32317,12,14515,113973,1373,334400,11987,4698,10244,419,1607,2497,2969,2752,5602,5280,322,5280,4848,432,2022-01-01,zipcode
ZCTA5 32320,12,3707,60528,1404,225400,3168,1534,3017,663,867,800,394,293,2084,1652,432,1652,1210,442,2022-01-01,zipcode
ZCTA5 32321,12,5995,47963,887,117200,5098,3119,4363,917,1808,872,454,312,2309,1774,535,1774,1396,378,2022-01-01,zipcode
ZCTA5 32322,12,4253,45625,1113,202200,3618,2612,3355,925,1365,713,196,156,2081,1186,895,1186,972,214,2022-01-01,zipcode
ZCTA5 32323,12,104,-666666666,-666666666,-666666666,104,104,104,0,24,43,19,18,324,61,263,61,33,28,2022-01-01,zipcode
ZCTA5 32324,12,4981,41418,693,72300,4484,3161,4072,957,1825,960,186,144,2102,1647,455,1647,1164,483,2022-01-01,zipcode
ZCTA5 32327,12,30090,73829,1007,199000,24613,10028,21350,2298,7885,6958,2481,1728,11509,10507,1002,10507,8503,2004,2022-01-01,zipcode
ZCTA5 32328,12,3716,57500,852,253300,3096,1314,2771,309,761,925,382,394,3084,1578,1506,1578,1352,226,2022-01-01,zipcode
ZCTA5 32330,12,757,43648,800,138300,554,289,467,234,122,83,28,0,336,283,53,283,107,176,2022-01-01,zipcode
ZCTA5 32331,12,4830,51678,868,79800,3917,2330,3577,559,1685,1061,257,15,2221,1767,454,1767,1504,263,2022-01-01,zipcode
ZCTA5 32332,12,1097,27256,671,79000,963,556,817,265,309,117,89,37,594,487,107,487,196,291,2022-01-01,zipcode
ZCTA5 32333,12,11688,58169,904,200700,9749,4363,8967,1212,2287,2481,2129,858,5226,4677,549,4677,3843,834,2022-01-01,zipcode
ZCTA5 32334,12,1611,54828,868,109900,1338,580,1055,94,435,363,64,99,748,612,136,612,516,96,2022-01-01,zipcode
ZCTA5 32336,12,1370,34840,1012,73800,1096,707,924,130,393,261,73,67,756,521,235,521,408,113,2022-01-01,zipcode
ZCTA5 32340,12,10213,36795,825,105200,8666,5037,7835,1609,2826,2351,631,418,4560,3675,885,3675,2432,1243,2022-01-01,zipcode
ZCTA5 32343,12,3517,58393,1097,183400,2345,753,1858,231,523,704,227,173,1177,1103,74,1103,978,125,2022-01-01,zipcode
ZCTA5 32344,12,12335,49785,710,174500,10509,5066,9354,1440,3492,2503,1271,648,5812,4771,1041,4771,3547,1224,2022-01-01,zipcode
ZCTA5 32346,12,2326,56176,1489,225400,1965,1116,1863,342,641,517,238,125,1739,938,801,938,802,136,2022-01-01,zipcode
ZCTA5 32347,12,7052,62411,810,106900,5536,2361,4735,490,1715,1623,725,182,3352,2589,763,2589,1903,686,2022-01-01,zipcode
ZCTA5 32348,12,12827,46157,961,88100,10843,7207,9709,2099,4425,1999,733,453,5384,3973,1411,3973,3003,970,2022-01-01,zipcode
ZCTA5 32350,12,1563,47946,-666666666,80000,1339,769,1259,137,363,444,261,54,821,690,131,690,552,138,2022-01-01,zipcode
ZCTA5 32351,12,16563,38955,758,110800,12893,6838,10956,2366,4263,2577,992,758,6889,5537,1352,5537,3699,1838,2022-01-01,zipcode
ZCTA5 32352,12,5143,47070,1020,134300,3991,1802,3430,755,1421,863,205,186,2622,2151,471,2151,1741,410,2022-01-01,zipcode
ZCTA5 32355,12,291,47500,1022,210000,283,193,263,14,98,139,12,0,244,148,96,148,114,34,2022-01-01,zipcode
ZCTA5 32356,12,79,-666666666,-666666666,-666666666,79,77,79,0,75,0,4,0,75,75,0,75,75,0,2022-01-01,zipcode
ZCTA5 32358,12,1521,94583,1551,220700,1350,699,1269,166,392,318,315,78,1193,623,570,623,541,82,2022-01-01,zipcode
ZCTA5 32359,12,1007,45500,-666666666,84700,949,600,875,41,377,308,114,35,2018,538,1480,538,508,30,2022-01-01,zipcode
ZCTA5 32361,12,297,112969,911,110900,265,121,249,44,60,113,32,0,162,162,0,162,128,34,2022-01-01,zipcode
ZCTA5 32399,12,0,-666666666,-666666666,-666666666,0,0,0,0,0,0,0,0,0,0,0,0,0,0,2022-01-01,zipcode
ZCTA5 32401,12,18120,46603,1055,172200,15257,6486,13440,2081,4560,4193,1617,989,9945,8613,1332,8613,4880,3733,2022-01-01,zipcode
ZCTA5 32403,12,746,90104,1712,-666666666,606,83,201,0,18,97,62,24,225,133,92,133,0,133,2022-01-01,zipcode
ZCTA5 32404,12,40969,66230,1259,211100,32933,12861,28849,3796,9762,9877,3569,1845,17389,15041,2348,15041,10813,4228,2022-01-01,zipcode
ZCTA5 32405,12,29661,68070,1320,232400,23454,8604,20167,1623,5330,7543,3283,2388,13396,12043,1353,12043,7571,4472,2022-01-01,zipcode
ZCTA5 32407,12,14710,75093,1750,334000,12334,4012,10836,650,2205,4123,2356,1502,11893,6459,5434,6459,3789,2670,2022-01-01,zipcode
ZCTA5 32408,12,18594,64561,1295,318200,15850,5734,14864,690,3078,5391,3718,1987,17115,8949,8166,8949,6277,2672,2022-01-01,zipcode
ZCTA5 32409,12,10518,56276,1255,173800,8337,3823,7400,936,2511,2356,1061,536,4328,3835,493,3835,3421,414,2022-01-01,zipcode
ZCTA5 32410,12,412,60152,1434,308300,394,183,394,6,74,187,76,51,748,242,506,242,185,57,2022-01-01,zipcode
ZCTA5 32413,12,14820,75970,1460,348600,13460,5246,11993,778,2856,4261,2648,1450,15546,7164,8382,7164,5218,1946,2022-01-01,zipcode
ZCTA5 32420,12,2712,46703,632,115700,2239,986,2073,292,840,739,181,21,1566,1275,291,1275,1180,95,2022-01-01,zipcode
ZCTA5 32421,12,3929,41923,755,110800,3068,1595,2806,572,1045,928,217,44,1655,1310,345,1310,1074,236,2022-01-01,zipcode
ZCTA5 32423,12,872,53016,642,169700,820,518,760,23,340,243,146,8,637,475,162,475,454,21,2022-01-01,zipcode
ZCTA5 32424,12,7516,41400,582,123100,6459,4101,5582,1204,2449,1310,422,197,2818,2252,566,2252,1612,640,2022-01-01,zipcode
ZCTA5 32425,12,13970,41658,812,100900,11586,6484,10131,2010,4831,2470,554,266,6014,4978,1036,4978,3688,1290,2022-01-01,zipcode
ZCTA5 32426,12,826,37396,950,86000,719,512,631,248,247,109,20,7,357,269,88,269,253,16,2022-01-01,zipcode
ZCTA5 32427,12,1111,39500,874,95600,957,392,752,197,353,122,33,47,500,466,34,466,238,228,2022-01-01,zipcode
ZCTA5 32428,12,17801,48984,915,141000,14416,8077,12866,2052,5142,3877,1078,717,7283,6165,1118,6165,4860,1305,2022-01-01,zipcode
ZCTA5 32430,12,732,58860,-666666666,114900,581,176,557,79,259,157,6,56,321,313,8,313,266,47,2022-01-01,zipcode
ZCTA5 32431,12,4515,54821,759,113000,3768,1927,3390,394,1653,831,331,181,2245,1852,393,1852,1465,387,2022-01-01,zipcode
ZCTA5 32432,12,0,-666666666,-666666666,-666666666,0,0,0,0,0,0,0,0,0,0,0,0,0,0,2022-01-01,zipcode
ZCTA5 32433,12,18387,50424,983,111300,14337,6611,13070,2157,5470,3688,1185,570,7992,6833,1159,6833,5065,1768,2022-01-01,zipcode
ZCTA5 32435,12,6525,68208,823,168800,5282,2177,4611,425,1595,1395,791,405,3003,2595,408,2595,2097,498,2022-01-01,zipcode
ZCTA5 32437,12,620,47176,800,-666666666,531,174,502,48,223,215,16,0,344,311,33,311,239,72,2022-01-01,zipcode
ZCTA5 32438,12,4858,40526,818,119600,3874,1897,3096,668,1119,966,277,66,2158,1856,302,1856,1559,297,2022-01-01,zipcode
ZCTA5 32439,12,14572,71685,1454,311700,11284,4426,9953,505,2475,3972,2153,848,6523,5661,862,5661,4517,1144,2022-01-01,zipcode
ZCTA5 32440,12,8239,52979,766,95300,7174,4166,6049,1231,2436,1527,552,303,2601,2300,301,2300,1520,780,2022-01-01,zipcode
ZCTA5 32442,12,3795,46964,729,122600,3068,1526,2605,290,1210,791,181,133,1769,1442,327,1442,996,446,2022-01-01,zipcode
ZCTA5 32443,12,2850,46274,736,115200,2327,1273,1961,310,629,660,229,133,1222,1004,218,1004,831,173,2022-01-01,zipcode
ZCTA5 32444,12,21564,84893,1436,270100,16441,5283,13878,844,3327,5271,3148,1288,8934,8027,907,8027,5747,2280,2022-01-01,zipcode
ZCTA5 32445,12,2415,55032,724,99700,2122,1684,1964,600,748,509,63,44,538,457,81,457,275,182,2022-01-01,zipcode
ZCTA5 32446,12,10676,50185,827,138600,8926,4278,7730,682,2837,2681,761,769,4500,3824,676,3824,2752,1072,2022-01-01,zipcode
ZCTA5 32448,12,7561,31427,750,99200,5708,3401,4906,652,2082,1579,429,164,3752,3255,497,3255,2230,1025,2022-01-01,zipcode
ZCTA5 32449,12,1037,29297,-666666666,-666666666,708,359,661,181,261,119,88,12,545,351,194,351,266,85,2022-01-01,zipcode
ZCTA5 32455,12,4239,47547,679,99600,3520,1599,3154,534,1616,684,250,70,2109,1728,381,1728,1371,357,2022-01-01,zipcode
ZCTA5 32456,12,7775,67922,1293,289000,6633,3187,6129,340,1644,2036,1197,912,6248,3551,2697,3551,2788,763,2022-01-01,zipcode
ZCTA5 32459,12,20558,99081,1932,499900,17048,5857,15247,728,2986,4376,5023,2134,16626,8638,7988,8638,6846,1792,2022-01-01,zipcode
ZCTA5 32460,12,5488,48000,750,104700,4998,3562,4520,964,1552,1521,241,242,1980,1628,352,1628,1248,380,2022-01-01,zipcode
ZCTA5 32461,12,2589,154750,2392,844300,2239,1162,2211,65,292,613,869,372,5419,1152,4267,1152,971,181,2022-01-01,zipcode
ZCTA5 32462,12,3417,36827,747,122400,2976,1886,2657,565,1346,536,93,117,1648,1291,357,1291,1030,261,2022-01-01,zipcode
ZCTA5 32463,12,158,-666666666,743,-666666666,137,36,104,17,42,40,0,5,78,69,9,69,34,35,2022-01-01,zipcode
ZCTA5 32464,12,3461,54816,792,122400,2849,1229,2556,337,884,880,284,171,1856,1457,399,1457,1338,119,2022-01-01,zipcode
ZCTA5 32465,12,7846,44781,854,113500,6995,4645,6261,1386,2512,1730,441,192,3352,2426,926,2426,1908,518,2022-01-01,zipcode
ZCTA5 32466,12,6167,64424,1090,158300,4732,2095,4233,395,1666,1774,294,104,2490,2187,303,2187,1675,512,2022-01-01,zipcode
ZCTA5 32501,12,10908,35344,906,253500,8887,4474,7613,1227,2312,2107,1137,830,5580,4647,933,4647,2192,2455,2022-01-01,zipcode
ZCTA5 32502,12,3887,65713,1173,233900,3385,1108,2878,261,607,959,594,457,2403,1883,520,1883,979,904,2022-01-01,zipcode
ZCTA5 32503,12,33875,64857,1141,236800,28382,10035,21111,1240,4758,6745,4824,3544,14735,13196,1539,13196,8813,4383,2022-01-01,zipcode
ZCTA5 32504,12,21710,69017,1194,229300,17755,6955,15340,1137,2930,5326,3397,2550,10192,9590,602,9590,5824,3766,2022-01-01,zipcode
ZCTA5 32505,12,28055,39672,1035,100900,21196,9799,18360,3031,6803,6237,1325,964,12698,10858,1840,10858,5229,5629,2022-01-01,zipcode
ZCTA5 32506,12,36066,57302,1180,177400,29666,11399,25124,3019,7166,9073,4254,1612,16535,14547,1988,14547,8724,5823,2022-01-01,zipcode
ZCTA5 32507,12,32766,64269,1166,240600,26698,10360,22753,2104,5228,8407,4646,2368,18742,13620,5122,13620,8653,4967,2022-01-01,zipcode
ZCTA5 32508,12,5015,61094,1721,-666666666,4551,401,1364,10,230,435,523,166,601,533,68,533,0,533,2022-01-01,zipcode
ZCTA5 32509,12,428,-666666666,-666666666,-666666666,428,428,428,135,142,139,0,12,0,0,0,0,0,0,2022-01-01,zipcode
ZCTA5 32511,12,1145,-666666666,-666666666,-666666666,1145,65,142,0,12,69,61,0,0,0,0,0,0,0,2022-01-01,zipcode
ZCTA5 32514,12,43940,64431,1271,203300,35786,13095,28922,2098,7588,9563,5379,4294,19149,17638,1511,17638,8548,9090,2022-01-01,zipcode
ZCTA5 32526,12,41522,69533,1298,202100,33447,13618,29763,2025,8788,11882,4870,2198,17351,16120,1231,16120,12592,3528,2022-01-01,zipcode
ZCTA5 32530,12,38,-666666666,-666666666,-666666666,21,0,21,0,0,21,0,0,8,8,0,8,8,0,2022-01-01,zipcode
ZCTA5 32531,12,7235,79258,874,266900,5563,2373,5217,252,1953,1695,814,503,3343,2983,360,2983,2531,452,2022-01-01,zipcode
ZCTA5 32533,12,29975,83099,998,237300,23682,9388,20947,1791,5942,7571,3921,1722,11600,10796,804,10796,9196,1600,2022-01-01,zipcode
ZCTA5 32534,12,15448,56517,1213,164900,12802,4570,11302,767,3453,4675,1639,768,7522,6928,594,6928,4130,2798,2022-01-01,zipcode
ZCTA5 32535,12,5510,39828,814,88000,4794,3048,4088,847,1937,1034,179,91,2067,1667,400,1667,1105,562,2022-01-01,zipcode
ZCTA5 32536,12,25210,77864,1285,251000,19376,6707,15477,1276,4155,5854,2368,1824,9348,8786,562,8786,6102,2684,2022-01-01,zipcode
ZCTA5 32539,12,31392,68183,1210,241300,24572,10042,21083,1795,5940,8755,3161,1432,12011,11076,935,11076,8597,2479,2022-01-01,zipcode
ZCTA5 32541,12,18784,89826,1830,476400,15668,5112,14446,775,2405,4462,4616,2188,16246,8442,7804,8442,5560,2882,2022-01-01,zipcode
ZCTA5 32542,12,3841,66100,1839,-666666666,2868,340,1475,69,212,674,365,155,1082,911,171,911,0,911,2022-01-01,zipcode
ZCTA5 32544,12,2315,39068,1781,-666666666,1576,267,929,0,161,350,384,34,627,533,94,533,0,533,2022-01-01,zipcode
ZCTA5 32547,12,34124,61407,1279,272100,27998,9321,24471,2608,6287,9270,4456,1850,16188,14883,1305,14883,8429,6454,2022-01-01,zipcode
ZCTA5 32548,12,23575,61037,1225,270500,19311,6346,16990,1262,4795,5767,3270,1896,14148,10239,3909,10239,5984,4255,2022-01-01,zipcode
ZCTA5 32550,12,8722,80000,2108,557700,8049,3911,7298,100,1219,1954,2531,1494,14345,4236,10109,4236,3077,1159,2022-01-01,zipcode
ZCTA5 32561,12,9495,118074,1609,526300,7848,3358,7193,140,785,1847,2407,2014,6526,4111,2415,4111,3272,839,2022-01-01,zipcode
ZCTA5 32563,12,28511,94175,1600,340400,23556,9089,20419,792,4321,7168,5380,2758,12361,11030,1331,11030,9010,2020,2022-01-01,zipcode
ZCTA5 32564,12,2350,65750,885,119300,2075,1032,1725,202,539,759,136,89,962,900,62,900,741,159,2022-01-01,zipcode
ZCTA5 32565,12,5515,77553,1032,182000,4296,1728,3728,405,1400,1192,595,136,2492,2082,410,2082,1645,437,2022-01-01,zipcode
ZCTA5 32566,12,42878,98065,1695,327700,33492,12606,29229,1385,6414,12065,5649,3716,17575,15663,1912,15663,12416,3247,2022-01-01,zipcode
ZCTA5 32567,12,4837,71205,-666666666,212600,3507,1619,2915,360,936,1230,241,148,2032,1705,327,1705,1470,235,2022-01-01,zipcode
ZCTA5 32568,12,3610,65296,1041,201800,2966,1225,2597,247,944,980,224,202,1491,1347,144,1347,1171,176,2022-01-01,zipcode
ZCTA5 32569,12,12936,70426,1371,272800,11116,3368,9449,543,2381,2714,2713,1098,5517,5106,411,5106,3546,1560,2022-01-01,zipcode
ZCTA5 32570,12,34755,70335,1201,220100,28966,11571,24869,1942,8492,8897,4018,1520,15505,13957,1548,13957,9225,4732,2022-01-01,zipcode
ZCTA5 32571,12,39756,84287,1133,246800,30468,12625,26363,1924,7260,8826,5444,2909,14748,13914,834,13914,11707,2207,2022-01-01,zipcode
ZCTA5 32577,12,4313,68269,903,190400,3479,1223,3009,177,1029,895,787,121,1901,1724,177,1724,1529,195,2022-01-01,zipcode
ZCTA5 32578,12,34022,101422,1682,386300,26994,10198,23689,730,5118,7598,5060,5183,14477,13065,1412,13065,9957,3108,2022-01-01,zipcode
ZCTA5 32579,12,10596,92344,1449,389100,8932,3568,7823,417,1520,2123,1893,1870,5084,4483,601,4483,3197,1286,2022-01-01,zipcode
ZCTA5 32580,12,4038,79643,1213,328300,3113,982,2723,85,476,1159,708,295,1914,1630,284,1630,1005,625,2022-01-01,zipcode
ZCTA5 32583,12,30534,82416,1265,219100,26233,12629,23344,3269,7809,7440,3035,1791,10698,9979,719,9979,8245,1734,2022-01-01,zipcode
ZCTA5 32601,12,22544,29059,1031,231800,20585,9129,8947,275,1514,2119,2574,2465,10364,9015,1349,9015,2175,6840,2022-01-01,zipcode
ZCTA5 32603,12,6855,12894,1138,284100,6675,3968,1095,59,59,187,268,522,2689,2043,646,2043,168,1875,2022-01-01,zipcode
ZCTA5 32605,12,26313,80939,1382,247600,21990,7658,18964,783,2023,4732,6216,5210,11467,10758,709,10758,8068,2690,2022-01-01,zipcode
ZCTA5 32606,12,23317,77733,1576,294900,19360,7285,16278,317,2682,3691,4278,5310,11456,10266,1190,10266,4850,5416,2022-01-01,zipcode
ZCTA5 32607,12,30306,48656,1178,276400,26211,8529,16756,842,3053,4023,4354,4484,15998,13077,2921,13077,4589,8488,2022-01-01,zipcode
ZCTA5 32608,12,53301,57249,1285,321200,46069,16154,32067,1662,4378,7386,8784,9857,25653,22032,3621,22032,8920,13112,2022-01-01,zipcode
ZCTA5 32609,12,18983,45301,1046,155000,15740,6334,13586,1876,3645,4256,2463,1346,8326,7486,840,7486,4083,3403,2022-01-01,zipcode
ZCTA5 32612,12,8795,-666666666,-666666666,-666666666,8795,6975,16,0,4,9,3,0,0,0,0,0,0,0,2022-01-01,zipcode
ZCTA5 32615,12,15295,71984,1100,274300,11967,4527,10711,574,2915,2910,2703,1609,6720,5993,727,5993,4549,1444,2022-01-01,zipcode
ZCTA5 32616,12,123,-666666666,-666666666,-666666666,100,52,100,48,51,0,1,0,71,71,0,71,0,71,2022-01-01,zipcode
ZCTA5 32617,12,4525,45931,818,185400,4025,2368,3620,290,1674,924,611,121,1763,1473,290,1473,1239,234,2022-01-01,zipcode
ZCTA5 32618,12,8111,57674,950,175800,6694,2549,6086,583,2006,2058,666,773,3700,3441,259,3441,2832,609,2022-01-01,zipcode
ZCTA5 32619,12,5004,56019,615,146300,4320,1841,3572,545,1475,1128,311,113,2141,2023,118,2023,1712,311,2022-01-01,zipcode
ZCTA5 32621,12,5332,49980,721,124100,4430,2137,3936,592,1641,1201,417,85,2341,2238,103,2238,1819,419,2022-01-01,zipcode
ZCTA5 32622,12,1712,66563,678,214900,1343,494,1197,175,378,361,165,118,636,624,12,624,372,252,2022-01-01,zipcode
ZCTA5 32625,12,1628,66938,872,241900,1422,743,1224,88,351,345,209,231,1300,725,575,725,579,146,2022-01-01,zipcode
ZCTA5 32626,12,8552,45311,828,142300,6844,3656,6115,731,2805,1816,554,209,4321,3528,793,3528,2608,920,2022-01-01,zipcode
ZCTA5 32628,12,5235,39835,814,91200,4354,2815,3811,779,1810,863,310,49,1984,1602,382,1602,1263,339,2022-01-01,zipcode
ZCTA5 32631,12,370,38836,-666666666,163400,312,145,312,0,95,81,136,0,188,172,16,172,172,0,2022-01-01,zipcode
ZCTA5 32639,12,261,39727,-666666666,-666666666,178,119,178,0,115,0,32,31,179,119,60,119,119,0,2022-01-01,zipcode
ZCTA5 32640,12,10360,54162,1012,151700,8522,4404,7876,1298,2796,2637,671,474,5103,4148,955,4148,3493,655,2022-01-01,zipcode
ZCTA5 32641,12,16898,37083,955,121800,12461,5874,10693,1695,3861,3392,1186,559,6247,5406,841,5406,3158,2248,2022-01-01,zipcode
ZCTA5 32643,12,11590,67923,1237,218000,8752,3808,7737,750,2239,2957,1175,616,4564,4122,442,4122,3460,662,2022-01-01,zipcode
ZCTA5 32648,12,316,61346,-666666666,187500,229,110,174,67,60,47,0,0,540,100,440,100,100,0,2022-01-01,zipcode
ZCTA5 32653,12,15524,86508,1081,251900,12214,5019,11042,267,1899,3080,2623,3173,6755,6344,411,6344,5198,1146,2022-01-01,zipcode
ZCTA5 32656,12,14702,63707,973,180100,11604,4892,9983,1154,3224,3651,1107,847,6419,5350,1069,5350,4351,999,2022-01-01,zipcode
ZCTA5 32658,12,354,78796,-666666666,77400,349,141,224,0,87,129,8,0,63,60,3,60,52,8,2022-01-01,zipcode
ZCTA5 32664,12,285,57279,-666666666,266700,218,141,218,0,63,68,64,23,168,137,31,137,102,35,2022-01-01,zipcode
ZCTA5 32666,12,6313,63395,629,175300,5529,2569,5111,263,1907,1677,550,714,3689,2681,1008,2681,2349,332,2022-01-01,zipcode
ZCTA5 32667,12,4334,72179,1023,256800,3882,1774,3313,161,657,1122,551,822,2171,1816,355,1816,1370,446,2022-01-01,zipcode
ZCTA5 32668,12,5115,51843,629,188200,4378,2162,3977,577,1698,1159,319,224,2409,2175,234,2175,1846,329,2022-01-01,zipcode
ZCTA5 32669,12,16100,97639,1341,283800,12346,4162,10429,301,2084,3576,2148,2320,6371,5857,514,5857,5162,695,2022-01-01,zipcode
ZCTA5 32680,12,10622,45182,796,92800,9046,5112,8062,1497,3966,2098,250,251,5796,4199,1597,4199,3491,708,2022-01-01,zipcode
ZCTA5 32681,12,288,51061,-666666666,-666666666,288,187,288,72,194,22,0,0,131,83,48,83,72,11,2022-01-01,zipcode
ZCTA5 32683,12,310,60984,-666666666,-666666666,203,117,155,27,97,24,7,0,136,111,25,111,59,52,2022-01-01,zipcode
ZCTA5 32686,12,5273,55641,762,309800,4523,2008,3791,374,1032,1647,357,381,2666,2238,428,2238,1459,779,2022-01-01,zipcode
ZCTA5 32692,12,88,-666666666,-666666666,168800,88,88,88,24,43,0,21,0,634,63,571,63,63,0,2022-01-01,zipcode
ZCTA5 32693,12,11426,58095,882,160800,9651,4759,8282,1124,3041,2840,798,479,4851,4221,630,4221,3502,719,2022-01-01,zipcode
ZCTA5 32694,12,1992,50854,672,115200,1716,657,1539,230,696,307,191,115,1334,1064,270,1064,704,360,2022-01-01,zipcode
ZCTA5 32696,12,13915,54688,792,186900,11150,5266,9916,1259,3765,2924,1522,446,5956,5485,471,5485,4351,1134,2022-01-01,zipcode
ZCTA5 32697,12,185,82083,990,93600,125,45,93,19,21,38,10,5,122,71,51,71,25,46,2022-01-01,zipcode
ZCTA5 32701,12,24551,61404,1415,253200,20776,6524,18635,1315,3517,7308,4762,1733,12149,11206,943,11206,5560,5646,2022-01-01,zipcode
ZCTA5 32702,12,2490,47179,3501,79400,2199,1428,1986,237,856,489,213,191,1551,1235,316,1235,686,549,2022-01-01,zipcode
ZCTA5 32703,12,57046,63693,1410,276900,45036,16014,39484,5376,11717,11284,8092,3015,21589,20148,1441,20148,13418,6730,2022-01-01,zipcode
ZCTA5 32707,12,38868,64381,1426,276800,31815,10324,28299,2389,6844,9192,6727,3147,16912,16207,705,16207,10914,5293,2022-01-01,zipcode
ZCTA5 32708,12,47437,84952,1596,318200,40092,12485,34643,1405,5597,11064,10964,5613,20252,19430,822,19430,14220,5210,2022-01-01,zipcode
ZCTA5 32709,12,1545,92550,-666666666,332300,1351,411,1197,158,285,369,313,72,686,633,53,633,524,109,2022-01-01,zipcode
ZCTA5 32712,12,49738,97718,1841,361100,39894,13686,34562,3449,8567,10238,7810,4498,17267,15927,1340,15927,13172,2755,2022-01-01,zipcode
ZCTA5 32713,12,22430,83468,1461,281700,18856,7539,16446,871,5010,6038,3341,1186,9482,8894,588,8894,7539,1355,2022-01-01,zipcode
ZCTA5 32714,12,38306,62581,1528,265600,31174,8565,27270,2320,5802,9308,7060,2780,17010,15747,1263,15747,7575,8172,2022-01-01,zipcode
ZCTA5 32720,12,33876,67102,1107,262400,28501,12521,23890,2885,7815,7421,3459,2310,13858,12592,1266,12592,8542,4050,2022-01-01,zipcode
ZCTA5 32724,12,42326,69060,1194,260000,34872,16402,29426,2273,8648,9383,5722,3400,18000,16443,1557,16443,12021,4422,2022-01-01,zipcode
ZCTA5 32725,12,50825,67131,1448,230400,40758,17138,35947,3581,11950,12993,5158,2265,19163,18290,873,18290,14465,3825,2022-01-01,zipcode
ZCTA5 32726,12,23661,57583,909,210500,18957,7350,16473,1995,6301,4987,2227,963,10802,9506,1296,9506,6542,2964,2022-01-01,zipcode
ZCTA5 32730,12,6410,45169,1330,256700,5308,1569,4876,313,1375,1884,983,321,3149,2883,266,2883,1136,1747,2022-01-01,zipcode
ZCTA5 32732,12,5104,109625,-666666666,457300,4241,1350,3686,81,1016,1021,881,687,1998,1774,224,1774,1695,79,2022-01-01,zipcode
ZCTA5 32735,12,5190,69316,1396,231000,4386,2212,3967,298,1619,1215,598,237,2569,2213,356,2213,1813,400,2022-01-01,zipcode
ZCTA5 32736,12,11925,84043,1160,337300,9904,3344,8605,769,2594,3157,1558,527,4585,4186,399,4186,3796,390,2022-01-01,zipcode
ZCTA5 32738,12,47917,72044,1393,227000,37887,13503,32666,2789,12268,12168,4072,1369,16659,15887,772,15887,13052,2835,2022-01-01,zipcode
ZCTA5 32744,12,3544,91556,1110,290600,2790,1188,2581,351,762,821,420,227,1361,1224,137,1224,1073,151,2022-01-01,zipcode
ZCTA5 32746,12,45331,103941,1780,378100,38003,12684,33262,1155,5289,9471,10770,6577,19909,18575,1334,18575,12026,6549,2022-01-01,zipcode
ZCTA5 32750,12,25176,81799,1563,318100,20515,6691,18787,1194,4557,6097,4615,2324,10295,9610,685,9610,7255,2355,2022-01-01,zipcode
ZCTA5 32751,12,22815,88599,1629,402700,19165,5636,16731,600,2447,4533,5463,3688,10652,9792,860,9792,6067,3725,2022-01-01,zipcode
ZCTA5 32754,12,11399,64855,1016,231900,9892,5418,8891,941,3083,3051,1320,496,5643,4432,1211,4432,4092,340,2022-01-01,zipcode
ZCTA5 32757,12,31758,70044,1386,313800,26043,12095,23569,1697,6694,7105,4669,3404,14481,12777,1704,12777,9561,3216,2022-01-01,zipcode
ZCTA5 32759,12,2683,59250,1040,254000,2281,1277,2145,233,888,621,242,161,1415,1031,384,1031,868,163,2022-01-01,zipcode
ZCTA5 32763,12,24852,61447,1366,207500,20915,8499,18220,1789,5776,6758,2604,1293,11452,10443,1009,10443,6484,3959,2022-01-01,zipcode
ZCTA5 32764,12,2642,80675,-666666666,307300,2298,1086,2032,227,805,523,408,69,1266,1053,213,1053,971,82,2022-01-01,zipcode
ZCTA5 32765,12,63210,98584,1832,384900,50975,16839,40341,1385,6391,11172,14011,7382,23170,21886,1284,21886,15860,6026,2022-01-01,zipcode
ZCTA5 32766,12,16425,134831,1972,473100,12559,4012,10616,493,2079,2851,2724,2469,5064,5059,5,5059,4478,581,2022-01-01,zipcode
ZCTA5 32767,12,3040,64539,1059,114000,2562,1176,2326,418,1011,847,50,0,1317,1061,256,1061,914,147,2022-01-01,zipcode
ZCTA5 32771,12,59134,70388,1441,308100,47610,16336,40422,3975,10577,12191,8488,5191,23221,21732,1489,21732,13286,8446,2022-01-01,zipcode
ZCTA5 32773,12,32342,61004,1407,228300,25625,8615,22701,2262,8097,6871,3877,1594,13134,12310,824,12310,7118,5192,2022-01-01,zipcode
ZCTA5 32776,12,11681,96136,898,359700,9608,2930,8879,600,1937,4306,1177,859,4874,4324,550,4324,3850,474,2022-01-01,zipcode
ZCTA5 32778,12,24317,57071,1203,209600,20815,11502,19059,2389,5379,6610,3234,1447,12637,10820,1817,10820,8353,2467,2022-01-01,zipcode
ZCTA5 32779,12,29111,107727,1787,418200,23984,9051,21405,664,3337,5936,6832,4636,11612,11108,504,11108,8922,2186,2022-01-01,zipcode
ZCTA5 32780,12,38552,58940,1163,223300,32778,15366,28737,2434,8018,10706,5026,2553,20114,16185,3929,16185,11602,4583,2022-01-01,zipcode
ZCTA5 32784,12,10545,67931,855,207900,8903,3778,7768,906,3104,2761,509,488,5285,4284,1001,4284,3476,808,2022-01-01,zipcode
ZCTA5 32789,12,26741,101113,1623,625700,23056,9515,19340,523,2692,3830,6679,5616,12718,11413,1305,11413,7454,3959,2022-01-01,zipcode
ZCTA5 32792,12,52120,63365,1470,318300,43783,14506,35619,2829,7487,10578,8735,5990,23870,21924,1946,21924,10268,11656,2022-01-01,zipcode
ZCTA5 32796,12,20757,59880,1111,210000,17401,8523,15707,1502,5648,4773,2425,1359,9812,8447,1365,8447,6957,1490,2022-01-01,zipcode
ZCTA5 32798,12,2437,53782,985,150900,2311,1341,2277,113,839,1087,187,51,1523,1274,249,1274,1208,66,2022-01-01,zipcode
ZCTA5 32801,12,14778,75646,1629,394500,13791,4094,12500,700,2210,1800,4662,3128,11336,9246,2090,9246,2638,6608,2022-01-01,zipcode
ZCTA5 32803,12,22067,92557,1719,379700,19620,4816,18322,640,2890,4266,6644,3882,11532,10563,969,10563,5530,5033,2022-01-01,zipcode
ZCTA5 32804,12,20542,108662,1586,484200,17828,4942,15857,499,2590,3134,5602,4032,9998,8855,1143,8855,5838,3017,2022-01-01,zipcode
ZCTA5 32805,12,17791,38885,969,220000,15109,5858,13798,2846,5271,3203,1675,803,9350,6846,2504,6846,3262,3584,2022-01-01,zipcode
ZCTA5 32806,12,26927,89102,1412,394100,22777,6054,20730,1071,3507,4940,6596,4616,12498,11430,1068,11430,7326,4104,2022-01-01,zipcode
ZCTA5 32807,12,35479,57039,1376,221800,29212,8510,25173,4121,7642,7754,3756,1900,13710,12760,950,12760,6231,6529,2022-01-01,zipcode
ZCTA5 32808,12,62827,43726,1311,193300,46410,15590,38710,8941,13866,11245,3283,1375,21248,19816,1432,19816,8256,11560,2022-01-01,zipcode
ZCTA5 32809,12,29207,50220,1216,243300,23458,8982,20602,4266,7439,4568,2919,1410,10775,9352,1423,9352,5149,4203,2022-01-01,zipcode
ZCTA5 32810,12,37755,60104,1460,240700,29806,8772,26205,3558,6844,8264,5465,2074,14733,13560,1173,13560,6936,6624,2022-01-01,zipcode
ZCTA5 32811,12,40191,46772,1371,164300,31802,9912,26612,3492,8569,7524,5048,1979,18310,13958,4352,13958,4286,9672,2022-01-01,zipcode
ZCTA5 32812,12,35822,66774,1390,315900,29169,9587,25552,2348,6318,7805,6501,2580,15192,13958,1234,13958,8118,5840,2022-01-01,zipcode
ZCTA5 32814,12,9500,123635,2168,723600,7780,1864,6894,18,374,884,2499,3119,4456,4156,300,4156,1480,2676,2022-01-01,zipcode
ZCTA5 32817,12,36808,76402,1610,292300,31803,12124,22265,1705,5643,7091,4814,3012,13551,11611,1940,11611,6785,4826,2022-01-01,zipcode
ZCTA5 32818,12,62566,54178,1367,250600,47524,14095,40098,7893,11865,12303,5623,2414,18760,17803,957,17803,9956,7847,2022-01-01,zipcode
ZCTA5 32819,12,27826,86306,1777,421300,23726,8929,20772,1528,3728,5326,6534,3656,14590,10445,4145,10445,6171,4274,2022-01-01,zipcode
ZCTA5 32820,12,10927,105912,1647,365200,8544,2305,7024,564,1698,1674,1685,1403,3433,3190,243,3190,2582,608,2022-01-01,zipcode
ZCTA5 32821,12,20034,57098,1686,274600,17025,4623,14128,588,2837,4510,4807,1386,15208,8654,6554,8654,2932,5722,2022-01-01,zipcode
ZCTA5 32822,12,68321,51555,1507,205300,56540,19780,48437,5919,15800,14327,8662,3729,26887,23943,2944,23943,10044,13899,2022-01-01,zipcode
ZCTA5 32824,12,56484,75125,1716,313600,44330,12788,38859,4251,11209,11752,7775,3872,19619,15895,3724,15895,11935,3960,2022-01-01,zipcode
ZCTA5 32825,12,63056,78321,1652,298100,52063,15511,42562,3973,9599,14795,9387,4808,21992,20263,1729,20263,13380,6883,2022-01-01,zipcode
ZCTA5 32826,12,28428,59358,1399,221700,25667,11151,15015,1359,4052,4515,2931,2158,10259,9314,945,9314,4524,4790,2022-01-01,zipcode
ZCTA5 32827,12,17918,111725,2091,516500,13612,4774,11364,202,2095,2752,3241,3074,7161,5827,1334,5827,3889,1938,2022-01-01,zipcode
ZCTA5 32828,12,69778,95943,1766,370700,55598,16811,45378,2682,8667,11152,15289,7588,25204,23957,1247,23957,15036,8921,2022-01-01,zipcode
ZCTA5 32829,12,19353,90174,1821,316800,15324,4901,13181,1266,2582,4169,3539,1625,7448,6317,1131,6317,4576,1741,2022-01-01,zipcode
ZCTA5 32830,12,49,118839,-666666666,110400,48,8,48,0,5,19,21,3,35,25,10,25,25,0,2022-01-01,zipcode
ZCTA5 32831,12,2414,-666666666,-666666666,-666666666,2414,2390,2162,1005,870,228,46,13,45,24,21,24,14,10,2022-01-01,zipcode
ZCTA5 32832,12,31143,110885,2097,398900,23676,6070,21141,864,2174,5820,7509,4774,12352,10788,1564,10788,7469,3319,2022-01-01,zipcode
ZCTA5 32833,12,10995,88200,1344,348500,8721,3448,7675,822,2157,2089,1842,765,3798,3516,282,3516,2747,769,2022-01-01,zipcode
ZCTA5 32835,12,49890,66970,1662,304000,40350,11853,33709,2844,7467,10368,8489,4541,19076,17642,1434,17642,7746,9896,2022-01-01,zipcode
ZCTA5 32836,12,23708,112822,1897,602400,19062,6186,16666,563,2364,3846,5988,3905,10122,8436,1686,8436,5178,3258,2022-01-01,zipcode
ZCTA5 32837,12,48762,81926,1782,334300,40654,13230,35035,3182,7747,10369,8686,5051,20927,15780,5147,15780,9534,6246,2022-01-01,zipcode
ZCTA5 32839,12,49304,51516,1323,214300,40691,14002,33482,5691,11160,9733,4645,2253,24118,17422,6696,17422,4602,12820,2022-01-01,zipcode
ZCTA5 32901,12,27574,47115,1209,222900,24380,12518,19437,1910,5151,6740,3588,2048,13064,11148,1916,11148,5484,5664,2022-01-01,zipcode
ZCTA5 32903,12,14604,96438,1618,454900,12084,5165,10985,352,1838,3148,2994,2653,7417,6090,1327,6090,5118,972,2022-01-01,zipcode
ZCTA5 32904,12,36556,85618,1619,306400,29844,11619,25352,1662,5768,8146,6223,3553,14910,13516,1394,13516,10816,2700,2022-01-01,zipcode
ZCTA5 32905,12,24971,54145,1249,180700,20764,9426,18691,1638,6001,6067,3619,1366,12707,10492,2215,10492,6053,4439,2022-01-01,zipcode
ZCTA5 32907,12,47823,67002,1481,230300,39472,17137,34644,3738,10883,13035,4480,2508,17547,16352,1195,16352,14155,2197,2022-01-01,zipcode
ZCTA5 32908,12,14172,63043,1681,228200,11084,3676,9456,1184,2953,3486,1146,687,4846,4608,238,4608,4159,449,2022-01-01,zipcode
ZCTA5 32909,12,36725,71783,1383,239100,28710,10685,24464,2140,7355,9133,3565,2271,13488,12321,1167,12321,10154,2167,2022-01-01,zipcode
ZCTA5 32920,12,9961,68642,1050,322500,9403,4019,9010,478,2323,2926,2136,1147,8833,5765,3068,5765,3547,2218,2022-01-01,zipcode
ZCTA5 32922,12,15198,44898,975,147000,12065,4353,10826,1493,3458,3704,1530,641,8402,6574,1828,6574,3418,3156,2022-01-01,zipcode
ZCTA5 32925,12,1606,76667,1809,-666666666,1200,444,828,52,94,283,245,154,517,516,1,516,0,516,2022-01-01,zipcode
ZCTA5 32926,12,22379,63391,1201,230600,19976,8911,18402,2413,5981,6059,2707,1242,10785,9436,1349,9436,7497,1939,2022-01-01,zipcode
ZCTA5 32927,12,27570,76843,1229,233100,23371,9276,20914,1938,6275,8079,3098,1524,11681,10267,1414,10267,9143,1124,2022-01-01,zipcode
ZCTA5 32931,12,13762,83195,1437,436200,12865,6492,12048,354,1916,3521,3391,2866,10932,7422,3510,7422,5568,1854,2022-01-01,zipcode
ZCTA5 32934,12,18030,99758,1716,362200,15751,7812,14055,803,3027,4403,3425,2397,7801,7438,363,7438,6634,804,2022-01-01,zipcode
ZCTA5 32935,12,41342,61069,1309,221700,34671,12208,30676,2161,8801,11303,5517,2894,19964,17764,2200,17764,10572,7192,2022-01-01,zipcode
ZCTA5 32937,12,27611,90344,1611,391600,22739,9848,19999,314,2981,6295,5616,4793,13332,11335,1997,11335,9100,2235,2022-01-01,zipcode
ZCTA5 32940,12,47030,100792,1796,395000,38394,17568,34806,1318,5776,10026,9342,8344,20748,19248,1500,19248,16262,2986,2022-01-01,zipcode
ZCTA5 32948,12,6032,48657,864,153400,4508,1586,3927,1103,1468,904,416,36,1956,1600,356,1600,1186,414,2022-01-01,zipcode
ZCTA5 32949,12,2609,108050,-666666666,437700,2409,1322,2262,188,785,589,417,283,1155,987,168,987,952,35,2022-01-01,zipcode
ZCTA5 32950,12,4666,105938,1830,410200,4120,1697,3657,110,1029,1358,709,451,1945,1885,60,1885,1744,141,2022-01-01,zipcode
ZCTA5 32951,12,11516,80411,1493,453900,10415,6297,9974,377,1530,2946,3123,1998,7643,5751,1892,5751,4913,838,2022-01-01,zipcode
ZCTA5 32952,12,20666,87148,1221,376300,17361,7936,15458,620,3268,4700,4066,2804,10050,8287,1763,8287,7085,1202,2022-01-01,zipcode
ZCTA5 32953,12,24924,80537,1165,356100,20897,9107,18496,905,4683,6174,4211,2523,11537,9655,1882,9655,7200,2455,2022-01-01,zipcode
ZCTA5 32955,12,39745,82969,1452,305800,33544,12663,29549,1841,7270,9469,6403,4566,18652,15799,2853,15799,12233,3566,2022-01-01,zipcode
ZCTA5 32958,12,28729,64698,1249,254500,25706,13662,24177,1692,7255,7804,4303,3123,15077,12749,2328,12749,10651,2098,2022-01-01,zipcode
ZCTA5 32960,12,23961,49634,1103,233200,20507,8623,18158,2083,5134,6538,2962,1441,11925,9756,2169,9756,5819,3937,2022-01-01,zipcode
ZCTA5 32962,12,26904,60649,1116,207600,22749,10713,19653,2370,5645,7293,3267,1078,12642,9734,2908,9734,8084,1650,2022-01-01,zipcode
ZCTA5 32963,12,15117,143438,1765,818500,14381,9760,14018,133,1669,2613,4942,4661,12379,7672,4707,7672,7289,383,2022-01-01,zipcode
ZCTA5 32966,12,19419,65923,1328,251100,17295,10411,16323,719,4482,5993,3293,1836,11441,9192,2249,9192,7059,2133,2022-01-01,zipcode
ZCTA5 32967,12,25116,66438,1212,350100,20766,11352,18140,2179,4962,5235,3387,2377,11904,9497,2407,9497,7449,2048,2022-01-01,zipcode
ZCTA5 32968,12,15456,90058,1597,343300,13331,5704,11290,489,2908,3906,2415,1572,6425,5483,942,5483,5153,330,2022-01-01,zipcode
ZCTA5 32970,12,252,53929,-666666666,-666666666,252,63,252,17,92,38,105,0,52,52,0,52,14,38,2022-01-01,zipcode
ZCTA5 32976,12,9310,46760,1298,144300,8897,6084,8592,489,3216,3299,1181,407,6948,5089,1859,5089,4804,285,2022-01-01,zipcode
ZCTA5 33001,12,340,59545,1932,622300,332,221,332,16,168,68,74,6,718,172,546,172,111,61,2022-01-01,zipcode
ZCTA5 33004,12,16449,45836,1558,278100,13932,5045,12665,1167,3727,3561,3033,1177,9109,7391,1718,7391,3205,4186,2022-01-01,zipcode
ZCTA5 33009,12,43893,44949,1448,237100,37204,14571,33773,4157,9561,8262,6920,4873,31149,20753,10396,20753,11252,9501,2022-01-01,zipcode
ZCTA5 33010,12,42081,41053,1240,324400,36482,15293,32549,10583,10860,4830,4451,1825,16273,15709,564,15709,4799,10910,2022-01-01,zipcode
ZCTA5 33012,12,71088,41921,1470,313600,60985,25295,54154,15438,18374,10928,6511,2903,25795,25048,747,25048,12205,12843,2022-01-01,zipcode
ZCTA5 33013,12,29830,54842,1457,362700,26303,10227,22408,6012,8105,4483,2627,1181,9668,9356,312,9356,5673,3683,2022-01-01,zipcode
ZCTA5 33014,12,40739,69586,1574,371000,33674,10473,29734,5048,7906,8663,4902,3215,15027,14420,607,14420,6554,7866,2022-01-01,zipcode
ZCTA5 33015,12,68517,69169,1720,358400,55961,16682,47266,6422,13122,13998,9429,4295,23919,23157,762,23157,12221,10936,2022-01-01,zipcode
ZCTA5 33016,12,45620,53180,1652,273100,37833,13769,32697,5951,10414,7801,5825,2706,16055,15621,434,15621,7760,7861,2022-01-01,zipcode
ZCTA5 33018,12,55241,83468,1850,379200,45794,13829,39620,6434,11899,10492,7467,3328,17452,16961,491,16961,12555,4406,2022-01-01,zipcode
ZCTA5 33019,12,13503,90748,1752,607400,12074,5166,10852,460,1268,2861,3096,3167,12455,6331,6124,6331,4783,1548,2022-01-01,zipcode
ZCTA5 33020,12,44914,50339,1358,278100,38057,10368,33096,4244,9480,9406,6117,3849,22888,20012,2876,20012,6455,13557,2022-01-01,zipcode
ZCTA5 33021,12,50300,66515,1618,365400,40721,13750,35269,3393,8491,10375,7699,5311,21594,19302,2292,19302,12560,6742,2022-01-01,zipcode
ZCTA5 33023,12,71749,66834,1531,315100,56680,17491,48835,7793,16156,15984,5904,2998,22499,21052,1447,21052,13761,7291,2022-01-01,zipcode
ZCTA5 33024,12,73405,72394,1600,338200,57941,18246,49904,5418,14458,17206,9005,3817,26232,24650,1582,24650,15948,8702,2022-01-01,zipcode
ZCTA5 33025,12,72684,66156,1786,311300,58887,16952,51795,3804,20686,13721,8370,5214,29658,27473,2185,27473,12856,14617,2022-01-01,zipcode
ZCTA5 33026,12,30868,84007,1829,361500,25356,9191,22930,1627,5673,6885,5530,3215,12513,12108,405,12108,9760,2348,2022-01-01,zipcode
ZCTA5 33027,12,63474,67015,1705,371200,54480,23098,48165,3277,15001,11475,11322,7090,25953,24914,1039,24914,19624,5290,2022-01-01,zipcode
ZCTA5 33028,12,27583,109393,2291,486000,21923,5957,18481,888,3676,4327,5554,4036,9082,8792,290,8792,6760,2032,2022-01-01,zipcode
ZCTA5 33029,12,44876,139461,2405,500100,35412,10530,29314,1206,7305,7810,8035,4958,13867,13443,424,13443,12181,1262,2022-01-01,zipcode
ZCTA5 33030,12,36405,37740,1237,342900,25472,9880,21482,8468,6274,4023,1909,808,11164,10582,582,10582,4036,6546,2022-01-01,zipcode
ZCTA5 33031,12,7692,107448,1471,441700,6395,2962,5325,500,2039,1707,642,437,2437,2419,18,2419,2177,242,2022-01-01,zipcode
ZCTA5 33032,12,57327,70706,1520,340000,43044,12757,36454,6719,10596,10702,6277,2160,17806,17014,792,17014,10075,6939,2022-01-01,zipcode
ZCTA5 33033,12,68121,61800,1571,332300,49850,16830,40891,8813,11375,11017,6547,3139,20659,19948,711,19948,11177,8771,2022-01-01,zipcode
ZCTA5 33034,12,23774,43015,1273,195700,16265,8364,13355,4768,3737,3539,905,406,6453,5930,523,5930,1825,4105,2022-01-01,zipcode
ZCTA5 33035,12,16788,68881,1781,248900,12755,4313,11144,1468,2582,3741,2547,806,5991,5474,517,5474,2850,2624,2022-01-01,zipcode
ZCTA5 33036,12,3620,91932,2033,916900,3099,1470,2945,104,769,911,678,483,3480,1681,1799,1681,1344,337,2022-01-01,zipcode
ZCTA5 33037,12,13265,73724,1848,632000,11769,5307,10798,873,2993,2681,2485,1766,10406,5613,4793,5613,4415,1198,2022-01-01,zipcode
ZCTA5 33039,12,0,-666666666,-666666666,-666666666,0,0,0,0,0,0,0,0,0,0,0,0,0,0,2022-01-01,zipcode
ZCTA5 33040,12,36379,80069,2044,766700,31059,9256,27815,2203,8013,7425,6207,3967,18919,14911,4008,14911,7112,7799,2022-01-01,zipcode
ZCTA5 33042,12,6990,104325,2193,703100,6190,2636,5664,211,1371,1672,1444,966,4748,3023,1725,3023,2386,637,2022-01-01,zipcode
ZCTA5 33043,12,4547,75455,2013,460000,3790,1606,3517,275,984,1277,644,337,2852,1918,934,1918,1588,330,2022-01-01,zipcode
ZCTA5 33050,12,10520,74487,1498,668700,8943,2974,8043,935,2446,2121,1573,968,7199,4256,2943,4256,2316,1940,2022-01-01,zipcode
ZCTA5 33051,12,650,103096,1797,828800,641,375,635,24,126,182,215,88,1191,367,824,367,268,99,2022-01-01,zipcode
ZCTA5 33054,12,31590,38952,1244,267300,25435,11159,21319,5297,8531,5398,1541,552,10788,10281,507,10281,4939,5342,2022-01-01,zipcode
ZCTA5 33055,12,37977,54869,1546,307100,31769,13782,27766,6882,10127,6309,3302,1146,12218,11898,320,11898,8916,2982,2022-01-01,zipcode
ZCTA5 33056,12,37274,58160,1560,288000,29817,11852,25485,4045,9795,7182,2785,1678,12053,11593,460,11593,7522,4071,2022-01-01,zipcode
ZCTA5 33060,12,37522,55733,1337,324500,30255,10730,26522,4876,7806,7564,4160,2116,15887,14079,1808,14079,7061,7018,2022-01-01,zipcode
ZCTA5 33062,12,24805,78267,1754,465000,23072,10767,21684,1195,4676,5743,5913,4157,22196,13541,8655,13541,9267,4274,2022-01-01,zipcode
ZCTA5 33063,12,55143,58340,1642,246900,47455,16603,43441,4282,13765,13154,8677,3563,27649,25161,2488,25161,18566,6595,2022-01-01,zipcode
ZCTA5 33064,12,60009,62808,1607,274000,49716,14870,44226,8284,12981,10683,8302,3976,26017,22837,3180,22837,14284,8553,2022-01-01,zipcode
ZCTA5 33065,12,60600,65145,1740,373400,46316,14071,38739,3011,11384,12485,7834,4025,21282,20071,1211,20071,9417,10654,2022-01-01,zipcode
ZCTA5 33066,12,16316,53460,1632,184000,14375,6804,13481,953,3923,3987,2656,1962,10487,8420,2067,8420,7090,1330,2022-01-01,zipcode
ZCTA5 33067,12,24696,118825,1896,588200,19326,6268,16712,642,2635,4222,5339,3874,8794,8227,567,8227,6279,1948,2022-01-01,zipcode
ZCTA5 33068,12,52792,60649,1806,248500,42396,11487,35011,5606,11965,10428,4587,2425,19770,18532,1238,18532,11374,7158,2022-01-01,zipcode
ZCTA5 33069,12,29228,57614,1589,231100,24031,10522,21326,2891,5697,5847,4280,2611,15945,11719,4226,11719,5447,6272,2022-01-01,zipcode
ZCTA5 33070,12,5717,73885,1746,674400,5041,1968,4482,347,1282,1412,795,646,4517,2443,2074,2443,1847,596,2022-01-01,zipcode
ZCTA5 33071,12,39677,98722,1899,470800,31187,8796,26288,1143,5296,8800,7244,3805,13999,13301,698,13301,8662,4639,2022-01-01,zipcode
ZCTA5 33073,12,33691,94775,2017,410100,26632,7775,22681,1640,5634,6897,5934,2576,12496,11669,827,11669,6551,5118,2022-01-01,zipcode
ZCTA5 33076,12,43660,164389,3032,676100,32094,10509,26899,596,4970,5151,7807,8375,13764,13069,695,13069,11187,1882,2022-01-01,zipcode
ZCTA5 33101,12,0,-666666666,-666666666,-666666666,0,0,0,0,0,0,0,0,0,0,0,0,0,0,2022-01-01,zipcode
ZCTA5 33109,12,792,250001,-666666666,2000001,695,385,695,0,97,90,170,338,726,328,398,328,307,21,2022-01-01,zipcode
ZCTA5 33122,12,1873,84329,2370,1335900,1508,410,1219,180,79,232,392,336,1013,816,197,816,76,740,2022-01-01,zipcode
ZCTA5 33125,12,54873,37370,1238,339300,47376,19084,42169,13333,13062,7499,5470,2805,22255,21227,1028,21227,5080,16147,2022-01-01,zipcode
ZCTA5 33126,12,46798,51733,1546,287100,40671,14351,36005,8166,9603,8570,7057,2609,19530,18073,1457,18073,7104,10969,2022-01-01,zipcode
ZCTA5 33127,12,28306,39690,1283,346000,22224,9553,18787,5948,6071,4196,1737,835,11396,9661,1735,9661,2819,6842,2022-01-01,zipcode
ZCTA5 33128,12,8989,33697,1191,292400,7655,2635,7014,2577,2095,1075,959,308,4298,3907,391,3907,123,3784,2022-01-01,zipcode
ZCTA5 33129,12,15184,93343,2153,526800,13452,3935,12113,447,1760,1860,4814,3232,8352,7267,1085,7267,3393,3874,2022-01-01,zipcode
ZCTA5 33130,12,32946,55285,1553,436000,29545,8479,26504,5177,5977,4766,6105,4479,19910,16915,2995,16915,2120,14795,2022-01-01,zipcode
ZCTA5 33131,12,22540,121730,2649,599100,20059,3075,18473,285,1244,2547,7467,6930,18627,12552,6075,12552,4132,8420,2022-01-01,zipcode
ZCTA5 33132,12,17136,101518,2373,535900,15989,3878,14513,979,1536,3198,4510,4290,11690,8969,2721,8969,2226,6743,2022-01-01,zipcode
ZCTA5 33133,12,34500,87924,1824,825100,27780,8352,25858,1572,4473,4372,8389,7052,16982,14479,2503,14479,7487,6992,2022-01-01,zipcode
ZCTA5 33134,12,37958,82925,1719,637300,32162,11982,28861,2658,5269,5501,8020,7413,18350,16251,2099,16251,8937,7314,2022-01-01,zipcode
ZCTA5 33135,12,34742,35185,1221,367100,30258,11521,27057,8334,7921,5427,3817,1558,15635,14513,1122,14513,3050,11463,2022-01-01,zipcode
ZCTA5 33136,12,16854,35129,1177,290500,14489,5549,13095,3663,3531,2969,1943,989,7772,6894,878,6894,834,6060,2022-01-01,zipcode
ZCTA5 33137,12,25283,71348,2142,462200,21315,5616,19347,2148,3461,3887,5472,4379,14313,11498,2815,11498,3020,8478,2022-01-01,zipcode
ZCTA5 33138,12,28609,58990,1390,604300,23625,7708,21047,2834,3932,4627,5269,4385,14223,12701,1522,12701,6193,6508,2022-01-01,zipcode
ZCTA5 33139,12,35100,60971,1680,476000,31258,9463,28913,3045,4789,6080,8427,6572,30347,20113,10234,20113,6338,13775,2022-01-01,zipcode
ZCTA5 33140,12,19785,98935,1912,837700,15993,5463,14569,1111,1528,2964,4606,4360,16290,8579,7711,8579,4878,3701,2022-01-01,zipcode
ZCTA5 33141,12,35967,61205,1634,419900,31860,9268,28951,2686,6077,7833,7742,4613,21704,16685,5019,16685,5675,11010,2022-01-01,zipcode
ZCTA5 33142,12,59121,35589,1189,277600,47064,18733,40166,14296,13234,7760,3544,1332,21855,20178,1677,20178,5729,14449,2022-01-01,zipcode
ZCTA5 33143,12,31688,78525,1709,711800,26054,9311,22930,1301,3637,4285,7518,6189,14805,13337,1468,13337,7356,5981,2022-01-01,zipcode
ZCTA5 33144,12,26596,58382,1611,410200,23062,9042,21086,3474,6492,5108,4285,1727,9760,9296,464,9296,5195,4101,2022-01-01,zipcode
ZCTA5 33145,12,29240,68717,1694,480100,25137,8931,22565,3456,4777,4843,5768,3721,12777,11809,968,11809,5921,5888,2022-01-01,zipcode
ZCTA5 33146,12,17962,125720,2571,1119100,15687,7575,8163,119,546,1281,2518,3699,6341,5357,984,5357,3500,1857,2022-01-01,zipcode
ZCTA5 33147,12,47065,45092,1279,234100,37131,15877,32224,7260,11957,7818,3613,1576,15999,14613,1386,14613,7389,7224,2022-01-01,zipcode
ZCTA5 33149,12,14639,169792,3501,1321200,10861,4635,9119,296,792,1365,3290,3376,7421,4676,2745,4676,3043,1633,2022-01-01,zipcode
ZCTA5 33150,12,31807,33629,1094,317200,23805,10187,20804,5607,7261,5070,2027,839,12101,10910,1191,10910,2995,7915,2022-01-01,zipcode
ZCTA5 33154,12,14557,75540,2080,716600,10748,3956,9499,158,1893,2013,2808,2627,10170,5666,4504,5666,3337,2329,2022-01-01,zipcode
ZCTA5 33155,12,43702,82321,1889,464900,36968,12777,32758,4533,8281,7971,7843,4130,15935,14905,1030,14905,10072,4833,2022-01-01,zipcode
ZCTA5 33156,12,32582,133862,1918,972000,25458,9411,22045,861,2725,3844,6722,7893,13123,11862,1261,11862,8607,3255,2022-01-01,zipcode
ZCTA5 33157,12,69152,77994,1414,433200,55347,19491,47851,5935,13606,11946,10610,5754,22536,21103,1433,21103,13824,7279,2022-01-01,zipcode
ZCTA5 33158,12,6536,177917,3321,890100,4995,2008,4336,38,351,599,1634,1714,2338,2166,172,2166,2058,108,2022-01-01,zipcode
ZCTA5 33160,12,42058,58174,1856,324100,35978,15614,32757,2056,5485,9021,9325,6870,35247,19954,15293,19954,11664,8290,2022-01-01,zipcode
ZCTA5 33161,12,52824,49159,1394,355300,42235,15103,35287,6622,13418,8211,4583,2453,18676,17162,1514,17162,6995,10167,2022-01-01,zipcode
ZCTA5 33162,12,48326,54884,1417,310700,37053,13023,31447,5699,11082,7979,4627,2060,16341,14978,1363,14978,7640,7338,2022-01-01,zipcode
ZCTA5 33165,12,52047,77482,1704,440700,45503,17644,40082,7201,12963,9223,6821,3874,17820,17306,514,17306,12508,4798,2022-01-01,zipcode
ZCTA5 33166,12,26364,74819,1655,466500,22282,7305,19162,3534,3408,4274,4677,3269,10478,9834,644,9834,4820,5014,2022-01-01,zipcode
ZCTA5 33167,12,22823,56044,1337,292300,17953,7352,14895,3456,5637,3357,1715,730,7058,6639,419,6639,3963,2676,2022-01-01,zipcode
ZCTA5 33168,12,23458,55866,1485,293800,18829,7483,15932,3625,6068,3856,1733,650,6791,6486,305,6486,4892,1594,2022-01-01,zipcode
ZCTA5 33169,12,42156,56415,1480,321100,32606,11102,28020,4479,9194,8100,4302,1945,14458,13254,1204,13254,6892,6362,2022-01-01,zipcode
ZCTA5 33170,12,14477,62001,1525,381000,11416,4245,9903,2248,3120,2434,1195,906,4856,4433,423,4433,2706,1727,2022-01-01,zipcode
ZCTA5 33172,12,40278,59228,1826,235800,34298,10766,30146,7144,6905,6768,6200,3129,16136,14485,1651,14485,6631,7854,2022-01-01,zipcode
ZCTA5 33173,12,33026,84644,1840,417500,27975,10681,24538,2036,4449,7459,6483,4111,12310,11749,561,11749,8071,3678,2022-01-01,zipcode
ZCTA5 33174,12,34335,55230,1667,357400,30257,12571,23777,6906,5783,4256,4724,2108,11454,11050,404,11050,5579,5471,2022-01-01,zipcode
ZCTA5 33175,12,50233,71621,1844,421400,43818,16628,38862,6923,10829,9005,7889,4216,17508,17115,393,17115,13043,4072,2022-01-01,zipcode
ZCTA5 33176,12,52719,80612,1605,541600,43381,14778,37802,3374,8179,10572,10016,5661,20048,18847,1201,18847,11835,7012,2022-01-01,zipcode
ZCTA5 33177,12,56791,74193,1961,362100,46891,18501,40720,6645,13974,10971,6363,2767,16708,16240,468,16240,12196,4044,2022-01-01,zipcode
ZCTA5 33178,12,64751,87817,2466,464100,50292,17423,42316,5440,5218,8660,12956,10042,22091,19718,2373,19718,9573,10145,2022-01-01,zipcode
ZCTA5 33179,12,48196,59920,1627,239900,39942,12991,34700,3059,9926,10273,6284,5158,20581,18433,2148,18433,10437,7996,2022-01-01,zipcode
ZCTA5 33180,12,32881,84490,2323,448300,27283,11263,24598,1325,3411,6128,7841,5893,22320,14456,7864,14456,9314,5142,2022-01-01,zipcode
ZCTA5 33181,12,20448,54618,1530,296800,16472,5300,13558,1377,3619,3424,3012,2126,9428,8384,1044,8384,3444,4940,2022-01-01,zipcode
ZCTA5 33182,12,13163,94129,2264,439900,11482,4009,9819,1100,2314,2202,3139,1064,4321,4240,81,4240,3508,732,2022-01-01,zipcode
ZCTA5 33183,12,34057,64714,1778,346600,29809,12104,25332,3941,7466,6693,4904,2328,12647,12349,298,12349,8144,4205,2022-01-01,zipcode
ZCTA5 33184,12,20850,72172,1976,364200,18094,6335,15785,4264,3839,2904,3255,1523,6852,6548,304,6548,4572,1976,2022-01-01,zipcode
ZCTA5 33185,12,29530,103401,2642,459800,23724,8785,20526,2970,4406,5191,5091,2868,9159,8974,185,8974,7262,1712,2022-01-01,zipcode
ZCTA5 33186,12,68750,81599,1961,391500,55969,19925,48658,4146,12353,15232,11255,5672,24148,23284,864,23284,15675,7609,2022-01-01,zipcode
ZCTA5 33187,12,19346,111525,2269,467900,15803,5676,13496,1676,3490,3876,3330,1124,5833,5656,177,5656,4953,703,2022-01-01,zipcode
ZCTA5 33189,12,24575,63250,1496,357200,19610,7173,17250,2794,5375,4669,2995,1417,8822,8431,391,8431,4972,3459,2022-01-01,zipcode
ZCTA5 33190,12,16909,71020,1663,339000,12793,3975,11107,1505,2718,3805,2262,817,5464,5373,91,5373,2450,2923,2022-01-01,zipcode
ZCTA5 33193,12,47116,72155,1697,384600,40366,14120,34455,7345,9151,7235,7384,3340,16095,15643,452,15643,9277,6366,2022-01-01,zipcode
ZCTA5 33194,12,8617,126910,2363,439500,7308,3408,6406,933,1193,1739,1634,907,1962,1962,0,1962,1576,386,2022-01-01,zipcode
ZCTA5 33196,12,54187,89326,2011,428400,43516,15493,37116,3418,9398,9851,9821,4628,17334,16980,354,16980,11447,5533,2022-01-01,zipcode
ZCTA5 33301,12,17069,115161,2252,701800,16066,4803,14756,665,1753,3343,5318,3677,13378,10017,3361,10017,3781,6236,2022-01-01,zipcode
ZCTA5 33304,12,18923,81266,1577,543500,16894,5571,15636,1491,2671,3534,5201,2739,12554,9566,2988,9566,3909,5657,2022-01-01,zipcode
ZCTA5 33305,12,12633,85246,1656,479000,11287,4032,10767,554,1633,2651,3208,2721,8074,6726,1348,6726,4625,2101,2022-01-01,zipcode
ZCTA5 33306,12,2767,74385,1201,466200,2613,899,2542,75,531,808,628,500,2157,1647,510,1647,1187,460,2022-01-01,zipcode
ZCTA5 33308,12,28406,80445,1759,489800,25905,11275,24288,1117,3847,6047,7446,5831,23595,15678,7917,15678,10807,4871,2022-01-01,zipcode
ZCTA5 33309,12,37829,68274,1724,273600,30622,7891,26229,3946,8493,7168,4458,2164,14888,13810,1078,13810,7841,5969,2022-01-01,zipcode
ZCTA5 33311,12,75435,48020,1297,246600,55667,22465,46899,9349,16481,13023,5287,2759,27466,24694,2772,24694,11390,13304,2022-01-01,zipcode
ZCTA5 33312,12,53409,72955,1524,361800,43670,15128,37796,5175,10831,10523,6765,4502,21687,18849,2838,18849,11838,7011,2022-01-01,zipcode
ZCTA5 33313,12,62232,43282,1479,220400,47803,16349,40392,6060,16607,11792,4217,1716,24893,21950,2943,21950,9388,12562,2022-01-01,zipcode
ZCTA5 33314,12,28978,59765,1844,285400,23643,7456,19163,2717,5889,4609,4044,1904,11906,10687,1219,10687,3757,6930,2022-01-01,zipcode
ZCTA5 33315,12,13253,88034,1676,416900,11529,3645,10400,618,3535,2357,2228,1662,6979,5832,1147,5832,3241,2591,2022-01-01,zipcode
ZCTA5 33316,12,11304,93063,1776,736400,10108,3695,9469,313,1407,2366,3392,1991,8842,5884,2958,5884,3355,2529,2022-01-01,zipcode
ZCTA5 33317,12,36322,79511,1839,406200,29341,9270,25970,2375,6932,7104,6185,3374,13430,12755,675,12755,9554,3201,2022-01-01,zipcode
ZCTA5 33319,12,52000,53705,1512,210500,42528,14245,37867,4857,11550,11529,6429,3502,25008,20966,4042,20966,13754,7212,2022-01-01,zipcode
ZCTA5 33321,12,50307,60113,1756,236800,43048,18029,38571,4537,10613,12505,6720,4196,23917,21766,2151,21766,16192,5574,2022-01-01,zipcode
ZCTA5 33322,12,40738,59066,1931,238500,35221,14578,32445,2796,8457,10413,7139,3640,21347,18730,2617,18730,15440,3290,2022-01-01,zipcode
ZCTA5 33323,12,22506,110395,2363,417700,18839,5221,16281,991,2824,4807,5051,2608,9285,8334,951,8334,6095,2239,2022-01-01,zipcode
ZCTA5 33324,12,49994,80348,1993,313500,40794,12942,36039,2250,6683,11460,9777,5869,22134,19860,2274,19860,11217,8643,2022-01-01,zipcode
ZCTA5 33325,12,31546,93060,1923,380000,25131,6616,21157,2230,4626,6263,5278,2760,11199,10487,712,10487,7981,2506,2022-01-01,zipcode
ZCTA5 33326,12,31514,107899,2250,474100,24518,7933,21141,776,2716,5350,6932,5367,12757,10800,1957,10800,7589,3211,2022-01-01,zipcode
ZCTA5 33327,12,23734,158184,2942,674200,17016,6256,14009,265,1666,2372,4924,4782,6640,6584,56,6584,5107,1477,2022-01-01,zipcode
ZCTA5 33328,12,29544,120195,1982,476100,23951,7127,19805,1036,3783,5619,5783,3584,10896,10261,635,10261,8257,2004,2022-01-01,zipcode
ZCTA5 33330,12,13619,136839,2600,646000,10977,3679,9436,585,1255,2307,2658,2631,4788,4446,342,4446,4219,227,2022-01-01,zipcode
ZCTA5 33331,12,25418,136734,2838,620200,20542,7834,16820,746,2123,4388,5671,3892,7831,7630,201,7630,6478,1152,2022-01-01,zipcode
ZCTA5 33332,12,11809,154652,3247,784500,9214,3154,7646,275,821,1568,2264,2718,3524,3461,63,3461,3019,442,2022-01-01,zipcode
ZCTA5 33334,12,31047,65379,1450,404600,25928,7303,22663,2666,6390,6393,4412,2802,14150,12877,1273,12877,7291,5586,2022-01-01,zipcode
ZCTA5 33351,12,35082,66611,1748,311500,28534,7565,25471,2228,6911,8763,5058,2511,13908,12891,1017,12891,7454,5437,2022-01-01,zipcode
ZCTA5 33401,12,31625,55238,1679,354900,27323,10432,22870,2589,4335,6282,5774,3890,18383,14332,4051,14332,5189,9143,2022-01-01,zipcode
ZCTA5 33403,12,13698,63481,1337,299100,11353,3978,9919,1329,3304,2758,1465,1063,6078,5117,961,5117,2327,2790,2022-01-01,zipcode
ZCTA5 33404,12,31034,56667,1408,257100,25005,9876,21857,2786,7071,6095,3763,2142,16322,11674,4648,11674,6482,5192,2022-01-01,zipcode
ZCTA5 33405,12,20377,77583,1274,346400,16988,5549,15061,2664,3069,4502,2964,1862,9299,8341,958,8341,5021,3320,2022-01-01,zipcode
ZCTA5 33406,12,26093,66531,1530,285900,21408,7786,17324,3156,5897,4385,2719,1167,9361,8587,774,8587,5618,2969,2022-01-01,zipcode
ZCTA5 33407,12,32904,52160,1449,253800,26496,9531,23356,4610,6687,6227,3786,2046,14783,12343,2440,12343,5714,6629,2022-01-01,zipcode
ZCTA5 33408,12,18839,89299,1757,472900,17102,8605,15887,447,3019,4052,5376,2993,13466,9707,3759,9707,7568,2139,2022-01-01,zipcode
ZCTA5 33409,12,33372,60484,1557,245900,26471,8092,21591,4369,5228,6147,4007,1840,13471,11753,1718,11753,5273,6480,2022-01-01,zipcode
ZCTA5 33410,12,36277,93643,1885,426200,30586,11456,27576,1306,5462,7696,8217,4895,17816,15222,2594,15222,10801,4421,2022-01-01,zipcode
ZCTA5 33411,12,73919,83770,1792,363900,60388,21421,53155,5371,11945,15409,12696,7734,29358,27200,2158,27200,20563,6637,2022-01-01,zipcode
ZCTA5 33412,12,15001,123934,1893,482200,12689,4777,11426,514,2442,3456,2880,2134,6431,5513,918,5513,4705,808,2022-01-01,zipcode
ZCTA5 33413,12,18125,77928,1942,344700,13908,4207,11623,1563,3021,4003,1906,1130,6093,5517,576,5517,3544,1973,2022-01-01,zipcode
ZCTA5 33414,12,58842,103525,2161,473300,45253,14994,38722,2581,6488,11950,10278,7425,22107,19761,2346,19761,14805,4956,2022-01-01,zipcode
ZCTA5 33415,12,51874,53496,1467,204000,41318,14460,35612,7768,11706,9657,4559,1922,20293,18334,1959,18334,10392,7942,2022-01-01,zipcode
ZCTA5 33417,12,35555,47293,1419,140700,30239,12441,27905,5180,8160,7674,4782,2109,20256,16131,4125,16131,9277,6854,2022-01-01,zipcode
ZCTA5 33418,12,42997,119156,2197,538900,36096,16212,32979,1164,4533,8266,10181,8835,21701,18339,3362,18339,14216,4123,2022-01-01,zipcode
ZCTA5 33426,12,23781,74073,1854,275400,20850,6821,18518,1948,4976,5869,3849,1876,11879,10302,1577,10302,6412,3890,2022-01-01,zipcode
ZCTA5 33428,12,45694,77322,2108,389700,35906,12463,30889,3165,7004,8001,8199,4520,17645,15922,1723,15922,10859,5063,2022-01-01,zipcode
ZCTA5 33430,12,20503,42968,772,133500,15110,6253,12843,4230,4376,2716,1070,451,7241,6273,968,6273,2235,4038,2022-01-01,zipcode
ZCTA5 33431,12,22488,101291,2115,496000,18895,8328,12855,754,1864,2913,4484,2840,9027,7462,1565,7462,5266,2196,2022-01-01,zipcode
ZCTA5 33432,12,21270,87634,2076,822200,19355,7795,17114,617,2201,4215,5851,4230,14923,10877,4046,10877,6233,4644,2022-01-01,zipcode
ZCTA5 33433,12,45580,77733,2198,382700,37695,17734,34207,1119,6369,8303,10511,7905,23300,20017,3283,20017,14069,5948,2022-01-01,zipcode
ZCTA5 33434,12,21214,68342,1448,329100,18832,11402,17947,911,2976,4227,5204,4629,13650,10683,2967,10683,8321,2362,2022-01-01,zipcode
ZCTA5 33435,12,37533,63691,1750,273600,31960,11869,27782,4162,8373,7377,5599,2271,19888,14535,5353,14535,8815,5720,2022-01-01,zipcode
ZCTA5 33436,12,47606,72164,1790,309900,39760,15542,35813,3424,8679,11258,8420,4032,23438,19472,3966,19472,14646,4826,2022-01-01,zipcode
ZCTA5 33437,12,38178,73502,1780,362500,35303,21485,32783,1145,7221,9556,8081,6780,21928,18288,3640,18288,15816,2472,2022-01-01,zipcode
ZCTA5 33438,12,609,70577,-666666666,87100,530,196,455,112,185,86,28,44,271,196,75,196,139,57,2022-01-01,zipcode
ZCTA5 33440,12,19800,54938,849,136400,15859,6120,13024,3804,4793,3218,904,305,7961,6978,983,6978,4892,2086,2022-01-01,zipcode
ZCTA5 33441,12,29576,53080,1406,335600,24639,8884,21635,3031,6559,6876,3422,1747,15440,12499,2941,12499,6706,5793,2022-01-01,zipcode
ZCTA5 33442,12,32076,51778,1845,202400,27432,12509,25603,2036,6510,8346,5996,2715,21663,15439,6224,15439,10329,5110,2022-01-01,zipcode
ZCTA5 33444,12,23569,72869,1627,378300,19784,6465,17555,2869,4496,4762,3542,1886,10103,8822,1281,8822,4740,4082,2022-01-01,zipcode
ZCTA5 33445,12,31283,67500,1826,261600,27747,11622,25151,2966,6220,6294,6116,3555,17407,13660,3747,13660,9640,4020,2022-01-01,zipcode
ZCTA5 33446,12,27774,67273,1564,352700,25192,16225,24023,894,4655,6710,6172,5592,18194,14150,4044,14150,12643,1507,2022-01-01,zipcode
ZCTA5 33449,12,9301,145952,3059,584600,7739,3369,6608,233,1268,1699,1825,1583,3603,3164,439,3164,2947,217,2022-01-01,zipcode
ZCTA5 33455,12,20936,72735,1196,365000,18260,9484,16950,1199,4455,5424,4020,1852,11579,9411,2168,9411,7946,1465,2022-01-01,zipcode
ZCTA5 33458,12,56799,104146,1945,487400,45868,14633,39538,3050,7146,10318,11761,7263,22915,21091,1824,21091,15734,5357,2022-01-01,zipcode
ZCTA5 33460,12,36578,58624,1324,292500,28978,8967,24205,6549,6249,5931,3555,1921,14394,12767,1627,12767,5488,7279,2022-01-01,zipcode
ZCTA5 33461,12,48575,57762,1466,229600,38835,11924,33308,8940,11034,7339,3668,2327,18288,15820,2468,15820,7757,8063,2022-01-01,zipcode
ZCTA5 33462,12,32232,67916,1590,287000,27638,8911,24617,3793,7381,6776,4200,2467,15605,12602,3003,12602,8143,4459,2022-01-01,zipcode
ZCTA5 33463,12,65766,66830,1646,284700,52251,16194,44154,8251,13424,11849,7109,3521,22679,20462,2217,20462,14547,5915,2022-01-01,zipcode
ZCTA5 33467,12,55101,83238,1760,376700,46711,20501,41845,2994,10073,12250,10468,6060,25214,21865,3349,21865,18787,3078,2022-01-01,zipcode
ZCTA5 33469,12,14639,96460,1788,471400,12757,6472,11784,260,2425,3358,3390,2351,8692,6876,1816,6876,6057,819,2022-01-01,zipcode
ZCTA5 33470,12,31165,108906,2520,464100,25821,8562,22429,2310,5815,7765,4491,2048,10505,10002,503,10002,9237,765,2022-01-01,zipcode
ZCTA5 33471,12,6759,36043,781,85000,5974,4071,5352,1587,1837,1249,433,246,3399,2492,907,2492,1777,715,2022-01-01,zipcode
ZCTA5 33472,12,18881,85238,1914,374500,17085,9544,15615,669,3377,5032,3701,2836,8946,8106,840,8106,7692,414,2022-01-01,zipcode
ZCTA5 33473,12,11107,157646,-666666666,662400,8982,4518,8309,51,921,2059,2146,3132,4713,4160,553,4160,4070,90,2022-01-01,zipcode
ZCTA5 33476,12,6999,25521,702,115400,5254,2603,4255,1353,1462,799,526,115,2370,2069,301,2069,801,1268,2022-01-01,zipcode
ZCTA5 33477,12,11524,104531,2389,551500,11067,6807,10549,322,1675,2589,3422,2541,11015,6517,4498,6517,5544,973,2022-01-01,zipcode
ZCTA5 33478,12,14845,137282,1921,578400,11921,4397,10833,361,2146,3396,3232,1698,5529,5040,489,5040,4875,165,2022-01-01,zipcode
ZCTA5 33480,12,10853,163929,1758,1173700,10318,6839,10167,219,1002,2367,3470,3109,12258,6364,5894,6364,5385,979,2022-01-01,zipcode
ZCTA5 33483,12,12639,112262,2316,703700,11860,5457,11078,500,1392,2709,3793,2684,9449,6512,2937,6512,4525,1987,2022-01-01,zipcode
ZCTA5 33484,12,26262,51036,1627,198300,24545,14903,23348,1293,6169,6795,4947,4144,19147,14463,4684,14463,11745,2718,2022-01-01,zipcode
ZCTA5 33486,12,22991,106343,2049,578500,18336,6652,15913,562,2630,4281,5453,2987,9855,8955,900,8955,6402,2553,2022-01-01,zipcode
ZCTA5 33487,12,21504,87266,2142,520500,18811,8936,17002,597,2221,4028,5896,4260,13595,10172,3423,10172,7397,2775,2022-01-01,zipcode
ZCTA5 33493,12,5035,48080,1058,117300,4395,3340,4128,1704,1405,721,231,67,828,733,95,733,430,303,2022-01-01,zipcode
ZCTA5 33496,12,23549,98843,2430,448100,20165,10745,18288,867,2455,3772,6854,4340,12121,10306,1815,10306,8509,1797,2022-01-01,zipcode
ZCTA5 33498,12,16866,124403,3501,519900,13195,5201,11339,691,1394,2622,3647,2985,5848,5543,305,5543,4997,546,2022-01-01,zipcode
ZCTA5 33503,12,401,-666666666,-666666666,388300,401,101,271,147,27,47,50,0,104,104,0,104,85,19,2022-01-01,zipcode
ZCTA5 33510,12,30103,68487,1270,251900,25018,8992,21460,2044,7115,6733,4179,1389,12078,11482,596,11482,7144,4338,2022-01-01,zipcode
ZCTA5 33511,12,58987,70696,1582,284400,47608,17037,40873,3391,10053,12911,9976,4542,24358,22550,1808,22550,12333,10217,2022-01-01,zipcode
ZCTA5 33513,12,12882,57634,999,191300,10660,6552,9424,1808,3679,2723,803,411,5254,4250,1004,4250,3357,893,2022-01-01,zipcode
ZCTA5 33514,12,2582,71000,907,172700,2059,927,1855,537,789,331,110,88,887,808,79,808,508,300,2022-01-01,zipcode
ZCTA5 33521,12,788,57031,885,106500,627,241,533,88,269,159,10,7,369,259,110,259,203,56,2022-01-01,zipcode
ZCTA5 33523,12,18867,56896,891,207300,15612,6480,12838,2487,4617,3040,1798,896,7875,6683,1192,6683,5144,1539,2022-01-01,zipcode
ZCTA5 33525,12,19186,65501,918,216800,15709,7745,13769,1381,4838,3743,2574,1233,8380,7369,1011,7369,5592,1777,2022-01-01,zipcode
ZCTA5 33527,12,16342,68713,839,288500,13309,5225,10891,2032,3787,2932,1432,708,5631,5293,338,5293,3886,1407,2022-01-01,zipcode
ZCTA5 33534,12,17479,68875,1292,241800,12618,3822,10673,1934,3511,3181,1401,646,6199,5689,510,5689,3751,1938,2022-01-01,zipcode
ZCTA5 33538,12,5599,47306,949,160600,4656,2175,4167,780,1537,1204,446,200,3280,2528,752,2528,1910,618,2022-01-01,zipcode
ZCTA5 33540,12,10282,46233,996,114100,8943,5220,8235,1195,3273,2575,804,388,5353,4504,849,4504,3737,767,2022-01-01,zipcode
ZCTA5 33541,12,23224,51246,1186,102200,20552,12967,18945,2235,7092,6451,2284,883,13856,10077,3779,10077,8695,1382,2022-01-01,zipcode
ZCTA5 33542,12,24573,45099,1016,119700,20884,12135,18603,2190,7327,6393,1793,900,13655,10668,2987,10668,7447,3221,2022-01-01,zipcode
ZCTA5 33543,12,35187,101000,1898,322600,27456,9458,23619,1382,4114,6762,6501,4860,13392,12306,1086,12306,10452,1854,2022-01-01,zipcode
ZCTA5 33544,12,28472,98177,1840,362100,21667,5954,18704,1471,3648,5332,4723,3530,10069,9606,463,9606,6798,2808,2022-01-01,zipcode
ZCTA5 33545,12,25721,100031,1971,315800,19853,5337,16548,841,4037,5375,4193,2102,8296,7897,399,7897,6199,1698,2022-01-01,zipcode
ZCTA5 33547,12,30431,116464,2155,435400,21904,7371,19070,1013,4348,5205,5026,3478,9911,9337,574,9337,7502,1835,2022-01-01,zipcode
ZCTA5 33548,12,7639,119705,1814,458500,5967,2024,5288,120,696,1466,1600,1406,2859,2766,93,2766,2369,397,2022-01-01,zipcode
ZCTA5 33549,12,18016,74094,1351,295200,15118,6127,13651,731,3128,4619,3156,2017,7655,7314,341,7314,5679,1635,2022-01-01,zipcode
ZCTA5 33556,12,30386,142738,1530,531600,23620,8176,20849,498,3502,5271,6886,4692,11231,10546,685,10546,9094,1452,2022-01-01,zipcode
ZCTA5 33558,12,29098,102821,1310,442800,22633,7820,19456,447,3390,4744,6324,4551,11093,10638,455,10638,7955,2683,2022-01-01,zipcode
ZCTA5 33559,12,19226,81715,1372,295300,15695,4612,11758,997,3344,3250,2732,1435,7041,6659,382,6659,4009,2650,2022-01-01,zipcode
ZCTA5 33563,12,26874,53068,1161,179800,21185,7382,17910,4219,5789,5040,2055,807,10773,9808,965,9808,5719,4089,2022-01-01,zipcode
ZCTA5 33565,12,17767,66210,1075,214500,14141,6130,12529,2125,4088,3647,1718,951,6864,6281,583,6281,5357,924,2022-01-01,zipcode
ZCTA5 33566,12,22842,69712,1234,271600,17887,6172,15464,1920,5740,3870,2778,1156,8126,7825,301,7825,5515,2310,2022-01-01,zipcode
ZCTA5 33567,12,12499,84237,1232,251200,10328,3262,8504,1877,2825,2092,1236,474,4157,3877,280,3877,3133,744,2022-01-01,zipcode
ZCTA5 33569,12,26189,91154,1729,302700,20477,6680,18048,1217,4715,6014,3964,2138,10150,9504,646,9504,7987,1517,2022-01-01,zipcode
ZCTA5 33570,12,32620,67149,1143,222100,25074,9400,21126,2750,6891,7012,2981,1492,13274,11058,2216,11058,8204,2854,2022-01-01,zipcode
ZCTA5 33572,12,23846,110558,1935,381100,19193,6913,17415,503,3585,5433,4624,3270,9853,9120,733,9120,7605,1515,2022-01-01,zipcode
ZCTA5 33573,12,28491,61635,1846,239100,26363,18920,25329,1442,7068,7984,5616,3219,16479,14479,2000,14479,11844,2635,2022-01-01,zipcode
ZCTA5 33576,12,6076,78114,933,292600,5418,3259,5017,171,1158,1879,1155,654,2978,2770,208,2770,2552,218,2022-01-01,zipcode
ZCTA5 33578,12,55724,75582,1625,267800,44008,11853,38246,2408,10274,11965,9118,4481,24704,22572,2132,22572,12989,9583,2022-01-01,zipcode
ZCTA5 33579,12,42456,102109,2050,307800,32172,8879,28006,3049,6257,9513,6253,2934,14126,13456,670,13456,10277,3179,2022-01-01,zipcode
ZCTA5 33584,12,27863,64993,1309,256500,22372,8858,19391,2532,6324,5582,3379,1574,10668,9985,683,9985,7396,2589,2022-01-01,zipcode
ZCTA5 33585,12,1352,59909,970,240700,1067,533,947,85,315,417,76,54,604,461,143,461,343,118,2022-01-01,zipcode
ZCTA5 33592,12,11275,56600,1053,185100,9433,4146,8198,1553,2972,1863,980,830,4735,4064,671,4064,2749,1315,2022-01-01,zipcode
ZCTA5 33594,12,35824,87241,1650,270600,30099,9794,25658,2225,7016,8136,5602,2679,13859,13126,733,13126,10278,2848,2022-01-01,zipcode
ZCTA5 33596,12,28558,108963,2215,360300,23542,7929,20365,1148,3992,5680,6619,2926,10488,9982,506,9982,8184,1798,2022-01-01,zipcode
ZCTA5 33597,12,8759,57981,904,172300,7622,3423,6591,998,2588,2222,712,71,4136,3457,679,3457,2958,499,2022-01-01,zipcode
ZCTA5 33598,12,27978,88231,1164,328800,20280,9121,17649,3547,5032,4240,2832,1998,8930,8355,575,8355,7051,1304,2022-01-01,zipcode
ZCTA5 33602,12,17631,88878,2010,464000,15725,4252,14004,1146,1952,2552,5130,3224,11063,9754,1309,9754,3142,6612,2022-01-01,zipcode
ZCTA5 33603,12,19545,60324,1205,293200,16257,4324,14447,1625,3380,3795,3617,2030,9381,8428,953,8428,5032,3396,2022-01-01,zipcode
ZCTA5 33604,12,40328,51918,1206,241100,31891,10581,28061,3759,9155,8219,4906,2022,16909,15621,1288,15621,8966,6655,2022-01-01,zipcode
ZCTA5 33605,12,16166,32381,1075,214100,13076,5520,11529,2601,3963,2769,1480,716,8737,7255,1482,7255,2688,4567,2022-01-01,zipcode
ZCTA5 33606,12,22546,106640,1770,740100,20108,7010,13049,285,1070,1988,5606,4100,10477,9110,1367,9110,3905,5205,2022-01-01,zipcode
ZCTA5 33607,12,24257,57581,1678,251600,21330,7186,19026,2840,5618,4269,4134,2165,12926,11163,1763,11163,4596,6567,2022-01-01,zipcode
ZCTA5 33609,12,18411,105761,1654,477600,15313,4407,13721,908,1531,2637,4777,3868,9165,8462,703,8462,5357,3105,2022-01-01,zipcode
ZCTA5 33610,12,45622,47591,1217,188200,34232,12742,28858,5586,9637,8369,3177,2089,17877,16487,1390,16487,8044,8443,2022-01-01,zipcode
ZCTA5 33611,12,34877,75718,1471,393300,28856,8985,26254,1242,5055,5863,8313,5781,18071,16728,1343,16728,9117,7611,2022-01-01,zipcode
ZCTA5 33612,12,50697,41984,1159,225000,39251,15971,32131,7173,10860,8067,4368,1663,20912,18908,2004,18908,6778,12130,2022-01-01,zipcode
ZCTA5 33613,12,37354,41841,1107,214700,32085,11314,22008,3115,6548,5925,3839,2581,18029,16138,1891,16138,4931,11207,2022-01-01,zipcode
ZCTA5 33614,12,46844,50168,1232,259400,40451,12757,35204,7637,11737,7484,6240,2106,19739,18644,1095,18644,7828,10816,2022-01-01,zipcode
ZCTA5 33615,12,48849,61761,1446,262100,39962,11325,35648,3982,12122,9170,7411,2963,20427,18681,1746,18681,10244,8437,2022-01-01,zipcode
ZCTA5 33616,12,14918,78176,1638,329300,12078,3082,10523,506,2487,2905,2417,2208,6772,6270,502,6270,3100,3170,2022-01-01,zipcode
ZCTA5 33617,12,48987,45719,1251,243000,40309,13084,31426,4056,9448,8905,5884,3133,21285,19942,1343,19942,8365,11577,2022-01-01,zipcode
ZCTA5 33618,12,28416,74016,1289,355200,23680,8233,21301,1100,4766,5886,6262,3287,12814,12184,630,12184,8215,3969,2022-01-01,zipcode
ZCTA5 33619,12,39272,55610,1426,178600,30963,11528,25937,4342,9009,7091,3427,2068,15184,14141,1043,14141,7401,6740,2022-01-01,zipcode
ZCTA5 33620,12,6451,-666666666,-666666666,-666666666,6451,4566,25,0,0,25,0,0,0,0,0,0,0,0,2022-01-01,zipcode
ZCTA5 33621,12,2309,93393,2432,-666666666,1481,413,918,0,238,301,208,171,579,475,104,475,0,475,2022-01-01,zipcode
ZCTA5 33624,12,41661,81241,1553,319000,33940,10355,30123,2132,6692,8642,8513,4144,16084,15656,428,15656,10269,5387,2022-01-01,zipcode
ZCTA5 33625,12,28818,80681,1631,322500,24427,8424,21206,1563,5060,6137,5280,3166,12022,11369,653,11369,7666,3703,2022-01-01,zipcode
ZCTA5 33626,12,30736,120240,1937,450800,24396,7970,21284,1054,2507,4452,8035,5236,12306,11799,507,11799,7985,3814,2022-01-01,zipcode
ZCTA5 33629,12,26625,152044,1663,726300,20131,6520,18030,385,1169,2781,6737,6958,11192,10275,917,10275,8163,2112,2022-01-01,zipcode
ZCTA5 33634,12,22927,64830,1625,268100,18905,5808,16231,1671,4951,5143,3222,1244,8336,7984,352,7984,4466,3518,2022-01-01,zipcode
ZCTA5 33635,12,19917,80653,1693,261300,16172,5023,14349,1258,3597,4049,3666,1779,8156,7547,609,7547,4750,2797,2022-01-01,zipcode
ZCTA5 33637,12,17507,55748,1390,207900,14283,4352,12123,1272,2801,3767,2616,1667,8123,7572,551,7572,3375,4197,2022-01-01,zipcode
ZCTA5 33647,12,72323,103918,1676,394800,56168,17114,48064,1938,6715,10737,16078,12596,27190,25717,1473,25717,15433,10284,2022-01-01,zipcode
ZCTA5 33701,12,17464,65058,1360,499900,15819,5890,14321,603,2305,3648,4398,3367,13092,9613,3479,9613,3713,5900,2022-01-01,zipcode
ZCTA5 33702,12,31119,62271,1226,266700,26862,9784,24094,2260,5255,7578,6297,2704,16450,14135,2315,14135,9227,4908,2022-01-01,zipcode
ZCTA5 33703,12,25900,98289,1539,373600,21593,7206,19388,715,2941,5642,5594,4496,12162,11011,1151,11011,8719,2292,2022-01-01,zipcode
ZCTA5 33704,12,16275,96986,1242,581700,14147,4517,13144,280,2227,2959,4154,3524,9025,7829,1196,7829,5441,2388,2022-01-01,zipcode
ZCTA5 33705,12,27426,68821,1346,272800,23481,9028,20721,1523,6018,5949,4671,2560,15447,11400,4047,11400,6776,4624,2022-01-01,zipcode
ZCTA5 33706,12,15433,103695,1480,573000,14755,7557,14105,506,2299,3949,4513,2838,14010,8193,5817,8193,6205,1988,2022-01-01,zipcode
ZCTA5 33707,12,25059,61988,1367,305300,23425,12340,21752,1050,5518,6963,5050,3171,16811,12745,4066,12745,8982,3763,2022-01-01,zipcode
ZCTA5 33708,12,15222,76684,1758,443700,14188,7311,13432,546,2881,4261,3369,2375,13471,7977,5494,7977,5966,2011,2022-01-01,zipcode
ZCTA5 33709,12,24120,48049,1236,178300,21097,9661,19285,2550,7035,5899,2644,1157,13988,10850,3138,10850,8217,2633,2022-01-01,zipcode
ZCTA5 33710,12,34102,72029,1417,267900,28837,10443,25919,1816,7095,7627,6626,2755,16392,14261,2131,14261,11431,2830,2022-01-01,zipcode
ZCTA5 33711,12,17984,61488,1601,234200,15448,7058,11728,513,3881,3824,2243,1267,9297,6284,3013,6284,4287,1997,2022-01-01,zipcode
ZCTA5 33712,12,25178,58137,1301,253600,20313,8198,17472,1235,4993,5636,3749,1859,12685,9436,3249,9436,5508,3928,2022-01-01,zipcode
ZCTA5 33713,12,32713,68022,1302,245500,27908,8548,25358,2258,6546,7805,6262,2487,15924,14341,1583,14341,9989,4352,2022-01-01,zipcode
ZCTA5 33714,12,20370,45820,1170,153400,16994,6856,15226,1930,6016,4629,1891,760,9904,8241,1663,8241,5288,2953,2022-01-01,zipcode
ZCTA5 33715,12,7876,103612,2746,461900,7061,3967,6756,115,933,2045,1623,2040,7098,3865,3233,3865,3502,363,2022-01-01,zipcode
ZCTA5 33716,12,18987,68488,1656,148000,16815,3295,14395,721,2294,4503,4562,2315,11375,10056,1319,10056,1868,8188,2022-01-01,zipcode
ZCTA5 33744,12,71,-666666666,-666666666,-666666666,71,71,71,12,59,0,0,0,0,0,0,0,0,0,2022-01-01,zipcode
ZCTA5 33755,12,27279,50866,1122,262800,22525,8150,19919,2372,6957,6025,3074,1491,11855,10562,1293,10562,5907,4655,2022-01-01,zipcode
ZCTA5 33756,12,32615,58059,1235,284800,27233,11942,24728,2277,8200,7240,4733,2278,15355,13241,2114,13241,7983,5258,2022-01-01,zipcode
ZCTA5 33759,12,17607,60781,1699,272300,14449,6493,12847,952,3277,3995,3011,1612,8791,7598,1193,7598,3985,3613,2022-01-01,zipcode
ZCTA5 33760,12,20401,56173,1313,194100,17632,6730,15309,2126,4677,4643,2498,1365,8595,7543,1052,7543,3506,4037,2022-01-01,zipcode
ZCTA5 33761,12,18558,66438,1614,249100,15955,7509,14781,870,3769,4788,3128,2226,9771,8576,1195,8576,6781,1795,2022-01-01,zipcode
ZCTA5 33762,12,5103,85472,1638,294700,4621,1493,4388,128,896,1172,1431,761,3153,2623,530,2623,2038,585,2022-01-01,zipcode
ZCTA5 33763,12,21272,50295,1272,182000,18322,9349,16992,1178,5543,5323,3050,1898,11573,9970,1603,9970,7110,2860,2022-01-01,zipcode
ZCTA5 33764,12,27681,61278,1457,274300,24022,9928,21719,1499,6269,7102,4367,2482,15183,12469,2714,12469,8579,3890,2022-01-01,zipcode
ZCTA5 33765,12,14578,59965,1438,271800,12312,4368,11087,1383,3076,3231,2201,1196,6844,6246,598,6246,3446,2800,2022-01-01,zipcode
ZCTA5 33767,12,7458,97500,1771,648300,6990,4372,6658,197,1284,1585,2004,1588,8848,3990,4858,3990,3276,714,2022-01-01,zipcode
ZCTA5 33770,12,25811,53456,1289,221700,22596,9548,19611,2179,6332,6304,3017,1779,13486,11410,2076,11410,6906,4504,2022-01-01,zipcode
ZCTA5 33771,12,28412,56275,1302,134500,24810,10969,22586,2040,7409,7445,4083,1609,16856,13248,3608,13248,8067,5181,2022-01-01,zipcode
ZCTA5 33772,12,23664,71464,1422,288200,20322,8374,18199,1506,4735,6127,4162,1669,12146,9988,2158,9988,7215,2773,2022-01-01,zipcode
ZCTA5 33773,12,16272,69285,1314,252300,14259,5042,12824,1240,3632,4017,3138,797,8145,6829,1316,6829,5098,1731,2022-01-01,zipcode
ZCTA5 33774,12,19629,72022,1280,291900,16335,6841,14602,924,3572,5894,2649,1563,10511,8277,2234,8277,6547,1730,2022-01-01,zipcode
ZCTA5 33776,12,13304,98886,1972,387000,10895,4668,9778,317,2229,2579,2818,1835,5482,5042,440,5042,4579,463,2022-01-01,zipcode
ZCTA5 33777,12,17860,83602,1645,271600,15061,5294,13705,736,3782,4098,3282,1807,8375,7335,1040,7335,6203,1132,2022-01-01,zipcode
ZCTA5 33778,12,15651,62369,1488,244300,13456,5326,12327,1144,3674,4309,1867,1333,8021,6421,1600,6421,5297,1124,2022-01-01,zipcode
ZCTA5 33781,12,26315,51958,1090,228500,22372,8608,20035,4042,6088,5658,2934,1313,12122,10300,1822,10300,6696,3604,2022-01-01,zipcode
ZCTA5 33782,12,23723,66824,1571,228900,19905,8373,17898,2028,5388,5664,3275,1543,10799,9387,1412,9387,7062,2325,2022-01-01,zipcode
ZCTA5 33785,12,4871,94638,1491,645400,4650,2069,4207,142,655,1415,1266,729,5874,2423,3451,2423,1870,553,2022-01-01,zipcode
ZCTA5 33786,12,1579,133750,2933,987000,1434,747,1373,51,159,334,468,361,1211,708,503,708,657,51,2022-01-01,zipcode
ZCTA5 33801,12,33861,45932,1024,123300,27619,13307,20347,3195,8263,5732,1897,1260,15252,11696,3556,11696,5667,6029,2022-01-01,zipcode
ZCTA5 33803,12,30230,62701,1238,215600,24987,10307,21573,1585,6068,6517,4372,3031,14976,12370,2606,12370,7610,4760,2022-01-01,zipcode
ZCTA5 33805,12,26064,51006,1118,150600,21005,9726,18221,3341,7156,4908,1872,944,11291,9707,1584,9707,4501,5206,2022-01-01,zipcode
ZCTA5 33809,12,30897,61911,1391,221800,25331,10621,21850,2212,7258,7221,3352,1807,12502,11397,1105,11397,7449,3948,2022-01-01,zipcode
ZCTA5 33810,12,51427,66045,1371,217000,42235,18003,36520,4766,12627,12747,4394,1986,21562,19229,2333,19229,14600,4629,2022-01-01,zipcode
ZCTA5 33811,12,25886,83043,1185,260900,20859,7403,17937,1668,4880,5789,4152,1448,10180,9353,827,9353,7287,2066,2022-01-01,zipcode
ZCTA5 33812,12,14736,95031,1440,286100,11756,3794,9720,565,2722,2982,1976,1475,5420,4741,679,4741,3659,1082,2022-01-01,zipcode
ZCTA5 33813,12,37582,93306,1560,301600,29090,10500,25337,1565,5588,8493,6512,3179,14511,13560,951,13560,10685,2875,2022-01-01,zipcode
ZCTA5 33815,12,13644,33540,996,29700,10821,5924,9472,1997,3739,2750,704,282,7304,5738,1566,5738,3237,2501,2022-01-01,zipcode
ZCTA5 33823,12,37082,61190,955,207600,29850,12160,26036,4051,10186,7283,3321,1195,14650,12752,1898,12752,9021,3731,2022-01-01,zipcode
ZCTA5 33825,12,25393,46017,865,123600,21428,12290,18560,3395,6841,5808,1634,882,12154,10047,2107,10047,7362,2685,2022-01-01,zipcode
ZCTA5 33827,12,2513,62466,1588,221400,2201,1183,1632,210,528,584,192,118,1211,881,330,881,766,115,2022-01-01,zipcode
ZCTA5 33830,12,30396,57904,980,192200,24356,9274,20673,2759,7643,6228,2938,1105,11747,10499,1248,10499,6947,3552,2022-01-01,zipcode
ZCTA5 33834,12,6371,51154,947,104200,5073,3090,4248,917,2085,833,226,187,2060,1544,516,1544,999,545,2022-01-01,zipcode
ZCTA5 33837,12,39979,71529,1642,271300,31179,12833,27043,2882,8625,8815,4719,2002,17361,13314,4047,13314,11096,2218,2022-01-01,zipcode
ZCTA5 33838,12,5226,49118,1167,200800,3927,1727,3448,922,1436,892,150,48,1957,1556,401,1556,1112,444,2022-01-01,zipcode
ZCTA5 33839,12,3649,75972,1283,172000,2786,977,2358,458,787,720,268,125,1444,1146,298,1146,871,275,2022-01-01,zipcode
ZCTA5 33841,12,8440,38466,816,133800,6918,3780,5842,1139,2757,1432,273,241,3954,3141,813,3141,2256,885,2022-01-01,zipcode
ZCTA5 33843,12,10790,49812,832,94700,9468,5593,8268,1687,3125,2356,600,500,5824,4004,1820,4004,3363,641,2022-01-01,zipcode
ZCTA5 33844,12,45765,58242,1150,191600,36495,15927,31304,4783,11585,9848,3462,1626,20750,15616,5134,15616,10896,4720,2022-01-01,zipcode
ZCTA5 33847,12,374,65391,753,153900,290,136,234,13,72,125,18,6,125,125,0,125,77,48,2022-01-01,zipcode
ZCTA5 33848,12,549,51700,1152,-666666666,422,272,361,72,156,104,0,29,215,148,67,148,66,82,2022-01-01,zipcode
ZCTA5 33849,12,713,53646,-666666666,216700,639,376,513,129,297,74,0,13,248,221,27,221,168,53,2022-01-01,zipcode
ZCTA5 33850,12,8876,49801,1114,188800,7472,3195,6846,855,2821,1764,787,619,4375,3378,997,3378,2367,1011,2022-01-01,zipcode
ZCTA5 33851,12,988,56938,-666666666,174000,778,407,672,168,259,191,39,15,355,283,72,283,255,28,2022-01-01,zipcode
ZCTA5 33852,12,21394,54055,1033,172700,17988,9888,16686,2476,6229,4911,1820,1250,13099,9361,3738,9361,7515,1846,2022-01-01,zipcode
ZCTA5 33853,12,12241,42397,949,177200,9502,4407,8393,1367,2952,2398,1096,580,5540,4719,821,4719,2573,2146,2022-01-01,zipcode
ZCTA5 33854,12,446,32438,672,83200,443,355,413,101,70,148,61,33,643,241,402,241,111,130,2022-01-01,zipcode
ZCTA5 33855,12,126,56302,-666666666,276000,126,80,126,32,77,17,0,0,41,41,0,41,41,0,2022-01-01,zipcode
ZCTA5 33856,12,297,30208,609,-666666666,297,203,297,30,90,149,28,0,520,219,301,219,6,213,2022-01-01,zipcode
ZCTA5 33857,12,1160,39659,-666666666,138200,1043,659,1037,116,454,297,157,13,1176,595,581,595,504,91,2022-01-01,zipcode
ZCTA5 33859,12,11081,61815,1104,181100,9555,5437,8267,1103,2547,2730,1270,617,5854,4441,1413,4441,3441,1000,2022-01-01,zipcode
ZCTA5 33860,12,26658,62429,1137,189400,20326,7316,16896,2799,5930,5599,1812,756,9613,8565,1048,8565,5815,2750,2022-01-01,zipcode
ZCTA5 33865,12,866,62689,-666666666,-666666666,722,223,629,73,352,102,82,20,276,276,0,276,117,159,2022-01-01,zipcode
ZCTA5 33867,12,76,-666666666,-666666666,163500,76,76,76,13,36,27,0,0,109,40,69,40,40,0,2022-01-01,zipcode
ZCTA5 33868,12,13404,67579,1051,190800,10810,5597,9632,1365,3568,2929,1239,531,5226,4210,1016,4210,3715,495,2022-01-01,zipcode
ZCTA5 33870,12,25314,43915,891,133800,21492,12128,19069,3149,6941,5961,1995,1023,13857,11070,2787,11070,7703,3367,2022-01-01,zipcode
ZCTA5 33872,12,12696,67576,1070,165800,11379,7178,10554,874,3253,3694,1858,875,7834,5981,1853,5981,5407,574,2022-01-01,zipcode
ZCTA5 33873,12,13678,40625,911,120200,10369,4961,8720,1932,4003,1939,649,197,5653,4880,773,4880,3144,1736,2022-01-01,zipcode
ZCTA5 33875,12,11129,73243,913,198600,9275,4757,8710,771,2884,3006,1268,781,5505,4681,824,4681,3898,783,2022-01-01,zipcode
ZCTA5 33876,12,6188,53388,887,152500,5535,3480,5231,586,1964,1878,626,177,3171,2523,648,2523,2207,316,2022-01-01,zipcode
ZCTA5 33877,12,269,-666666666,-666666666,188800,269,107,269,0,132,137,0,0,211,211,0,211,211,0,2022-01-01,zipcode
ZCTA5 33880,12,43732,53569,1038,178400,34065,13882,28996,5670,10954,8382,2859,1131,17358,15169,2189,15169,9937,5232,2022-01-01,zipcode
ZCTA5 33881,12,38946,51685,1085,157400,31440,15643,27697,3667,10262,9096,3186,1486,17619,14359,3260,14359,10152,4207,2022-01-01,zipcode
ZCTA5 33884,12,36058,68638,1374,245300,30159,13805,26127,2130,7895,9000,4709,2393,15587,13554,2033,13554,10365,3189,2022-01-01,zipcode
ZCTA5 33890,12,4821,49219,856,129300,3709,1680,3078,736,1419,561,217,145,1905,1469,436,1469,1166,303,2022-01-01,zipcode
ZCTA5 33896,12,20528,67999,1823,277800,17015,4874,14011,870,3146,5142,3192,1661,10737,7503,3234,7503,3452,4051,2022-01-01,zipcode
ZCTA5 33897,12,28083,68857,1764,246700,22650,7270,19973,1416,6328,7104,3831,1294,13396,9688,3708,9688,6673,3015,2022-01-01,zipcode
ZCTA5 33898,12,17066,53717,1095,147500,13825,7118,12533,1955,4748,3824,1482,524,9798,6884,2914,6884,5678,1206,2022-01-01,zipcode
ZCTA5 33901,12,24284,46903,1195,274300,19451,9016,17028,2929,5578,3932,2609,1980,11657,9551,2106,9551,4141,5410,2022-01-01,zipcode
ZCTA5 33903,12,22430,55596,1096,117200,20293,12045,18991,2381,5981,6433,2741,1455,15240,11482,3758,11482,9380,2102,2022-01-01,zipcode
ZCTA5 33904,12,32345,62177,1520,301700,28951,14668,27475,1567,9795,8802,4872,2439,20296,14612,5684,14612,11161,3451,2022-01-01,zipcode
ZCTA5 33905,12,39247,68335,1458,221200,32050,14084,27531,5469,8538,7703,3686,2135,16479,14053,2426,14053,8941,5112,2022-01-01,zipcode
ZCTA5 33907,12,25828,51122,1360,213800,21933,8574,19366,2350,6067,5588,3325,2036,14105,11244,2861,11244,4745,6499,2022-01-01,zipcode
ZCTA5 33908,12,38844,68445,1729,300200,35953,21361,33772,1422,9181,8901,8052,6216,31714,20062,11652,20062,14156,5906,2022-01-01,zipcode
ZCTA5 33909,12,36172,73851,1653,260800,28818,9908,24579,1536,9507,7891,3610,2035,13768,12681,1087,12681,9228,3453,2022-01-01,zipcode
ZCTA5 33912,12,19370,98293,1695,335200,17425,9534,16010,440,3440,4439,4557,3134,12033,8637,3396,8637,7361,1276,2022-01-01,zipcode
ZCTA5 33913,12,27056,104877,1847,380700,23393,12093,19867,997,4106,5472,5219,4073,15159,10612,4547,10612,9545,1067,2022-01-01,zipcode
ZCTA5 33914,12,43289,72662,1590,369400,38742,17233,35716,1797,11640,12444,5984,3851,22594,17707,4887,17707,14325,3382,2022-01-01,zipcode
ZCTA5 33916,12,26153,46342,1219,209400,21006,8226,17913,3620,6329,4175,2594,1195,12366,10054,2312,10054,3403,6651,2022-01-01,zipcode
ZCTA5 33917,12,30512,51070,1140,155500,27634,15360,25423,2775,9457,8428,3073,1690,18365,14385,3980,14385,11978,2407,2022-01-01,zipcode
ZCTA5 33919,12,28483,67788,1470,265200,25520,12792,23710,1124,5098,7507,5707,4274,19210,14231,4979,14231,10996,3235,2022-01-01,zipcode
ZCTA5 33920,12,7250,84065,986,319300,5942,2679,5334,343,1508,1869,1068,546,3020,2683,337,2683,2507,176,2022-01-01,zipcode
ZCTA5 33921,12,726,117240,-666666666,2000001,723,529,711,28,121,182,212,168,1688,362,1326,362,362,0,2022-01-01,zipcode
ZCTA5 33922,12,4235,64461,1120,278100,3616,2151,3353,414,893,896,670,480,2959,1784,1175,1784,1519,265,2022-01-01,zipcode
ZCTA5 33924,12,161,-666666666,-666666666,-666666666,161,105,131,31,18,18,58,6,1748,40,1708,40,40,0,2022-01-01,zipcode
ZCTA5 33928,12,29948,95979,1928,378800,26717,14857,25163,787,5158,7549,6776,4893,19881,13675,6206,13675,11470,2205,2022-01-01,zipcode
ZCTA5 33930,12,993,75152,-666666666,-666666666,720,213,549,197,282,70,0,0,315,264,51,264,214,50,2022-01-01,zipcode
ZCTA5 33931,12,9150,74838,1453,426000,8867,6259,8568,300,2546,2523,1702,1497,14785,4825,9960,4825,4359,466,2022-01-01,zipcode
ZCTA5 33935,12,22521,47027,912,159200,17332,6544,14570,4406,4859,3197,1623,485,8648,7437,1211,7437,5358,2079,2022-01-01,zipcode
ZCTA5 33936,12,26537,43640,1152,182700,21704,9762,18485,3710,6938,4964,2063,810,10684,9756,928,9756,6382,3374,2022-01-01,zipcode
ZCTA5 33944,12,186,36203,-666666666,75200,186,95,186,0,100,80,0,6,152,95,57,95,95,0,2022-01-01,zipcode
ZCTA5 33946,12,2704,82358,785,565500,2578,1528,2462,63,707,677,497,518,3072,1315,1757,1315,1198,117,2022-01-01,zipcode
ZCTA5 33947,12,9927,60984,1265,312700,9327,6083,8959,631,2710,3065,1670,883,6555,4912,1643,4912,3953,959,2022-01-01,zipcode
ZCTA5 33948,12,18440,59861,1265,249500,16755,9182,15837,1309,5425,5895,2156,1052,9386,7839,1547,7839,6758,1081,2022-01-01,zipcode
ZCTA5 33950,12,24702,71357,1153,372900,22356,14580,20763,877,4941,7640,4391,2914,16514,12055,4459,12055,9959,2096,2022-01-01,zipcode
ZCTA5 33952,12,34731,52312,1161,201500,30071,15340,26920,2994,10219,8464,3515,1728,17516,14697,2819,14697,11143,3554,2022-01-01,zipcode
ZCTA5 33953,12,7347,73294,1568,292100,6782,4221,6018,359,1806,1986,1187,680,4109,2976,1133,2976,2887,89,2022-01-01,zipcode
ZCTA5 33954,12,10393,74221,1580,289400,8887,3843,8083,546,2367,3152,1382,636,4541,4183,358,4183,3268,915,2022-01-01,zipcode
ZCTA5 33955,12,10397,73523,1531,302600,9777,6298,9263,1100,2830,2616,1689,1028,6751,4894,1857,4894,4523,371,2022-01-01,zipcode
ZCTA5 33956,12,3494,62415,2191,251600,3346,2093,3248,239,1021,1196,412,380,3629,1773,1856,1773,1648,125,2022-01-01,zipcode
ZCTA5 33957,12,6420,111683,1003,844500,6288,4203,6126,37,1316,1149,1904,1720,8475,3491,4984,3491,3133,358,2022-01-01,zipcode
ZCTA5 33960,12,581,37500,1083,205000,474,229,468,56,154,171,57,30,444,310,134,310,270,40,2022-01-01,zipcode
ZCTA5 33965,12,3793,25179,1365,-666666666,3793,1891,54,0,10,40,4,0,33,33,0,33,0,33,2022-01-01,zipcode
ZCTA5 33966,12,11236,79172,1557,326900,9509,3864,8945,314,1879,2806,2543,1403,6768,5130,1638,5130,3407,1723,2022-01-01,zipcode
ZCTA5 33967,12,27887,82732,1634,293300,22695,6995,18515,1847,4600,6112,3823,2133,11241,9734,1507,9734,6963,2771,2022-01-01,zipcode
ZCTA5 33971,12,28712,69061,1566,240900,21441,6951,17563,3055,6413,5475,1813,807,8561,8176,385,8176,6523,1653,2022-01-01,zipcode
ZCTA5 33972,12,15218,66643,1434,260000,11841,4842,9980,1353,3820,3011,1280,516,5131,4617,514,4617,3644,973,2022-01-01,zipcode
ZCTA5 33973,12,14585,58989,1342,289300,10036,3411,7887,1667,2887,2363,667,303,4257,3992,265,3992,895,3097,2022-01-01,zipcode
ZCTA5 33974,12,19218,60617,1595,237600,14501,5304,11985,1903,4658,3444,1478,502,5726,5277,449,5277,3539,1738,2022-01-01,zipcode
ZCTA5 33976,12,17874,63992,1633,234600,13030,4170,10791,2451,3336,3074,1581,349,5189,4977,212,4977,3606,1371,2022-01-01,zipcode
ZCTA5 33980,12,13071,58919,1151,201500,11450,7186,10825,820,4351,3243,1384,1027,8096,6062,2034,6062,4570,1492,2022-01-01,zipcode
ZCTA5 33981,12,14330,66708,1385,319400,12736,7094,12168,865,4164,4050,1824,1265,7473,6121,1352,6121,5464,657,2022-01-01,zipcode
ZCTA5 33982,12,11067,56518,993,246200,9803,6018,9334,1203,3388,2695,1112,936,5485,4262,1223,4262,3685,577,2022-01-01,zipcode
ZCTA5 33983,12,16637,63213,1190,291300,14623,7650,13186,850,4891,4325,2079,1041,8650,7201,1449,7201,5857,1344,2022-01-01,zipcode
ZCTA5 33990,12,34275,67030,1498,289100,29186,12128,26339,2955,9961,7351,4322,1750,15394,13125,2269,13125,9468,3657,2022-01-01,zipcode
ZCTA5 33991,12,24993,76996,1735,317800,20205,8451,18131,938,6340,6358,3350,1145,11043,9452,1591,9452,7508,1944,2022-01-01,zipcode
ZCTA5 33993,12,30572,86117,1859,289900,24870,9521,21401,2288,7530,6966,2890,1727,11698,10411,1287,10411,8810,1601,2022-01-01,zipcode
ZCTA5 34101,12,0,-666666666,-666666666,-666666666,0,0,0,0,0,0,0,0,0,0,0,0,0,0,2022-01-01,zipcode
ZCTA5 34102,12,10767,111742,1306,1207200,9663,5697,9155,486,1398,2007,2991,2273,9616,5385,4231,5385,4013,1372,2022-01-01,zipcode
ZCTA5 34103,12,11214,99615,1823,876500,10221,5459,9273,290,1727,2087,3062,2107,10351,5390,4961,5390,4548,842,2022-01-01,zipcode
ZCTA5 34104,12,24269,67932,1531,312200,20143,9850,18732,1599,5454,5544,3841,2294,15670,11060,4610,11060,7584,3476,2022-01-01,zipcode
ZCTA5 34105,12,16462,101282,1896,496900,14589,7518,13538,442,2369,3647,4000,3080,11540,7721,3819,7721,5106,2615,2022-01-01,zipcode
ZCTA5 34108,12,16401,115182,1843,903100,15467,9718,14874,481,2252,3265,5154,3722,15030,8412,6618,8412,7198,1214,2022-01-01,zipcode
ZCTA5 34109,12,25845,88203,1766,531600,21669,11316,19983,744,4167,5000,5817,4255,15744,11765,3979,11765,8204,3561,2022-01-01,zipcode
ZCTA5 34110,12,24584,90006,1945,472800,22219,13066,20810,774,3782,5295,6745,4214,17976,12641,5335,12641,9252,3389,2022-01-01,zipcode
ZCTA5 34112,12,26597,66692,1373,271200,24711,13417,22568,2144,6651,6110,4450,3213,20323,12975,7348,12975,9921,3054,2022-01-01,zipcode
ZCTA5 34113,12,24413,72688,1723,399700,21216,10883,19270,2359,5347,4303,4447,2814,16095,10424,5671,10424,7399,3025,2022-01-01,zipcode
ZCTA5 34114,12,20716,79130,1767,383700,18519,10355,17353,1854,4214,4712,3740,2833,15213,9360,5853,9360,7834,1526,2022-01-01,zipcode
ZCTA5 34116,12,35710,66302,1483,344100,28257,7832,23485,4443,9540,5488,2653,1361,11439,10832,607,10832,6066,4766,2022-01-01,zipcode
ZCTA5 34117,12,19218,101392,1488,379500,15937,5099,13690,1749,4634,4263,2081,963,5813,5433,380,5433,4650,783,2022-01-01,zipcode
ZCTA5 34119,12,33017,105263,1641,599800,27137,13730,24816,1032,4937,6166,7032,5649,17758,14047,3711,14047,11658,2389,2022-01-01,zipcode
ZCTA5 34120,12,38191,83636,2022,408600,31790,10931,27883,3469,9228,6634,4992,3560,16805,13401,3404,13401,11619,1782,2022-01-01,zipcode
ZCTA5 34134,12,15859,121713,1736,605800,15152,10223,14773,299,2322,3904,4277,3971,14616,8305,6311,8305,6752,1553,2022-01-01,zipcode
ZCTA5 34135,12,45781,81024,1662,380600,40273,21100,37207,4362,8010,10391,8780,5664,29780,19810,9970,19810,15648,4162,2022-01-01,zipcode
ZCTA5 34137,12,369,81228,-666666666,162300,194,29,194,0,138,56,0,0,115,115,0,115,115,0,2022-01-01,zipcode
ZCTA5 34138,12,1061,91080,-666666666,213000,762,372,762,0,333,368,61,0,676,364,312,364,315,49,2022-01-01,zipcode
ZCTA5 34139,12,143,-666666666,-666666666,394100,127,51,127,0,36,55,17,19,486,72,414,72,68,4,2022-01-01,zipcode
ZCTA5 34140,12,155,-666666666,-666666666,-666666666,113,86,86,0,27,33,26,0,220,53,167,53,26,27,2022-01-01,zipcode
ZCTA5 34141,12,74,-666666666,-666666666,-666666666,43,28,34,5,24,5,0,0,4,4,0,4,4,0,2022-01-01,zipcode
ZCTA5 34142,12,34411,55225,926,246600,26125,9734,20264,8072,6285,3447,1531,929,10005,8577,1428,8577,3975,4602,2022-01-01,zipcode
ZCTA5 34145,12,15942,105315,1870,808800,14924,10056,14409,616,3049,4014,3667,3063,18135,8276,9859,8276,7487,789,2022-01-01,zipcode
ZCTA5 34201,12,3912,123105,1820,587700,3698,2369,3483,88,406,598,1415,976,2481,1801,680,1801,1712,89,2022-01-01,zipcode
ZCTA5 34202,12,26762,114234,1941,550300,22209,11065,19829,663,3035,5327,5876,4928,12099,10395,1704,10395,8123,2272,2022-01-01,zipcode
ZCTA5 34203,12,39757,66580,1243,276600,34025,15289,30623,3644,11450,7934,4720,2875,20687,16637,4050,16637,12218,4419,2022-01-01,zipcode
ZCTA5 34205,12,30966,48859,1192,215000,26220,10837,22981,3526,7581,6593,3490,1791,16302,12978,3324,12978,7750,5228,2022-01-01,zipcode
ZCTA5 34207,12,34437,47711,1168,116100,29389,12996,25609,4186,10541,7056,2737,1089,19419,14675,4744,14675,9358,5317,2022-01-01,zipcode
ZCTA5 34208,12,41521,55576,1352,259500,31950,13396,27761,5900,8939,6918,3923,2081,16280,13815,2465,13815,7977,5838,2022-01-01,zipcode
ZCTA5 34209,12,34089,75739,1595,323300,29868,15237,27734,1680,7907,8291,5786,4070,18900,14797,4103,14797,11691,3106,2022-01-01,zipcode
ZCTA5 34210,12,16461,56799,1336,263300,14829,7847,13112,945,4050,3625,2694,1798,11648,7701,3947,7701,4857,2844,2022-01-01,zipcode
ZCTA5 34211,12,16508,119663,1851,535600,13918,6130,12488,569,1860,3721,3800,2538,8451,6209,2242,6209,5292,917,2022-01-01,zipcode
ZCTA5 34212,12,23754,107699,1764,441800,19606,8418,17728,502,2999,5768,5187,3272,10884,8892,1992,8892,7452,1440,2022-01-01,zipcode
ZCTA5 34215,12,683,-666666666,-666666666,796900,683,434,665,0,101,307,174,83,551,322,229,322,300,22,2022-01-01,zipcode
ZCTA5 34216,12,924,95694,-666666666,1108600,923,680,912,23,100,235,371,183,1840,558,1282,558,536,22,2022-01-01,zipcode
ZCTA5 34217,12,3719,85896,1770,607300,3371,2097,3299,72,557,736,1086,848,5811,1962,3849,1962,1650,312,2022-01-01,zipcode
ZCTA5 34219,12,27838,103000,1901,376200,23084,9431,20744,510,5549,6538,5421,2726,11554,10390,1164,10390,9399,991,2022-01-01,zipcode
ZCTA5 34221,12,52882,71679,1365,271200,44151,19191,39411,3926,13117,11919,6665,3784,23685,19085,4600,19085,15010,4075,2022-01-01,zipcode
ZCTA5 34222,12,13975,63142,1388,166400,11883,6149,10652,727,3888,3744,1303,990,7838,6060,1778,6060,4803,1257,2022-01-01,zipcode
ZCTA5 34223,12,19116,66268,1256,340600,17894,11839,17080,548,5050,4904,3825,2753,14336,9930,4406,9930,8482,1448,2022-01-01,zipcode
ZCTA5 34224,12,15263,52129,1143,229200,14404,8963,13237,1038,4750,4382,2006,1061,11277,7688,3589,7688,6148,1540,2022-01-01,zipcode
ZCTA5 34228,12,7479,141250,2469,909700,7456,5952,7432,169,897,1415,2303,2648,9708,4171,5537,4171,3909,262,2022-01-01,zipcode
ZCTA5 34229,12,7575,94496,2200,620800,6879,4423,6505,170,1165,1274,2101,1795,4626,3548,1078,3548,3196,352,2022-01-01,zipcode
ZCTA5 34231,12,32413,67543,1483,337400,27732,13100,25671,1465,7100,7604,5679,3823,18854,15180,3674,15180,9962,5218,2022-01-01,zipcode
ZCTA5 34232,12,34324,79806,1697,296300,29164,10068,26078,1917,7944,7772,5402,3043,16967,14870,2097,14870,10254,4616,2022-01-01,zipcode
ZCTA5 34233,12,19179,74365,1652,321100,16284,6636,14837,706,4189,4322,3906,1714,9455,8403,1052,8403,6078,2325,2022-01-01,zipcode
ZCTA5 34234,12,21621,54669,1321,196000,18020,8223,15609,2630,5229,3715,2461,1574,10256,8828,1428,8828,5318,3510,2022-01-01,zipcode
ZCTA5 34235,12,14760,69623,1619,301500,13418,6636,12180,631,3631,3280,2816,1822,8201,7045,1156,7045,5157,1888,2022-01-01,zipcode
ZCTA5 34236,12,13347,95231,1852,867000,12842,8296,12409,553,1814,2252,3758,4032,11436,7608,3828,7608,4446,3162,2022-01-01,zipcode
ZCTA5 34237,12,17877,61556,1409,224500,15042,4825,13128,1535,4576,3928,2104,985,9028,7227,1801,7227,3182,4045,2022-01-01,zipcode
ZCTA5 34238,12,22426,91936,1833,479400,20383,12001,19145,317,3804,4762,4739,5523,13715,11100,2615,11100,8355,2745,2022-01-01,zipcode
ZCTA5 34239,12,14812,72079,1523,376900,12867,5415,11638,899,2650,3240,2999,1850,7997,6871,1126,6871,5107,1764,2022-01-01,zipcode
ZCTA5 34240,12,14400,120581,2014,531900,11835,5219,10648,223,2302,3018,3199,1906,6917,5629,1288,5629,4941,688,2022-01-01,zipcode
ZCTA5 34241,12,15608,105794,1854,461600,13012,5297,11450,451,2509,3161,3361,1968,6738,5957,781,5957,5197,760,2022-01-01,zipcode
ZCTA5 34242,12,7602,121006,2169,877400,7162,4694,6913,218,751,1470,2330,2144,10419,4053,6366,4053,3538,515,2022-01-01,zipcode
ZCTA5 34243,12,31656,77236,1826,365300,27933,12810,24872,1158,6236,7201,5386,4891,16052,13411,2641,13411,10453,2958,2022-01-01,zipcode
ZCTA5 34251,12,7324,82926,951,457700,5957,2335,4947,455,2045,1631,574,242,2335,2204,131,2204,2000,204,2022-01-01,zipcode
ZCTA5 34266,12,28420,41328,857,131500,23588,11923,20415,6122,7896,4322,1303,772,12147,9972,2175,9972,6636,3336,2022-01-01,zipcode
ZCTA5 34268,12,508,-666666666,-666666666,-666666666,508,284,341,128,112,21,80,0,165,96,69,96,92,4,2022-01-01,zipcode
ZCTA5 34269,12,5274,52473,1039,168200,4639,2807,4210,470,1921,1074,577,168,3226,2243,983,2243,2027,216,2022-01-01,zipcode
ZCTA5 34275,12,20692,78532,1641,375000,18839,10821,17634,601,4766,4921,4019,3327,12490,10329,2161,10329,8876,1453,2022-01-01,zipcode
ZCTA5 34285,12,18791,61531,1363,280000,18030,12006,17278,730,4544,5008,3862,3134,15940,10360,5580,10360,8229,2131,2022-01-01,zipcode
ZCTA5 34286,12,20571,67867,1734,273600,17392,8148,15047,1403,4188,5650,2287,1519,8447,7783,664,7783,6236,1547,2022-01-01,zipcode
ZCTA5 34287,12,26721,63657,1235,209200,22583,12680,20781,1710,6993,7590,2763,1725,15469,11330,4139,11330,8711,2619,2022-01-01,zipcode
ZCTA5 34288,12,14412,77440,1515,266200,11788,5115,9552,745,2606,3506,1841,854,5723,5400,323,5400,4370,1030,2022-01-01,zipcode
ZCTA5 34289,12,4692,112576,1644,302300,3991,1513,3316,327,806,1195,668,320,1908,1491,417,1491,874,617,2022-01-01,zipcode
ZCTA5 34291,12,8104,87529,1719,295800,7063,2536,6161,282,2793,2224,572,290,3143,3060,83,3060,2688,372,2022-01-01,zipcode
ZCTA5 34292,12,16426,80824,1912,389800,15274,10140,14500,545,3591,4036,3501,2827,10329,8215,2114,8215,6511,1704,2022-01-01,zipcode
ZCTA5 34293,12,46782,84110,1678,335700,41987,23243,39691,1966,9544,13429,7916,6836,27125,22049,5076,22049,19449,2600,2022-01-01,zipcode
ZCTA5 34420,12,18396,50355,873,160800,14364,6316,12424,1195,4899,4583,1062,685,7949,6953,996,6953,4854,2099,2022-01-01,zipcode
ZCTA5 34428,12,9175,50075,813,218800,8074,4327,7139,794,2510,2412,953,470,5028,4099,929,4099,3128,971,2022-01-01,zipcode
ZCTA5 34429,12,9448,55797,940,193500,8406,5432,7931,700,3169,2192,1219,651,5470,4248,1222,4248,3570,678,2022-01-01,zipcode
ZCTA5 34431,12,8448,47632,835,161300,7399,4325,6793,942,2734,2234,703,180,4790,3870,920,3870,3282,588,2022-01-01,zipcode
ZCTA5 34432,12,13029,45583,941,189400,10977,6500,10340,1051,3920,3292,1298,779,6599,5694,905,5694,5019,675,2022-01-01,zipcode
ZCTA5 34433,12,8128,68072,1351,202100,6796,3625,5763,683,2421,1567,707,385,3702,3149,553,3149,2894,255,2022-01-01,zipcode
ZCTA5 34434,12,9981,54202,1213,181400,7686,4054,7160,688,2516,2539,1035,382,4349,3682,667,3682,3238,444,2022-01-01,zipcode
ZCTA5 34436,12,7846,47580,611,174600,6943,4488,6508,842,2360,2276,598,432,4817,3657,1160,3657,3130,527,2022-01-01,zipcode
ZCTA5 34442,12,16674,51216,848,257800,15184,10868,14285,928,4945,4584,1921,1907,9771,7843,1928,7843,6841,1002,2022-01-01,zipcode
ZCTA5 34445,12,0,-666666666,-666666666,-666666666,0,0,0,0,0,0,0,0,40,0,40,0,0,0,2022-01-01,zipcode
ZCTA5 34446,12,18668,57773,883,201600,16711,11113,15397,1668,5613,5481,1404,1231,9513,8336,1177,8336,7811,525,2022-01-01,zipcode
ZCTA5 34448,12,10607,45685,903,124600,9613,5505,8553,1208,3568,2512,1042,223,6200,4661,1539,4661,3949,712,2022-01-01,zipcode
ZCTA5 34449,12,3510,49331,755,125000,3162,1605,2915,390,1368,818,259,80,1937,1521,416,1521,1126,395,2022-01-01,zipcode
ZCTA5 34450,12,10005,42815,942,177200,9206,5909,8247,713,2425,3116,1296,697,6624,5004,1620,5004,4003,1001,2022-01-01,zipcode
ZCTA5 34452,12,13592,55122,1080,172600,10886,5192,10235,1032,3875,3947,1095,286,6138,5452,686,5452,4552,900,2022-01-01,zipcode
ZCTA5 34453,12,10108,50803,983,156100,8757,4949,8158,619,3539,2720,899,381,5455,4405,1050,4405,3816,589,2022-01-01,zipcode
ZCTA5 34461,12,12424,55170,997,256300,10727,7055,9705,827,4078,2599,1246,955,5526,4645,881,4645,4097,548,2022-01-01,zipcode
ZCTA5 34465,12,18121,55256,1107,195600,15802,9339,14343,1120,5552,4811,1545,1315,9144,8163,981,8163,6519,1644,2022-01-01,zipcode
ZCTA5 34470,12,20903,47098,1065,152300,17067,7756,14488,1483,4640,5200,2130,1035,9782,8807,975,8807,5010,3797,2022-01-01,zipcode
ZCTA5 34471,12,26614,56382,1126,259000,21589,9602,18696,1256,5072,5814,3509,3045,12011,10884,1127,10884,6576,4308,2022-01-01,zipcode
ZCTA5 34472,12,32528,55798,1132,168900,25983,11775,22205,3038,7793,7250,2557,1567,13526,12240,1286,12240,9477,2763,2022-01-01,zipcode
ZCTA5 34473,12,22902,68253,1272,207500,18053,7541,16091,2075,5892,5370,1831,923,8756,7953,803,7953,6519,1434,2022-01-01,zipcode
ZCTA5 34474,12,19380,58678,1400,168700,15609,6305,13839,1334,4170,4350,2774,1211,8871,7823,1048,7823,3543,4280,2022-01-01,zipcode
ZCTA5 34475,12,15084,33817,849,157400,11716,6279,10004,1478,3999,3129,827,571,5597,4615,982,4615,2063,2552,2022-01-01,zipcode
ZCTA5 34476,12,25106,62283,1247,234700,21531,12028,19732,1175,6633,6504,3186,2234,12397,11346,1051,11346,10355,991,2022-01-01,zipcode
ZCTA5 34479,12,13502,54704,1189,176000,10731,4619,9229,1210,3858,2964,789,408,5964,5389,575,5389,3671,1718,2022-01-01,zipcode
ZCTA5 34480,12,22956,71410,1059,237100,18432,6706,15220,1159,5015,5013,2970,1063,9667,8629,1038,8629,6483,2146,2022-01-01,zipcode
ZCTA5 34481,12,24113,50822,1158,186800,23002,17686,21872,1517,6984,7200,3943,2228,13555,12644,911,12644,11536,1108,2022-01-01,zipcode
ZCTA5 34482,12,22755,64491,861,216200,19616,12203,18186,2832,6880,4768,2468,1238,9543,7871,1672,7871,6613,1258,2022-01-01,zipcode
ZCTA5 34484,12,5090,89563,-666666666,355700,4411,1586,3974,641,1216,1008,576,533,2768,2478,290,2478,1524,954,2022-01-01,zipcode
ZCTA5 34488,12,11687,44047,1012,82300,9618,4589,8307,952,3178,2514,1241,422,6423,4967,1456,4967,3551,1416,2022-01-01,zipcode
ZCTA5 34491,12,32062,64546,1037,219400,27122,15617,25472,3162,9167,7810,3255,2078,15520,13941,1579,13941,12005,1936,2022-01-01,zipcode
ZCTA5 34498,12,629,49833,977,247700,514,342,475,13,200,111,90,61,531,302,229,302,246,56,2022-01-01,zipcode
ZCTA5 34601,12,23054,49856,999,120400,19492,10283,17706,2386,6210,5731,2488,891,12210,10305,1905,10305,7281,3024,2022-01-01,zipcode
ZCTA5 34602,12,9024,73355,1103,235300,7431,3140,6736,678,2501,2043,925,589,3675,3198,477,3198,2855,343,2022-01-01,zipcode
ZCTA5 34604,12,13689,79316,1065,244000,11338,5454,9967,1198,3255,3571,1331,612,4830,4463,367,4463,3946,517,2022-01-01,zipcode
ZCTA5 34606,12,27795,52274,1128,201800,23985,13056,21672,2042,7578,7668,3075,1309,13961,12416,1545,12416,9486,2930,2022-01-01,zipcode
ZCTA5 34607,12,9061,58464,1241,304400,7871,3944,7026,425,1954,3033,998,616,4947,3876,1071,3876,3177,699,2022-01-01,zipcode
ZCTA5 34608,12,36398,58194,1169,208000,29763,14006,26548,3128,8692,9878,3223,1627,15256,14256,1000,14256,10929,3327,2022-01-01,zipcode
ZCTA5 34609,12,44696,71303,1358,244700,36712,16615,32360,3001,9730,12870,4541,2218,18086,16734,1352,16734,13638,3096,2022-01-01,zipcode
ZCTA5 34610,12,16620,67042,1178,229200,13150,4905,11637,1810,3632,3807,1942,446,6389,5820,569,5820,4562,1258,2022-01-01,zipcode
ZCTA5 34613,12,18071,53544,1133,154100,16007,9435,15139,1447,4943,5582,2264,903,10367,8480,1887,8480,7396,1084,2022-01-01,zipcode
ZCTA5 34614,12,8794,84875,-666666666,246700,7179,2898,5863,757,1402,2401,698,605,3233,2970,263,2970,2839,131,2022-01-01,zipcode
ZCTA5 34637,12,10784,111053,1531,360200,8308,4281,7111,448,1398,2047,1927,1291,3562,3242,320,3242,3003,239,2022-01-01,zipcode
ZCTA5 34638,12,33183,113625,2054,341700,24879,7802,21661,1090,4967,6729,5805,3070,11488,10838,650,10838,8752,2086,2022-01-01,zipcode
ZCTA5 34639,12,29953,98750,1700,327400,23790,7919,20438,1217,4773,6944,5190,2314,10867,10470,397,10470,8534,1936,2022-01-01,zipcode
ZCTA5 34652,12,25335,48891,1133,169300,22023,10723,19683,2610,7638,5718,2588,1129,14584,11394,3190,11394,7035,4359,2022-01-01,zipcode
ZCTA5 34653,12,35319,45795,1176,157800,30198,15691,27484,2556,11603,8538,3092,1695,17612,15409,2203,15409,10030,5379,2022-01-01,zipcode
ZCTA5 34654,12,23727,61517,1404,222900,20267,9166,18050,2116,6784,5554,2133,1463,10203,8943,1260,8943,7009,1934,2022-01-01,zipcode
ZCTA5 34655,12,45050,76050,1524,321700,37330,15848,33116,1893,8420,10690,7946,4167,20254,18505,1749,18505,14509,3996,2022-01-01,zipcode
ZCTA5 34661,12,250,29132,-666666666,180100,216,128,216,36,110,51,19,0,255,153,102,153,83,70,2022-01-01,zipcode
ZCTA5 34667,12,29836,49334,1135,185800,26879,15592,25426,2653,10613,7388,2944,1828,19656,15065,4591,15065,11388,3677,2022-01-01,zipcode
ZCTA5 34668,12,49271,43376,1186,142800,40626,20286,35131,4198,15601,10702,3259,1371,23807,20909,2898,20909,12925,7984,2022-01-01,zipcode
ZCTA5 34669,12,14563,54698,1178,202100,11836,5717,10653,1162,4960,3059,1121,351,6551,5713,838,5713,4876,837,2022-01-01,zipcode
ZCTA5 34677,12,22634,83034,1348,327100,18952,7526,16945,893,4438,4929,4086,2599,9943,8789,1154,8789,6799,1990,2022-01-01,zipcode
ZCTA5 34679,12,144,33962,-666666666,-666666666,144,119,144,57,62,25,0,0,118,62,56,62,34,28,2022-01-01,zipcode
ZCTA5 34681,12,994,68000,-666666666,528300,785,276,734,36,122,246,259,71,561,452,109,452,407,45,2022-01-01,zipcode
ZCTA5 34683,12,34031,85956,1442,372900,28506,10152,25786,1531,5713,8270,6741,3531,15602,13792,1810,13792,10935,2857,2022-01-01,zipcode
ZCTA5 34684,12,27607,62541,1677,258300,24040,11737,22084,1045,6094,7478,4984,2483,14497,12988,1509,12988,9356,3632,2022-01-01,zipcode
ZCTA5 34685,12,17869,88867,1665,444800,15093,6678,13625,596,2322,4181,4084,2442,7996,7499,497,7499,5634,1865,2022-01-01,zipcode
ZCTA5 34688,12,9074,110893,1408,461000,7680,3345,6780,222,1357,1876,2060,1265,3614,3408,206,3408,3116,292,2022-01-01,zipcode
ZCTA5 34689,12,27076,62669,1048,284300,23895,11684,21834,1491,6553,6761,4705,2324,14056,12099,1957,12099,9638,2461,2022-01-01,zipcode
ZCTA5 34690,12,11876,42088,1161,116900,10284,4812,9369,1071,4644,2642,708,304,6953,5419,1534,5419,3344,2075,2022-01-01,zipcode
ZCTA5 34691,12,19868,45110,1182,149100,16283,6931,14803,1340,6948,4369,1418,728,12304,9148,3156,9148,5771,3377,2022-01-01,zipcode
ZCTA5 34695,12,17853,98494,1644,356200,14843,5642,13503,397,3249,3914,4066,1877,7931,7255,676,7255,6072,1183,2022-01-01,zipcode
ZCTA5 34698,12,37838,63824,1385,289300,33886,16361,31419,1693,8615,10245,6355,4511,21949,18011,3938,18011,13206,4805,2022-01-01,zipcode
ZCTA5 34705,12,3306,65388,1004,213800,2592,1046,2104,415,719,660,254,56,1240,1131,109,1131,916,215,2022-01-01,zipcode
ZCTA5 34711,12,66744,86419,1737,333600,54899,23636,47805,2591,11624,17449,10658,5483,27006,24526,2480,24526,18775,5751,2022-01-01,zipcode
ZCTA5 34714,12,25047,75029,1517,291200,20107,6122,17116,975,4796,6306,3526,1513,10877,8755,2122,8755,4352,4403,2022-01-01,zipcode
ZCTA5 34715,12,24484,83993,1828,371300,19029,7388,16851,1994,4883,5709,2656,1609,8346,7816,530,7816,5901,1915,2022-01-01,zipcode
ZCTA5 34731,12,11911,55379,1103,163700,10100,4430,8975,677,4079,2664,879,676,6324,4866,1458,4866,4009,857,2022-01-01,zipcode
ZCTA5 34734,12,4502,76017,1974,331400,3093,1041,2666,39,699,903,718,307,1322,1296,26,1296,1105,191,2022-01-01,zipcode
ZCTA5 34736,12,26040,74530,1534,303800,20333,8232,17827,2262,4812,5424,3262,2067,10061,9402,659,9402,8393,1009,2022-01-01,zipcode
ZCTA5 34737,12,3862,68348,1715,322600,3426,1397,3134,584,641,1030,604,275,1889,1733,156,1733,1552,181,2022-01-01,zipcode
ZCTA5 34739,12,782,-666666666,-666666666,174300,676,231,532,132,239,91,20,50,535,361,174,361,247,114,2022-01-01,zipcode
ZCTA5 34741,12,54464,42664,1451,250500,41839,14726,35185,5066,10656,11012,5996,2455,21036,17453,3583,17453,5934,11519,2022-01-01,zipcode
ZCTA5 34743,12,43330,58871,1606,251500,35215,10419,29216,4265,9594,9565,4293,1499,13287,11942,1345,11942,8571,3371,2022-01-01,zipcode
ZCTA5 34744,12,60995,63320,1297,291800,49545,16628,41888,6360,12259,12447,7403,3419,21521,19315,2206,19315,13090,6225,2022-01-01,zipcode
ZCTA5 34746,12,53653,65167,1643,296600,42652,16198,36468,4930,9131,11762,6944,3701,24383,16338,8045,16338,11836,4502,2022-01-01,zipcode
ZCTA5 34747,12,26021,81019,1710,418600,20625,6083,17738,680,3754,4968,5280,3056,21719,9430,12289,9430,5050,4380,2022-01-01,zipcode
ZCTA5 34748,12,43915,50953,1077,203900,38348,23637,34950,3339,11844,12040,4694,3033,24579,20021,4558,20021,14642,5379,2022-01-01,zipcode
ZCTA5 34753,12,6985,64896,1227,234100,5132,1659,4339,1204,994,1505,476,160,2120,2069,51,2069,1516,553,2022-01-01,zipcode
ZCTA5 34756,12,4065,109327,1436,463400,3422,1326,2833,228,696,1005,639,265,1485,1391,94,1391,1085,306,2022-01-01,zipcode
ZCTA5 34758,12,44793,62858,1607,243300,34775,11972,28650,3676,10665,9468,2985,1856,14110,11574,2536,11574,9052,2522,2022-01-01,zipcode
ZCTA5 34759,12,39528,61644,1484,251700,32568,15890,27097,3845,6711,9624,4363,2554,16611,13627,2984,13627,10469,3158,2022-01-01,zipcode
ZCTA5 34760,12,978,116429,1550,311100,840,310,773,32,219,372,105,45,330,310,20,310,264,46,2022-01-01,zipcode
ZCTA5 34761,12,46233,86016,1720,318700,35621,10298,30653,5250,7247,9412,5947,2797,14613,14026,587,14026,9937,4089,2022-01-01,zipcode
ZCTA5 34762,12,319,66250,-666666666,-666666666,270,104,230,18,63,117,32,0,311,130,181,130,130,0,2022-01-01,zipcode
ZCTA5 34769,12,29975,57378,1245,248700,23023,9038,19680,2317,7078,6164,2726,1395,11070,9250,1820,9250,6329,2921,2022-01-01,zipcode
ZCTA5 34771,12,27537,95450,1644,399400,21667,7733,18133,1658,4599,5051,4673,2152,9840,8286,1554,8286,6922,1364,2022-01-01,zipcode
ZCTA5 34772,12,32268,81169,1836,320800,25568,10417,21821,1496,6630,7676,4545,1474,10957,9661,1296,9661,7807,1854,2022-01-01,zipcode
ZCTA5 34773,12,4647,71774,2030,297900,3291,1599,2853,400,651,938,526,338,1605,1384,221,1384,1205,179,2022-01-01,zipcode
ZCTA5 34785,12,18487,42496,1080,139700,16028,10423,15062,2821,6378,3732,1539,592,6808,5831,977,5831,3677,2154,2022-01-01,zipcode
ZCTA5 34786,12,45914,120117,2238,578400,34666,11086,31175,929,3295,9060,11802,6089,17484,15251,2233,15251,10775,4476,2022-01-01,zipcode
ZCTA5 34787,12,86913,108750,1783,440500,65024,19555,56807,4550,11039,14814,16330,10074,30303,28229,2074,28229,20346,7883,2022-01-01,zipcode
ZCTA5 34788,12,22414,53140,1327,154300,19359,9764,17713,1845,6837,5511,2250,1270,11197,9313,1884,9313,7638,1675,2022-01-01,zipcode
ZCTA5 34797,12,1304,123003,-666666666,478300,1139,705,1139,18,270,323,367,161,817,618,199,618,618,0,2022-01-01,zipcode
ZCTA5 34945,12,5608,66917,686,250800,4658,2973,4095,617,1258,1306,606,308,1874,1644,230,1644,1537,107,2022-01-01,zipcode
ZCTA5 34946,12,5825,37511,895,107800,5101,2555,4371,1359,1450,1073,306,183,3261,2575,686,2575,1534,1041,2022-01-01,zipcode
ZCTA5 34947,12,12992,39375,1019,181100,9559,4026,7707,1701,2278,2249,522,957,4741,4136,605,4136,1766,2370,2022-01-01,zipcode
ZCTA5 34949,12,7993,83068,1313,381000,7815,4423,7388,346,1410,2190,1914,1528,8034,4441,3593,4441,3493,948,2022-01-01,zipcode
ZCTA5 34950,12,17623,30451,1041,146800,14192,7399,11998,3966,3671,2669,1250,442,7873,6725,1148,6725,2458,4267,2022-01-01,zipcode
ZCTA5 34951,12,16853,56870,1141,199400,14600,7181,13087,1453,4069,5066,1859,640,8301,7136,1165,7136,6036,1100,2022-01-01,zipcode
ZCTA5 34952,12,41779,57387,1458,221400,35782,16385,32603,2966,10910,11377,5015,2335,21593,17495,4098,17495,12434,5061,2022-01-01,zipcode
ZCTA5 34953,12,78558,79777,1783,294200,62444,20916,53545,5560,16651,19533,8331,3470,26978,25550,1428,25550,22046,3504,2022-01-01,zipcode
ZCTA5 34956,12,9531,48138,819,119100,7432,3894,6229,1982,1875,1746,486,140,2789,2402,387,2402,1753,649,2022-01-01,zipcode
ZCTA5 34957,12,22523,68110,1448,347100,19988,10872,18399,1165,4553,5557,4437,2687,17093,10779,6314,10779,8126,2653,2022-01-01,zipcode
ZCTA5 34972,12,19112,54315,1005,165400,15524,7997,13203,3086,4633,3266,1303,915,7101,6035,1066,6035,4082,1953,2022-01-01,zipcode
ZCTA5 34974,12,23601,48462,942,150000,19516,10067,17599,2978,6627,5300,1974,720,13607,10225,3382,10225,8158,2067,2022-01-01,zipcode
ZCTA5 34981,12,6703,77713,1288,340800,5105,1931,4453,255,1837,1253,524,584,1974,1844,130,1844,1037,807,2022-01-01,zipcode
ZCTA5 34982,12,26727,52820,1162,212000,21970,9499,19163,2889,6751,6094,2410,1019,12177,10833,1344,10833,8001,2832,2022-01-01,zipcode
ZCTA5 34983,12,45943,69031,1641,266300,36932,13599,32948,2613,10816,10568,6128,2823,17147,16114,1033,16114,13634,2480,2022-01-01,zipcode
ZCTA5 34984,12,18691,74976,1798,287300,14999,5561,13699,1791,3811,5127,2025,945,6975,6452,523,6452,5425,1027,2022-01-01,zipcode
ZCTA5 34986,12,29319,80350,1655,348600,25307,14248,22338,1700,6143,6676,4918,2901,14047,11871,2176,11871,9954,1917,2022-01-01,zipcode
ZCTA5 34987,12,14507,80065,1882,351700,12779,7454,11997,465,3107,3567,2881,1977,7128,6360,768,6360,5128,1232,2022-01-01,zipcode
ZCTA5 34990,12,30606,114842,1763,517100,25677,11319,23144,872,3787,7348,6973,4164,13688,12144,1544,12144,10818,1326,2022-01-01,zipcode
ZCTA5 34994,12,17958,60815,1373,223900,15104,7146,13796,1129,3688,4652,2988,1339,9780,7762,2018,7762,4823,2939,2022-01-01,zipcode
ZCTA5 34996,12,10755,82655,1283,394900,9874,5681,9403,348,1923,3022,2198,1912,8712,5620,3092,5620,4768,852,2022-01-01,zipcode
ZCTA5 34997,12,45562,72963,1374,317300,39568,18627,35671,2828,10225,12468,6349,3801,21996,18841,3155,18841,15572,3269,2022-01-01,zipcode
ZCTA5 35004,01,11737,76683,1254,205300,9340,3657,8536,513,3041,3015,1481,486,4661,4573,88,4573,3486,1087,2022-01-01,zipcode
ZCTA5 35005,01,8194,55017,1036,126000,6798,2718,6166,956,2567,1620,725,298,3386,2927,459,2927,2455,472,2022-01-01,zipcode
ZCTA5 35006,01,3391,63521,803,111400,2861,1268,2466,339,1285,719,68,55,1657,1232,425,1232,1140,92,2022-01-01,zipcode
ZCTA5 35007,01,27052,81351,1181,215500,21213,6711,18324,1530,4752,5141,4891,2010,10591,10062,529,10062,8393,1669,2022-01-01,zipcode
ZCTA5 35010,01,20406,46730,650,120000,16313,7683,14259,2712,4602,4393,1505,1047,10546,8149,2397,8149,5762,2387,2022-01-01,zipcode
ZCTA5 35013,01,97,-666666666,-666666666,-666666666,94,8,94,79,0,15,0,0,27,23,4,23,9,14,2022-01-01,zipcode
ZCTA5 35014,01,3317,58250,-666666666,107900,2952,1249,2593,628,853,778,212,122,1761,1483,278,1483,1356,127,2022-01-01,zipcode
ZCTA5 35016,01,17532,55440,718,172600,13776,6227,11872,1277,3841,4277,1714,763,7391,6712,679,6712,4965,1747,2022-01-01,zipcode
ZCTA5 35019,01,2233,58518,698,120700,1827,645,1532,228,556,592,127,29,1026,949,77,949,738,211,2022-01-01,zipcode
ZCTA5 35020,01,25713,31257,828,87000,19935,9855,17469,3064,7207,5370,1268,560,12290,10049,2241,10049,5502,4547,2022-01-01,zipcode
ZCTA5 35022,01,23237,74951,999,227400,18789,7217,16602,1112,4339,5663,3163,2325,10030,9188,842,9188,7479,1709,2022-01-01,zipcode
ZCTA5 35023,01,25335,67141,1138,143000,19928,8052,17510,1889,6372,5791,2482,976,9892,8600,1292,8600,6775,1825,2022-01-01,zipcode
ZCTA5 35031,01,7274,55583,682,131600,5849,2574,5007,873,1620,1662,419,433,3166,2613,553,2613,1976,637,2022-01-01,zipcode
ZCTA5 35032,01,39,-666666666,-666666666,69000,32,23,26,14,12,0,0,0,26,17,9,17,13,4,2022-01-01,zipcode
ZCTA5 35033,01,3297,47896,1042,136400,2545,1134,2271,408,764,782,183,134,1619,1307,312,1307,1178,129,2022-01-01,zipcode
ZCTA5 35034,01,5327,39474,834,125000,4138,2912,3676,1121,1542,623,172,218,1660,1422,238,1422,1002,420,2022-01-01,zipcode
ZCTA5 35035,01,818,-666666666,-666666666,-666666666,674,274,550,120,213,160,42,15,451,451,0,451,329,122,2022-01-01,zipcode
ZCTA5 35036,01,110,-666666666,-666666666,-666666666,110,110,69,11,48,10,0,0,73,69,4,69,11,58,2022-01-01,zipcode
ZCTA5 35040,01,18464,72474,1487,183700,13950,3743,11935,862,2999,4109,2778,1187,7468,6876,592,6876,5506,1370,2022-01-01,zipcode
ZCTA5 35042,01,6127,52209,470,128300,5315,2406,4839,793,1984,1416,284,362,2725,2204,521,2204,1734,470,2022-01-01,zipcode
ZCTA5 35043,01,14564,106660,1348,301200,11010,4151,9600,285,1904,3207,3105,1099,4861,4631,230,4631,4153,478,2022-01-01,zipcode
ZCTA5 35044,01,8389,44964,789,107000,7071,3483,5836,1104,2069,2093,291,279,3932,3494,438,3494,2350,1144,2022-01-01,zipcode
ZCTA5 35045,01,14496,61822,888,179500,11354,5145,10125,1348,4036,2874,901,966,6254,5704,550,5704,3870,1834,2022-01-01,zipcode
ZCTA5 35046,01,5172,66371,693,136300,3940,1627,3353,590,1418,919,264,162,2572,1910,662,1910,1537,373,2022-01-01,zipcode
ZCTA5 35049,01,4001,52879,924,169100,3136,1094,2688,447,1230,732,167,112,1723,1552,171,1552,1105,447,2022-01-01,zipcode
ZCTA5 35051,01,9879,65563,830,230000,8051,3767,7003,1097,2696,1844,862,504,3542,3292,250,3292,2608,684,2022-01-01,zipcode
ZCTA5 35052,01,257,-666666666,-666666666,-666666666,257,257,257,65,83,52,12,45,24,24,0,24,0,24,2022-01-01,zipcode
ZCTA5 35053,01,3073,61324,932,231800,2343,1214,2228,257,670,764,386,151,2398,1146,1252,1146,1098,48,2022-01-01,zipcode
ZCTA5 35054,01,4649,83315,1311,259000,3690,1542,3103,369,940,1063,402,329,2076,1742,334,1742,1559,183,2022-01-01,zipcode
ZCTA5 35055,01,22521,56769,851,185300,18373,7796,15893,1877,4220,5412,2991,1393,10532,9406,1126,9406,6149,3257,2022-01-01,zipcode
ZCTA5 35057,01,15058,73669,856,174700,11916,4318,10150,1527,3280,3650,988,705,6139,5213,926,5213,4316,897,2022-01-01,zipcode
ZCTA5 35058,01,10555,58631,874,170100,8590,3076,7577,1190,2778,2499,749,361,4446,3973,473,3973,2960,1013,2022-01-01,zipcode
ZCTA5 35060,01,296,-666666666,-666666666,109000,247,67,220,0,111,92,0,17,243,156,87,156,156,0,2022-01-01,zipcode
ZCTA5 35061,01,1389,59010,1219,172000,1236,473,1049,40,462,409,104,34,587,417,170,417,256,161,2022-01-01,zipcode
ZCTA5 35062,01,8623,64669,725,177700,7060,3269,6150,814,2278,1940,853,265,3699,3235,464,3235,2666,569,2022-01-01,zipcode
ZCTA5 35063,01,3408,53750,888,85300,2827,1266,2450,522,980,819,83,46,1641,1264,377,1264,1112,152,2022-01-01,zipcode
ZCTA5 35064,01,9995,45685,998,116500,7907,3583,6195,283,2494,1989,985,444,4858,3792,1066,3792,2139,1653,2022-01-01,zipcode
ZCTA5 35068,01,8016,74066,1104,182900,6292,2153,5600,586,1468,1891,882,773,3704,3564,140,3564,2642,922,2022-01-01,zipcode
ZCTA5 35070,01,122,64196,-666666666,132300,113,81,113,13,48,36,16,0,47,47,0,47,47,0,2022-01-01,zipcode
ZCTA5 35071,01,17459,78914,1161,228100,13676,5023,11919,988,3647,3680,2289,1315,7277,6836,441,6836,5231,1605,2022-01-01,zipcode
ZCTA5 35072,01,4508,49464,593,99700,3436,1850,3137,498,1291,871,355,122,2369,1710,659,1710,1363,347,2022-01-01,zipcode
ZCTA5 35073,01,2898,49960,811,110300,2528,974,2209,414,681,684,317,113,1489,1277,212,1277,863,414,2022-01-01,zipcode
ZCTA5 35074,01,112,-666666666,-666666666,-666666666,112,0,112,53,0,59,0,0,59,59,0,59,0,59,2022-01-01,zipcode
ZCTA5 35077,01,13789,46624,821,144000,11506,5411,10010,2118,3439,3153,755,545,6204,5422,782,5422,3889,1533,2022-01-01,zipcode
ZCTA5 35078,01,2089,71348,778,190500,1650,629,1486,167,443,595,196,85,1027,833,194,833,693,140,2022-01-01,zipcode
ZCTA5 35079,01,9301,73040,893,173500,7522,3228,6405,848,2417,2079,768,293,3681,3217,464,3217,2935,282,2022-01-01,zipcode
ZCTA5 35080,01,19561,106660,1483,256100,14716,4327,12589,473,2231,3910,4085,1890,7123,6656,467,6656,6065,591,2022-01-01,zipcode
ZCTA5 35082,01,0,-666666666,-666666666,-666666666,0,0,0,0,0,0,0,0,0,0,0,0,0,0,2022-01-01,zipcode
ZCTA5 35083,01,3922,46146,873,148100,3057,1133,2620,630,832,899,160,99,1494,1397,97,1397,1180,217,2022-01-01,zipcode
ZCTA5 35085,01,9246,66771,846,113900,7435,2831,6053,1448,2627,1190,509,279,3752,3327,425,3327,2738,589,2022-01-01,zipcode
ZCTA5 35087,01,2923,60197,903,151600,2306,801,2029,230,442,941,268,148,1102,1102,0,1102,976,126,2022-01-01,zipcode
ZCTA5 35089,01,1697,56696,743,93700,1600,742,1375,201,754,372,18,30,799,681,118,681,594,87,2022-01-01,zipcode
ZCTA5 35091,01,3407,106953,1042,263900,2563,691,2286,143,401,1041,330,371,1488,1222,266,1222,1149,73,2022-01-01,zipcode
ZCTA5 35094,01,15406,69548,967,202100,12217,4324,10939,1431,2823,3676,1901,1108,6695,5834,861,5834,4549,1285,2022-01-01,zipcode
ZCTA5 35096,01,8586,70780,1002,169600,6775,2644,5820,792,2033,1946,704,345,3866,3148,718,3148,2765,383,2022-01-01,zipcode
ZCTA5 35097,01,1930,72917,1026,124700,1664,791,1451,420,488,381,109,53,871,780,91,780,716,64,2022-01-01,zipcode
ZCTA5 35098,01,1161,60670,739,106700,920,426,763,121,176,385,81,0,582,481,101,481,307,174,2022-01-01,zipcode
ZCTA5 35111,01,19418,81162,1241,244600,15692,5968,13286,1004,3625,4670,2604,1383,7476,7089,387,7089,6535,554,2022-01-01,zipcode
ZCTA5 35112,01,0,-666666666,-666666666,-666666666,0,0,0,0,0,0,0,0,51,0,51,0,0,0,2022-01-01,zipcode
ZCTA5 35114,01,8548,94778,1220,260600,6628,2160,5554,156,1050,1848,1449,1051,3023,2921,102,2921,2572,349,2022-01-01,zipcode
ZCTA5 35115,01,16709,54746,845,155700,13438,5429,10028,1703,3047,2953,1720,605,6237,5764,473,5764,4133,1631,2022-01-01,zipcode
ZCTA5 35116,01,5218,85208,1049,206300,4037,1445,3653,306,1062,1282,733,270,2114,1953,161,1953,1787,166,2022-01-01,zipcode
ZCTA5 35117,01,6002,94907,1152,195400,4896,1773,4122,309,1179,1711,688,235,2594,2288,306,2288,2187,101,2022-01-01,zipcode
ZCTA5 35118,01,3052,67792,924,143100,2352,1098,2014,218,861,667,171,97,1220,1021,199,1021,816,205,2022-01-01,zipcode
ZCTA5 35119,01,0,-666666666,-666666666,-666666666,0,0,0,0,0,0,0,0,0,0,0,0,0,0,2022-01-01,zipcode
ZCTA5 35120,01,17943,73186,909,180900,13656,4712,11730,1568,4545,3685,1234,698,6810,6289,521,6289,5257,1032,2022-01-01,zipcode
ZCTA5 35121,01,16591,51098,703,149400,13264,6895,11448,2577,3499,3538,1128,706,6934,6203,731,6203,4371,1832,2022-01-01,zipcode
ZCTA5 35124,01,24408,91836,1354,263700,19517,5957,17336,884,3272,4871,5088,3221,9581,9286,295,9286,7822,1464,2022-01-01,zipcode
ZCTA5 35125,01,10759,61865,1009,173800,8589,3513,7181,1249,2733,2061,785,353,4519,4017,502,4017,2707,1310,2022-01-01,zipcode
ZCTA5 35126,01,21612,79723,1095,174600,17411,6053,14736,1355,5323,5470,1992,596,8340,7606,734,7606,6757,849,2022-01-01,zipcode
ZCTA5 35127,01,9549,72917,1183,173100,8272,3185,6708,492,1601,3100,940,575,3877,3553,324,3553,2744,809,2022-01-01,zipcode
ZCTA5 35128,01,10264,79226,1172,219600,8440,3034,7503,749,2498,2667,1133,456,4511,4009,502,4009,3302,707,2022-01-01,zipcode
ZCTA5 35130,01,3171,46000,535,108300,2682,1610,2351,402,1051,721,94,83,1885,1394,491,1394,1133,261,2022-01-01,zipcode
ZCTA5 35131,01,3373,42639,746,94600,2779,1445,2494,431,974,627,378,84,1833,1406,427,1406,1144,262,2022-01-01,zipcode
ZCTA5 35133,01,2922,56853,796,165000,2378,1124,2211,355,763,895,121,77,1414,1175,239,1175,1064,111,2022-01-01,zipcode
ZCTA5 35135,01,1917,56250,1130,251000,1555,615,1387,277,532,273,216,89,855,775,80,775,603,172,2022-01-01,zipcode
ZCTA5 35136,01,2009,55221,365,125800,1722,1030,1527,159,582,571,186,29,1238,788,450,788,663,125,2022-01-01,zipcode
ZCTA5 35143,01,3122,73788,766,218500,2741,1266,2363,193,848,754,514,54,2029,1296,733,1296,1099,197,2022-01-01,zipcode
ZCTA5 35146,01,12908,79200,679,245400,10871,5291,9235,1162,3051,2851,1496,675,4480,4190,290,4190,3635,555,2022-01-01,zipcode
ZCTA5 35147,01,6465,87788,1594,277200,5090,1576,4307,304,768,1405,1304,526,2377,2274,103,2274,2035,239,2022-01-01,zipcode
ZCTA5 35148,01,2418,52991,638,129900,2083,916,1828,303,624,728,98,75,1212,979,233,979,683,296,2022-01-01,zipcode
ZCTA5 35149,01,77,-666666666,-666666666,-666666666,77,0,77,0,77,0,0,0,77,77,0,77,77,0,2022-01-01,zipcode
ZCTA5 35150,01,17283,41240,707,138300,13495,6303,12016,1909,4321,4200,941,645,8362,7233,1129,7233,4207,3026,2022-01-01,zipcode
ZCTA5 35151,01,7289,59489,960,146300,5992,2513,5483,768,1716,1694,851,454,3553,2914,639,2914,2562,352,2022-01-01,zipcode
ZCTA5 35160,01,26649,44852,707,124300,22423,12007,19212,3906,6966,5402,1863,1075,12959,10398,2561,10398,6759,3639,2022-01-01,zipcode
ZCTA5 35171,01,3642,66651,-666666666,177100,2979,1551,2638,529,840,900,257,112,1413,1332,81,1332,1036,296,2022-01-01,zipcode
ZCTA5 35172,01,2842,43125,799,97500,2367,1059,2078,276,1089,610,100,3,1248,1069,179,1069,794,275,2022-01-01,zipcode
ZCTA5 35173,01,31103,114483,1200,311000,24711,8256,21278,1063,4738,6462,5931,3084,11572,11027,545,11027,9909,1118,2022-01-01,zipcode
ZCTA5 35175,01,4986,69419,856,164100,4117,1917,3637,372,1323,1076,476,390,2321,2077,244,2077,1748,329,2022-01-01,zipcode
ZCTA5 35176,01,798,28029,817,104300,678,353,625,219,211,130,17,48,357,357,0,357,244,113,2022-01-01,zipcode
ZCTA5 35178,01,2632,36065,821,134700,2176,1133,1968,272,1040,391,177,88,1544,1176,368,1176,969,207,2022-01-01,zipcode
ZCTA5 35179,01,8835,62434,800,168300,7260,3372,5889,822,2004,2062,705,296,3610,3042,568,3042,2633,409,2022-01-01,zipcode
ZCTA5 35180,01,14418,74234,860,183300,11137,4877,9455,956,3527,3516,1026,430,5481,4960,521,4960,4163,797,2022-01-01,zipcode
ZCTA5 35183,01,1101,71488,-666666666,117000,1036,576,993,226,464,268,9,26,467,365,102,365,297,68,2022-01-01,zipcode
ZCTA5 35184,01,6153,44172,829,105200,4769,2272,4073,810,1892,1153,182,36,2509,1963,546,1963,1516,447,2022-01-01,zipcode
ZCTA5 35186,01,5189,89143,1055,272000,4175,1728,3692,336,1013,1304,750,289,2124,1994,130,1994,1669,325,2022-01-01,zipcode
ZCTA5 35188,01,2701,65996,916,180300,2055,852,1774,293,759,568,106,48,964,775,189,775,682,93,2022-01-01,zipcode
ZCTA5 35203,01,3157,42596,729,284800,2917,1620,2633,480,834,360,490,469,1924,1542,382,1542,381,1161,2022-01-01,zipcode
ZCTA5 35204,01,9343,30414,718,80000,7840,4240,6687,1189,2881,1734,564,319,5411,4140,1271,4140,1774,2366,2022-01-01,zipcode
ZCTA5 35205,01,19047,48681,978,268900,17842,6806,12325,547,1555,3222,3687,3314,11781,9309,2472,9309,2857,6452,2022-01-01,zipcode
ZCTA5 35206,01,16477,38671,966,110700,13670,6011,12107,1750,4428,3974,1360,595,8033,6464,1569,6464,3091,3373,2022-01-01,zipcode
ZCTA5 35207,01,6820,27939,743,71700,5468,2947,4766,1097,1485,1587,364,233,3961,3152,809,3152,1753,1399,2022-01-01,zipcode
ZCTA5 35208,01,14629,34669,938,86100,11798,6192,10096,1234,3792,3443,1204,423,7484,5851,1633,5851,3608,2243,2022-01-01,zipcode
ZCTA5 35209,01,29884,74742,1186,436100,23057,6025,18682,776,2459,3682,6559,5206,15134,12520,2614,12520,6455,6065,2022-01-01,zipcode
ZCTA5 35210,01,13230,70902,1094,205400,11581,4354,10613,643,2640,2914,2642,1774,6859,5919,940,5919,4262,1657,2022-01-01,zipcode
ZCTA5 35211,01,24795,32677,969,89100,19510,8298,16449,2089,5027,5833,2427,1073,14143,11127,3016,11127,4630,6497,2022-01-01,zipcode
ZCTA5 35212,01,10136,28216,688,183000,7130,2621,6467,837,1797,1665,1221,947,5339,4205,1134,4205,1779,2426,2022-01-01,zipcode
ZCTA5 35213,01,15551,137879,1687,664500,12101,3565,10575,63,312,998,5047,4155,6583,6328,255,6328,4902,1426,2022-01-01,zipcode
ZCTA5 35214,01,17507,55703,874,144400,15212,6657,13296,1248,3929,4311,2549,1259,8224,7007,1217,7007,4669,2338,2022-01-01,zipcode
ZCTA5 35215,01,46738,47975,1031,134700,34299,13273,28618,3661,9985,9652,3542,1778,19665,16989,2676,16989,9338,7651,2022-01-01,zipcode
ZCTA5 35216,01,38352,68237,1257,353600,29458,8981,24747,1312,3779,6615,8102,4939,16836,15547,1289,15547,8620,6927,2022-01-01,zipcode
ZCTA5 35217,01,12630,37220,874,106200,10294,4580,8786,1688,3117,3041,577,363,6196,5213,983,5213,2460,2753,2022-01-01,zipcode
ZCTA5 35218,01,6962,32095,883,74700,5701,2941,4958,904,1578,2082,251,143,3447,2586,861,2586,1070,1516,2022-01-01,zipcode
ZCTA5 35221,01,3034,33660,968,71400,2657,1579,2386,498,639,968,233,48,2273,1399,874,1399,887,512,2022-01-01,zipcode
ZCTA5 35222,01,8387,77500,948,367300,6924,2100,6230,370,829,1218,1860,1953,4234,3640,594,3640,2111,1529,2022-01-01,zipcode
ZCTA5 35223,01,11226,151550,1746,697200,8864,3678,8003,58,370,1128,3478,2969,4720,4361,359,4361,3878,483,2022-01-01,zipcode
ZCTA5 35224,01,5483,43551,977,78500,4180,1792,3526,377,1510,1315,236,88,2758,1978,780,1978,1093,885,2022-01-01,zipcode
ZCTA5 35226,01,38079,121975,1455,366300,29457,8715,26086,668,2147,5499,9522,8250,15109,14378,731,14378,11561,2817,2022-01-01,zipcode
ZCTA5 35228,01,10016,46114,978,79900,7871,3277,6809,950,2538,2017,979,325,4334,3688,646,3688,2255,1433,2022-01-01,zipcode
ZCTA5 35229,01,2514,-666666666,-666666666,-666666666,2514,1679,5,0,0,5,0,0,0,0,0,0,0,0,2022-01-01,zipcode
ZCTA5 35233,01,2787,57740,1548,322600,2748,626,1709,26,105,73,361,1144,2268,1880,388,1880,210,1670,2022-01-01,zipcode
ZCTA5 35234,01,4195,23273,723,67400,3701,2210,3488,763,1367,1035,278,45,2478,1713,765,1713,938,775,2022-01-01,zipcode
ZCTA5 35235,01,20043,59476,1171,145300,15670,5852,13546,900,3654,5081,2613,1298,8930,8058,872,8058,5194,2864,2022-01-01,zipcode
ZCTA5 35242,01,56466,115541,1368,433800,47150,16376,40485,1465,4424,8571,16174,9851,24835,23290,1545,23290,17107,6183,2022-01-01,zipcode
ZCTA5 35243,01,18575,102163,1478,458000,15377,5172,13631,211,1500,2406,5394,4120,10226,8927,1299,8927,5094,3833,2022-01-01,zipcode
ZCTA5 35244,01,36783,106338,1381,357000,29037,8836,25354,832,3404,6247,8245,6626,15155,14198,957,14198,9912,4286,2022-01-01,zipcode
ZCTA5 35254,01,1795,-666666666,-666666666,-666666666,1795,1309,0,0,0,0,0,0,0,0,0,0,0,0,2022-01-01,zipcode
ZCTA5 35401,01,39168,27497,885,132400,34882,18596,17364,2538,5853,4400,2718,1855,19315,12671,6644,12671,4144,8527,2022-01-01,zipcode
ZCTA5 35404,01,23373,44676,974,182400,18994,6842,12992,1384,4325,3957,1925,1401,11305,8343,2962,8343,4073,4270,2022-01-01,zipcode
ZCTA5 35405,01,49196,60210,1030,214200,40196,13134,33203,2526,10068,10383,6379,3847,22266,19758,2508,19758,10558,9200,2022-01-01,zipcode
ZCTA5 35406,01,19062,117945,1320,438500,15195,5642,12989,345,1079,2538,4499,4528,8436,7625,811,7625,5792,1833,2022-01-01,zipcode
ZCTA5 35441,01,907,50714,-666666666,73500,726,316,652,97,262,196,45,52,820,332,488,332,317,15,2022-01-01,zipcode
ZCTA5 35442,01,5450,30509,601,113000,4486,2906,4119,909,1484,1155,349,222,2076,1666,410,1666,900,766,2022-01-01,zipcode
ZCTA5 35443,01,1359,23438,441,53700,1250,761,1192,125,658,325,17,67,1013,513,500,513,410,103,2022-01-01,zipcode
ZCTA5 35444,01,4012,58750,856,163000,3394,1281,2931,374,1050,1078,352,77,1807,1574,233,1574,1258,316,2022-01-01,zipcode
ZCTA5 35446,01,2162,50357,783,-666666666,1708,753,1464,262,593,459,125,25,749,738,11,738,617,121,2022-01-01,zipcode
ZCTA5 35447,01,3025,40184,596,137500,2650,1459,2371,311,1137,636,175,112,1707,1279,428,1279,975,304,2022-01-01,zipcode
ZCTA5 35452,01,4018,61422,1259,171300,3342,1413,2740,320,939,1041,319,121,1720,1547,173,1547,1355,192,2022-01-01,zipcode
ZCTA5 35453,01,12130,69949,881,164400,9509,3316,8209,954,3352,2500,802,601,4991,4348,643,4348,3660,688,2022-01-01,zipcode
ZCTA5 35456,01,4639,51325,969,169300,3672,1484,2942,445,1209,1017,128,143,2054,1707,347,1707,1152,555,2022-01-01,zipcode
ZCTA5 35457,01,51,-666666666,-666666666,-666666666,51,0,51,0,51,0,0,0,51,51,0,51,51,0,2022-01-01,zipcode
ZCTA5 35458,01,912,-666666666,-666666666,-666666666,678,260,451,75,51,167,0,158,276,228,48,228,184,44,2022-01-01,zipcode
ZCTA5 35459,01,761,31354,717,-666666666,694,421,527,134,238,99,22,34,457,347,110,347,269,78,2022-01-01,zipcode
ZCTA5 35460,01,839,27727,-666666666,118200,715,490,568,19,209,240,100,0,474,414,60,414,366,48,2022-01-01,zipcode
ZCTA5 35461,01,2006,60461,1138,178000,1727,794,1497,158,602,463,156,118,1078,856,222,856,822,34,2022-01-01,zipcode
ZCTA5 35462,01,4234,32973,726,99000,3230,1841,3107,716,845,901,413,232,2328,1765,563,1765,1229,536,2022-01-01,zipcode
ZCTA5 35463,01,2130,75559,-666666666,196500,1777,618,1465,238,559,457,143,68,878,699,179,699,637,62,2022-01-01,zipcode
ZCTA5 35464,01,563,14722,491,-666666666,440,294,282,26,98,104,54,0,257,166,91,166,63,103,2022-01-01,zipcode
ZCTA5 35466,01,5513,59535,647,110100,4391,1951,3529,388,1242,1229,399,271,2444,2046,398,2046,1748,298,2022-01-01,zipcode
ZCTA5 35469,01,271,60182,-666666666,57600,185,121,161,0,12,84,61,4,126,126,0,126,102,24,2022-01-01,zipcode
ZCTA5 35470,01,5045,27441,811,144200,4154,2142,2261,165,657,675,369,395,1880,1482,398,1482,886,596,2022-01-01,zipcode
ZCTA5 35473,01,19844,70047,893,232500,15467,5150,12418,1183,2733,3797,3027,1678,8481,8060,421,8060,5109,2951,2022-01-01,zipcode
ZCTA5 35474,01,8344,73293,857,171800,6681,2152,5096,777,1645,1299,654,721,2943,2578,365,2578,2267,311,2022-01-01,zipcode
ZCTA5 35475,01,18908,98313,832,279000,14818,5101,12677,536,3599,4460,2545,1537,7378,6697,681,6697,6217,480,2022-01-01,zipcode
ZCTA5 35476,01,8240,60347,920,178200,6627,2349,5714,623,1718,2029,827,517,3464,3112,352,3112,1121,1991,2022-01-01,zipcode
ZCTA5 35477,01,114,-666666666,-666666666,-666666666,47,16,47,0,29,14,4,0,50,32,18,32,32,0,2022-01-01,zipcode
ZCTA5 35480,01,1828,100000,-666666666,229200,1429,578,992,110,302,391,166,23,584,490,94,490,472,18,2022-01-01,zipcode
ZCTA5 35481,01,3171,43950,436,93600,2623,1325,2135,293,1001,641,122,78,1523,1319,204,1319,856,463,2022-01-01,zipcode
ZCTA5 35490,01,4947,73190,876,165800,4078,1366,3122,510,1252,977,295,88,1893,1652,241,1652,1359,293,2022-01-01,zipcode
ZCTA5 35501,01,10126,52927,680,164100,7815,3454,6527,996,2128,2320,571,512,4426,3471,955,3471,2171,1300,2022-01-01,zipcode
ZCTA5 35503,01,10070,58924,711,150200,8068,3552,7329,1053,2323,2576,969,408,4640,3901,739,3901,3248,653,2022-01-01,zipcode
ZCTA5 35504,01,12942,67514,766,174400,10159,4519,8896,1246,2580,2891,1395,784,5730,4961,769,4961,3866,1095,2022-01-01,zipcode
ZCTA5 35540,01,2228,47230,608,106200,1635,652,1493,141,693,488,129,42,1095,894,201,894,729,165,2022-01-01,zipcode
ZCTA5 35541,01,4141,42111,856,164300,3440,1859,3020,517,1045,907,342,209,2621,1555,1066,1555,1266,289,2022-01-01,zipcode
ZCTA5 35542,01,819,32356,-666666666,87900,663,379,559,81,172,260,44,2,431,373,58,373,354,19,2022-01-01,zipcode
ZCTA5 35543,01,1264,26250,609,102400,989,565,802,336,243,148,58,17,604,490,114,490,352,138,2022-01-01,zipcode
ZCTA5 35544,01,991,51270,843,-666666666,946,495,931,245,235,264,137,50,441,407,34,407,295,112,2022-01-01,zipcode
ZCTA5 35545,01,133,52917,-666666666,120000,110,51,95,20,28,42,3,2,48,45,3,45,32,13,2022-01-01,zipcode
ZCTA5 35546,01,4065,59604,578,118700,3040,1341,2583,373,1160,779,167,104,1706,1369,337,1369,1156,213,2022-01-01,zipcode
ZCTA5 35548,01,1963,45682,402,81400,1618,745,1398,366,428,459,119,26,928,792,136,792,622,170,2022-01-01,zipcode
ZCTA5 35549,01,3128,43061,534,59600,2616,1293,2266,468,786,909,51,52,1813,1359,454,1359,1064,295,2022-01-01,zipcode
ZCTA5 35550,01,5288,44516,448,89000,4291,2333,3792,650,1430,1253,278,181,2430,1974,456,1974,1569,405,2022-01-01,zipcode
ZCTA5 35552,01,1230,63405,383,83800,1009,297,794,72,313,235,146,28,524,413,111,413,354,59,2022-01-01,zipcode
ZCTA5 35553,01,4831,41938,539,80900,3902,1805,3194,691,1422,701,183,197,2333,1823,510,1823,1435,388,2022-01-01,zipcode
ZCTA5 35554,01,1246,37388,643,68500,983,476,823,159,298,283,78,5,639,490,149,490,394,96,2022-01-01,zipcode
ZCTA5 35555,01,9953,45787,609,125600,8292,3983,7076,1025,2739,2167,685,460,4935,3698,1237,3698,2520,1178,2022-01-01,zipcode
ZCTA5 35559,01,85,25909,-666666666,-666666666,83,18,72,4,57,11,0,0,18,18,0,18,7,11,2022-01-01,zipcode
ZCTA5 35563,01,3733,47095,548,101700,3018,1412,2501,256,965,1016,194,70,1908,1378,530,1378,1040,338,2022-01-01,zipcode
ZCTA5 35564,01,2090,36929,561,106400,1657,870,1424,277,450,587,82,28,1068,856,212,856,643,213,2022-01-01,zipcode
ZCTA5 35565,01,10966,48558,671,86500,8952,4403,8076,1908,3208,2153,382,425,5681,4228,1453,4228,3120,1108,2022-01-01,zipcode
ZCTA5 35570,01,10775,52454,571,113700,9157,4868,7791,1591,2895,2225,648,432,5154,4035,1119,4035,2723,1312,2022-01-01,zipcode
ZCTA5 35571,01,772,48977,575,86700,551,269,465,55,225,139,30,16,402,281,121,281,248,33,2022-01-01,zipcode
ZCTA5 35572,01,1448,65674,-666666666,312200,1363,654,1203,281,598,180,101,43,1168,652,516,652,634,18,2022-01-01,zipcode
ZCTA5 35574,01,1346,52386,538,139400,1103,512,1088,176,549,289,36,38,715,559,156,559,486,73,2022-01-01,zipcode
ZCTA5 35575,01,1090,47759,767,76700,869,445,792,133,274,289,45,51,581,440,141,440,360,80,2022-01-01,zipcode
ZCTA5 35576,01,3517,64155,520,111900,2781,1160,2435,310,1039,833,174,79,1705,1223,482,1223,1063,160,2022-01-01,zipcode
ZCTA5 35577,01,4,-666666666,-666666666,-666666666,4,4,4,0,2,2,0,0,4,2,2,2,2,0,2022-01-01,zipcode
ZCTA5 35578,01,5029,49500,1004,97500,4114,1977,3315,463,1426,1025,221,180,2337,2006,331,2006,1741,265,2022-01-01,zipcode
ZCTA5 35579,01,3552,43693,544,102100,2937,1763,2672,545,1228,693,170,36,1604,1383,221,1383,1157,226,2022-01-01,zipcode
ZCTA5 35580,01,3748,55875,685,102400,3014,1389,2770,678,1046,715,212,119,1834,1364,470,1364,1199,165,2022-01-01,zipcode
ZCTA5 35581,01,5904,48025,676,109700,4559,2185,3834,773,1376,1226,286,173,2379,1935,444,1935,1486,449,2022-01-01,zipcode
ZCTA5 35582,01,4518,37991,489,102700,3638,1530,3306,508,1389,662,605,142,2353,1927,426,1927,1270,657,2022-01-01,zipcode
ZCTA5 35584,01,211,23750,-666666666,51300,211,149,181,86,65,26,0,4,132,97,35,97,64,33,2022-01-01,zipcode
ZCTA5 35585,01,1838,64583,-666666666,209500,1221,597,1047,195,169,346,272,65,690,521,169,521,461,60,2022-01-01,zipcode
ZCTA5 35586,01,3703,44100,498,88300,2690,1210,2273,364,941,753,123,92,1870,1280,590,1280,977,303,2022-01-01,zipcode
ZCTA5 35587,01,734,40288,778,-666666666,620,367,620,222,266,103,0,29,440,314,126,314,238,76,2022-01-01,zipcode
ZCTA5 35592,01,4196,41343,487,120400,3464,1938,3161,697,1303,896,122,143,2420,1686,734,1686,1069,617,2022-01-01,zipcode
ZCTA5 35593,01,1602,58966,646,99600,1413,621,1261,176,652,261,78,94,791,595,196,595,540,55,2022-01-01,zipcode
ZCTA5 35594,01,7094,53651,669,150500,5869,2581,5338,778,1946,1926,331,357,3330,2696,634,2696,2038,658,2022-01-01,zipcode
ZCTA5 35601,01,34817,46276,804,135100,27130,11402,23236,5449,6628,6754,3010,1395,14880,13307,1573,13307,7913,5394,2022-01-01,zipcode
ZCTA5 35603,01,32372,71453,790,218800,26368,10526,22734,2147,6483,7366,4487,2251,14610,13731,879,13731,10016,3715,2022-01-01,zipcode
ZCTA5 35610,01,1739,66150,-666666666,125700,1568,671,1251,109,491,336,135,180,717,673,44,673,589,84,2022-01-01,zipcode
ZCTA5 35611,01,28375,54094,747,169600,23205,9872,20099,3419,5871,6567,2951,1291,13614,11707,1907,11707,7087,4620,2022-01-01,zipcode
ZCTA5 35613,01,22278,96542,1044,271100,18270,7223,16175,1570,3865,4878,3842,2020,8713,8256,457,8256,7192,1064,2022-01-01,zipcode
ZCTA5 35614,01,6753,56415,955,170900,5167,2179,4458,683,1731,1191,530,323,3029,2467,562,2467,1900,567,2022-01-01,zipcode
ZCTA5 35615,01,0,-666666666,-666666666,-666666666,0,0,0,0,0,0,0,0,43,0,43,0,0,0,2022-01-01,zipcode
ZCTA5 35616,01,3599,46992,771,92300,2877,1223,2519,394,1016,800,194,115,1969,1448,521,1448,1027,421,2022-01-01,zipcode
ZCTA5 35618,01,1891,45820,555,100200,1601,854,1397,171,591,436,85,114,970,830,140,830,613,217,2022-01-01,zipcode
ZCTA5 35619,01,4739,62750,970,150100,3809,1565,3322,702,1291,942,295,92,2226,1780,446,1780,1501,279,2022-01-01,zipcode
ZCTA5 35620,01,11648,80145,959,175700,9634,3361,7799,825,2925,3013,585,451,4581,4190,391,4190,3611,579,2022-01-01,zipcode
ZCTA5 35621,01,3242,80938,1054,155200,2206,755,2057,222,456,860,465,54,1107,1052,55,1052,983,69,2022-01-01,zipcode
ZCTA5 35622,01,6650,54891,846,144400,5278,2516,4705,586,2181,1297,448,193,2849,2450,399,2450,1869,581,2022-01-01,zipcode
ZCTA5 35630,01,33252,41174,757,148700,27416,11923,21414,2892,7609,5695,3244,1974,17302,14590,2712,14590,6289,8301,2022-01-01,zipcode
ZCTA5 35633,01,20720,65385,819,163200,17075,7258,14828,1781,5295,3939,2416,1397,9093,8267,826,8267,6817,1450,2022-01-01,zipcode
ZCTA5 35634,01,10272,71475,827,252200,8643,3729,7818,401,2399,2462,1640,916,5046,4236,810,4236,3405,831,2022-01-01,zipcode
ZCTA5 35640,01,26909,69233,788,176900,21768,9081,18530,1912,6547,5475,2872,1724,11258,10194,1064,10194,8203,1991,2022-01-01,zipcode
ZCTA5 35643,01,4008,50966,725,111100,3221,1552,2871,991,917,623,166,174,1749,1559,190,1559,1384,175,2022-01-01,zipcode
ZCTA5 35645,01,13575,81364,874,211200,10710,3902,9446,737,3203,2871,1620,1015,5676,5042,634,5042,4216,826,2022-01-01,zipcode
ZCTA5 35646,01,4038,54837,661,109900,3603,1854,3226,690,1478,803,119,136,2188,1719,469,1719,1451,268,2022-01-01,zipcode
ZCTA5 35647,01,989,93793,743,184000,731,265,622,83,177,171,140,51,367,334,33,334,320,14,2022-01-01,zipcode
ZCTA5 35648,01,3184,66897,648,143700,2593,1007,2199,286,801,689,200,223,1315,1178,137,1178,975,203,2022-01-01,zipcode
ZCTA5 35649,01,93,-666666666,-666666666,-666666666,81,46,74,1,8,12,37,16,40,36,4,36,36,0,2022-01-01,zipcode
ZCTA5 35650,01,13101,54230,621,143200,10915,5322,9450,1436,3916,2421,1012,665,6000,5201,799,5201,4157,1044,2022-01-01,zipcode
ZCTA5 35651,01,1384,72552,-666666666,220600,1179,575,967,132,364,177,275,19,589,461,128,461,400,61,2022-01-01,zipcode
ZCTA5 35652,01,9268,66512,786,165600,7634,2961,6666,854,2327,1880,1051,554,4698,3751,947,3751,3059,692,2022-01-01,zipcode
ZCTA5 35653,01,10956,52648,676,107400,8331,3057,6954,1727,2463,1786,621,357,4508,3559,949,3559,2576,983,2022-01-01,zipcode
ZCTA5 35654,01,8314,43327,589,149600,6711,3273,5729,1205,2669,1296,388,171,3699,3111,588,3111,2149,962,2022-01-01,zipcode
ZCTA5 35660,01,9433,40357,765,122100,7781,3528,6706,1048,2271,2261,720,406,5224,4380,844,4380,2579,1801,2022-01-01,zipcode
ZCTA5 35661,01,18982,68659,950,176600,15781,6299,14074,1545,4464,5039,1875,1151,8796,7667,1129,7667,5885,1782,2022-01-01,zipcode
ZCTA5 35670,01,7181,52284,722,152600,5582,2389,4944,966,1204,1644,833,297,3086,2531,555,2531,1926,605,2022-01-01,zipcode
ZCTA5 35671,01,1526,58246,637,96100,1373,577,1309,317,579,220,162,31,642,537,105,537,500,37,2022-01-01,zipcode
ZCTA5 35672,01,5387,53204,636,121400,4113,1928,3663,465,1642,1082,277,197,2707,2146,561,2146,1648,498,2022-01-01,zipcode
ZCTA5 35673,01,7698,71587,719,176600,5981,2267,5314,599,2245,1664,593,213,3263,2737,526,2737,2144,593,2022-01-01,zipcode
ZCTA5 35674,01,20214,56882,765,154100,15870,6797,13606,1743,5453,3840,1632,938,8921,7621,1300,7621,5268,2353,2022-01-01,zipcode
ZCTA5 35677,01,1891,41923,688,167200,1624,851,1221,193,495,362,84,87,1042,684,358,684,619,65,2022-01-01,zipcode
ZCTA5 35739,01,5013,60526,778,194300,4252,1755,3723,489,1611,940,379,304,2218,2100,118,2100,1727,373,2022-01-01,zipcode
ZCTA5 35740,01,3342,42012,391,108400,2822,1506,2497,376,1114,718,203,86,1748,1536,212,1536,1000,536,2022-01-01,zipcode
ZCTA5 35741,01,4206,88979,1090,282200,3884,1357,3417,211,464,562,1554,626,2026,1993,33,1993,1576,417,2022-01-01,zipcode
ZCTA5 35744,01,2113,44020,746,139600,1923,905,1601,342,711,414,81,53,875,746,129,746,562,184,2022-01-01,zipcode
ZCTA5 35745,01,99,22212,-666666666,-666666666,99,78,99,5,82,12,0,0,150,61,89,61,48,13,2022-01-01,zipcode
ZCTA5 35746,01,747,43803,-666666666,117100,680,435,663,161,263,161,38,40,412,339,73,339,329,10,2022-01-01,zipcode
ZCTA5 35747,01,6229,80833,778,208300,5061,1942,4359,459,1383,1472,694,351,3310,2452,858,2452,2056,396,2022-01-01,zipcode
ZCTA5 35748,01,7170,90500,813,320500,6004,2378,5417,522,1313,1173,1357,1052,3183,2924,259,2924,2514,410,2022-01-01,zipcode
ZCTA5 35749,01,28121,107188,1202,246000,23279,9287,19977,2003,4531,6053,4290,3100,10221,9618,603,9618,8619,999,2022-01-01,zipcode
ZCTA5 35750,01,14255,72052,993,173800,11361,4063,9823,1210,3055,2614,2223,721,5804,5405,399,5405,4231,1174,2022-01-01,zipcode
ZCTA5 35751,01,245,-666666666,-666666666,227500,211,68,151,0,51,39,49,12,94,70,24,70,70,0,2022-01-01,zipcode
ZCTA5 35752,01,2220,41339,904,85700,1854,873,1628,279,706,419,116,108,1135,994,141,994,691,303,2022-01-01,zipcode
ZCTA5 35754,01,5555,90417,750,205700,4743,1928,4083,675,852,1139,836,581,2478,2199,279,2199,1875,324,2022-01-01,zipcode
ZCTA5 35755,01,404,39471,735,270800,385,231,365,61,106,128,39,31,482,207,275,207,139,68,2022-01-01,zipcode
ZCTA5 35756,01,23425,124874,1534,321000,17293,5326,14971,482,2168,3506,4960,3855,9087,8412,675,8412,6776,1636,2022-01-01,zipcode
ZCTA5 35757,01,17622,106897,1336,266800,13663,4206,12168,726,1738,3726,3764,2214,6712,6451,261,6451,5341,1110,2022-01-01,zipcode
ZCTA5 35758,01,48043,103914,1219,294100,37754,13124,32940,995,4142,7180,11155,9468,20163,19584,579,19584,13743,5841,2022-01-01,zipcode
ZCTA5 35759,01,11627,96433,1116,241300,9274,2901,8221,821,1968,2132,2219,1081,4476,4360,116,4360,4100,260,2022-01-01,zipcode
ZCTA5 35760,01,4847,67500,889,163300,3503,1162,3199,398,1047,921,641,192,1862,1722,140,1722,1421,301,2022-01-01,zipcode
ZCTA5 35761,01,13032,72768,978,196300,9842,3474,8657,871,2210,3183,1775,618,5215,4847,368,4847,4007,840,2022-01-01,zipcode
ZCTA5 35763,01,19203,122929,2000,346700,14375,5272,13073,467,1912,2848,4280,3566,7160,7072,88,7072,6481,591,2022-01-01,zipcode
ZCTA5 35764,01,523,41061,-666666666,78800,485,269,424,121,230,64,6,3,294,234,60,234,208,26,2022-01-01,zipcode
ZCTA5 35765,01,4582,61146,675,148200,3627,1854,3273,599,1028,975,298,373,2095,1713,382,1713,1442,271,2022-01-01,zipcode
ZCTA5 35766,01,245,77396,-666666666,84700,211,54,198,28,138,21,8,3,120,85,35,85,51,34,2022-01-01,zipcode
ZCTA5 35768,01,12328,46386,724,120800,10083,5243,8683,1541,3161,2538,977,466,5394,4657,737,4657,3176,1481,2022-01-01,zipcode
ZCTA5 35769,01,9832,56136,762,177400,8062,3566,7175,768,2035,2423,1323,626,4850,4066,784,4066,3344,722,2022-01-01,zipcode
ZCTA5 35771,01,3018,51389,676,91400,2388,1042,2004,389,750,629,128,108,1467,1194,273,1194,960,234,2022-01-01,zipcode
ZCTA5 35772,01,4855,38333,763,123200,3796,2090,3468,890,1324,884,271,99,2320,1890,430,1890,1366,524,2022-01-01,zipcode
ZCTA5 35773,01,13784,62188,1050,172500,11253,4316,10218,1068,3234,3331,1572,1013,5567,5315,252,5315,4519,796,2022-01-01,zipcode
ZCTA5 35774,01,118,75750,-666666666,96900,118,72,112,0,45,41,6,20,67,45,22,45,45,0,2022-01-01,zipcode
ZCTA5 35775,01,555,47905,-666666666,91800,442,248,401,33,191,141,19,17,279,224,55,224,218,6,2022-01-01,zipcode
ZCTA5 35776,01,3651,46875,579,120500,3035,1528,2636,377,1070,747,281,161,1718,1405,313,1405,1173,232,2022-01-01,zipcode
ZCTA5 35801,01,24002,97643,1109,367300,20587,8375,18236,1861,2876,3667,5780,4052,11233,10321,912,10321,6943,3378,2022-01-01,zipcode
ZCTA5 35802,01,23508,68352,1038,289600,19815,7354,17418,837,2205,5667,5019,3690,12365,11361,1004,11361,6062,5299,2022-01-01,zipcode
ZCTA5 35803,01,28210,89714,1073,234900,23373,9254,20581,835,3286,5350,6698,4412,12921,12080,841,12080,9767,2313,2022-01-01,zipcode
ZCTA5 35805,01,20907,30365,752,93300,16232,6504,12393,2670,3585,3957,1508,673,10385,9105,1280,9105,2881,6224,2022-01-01,zipcode
ZCTA5 35806,01,27549,75637,1178,286600,23342,6395,18143,857,2068,4580,6170,4468,13987,13203,784,13203,6525,6678,2022-01-01,zipcode
ZCTA5 35808,01,1112,124028,1677,-666666666,931,221,719,4,116,224,173,202,395,385,10,385,13,372,2022-01-01,zipcode
ZCTA5 35810,01,31668,46285,1053,113500,24968,10165,20858,3257,5462,7217,3480,1442,13066,11881,1185,11881,7714,4167,2022-01-01,zipcode
ZCTA5 35811,01,28841,81754,941,229500,24416,9661,19171,1369,4016,7269,4352,2165,12157,11084,1073,11084,8570,2514,2022-01-01,zipcode
ZCTA5 35816,01,15569,36885,832,107100,12802,4363,8671,1062,2201,2945,1532,931,7872,6834,1038,6834,1941,4893,2022-01-01,zipcode
ZCTA5 35824,01,9767,107828,1218,348800,8318,2246,7635,116,766,1880,2237,2636,4692,4401,291,4401,2252,2149,2022-01-01,zipcode
ZCTA5 35896,01,527,-666666666,-666666666,-666666666,527,291,0,0,0,0,0,0,0,0,0,0,0,0,2022-01-01,zipcode
ZCTA5 35901,01,18818,43638,768,167200,14918,6858,12904,1808,3903,4130,1969,1094,8966,7166,1800,7166,4552,2614,2022-01-01,zipcode
ZCTA5 35903,01,17717,51119,787,145900,15048,5474,12601,1993,3657,4999,1220,732,8304,6777,1527,6777,4352,2425,2022-01-01,zipcode
ZCTA5 35904,01,13482,42738,727,94700,10704,5280,9411,1491,3758,3067,655,440,6378,5015,1363,5015,3722,1293,2022-01-01,zipcode
ZCTA5 35905,01,6221,67321,774,166400,4980,2015,4285,265,1431,1726,367,496,2907,2269,638,2269,1918,351,2022-01-01,zipcode
ZCTA5 35906,01,10429,60373,959,188500,8351,3470,7340,802,2174,2456,1224,684,4670,4009,661,4009,2586,1423,2022-01-01,zipcode
ZCTA5 35907,01,9235,70919,1105,187600,7106,2856,6463,513,2029,2495,877,549,3367,3060,307,3060,2773,287,2022-01-01,zipcode
ZCTA5 35950,01,21156,57867,839,139500,15329,5527,12978,2889,3526,4036,1732,795,7648,7103,545,7103,4948,2155,2022-01-01,zipcode
ZCTA5 35951,01,13486,47775,689,145000,10526,4759,8867,2171,2841,2584,901,370,5586,4682,904,4682,3485,1197,2022-01-01,zipcode
ZCTA5 35952,01,8948,46002,681,123400,7190,3272,6416,1457,2493,1749,486,231,3871,3379,492,3379,2660,719,2022-01-01,zipcode
ZCTA5 35953,01,6557,63802,1006,189100,5747,2984,5202,837,2115,1867,249,134,3316,2572,744,2572,2134,438,2022-01-01,zipcode
ZCTA5 35954,01,12594,52313,641,124700,10636,4843,9321,1338,3776,3191,616,400,5919,4919,1000,4919,4033,886,2022-01-01,zipcode
ZCTA5 35956,01,8207,56397,786,159500,6484,2921,5540,793,1730,1976,566,475,3819,2994,825,2994,2437,557,2022-01-01,zipcode
ZCTA5 35957,01,16269,46799,653,119800,12103,5198,10306,1559,4171,3206,898,472,6820,5912,908,5912,3988,1924,2022-01-01,zipcode
ZCTA5 35958,01,3290,41883,770,149000,2508,1259,2285,470,867,522,255,171,1409,1169,240,1169,977,192,2022-01-01,zipcode
ZCTA5 35959,01,4234,41275,696,186000,3572,2119,3233,486,1219,1053,252,223,3347,1877,1470,1877,1450,427,2022-01-01,zipcode
ZCTA5 35960,01,9101,45925,703,171200,7823,3780,7036,1316,2434,2180,648,458,5464,3693,1771,3693,2829,864,2022-01-01,zipcode
ZCTA5 35961,01,6271,43063,611,85000,5023,2221,4067,1295,1232,1336,136,68,2594,2048,546,2048,1469,579,2022-01-01,zipcode
ZCTA5 35962,01,8391,56838,801,152700,6851,2768,5785,1644,1803,1623,353,362,3461,2834,627,2834,2186,648,2022-01-01,zipcode
ZCTA5 35963,01,1608,66288,563,129500,1397,494,1227,194,429,506,69,29,647,571,76,571,415,156,2022-01-01,zipcode
ZCTA5 35966,01,3360,39239,701,132300,2850,1442,2455,685,889,695,167,19,1651,1310,341,1310,1055,255,2022-01-01,zipcode
ZCTA5 35967,01,17257,45639,675,141100,13296,5656,11418,2392,3145,4003,971,907,7790,6720,1070,6720,4666,2054,2022-01-01,zipcode
ZCTA5 35968,01,4870,54766,693,114400,3861,1735,3288,722,1221,837,281,227,1953,1653,300,1653,1268,385,2022-01-01,zipcode
ZCTA5 35971,01,5043,52930,729,111700,4292,2042,3584,767,1513,1082,128,94,1957,1806,151,1806,1240,566,2022-01-01,zipcode
ZCTA5 35972,01,1293,-666666666,-666666666,88500,962,540,869,210,262,265,48,84,691,541,150,541,489,52,2022-01-01,zipcode
ZCTA5 35973,01,3336,62204,1000,106300,2717,1221,2258,445,805,724,190,94,1360,1081,279,1081,895,186,2022-01-01,zipcode
ZCTA5 35974,01,1695,60127,682,148500,1301,426,1172,267,353,337,102,113,649,614,35,614,426,188,2022-01-01,zipcode
ZCTA5 35975,01,1400,43333,719,165800,1116,524,981,62,504,279,62,74,553,522,31,522,475,47,2022-01-01,zipcode
ZCTA5 35976,01,16769,63551,733,235800,13888,6829,12109,1565,3111,3541,2812,1080,7550,6609,941,6609,5123,1486,2022-01-01,zipcode
ZCTA5 35978,01,5877,51276,816,128200,4370,1942,3989,675,1774,1186,178,176,2297,1952,345,1952,1477,475,2022-01-01,zipcode
ZCTA5 35979,01,744,30547,-666666666,134400,606,270,511,152,201,136,16,6,420,319,101,319,319,0,2022-01-01,zipcode
ZCTA5 35980,01,6420,55720,785,156900,4662,2015,3852,817,1417,944,352,322,2230,2006,224,2006,1630,376,2022-01-01,zipcode
ZCTA5 35981,01,1806,41620,840,105700,1546,718,1312,270,406,362,256,18,843,602,241,602,480,122,2022-01-01,zipcode
ZCTA5 35983,01,3426,60639,710,134300,2773,1296,2437,368,769,876,186,238,2102,1356,746,1356,1166,190,2022-01-01,zipcode
ZCTA5 35984,01,1489,41078,785,143400,1383,782,1352,187,420,276,212,257,1508,778,730,778,608,170,2022-01-01,zipcode
ZCTA5 35986,01,8415,60755,646,192400,6709,2809,5622,909,1572,1924,820,397,3524,3077,447,3077,2486,591,2022-01-01,zipcode
ZCTA5 35987,01,2599,62039,-666666666,123600,1970,848,1762,349,766,502,92,53,1163,969,194,969,826,143,2022-01-01,zipcode
ZCTA5 35988,01,2028,41000,624,103100,1564,572,1321,281,409,329,188,114,881,730,151,730,497,233,2022-01-01,zipcode
ZCTA5 35989,01,3590,47138,669,97200,2757,1301,2278,553,594,798,228,105,1493,1237,256,1237,1055,182,2022-01-01,zipcode
ZCTA5 35990,01,0,-666666666,-666666666,-666666666,0,0,0,0,0,0,0,0,24,0,24,0,0,0,2022-01-01,zipcode
ZCTA5 36003,01,2420,31719,425,103800,1924,1020,1623,319,632,512,53,107,1153,1007,146,1007,829,178,2022-01-01,zipcode
ZCTA5 36005,01,1536,43167,925,109000,1300,590,1078,254,383,249,114,78,921,610,311,610,511,99,2022-01-01,zipcode
ZCTA5 36006,01,1909,-666666666,1014,193800,1549,805,1467,97,642,608,118,2,866,782,84,782,727,55,2022-01-01,zipcode
ZCTA5 36009,01,2142,42434,602,98600,1777,945,1582,190,748,335,212,97,1199,903,296,903,667,236,2022-01-01,zipcode
ZCTA5 36010,01,5209,39071,659,112000,4211,2119,3721,675,1706,775,369,196,2947,2091,856,2091,1427,664,2022-01-01,zipcode
ZCTA5 36013,01,391,176406,-666666666,372500,342,182,283,56,55,89,62,21,159,139,20,139,139,0,2022-01-01,zipcode
ZCTA5 36016,01,4429,57734,633,65000,3772,2404,3430,809,1442,980,140,59,1674,1232,442,1232,870,362,2022-01-01,zipcode
ZCTA5 36017,01,3211,31167,403,73300,2779,2068,2642,1020,872,556,133,61,977,768,209,768,476,292,2022-01-01,zipcode
ZCTA5 36020,01,1080,54375,930,154500,850,388,702,87,243,250,82,40,505,414,91,414,337,77,2022-01-01,zipcode
ZCTA5 36022,01,16150,81276,956,211300,11923,3873,10371,745,3127,3652,1882,965,5958,5555,403,5555,4778,777,2022-01-01,zipcode
ZCTA5 36024,01,5305,55170,760,218700,4674,2127,4268,429,1713,1381,476,269,3556,2385,1171,2385,1908,477,2022-01-01,zipcode
ZCTA5 36025,01,7120,51875,1052,185600,6066,4112,5507,1467,2121,1048,687,184,1700,1535,165,1535,1151,384,2022-01-01,zipcode
ZCTA5 36026,01,1294,86321,1045,293800,1198,606,1078,92,344,377,251,14,923,585,338,585,541,44,2022-01-01,zipcode
ZCTA5 36027,01,14887,39419,638,118300,11906,6110,9978,1928,3561,2909,825,755,7484,5944,1540,5944,3723,2221,2022-01-01,zipcode
ZCTA5 36028,01,1653,38482,575,120200,1408,817,1203,314,314,331,178,66,923,640,283,640,391,249,2022-01-01,zipcode
ZCTA5 36029,01,813,58409,-666666666,-666666666,684,290,639,162,217,123,111,26,409,308,101,308,247,61,2022-01-01,zipcode
ZCTA5 36030,01,316,32768,-666666666,-666666666,272,174,214,0,141,56,11,6,195,105,90,105,83,22,2022-01-01,zipcode
ZCTA5 36031,01,23,-666666666,-666666666,-666666666,23,16,23,0,16,7,0,0,25,12,13,12,12,0,2022-01-01,zipcode
ZCTA5 36032,01,2408,31080,430,70000,1918,1127,1578,349,735,333,89,72,1117,921,196,921,670,251,2022-01-01,zipcode
ZCTA5 36033,01,3513,38500,628,88900,2890,1504,2674,335,1388,576,234,141,2149,1446,703,1446,1137,309,2022-01-01,zipcode
ZCTA5 36034,01,715,39773,786,81400,549,250,496,29,188,164,76,39,351,240,111,240,218,22,2022-01-01,zipcode
ZCTA5 36035,01,2019,48354,947,114200,1591,634,1377,154,579,331,203,110,1117,808,309,808,685,123,2022-01-01,zipcode
ZCTA5 36036,01,1904,47500,909,159400,1720,998,1400,256,616,337,113,78,986,720,266,720,575,145,2022-01-01,zipcode
ZCTA5 36037,01,13177,47707,733,95800,10539,4658,9112,1163,4350,2421,679,499,6498,4873,1625,4873,3236,1637,2022-01-01,zipcode
ZCTA5 36038,01,144,9145,-666666666,-666666666,144,40,143,9,20,25,13,76,106,100,6,100,24,76,2022-01-01,zipcode
ZCTA5 36039,01,261,49107,-666666666,-666666666,261,128,230,41,81,89,19,0,148,103,45,103,54,49,2022-01-01,zipcode
ZCTA5 36040,01,3748,32438,771,71900,3008,1577,2623,466,1095,605,314,143,1593,1416,177,1416,956,460,2022-01-01,zipcode
ZCTA5 36041,01,1506,42882,672,107700,1137,487,923,168,337,268,123,27,774,565,209,565,491,74,2022-01-01,zipcode
ZCTA5 36042,01,1389,81607,-666666666,97800,1070,393,901,128,336,325,77,35,735,443,292,443,408,35,2022-01-01,zipcode
ZCTA5 36043,01,3800,87813,968,228300,3178,1388,2541,320,835,795,314,277,1555,1316,239,1316,1080,236,2022-01-01,zipcode
ZCTA5 36046,01,1358,43289,-666666666,102000,1126,481,948,216,359,239,77,57,587,522,65,522,473,49,2022-01-01,zipcode
ZCTA5 36047,01,859,-666666666,-666666666,-666666666,856,336,770,96,235,329,72,38,436,339,97,339,324,15,2022-01-01,zipcode
ZCTA5 36048,01,1240,24289,760,83700,1019,497,943,222,392,239,48,42,794,583,211,583,412,171,2022-01-01,zipcode
ZCTA5 36049,01,5403,51839,587,114800,4342,2140,3853,697,1684,674,512,286,2384,1806,578,1806,1317,489,2022-01-01,zipcode
ZCTA5 36051,01,3308,76250,966,91000,2538,806,2323,142,1040,802,127,212,1179,1066,113,1066,926,140,2022-01-01,zipcode
ZCTA5 36052,01,674,125000,-666666666,625000,621,245,536,23,88,106,171,148,345,334,11,334,317,17,2022-01-01,zipcode
ZCTA5 36053,01,2505,45403,585,103000,2031,1072,1583,257,580,622,39,85,1195,882,313,882,671,211,2022-01-01,zipcode
ZCTA5 36054,01,15233,53371,976,155200,12096,5204,9882,1191,3269,2975,1714,733,6468,5950,518,5950,4137,1813,2022-01-01,zipcode
ZCTA5 36064,01,13007,122500,1444,359500,9201,2642,8184,321,1300,1962,2661,1940,4799,4364,435,4364,3808,556,2022-01-01,zipcode
ZCTA5 36066,01,21626,78271,1298,204300,17901,6310,14534,930,3135,3654,3829,2986,9069,8731,338,8731,5430,3301,2022-01-01,zipcode
ZCTA5 36067,01,27436,63836,924,172500,22028,9716,19097,2146,6549,5880,2499,2023,11359,10115,1244,10115,7803,2312,2022-01-01,zipcode
ZCTA5 36069,01,1987,44643,813,97400,1660,871,1475,215,508,430,214,108,1293,950,343,950,732,218,2022-01-01,zipcode
ZCTA5 36071,01,467,47708,679,97400,360,207,344,64,131,69,63,17,294,198,96,198,164,34,2022-01-01,zipcode
ZCTA5 36075,01,1642,45032,929,96600,1429,837,1292,313,417,413,84,65,802,649,153,649,538,111,2022-01-01,zipcode
ZCTA5 36078,01,13398,61574,837,167000,11057,4612,9255,1190,3712,2893,992,468,5814,5220,594,5220,3658,1562,2022-01-01,zipcode
ZCTA5 36079,01,8998,53846,888,142400,7317,3407,6263,800,2047,1591,870,955,4487,3536,951,3536,2743,793,2022-01-01,zipcode
ZCTA5 36080,01,2551,77866,974,250000,1897,797,1785,342,681,409,201,152,938,838,100,838,630,208,2022-01-01,zipcode
ZCTA5 36081,01,16008,39133,740,175900,13520,5951,7848,712,2707,1877,1506,1046,7458,5557,1901,5557,2614,2943,2022-01-01,zipcode
ZCTA5 36082,01,823,-666666666,-666666666,-666666666,823,695,11,0,7,4,0,0,0,0,0,0,0,0,2022-01-01,zipcode
ZCTA5 36083,01,9385,40295,662,87900,8068,4013,5618,873,1663,1773,573,736,4681,3527,1154,3527,1970,1557,2022-01-01,zipcode
ZCTA5 36088,01,3451,32885,766,97200,3039,1509,1492,270,296,351,312,263,1912,1172,740,1172,591,581,2022-01-01,zipcode
ZCTA5 36089,01,7740,29275,625,88900,6102,3414,5296,1588,2178,1012,429,89,3325,2525,800,2525,1533,992,2022-01-01,zipcode
ZCTA5 36091,01,3887,46236,783,128200,3251,1668,2963,553,1343,821,103,143,2050,1554,496,1554,1181,373,2022-01-01,zipcode
ZCTA5 36092,01,21053,74719,974,178600,16996,6641,14878,1428,6246,4585,1884,735,9129,8007,1122,8007,6274,1733,2022-01-01,zipcode
ZCTA5 36093,01,11769,117243,897,298500,9617,3371,7907,435,1475,2539,1928,1530,4400,4086,314,4086,3849,237,2022-01-01,zipcode
ZCTA5 36104,01,10132,31231,753,110400,8438,4561,6078,1385,1755,1434,812,692,5071,3825,1246,3825,986,2839,2022-01-01,zipcode
ZCTA5 36105,01,9668,42696,914,83200,8263,3940,7551,1871,2197,2182,820,481,5571,4293,1278,4293,2619,1674,2022-01-01,zipcode
ZCTA5 36106,01,15081,69512,1068,182200,12516,4638,9966,535,1901,2729,2364,2437,7162,6370,792,6370,3558,2812,2022-01-01,zipcode
ZCTA5 36107,01,7464,29922,876,71400,5569,2606,4495,919,1124,1591,494,367,3969,2968,1001,2968,1104,1864,2022-01-01,zipcode
ZCTA5 36108,01,15271,27338,712,68300,12415,6958,11100,2862,3979,2691,931,637,8657,6299,2358,6299,3979,2320,2022-01-01,zipcode
ZCTA5 36109,01,23935,58053,1047,129000,19796,8275,16626,1352,5261,5134,3162,1717,11199,10068,1131,10068,6506,3562,2022-01-01,zipcode
ZCTA5 36110,01,11245,38860,970,74600,8636,4161,7532,1693,2981,2140,441,277,5142,4031,1111,4031,2102,1929,2022-01-01,zipcode
ZCTA5 36111,01,13033,57958,1024,145300,10275,4331,8644,1260,2029,2197,1973,1185,5770,4899,871,4899,2920,1979,2022-01-01,zipcode
ZCTA5 36112,01,239,70625,1125,-666666666,236,113,181,37,77,54,8,5,7,7,0,7,0,7,2022-01-01,zipcode
ZCTA5 36113,01,1444,112321,1833,-666666666,1176,729,1044,195,179,382,136,152,302,255,47,255,0,255,2022-01-01,zipcode
ZCTA5 36115,01,1083,91667,1427,-666666666,624,139,446,0,51,217,111,67,236,228,8,228,0,228,2022-01-01,zipcode
ZCTA5 36116,01,45445,52015,1041,131300,34882,12410,28484,2848,7899,8126,5474,4137,19858,17362,2496,17362,8149,9213,2022-01-01,zipcode
ZCTA5 36117,01,53559,73919,1150,211800,42051,14115,35675,2167,6315,10990,9298,6905,24033,21737,2296,21737,13151,8586,2022-01-01,zipcode
ZCTA5 36201,01,16794,31807,700,72700,14334,7181,11992,2746,5093,3510,407,236,9486,7068,2418,7068,4359,2709,2022-01-01,zipcode
ZCTA5 36203,01,18579,61519,891,158600,14934,5643,13149,1956,3431,4601,1748,1413,8013,7306,707,7306,5382,1924,2022-01-01,zipcode
ZCTA5 36205,01,1108,25667,816,255700,899,439,758,110,221,318,59,50,564,478,86,478,218,260,2022-01-01,zipcode
ZCTA5 36206,01,10730,53895,786,122200,8440,3216,7210,1075,2607,2275,770,483,4750,4133,617,4133,2715,1418,2022-01-01,zipcode
ZCTA5 36207,01,19750,66949,942,184700,15893,6789,13608,1336,3718,4302,2544,1708,9396,8008,1388,8008,6091,1917,2022-01-01,zipcode
ZCTA5 36250,01,4419,81023,1075,169000,3591,1404,3240,264,1116,1300,305,255,1770,1528,242,1528,1273,255,2022-01-01,zipcode
ZCTA5 36251,01,5291,44970,417,136700,4391,2213,3545,650,1182,1342,314,57,2507,2077,430,2077,1570,507,2022-01-01,zipcode
ZCTA5 36255,01,901,60417,-666666666,126800,824,368,651,176,161,226,25,63,504,379,125,379,345,34,2022-01-01,zipcode
ZCTA5 36256,01,1376,55500,629,139500,1070,490,951,118,315,374,59,85,720,588,132,588,524,64,2022-01-01,zipcode
ZCTA5 36258,01,1609,54227,-666666666,100600,1340,783,1247,170,502,467,98,10,886,690,196,690,627,63,2022-01-01,zipcode
ZCTA5 36260,01,4602,65440,675,158200,3410,1878,3150,546,1099,912,391,202,1637,1411,226,1411,1136,275,2022-01-01,zipcode
ZCTA5 36262,01,1752,55375,883,96600,1428,697,1251,343,551,205,128,24,709,589,120,589,530,59,2022-01-01,zipcode
ZCTA5 36263,01,520,-666666666,-666666666,117300,421,215,342,130,151,45,0,16,265,172,93,172,135,37,2022-01-01,zipcode
ZCTA5 36264,01,8341,52482,772,148800,6663,3416,5923,1067,2064,1868,615,309,3673,3124,549,3124,2291,833,2022-01-01,zipcode
ZCTA5 36265,01,21802,49924,761,159000,18795,8243,13422,1560,4550,4007,1980,1325,9695,8470,1225,8470,5409,3061,2022-01-01,zipcode
ZCTA5 36266,01,6276,46094,605,168500,4891,2525,4418,707,1994,1151,417,149,3257,2419,838,2419,1817,602,2022-01-01,zipcode
ZCTA5 36267,01,222,-666666666,-666666666,-666666666,89,73,89,0,71,18,0,0,16,16,0,16,16,0,2022-01-01,zipcode
ZCTA5 36268,01,6424,62466,743,100700,4840,2063,4163,493,1807,1423,146,294,2701,2305,396,2305,2077,228,2022-01-01,zipcode
ZCTA5 36269,01,1350,41867,909,125400,927,469,894,161,410,181,100,42,672,572,100,572,401,171,2022-01-01,zipcode
ZCTA5 36271,01,6106,63088,739,148700,4866,2191,4245,721,1742,1185,264,333,2717,2228,489,2228,2029,199,2022-01-01,zipcode
ZCTA5 36272,01,13048,49474,704,111200,10703,4611,9412,1642,3866,2599,794,511,6252,5043,1209,5043,3921,1122,2022-01-01,zipcode
ZCTA5 36273,01,3300,56016,-666666666,137100,2657,1320,2233,333,842,540,313,205,1540,1279,261,1279,1081,198,2022-01-01,zipcode
ZCTA5 36274,01,10162,44100,671,102600,8357,4227,7401,1249,2936,2067,839,310,5239,4162,1077,4162,3177,985,2022-01-01,zipcode
ZCTA5 36276,01,2841,43000,633,105100,2242,1184,1684,260,653,488,225,58,1138,948,190,948,723,225,2022-01-01,zipcode
ZCTA5 36277,01,5531,67019,899,131300,4340,1821,3620,572,1027,1194,580,247,2039,1828,211,1828,1476,352,2022-01-01,zipcode
ZCTA5 36278,01,4056,44864,654,241300,3445,2040,3217,456,913,1088,443,317,3354,1871,1483,1871,1564,307,2022-01-01,zipcode
ZCTA5 36279,01,2932,67344,1146,156100,2137,927,1940,287,731,629,155,138,1096,979,117,979,854,125,2022-01-01,zipcode
ZCTA5 36280,01,4285,77716,833,215100,3391,1422,2869,469,855,771,394,380,2081,1551,530,1551,1302,249,2022-01-01,zipcode
ZCTA5 36301,01,38101,47414,835,146800,30001,13049,26315,3826,8762,9096,3001,1630,17674,15172,2502,15172,9094,6078,2022-01-01,zipcode
ZCTA5 36303,01,30390,51982,814,166400,24031,10456,20526,2311,5949,6608,3681,1977,14564,11808,2756,11808,7204,4604,2022-01-01,zipcode
ZCTA5 36305,01,17309,79618,1068,226000,13755,5182,11833,818,2983,3831,2418,1783,7337,6603,734,6603,4536,2067,2022-01-01,zipcode
ZCTA5 36310,01,6071,38514,588,116000,5318,3237,4808,1068,1680,1330,424,306,4248,2594,1654,2594,1929,665,2022-01-01,zipcode
ZCTA5 36311,01,2761,44926,714,111400,2184,977,1818,291,774,570,82,101,1348,1052,296,1052,832,220,2022-01-01,zipcode
ZCTA5 36312,01,6066,49643,779,144700,4937,2342,4302,716,1585,1388,447,166,2757,2290,467,2290,1715,575,2022-01-01,zipcode
ZCTA5 36313,01,122,-666666666,-666666666,-666666666,122,0,122,42,0,80,0,0,122,122,0,122,80,42,2022-01-01,zipcode
ZCTA5 36314,01,560,55058,568,58200,417,191,409,27,198,163,21,0,260,211,49,211,180,31,2022-01-01,zipcode
ZCTA5 36316,01,2177,87703,900,164000,1824,755,1635,155,385,687,281,127,998,794,204,794,712,82,2022-01-01,zipcode
ZCTA5 36317,01,703,63281,-666666666,105000,607,290,564,70,169,125,103,97,324,281,43,281,276,5,2022-01-01,zipcode
ZCTA5 36318,01,1302,61875,719,116000,1033,482,916,136,272,336,109,63,761,526,235,526,463,63,2022-01-01,zipcode
ZCTA5 36319,01,2404,59375,768,144000,1879,802,1591,179,695,513,146,58,1064,887,177,887,723,164,2022-01-01,zipcode
ZCTA5 36320,01,3213,39640,480,115300,2774,1447,2498,465,1078,643,238,74,1738,1363,375,1363,1063,300,2022-01-01,zipcode
ZCTA5 36321,01,2156,56964,783,158200,1689,821,1500,254,594,467,110,75,880,799,81,799,624,175,2022-01-01,zipcode
ZCTA5 36322,01,8186,46590,739,111700,6960,2852,6084,895,2067,2120,709,293,4495,3795,700,3795,2312,1483,2022-01-01,zipcode
ZCTA5 36323,01,7941,41907,664,93300,6854,3466,6038,1237,2171,1750,593,287,4023,3150,873,3150,2534,616,2022-01-01,zipcode
ZCTA5 36330,01,38461,69544,971,190000,29957,12188,25508,2685,6851,9804,3782,2386,16725,14498,2227,14498,9229,5269,2022-01-01,zipcode
ZCTA5 36340,01,5235,45922,657,123100,4258,2202,3819,789,1584,816,369,261,2458,2175,283,2175,1482,693,2022-01-01,zipcode
ZCTA5 36343,01,1391,47083,879,97100,1198,647,1076,209,421,355,66,25,783,549,234,549,414,135,2022-01-01,zipcode
ZCTA5 36344,01,5872,53566,738,146400,4486,1969,4082,498,1474,1521,410,179,2615,2143,472,2143,1594,549,2022-01-01,zipcode
ZCTA5 36345,01,8977,73750,728,161800,6830,2198,5955,890,1709,1718,1214,424,3528,3223,305,3223,2700,523,2022-01-01,zipcode
ZCTA5 36346,01,1309,57308,696,122900,1044,446,887,220,295,228,67,77,774,510,264,510,461,49,2022-01-01,zipcode
ZCTA5 36350,01,7958,52417,769,157500,6187,2263,5397,1178,1693,1485,762,279,3428,2971,457,2971,1729,1242,2022-01-01,zipcode
ZCTA5 36351,01,3670,64107,689,135200,2966,1305,2601,358,785,897,383,178,1733,1467,266,1467,1212,255,2022-01-01,zipcode
ZCTA5 36352,01,5682,69429,769,177500,4680,2075,3869,366,1238,1584,427,254,2177,1937,240,1937,1635,302,2022-01-01,zipcode
ZCTA5 36353,01,1704,43125,830,97500,1514,751,1253,164,479,446,131,33,880,644,236,644,562,82,2022-01-01,zipcode
ZCTA5 36360,01,19053,48654,739,131900,15415,7950,13430,1933,4175,4867,1366,1089,8995,7763,1232,7763,5039,2724,2022-01-01,zipcode
ZCTA5 36362,01,5422,72681,1347,-666666666,3452,894,2520,22,291,1092,943,172,1550,1465,85,1465,12,1453,2022-01-01,zipcode
ZCTA5 36370,01,973,52000,567,90400,816,395,728,111,353,204,60,0,431,360,71,360,335,25,2022-01-01,zipcode
ZCTA5 36371,01,447,39250,767,118900,397,163,336,33,121,155,20,7,221,203,18,203,147,56,2022-01-01,zipcode
ZCTA5 36373,01,435,31188,-666666666,-666666666,416,192,375,122,197,56,0,0,436,171,265,171,130,41,2022-01-01,zipcode
ZCTA5 36374,01,572,65139,856,96500,471,159,443,81,106,158,44,54,458,235,223,235,183,52,2022-01-01,zipcode
ZCTA5 36375,01,7242,47247,789,120000,5933,2883,5160,909,1929,1768,409,145,3378,2771,607,2771,2153,618,2022-01-01,zipcode
ZCTA5 36376,01,2253,46985,814,95200,1840,906,1709,255,857,470,64,63,1074,890,184,890,715,175,2022-01-01,zipcode
ZCTA5 36401,01,7579,38324,721,101000,6124,3719,5215,477,2496,1626,284,332,3921,2834,1087,2834,2039,795,2022-01-01,zipcode
ZCTA5 36420,01,10429,47935,652,150800,8230,3762,7219,1099,2186,2325,926,683,5033,3850,1183,3850,2849,1001,2022-01-01,zipcode
ZCTA5 36421,01,9717,57018,723,147700,7526,3614,6778,886,2321,2424,724,423,4952,3636,1316,3636,2776,860,2022-01-01,zipcode
ZCTA5 36425,01,719,33281,-666666666,-666666666,601,325,452,67,232,109,37,7,533,287,246,287,205,82,2022-01-01,zipcode
ZCTA5 36426,01,15932,48314,670,122800,12492,5792,10730,1651,4316,3016,1276,471,7202,5455,1747,5455,3871,1584,2022-01-01,zipcode
ZCTA5 36432,01,1718,44390,756,55300,1583,874,1420,268,567,348,181,56,1035,721,314,721,584,137,2022-01-01,zipcode
ZCTA5 36435,01,433,41458,-666666666,110700,421,238,406,94,193,106,6,7,294,194,100,194,152,42,2022-01-01,zipcode
ZCTA5 36436,01,718,63571,-666666666,134200,563,246,368,88,103,158,4,15,344,218,126,218,167,51,2022-01-01,zipcode
ZCTA5 36439,01,82,74464,-666666666,-666666666,65,38,59,9,8,20,14,8,70,39,31,39,30,9,2022-01-01,zipcode
ZCTA5 36441,01,3505,42500,695,124000,2599,1119,2290,280,968,661,225,156,1918,1298,620,1298,897,401,2022-01-01,zipcode
ZCTA5 36442,01,3456,43594,714,112000,2775,1413,2441,390,975,864,106,106,1787,1222,565,1222,830,392,2022-01-01,zipcode
ZCTA5 36444,01,626,58000,-666666666,85500,526,337,514,126,263,79,15,31,436,216,220,216,199,17,2022-01-01,zipcode
ZCTA5 36445,01,5115,37450,754,99100,4443,2677,3850,833,1764,948,149,156,2337,1830,507,1830,1512,318,2022-01-01,zipcode
ZCTA5 36446,01,451,54583,-666666666,109800,347,145,286,29,142,81,34,0,202,117,85,117,81,36,2022-01-01,zipcode
ZCTA5 36451,01,4348,47083,757,123600,3694,1920,3162,553,1311,853,288,157,2139,1613,526,1613,1282,331,2022-01-01,zipcode
ZCTA5 36453,01,2583,44099,669,91400,2205,1097,1882,287,761,581,172,81,1100,973,127,973,794,179,2022-01-01,zipcode
ZCTA5 36454,01,30,105556,-666666666,77800,30,5,30,0,30,0,0,0,53,28,25,28,28,0,2022-01-01,zipcode
ZCTA5 36455,01,304,33583,668,75000,267,154,248,28,167,39,5,9,224,143,81,143,80,63,2022-01-01,zipcode
ZCTA5 36456,01,1705,47500,545,78700,1284,649,1081,105,504,331,109,32,929,632,297,632,521,111,2022-01-01,zipcode
ZCTA5 36460,01,9483,37409,663,118100,7506,3892,6414,980,2695,1606,671,462,4710,3671,1039,3671,2313,1358,2022-01-01,zipcode
ZCTA5 36467,01,10057,43244,673,112200,8352,3785,7229,1068,2902,2375,581,303,4882,3978,904,3978,3026,952,2022-01-01,zipcode
ZCTA5 36470,01,0,-666666666,-666666666,-666666666,0,0,0,0,0,0,0,0,0,0,0,0,0,0,2022-01-01,zipcode
ZCTA5 36471,01,826,29554,721,61100,625,444,523,21,342,99,19,42,559,301,258,301,157,144,2022-01-01,zipcode
ZCTA5 36473,01,171,-666666666,-666666666,129200,160,104,151,14,83,41,0,13,132,69,63,69,47,22,2022-01-01,zipcode
ZCTA5 36474,01,2496,39348,711,94600,2009,925,1633,192,834,451,73,83,1302,972,330,972,838,134,2022-01-01,zipcode
ZCTA5 36475,01,2173,43641,717,109900,1799,918,1421,136,759,295,170,61,1079,753,326,753,604,149,2022-01-01,zipcode
ZCTA5 36476,01,40,-666666666,-666666666,-666666666,33,15,26,9,15,2,0,0,34,18,16,18,4,14,2022-01-01,zipcode
ZCTA5 36477,01,4276,46020,622,101500,3373,1496,3066,637,948,1190,216,75,2174,1706,468,1706,1282,424,2022-01-01,zipcode
ZCTA5 36480,01,1735,66103,-666666666,155500,1487,838,1229,122,403,586,71,47,927,585,342,585,525,60,2022-01-01,zipcode
ZCTA5 36481,01,240,20568,-666666666,-666666666,214,163,181,51,96,20,1,13,148,71,77,71,63,8,2022-01-01,zipcode
ZCTA5 36482,01,825,-666666666,-666666666,113000,774,400,682,262,256,96,68,0,561,330,231,330,272,58,2022-01-01,zipcode
ZCTA5 36483,01,588,58869,-666666666,138500,532,286,490,45,220,138,72,15,329,247,82,247,209,38,2022-01-01,zipcode
ZCTA5 36502,01,16132,35808,643,131400,12977,6743,11190,1952,5480,2682,682,394,7540,6230,1310,6230,3975,2255,2022-01-01,zipcode
ZCTA5 36505,01,1176,89514,-666666666,161500,985,377,776,137,303,125,104,107,387,387,0,387,334,53,2022-01-01,zipcode
ZCTA5 36507,01,20603,50147,857,150000,17009,7287,13734,2400,4913,4392,1088,941,8364,7409,955,7409,5679,1730,2022-01-01,zipcode
ZCTA5 36509,01,1575,39375,716,83500,1280,694,1174,496,323,262,87,6,689,550,139,550,387,163,2022-01-01,zipcode
ZCTA5 36511,01,620,85588,-666666666,-666666666,479,71,479,156,227,0,96,0,519,320,199,320,320,0,2022-01-01,zipcode
ZCTA5 36512,01,20,-666666666,-666666666,-666666666,20,20,20,20,0,0,0,0,10,10,0,10,10,0,2022-01-01,zipcode
ZCTA5 36513,01,409,-666666666,-666666666,113000,281,183,281,0,173,108,0,0,166,148,18,148,148,0,2022-01-01,zipcode
ZCTA5 36518,01,2256,65125,646,168000,1993,969,1839,327,608,599,151,154,1161,839,322,839,703,136,2022-01-01,zipcode
ZCTA5 36521,01,5804,67114,899,158900,4683,1963,4026,781,1821,875,384,165,2221,2001,220,2001,1825,176,2022-01-01,zipcode
ZCTA5 36522,01,7101,46888,740,155400,5320,2630,4544,645,2042,1425,298,134,2977,2506,471,2506,1749,757,2022-01-01,zipcode
ZCTA5 36523,01,3139,55815,974,168000,2530,1404,2141,435,870,447,255,134,1234,1047,187,1047,803,244,2022-01-01,zipcode
ZCTA5 36524,01,1193,36875,646,79900,1014,587,902,233,418,133,43,75,803,418,385,418,329,89,2022-01-01,zipcode
ZCTA5 36525,01,2035,61550,942,168400,1522,695,1395,209,498,476,166,46,744,703,41,703,554,149,2022-01-01,zipcode
ZCTA5 36526,01,34611,82573,1325,280000,25936,9355,22955,1207,5560,7113,5680,3395,13772,12645,1127,12645,9305,3340,2022-01-01,zipcode
ZCTA5 36527,01,19942,111334,1456,327100,14523,4634,12078,244,1987,4372,2968,2507,7408,6715,693,6715,5025,1690,2022-01-01,zipcode
ZCTA5 36528,01,1793,62000,1268,355200,1685,911,1559,46,287,595,394,237,2244,816,1428,816,787,29,2022-01-01,zipcode
ZCTA5 36529,01,193,123056,-666666666,-666666666,184,95,160,0,84,28,28,20,127,62,65,62,57,5,2022-01-01,zipcode
ZCTA5 36530,01,6272,54766,939,236700,5518,2403,4870,601,1614,1604,748,303,3959,2903,1056,2903,2292,611,2022-01-01,zipcode
ZCTA5 36532,01,35824,84886,1414,384500,29171,13315,26132,1341,4447,7246,7815,5283,16674,14309,2365,14309,11982,2327,2022-01-01,zipcode
ZCTA5 36535,01,37703,61158,976,237900,32001,13820,29099,3062,9975,9050,4434,2578,18106,15934,2172,15934,12353,3581,2022-01-01,zipcode
ZCTA5 36538,01,406,37865,-666666666,82200,350,206,263,37,178,19,11,18,295,185,110,185,86,99,2022-01-01,zipcode
ZCTA5 36539,01,451,62639,-666666666,126400,355,221,257,17,155,70,6,9,260,177,83,177,169,8,2022-01-01,zipcode
ZCTA5 36540,01,1050,27254,-666666666,-666666666,721,358,640,218,307,93,15,7,428,308,120,308,256,52,2022-01-01,zipcode
ZCTA5 36541,01,15601,77577,952,145400,12266,5267,10980,1244,4721,3701,833,481,6357,5422,935,5422,4725,697,2022-01-01,zipcode
ZCTA5 36542,01,17089,63305,1182,323900,15121,5880,13383,673,3056,4449,2933,2272,18299,7762,10537,7762,5371,2391,2022-01-01,zipcode
ZCTA5 36543,01,8,-666666666,-666666666,-666666666,8,0,8,0,0,8,0,0,5,5,0,5,5,0,2022-01-01,zipcode
ZCTA5 36544,01,11726,52268,781,129800,9459,3935,8292,2391,3204,2026,524,147,4803,4314,489,4314,3188,1126,2022-01-01,zipcode
ZCTA5 36545,01,8818,52027,643,134100,7279,3939,6220,1166,2300,1660,693,401,4387,3116,1271,3116,2224,892,2022-01-01,zipcode
ZCTA5 36548,01,1220,97917,-666666666,169300,825,368,708,25,265,211,123,84,513,387,126,387,339,48,2022-01-01,zipcode
ZCTA5 36549,01,6048,64722,864,165700,5493,3080,4897,274,1721,1659,913,330,3027,2552,475,2552,2235,317,2022-01-01,zipcode
ZCTA5 36550,01,368,-666666666,-666666666,-666666666,302,171,274,42,188,35,0,9,223,170,53,170,148,22,2022-01-01,zipcode
ZCTA5 36551,01,12416,70346,1186,209300,9533,3387,8397,604,2903,2925,1324,641,4379,3728,651,3728,3043,685,2022-01-01,zipcode
ZCTA5 36553,01,3498,50000,600,155600,2869,1497,1904,88,827,746,120,123,1398,1068,330,1068,986,82,2022-01-01,zipcode
ZCTA5 36555,01,1298,88333,1136,337500,1106,479,987,7,126,392,291,171,678,484,194,484,440,44,2022-01-01,zipcode
ZCTA5 36556,01,44,-666666666,-666666666,-666666666,44,44,19,0,0,19,0,0,206,19,187,19,19,0,2022-01-01,zipcode
ZCTA5 36558,01,4042,58962,701,119000,3318,1690,2856,471,1135,677,242,331,1965,1488,477,1488,1325,163,2022-01-01,zipcode
ZCTA5 36559,01,375,72783,-666666666,631300,375,256,356,0,0,75,68,213,201,128,73,128,128,0,2022-01-01,zipcode
ZCTA5 36560,01,3211,42125,805,84900,2638,1387,2263,544,997,448,262,12,1292,1033,259,1033,833,200,2022-01-01,zipcode
ZCTA5 36561,01,8952,90778,1260,482800,7953,3345,7168,224,1775,2152,1970,1047,15909,4150,11759,4150,2943,1207,2022-01-01,zipcode
ZCTA5 36562,01,1456,36632,-666666666,114400,1104,565,1013,181,497,249,77,9,678,570,108,570,457,113,2022-01-01,zipcode
ZCTA5 36564,01,0,-666666666,-666666666,-666666666,0,0,0,0,0,0,0,0,0,0,0,0,0,0,2022-01-01,zipcode
ZCTA5 36567,01,14313,61678,980,192800,11606,4940,10208,1522,3643,3074,1502,467,5739,5337,402,5337,4078,1259,2022-01-01,zipcode
ZCTA5 36568,01,85,-666666666,-666666666,-666666666,85,30,55,0,0,20,0,35,36,36,0,36,16,20,2022-01-01,zipcode
ZCTA5 36569,01,706,50625,-666666666,108200,666,534,666,57,370,184,25,30,359,262,97,262,253,9,2022-01-01,zipcode
ZCTA5 36571,01,16497,63513,974,187600,12909,5371,11642,1179,4817,2969,1915,762,7305,6564,741,6564,4951,1613,2022-01-01,zipcode
ZCTA5 36572,01,6770,88438,1233,178600,5371,2037,4921,416,1834,1328,919,424,2584,2414,170,2414,1977,437,2022-01-01,zipcode
ZCTA5 36574,01,1636,43137,1102,190100,1363,848,1131,79,551,246,197,58,682,579,103,579,461,118,2022-01-01,zipcode
ZCTA5 36575,01,21680,66830,998,181400,16825,6794,14627,975,6326,4260,1955,1111,8010,7455,555,7455,6182,1273,2022-01-01,zipcode
ZCTA5 36576,01,4360,85156,984,236000,3652,1035,3213,190,1046,1254,431,292,2070,1746,324,1746,1390,356,2022-01-01,zipcode
ZCTA5 36578,01,1217,67857,-666666666,198600,1022,360,1022,155,457,243,85,82,538,476,62,476,476,0,2022-01-01,zipcode
ZCTA5 36579,01,1649,64732,691,198300,1442,726,1245,171,553,255,228,38,1039,515,524,515,472,43,2022-01-01,zipcode
ZCTA5 36580,01,6574,49844,906,205700,4762,1871,4311,1002,1061,1355,618,275,2763,2311,452,2311,2016,295,2022-01-01,zipcode
ZCTA5 36581,01,232,-666666666,-666666666,-666666666,232,117,232,24,158,50,0,0,190,145,45,145,104,41,2022-01-01,zipcode
ZCTA5 36582,01,23964,58333,854,161500,18590,8509,16126,2203,6041,4910,1841,1131,10382,9262,1120,9262,7098,2164,2022-01-01,zipcode
ZCTA5 36583,01,505,46638,-666666666,167100,422,213,384,17,206,145,0,16,229,204,25,204,192,12,2022-01-01,zipcode
ZCTA5 36584,01,654,-666666666,-666666666,-666666666,571,368,502,127,171,160,36,8,599,375,224,375,347,28,2022-01-01,zipcode
ZCTA5 36585,01,917,63350,-666666666,71400,683,282,555,8,354,119,10,64,431,261,170,261,237,24,2022-01-01,zipcode
ZCTA5 36587,01,12967,60772,924,146900,10139,5108,7966,1680,3268,2011,614,393,4928,4069,859,4069,3266,803,2022-01-01,zipcode
ZCTA5 36602,01,928,30795,463,241000,910,498,853,117,198,223,197,118,778,643,135,643,139,504,2022-01-01,zipcode
ZCTA5 36603,01,8562,24612,747,117400,6764,4604,5921,1407,2253,1543,435,283,3938,2997,941,2997,956,2041,2022-01-01,zipcode
ZCTA5 36604,01,9080,58952,868,211700,7374,2563,6528,434,1592,1642,1640,1220,4962,3841,1121,3841,2254,1587,2022-01-01,zipcode
ZCTA5 36605,01,25732,40802,995,95100,20148,9361,16787,2426,7052,4799,1560,950,12124,9752,2372,9752,4855,4897,2022-01-01,zipcode
ZCTA5 36606,01,19672,50748,923,140800,14949,5126,13436,1802,4648,3200,2559,1227,9133,8144,989,8144,4099,4045,2022-01-01,zipcode
ZCTA5 36607,01,5853,42389,885,111200,5126,2550,4561,686,1473,1117,929,356,3202,2514,688,2514,1398,1116,2022-01-01,zipcode
ZCTA5 36608,01,36281,59400,992,205800,29408,11231,23986,1762,5504,6970,6011,3739,17664,15625,2039,15625,8218,7407,2022-01-01,zipcode
ZCTA5 36609,01,23552,46173,991,179300,19296,6689,16192,1403,4324,5107,3418,1940,12761,11350,1411,11350,4787,6563,2022-01-01,zipcode
ZCTA5 36610,01,10024,27464,674,52800,8027,4528,6846,1236,3089,1986,301,234,5338,3800,1538,3800,1730,2070,2022-01-01,zipcode
ZCTA5 36611,01,6398,38985,871,89300,4839,1976,4007,468,1484,1567,389,99,2767,2379,388,2379,1134,1245,2022-01-01,zipcode
ZCTA5 36612,01,3877,34575,733,75500,2771,1542,2367,589,949,552,143,134,1741,1369,372,1369,807,562,2022-01-01,zipcode
ZCTA5 36613,01,12326,49056,1152,142100,9597,4952,7661,1239,2999,2411,532,480,5005,4002,1003,4002,2980,1022,2022-01-01,zipcode
ZCTA5 36615,01,0,-666666666,-666666666,-666666666,0,0,0,0,0,0,0,0,0,0,0,0,0,0,2022-01-01,zipcode
ZCTA5 36617,01,12162,37379,1062,76600,10187,5626,8844,1228,3193,2899,1018,506,5847,4960,887,4960,2287,2673,2022-01-01,zipcode
ZCTA5 36618,01,17386,52341,1055,141600,14213,5457,11449,1011,3207,4060,2037,1134,7332,6762,570,6762,4869,1893,2022-01-01,zipcode
ZCTA5 36619,01,14658,57545,1031,157300,11891,4837,10250,1271,3211,3748,1365,655,6285,5646,639,5646,3919,1727,2022-01-01,zipcode
ZCTA5 36688,01,1693,7609,608,-666666666,1693,1008,82,44,0,31,0,7,129,56,73,56,0,56,2022-01-01,zipcode
ZCTA5 36693,01,18804,67048,1035,188100,15299,6096,13070,643,3580,4045,3205,1597,8805,7654,1151,7654,5226,2428,2022-01-01,zipcode
ZCTA5 36695,01,51877,72825,1166,222700,39710,14202,34567,2064,9425,11598,7539,3941,20924,19596,1328,19596,13052,6544,2022-01-01,zipcode
ZCTA5 36701,01,21940,41528,807,108400,17455,7291,14818,1692,5722,4408,1926,1070,10385,8222,2163,8222,4898,3324,2022-01-01,zipcode
ZCTA5 36703,01,10883,28337,666,61300,8999,5191,7677,1183,3243,2499,453,299,5708,4503,1205,4503,2654,1849,2022-01-01,zipcode
ZCTA5 36720,01,753,20536,-666666666,112800,576,372,460,103,304,39,8,6,343,260,83,260,240,20,2022-01-01,zipcode
ZCTA5 36722,01,98,-666666666,-666666666,54800,82,44,82,7,8,67,0,0,188,70,118,70,46,24,2022-01-01,zipcode
ZCTA5 36723,01,455,35625,-666666666,-666666666,347,213,146,51,31,64,0,0,277,117,160,117,104,13,2022-01-01,zipcode
ZCTA5 36726,01,5016,38427,828,92200,3948,2197,3589,870,1208,947,394,170,2288,1653,635,1653,1278,375,2022-01-01,zipcode
ZCTA5 36727,01,168,-666666666,-666666666,9999,160,88,153,30,15,82,25,1,147,115,32,115,115,0,2022-01-01,zipcode
ZCTA5 36728,01,604,18491,-666666666,47900,385,317,351,96,128,113,6,8,335,201,134,201,178,23,2022-01-01,zipcode
ZCTA5 36732,01,7985,52524,681,184600,6401,2559,5594,309,1789,1701,1206,589,3985,3324,661,3324,1923,1401,2022-01-01,zipcode
ZCTA5 36736,01,1436,34500,1083,67900,767,525,692,157,203,157,10,165,485,354,131,354,313,41,2022-01-01,zipcode
ZCTA5 36738,01,870,24609,726,77000,785,528,669,126,310,119,31,83,362,263,99,263,141,122,2022-01-01,zipcode
ZCTA5 36740,01,1220,-666666666,702,60000,1054,657,795,142,332,176,112,33,685,421,264,421,304,117,2022-01-01,zipcode
ZCTA5 36742,01,2801,43232,660,84000,2546,1599,1788,336,468,693,152,139,1263,998,265,998,820,178,2022-01-01,zipcode
ZCTA5 36744,01,5703,29857,665,124800,4515,2285,4057,885,1737,844,428,163,3151,2359,792,2359,1600,759,2022-01-01,zipcode
ZCTA5 36748,01,2697,46149,729,93000,2316,1216,2053,246,875,680,133,119,1434,1020,414,1020,662,358,2022-01-01,zipcode
ZCTA5 36749,01,608,21651,-666666666,-666666666,532,344,469,127,213,129,0,0,377,260,117,260,166,94,2022-01-01,zipcode
ZCTA5 36750,01,2659,43846,954,153900,1885,838,1723,291,880,417,74,61,1135,974,161,974,838,136,2022-01-01,zipcode
ZCTA5 36751,01,416,41705,-666666666,23000,373,168,187,43,96,25,14,9,240,131,109,131,111,20,2022-01-01,zipcode
ZCTA5 36752,01,1081,42500,-666666666,137300,888,389,840,60,274,323,143,40,665,548,117,548,508,40,2022-01-01,zipcode
ZCTA5 36753,01,0,-666666666,-666666666,-666666666,0,0,0,0,0,0,0,0,0,0,0,0,0,0,2022-01-01,zipcode
ZCTA5 36754,01,284,-666666666,-666666666,-666666666,150,83,119,13,95,0,6,5,109,99,10,99,89,10,2022-01-01,zipcode
ZCTA5 36756,01,5570,37758,573,90700,4553,2915,3199,745,1334,605,323,192,2147,1746,401,1746,1175,571,2022-01-01,zipcode
ZCTA5 36758,01,1805,48276,760,85600,1166,531,1061,241,404,319,81,16,724,608,116,608,543,65,2022-01-01,zipcode
ZCTA5 36759,01,1683,27390,1574,58400,1335,598,1219,215,453,388,130,33,924,686,238,686,542,144,2022-01-01,zipcode
ZCTA5 36761,01,754,26528,785,51100,602,428,531,131,236,137,12,15,519,374,145,374,278,96,2022-01-01,zipcode
ZCTA5 36763,01,186,82917,-666666666,-666666666,182,117,173,11,127,27,4,4,91,59,32,59,57,2,2022-01-01,zipcode
ZCTA5 36765,01,1128,47984,-666666666,76300,928,524,827,134,462,179,45,7,546,442,104,442,402,40,2022-01-01,zipcode
ZCTA5 36766,01,19,-666666666,-666666666,145000,19,12,19,5,0,0,9,5,27,13,14,13,8,5,2022-01-01,zipcode
ZCTA5 36767,01,1434,30608,346,82000,890,488,746,159,304,177,81,25,760,424,336,424,332,92,2022-01-01,zipcode
ZCTA5 36768,01,1029,37614,935,-666666666,944,404,804,158,257,277,66,46,643,361,282,361,252,109,2022-01-01,zipcode
ZCTA5 36769,01,1927,40505,-666666666,76000,1521,917,1330,199,739,285,81,26,1074,783,291,783,621,162,2022-01-01,zipcode
ZCTA5 36773,01,283,32989,-666666666,-666666666,224,111,196,35,39,117,0,5,211,95,116,95,74,21,2022-01-01,zipcode
ZCTA5 36775,01,1117,55341,1117,97700,871,588,799,287,295,181,31,5,716,547,169,547,372,175,2022-01-01,zipcode
ZCTA5 36776,01,1992,-666666666,-666666666,62200,1351,649,1047,205,306,306,145,85,835,582,253,582,459,123,2022-01-01,zipcode
ZCTA5 36782,01,2004,58438,781,86700,1539,563,1263,100,467,557,97,42,1159,785,374,785,706,79,2022-01-01,zipcode
ZCTA5 36783,01,627,41944,488,74200,556,356,491,42,203,144,62,40,499,272,227,272,181,91,2022-01-01,zipcode
ZCTA5 36784,01,6112,49186,697,137100,4601,2170,3958,485,1861,1211,186,215,3100,2194,906,2194,1407,787,2022-01-01,zipcode
ZCTA5 36785,01,742,40515,1295,101900,621,318,598,72,283,202,36,5,529,363,166,363,291,72,2022-01-01,zipcode
ZCTA5 36786,01,2055,24492,510,64900,1611,972,1493,290,640,346,138,79,1243,934,309,934,621,313,2022-01-01,zipcode
ZCTA5 36790,01,534,-666666666,240,155700,452,112,366,104,27,226,9,0,298,224,74,224,145,79,2022-01-01,zipcode
ZCTA5 36792,01,800,33350,-666666666,-666666666,648,319,648,107,288,219,17,17,630,307,323,307,239,68,2022-01-01,zipcode
ZCTA5 36793,01,859,92981,-666666666,153400,744,345,538,95,204,210,29,0,291,226,65,226,151,75,2022-01-01,zipcode
ZCTA5 36801,01,23479,55728,872,193800,19154,7794,16502,1655,4651,4833,3260,2103,10901,9578,1323,9578,6084,3494,2022-01-01,zipcode
ZCTA5 36804,01,19917,54504,738,138000,15768,6818,13349,1848,3465,4186,2382,1468,7943,7044,899,7044,5654,1390,2022-01-01,zipcode
ZCTA5 36830,01,47050,63292,1004,322100,38932,14369,29446,994,3721,6680,9700,8351,22683,19684,2999,19684,10923,8761,2022-01-01,zipcode
ZCTA5 36832,01,28917,32974,957,216000,24194,10111,13589,941,2696,3290,3111,3551,14049,10928,3121,10928,5113,5815,2022-01-01,zipcode
ZCTA5 36849,01,5397,-666666666,-666666666,-666666666,5397,3689,32,0,0,22,10,0,0,0,0,0,0,0,2022-01-01,zipcode
ZCTA5 36850,01,2731,41611,589,63400,2222,1408,1988,485,836,496,113,58,1490,1108,382,1108,912,196,2022-01-01,zipcode
ZCTA5 36852,01,2281,73832,1070,184900,1568,599,1463,111,607,584,99,62,990,793,197,793,633,160,2022-01-01,zipcode
ZCTA5 36853,01,8579,60158,849,233000,7528,3965,6650,1026,1595,2453,1136,440,6086,3398,2688,3398,2664,734,2022-01-01,zipcode
ZCTA5 36854,01,15643,58324,990,130500,12558,4797,10675,1332,3992,3638,1236,477,7560,6074,1486,6074,4198,1876,2022-01-01,zipcode
ZCTA5 36855,01,1331,56220,973,157100,1180,572,1087,161,431,404,70,21,748,609,139,609,544,65,2022-01-01,zipcode
ZCTA5 36856,01,8769,66994,1597,224600,5942,2925,5331,687,965,2736,699,244,3000,2804,196,2804,2584,220,2022-01-01,zipcode
ZCTA5 36858,01,405,33750,-666666666,146200,302,181,302,42,123,75,21,41,221,204,17,204,182,22,2022-01-01,zipcode
ZCTA5 36860,01,1710,46725,638,77600,1560,838,1322,249,434,479,90,70,954,715,239,715,544,171,2022-01-01,zipcode
ZCTA5 36861,01,2703,61563,702,238900,2414,1144,2218,454,677,579,275,233,2006,1098,908,1098,1014,84,2022-01-01,zipcode
ZCTA5 36862,01,5986,44014,599,139400,5023,2720,4638,981,1834,1226,472,125,2988,2329,659,2329,1782,547,2022-01-01,zipcode
ZCTA5 36863,01,12370,46120,724,105300,9949,4329,8647,1710,3228,2838,689,182,5580,4458,1122,4458,3177,1281,2022-01-01,zipcode
ZCTA5 36865,01,46,62656,-666666666,-666666666,46,12,27,0,12,10,5,0,23,17,6,17,5,12,2022-01-01,zipcode
ZCTA5 36866,01,4188,59086,550,96800,3444,1506,2961,724,994,896,239,108,1849,1551,298,1551,1165,386,2022-01-01,zipcode
ZCTA5 36867,01,21700,46401,938,175900,17265,6923,14341,1518,3914,5332,2120,1457,10474,8993,1481,8993,4121,4872,2022-01-01,zipcode
ZCTA5 36869,01,23052,47823,910,119800,18105,7266,15911,2856,4778,5860,1513,904,10603,9194,1409,9194,5507,3687,2022-01-01,zipcode
ZCTA5 36870,01,18812,69766,893,174100,15178,5729,13507,1185,3621,5500,1675,1526,7914,7259,655,7259,5970,1289,2022-01-01,zipcode
ZCTA5 36871,01,1027,41850,816,115500,853,532,777,275,290,105,58,49,605,417,188,417,373,44,2022-01-01,zipcode
ZCTA5 36874,01,10373,54478,914,170100,8250,3905,7358,811,2554,2490,954,549,4512,3929,583,3929,3539,390,2022-01-01,zipcode
ZCTA5 36875,01,3679,53735,701,186000,3035,1381,2628,205,696,1283,234,210,1665,1432,233,1432,1150,282,2022-01-01,zipcode
ZCTA5 36877,01,12933,62859,1043,189900,9830,3687,8040,1025,2065,3099,1091,760,4673,4099,574,4099,3240,859,2022-01-01,zipcode
ZCTA5 36879,01,3000,108015,707,288500,2438,931,2159,303,455,548,496,357,1038,986,52,986,840,146,2022-01-01,zipcode
ZCTA5 36901,01,49,-666666666,-666666666,-666666666,49,44,49,18,31,0,0,0,95,39,56,39,39,0,2022-01-01,zipcode
ZCTA5 36904,01,4196,41419,658,121300,3430,1815,2979,344,1255,942,383,55,2167,1680,487,1680,1322,358,2022-01-01,zipcode
ZCTA5 36907,01,1572,32426,1271,87900,1380,932,1185,235,385,302,112,151,1057,795,262,795,685,110,2022-01-01,zipcode
ZCTA5 36908,01,1885,64375,780,89600,1560,773,1254,187,424,405,200,38,1094,746,348,746,611,135,2022-01-01,zipcode
ZCTA5 36910,01,14,-666666666,-666666666,-666666666,14,14,14,0,0,14,0,0,6,6,0,6,6,0,2022-01-01,zipcode
ZCTA5 36912,01,1558,53000,1227,65100,1327,735,1186,149,289,602,56,90,908,598,310,598,525,73,2022-01-01,zipcode
ZCTA5 36913,01,54,-666666666,-666666666,-666666666,54,54,54,40,0,14,0,0,25,25,0,25,25,0,2022-01-01,zipcode
ZCTA5 36915,01,574,32941,-666666666,114800,474,251,431,63,227,121,19,1,355,280,75,280,213,67,2022-01-01,zipcode
ZCTA5 36916,01,689,28792,328,81100,538,302,467,97,144,206,8,12,409,296,113,296,233,63,2022-01-01,zipcode
ZCTA5 36919,01,1764,51196,454,79700,1502,879,1305,266,637,294,67,41,938,708,230,708,555,153,2022-01-01,zipcode
ZCTA5 36921,01,919,26111,475,154700,831,532,681,238,233,170,40,0,696,524,172,524,461,63,2022-01-01,zipcode
ZCTA5 36922,01,805,112778,-666666666,111000,602,286,485,177,153,123,32,0,392,224,168,224,224,0,2022-01-01,zipcode
ZCTA5 36925,01,2961,35481,545,49400,2398,1033,2191,219,658,955,240,119,1790,1397,393,1397,858,539,2022-01-01,zipcode
